"","ensembl_gene_id","chromosome_name","start_position","end_position","length"
"1","ENSACAG00000000002","AAWZ02036500",57,24966,24909
"2","ENSACAG00000000003","GL343298.1",382762,383478,716
"3","ENSACAG00000000004","AAWZ02037281",917,3083,2166
"4","ENSACAG00000000006","5",56399421,56439432,40011
"5","ENSACAG00000000007","5",56207307,56390378,183071
"6","ENSACAG00000000008","GL343592.1",377831,378006,175
"7","ENSACAG00000000009","GL343592.1",383044,431316,48272
"8","ENSACAG00000000010","AAWZ02036318",1365,13507,12142
"9","ENSACAG00000000011","AAWZ02036318",15192,28124,12932
"10","ENSACAG00000000012","GL344868.1",2970,9978,7008
"11","ENSACAG00000000013","6",32194075,32364304,170229
"12","ENSACAG00000000014","6",32849361,32865768,16407
"13","ENSACAG00000000015","6",32865073,32894860,29787
"14","ENSACAG00000000016","6",32938536,32945799,7263
"15","ENSACAG00000000017","6",32947222,32955883,8661
"16","ENSACAG00000000018","6",32979477,33004588,25111
"17","ENSACAG00000000019","6",33107899,33304466,196567
"18","ENSACAG00000000020","5",12823388,12852929,29541
"19","ENSACAG00000000021","5",12799686,12818924,19238
"20","ENSACAG00000000022","5",12649701,12776919,127218
"21","ENSACAG00000000024","5",12377219,12454539,77320
"22","ENSACAG00000000026","5",12351838,12360427,8589
"23","ENSACAG00000000027","AAWZ02038099",807,1183,376
"24","ENSACAG00000000028","5",12207683,12335637,127954
"25","ENSACAG00000000029","AAWZ02038536",285,8491,8206
"26","ENSACAG00000000030","AAWZ02041297",1011,3365,2354
"27","ENSACAG00000000031","5",12084608,12143471,58863
"28","ENSACAG00000000032","5",11969736,12077422,107686
"29","ENSACAG00000000033","5",11936789,11955459,18670
"30","ENSACAG00000000034","5",11886209,11931909,45700
"31","ENSACAG00000000035","5",11824545,11877262,52717
"32","ENSACAG00000000036","5",11644186,11683392,39206
"33","ENSACAG00000000037","5",11427369,11611880,184511
"34","ENSACAG00000000038","5",11324639,11363802,39163
"35","ENSACAG00000000039","5",11288836,11321695,32859
"36","ENSACAG00000000042","1",66306676,66314838,8162
"37","ENSACAG00000000043","1",66327388,66525731,198343
"38","ENSACAG00000000044","1",66622601,66629484,6883
"39","ENSACAG00000000045","1",66632086,66675396,43310
"40","ENSACAG00000000046","1",66707614,66748533,40919
"41","ENSACAG00000000047","1",66773690,66774871,1181
"42","ENSACAG00000000048","1",66778470,66870434,91964
"43","ENSACAG00000000051","1",66890849,66949839,58990
"44","ENSACAG00000000052","1",66982664,67095580,112916
"45","ENSACAG00000000053","1",67277630,67287305,9675
"46","ENSACAG00000000054","1",67298921,67311593,12672
"47","ENSACAG00000000055","1",67348426,67505179,156753
"48","ENSACAG00000000057","1",67635627,67657531,21904
"49","ENSACAG00000000058","1",67690956,67709418,18462
"50","ENSACAG00000000059","1",67709437,67744518,35081
"51","ENSACAG00000000060","1",67753410,67775098,21688
"52","ENSACAG00000000061","1",67792747,67811950,19203
"53","ENSACAG00000000062","1",67814852,67847723,32871
"54","ENSACAG00000000063","1",67850166,67864236,14070
"55","ENSACAG00000000064","1",67869567,67885623,16056
"56","ENSACAG00000000065","1",67922611,67971237,48626
"57","ENSACAG00000000066","1",67988391,68033979,45588
"58","ENSACAG00000000067","1",68039261,68104629,65368
"59","ENSACAG00000000068","1",68208286,68313947,105661
"60","ENSACAG00000000070","1",68455131,68527757,72626
"61","ENSACAG00000000071","1",68530710,68540182,9472
"62","ENSACAG00000000073","1",68593585,68628666,35081
"63","ENSACAG00000000074","1",68646490,68699662,53172
"64","ENSACAG00000000075","1",68778119,68778732,613
"65","ENSACAG00000000076","1",68732281,68732730,449
"66","ENSACAG00000000077","1",68784032,68867384,83352
"67","ENSACAG00000000079","GL343363.1",10058,25729,15671
"68","ENSACAG00000000080","GL343363.1",942808,961857,19049
"69","ENSACAG00000000081","GL343363.1",1113441,1123045,9604
"70","ENSACAG00000000082","AAWZ02039446",2834,4938,2104
"71","ENSACAG00000000083","GL343674.1",245029,248542,3513
"72","ENSACAG00000000084","GL343392.1",638245,719118,80873
"73","ENSACAG00000000085","GL343392.1",777376,796525,19149
"74","ENSACAG00000000086","GL343392.1",799049,805633,6584
"75","ENSACAG00000000087","GL343392.1",814067,825003,10936
"76","ENSACAG00000000088","GL343392.1",882188,947446,65258
"77","ENSACAG00000000089","GL343392.1",947511,1006031,58520
"78","ENSACAG00000000090","AAWZ02037755",870,14726,13856
"79","ENSACAG00000000091","GL343322.1",1326543,1432528,105985
"80","ENSACAG00000000092","GL343571.1",389727,401973,12246
"81","ENSACAG00000000094","AAWZ02039691",2049,5901,3852
"82","ENSACAG00000000095","GL343837.1",74615,166283,91668
"83","ENSACAG00000000097","GL343322.1",1279903,1306672,26769
"84","ENSACAG00000000098","GL343232.1",2018227,2109681,91454
"85","ENSACAG00000000099","GL343407.1",158529,236511,77982
"86","ENSACAG00000000100","GL343407.1",107371,138995,31624
"87","ENSACAG00000000101","GL343322.1",1129449,1158460,29011
"88","ENSACAG00000000102","GL343232.1",1943433,2001780,58347
"89","ENSACAG00000000103","GL343322.1",1123000,1125455,2455
"90","ENSACAG00000000106","4",69088805,69667612,578807
"91","ENSACAG00000000107","GL343322.1",1098262,1108101,9839
"92","ENSACAG00000000108","GL343322.1",1079321,1096052,16731
"93","ENSACAG00000000109","GL343322.1",1075060,1080048,4988
"94","ENSACAG00000000112","1",148001345,148019236,17891
"95","ENSACAG00000000114","GL343322.1",935358,945110,9752
"96","ENSACAG00000000115","4",104460292,104461710,1418
"97","ENSACAG00000000118","GL343322.1",858415,864826,6411
"98","ENSACAG00000000119","4",104449080,104459299,10219
"99","ENSACAG00000000120","GL343322.1",831857,845507,13650
"100","ENSACAG00000000122","GL344817.1",7665,9254,1589
"101","ENSACAG00000000124","4",104433385,104447933,14548
"102","ENSACAG00000000125","GL343967.1",626,9418,8792
"103","ENSACAG00000000126","AAWZ02037500",5013,14108,9095
"104","ENSACAG00000000128","1",148050180,148071864,21684
"105","ENSACAG00000000129","4",104410900,104431007,20107
"106","ENSACAG00000000130","4",104392352,104405193,12841
"107","ENSACAG00000000131","4",16488532,16489341,809
"108","ENSACAG00000000132","1",148095348,148179992,84644
"109","ENSACAG00000000133","4",16509426,16510409,983
"110","ENSACAG00000000135","4",16441421,16444268,2847
"111","ENSACAG00000000136","GL343322.1",812723,825080,12357
"112","ENSACAG00000000139","4",16274636,16276087,1451
"113","ENSACAG00000000140","4",16041507,16127709,86202
"114","ENSACAG00000000141","4",139233222,139278542,45320
"115","ENSACAG00000000144","4",15677183,15790531,113348
"116","ENSACAG00000000145","4",104357124,104357225,101
"117","ENSACAG00000000146","4",104277264,104302469,25205
"118","ENSACAG00000000150","4",139295513,139327114,31601
"119","ENSACAG00000000151","GL343232.1",1912641,1921714,9073
"120","ENSACAG00000000152","1",148191308,148247259,55951
"121","ENSACAG00000000153","4",139345663,139391290,45627
"122","ENSACAG00000000154","4",38374979,38435503,60524
"123","ENSACAG00000000155","GL343322.1",798141,809462,11321
"124","ENSACAG00000000156","2",134467111,134525427,58316
"125","ENSACAG00000000157","GL344422.1",38168,43435,5267
"126","ENSACAG00000000159","4",38289966,38308641,18675
"127","ENSACAG00000000160","4",139398135,139609548,211413
"128","ENSACAG00000000164","GL343232.1",1837284,1889292,52008
"129","ENSACAG00000000165","GL343322.1",301048,324114,23066
"130","ENSACAG00000000166","4",15669999,15672625,2626
"131","ENSACAG00000000167","4",15623698,15657145,33447
"132","ENSACAG00000000168","4",104183166,104272080,88914
"133","ENSACAG00000000169","GL343232.1",1812223,1826315,14092
"134","ENSACAG00000000170","GL343838.1",14072,71800,57728
"135","ENSACAG00000000171","GL343232.1",1804021,1807614,3593
"136","ENSACAG00000000173","GL343322.1",203924,219190,15266
"137","ENSACAG00000000175","4",38261221,38285414,24193
"138","ENSACAG00000000176","GL343232.1",1755039,1800065,45026
"139","ENSACAG00000000177","GL343406.1",308556,324444,15888
"140","ENSACAG00000000178","4",103442851,103522520,79669
"141","ENSACAG00000000179","3",105978360,105988812,10452
"142","ENSACAG00000000180","GL343232.1",1714679,1715566,887
"143","ENSACAG00000000181","GL343406.1",326696,331875,5179
"144","ENSACAG00000000182","GL343232.1",1400418,1564379,163961
"145","ENSACAG00000000184","GL343250.1",206620,318155,111535
"146","ENSACAG00000000185","GL343322.1",196438,197813,1375
"147","ENSACAG00000000186","GL343322.1",192646,198889,6243
"148","ENSACAG00000000187","GL344274.1",13468,46215,32747
"149","ENSACAG00000000188","3",105990179,106012619,22440
"150","ENSACAG00000000189","GL343322.1",185479,192281,6802
"151","ENSACAG00000000190","AAWZ02039250",143,6456,6313
"152","ENSACAG00000000191","GL343644.1",421,5565,5144
"153","ENSACAG00000000192","GL343644.1",8689,15789,7100
"154","ENSACAG00000000193","GL343406.1",336253,337626,1373
"155","ENSACAG00000000194","1",147194573,147197367,2794
"156","ENSACAG00000000195","GL343406.1",341665,430245,88580
"157","ENSACAG00000000197","4",15614195,15617737,3542
"158","ENSACAG00000000198","1",147049018,147159318,110300
"159","ENSACAG00000000199","GL343644.1",17703,28093,10390
"160","ENSACAG00000000200","GL343322.1",177623,182891,5268
"161","ENSACAG00000000201","4",38225663,38260674,35011
"162","ENSACAG00000000202","GL343232.1",1117283,1157266,39983
"163","ENSACAG00000000203","4",15476845,15611749,134904
"164","ENSACAG00000000204","GL343250.1",363826,402454,38628
"165","ENSACAG00000000205","GL343322.1",160228,176684,16456
"166","ENSACAG00000000206","GL343250.1",420411,622104,201693
"167","ENSACAG00000000207","GL343232.1",948852,1064864,116012
"168","ENSACAG00000000210","GL343250.1",674851,689170,14319
"169","ENSACAG00000000211","GL344615.1",15725,20473,4748
"170","ENSACAG00000000212","3",106014173,106053439,39266
"171","ENSACAG00000000213","GL343698.1",2618,27939,25321
"172","ENSACAG00000000214","GL343232.1",781148,925254,144106
"173","ENSACAG00000000215","GL343322.1",151436,158084,6648
"174","ENSACAG00000000216","GL343644.1",124161,196498,72337
"175","ENSACAG00000000222","GL343698.1",53176,113460,60284
"176","ENSACAG00000000223","GL343491.1",60841,62220,1379
"177","ENSACAG00000000224","AAWZ02038389",7235,11818,4583
"178","ENSACAG00000000225","GL343406.1",429394,433934,4540
"179","ENSACAG00000000226","GL343685.1",927,221933,221006
"180","ENSACAG00000000227","GL343367.1",14652,73118,58466
"181","ENSACAG00000000228","AAWZ02039762",4137,7682,3545
"182","ENSACAG00000000229","GL343615.1",89104,96146,7042
"183","ENSACAG00000000230","GL343251.1",31267,252657,221390
"184","ENSACAG00000000231","AAWZ02037242",1540,16668,15128
"185","ENSACAG00000000233","GL343406.1",451846,459830,7984
"186","ENSACAG00000000234","GL343367.1",81098,92736,11638
"187","ENSACAG00000000235","GL343201.1",1391401,1392463,1062
"188","ENSACAG00000000236","GL343201.1",1265534,1294797,29263
"189","ENSACAG00000000237","GL343367.1",266264,455781,189517
"190","ENSACAG00000000239","GL343250.1",866684,936705,70021
"191","ENSACAG00000000240","GL343555.1",263570,311098,47528
"192","ENSACAG00000000241","GL343406.1",513039,519545,6506
"193","ENSACAG00000000242","GL343615.1",133163,276011,142848
"194","ENSACAG00000000244","GL343195.1",2745772,2911355,165583
"195","ENSACAG00000000245","GL343201.1",1126836,1158678,31842
"196","ENSACAG00000000246","AAWZ02036995",977,20395,19418
"197","ENSACAG00000000247","GL343555.1",358345,371198,12853
"198","ENSACAG00000000248","GL343653.1",125414,127062,1648
"199","ENSACAG00000000249","GL343563.1",341026,342582,1556
"200","ENSACAG00000000251","GL343653.1",72885,73238,353
"201","ENSACAG00000000252","GL343317.1",508013,643221,135208
"202","ENSACAG00000000253","GL343250.1",948282,972253,23971
"203","ENSACAG00000000254","GL343343.1",388362,389520,1158
"204","ENSACAG00000000255","GL343653.1",22833,52009,29176
"205","ENSACAG00000000256","GL343201.1",1047143,1113428,66285
"206","ENSACAG00000000258","GL344178.1",9259,9537,278
"207","ENSACAG00000000260","GL343317.1",161017,177495,16478
"208","ENSACAG00000000261","GL343563.1",248769,249330,561
"209","ENSACAG00000000262","GL343563.1",222394,237055,14661
"210","ENSACAG00000000263","1",147005364,147008531,3167
"211","ENSACAG00000000264","3",106059663,106077417,17754
"212","ENSACAG00000000265","3",106080180,106114012,33832
"213","ENSACAG00000000267","1",146855676,146972894,117218
"214","ENSACAG00000000268","GL343563.1",188923,196743,7820
"215","ENSACAG00000000269","GL343250.1",995110,1081163,86053
"216","ENSACAG00000000270","GL343653.1",416,7208,6792
"217","ENSACAG00000000271","GL343317.1",77360,92970,15610
"218","ENSACAG00000000272","GL343406.1",536199,540859,4660
"219","ENSACAG00000000273","GL343406.1",591195,608254,17059
"220","ENSACAG00000000274","3",106152098,106193059,40961
"221","ENSACAG00000000275","GL343644.1",271780,302250,30470
"222","ENSACAG00000000276","GL344343.1",7398,12860,5462
"223","ENSACAG00000000278","4",60643273,60685163,41890
"224","ENSACAG00000000279","2",41708663,41745711,37048
"225","ENSACAG00000000280","AAWZ02038699",257,10724,10467
"226","ENSACAG00000000281","AAWZ02036575",16,11983,11967
"227","ENSACAG00000000282","GL343722.1",235152,242324,7172
"228","ENSACAG00000000284","GL344245.1",7304,31405,24101
"229","ENSACAG00000000285","GL345004.1",1167,2892,1725
"230","ENSACAG00000000286","AAWZ02038541",642,7948,7306
"231","ENSACAG00000000288","GL343282.1",1639515,1640069,554
"232","ENSACAG00000000289","4",38167033,38198701,31668
"233","ENSACAG00000000290","GL343282.1",1592151,1629022,36871
"234","ENSACAG00000000291","GL343212.1",4031,19420,15389
"235","ENSACAG00000000294","GL343644.1",314024,325947,11923
"236","ENSACAG00000000295","GL343406.1",654470,670157,15687
"237","ENSACAG00000000296","GL343201.1",968654,991722,23068
"238","ENSACAG00000000298","1",235812496,235821766,9270
"239","ENSACAG00000000300","1",235768278,235782580,14302
"240","ENSACAG00000000301","GL343317.1",25973,74531,48558
"241","ENSACAG00000000302","4",60342080,60539586,197506
"242","ENSACAG00000000303","GL344343.1",14915,38282,23367
"243","ENSACAG00000000304","4",37985524,38143246,157722
"244","ENSACAG00000000305","4",60306620,60321404,14784
"245","ENSACAG00000000306","4",60242077,60255326,13249
"246","ENSACAG00000000307","AAWZ02041731",418,5255,4837
"247","ENSACAG00000000308","GL343201.1",882598,960694,78096
"248","ENSACAG00000000309","3",106196849,106216533,19684
"249","ENSACAG00000000310","GL343384.1",996761,1000854,4093
"250","ENSACAG00000000311","6",38295851,38298037,2186
"251","ENSACAG00000000315","GL343974.1",86711,100584,13873
"252","ENSACAG00000000317","GL343250.1",1088074,1101176,13102
"253","ENSACAG00000000318","GL343295.1",1607735,1623403,15668
"254","ENSACAG00000000319","GL343250.1",1113789,1125650,11861
"255","ENSACAG00000000320","GL343695.1",1430,209430,208000
"256","ENSACAG00000000321","3",96226872,96228251,1379
"257","ENSACAG00000000322","GL344356.1",11630,17177,5547
"258","ENSACAG00000000324","4",60162321,60228075,65754
"259","ENSACAG00000000325","1",146726342,146777382,51040
"260","ENSACAG00000000328","6",38213876,38266274,52398
"261","ENSACAG00000000329","GL343698.1",296840,311268,14428
"262","ENSACAG00000000330","GL343555.1",378113,393833,15720
"263","ENSACAG00000000332","3",93916936,93919041,2105
"264","ENSACAG00000000334","1",98527785,98529407,1622
"265","ENSACAG00000000336","GL343223.1",1745057,1913136,168079
"266","ENSACAG00000000338","1",98452786,98500005,47219
"267","ENSACAG00000000339","AAWZ02039732",3830,6786,2956
"268","ENSACAG00000000340","GL344245.1",34248,49637,15389
"269","ENSACAG00000000341","AAWZ02036909",14875,16360,1485
"270","ENSACAG00000000342","AAWZ02037835",390,2516,2126
"271","ENSACAG00000000343","GL343238.1",1782641,2150819,368178
"272","ENSACAG00000000344","GL343325.1",959686,993619,33933
"273","ENSACAG00000000347","GL343386.1",24198,69112,44914
"274","ENSACAG00000000349","GL343385.1",390402,430431,40029
"275","ENSACAG00000000350","GL343214.1",229056,439293,210237
"276","ENSACAG00000000351","4",60009096,60144194,135098
"277","ENSACAG00000000352","AAWZ02039935",2,4264,4262
"278","ENSACAG00000000353","GL343214.1",737315,867044,129729
"279","ENSACAG00000000355","5",148200997,148216620,15623
"280","ENSACAG00000000356","AAWZ02037656",918,8803,7885
"281","ENSACAG00000000359","GL343513.1",289626,318387,28761
"282","ENSACAG00000000361","GL344487.1",21,24731,24710
"283","ENSACAG00000000362","GL344052.1",12456,67440,54984
"284","ENSACAG00000000363","GL343799.1",157169,194792,37623
"285","ENSACAG00000000364","GL343815.1",80491,140787,60296
"286","ENSACAG00000000365","1",45463006,45463292,286
"287","ENSACAG00000000366","GL343232.1",404822,429161,24339
"288","ENSACAG00000000367","3",106223839,106245468,21629
"289","ENSACAG00000000369","2",41747560,41759185,11625
"290","ENSACAG00000000371","2",41800401,41826247,25846
"291","ENSACAG00000000373","3",42319932,42321480,1548
"292","ENSACAG00000000374","GL344157.1",13212,62717,49505
"293","ENSACAG00000000375","GL343635.1",350882,380593,29711
"294","ENSACAG00000000376","GL343349.1",724506,963399,238893
"295","ENSACAG00000000378","GL343991.1",32815,78093,45278
"296","ENSACAG00000000380","3",71184062,71223609,39547
"297","ENSACAG00000000382","5",73253010,73268869,15859
"298","ENSACAG00000000383","GL343295.1",1565049,1600242,35193
"299","ENSACAG00000000384","1",146227980,146258714,30734
"300","ENSACAG00000000385","AAWZ02036634",13854,23015,9161
"301","ENSACAG00000000386","GL343230.1",1569855,1600153,30298
"302","ENSACAG00000000388","GL343349.1",1012293,1118225,105932
"303","ENSACAG00000000389","GL343563.1",162086,167048,4962
"304","ENSACAG00000000390","3",117250437,117364284,113847
"305","ENSACAG00000000392","GL343568.1",290479,325945,35466
"306","ENSACAG00000000396","3",70901380,70912128,10748
"307","ENSACAG00000000397","1",235667439,235717211,49772
"308","ENSACAG00000000398","GL343815.1",33869,46690,12821
"309","ENSACAG00000000399","AAWZ02037182",5851,12963,7112
"310","ENSACAG00000000400","GL344753.1",2548,6587,4039
"311","ENSACAG00000000401","GL344705.1",2681,24215,21534
"312","ENSACAG00000000402","1",145258003,145263945,5942
"313","ENSACAG00000000403","GL343385.1",540924,555309,14385
"314","ENSACAG00000000404","GL343583.1",375817,397180,21363
"315","ENSACAG00000000406","1",221078054,221155221,77167
"316","ENSACAG00000000407","1",127344168,127504132,159964
"317","ENSACAG00000000408","AAWZ02040772",3858,3983,125
"318","ENSACAG00000000409","GL344091.1",1862,79860,77998
"319","ENSACAG00000000410","5",73296826,73297548,722
"320","ENSACAG00000000412","5",73432807,73471738,38931
"321","ENSACAG00000000413","GL344575.1",741,16522,15781
"322","ENSACAG00000000415","3",117644233,117669759,25526
"323","ENSACAG00000000417","3",106344205,106417648,73443
"324","ENSACAG00000000418","GL343765.1",55659,70125,14466
"325","ENSACAG00000000419","GL343858.1",165639,171184,5545
"326","ENSACAG00000000420","GL344203.1",2418,18668,16250
"327","ENSACAG00000000421","GL343295.1",44099,65190,21091
"328","ENSACAG00000000422","1",129570701,129635084,64383
"329","ENSACAG00000000423","GL343971.1",81052,109409,28357
"330","ENSACAG00000000424","2",41830744,41858652,27908
"331","ENSACAG00000000425","GL343528.1",439337,466014,26677
"332","ENSACAG00000000426","GL343444.1",43348,100633,57285
"333","ENSACAG00000000427","GL344335.1",1510,7093,5583
"334","ENSACAG00000000428","3",106250490,106306788,56298
"335","ENSACAG00000000429","GL343406.1",675643,677069,1426
"336","ENSACAG00000000431","3",15863207,15870385,7178
"337","ENSACAG00000000432","GL343349.1",1155153,1165731,10578
"338","ENSACAG00000000433","3",30679127,30683090,3963
"339","ENSACAG00000000434","GL343858.1",94903,137078,42175
"340","ENSACAG00000000435","GL345040.1",21,4195,4174
"341","ENSACAG00000000438","GL343367.1",455851,533339,77488
"342","ENSACAG00000000439","3",118028203,118138616,110413
"343","ENSACAG00000000440","GL344704.1",10438,23133,12695
"344","ENSACAG00000000441","GL344335.1",55203,58794,3591
"345","ENSACAG00000000442","3",70812588,70851893,39305
"346","ENSACAG00000000443","5",50861551,50877726,16175
"347","ENSACAG00000000445","AAWZ02039169",232,7274,7042
"348","ENSACAG00000000446","3",30666799,30674320,7521
"349","ENSACAG00000000447","GL343528.1",426292,432230,5938
"350","ENSACAG00000000448","5",50962739,51071655,108916
"351","ENSACAG00000000449","GL344608.1",1027,11736,10709
"352","ENSACAG00000000451","1",98203548,98241017,37469
"353","ENSACAG00000000452","GL343734.1",20325,60878,40553
"354","ENSACAG00000000455","GL343616.1",313492,366181,52689
"355","ENSACAG00000000456","3",63189426,63528796,339370
"356","ENSACAG00000000458","GL343350.1",202972,245327,42355
"357","ENSACAG00000000459","GL344452.1",21,12131,12110
"358","ENSACAG00000000460","AAWZ02037994",739,12441,11702
"359","ENSACAG00000000461","AAWZ02035620",33975,35002,1027
"360","ENSACAG00000000462","GL343386.1",125949,253305,127356
"361","ENSACAG00000000463","GL344084.1",6394,10013,3619
"362","ENSACAG00000000464","GL344337.1",2702,41609,38907
"363","ENSACAG00000000465","3",82506446,82912520,406074
"364","ENSACAG00000000466","GL344031.1",939,6592,5653
"365","ENSACAG00000000468","GL343777.1",59223,67524,8301
"366","ENSACAG00000000469","GL343563.1",155788,163122,7334
"367","ENSACAG00000000470","3",86669814,86679100,9286
"368","ENSACAG00000000471","GL343246.1",749,1498,749
"369","ENSACAG00000000472","GL343246.1",130333,141781,11448
"370","ENSACAG00000000473","GL343232.1",331659,331976,317
"371","ENSACAG00000000474","GL343250.1",1164665,1277130,112465
"372","ENSACAG00000000475","GL343246.1",163717,183328,19611
"373","ENSACAG00000000476","1",31742989,31973272,230283
"374","ENSACAG00000000477","1",28875367,29032400,157033
"375","ENSACAG00000000478","4",52244052,52268338,24286
"376","ENSACAG00000000479","3",166262309,166289164,26855
"377","ENSACAG00000000481","GL343367.1",548121,576545,28424
"378","ENSACAG00000000482","3",73953685,73956255,2570
"379","ENSACAG00000000483","3",15839636,15853662,14026
"380","ENSACAG00000000484","6",38196867,38212467,15600
"381","ENSACAG00000000485","GL343232.1",310989,318668,7679
"382","ENSACAG00000000486","AAWZ02039304",2305,7997,5692
"383","ENSACAG00000000487","AAWZ02037120",339,15275,14936
"384","ENSACAG00000000488","2",21681539,21795554,114015
"385","ENSACAG00000000489","GL343785.1",58264,58732,468
"386","ENSACAG00000000490","GL343385.1",577728,634758,57030
"387","ENSACAG00000000491","GL343583.1",148840,241917,93077
"388","ENSACAG00000000492","3",30619744,30646588,26844
"389","ENSACAG00000000493","GL343350.1",254215,391421,137206
"390","ENSACAG00000000495","3",86663376,86670717,7341
"391","ENSACAG00000000496","AAWZ02039731",3334,6348,3014
"392","ENSACAG00000000497","4",82934304,82952564,18260
"393","ENSACAG00000000498","3",52573842,52586301,12459
"394","ENSACAG00000000499","AAWZ02038557",5595,6725,1130
"395","ENSACAG00000000500","GL344392.1",35306,36196,890
"396","ENSACAG00000000501","GL344394.1",11477,30896,19419
"397","ENSACAG00000000502","GL344648.1",21,23725,23704
"398","ENSACAG00000000504","AAWZ02037788",1987,2970,983
"399","ENSACAG00000000506","AAWZ02038732",1282,10179,8897
"400","ENSACAG00000000507","GL344627.1",16557,26907,10350
"401","ENSACAG00000000508","GL344322.1",18855,42805,23950
"402","ENSACAG00000000509","GL344046.1",11479,12545,1066
"403","ENSACAG00000000510","1",45406716,45427253,20537
"404","ENSACAG00000000511","GL343635.1",79657,93770,14113
"405","ENSACAG00000000512","GL344154.1",28805,60169,31364
"406","ENSACAG00000000513","GL343744.1",216452,222714,6262
"407","ENSACAG00000000514","AAWZ02040038",1009,2636,1627
"408","ENSACAG00000000515","AAWZ02037496",3079,13398,10319
"409","ENSACAG00000000516","AAWZ02039054",7888,8025,137
"410","ENSACAG00000000517","GL343528.1",418862,419968,1106
"411","ENSACAG00000000520","GL343311.1",150147,225251,75104
"412","ENSACAG00000000522","5",81821509,82024856,203347
"413","ENSACAG00000000523","3",166290663,166344143,53480
"414","ENSACAG00000000524","AAWZ02037460",2045,14966,12921
"415","ENSACAG00000000525","GL343527.1",380344,483857,103513
"416","ENSACAG00000000526","GL343528.1",413280,413941,661
"417","ENSACAG00000000527","1",253739903,253745040,5137
"418","ENSACAG00000000531","GL343811.1",5474,55951,50477
"419","ENSACAG00000000532","GL343201.1",892369,951292,58923
"420","ENSACAG00000000533","3",30587941,30609453,21512
"421","ENSACAG00000000535","3",86653968,86660271,6303
"422","ENSACAG00000000536","GL343799.1",114198,128440,14242
"423","ENSACAG00000000538","1",253711497,253740258,28761
"424","ENSACAG00000000539","3",118514453,118546473,32020
"425","ENSACAG00000000541","GL343744.1",153709,156820,3111
"426","ENSACAG00000000542","GL343777.1",85618,94235,8617
"427","ENSACAG00000000543","GL344390.1",4620,40900,36280
"428","ENSACAG00000000544","GL343676.1",2729,12639,9910
"429","ENSACAG00000000545","1",97486789,98047440,560651
"430","ENSACAG00000000546","GL343691.1",76535,108399,31864
"431","ENSACAG00000000547","GL343339.1",134320,217515,83195
"432","ENSACAG00000000548","GL343367.1",633582,659656,26074
"433","ENSACAG00000000549","4",15277414,15324810,47396
"434","ENSACAG00000000550","GL343230.1",1606846,1616812,9966
"435","ENSACAG00000000552","4",52298853,52460200,161347
"436","ENSACAG00000000553","GL344296.1",800,11828,11028
"437","ENSACAG00000000555","GL343230.1",1633266,1665146,31880
"438","ENSACAG00000000556","3",15759455,15835869,76414
"439","ENSACAG00000000557","GL344114.1",22955,27362,4407
"440","ENSACAG00000000558","GL344203.1",19304,30311,11007
"441","ENSACAG00000000559","GL343858.1",85587,91657,6070
"442","ENSACAG00000000561","GL344205.1",2889,46072,43183
"443","ENSACAG00000000562","GL344462.1",419,13774,13355
"444","ENSACAG00000000564","3",52507353,52562013,54660
"445","ENSACAG00000000565","GL343765.1",146281,196748,50467
"446","ENSACAG00000000566","GL343339.1",229706,477764,248058
"447","ENSACAG00000000567","GL343406.1",702937,779485,76548
"448","ENSACAG00000000569","AAWZ02037240",11818,13836,2018
"449","ENSACAG00000000571","GL343799.1",78043,87824,9781
"450","ENSACAG00000000574","5",51082174,51134587,52413
"451","ENSACAG00000000575","1",129395718,129411859,16141
"452","ENSACAG00000000576","GL343201.1",864817,879188,14371
"453","ENSACAG00000000577","GL343201.1",783235,838060,54825
"454","ENSACAG00000000578","GL343615.1",184049,203289,19240
"455","ENSACAG00000000579","GL344014.1",8445,13799,5354
"456","ENSACAG00000000580","GL343854.1",79816,112800,32984
"457","ENSACAG00000000581","4",92664046,92729389,65343
"458","ENSACAG00000000582","1",127301548,127313812,12264
"459","ENSACAG00000000583","2",21330982,21368074,37092
"460","ENSACAG00000000587","GL344049.1",4825,5784,959
"461","ENSACAG00000000590","GL343311.1",458981,480065,21084
"462","ENSACAG00000000591","GL344099.1",23037,24684,1647
"463","ENSACAG00000000592","GL343396.1",717754,775387,57633
"464","ENSACAG00000000593","LGc",9415737,9460704,44967
"465","ENSACAG00000000594","GL344049.1",19514,22505,2991
"466","ENSACAG00000000595","GL343333.1",639306,649152,9846
"467","ENSACAG00000000597","GL343210.1",1188949,1299105,110156
"468","ENSACAG00000000598","GL343391.1",459735,460685,950
"469","ENSACAG00000000599","GL343858.1",67990,72195,4205
"470","ENSACAG00000000600","5",90186469,90353279,166810
"471","ENSACAG00000000601","GL343528.1",343968,377523,33555
"472","ENSACAG00000000602","GL343744.1",104847,128972,24125
"473","ENSACAG00000000603","GL343777.1",122574,129791,7217
"474","ENSACAG00000000604","2",164488645,164641513,152868
"475","ENSACAG00000000605","3",70777842,70809909,32067
"476","ENSACAG00000000606","2",73704768,73706678,1910
"477","ENSACAG00000000607","GL343578.1",323465,332205,8740
"478","ENSACAG00000000608","3",86642479,86647794,5315
"479","ENSACAG00000000609","1",253621810,253683402,61592
"480","ENSACAG00000000610","2",73497250,73536215,38965
"481","ENSACAG00000000611","GL344296.1",37466,39681,2215
"482","ENSACAG00000000612","GL343889.1",125794,145845,20051
"483","ENSACAG00000000613","GL343391.1",327711,391880,64169
"484","ENSACAG00000000615","GL344049.1",38461,39863,1402
"485","ENSACAG00000000617","GL344049.1",72436,84522,12086
"486","ENSACAG00000000618","3",88643998,88650414,6416
"487","ENSACAG00000000619","GL343333.1",255204,588052,332848
"488","ENSACAG00000000623","GL343799.1",5780,62667,56887
"489","ENSACAG00000000624","GL343858.1",41942,64868,22926
"490","ENSACAG00000000625","3",88625470,88638102,12632
"491","ENSACAG00000000626","GL343735.1",2400,16460,14060
"492","ENSACAG00000000627","2",20889479,20909410,19931
"493","ENSACAG00000000628","6",10864238,10899058,34820
"494","ENSACAG00000000629","GL343260.1",67393,258683,191290
"495","ENSACAG00000000630","GL344228.1",12866,17397,4531
"496","ENSACAG00000000631","GL344046.1",30105,80192,50087
"497","ENSACAG00000000632","GL343199.1",370765,371040,275
"498","ENSACAG00000000633","1",127296933,127299461,2528
"499","ENSACAG00000000635","GL343367.1",731698,1014060,282362
"500","ENSACAG00000000637","GL343928.1",834,12680,11846
"501","ENSACAG00000000638","3",166316258,166317133,875
"502","ENSACAG00000000639","GL344203.1",30373,39648,9275
"503","ENSACAG00000000640","GL343246.1",188479,229535,41056
"504","ENSACAG00000000642","GL343854.1",44351,77155,32804
"505","ENSACAG00000000643","GL343739.1",271348,291613,20265
"506","ENSACAG00000000644","3",166347880,166396218,48338
"507","ENSACAG00000000645","GL344228.1",24689,40705,16016
"508","ENSACAG00000000646","3",86475749,86637155,161406
"509","ENSACAG00000000647","GL343325.1",926786,959293,32507
"510","ENSACAG00000000648","GL343211.1",2837912,2956975,119063
"511","ENSACAG00000000649","3",88594053,88622530,28477
"512","ENSACAG00000000650","GL343475.1",380696,520136,139440
"513","ENSACAG00000000651","GL343578.1",339179,346341,7162
"514","ENSACAG00000000652","GL343232.1",161320,244112,82792
"515","ENSACAG00000000653","4",15179931,15271163,91232
"516","ENSACAG00000000654","GL343396.1",781747,827954,46207
"517","ENSACAG00000000655","GL343386.1",308997,315411,6414
"518","ENSACAG00000000656","GL343744.1",736,72722,71986
"519","ENSACAG00000000657","GL343560.1",81676,99989,18313
"520","ENSACAG00000000660","GL343194.1",10028597,10029778,1181
"521","ENSACAG00000000662","GL344014.1",94633,103865,9232
"522","ENSACAG00000000663","1",126980784,127123060,142276
"523","ENSACAG00000000664","1",129363630,129387076,23446
"524","ENSACAG00000000665","3",30571592,30587392,15800
"525","ENSACAG00000000666","1",235500964,235518319,17355
"526","ENSACAG00000000667","1",236544018,236562923,18905
"527","ENSACAG00000000669","GL343225.1",785102,821567,36465
"528","ENSACAG00000000671","2",73448897,73486848,37951
"529","ENSACAG00000000673","1",31494298,31664925,170627
"530","ENSACAG00000000676","GL343815.1",10724,26317,15593
"531","ENSACAG00000000677","4",83036929,83071407,34478
"532","ENSACAG00000000678","GL344203.1",40243,46894,6651
"533","ENSACAG00000000680","GL343225.1",878069,897333,19264
"534","ENSACAG00000000682","GL343563.1",121122,150712,29590
"535","ENSACAG00000000683","GL343815.1",147,7567,7420
"536","ENSACAG00000000684","GL343317.1",3882,17326,13444
"537","ENSACAG00000000685","GL344366.1",1045,16800,15755
"538","ENSACAG00000000686","6",11025410,11524167,498757
"539","ENSACAG00000000687","1",30358817,30426151,67334
"540","ENSACAG00000000688","GL343391.1",246038,283384,37346
"541","ENSACAG00000000689","3",106410994,106444972,33978
"542","ENSACAG00000000690","GL343735.1",137908,178846,40938
"543","ENSACAG00000000693","GL343635.1",305970,316559,10589
"544","ENSACAG00000000694","GL343292.1",1435787,1449574,13787
"545","ENSACAG00000000695","GL343311.1",481028,506700,25672
"546","ENSACAG00000000696","GL343555.1",393389,405559,12170
"547","ENSACAG00000000697","GL343811.1",83304,83609,305
"548","ENSACAG00000000698","GL343991.1",395,29882,29487
"549","ENSACAG00000000699","GL343444.1",119277,121482,2205
"550","ENSACAG00000000701","GL343811.1",143836,158374,14538
"551","ENSACAG00000000702","GL343578.1",350461,351312,851
"552","ENSACAG00000000703","GL343578.1",367692,382667,14975
"553","ENSACAG00000000704","GL343889.1",105848,119769,13921
"554","ENSACAG00000000705","GL343858.1",24938,41509,16571
"555","ENSACAG00000000706","GL343214.1",2614242,2759471,145229
"556","ENSACAG00000000707","GL343539.1",448629,458888,10259
"557","ENSACAG00000000711","GL344155.1",8718,60087,51369
"558","ENSACAG00000000712","6",38147455,38193009,45554
"559","ENSACAG00000000713","2",134725266,134802139,76873
"560","ENSACAG00000000714","GL343214.1",1891414,1966746,75332
"561","ENSACAG00000000715","AAWZ02040100",2561,4951,2390
"562","ENSACAG00000000716","LGb",3261512,3267944,6432
"563","ENSACAG00000000717","1",45373842,45401947,28105
"564","ENSACAG00000000718","GL343225.1",1214917,1360942,146025
"565","ENSACAG00000000719","3",70733357,70767463,34106
"566","ENSACAG00000000720","GL343388.1",38988,41911,2923
"567","ENSACAG00000000721","GL345102.1",1155,9901,8746
"568","ENSACAG00000000723","GL344031.1",20183,33510,13327
"569","ENSACAG00000000724","GL343478.1",68858,136570,67712
"570","ENSACAG00000000725","1",236613088,236614089,1001
"571","ENSACAG00000000726","GL343385.1",640741,651451,10710
"572","ENSACAG00000000727","GL343555.1",410633,415811,5178
"573","ENSACAG00000000728","1",220937628,220940399,2771
"574","ENSACAG00000000729","4",68576835,68605372,28537
"575","ENSACAG00000000730","GL344132.1",26341,64332,37991
"576","ENSACAG00000000731","1",220845891,220864879,18988
"577","ENSACAG00000000732","1",236627428,236655091,27663
"578","ENSACAG00000000733","GL343386.1",397350,421716,24366
"579","ENSACAG00000000734","GL343250.1",1282206,1310372,28166
"580","ENSACAG00000000735","3",118552710,118578176,25466
"581","ENSACAG00000000736","GL343444.1",144814,174181,29367
"582","ENSACAG00000000737","GL343388.1",52514,80863,28349
"583","ENSACAG00000000738","AAWZ02037766",6980,14374,7394
"584","ENSACAG00000000739","3",30562834,30571520,8686
"585","ENSACAG00000000740","GL344366.1",38485,40993,2508
"586","ENSACAG00000000741","5",74113190,74219756,106566
"587","ENSACAG00000000744","1",222126223,222132156,5933
"588","ENSACAG00000000745","GL343367.1",1021309,1055035,33726
"589","ENSACAG00000000746","GL343928.1",28683,58135,29452
"590","ENSACAG00000000747","5",67509051,67556027,46976
"591","ENSACAG00000000748","4",15088301,15089353,1052
"592","ENSACAG00000000749","4",14931279,15001838,70559
"593","ENSACAG00000000750","GL343765.1",209941,216295,6354
"594","ENSACAG00000000751","GL343325.1",829340,853209,23869
"595","ENSACAG00000000752","GL343773.1",34345,58254,23909
"596","ENSACAG00000000754","GL343282.1",1536457,1590819,54362
"597","ENSACAG00000000755","1",227547842,227602381,54539
"598","ENSACAG00000000756","GL343282.1",1495441,1512260,16819
"599","ENSACAG00000000757","GL343560.1",54509,80726,26217
"600","ENSACAG00000000758","GL343555.1",469855,475052,5197
"601","ENSACAG00000000759","1",236661699,236738320,76621
"602","ENSACAG00000000760","GL343246.1",247602,272878,25276
"603","ENSACAG00000000761","GL343325.1",721355,770982,49627
"604","ENSACAG00000000762","1",126934251,126958951,24700
"605","ENSACAG00000000763","2",32192544,32193191,647
"606","ENSACAG00000000765","1",220695251,220837937,142686
"607","ENSACAG00000000766","2",73420138,73430976,10838
"608","ENSACAG00000000767","1",235477978,235481524,3546
"609","ENSACAG00000000768","2",32078575,32126403,47828
"610","ENSACAG00000000769","2",20823673,20889265,65592
"611","ENSACAG00000000771","GL343386.1",404715,407567,2852
"612","ENSACAG00000000772","GL343211.1",2416264,2453455,37191
"613","ENSACAG00000000773","GL343386.1",589164,675639,86475
"614","ENSACAG00000000774","4",68484462,68496676,12214
"615","ENSACAG00000000776","3",30535140,30557980,22840
"616","ENSACAG00000000777","3",118736835,118755722,18887
"617","ENSACAG00000000778","GL343539.1",423522,438387,14865
"618","ENSACAG00000000779","3",15721965,15733029,11064
"619","ENSACAG00000000780","1",235431181,235473606,42425
"620","ENSACAG00000000781","GL343898.1",18599,81386,62787
"621","ENSACAG00000000782","4",83182069,83409908,227839
"622","ENSACAG00000000783","2",73364147,73391810,27663
"623","ENSACAG00000000785","GL343238.1",1237023,1238064,1041
"624","ENSACAG00000000786","GL344849.1",3916,8473,4557
"625","ENSACAG00000000787","GL343635.1",250924,285719,34795
"626","ENSACAG00000000788","2",164416907,164439137,22230
"627","ENSACAG00000000789","GL343232.1",117323,137732,20409
"628","ENSACAG00000000790","1",89060824,89472941,412117
"629","ENSACAG00000000791","GL343238.1",1108141,1120505,12364
"630","ENSACAG00000000792","GL343211.1",2517096,2527708,10612
"631","ENSACAG00000000793","GL343325.1",474795,508304,33509
"632","ENSACAG00000000794","GL343858.1",1483,21538,20055
"633","ENSACAG00000000795","1",96948392,96955260,6868
"634","ENSACAG00000000796","GL344849.1",8238,9493,1255
"635","ENSACAG00000000797","GL343444.1",188033,195151,7118
"636","ENSACAG00000000798","3",70669313,70687542,18229
"637","ENSACAG00000000800","GL344278.1",24639,41258,16619
"638","ENSACAG00000000801","1",48501096,48503006,1910
"639","ENSACAG00000000802","5",51166417,51233838,67421
"640","ENSACAG00000000803","5",67500118,67506771,6653
"641","ENSACAG00000000804","1",96799050,96851196,52146
"642","ENSACAG00000000805","GL343211.1",2744205,2750273,6068
"643","ENSACAG00000000808","2",134648332,134699125,50793
"644","ENSACAG00000000810","GL343367.1",1061231,1076263,15032
"645","ENSACAG00000000811","3",52414588,52470363,55775
"646","ENSACAG00000000812","GL343491.1",399288,479888,80600
"647","ENSACAG00000000813","GL343592.1",3063,48441,45378
"648","ENSACAG00000000815","GL343223.1",1603442,1633447,30005
"649","ENSACAG00000000816","GL343889.1",62335,97855,35520
"650","ENSACAG00000000818","5",90152592,90172728,20136
"651","ENSACAG00000000820","4",68480488,68589301,108813
"652","ENSACAG00000000821","4",68268413,68333118,64705
"653","ENSACAG00000000822","1",222148132,222174973,26841
"654","ENSACAG00000000824","1",126816950,126830584,13634
"655","ENSACAG00000000825","3",88476851,88594866,118015
"656","ENSACAG00000000826","GL344145.1",34051,57069,23018
"657","ENSACAG00000000827","3",118784438,118785571,1133
"658","ENSACAG00000000828","3",118795205,118907180,111975
"659","ENSACAG00000000829","AAWZ02038517",1562,11132,9570
"660","ENSACAG00000000830","1",252870449,252921985,51536
"661","ENSACAG00000000831","3",15508198,15661079,152881
"662","ENSACAG00000000833","GL343325.1",389582,403791,14209
"663","ENSACAG00000000835","GL344046.1",99700,107492,7792
"664","ENSACAG00000000836","1",222205572,222213068,7496
"665","ENSACAG00000000837","GL343773.1",58438,81120,22682
"666","ENSACAG00000000839","1",129353214,129360482,7268
"667","ENSACAG00000000840","2",134620854,134641580,20726
"668","ENSACAG00000000842","AAWZ02039178",2232,9123,6891
"669","ENSACAG00000000843","GL343250.1",1330131,1338692,8561
"670","ENSACAG00000000845","6",38166407,38167474,1067
"671","ENSACAG00000000846","AAWZ02039797",2571,4088,1517
"672","ENSACAG00000000847","3",63123664,63176243,52579
"673","ENSACAG00000000848","GL343475.1",535295,552382,17087
"674","ENSACAG00000000850","6",38044936,38152973,108037
"675","ENSACAG00000000851","5",67475739,67490053,14314
"676","ENSACAG00000000853","6",35556271,35600427,44156
"677","ENSACAG00000000854","GL343367.1",1116876,1133294,16418
"678","ENSACAG00000000855","1",45349157,45368928,19771
"679","ENSACAG00000000856","1",126748971,126775178,26207
"680","ENSACAG00000000857","4",70252824,70351783,98959
"681","ENSACAG00000000858","GL343223.1",1465840,1531972,66132
"682","ENSACAG00000000859","AAWZ02037887",265,13754,13489
"683","ENSACAG00000000860","GL343232.1",32338,90502,58164
"684","ENSACAG00000000861","GL343396.1",832456,841218,8762
"685","ENSACAG00000000862","3",52263960,52403218,139258
"686","ENSACAG00000000864","3",106551562,106661947,110385
"687","ENSACAG00000000866","GL343295.1",996863,1099067,102204
"688","ENSACAG00000000867","1",126740007,126745627,5620
"689","ENSACAG00000000868","GL343769.1",50126,66055,15929
"690","ENSACAG00000000869","GL344418.1",29748,35981,6233
"691","ENSACAG00000000870","1",129332701,129343404,10703
"692","ENSACAG00000000871","1",126710206,126729839,19633
"693","ENSACAG00000000872","3",166700230,166879358,179128
"694","ENSACAG00000000874","GL343987.1",113184,127496,14312
"695","ENSACAG00000000875","GL343635.1",211685,218143,6458
"696","ENSACAG00000000876","3",30506145,30534583,28438
"697","ENSACAG00000000877","6",35510210,35549421,39211
"698","ENSACAG00000000878","GL343311.1",566764,578510,11746
"699","ENSACAG00000000879","GL343311.1",595295,637065,41770
"700","ENSACAG00000000880","GL343311.1",683935,700765,16830
"701","ENSACAG00000000882","GL343444.1",233145,281061,47916
"702","ENSACAG00000000883","LGc",6949793,7121366,171573
"703","ENSACAG00000000884","AAWZ02036001",1511,32971,31460
"704","ENSACAG00000000885","GL343238.1",1050093,1075559,25466
"705","ENSACAG00000000886","3",63048317,63062318,14001
"706","ENSACAG00000000888","GL343238.1",1036809,1043213,6404
"707","ENSACAG00000000889","GL343812.1",41531,127435,85904
"708","ENSACAG00000000891","GL343352.1",543025,804036,261011
"709","ENSACAG00000000892","GL343282.1",1475340,1493735,18395
"710","ENSACAG00000000893","GL343225.1",1432913,1489358,56445
"711","ENSACAG00000000895","AAWZ02039126",21,5326,5305
"712","ENSACAG00000000896","1",222220581,222266251,45670
"713","ENSACAG00000000897","3",70640277,70663330,23053
"714","ENSACAG00000000899","2",73188592,73348674,160082
"715","ENSACAG00000000900","5",90073784,90138591,64807
"716","ENSACAG00000000902","GL343528.1",280997,282052,1055
"717","ENSACAG00000000904","GL343386.1",730280,750058,19778
"718","ENSACAG00000000905","GL343464.1",630926,647703,16777
"719","ENSACAG00000000907","3",51936862,52141475,204613
"720","ENSACAG00000000908","GL344031.1",42208,55425,13217
"721","ENSACAG00000000910","GL343528.1",256781,262483,5702
"722","ENSACAG00000000911","GL343463.1",583408,651541,68133
"723","ENSACAG00000000912","GL343528.1",217881,218900,1019
"724","ENSACAG00000000914","GL343396.1",840504,846748,6244
"725","ENSACAG00000000915","2",31881526,31882914,1388
"726","ENSACAG00000000916","2",49095337,49123764,28427
"727","ENSACAG00000000917","GL343559.1",44537,200091,155554
"728","ENSACAG00000000919","3",30473391,30501947,28556
"729","ENSACAG00000000920","3",63020683,63048907,28224
"730","ENSACAG00000000921","GL343200.1",4570689,4621309,50620
"731","ENSACAG00000000922","2",31662494,31753920,91426
"732","ENSACAG00000000923","GL343214.1",1750932,1871184,120252
"733","ENSACAG00000000927","GL344643.1",14658,24498,9840
"734","ENSACAG00000000928","6",64898861,64931375,32514
"735","ENSACAG00000000930","GL343238.1",1007693,1034895,27202
"736","ENSACAG00000000931","2",49140661,49208389,67728
"737","ENSACAG00000000932","GL343819.1",22623,46166,23543
"738","ENSACAG00000000933","GL343940.1",96075,98567,2492
"739","ENSACAG00000000936","GL343451.1",583844,615148,31304
"740","ENSACAG00000000937","GL343913.1",4282,29807,25525
"741","ENSACAG00000000939","GL343635.1",201004,212202,11198
"742","ENSACAG00000000940","GL343563.1",93505,116287,22782
"743","ENSACAG00000000941","4",52504007,52674669,170662
"744","ENSACAG00000000942","GL343940.1",86357,94655,8298
"745","ENSACAG00000000943","GL343210.1",1541842,1737959,196117
"746","ENSACAG00000000944","AAWZ02036756",21,13081,13060
"747","ENSACAG00000000945","GL343491.1",539510,548009,8499
"748","ENSACAG00000000946","2",49222566,49289587,67021
"749","ENSACAG00000000947","6",10823012,10846853,23841
"750","ENSACAG00000000948","3",86178234,86229017,50783
"751","ENSACAG00000000949","3",88396564,88432768,36204
"752","ENSACAG00000000951","5",67443886,67460292,16406
"753","ENSACAG00000000952","GL343528.1",171825,191098,19273
"754","ENSACAG00000000953","6",35488243,35499218,10975
"755","ENSACAG00000000954","3",86073088,86099100,26012
"756","ENSACAG00000000955","4",70392296,70481159,88863
"757","ENSACAG00000000956","1",143807654,143822327,14673
"758","ENSACAG00000000957","GL343563.1",65963,75014,9051
"759","ENSACAG00000000958","GL343310.1",386573,387550,977
"760","ENSACAG00000000959","5",90032611,90053947,21336
"761","ENSACAG00000000960","GL343769.1",71314,177758,106444
"762","ENSACAG00000000961","GL343578.1",405283,405513,230
"763","ENSACAG00000000963","1",129279990,129329948,49958
"764","ENSACAG00000000965","1",129148805,129218466,69661
"765","ENSACAG00000000966","GL343214.1",1667766,1696068,28302
"766","ENSACAG00000000967","GL343396.1",850841,857254,6413
"767","ENSACAG00000000969","3",85976104,86043636,67532
"768","ENSACAG00000000970","GL343812.1",183231,201709,18478
"769","ENSACAG00000000971","3",30415056,30445338,30282
"770","ENSACAG00000000972","GL343928.1",67128,76309,9181
"771","ENSACAG00000000973","1",235399566,235422186,22620
"772","ENSACAG00000000974","4",68195935,68231917,35982
"773","ENSACAG00000000975","1",220625817,220682809,56992
"774","ENSACAG00000000976","GL343940.1",67071,68189,1118
"775","ENSACAG00000000977","2",164375606,164409228,33622
"776","ENSACAG00000000978","2",42153883,42342079,188196
"777","ENSACAG00000000979","5",67388938,67431696,42758
"778","ENSACAG00000000982","GL343940.1",1810,37592,35782
"779","ENSACAG00000000983","AAWZ02039032",481,9487,9006
"780","ENSACAG00000000984","3",70585896,70631160,45264
"781","ENSACAG00000000985","1",204367598,204372397,4799
"782","ENSACAG00000000986","GL343497.1",81367,123349,41982
"783","ENSACAG00000000987","GL343310.1",471964,518687,46723
"784","ENSACAG00000000988","6",35451519,35487400,35881
"785","ENSACAG00000000989","GL343773.1",80258,87453,7195
"786","ENSACAG00000000991","GL343773.1",102046,111996,9950
"787","ENSACAG00000000992","GL343423.1",5918,9674,3756
"788","ENSACAG00000000993","GL343325.1",382438,387892,5454
"789","ENSACAG00000000994","3",62964122,63010853,46731
"790","ENSACAG00000000996","GL343889.1",38092,55820,17728
"791","ENSACAG00000000998","3",186664834,186669416,4582
"792","ENSACAG00000000999","1",126676459,126687907,11448
"793","ENSACAG00000001000","GL343195.1",9000408,9001133,725
"794","ENSACAG00000001002","GL343304.1",1645444,1646451,1007
"795","ENSACAG00000001003","GL343391.1",75572,141745,66173
"796","ENSACAG00000001004","3",51850792,51885141,34349
"797","ENSACAG00000001005","GL343928.1",105389,113090,7701
"798","ENSACAG00000001006","GL343304.1",1620176,1635356,15180
"799","ENSACAG00000001008","5",74802518,74880292,77774
"800","ENSACAG00000001010","AAWZ02037486",1724,3019,1295
"801","ENSACAG00000001012","GL343559.1",230975,247221,16246
"802","ENSACAG00000001014","GL343939.1",21,31399,31378
"803","ENSACAG00000001015","GL343770.1",32022,36559,4537
"804","ENSACAG00000001016","2",20639198,20642735,3537
"805","ENSACAG00000001017","AAWZ02039830",21,7725,7704
"806","ENSACAG00000001018","GL343391.1",21,66632,66611
"807","ENSACAG00000001019","AAWZ02039539",2431,8061,5630
"808","ENSACAG00000001020","GL343632.1",40293,42818,2525
"809","ENSACAG00000001021","GL343210.1",1855641,1873807,18166
"810","ENSACAG00000001023","1",6736997,6737721,724
"811","ENSACAG00000001024","GL343528.1",60476,72975,12499
"812","ENSACAG00000001025","2",49343176,49355994,12818
"813","ENSACAG00000001027","GL343563.1",28599,64301,35702
"814","ENSACAG00000001028","GL343932.1",26189,108010,81821
"815","ENSACAG00000001030","3",202336721,202337560,839
"816","ENSACAG00000001031","3",186344935,186396636,51701
"817","ENSACAG00000001032","3",202250656,202296352,45696
"818","ENSACAG00000001033","GL343932.1",6808,15650,8842
"819","ENSACAG00000001034","GL343311.1",703856,715609,11753
"820","ENSACAG00000001035","GL343491.1",548926,564630,15704
"821","ENSACAG00000001036","GL343230.1",1670703,1673120,2417
"822","ENSACAG00000001037","GL343396.1",860256,887631,27375
"823","ENSACAG00000001038","GL343214.1",1520472,1611131,90659
"824","ENSACAG00000001039","GL343475.1",579853,603101,23248
"825","ENSACAG00000001040","2",49432429,49545416,112987
"826","ENSACAG00000001042","GL343819.1",51165,66599,15434
"827","ENSACAG00000001044","1",126546387,126637462,91075
"828","ENSACAG00000001046","GL343396.1",889763,902029,12266
"829","ENSACAG00000001047","5",74920573,74976491,55918
"830","ENSACAG00000001048","2",73156986,73177421,20435
"831","ENSACAG00000001049","GL343632.1",96648,321433,224785
"832","ENSACAG00000001050","GL343295.1",964156,978165,14009
"833","ENSACAG00000001051","GL343610.1",164247,164669,422
"834","ENSACAG00000001052","2",31523293,31555342,32049
"835","ENSACAG00000001053","GL343282.1",1463449,1472949,9500
"836","ENSACAG00000001054","4",70532201,70622857,90656
"837","ENSACAG00000001055","GL344643.1",393,11448,11055
"838","ENSACAG00000001056","GL343282.1",1413479,1458704,45225
"839","ENSACAG00000001057","GL344264.1",9655,12841,3186
"840","ENSACAG00000001058","AAWZ02035589",1667,43130,41463
"841","ENSACAG00000001059","GL343610.1",286781,308697,21916
"842","ENSACAG00000001061","GL343610.1",312014,318199,6185
"843","ENSACAG00000001062","GL344557.1",1582,8530,6948
"844","ENSACAG00000001063","GL343385.1",687402,694400,6998
"845","ENSACAG00000001066","1",88981687,88982766,1079
"846","ENSACAG00000001067","1",235374401,235391934,17533
"847","ENSACAG00000001068","GL344557.1",14946,23348,8402
"848","ENSACAG00000001069","GL343757.1",128214,151457,23243
"849","ENSACAG00000001070","GL343472.1",420716,492146,71430
"850","ENSACAG00000001072","1",96763400,96784612,21212
"851","ENSACAG00000001073","GL343539.1",229426,294972,65546
"852","ENSACAG00000001075","6",10702877,10734131,31254
"853","ENSACAG00000001076","1",88971792,88972871,1079
"854","ENSACAG00000001078","GL344421.1",21,16420,16399
"855","ENSACAG00000001080","1",236769289,236852908,83619
"856","ENSACAG00000001081","GL343560.1",1332,11913,10581
"857","ENSACAG00000001082","GL343290.1",383167,429426,46259
"858","ENSACAG00000001083","3",186411969,186449397,37428
"859","ENSACAG00000001084","GL343230.1",1723070,1794374,71304
"860","ENSACAG00000001085","GL343770.1",144839,157783,12944
"861","ENSACAG00000001087","GL343735.1",233241,245329,12088
"862","ENSACAG00000001088","GL343210.1",1882830,1982501,99671
"863","ENSACAG00000001089","1",88909849,88940355,30506
"864","ENSACAG00000001091","GL343518.1",249797,278332,28535
"865","ENSACAG00000001093","GL343290.1",219300,249259,29959
"866","ENSACAG00000001095","GL344557.1",22778,29258,6480
"867","ENSACAG00000001096","GL343423.1",35272,73204,37932
"868","ENSACAG00000001097","3",202240803,202241881,1078
"869","ENSACAG00000001098","3",202192835,202223799,30964
"870","ENSACAG00000001099","5",89977349,89997444,20095
"871","ENSACAG00000001100","2",73133323,73151914,18591
"872","ENSACAG00000001101","GL343889.1",8918,27314,18396
"873","ENSACAG00000001102","GL343770.1",173297,184456,11159
"874","ENSACAG00000001104","1",30299394,30316697,17303
"875","ENSACAG00000001105","1",220519470,220545443,25973
"876","ENSACAG00000001106","GL343610.1",320872,330964,10092
"877","ENSACAG00000001107","GL344328.1",54350,56844,2494
"878","ENSACAG00000001108","GL343478.1",162065,186972,24907
"879","ENSACAG00000001109","GL343627.1",380397,395822,15425
"880","ENSACAG00000001110","1",129062140,129113179,51039
"881","ENSACAG00000001111","GL343773.1",142574,185909,43335
"882","ENSACAG00000001112","GL343475.1",608107,617576,9469
"883","ENSACAG00000001114","GL343304.1",1473575,1492860,19285
"884","ENSACAG00000001115","GL343994.1",138293,143216,4923
"885","ENSACAG00000001116","GL343396.1",960391,963872,3481
"886","ENSACAG00000001117","GL343385.1",700091,720552,20461
"887","ENSACAG00000001118","GL343250.1",1345008,1355050,10042
"888","ENSACAG00000001119","GL344821.1",1967,14947,12980
"889","ENSACAG00000001121","6",10693323,10695851,2528
"890","ENSACAG00000001123","1",128963336,129011098,47762
"891","ENSACAG00000001124","3",51745064,51747890,2826
"892","ENSACAG00000001125","AAWZ02041905",2712,4700,1988
"893","ENSACAG00000001127","AAWZ02038483",2140,7124,4984
"894","ENSACAG00000001128","GL343528.1",17852,21612,3760
"895","ENSACAG00000001130","1",222273426,222303069,29643
"896","ENSACAG00000001131","GL344170.1",32636,47086,14450
"897","ENSACAG00000001132","GL344328.1",50,29498,29448
"898","ENSACAG00000001133","3",85777804,85779264,1460
"899","ENSACAG00000001134","1",220156091,220359562,203471
"900","ENSACAG00000001135","3",202080465,202106670,26205
"901","ENSACAG00000001137","6",10678703,10680740,2037
"902","ENSACAG00000001138","GL343464.1",679650,701767,22117
"903","ENSACAG00000001139","1",235280987,235341315,60328
"904","ENSACAG00000001140","GL343757.1",168201,185371,17170
"905","ENSACAG00000001141","1",220139311,220140732,1421
"906","ENSACAG00000001142","1",220109561,220138200,28639
"907","ENSACAG00000001143","GL344645.1",3474,24459,20985
"908","ENSACAG00000001144","GL343223.1",1376285,1396802,20517
"909","ENSACAG00000001145","GL343500.1",409845,486466,76621
"910","ENSACAG00000001146","1",245274060,245283362,9302
"911","ENSACAG00000001147","GL343621.1",30863,49843,18980
"912","ENSACAG00000001148","4",52783718,52828842,45124
"913","ENSACAG00000001149","AAWZ02039648",969,5211,4242
"914","ENSACAG00000001150","GL343225.1",1588925,1672311,83386
"915","ENSACAG00000001151","4",95512110,95537378,25268
"916","ENSACAG00000001152","GL343210.1",2021078,2041396,20318
"917","ENSACAG00000001153","GL343770.1",189101,197429,8328
"918","ENSACAG00000001156","1",30267920,30272879,4959
"919","ENSACAG00000001157","1",245297868,245307284,9416
"920","ENSACAG00000001158","GL344031.1",62077,82585,20508
"921","ENSACAG00000001160","1",25699060,25730723,31663
"922","ENSACAG00000001161","4",70661893,70678866,16973
"923","ENSACAG00000001162","4",70717077,70764592,47515
"924","ENSACAG00000001164","GL343295.1",871622,947995,76373
"925","ENSACAG00000001165","GL343463.1",493973,556078,62105
"926","ENSACAG00000001166","6",9648830,9662243,13413
"927","ENSACAG00000001167","AAWZ02041877",2101,4231,2130
"928","ENSACAG00000001169","GL343913.1",70283,71041,758
"929","ENSACAG00000001170","3",70555341,70569559,14218
"930","ENSACAG00000001171","1",88894714,88908510,13796
"931","ENSACAG00000001172","GL343913.1",79476,83133,3657
"932","ENSACAG00000001173","GL343230.1",2051237,2054749,3512
"933","ENSACAG00000001174","GL343223.1",1308345,1339331,30986
"934","ENSACAG00000001175","GL344051.1",49246,74985,25739
"935","ENSACAG00000001176","GL343913.1",90259,121649,31390
"936","ENSACAG00000001178","GL343203.1",2256271,2268823,12552
"937","ENSACAG00000001179","GL343825.1",8626,73329,64703
"938","ENSACAG00000001180","2",164254121,164356861,102740
"939","ENSACAG00000001181","GL343500.1",1814,24177,22363
"940","ENSACAG00000001182","AAWZ02039051",2661,7060,4399
"941","ENSACAG00000001183","1",242486323,242630450,144127
"942","ENSACAG00000001184","GL343252.1",1944408,2004224,59816
"943","ENSACAG00000001185","2",42432646,42492976,60330
"944","ENSACAG00000001186","1",30008532,30040594,32062
"945","ENSACAG00000001187","GL343210.1",2126163,2137004,10841
"946","ENSACAG00000001188","3",70423023,70476728,53705
"947","ENSACAG00000001189","GL343943.1",61895,112859,50964
"948","ENSACAG00000001190","GL343444.1",273262,327180,53918
"949","ENSACAG00000001191","2",49552932,49596012,43080
"950","ENSACAG00000001192","3",30299397,30416008,116611
"951","ENSACAG00000001193","AAWZ02039426",443,4021,3578
"952","ENSACAG00000001194","1",219997126,219998898,1772
"953","ENSACAG00000001195","5",89958488,89968915,10427
"954","ENSACAG00000001196","1",245304092,245371522,67430
"955","ENSACAG00000001199","2",72968514,73099099,130585
"956","ENSACAG00000001200","GL344051.1",74996,83159,8163
"957","ENSACAG00000001203","1",243174239,243181493,7254
"958","ENSACAG00000001205","GL343210.1",2155334,2227278,71944
"959","ENSACAG00000001206","GL343463.1",474408,475316,908
"960","ENSACAG00000001207","GL343559.1",269476,293719,24243
"961","ENSACAG00000001208","5",89915374,89944821,29447
"962","ENSACAG00000001209","3",51710509,51715418,4909
"963","ENSACAG00000001210","4",37903238,37973416,70178
"964","ENSACAG00000001211","GL343463.1",205111,205827,716
"965","ENSACAG00000001213","1",243199238,243257384,58146
"966","ENSACAG00000001214","GL343621.1",54781,74574,19793
"967","ENSACAG00000001215","GL343463.1",81656,92789,11133
"968","ENSACAG00000001216","GL343330.1",648419,649021,602
"969","ENSACAG00000001217","GL343627.1",332775,338137,5362
"970","ENSACAG00000001218","1",126563899,126578403,14504
"971","ENSACAG00000001219","3",119078938,119346275,267337
"972","ENSACAG00000001220","4",70772959,70779980,7021
"973","ENSACAG00000001221","4",53002745,53036169,33424
"974","ENSACAG00000001222","3",51634396,51643382,8986
"975","ENSACAG00000001223","GL343330.1",665914,680415,14501
"976","ENSACAG00000001224","GL343282.1",1353936,1411983,58047
"977","ENSACAG00000001225","GL343737.1",200968,210800,9832
"978","ENSACAG00000001226","GL343528.1",7883,11758,3875
"979","ENSACAG00000001227","GL343939.1",35000,39529,4529
"980","ENSACAG00000001228","GL343769.1",191793,198032,6239
"981","ENSACAG00000001229","GL343518.1",278393,296377,17984
"982","ENSACAG00000001230","6",59634418,59648790,14372
"983","ENSACAG00000001231","GL343610.1",333467,333838,371
"984","ENSACAG00000001232","3",62947470,62966804,19334
"985","ENSACAG00000001233","GL343939.1",65643,80768,15125
"986","ENSACAG00000001234","1",236865350,236871876,6526
"987","ENSACAG00000001235","1",204285991,204337055,51064
"988","ENSACAG00000001236","AAWZ02035993",2264,26696,24432
"989","ENSACAG00000001237","1",222315969,222329619,13650
"990","ENSACAG00000001238","4",95733139,95766411,33272
"991","ENSACAG00000001239","GL343225.1",1845206,1868058,22852
"992","ENSACAG00000001240","GL343610.1",336769,354952,18183
"993","ENSACAG00000001241","AAWZ02040481",991,6819,5828
"994","ENSACAG00000001243","GL343769.1",203791,214178,10387
"995","ENSACAG00000001244","3",51523594,51627015,103421
"996","ENSACAG00000001245","4",70967973,71014839,46866
"997","ENSACAG00000001246","2",72951592,72957074,5482
"998","ENSACAG00000001250","4",71034684,71063536,28852
"999","ENSACAG00000001251","GL344351.1",8818,12530,3712
"1000","ENSACAG00000001252","2",49611370,49666501,55131
"1001","ENSACAG00000001253","1",219633068,219648526,15458
"1002","ENSACAG00000001255","GL343223.1",1068761,1069447,686
"1003","ENSACAG00000001256","1",25570112,25581834,11722
"1004","ENSACAG00000001257","2",49715216,49724074,8858
"1005","ENSACAG00000001258","GL343939.1",91146,91814,668
"1006","ENSACAG00000001260","1",182418768,182444958,26190
"1007","ENSACAG00000001261","4",68147845,68189376,41531
"1008","ENSACAG00000001262","GL343737.1",135539,186017,50478
"1009","ENSACAG00000001263","GL343463.1",71961,79049,7088
"1010","ENSACAG00000001264","GL343939.1",104795,120788,15993
"1011","ENSACAG00000001265","GL343491.1",565933,571400,5467
"1012","ENSACAG00000001266","GL343238.1",976214,1002556,26342
"1013","ENSACAG00000001267","GL343588.1",147296,147856,560
"1014","ENSACAG00000001268","GL343201.1",706165,712490,6325
"1015","ENSACAG00000001269","GL343223.1",861339,919095,57756
"1016","ENSACAG00000001270","4",53039814,53113689,73875
"1017","ENSACAG00000001271","GL343819.1",143855,169760,25905
"1018","ENSACAG00000001272","GL343222.1",2279668,2338394,58726
"1019","ENSACAG00000001274","GL343201.1",690964,699524,8560
"1020","ENSACAG00000001276","GL343472.1",641662,661668,20006
"1021","ENSACAG00000001279","5",75539776,75585589,45813
"1022","ENSACAG00000001281","2",49733806,49838777,104971
"1023","ENSACAG00000001282","1",88879732,88894615,14883
"1024","ENSACAG00000001283","AAWZ02039681",126,8086,7960
"1025","ENSACAG00000001285","1",222338190,222366674,28484
"1026","ENSACAG00000001286","5",66910729,66928069,17340
"1027","ENSACAG00000001287","GL343491.1",578665,596982,18317
"1028","ENSACAG00000001288","4",95807080,95812025,4945
"1029","ENSACAG00000001289","1",219569474,219629761,60287
"1030","ENSACAG00000001290","GL343757.1",191971,207622,15651
"1031","ENSACAG00000001291","2",72772605,72806632,34027
"1032","ENSACAG00000001292","1",236886951,236904674,17723
"1033","ENSACAG00000001293","GL343222.1",2353673,2358082,4409
"1034","ENSACAG00000001294","5",75585434,75603804,18370
"1035","ENSACAG00000001296","GL343478.1",190241,216027,25786
"1036","ENSACAG00000001297","GL343225.1",1941305,2006190,64885
"1037","ENSACAG00000001298","GL343295.1",805868,816267,10399
"1038","ENSACAG00000001299","4",95849642,95876842,27200
"1039","ENSACAG00000001300","5",112144573,112182752,38179
"1040","ENSACAG00000001301","5",66751848,66836474,84626
"1041","ENSACAG00000001302","4",37884322,37900360,16038
"1042","ENSACAG00000001304","5",75616186,75737578,121392
"1043","ENSACAG00000001306","1",148381388,148402159,20771
"1044","ENSACAG00000001307","GL343225.1",2098395,2147128,48733
"1045","ENSACAG00000001310","4",53139228,53147065,7837
"1046","ENSACAG00000001313","GL343334.1",803479,820296,16817
"1047","ENSACAG00000001314","AAWZ02038110",363,12630,12267
"1048","ENSACAG00000001318","GL343222.1",2451196,2480763,29567
"1049","ENSACAG00000001319","GL343385.1",737243,747004,9761
"1050","ENSACAG00000001320","4",53180000,53192293,12293
"1051","ENSACAG00000001323","4",53193647,53204665,11018
"1052","ENSACAG00000001324","1",25315006,25494906,179900
"1053","ENSACAG00000001325","AAWZ02036615",20249,21304,1055
"1054","ENSACAG00000001327","4",37775718,37881994,106276
"1055","ENSACAG00000001328","GL343737.1",30207,112534,82327
"1056","ENSACAG00000001329","GL343222.1",2599378,2624708,25330
"1057","ENSACAG00000001330","GL343330.1",682510,720932,38422
"1058","ENSACAG00000001331","GL343245.1",513928,517306,3378
"1059","ENSACAG00000001332","GL343295.1",792613,801049,8436
"1060","ENSACAG00000001333","GL343423.1",75273,176631,101358
"1061","ENSACAG00000001334","6",37933056,37968777,35721
"1062","ENSACAG00000001335","GL343627.1",322866,323393,527
"1063","ENSACAG00000001336","4",71076272,71132549,56277
"1064","ENSACAG00000001337","1",126524250,126530358,6108
"1065","ENSACAG00000001338","GL343825.1",73686,84937,11251
"1066","ENSACAG00000001339","AAWZ02039455",2395,8359,5964
"1067","ENSACAG00000001340","GL343245.1",427907,432750,4843
"1068","ENSACAG00000001341","3",146650466,146657416,6950
"1069","ENSACAG00000001342","GL343201.1",673630,690108,16478
"1070","ENSACAG00000001343","3",186481958,186494838,12880
"1071","ENSACAG00000001344","1",245388446,245518415,129969
"1072","ENSACAG00000001346","3",146617518,146648944,31426
"1073","ENSACAG00000001347","GL343478.1",254311,285098,30787
"1074","ENSACAG00000001348","3",51363684,51493625,129941
"1075","ENSACAG00000001349","1",88840077,88851470,11393
"1076","ENSACAG00000001350","GL343245.1",345655,417164,71509
"1077","ENSACAG00000001351","GL343463.1",56526,65252,8726
"1078","ENSACAG00000001352","5",65516837,65847249,330412
"1079","ENSACAG00000001353","AAWZ02038905",5294,8906,3612
"1080","ENSACAG00000001354","GL343463.1",19739,46391,26652
"1081","ENSACAG00000001355","GL343627.1",237623,275388,37765
"1082","ENSACAG00000001356","1",148417544,148444228,26684
"1083","ENSACAG00000001358","GL343295.1",766661,774581,7920
"1084","ENSACAG00000001359","4",53239292,53245855,6563
"1085","ENSACAG00000001360","3",106757007,106777810,20803
"1086","ENSACAG00000001361","GL343467.1",770295,777471,7176
"1087","ENSACAG00000001362","4",95880146,95907992,27846
"1088","ENSACAG00000001363","1",182399345,182412659,13314
"1089","ENSACAG00000001364","5",89882946,89910422,27476
"1090","ENSACAG00000001365","GL344017.1",52985,72848,19863
"1091","ENSACAG00000001366","GL344302.1",3624,47092,43468
"1092","ENSACAG00000001367","3",119453243,119495627,42384
"1093","ENSACAG00000001368","3",186529916,186641525,111609
"1094","ENSACAG00000001369","GL343295.1",711685,758501,46816
"1095","ENSACAG00000001370","GL343260.1",380055,398494,18439
"1096","ENSACAG00000001371","1",235262830,235276544,13714
"1097","ENSACAG00000001373","GL343203.1",2379564,2388905,9341
"1098","ENSACAG00000001375","4",53252733,53255248,2515
"1099","ENSACAG00000001376","GL343201.1",538281,619234,80953
"1100","ENSACAG00000001377","1",222556365,222633913,77548
"1101","ENSACAG00000001378","GL343349.1",81987,160634,78647
"1102","ENSACAG00000001379","GL343913.1",125073,126928,1855
"1103","ENSACAG00000001380","GL343223.1",498574,508364,9790
"1104","ENSACAG00000001381","GL344002.1",33879,42216,8337
"1105","ENSACAG00000001382","GL343825.1",104184,113883,9699
"1106","ENSACAG00000001384","4",94142008,94336924,194916
"1107","ENSACAG00000001386","GL343223.1",403265,433458,30193
"1108","ENSACAG00000001387","GL343913.1",137250,145095,7845
"1109","ENSACAG00000001388","GL344002.1",42287,46452,4165
"1110","ENSACAG00000001389","2",31445365,31452735,7370
"1111","ENSACAG00000001390","3",202046778,202074559,27781
"1112","ENSACAG00000001391","1",24880477,25010151,129674
"1113","ENSACAG00000001393","GL343260.1",424520,768709,344189
"1114","ENSACAG00000001394","1",204215009,204270725,55716
"1115","ENSACAG00000001395","4",53266469,53343515,77046
"1116","ENSACAG00000001396","2",117235167,117323370,88203
"1117","ENSACAG00000001397","GL343282.1",1339479,1348162,8683
"1118","ENSACAG00000001398","GL345105.1",1116,14092,12976
"1119","ENSACAG00000001399","GL343203.1",2407266,2432150,24884
"1120","ENSACAG00000001400","GL343223.1",354520,393394,38874
"1121","ENSACAG00000001401","1",236968894,237084075,115181
"1122","ENSACAG00000001402","GL343282.1",1294534,1309924,15390
"1123","ENSACAG00000001403","4",71136636,71174852,38216
"1124","ENSACAG00000001404","AAWZ02037346",4648,17157,12509
"1125","ENSACAG00000001405","2",176790205,176885366,95161
"1126","ENSACAG00000001406","GL344795.1",1957,8636,6679
"1127","ENSACAG00000001407","6",37520578,37801260,280682
"1128","ENSACAG00000001408","3",30289791,30298714,8923
"1129","ENSACAG00000001410","2",49911652,49971753,60101
"1130","ENSACAG00000001411","1",235235872,235262960,27088
"1131","ENSACAG00000001412","GL343478.1",302000,331213,29213
"1132","ENSACAG00000001414","GL343702.1",32720,43846,11126
"1133","ENSACAG00000001415","GL343208.1",626401,627504,1103
"1134","ENSACAG00000001416","3",119510999,119534859,23860
"1135","ENSACAG00000001417","4",95914332,95988033,73701
"1136","ENSACAG00000001418","3",186821149,186905122,83973
"1137","ENSACAG00000001420","2",31309064,31315144,6080
"1138","ENSACAG00000001421","GL343500.1",60011,65863,5852
"1139","ENSACAG00000001422","3",85426961,85531511,104550
"1140","ENSACAG00000001423","GL343208.1",641423,652683,11260
"1141","ENSACAG00000001424","2",31298076,31306256,8180
"1142","ENSACAG00000001427","GL343223.1",332481,343554,11073
"1143","ENSACAG00000001428","GL343351.1",42092,152595,110503
"1144","ENSACAG00000001430","GL343734.1",66304,70012,3708
"1145","ENSACAG00000001431","5",51390429,51435801,45372
"1146","ENSACAG00000001432","4",53417689,53452613,34924
"1147","ENSACAG00000001433","GL343223.1",315809,316375,566
"1148","ENSACAG00000001436","1",227451580,227492087,40507
"1149","ENSACAG00000001437","GL343223.1",250644,280087,29443
"1150","ENSACAG00000001438","GL343539.1",165078,227497,62419
"1151","ENSACAG00000001439","GL343500.1",378641,395341,16700
"1152","ENSACAG00000001440","GL343518.1",347727,387543,39816
"1153","ENSACAG00000001441","1",237144861,237166244,21383
"1154","ENSACAG00000001442","4",83659320,83659949,629
"1155","ENSACAG00000001444","GL343559.1",336603,364922,28319
"1156","ENSACAG00000001445","GL343451.1",722482,723156,674
"1157","ENSACAG00000001446","1",237255452,237325033,69581
"1158","ENSACAG00000001448","GL343559.1",367876,407360,39484
"1159","ENSACAG00000001449","GL343603.1",217699,300138,82439
"1160","ENSACAG00000001451","5",52079450,52201518,122068
"1161","ENSACAG00000001452","GL343203.1",2433509,2499533,66024
"1162","ENSACAG00000001453","3",15488329,15492744,4415
"1163","ENSACAG00000001454","2",30769735,30869036,99301
"1164","ENSACAG00000001456","GL343621.1",77126,92542,15416
"1165","ENSACAG00000001457","GL343734.1",92695,105640,12945
"1166","ENSACAG00000001459","1",243259730,243271730,12000
"1167","ENSACAG00000001460","5",37885660,37979490,93830
"1168","ENSACAG00000001461","GL343282.1",1263283,1283441,20158
"1169","ENSACAG00000001462","3",51302552,51316471,13919
"1170","ENSACAG00000001463","1",219508814,219515202,6388
"1171","ENSACAG00000001464","GL343295.1",692209,699057,6848
"1172","ENSACAG00000001468","4",85537665,85554909,17244
"1173","ENSACAG00000001469","3",202038170,202046965,8795
"1174","ENSACAG00000001470","3",51292499,51296439,3940
"1175","ENSACAG00000001471","GL343208.1",652235,677898,25663
"1176","ENSACAG00000001472","GL343238.1",928911,966539,37628
"1177","ENSACAG00000001473","GL343330.1",730006,733620,3614
"1178","ENSACAG00000001474","2",42550953,42552662,1709
"1179","ENSACAG00000001475","GL343385.1",755384,758680,3296
"1180","ENSACAG00000001476","GL343879.1",1612,11940,10328
"1181","ENSACAG00000001479","2",42561266,42575155,13889
"1182","ENSACAG00000001482","GL343330.1",737789,751367,13578
"1183","ENSACAG00000001483","2",30815429,30815788,359
"1184","ENSACAG00000001485","GL343385.1",764731,818871,54140
"1185","ENSACAG00000001486","1",88815165,88834073,18908
"1186","ENSACAG00000001487","GL344150.1",21,23531,23510
"1187","ENSACAG00000001488","3",15398117,15430460,32343
"1188","ENSACAG00000001489","1",219465333,219491754,26421
"1189","ENSACAG00000001491","2",30600349,30740610,140261
"1190","ENSACAG00000001492","5",112192016,112229183,37167
"1191","ENSACAG00000001493","GL344941.1",704,4366,3662
"1192","ENSACAG00000001494","5",65063431,65071582,8151
"1193","ENSACAG00000001495","1",237491289,237757502,266213
"1194","ENSACAG00000001496","3",138500582,138514812,14230
"1195","ENSACAG00000001497","GL343238.1",908975,910584,1609
"1196","ENSACAG00000001499","1",182269043,182277716,8673
"1197","ENSACAG00000001501","GL343238.1",853473,859585,6112
"1198","ENSACAG00000001502","GL343949.1",24401,45944,21543
"1199","ENSACAG00000001503","4",94514181,94540170,25989
"1200","ENSACAG00000001504","4",121068515,121121828,53313
"1201","ENSACAG00000001505","GL344549.1",1287,4552,3265
"1202","ENSACAG00000001506","1",245573738,245722447,148709
"1203","ENSACAG00000001507","GL343238.1",840452,848403,7951
"1204","ENSACAG00000001508","GL343238.1",794348,833525,39177
"1205","ENSACAG00000001509","GL343233.1",1952537,1999131,46594
"1206","ENSACAG00000001510","4",79834745,79875090,40345
"1207","ENSACAG00000001511","1",133379751,133421120,41369
"1208","ENSACAG00000001512","5",65040273,65043275,3002
"1209","ENSACAG00000001513","5",52537213,52620791,83578
"1210","ENSACAG00000001515","3",119678574,119962244,283670
"1211","ENSACAG00000001517","GL343295.1",682555,683450,895
"1212","ENSACAG00000001519","GL343260.1",882505,926506,44001
"1213","ENSACAG00000001520","GL343295.1",663769,669360,5591
"1214","ENSACAG00000001521","GL343879.1",17394,30191,12797
"1215","ENSACAG00000001523","1",222652442,222737100,84658
"1216","ENSACAG00000001524","1",233000774,233161060,160286
"1217","ENSACAG00000001526","AAWZ02036281",17866,24303,6437
"1218","ENSACAG00000001527","GL344941.1",10919,15300,4381
"1219","ENSACAG00000001529","GL343563.1",6059,13383,7324
"1220","ENSACAG00000001530","3",15191770,15221921,30151
"1221","ENSACAG00000001533","4",79727093,79800906,73813
"1222","ENSACAG00000001535","AAWZ02038821",3457,10280,6823
"1223","ENSACAG00000001536","GL344149.1",3,716,713
"1224","ENSACAG00000001537","1",182220320,182259327,39007
"1225","ENSACAG00000001538","1",261620736,261624061,3325
"1226","ENSACAG00000001540","3",106778991,106799339,20348
"1227","ENSACAG00000001541","GL343288.1",260,65405,65145
"1228","ENSACAG00000001542","1",222808584,222824795,16211
"1229","ENSACAG00000001543","1",133480023,133488083,8060
"1230","ENSACAG00000001544","GL344074.1",6380,22912,16532
"1231","ENSACAG00000001545","GL343423.1",188503,208867,20364
"1232","ENSACAG00000001546","GL343511.1",504011,543695,39684
"1233","ENSACAG00000001547","3",15022965,15038123,15158
"1234","ENSACAG00000001548","AAWZ02040813",931,6437,5506
"1235","ENSACAG00000001549","3",51243624,51278300,34676
"1236","ENSACAG00000001550","1",261027766,261244053,216287
"1237","ENSACAG00000001551","GL343282.1",1243229,1261676,18447
"1238","ENSACAG00000001552","GL343518.1",422416,471713,49297
"1239","ENSACAG00000001554","GL343225.1",2235799,2290863,55064
"1240","ENSACAG00000001555","GL344149.1",790,9944,9154
"1241","ENSACAG00000001556","3",30209683,30281114,71431
"1242","ENSACAG00000001557","GL343233.1",2003784,2076025,72241
"1243","ENSACAG00000001558","1",24464037,24487972,23935
"1244","ENSACAG00000001560","3",146603334,146609278,5944
"1245","ENSACAG00000001561","GL343295.1",559300,606145,46845
"1246","ENSACAG00000001562","2",117329994,117343659,13665
"1247","ENSACAG00000001563","GL343574.1",21,16190,16169
"1248","ENSACAG00000001564","1",133496858,133502504,5646
"1249","ENSACAG00000001566","1",243279117,243316004,36887
"1250","ENSACAG00000001567","1",134088085,134145112,57027
"1251","ENSACAG00000001569","GL343879.1",38822,52371,13549
"1252","ENSACAG00000001570","GL343898.1",86623,105232,18609
"1253","ENSACAG00000001571","GL343734.1",104958,117408,12450
"1254","ENSACAG00000001572","5",64420579,64548356,127777
"1255","ENSACAG00000001573","4",121060802,121063115,2313
"1256","ENSACAG00000001574","4",53474043,53649794,175751
"1257","ENSACAG00000001575","1",96693704,96715114,21410
"1258","ENSACAG00000001576","GL343621.1",132131,144509,12378
"1259","ENSACAG00000001578","2",30450647,30463770,13123
"1260","ENSACAG00000001579","AAWZ02040500",707,4081,3374
"1261","ENSACAG00000001580","AAWZ02036546",21,25225,25204
"1262","ENSACAG00000001581","3",146579479,146596315,16836
"1263","ENSACAG00000001582","GL343708.1",195433,221102,25669
"1264","ENSACAG00000001583","1",24178761,24205903,27142
"1265","ENSACAG00000001584","3",119990090,120026928,36838
"1266","ENSACAG00000001585","GL343621.1",158069,223926,65857
"1267","ENSACAG00000001586","2",117345566,117370460,24894
"1268","ENSACAG00000001587","4",68057357,68086836,29479
"1269","ENSACAG00000001588","1",245835035,245836015,980
"1270","ENSACAG00000001589","GL343251.1",313809,335357,21548
"1271","ENSACAG00000001590","GL344123.1",6129,20116,13987
"1272","ENSACAG00000001591","GL343223.1",229984,239848,9864
"1273","ENSACAG00000001592","4",120856305,121046585,190280
"1274","ENSACAG00000001593","5",112251139,112300438,49299
"1275","ENSACAG00000001594","1",246195845,246248865,53020
"1276","ENSACAG00000001595","GL343334.1",837489,897919,60430
"1277","ENSACAG00000001596","6",37466508,37502160,35652
"1278","ENSACAG00000001597","GL344150.1",24156,37648,13492
"1279","ENSACAG00000001599","GL344074.1",22981,30784,7803
"1280","ENSACAG00000001600","1",142896454,142940981,44527
"1281","ENSACAG00000001601","AAWZ02036584",9935,21825,11890
"1282","ENSACAG00000001602","GL344149.1",19203,66337,47134
"1283","ENSACAG00000001604","1",142994191,142994445,254
"1284","ENSACAG00000001605","1",123978277,123990186,11909
"1285","ENSACAG00000001606","GL343518.1",481647,504237,22590
"1286","ENSACAG00000001607","1",143015072,143035319,20247
"1287","ENSACAG00000001608","4",94747357,94775793,28436
"1288","ENSACAG00000001609","GL343334.1",907205,1084936,177731
"1289","ENSACAG00000001610","1",227360161,227368902,8741
"1290","ENSACAG00000001611","GL343334.1",1036941,1044433,7492
"1291","ENSACAG00000001612","1",226686337,226708550,22213
"1292","ENSACAG00000001613","1",143049145,143120224,71079
"1293","ENSACAG00000001614","2",30391793,30446104,54311
"1294","ENSACAG00000001615","1",148447976,148453898,5922
"1295","ENSACAG00000001617","1",88711690,88760810,49120
"1296","ENSACAG00000001618","5",52925846,52936222,10376
"1297","ENSACAG00000001619","1",182203073,182204176,1103
"1298","ENSACAG00000001620","GL343385.1",826888,836376,9488
"1299","ENSACAG00000001621","1",182100662,182156308,55646
"1300","ENSACAG00000001622","GL344123.1",32954,70924,37970
"1301","ENSACAG00000001623","GL343223.1",177015,217799,40784
"1302","ENSACAG00000001625","GL343251.1",391754,427843,36089
"1303","ENSACAG00000001626","GL343260.1",1267284,1346087,78803
"1304","ENSACAG00000001627","3",201507637,201954890,447253
"1305","ENSACAG00000001628","GL343334.1",1171636,1428148,256512
"1306","ENSACAG00000001630","1",204138116,204187628,49512
"1307","ENSACAG00000001631","GL343608.1",422244,430974,8730
"1308","ENSACAG00000001632","GL343608.1",365838,386332,20494
"1309","ENSACAG00000001633","1",219429700,219464071,34371
"1310","ENSACAG00000001635","GL343330.1",782372,807464,25092
"1311","ENSACAG00000001636","5",52935751,52964523,28772
"1312","ENSACAG00000001637","GL343734.1",117977,131209,13232
"1313","ENSACAG00000001638","GL343708.1",158801,194906,36105
"1314","ENSACAG00000001639","GL343925.1",2850,101730,98880
"1315","ENSACAG00000001641","GL343949.1",68211,70358,2147
"1316","ENSACAG00000001642","AAWZ02034921",4101,25073,20972
"1317","ENSACAG00000001643","3",106820503,106823553,3050
"1318","ENSACAG00000001644","GL344150.1",40240,65213,24973
"1319","ENSACAG00000001645","GL344533.1",6801,26008,19207
"1320","ENSACAG00000001646","4",79577553,79711409,133856
"1321","ENSACAG00000001650","GL343539.1",113158,153472,40314
"1322","ENSACAG00000001651","AAWZ02038341",930,8205,7275
"1323","ENSACAG00000001652","GL343423.1",210271,226628,16357
"1324","ENSACAG00000001654","1",124047508,124091704,44196
"1325","ENSACAG00000001655","3",120031300,120038102,6802
"1326","ENSACAG00000001656","GL343478.1",340167,364387,24220
"1327","ENSACAG00000001657","GL343621.1",283559,299117,15558
"1328","ENSACAG00000001658","2",49999445,50023007,23562
"1329","ENSACAG00000001659","3",120366660,120418572,51912
"1330","ENSACAG00000001660","3",106895687,106922147,26460
"1331","ENSACAG00000001662","3",70270166,70387147,116981
"1332","ENSACAG00000001663","4",37738828,37760763,21935
"1333","ENSACAG00000001664","1",151805351,151845842,40491
"1334","ENSACAG00000001666","GL343621.1",322520,339362,16842
"1335","ENSACAG00000001669","GL343385.1",837192,842904,5712
"1336","ENSACAG00000001671","4",97210011,97328163,118152
"1337","ENSACAG00000001672","1",181799207,181799404,197
"1338","ENSACAG00000001675","GL343251.1",450113,471084,20971
"1339","ENSACAG00000001676","1",96595969,96688692,92723
"1340","ENSACAG00000001677","GL343251.1",579657,674487,94830
"1341","ENSACAG00000001678","GL343385.1",845885,847873,1988
"1342","ENSACAG00000001679","2",117409527,117417396,7869
"1343","ENSACAG00000001680","3",120440762,120449319,8557
"1344","ENSACAG00000001682","GL343511.1",208730,492807,284077
"1345","ENSACAG00000001683","3",186905816,186933205,27389
"1346","ENSACAG00000001684","GL343943.1",56582,60682,4100
"1347","ENSACAG00000001685","GL343282.1",1175858,1180757,4899
"1348","ENSACAG00000001686","1",181095279,181096670,1391
"1349","ENSACAG00000001687","GL344359.1",600,41922,41322
"1350","ENSACAG00000001690","1",181137095,181138222,1127
"1351","ENSACAG00000001691","6",37238498,37384842,146344
"1352","ENSACAG00000001693","1",88695617,88707412,11795
"1353","ENSACAG00000001694","1",180856800,180902522,45722
"1354","ENSACAG00000001695","GL344042.1",1833,23302,21469
"1355","ENSACAG00000001696","1",219406963,219416435,9472
"1356","ENSACAG00000001698","2",117453808,117454806,998
"1357","ENSACAG00000001701","1",219274460,219378330,103870
"1358","ENSACAG00000001702","1",180754865,180807908,53043
"1359","ENSACAG00000001703","GL343385.1",868741,887722,18981
"1360","ENSACAG00000001704","5",120682280,120751095,68815
"1361","ENSACAG00000001705","2",117637416,117739729,102313
"1362","ENSACAG00000001706","GL343997.1",12120,13796,1676
"1363","ENSACAG00000001707","GL343282.1",1145954,1155672,9718
"1364","ENSACAG00000001708","GL343621.1",342975,354944,11969
"1365","ENSACAG00000001709","4",97400549,97428800,28251
"1366","ENSACAG00000001710","GL343704.1",2178,32272,30094
"1367","ENSACAG00000001711","2",30114722,30270364,155642
"1368","ENSACAG00000001712","3",120462744,120465232,2488
"1369","ENSACAG00000001713","GL343478.1",364163,382863,18700
"1370","ENSACAG00000001714","1",124150447,124151406,959
"1371","ENSACAG00000001715","GL344060.1",29211,78448,49237
"1372","ENSACAG00000001716","1",88642386,88681557,39171
"1373","ENSACAG00000001717","1",124379453,124418441,38988
"1374","ENSACAG00000001718","GL343608.1",290062,319011,28949
"1375","ENSACAG00000001719","3",120465834,120470547,4713
"1376","ENSACAG00000001720","GL343820.1",21295,34359,13064
"1377","ENSACAG00000001721","2",42582251,42606642,24391
"1378","ENSACAG00000001722","GL343423.1",226934,306190,79256
"1379","ENSACAG00000001723","GL343627.1",174232,197491,23259
"1380","ENSACAG00000001725","3",186936870,186997956,61086
"1381","ENSACAG00000001726","GL343949.1",74516,83300,8784
"1382","ENSACAG00000001727","GL343245.1",301275,331934,30659
"1383","ENSACAG00000001728","GL343210.1",1749472,1750947,1475
"1384","ENSACAG00000001729","GL343295.1",499113,515390,16277
"1385","ENSACAG00000001730","GL344806.1",3456,16716,13260
"1386","ENSACAG00000001731","GL343201.1",419872,490617,70745
"1387","ENSACAG00000001732","5",112305568,112319535,13967
"1388","ENSACAG00000001733","2",164066029,164223893,157864
"1389","ENSACAG00000001734","GL343879.1",52516,75894,23378
"1390","ENSACAG00000001735","2",42609879,42640889,31010
"1391","ENSACAG00000001736","5",53189607,53191163,1556
"1392","ENSACAG00000001737","GL343295.1",474128,489379,15251
"1393","ENSACAG00000001739","3",155004427,155152729,148302
"1394","ENSACAG00000001740","1",222829189,222839682,10493
"1395","ENSACAG00000001741","GL343511.1",153731,179342,25611
"1396","ENSACAG00000001742","5",53305995,53336494,30499
"1397","ENSACAG00000001743","GL343282.1",1138838,1145337,6499
"1398","ENSACAG00000001744","GL343708.1",12272,105003,92731
"1399","ENSACAG00000001745","3",120481124,120523225,42101
"1400","ENSACAG00000001746","1",143127052,143286260,159208
"1401","ENSACAG00000001747","GL343478.1",392496,421272,28776
"1402","ENSACAG00000001748","6",37221307,37362972,141665
"1403","ENSACAG00000001750","GL343820.1",35886,46041,10155
"1404","ENSACAG00000001752","GL343518.1",525477,543048,17571
"1405","ENSACAG00000001754","GL343337.1",595295,628486,33191
"1406","ENSACAG00000001755","GL343311.1",780350,808176,27826
"1407","ENSACAG00000001756","6",37152401,37219505,67104
"1408","ENSACAG00000001757","GL343233.1",2192465,2332987,140522
"1409","ENSACAG00000001758","GL343518.1",546070,552315,6245
"1410","ENSACAG00000001759","1",148474148,148492523,18375
"1411","ENSACAG00000001760","GL343282.1",1075251,1076960,1709
"1412","ENSACAG00000001761","GL343282.1",932623,979832,47209
"1413","ENSACAG00000001762","GL343591.1",336,6352,6016
"1414","ENSACAG00000001764","3",87894431,88146020,251589
"1415","ENSACAG00000001765","GL343987.1",51468,63204,11736
"1416","ENSACAG00000001767","GL343713.1",141888,153746,11858
"1417","ENSACAG00000001768","1",222849579,222886409,36830
"1418","ENSACAG00000001769","1",243317690,243377573,59883
"1419","ENSACAG00000001770","AAWZ02036294",4846,27569,22723
"1420","ENSACAG00000001771","1",228214308,228234917,20609
"1421","ENSACAG00000001772","GL343550.1",2036,12726,10690
"1422","ENSACAG00000001773","AAWZ02039112",4481,7077,2596
"1423","ENSACAG00000001775","GL343820.1",77098,112108,35010
"1424","ENSACAG00000001776","GL343518.1",591666,595843,4177
"1425","ENSACAG00000001777","GL343478.1",445742,449601,3859
"1426","ENSACAG00000001779","GL343478.1",481125,506066,24941
"1427","ENSACAG00000001781","GL343627.1",164911,170249,5338
"1428","ENSACAG00000001783","GL343616.1",126064,185795,59731
"1429","ENSACAG00000001784","3",146563076,146577438,14362
"1430","ENSACAG00000001785","AAWZ02039019",21,7111,7090
"1431","ENSACAG00000001786","GL343333.1",21,54724,54703
"1432","ENSACAG00000001787","1",180738607,180752671,14064
"1433","ENSACAG00000001789","3",30176380,30203750,27370
"1434","ENSACAG00000001791","5",112611439,112730751,119312
"1435","ENSACAG00000001792","1",83055481,83055798,317
"1436","ENSACAG00000001793","GL343704.1",87009,112621,25612
"1437","ENSACAG00000001795","1",82301580,82333102,31522
"1438","ENSACAG00000001796","4",67664325,67815251,150926
"1439","ENSACAG00000001798","1",82191136,82238841,47705
"1440","ENSACAG00000001799","4",37176301,37492311,316010
"1441","ENSACAG00000001800","4",97475496,97501040,25544
"1442","ENSACAG00000001801","GL343330.1",812535,836179,23644
"1443","ENSACAG00000001802","1",243423526,243521999,98473
"1444","ENSACAG00000001803","4",53678268,53725671,47403
"1445","ENSACAG00000001804","GL343608.1",261984,283078,21094
"1446","ENSACAG00000001805","GL343933.1",22775,29544,6769
"1447","ENSACAG00000001806","5",64268774,64319908,51134
"1448","ENSACAG00000001807","GL344346.1",25611,27000,1389
"1449","ENSACAG00000001808","GL343931.1",8805,17383,8578
"1450","ENSACAG00000001810","GL343627.1",144086,162601,18515
"1451","ENSACAG00000001811","AAWZ02038459",648,9596,8948
"1452","ENSACAG00000001813","1",180532647,180559330,26683
"1453","ENSACAG00000001814","GL344927.1",9483,14636,5153
"1454","ENSACAG00000001815","1",245989260,245989454,194
"1455","ENSACAG00000001817","GL343539.1",79562,108340,28778
"1456","ENSACAG00000001819","GL343365.1",96166,112923,16757
"1457","ENSACAG00000001820","1",203957114,204037755,80641
"1458","ENSACAG00000001821","GL343511.1",96590,122943,26353
"1459","ENSACAG00000001823","4",85611860,85635567,23707
"1460","ENSACAG00000001824","GL343203.1",2499722,2541877,42155
"1461","ENSACAG00000001826","GL343251.1",688754,838321,149567
"1462","ENSACAG00000001828","GL344820.1",9856,13454,3598
"1463","ENSACAG00000001829","GL343201.1",1682861,1908280,225419
"1464","ENSACAG00000001830","GL344342.1",38787,53493,14706
"1465","ENSACAG00000001831","3",120526261,120576164,49903
"1466","ENSACAG00000001832","3",85358907,85414968,56061
"1467","ENSACAG00000001833","4",112690969,112698580,7611
"1468","ENSACAG00000001834","4",120831421,120853376,21955
"1469","ENSACAG00000001835","2",42641336,42660506,19170
"1470","ENSACAG00000001836","1",204006023,204008419,2396
"1471","ENSACAG00000001838","AAWZ02036331",468,10480,10012
"1472","ENSACAG00000001840","GL343330.1",861913,876329,14416
"1473","ENSACAG00000001841","GL343385.1",938933,940252,1319
"1474","ENSACAG00000001842","2",163961108,163969734,8626
"1475","ENSACAG00000001843","1",246318330,246392305,73975
"1476","ENSACAG00000001844","GL343295.1",440614,472688,32074
"1477","ENSACAG00000001846","3",106960072,107257547,297475
"1478","ENSACAG00000001848","2",54401943,54406467,4524
"1479","ENSACAG00000001849","GL343385.1",994531,1005868,11337
"1480","ENSACAG00000001850","GL343223.1",143641,170017,26376
"1481","ENSACAG00000001851","GL343365.1",120955,181229,60274
"1482","ENSACAG00000001852","4",67584006,67609063,25057
"1483","ENSACAG00000001853","4",36823528,36856271,32743
"1484","ENSACAG00000001855","AAWZ02039581",21,3665,3644
"1485","ENSACAG00000001856","GL344820.1",17148,20164,3016
"1486","ENSACAG00000001857","GL343201.1",2258117,2311048,52931
"1487","ENSACAG00000001858","1",44582176,44655370,73194
"1488","ENSACAG00000001860","AAWZ02039020",290,9728,9438
"1489","ENSACAG00000001861","GL343511.1",65813,93477,27664
"1490","ENSACAG00000001862","GL343608.1",252402,261955,9553
"1491","ENSACAG00000001863","1",124434117,124458323,24206
"1492","ENSACAG00000001864","GL343203.1",1975187,2077718,102531
"1493","ENSACAG00000001865","1",180399509,180442908,43399
"1494","ENSACAG00000001866","1",124468477,124520284,51807
"1495","ENSACAG00000001869","GL343879.1",85706,98396,12690
"1496","ENSACAG00000001870","4",112617863,112664205,46342
"1497","ENSACAG00000001871","GL343550.1",44269,117133,72864
"1498","ENSACAG00000001873","4",97507032,97528552,21520
"1499","ENSACAG00000001874","2",163775669,163796181,20512
"1500","ENSACAG00000001875","GL343820.1",148826,160773,11947
"1501","ENSACAG00000001877","GL343238.1",687291,784896,97605
"1502","ENSACAG00000001878","GL343439.1",138134,248153,110019
"1503","ENSACAG00000001879","AAWZ02036999",2230,6067,3837
"1504","ENSACAG00000001880","2",42676593,42701741,25148
"1505","ENSACAG00000001881","GL343260.1",1398524,1428679,30155
"1506","ENSACAG00000001882","GL344145.1",44181,48340,4159
"1507","ENSACAG00000001883","1",134170553,134218296,47743
"1508","ENSACAG00000001884","GL343949.1",86010,94140,8130
"1509","ENSACAG00000001885","1",134279725,134296580,16855
"1510","ENSACAG00000001886","GL343608.1",233051,250888,17837
"1511","ENSACAG00000001888","GL343337.1",638741,645205,6464
"1512","ENSACAG00000001889","GL343627.1",23288,141315,118027
"1513","ENSACAG00000001891","GL343423.1",308248,318192,9944
"1514","ENSACAG00000001892","GL343251.1",1009300,1160188,150888
"1515","ENSACAG00000001893","GL344025.1",33022,89798,56776
"1516","ENSACAG00000001894","3",200672168,200678058,5890
"1517","ENSACAG00000001895","GL343704.1",155389,162465,7076
"1518","ENSACAG00000001896","2",54456746,54470009,13263
"1519","ENSACAG00000001897","GL343223.1",198,50748,50550
"1520","ENSACAG00000001898","GL343879.1",100413,116525,16112
"1521","ENSACAG00000001900","GL343938.1",78707,94879,16172
"1522","ENSACAG00000001901","GL343337.1",692241,717691,25450
"1523","ENSACAG00000001902","GL344247.1",861,23524,22663
"1524","ENSACAG00000001904","6",70009033,70047926,38893
"1525","ENSACAG00000001905","GL344197.1",8946,58900,49954
"1526","ENSACAG00000001906","3",200663790,200664341,551
"1527","ENSACAG00000001907","3",187005774,187029164,23390
"1528","ENSACAG00000001908","GL343423.1",318089,330455,12366
"1529","ENSACAG00000001909","3",30132729,30157307,24578
"1530","ENSACAG00000001910","GL343511.1",23715,60261,36546
"1531","ENSACAG00000001911","3",70210795,70237975,27180
"1532","ENSACAG00000001912","GL343704.1",169209,230331,61122
"1533","ENSACAG00000001913","4",67570011,67575697,5686
"1534","ENSACAG00000001914","GL343423.1",333744,352888,19144
"1535","ENSACAG00000001915","GL343478.1",520669,549546,28877
"1536","ENSACAG00000001916","GL343737.1",4186,11884,7698
"1537","ENSACAG00000001917","3",200568403,200655089,86686
"1538","ENSACAG00000001918","1",124520012,124556947,36935
"1539","ENSACAG00000001919","5",64196975,64250837,53862
"1540","ENSACAG00000001920","1",134328517,134351810,23293
"1541","ENSACAG00000001921","2",163718148,163735992,17844
"1542","ENSACAG00000001922","GL343998.1",4633,14350,9717
"1543","ENSACAG00000001923","3",70126679,70153136,26457
"1544","ENSACAG00000001924","2",50038553,50145091,106538
"1545","ENSACAG00000001925","GL343616.1",192489,279536,87047
"1546","ENSACAG00000001926","GL343949.1",98090,104039,5949
"1547","ENSACAG00000001927","GL343986.1",25540,59127,33587
"1548","ENSACAG00000001928","GL343238.1",667038,675712,8674
"1549","ENSACAG00000001929","2",54473219,54524439,51220
"1550","ENSACAG00000001931","GL343879.1",117635,124054,6419
"1551","ENSACAG00000001933","GL344060.1",1419,18431,17012
"1552","ENSACAG00000001934","1",96527049,96588828,61779
"1553","ENSACAG00000001936","1",59350772,59352760,1988
"1554","ENSACAG00000001937","4",53834745,53906466,71721
"1555","ENSACAG00000001938","GL343260.1",1445104,1454505,9401
"1556","ENSACAG00000001939","GL343550.1",125296,143540,18244
"1557","ENSACAG00000001940","4",67536822,67566540,29718
"1558","ENSACAG00000001941","1",243565629,243566042,413
"1559","ENSACAG00000001943","GL343251.1",1193895,1209643,15748
"1560","ENSACAG00000001944","3",85311600,85340479,28879
"1561","ENSACAG00000001945","GL343423.1",356942,372787,15845
"1562","ENSACAG00000001946","1",243573954,243586585,12631
"1563","ENSACAG00000001947","4",120628086,120779710,151624
"1564","ENSACAG00000001948","GL344247.1",24937,28073,3136
"1565","ENSACAG00000001949","3",107313660,107381508,67848
"1566","ENSACAG00000001950","AAWZ02037816",12534,13921,1387
"1567","ENSACAG00000001951","4",112340672,112368289,27617
"1568","ENSACAG00000001954","1",88577991,88614643,36652
"1569","ENSACAG00000001956","GL343251.1",1213445,1357010,143565
"1570","ENSACAG00000001957","GL343550.1",153776,154924,1148
"1571","ENSACAG00000001958","1",44312831,44314233,1402
"1572","ENSACAG00000001960","GL343337.1",729383,745158,15775
"1573","ENSACAG00000001961","5",120425364,120430006,4642
"1574","ENSACAG00000001962","3",30099366,30128193,28827
"1575","ENSACAG00000001965","GL343427.1",685880,727627,41747
"1576","ENSACAG00000001966","1",44280357,44290380,10023
"1577","ENSACAG00000001968","GL343337.1",900298,994845,94547
"1578","ENSACAG00000001969","GL343245.1",1508729,1529577,20848
"1579","ENSACAG00000001970","3",146490255,146529584,39329
"1580","ENSACAG00000001971","GL343777.1",150136,185200,35064
"1581","ENSACAG00000001972","GL343295.1",373987,412709,38722
"1582","ENSACAG00000001973","1",134499053,134528601,29548
"1583","ENSACAG00000001974","3",146438563,146465274,26711
"1584","ENSACAG00000001975","GL344247.1",30071,50738,20667
"1585","ENSACAG00000001976","AAWZ02038818",708,9845,9137
"1586","ENSACAG00000001977","GL344799.1",2324,11031,8707
"1587","ENSACAG00000001978","GL343539.1",63558,80106,16548
"1588","ENSACAG00000001979","5",120389787,120418932,29145
"1589","ENSACAG00000001980","GL343797.1",1526,16473,14947
"1590","ENSACAG00000001981","GL343810.1",28674,66684,38010
"1591","ENSACAG00000001983","AAWZ02041090",21,5502,5481
"1592","ENSACAG00000001984","4",112228896,112249310,20414
"1593","ENSACAG00000001987","3",69904547,69909582,5035
"1594","ENSACAG00000001988","3",120695762,120746445,50683
"1595","ENSACAG00000001990","GL343608.1",225972,229459,3487
"1596","ENSACAG00000001991","GL343201.1",2314313,2340774,26461
"1597","ENSACAG00000001992","5",138090998,138091195,197
"1598","ENSACAG00000001993","1",148497669,148504600,6931
"1599","ENSACAG00000001994","AAWZ02036331",10564,27314,16750
"1600","ENSACAG00000001995","GL343210.1",3288706,3461317,172611
"1601","ENSACAG00000001996","3",85287096,85308869,21773
"1602","ENSACAG00000001998","GL343608.1",213735,225685,11950
"1603","ENSACAG00000001999","GL343810.1",68857,83044,14187
"1604","ENSACAG00000002000","2",42706856,42720988,14132
"1605","ENSACAG00000002001","3",200518994,200553255,34261
"1606","ENSACAG00000002002","AAWZ02039942",3334,6681,3347
"1607","ENSACAG00000002003","GL343260.1",1472254,1479234,6980
"1608","ENSACAG00000002004","1",148510641,148655460,144819
"1609","ENSACAG00000002005","GL343331.1",172844,410042,237198
"1610","ENSACAG00000002006","GL343423.1",373378,376520,3142
"1611","ENSACAG00000002007","GL343797.1",23219,34830,11611
"1612","ENSACAG00000002008","GL343257.1",1986047,2009311,23264
"1613","ENSACAG00000002009","1",124573904,124658401,84497
"1614","ENSACAG00000002010","GL343238.1",646851,651663,4812
"1615","ENSACAG00000002011","2",54527365,54548661,21296
"1616","ENSACAG00000002012","5",76817319,76863247,45928
"1617","ENSACAG00000002013","GL343949.1",108247,116549,8302
"1618","ENSACAG00000002014","GL343986.1",59840,101525,41685
"1619","ENSACAG00000002015","1",246396747,246402078,5331
"1620","ENSACAG00000002017","1",246496866,246505740,8874
"1621","ENSACAG00000002018","AAWZ02040697",150,4760,4610
"1622","ENSACAG00000002019","1",59503918,59518600,14682
"1623","ENSACAG00000002022","3",69815450,69852334,36884
"1624","ENSACAG00000002023","3",30065502,30095550,30048
"1625","ENSACAG00000002025","GL343214.1",1400501,1475843,75342
"1626","ENSACAG00000002026","3",146163160,146416553,253393
"1627","ENSACAG00000002029","4",85651506,85682053,30547
"1628","ENSACAG00000002030","3",69556486,69729279,172793
"1629","ENSACAG00000002031","2",163592191,163687981,95790
"1630","ENSACAG00000002032","2",42809720,42884101,74381
"1631","ENSACAG00000002033","3",87344947,87361956,17009
"1632","ENSACAG00000002034","3",107401006,107453771,52765
"1633","ENSACAG00000002035","3",87307060,87335897,28837
"1634","ENSACAG00000002036","GL343797.1",132681,148676,15995
"1635","ENSACAG00000002037","3",200435288,200515771,80483
"1636","ENSACAG00000002040","4",112195875,112227243,31368
"1637","ENSACAG00000002041","5",64086542,64122204,35662
"1638","ENSACAG00000002042","1",243672632,243682671,10039
"1639","ENSACAG00000002043","GL343238.1",585435,644687,59252
"1640","ENSACAG00000002045","1",82159582,82177456,17874
"1641","ENSACAG00000002046","GL343406.1",813598,838165,24567
"1642","ENSACAG00000002047","5",112753986,112795980,41994
"1643","ENSACAG00000002048","4",79482381,79487448,5067
"1644","ENSACAG00000002049","GL343201.1",2362809,2364569,1760
"1645","ENSACAG00000002050","3",30018147,30086640,68493
"1646","ENSACAG00000002051","4",118566470,118588425,21955
"1647","ENSACAG00000002052","1",44268880,44276055,7175
"1648","ENSACAG00000002053","GL343820.1",155984,166215,10231
"1649","ENSACAG00000002054","GL343201.1",2372213,2387696,15483
"1650","ENSACAG00000002056","4",36730138,36808152,78014
"1651","ENSACAG00000002058","3",85023613,85193849,170236
"1652","ENSACAG00000002059","AAWZ02039698",58,5389,5331
"1653","ENSACAG00000002060","5",53428492,53451153,22661
"1654","ENSACAG00000002061","GL343365.1",501435,510157,8722
"1655","ENSACAG00000002062","1",173710629,173743645,33016
"1656","ENSACAG00000002063","GL343214.1",1332766,1396213,63447
"1657","ENSACAG00000002064","5",76876212,76876769,557
"1658","ENSACAG00000002065","GL343423.1",393055,421796,28741
"1659","ENSACAG00000002066","5",76899520,76934477,34957
"1660","ENSACAG00000002067","GL343203.1",2588388,2828895,240507
"1661","ENSACAG00000002068","AAWZ02040386",638,6669,6031
"1662","ENSACAG00000002071","4",67376341,67469228,92887
"1663","ENSACAG00000002072","1",180348799,180378506,29707
"1664","ENSACAG00000002073","1",96491978,96528350,36372
"1665","ENSACAG00000002074","4",79471202,79475828,4626
"1666","ENSACAG00000002076","4",79463369,79466783,3414
"1667","ENSACAG00000002077","1",246637033,246674308,37275
"1668","ENSACAG00000002078","GL343410.1",578381,579319,938
"1669","ENSACAG00000002080","GL343257.1",1872867,1880497,7630
"1670","ENSACAG00000002081","GL343406.1",837735,853620,15885
"1671","ENSACAG00000002083","1",125268756,125437201,168445
"1672","ENSACAG00000002085","1",44261702,44268046,6344
"1673","ENSACAG00000002086","1",134727050,134815315,88265
"1674","ENSACAG00000002088","GL343366.1",235437,303423,67986
"1675","ENSACAG00000002089","1",219142887,219190876,47989
"1676","ENSACAG00000002090","4",79398811,79457388,58577
"1677","ENSACAG00000002091","3",107454117,107504389,50272
"1678","ENSACAG00000002092","5",120269656,120307473,37817
"1679","ENSACAG00000002093","3",187064008,187095613,31605
"1680","ENSACAG00000002094","1",246677431,246691184,13753
"1681","ENSACAG00000002096","5",112811696,112829413,17717
"1682","ENSACAG00000002097","GL343298.1",502074,683197,181123
"1683","ENSACAG00000002098","GL344413.1",1007,21133,20126
"1684","ENSACAG00000002099","5",82042704,82061825,19121
"1685","ENSACAG00000002100","5",112830267,112854801,24534
"1686","ENSACAG00000002101","GL343810.1",85040,89786,4746
"1687","ENSACAG00000002102","1",244005458,244065052,59594
"1688","ENSACAG00000002103","2",54574067,54588250,14183
"1689","ENSACAG00000002107","GL343306.1",50672,75325,24653
"1690","ENSACAG00000002110","5",112857440,112873724,16284
"1691","ENSACAG00000002113","GL343201.1",2398183,2418508,20325
"1692","ENSACAG00000002114","1",44225426,44261465,36039
"1693","ENSACAG00000002115","1",222906113,222963160,57047
"1694","ENSACAG00000002116","AAWZ02039503",633,7222,6589
"1695","ENSACAG00000002117","1",173642972,173644267,1295
"1696","ENSACAG00000002118","1",59957015,60023650,66635
"1697","ENSACAG00000002119","6",59670350,59711857,41507
"1698","ENSACAG00000002120","GL343245.1",200116,262973,62857
"1699","ENSACAG00000002121","1",173582119,173585828,3709
"1700","ENSACAG00000002122","1",173464719,173535347,70628
"1701","ENSACAG00000002123","GL343257.1",1844453,1870885,26432
"1702","ENSACAG00000002124","GL343797.1",168280,199197,30917
"1703","ENSACAG00000002125","1",246699317,246901752,202435
"1704","ENSACAG00000002126","GL343810.1",92914,98909,5995
"1705","ENSACAG00000002127","4",36669709,36699528,29819
"1706","ENSACAG00000002128","GL344143.1",8279,68272,59993
"1707","ENSACAG00000002129","4",120554045,120621560,67515
"1708","ENSACAG00000002130","1",244356181,244385967,29786
"1709","ENSACAG00000002131","GL343820.1",175326,190348,15022
"1710","ENSACAG00000002132","GL343406.1",889243,890645,1402
"1711","ENSACAG00000002133","AAWZ02039834",684,7659,6975
"1712","ENSACAG00000002137","4",79321156,79383694,62538
"1713","ENSACAG00000002138","GL344305.1",30522,49910,19388
"1714","ENSACAG00000002140","4",79262422,79280185,17763
"1715","ENSACAG00000002142","1",60256746,60278336,21590
"1716","ENSACAG00000002143","GL343365.1",530524,579116,48592
"1717","ENSACAG00000002144","4",118598704,118628063,29359
"1718","ENSACAG00000002145","GL343481.1",2178,5600,3422
"1719","ENSACAG00000002146","3",57870493,57872581,2088
"1720","ENSACAG00000002147","5",82096934,82111405,14471
"1721","ENSACAG00000002149","5",82113534,82159136,45602
"1722","ENSACAG00000002150","4",112170877,112185699,14822
"1723","ENSACAG00000002152","1",60350733,60371354,20621
"1724","ENSACAG00000002154","3",156802493,156803167,674
"1725","ENSACAG00000002155","2",42954126,43001958,47832
"1726","ENSACAG00000002156","3",87085878,87272926,187048
"1727","ENSACAG00000002157","4",61525337,61529112,3775
"1728","ENSACAG00000002158","GL343481.1",18969,40633,21664
"1729","ENSACAG00000002159","4",36445020,36460870,15850
"1730","ENSACAG00000002160","GL343406.1",899252,900013,761
"1731","ENSACAG00000002161","GL343608.1",190835,203095,12260
"1732","ENSACAG00000002162","4",97534009,97558801,24792
"1733","ENSACAG00000002163","GL343201.1",2424526,2454313,29787
"1734","ENSACAG00000002164","GL343313.1",949045,1030195,81150
"1735","ENSACAG00000002165","4",118742803,118768180,25377
"1736","ENSACAG00000002166","AAWZ02036975",990,3625,2635
"1737","ENSACAG00000002168","AAWZ02039288",2225,8807,6582
"1738","ENSACAG00000002169","GL343298.1",701102,709200,8098
"1739","ENSACAG00000002171","1",81186472,81498345,311873
"1740","ENSACAG00000002172","3",156971665,157220917,249252
"1741","ENSACAG00000002175","GL343810.1",105543,134379,28836
"1742","ENSACAG00000002177","GL343210.1",486563,628989,142426
"1743","ENSACAG00000002178","1",60373511,60391520,18009
"1744","ENSACAG00000002180","GL343481.1",48324,78614,30290
"1745","ENSACAG00000002181","1",244390319,244404394,14075
"1746","ENSACAG00000002182","5",64039579,64076520,36941
"1747","ENSACAG00000002183","4",79233652,79248588,14936
"1748","ENSACAG00000002184","1",60436051,60681809,245758
"1749","ENSACAG00000002186","4",78998808,79017253,18445
"1750","ENSACAG00000002188","2",117749525,117771891,22366
"1751","ENSACAG00000002189","3",187129734,187237374,107640
"1752","ENSACAG00000002190","GL343433.1",643859,747908,104049
"1753","ENSACAG00000002192","5",112885345,112904715,19370
"1754","ENSACAG00000002194","4",112161782,112167398,5616
"1755","ENSACAG00000002195","GL343427.1",738666,785974,47308
"1756","ENSACAG00000002197","4",78657817,78742172,84355
"1757","ENSACAG00000002198","AAWZ02037657",124,11366,11242
"1758","ENSACAG00000002199","4",66960338,67364534,404196
"1759","ENSACAG00000002200","GL343423.1",466272,485551,19279
"1760","ENSACAG00000002201","AAWZ02040720",2541,5430,2889
"1761","ENSACAG00000002203","GL344306.1",6737,50311,43574
"1762","ENSACAG00000002204","4",129600315,129619698,19383
"1763","ENSACAG00000002209","3",29896944,29991587,94643
"1764","ENSACAG00000002210","4",112146743,112161560,14817
"1765","ENSACAG00000002211","GL343924.1",15071,52093,37022
"1766","ENSACAG00000002214","1",88508323,88543051,34728
"1767","ENSACAG00000002217","GL343427.1",208928,289240,80312
"1768","ENSACAG00000002218","4",67861091,67937608,76517
"1769","ENSACAG00000002219","4",136707547,136748578,41031
"1770","ENSACAG00000002220","GL343337.1",1011645,1028791,17146
"1771","ENSACAG00000002222","1",247088005,247210475,122470
"1772","ENSACAG00000002223","4",36354139,36427063,72924
"1773","ENSACAG00000002224","GL343203.1",3103451,3123862,20411
"1774","ENSACAG00000002227","5",120263718,120268242,4524
"1775","ENSACAG00000002228","4",120478307,120542623,64316
"1776","ENSACAG00000002229","GL343298.1",714401,718931,4530
"1777","ENSACAG00000002231","GL344962.1",3472,13092,9620
"1778","ENSACAG00000002232","5",112906122,112977371,71249
"1779","ENSACAG00000002233","GL343924.1",27608,81956,54348
"1780","ENSACAG00000002234","3",187331215,187352256,21041
"1781","ENSACAG00000002238","GL344370.1",21,3960,3939
"1782","ENSACAG00000002239","6",7330687,7359087,28400
"1783","ENSACAG00000002241","4",53910205,53922889,12684
"1784","ENSACAG00000002242","1",44186910,44207611,20701
"1785","ENSACAG00000002245","6",3890653,3909064,18411
"1786","ENSACAG00000002246","3",187420289,187445987,25698
"1787","ENSACAG00000002247","AAWZ02036894",21,17114,17093
"1788","ENSACAG00000002249","5",120205988,120227441,21453
"1789","ENSACAG00000002251","6",3937567,3950417,12850
"1790","ENSACAG00000002252","1",60705219,60743090,37871
"1791","ENSACAG00000002254","1",244423968,244469048,45080
"1792","ENSACAG00000002255","1",134818214,134836982,18768
"1793","ENSACAG00000002256","5",64007155,64018564,11409
"1794","ENSACAG00000002257","GL343282.1",950208,956336,6128
"1795","ENSACAG00000002258","AAWZ02037698",642,1379,737
"1796","ENSACAG00000002259","AAWZ02037698",672,8224,7552
"1797","ENSACAG00000002260","GL343330.1",383966,455259,71293
"1798","ENSACAG00000002261","GL343365.1",592634,637962,45328
"1799","ENSACAG00000002262","2",43549048,43638452,89404
"1800","ENSACAG00000002263","AAWZ02041413",21,5517,5496
"1801","ENSACAG00000002264","AAWZ02037698",8856,14937,6081
"1802","ENSACAG00000002265","6",3956128,3972657,16529
"1803","ENSACAG00000002266","GL343539.1",29003,64242,35239
"1804","ENSACAG00000002267","1",148747709,148873413,125704
"1805","ENSACAG00000002268","5",120039662,120164690,125028
"1806","ENSACAG00000002269","3",29870866,29888911,18045
"1807","ENSACAG00000002270","2",50225073,50290209,65136
"1808","ENSACAG00000002271","1",134861937,135024034,162097
"1809","ENSACAG00000002273","GL343722.1",12444,25079,12635
"1810","ENSACAG00000002274","GL343337.1",1040004,1179267,139263
"1811","ENSACAG00000002275","6",35386115,35433356,47241
"1812","ENSACAG00000002276","GL343203.1",3163445,3197811,34366
"1813","ENSACAG00000002277","4",53936640,53944855,8215
"1814","ENSACAG00000002278","GL343282.1",915852,924473,8621
"1815","ENSACAG00000002279","5",82207004,82253127,46123
"1816","ENSACAG00000002280","GL343481.1",97383,114408,17025
"1817","ENSACAG00000002281","GL343423.1",512853,654956,142103
"1818","ENSACAG00000002282","3",29812882,29867475,54593
"1819","ENSACAG00000002283","GL344370.1",8142,15911,7769
"1820","ENSACAG00000002284","2",117783104,117831955,48851
"1821","ENSACAG00000002285","5",53479494,53541741,62247
"1822","ENSACAG00000002286","GL343427.1",166535,183917,17382
"1823","ENSACAG00000002288","5",119789568,119791339,1771
"1824","ENSACAG00000002289","1",44174621,44184122,9501
"1825","ENSACAG00000002290","GL343427.1",332219,386718,54499
"1826","ENSACAG00000002291","4",129621246,129628023,6777
"1827","ENSACAG00000002292","6",7384754,7436487,51733
"1828","ENSACAG00000002293","5",119762596,119784692,22096
"1829","ENSACAG00000002294","2",54601129,54628945,27816
"1830","ENSACAG00000002295","GL343306.1",84437,120020,35583
"1831","ENSACAG00000002296","GL343918.1",47324,113132,65808
"1832","ENSACAG00000002297","6",7543513,7608075,64562
"1833","ENSACAG00000002298","GL343298.1",771514,772360,846
"1834","ENSACAG00000002299","1",222962869,222980502,17633
"1835","ENSACAG00000002300","GL343722.1",25162,41749,16587
"1836","ENSACAG00000002301","GL343282.1",864633,910346,45713
"1837","ENSACAG00000002302","4",66887570,66934586,47016
"1838","ENSACAG00000002303","6",59717772,59738613,20841
"1839","ENSACAG00000002304","5",63968514,64001282,32768
"1840","ENSACAG00000002306","GL343295.1",356184,370209,14025
"1841","ENSACAG00000002307","4",53948353,53953576,5223
"1842","ENSACAG00000002308","GL343295.1",346638,354289,7651
"1843","ENSACAG00000002309","4",129646631,129702113,55482
"1844","ENSACAG00000002310","GL343298.1",898769,1058162,159393
"1845","ENSACAG00000002311","GL343433.1",485927,622095,136168
"1846","ENSACAG00000002312","4",112128562,112147944,19382
"1847","ENSACAG00000002314","GL343245.1",60976,150142,89166
"1848","ENSACAG00000002315","1",223005064,223011119,6055
"1849","ENSACAG00000002316","3",107508842,107530508,21666
"1850","ENSACAG00000002318","4",85919156,86232782,313626
"1851","ENSACAG00000002319","GL344444.1",28723,33060,4337
"1852","ENSACAG00000002320","1",223068686,223117933,49247
"1853","ENSACAG00000002321","3",187453735,187505259,51524
"1854","ENSACAG00000002322","4",120443452,120464031,20579
"1855","ENSACAG00000002323","GL344444.1",2587,11603,9016
"1856","ENSACAG00000002324","GL343722.1",47680,93838,46158
"1857","ENSACAG00000002326","4",53958694,53961153,2459
"1858","ENSACAG00000002327","GL343257.1",1823228,1844759,21531
"1859","ENSACAG00000002328","2",54656802,54714281,57479
"1860","ENSACAG00000002329","3",29620281,29812112,191831
"1861","ENSACAG00000002330","1",179956996,179965755,8759
"1862","ENSACAG00000002331","GL343522.1",373590,498925,125335
"1863","ENSACAG00000002332","4",53966167,53978873,12706
"1864","ENSACAG00000002333","6",37056834,37090380,33546
"1865","ENSACAG00000002334","GL343295.1",327794,341604,13810
"1866","ENSACAG00000002335","1",96449074,96465347,16273
"1867","ENSACAG00000002337","6",3990600,4018119,27519
"1868","ENSACAG00000002338","GL343210.1",3187650,3200155,12505
"1869","ENSACAG00000002339","1",244472758,244496057,23299
"1870","ENSACAG00000002340","GL343427.1",317055,407955,90900
"1871","ENSACAG00000002342","GL343203.1",3202636,3225737,23101
"1872","ENSACAG00000002343","GL343245.1",8669,40682,32013
"1873","ENSACAG00000002344","1",219079857,219111545,31688
"1874","ENSACAG00000002345","5",112985264,113002685,17421
"1875","ENSACAG00000002346","GL343696.1",30401,115717,85316
"1876","ENSACAG00000002347","5",63901915,63939083,37168
"1877","ENSACAG00000002348","1",88475006,88503265,28259
"1878","ENSACAG00000002349","4",66844756,66877622,32866
"1879","ENSACAG00000002350","4",120427393,120433356,5963
"1880","ENSACAG00000002351","GL343810.1",136692,174669,37977
"1881","ENSACAG00000002352","5",113006040,113017643,11603
"1882","ENSACAG00000002353","6",59759402,59771538,12136
"1883","ENSACAG00000002354","GL343294.1",169086,170162,1076
"1884","ENSACAG00000002355","GL343257.1",1801780,1812871,11091
"1885","ENSACAG00000002356","2",50313342,50357425,44083
"1886","ENSACAG00000002357","5",63832997,63889886,56889
"1887","ENSACAG00000002358","GL343294.1",754,38491,37737
"1888","ENSACAG00000002359","4",120403804,120413732,9928
"1889","ENSACAG00000002360","AAWZ02039718",3621,5749,2128
"1890","ENSACAG00000002361","6",59840548,59840910,362
"1891","ENSACAG00000002362","4",53998635,54024678,26043
"1892","ENSACAG00000002364","GL343295.1",294494,299912,5418
"1893","ENSACAG00000002366","4",119882293,119988571,106278
"1894","ENSACAG00000002367","LGa",2327294,2393713,66419
"1895","ENSACAG00000002368","6",35343279,35374110,30831
"1896","ENSACAG00000002369","GL344370.1",23359,42934,19575
"1897","ENSACAG00000002370","GL343210.1",2802419,3144082,341663
"1898","ENSACAG00000002372","5",53575412,53608392,32980
"1899","ENSACAG00000002373","5",63806982,63827875,20893
"1900","ENSACAG00000002375","GL343257.1",1762877,1776962,14085
"1901","ENSACAG00000002376","3",107596631,107629827,33196
"1902","ENSACAG00000002377","GL343306.1",151109,161539,10430
"1903","ENSACAG00000002379","1",219039534,219076406,36872
"1904","ENSACAG00000002380","GL343295.1",271136,279506,8370
"1905","ENSACAG00000002381","GL343257.1",1723173,1747649,24476
"1906","ENSACAG00000002383","AAWZ02041188",708,3622,2914
"1907","ENSACAG00000002384","1",244514446,244524229,9783
"1908","ENSACAG00000002385","2",54726583,54730777,4194
"1909","ENSACAG00000002386","1",148886327,148951304,64977
"1910","ENSACAG00000002387","GL343446.1",8521,12429,3908
"1911","ENSACAG00000002388","GL343696.1",180420,196186,15766
"1912","ENSACAG00000002389","5",113066165,113072833,6668
"1913","ENSACAG00000002390","GL344118.1",12766,30703,17937
"1914","ENSACAG00000002391","GL343427.1",438718,446593,7875
"1915","ENSACAG00000002392","GL343696.1",207535,265559,58024
"1916","ENSACAG00000002393","1",219000268,219019479,19211
"1917","ENSACAG00000002395","GL343423.1",701553,750627,49074
"1918","ENSACAG00000002396","5",119717374,119755438,38064
"1919","ENSACAG00000002397","GL343306.1",285045,371857,86812
"1920","ENSACAG00000002398","1",96416770,96445546,28776
"1921","ENSACAG00000002400","5",113179027,113229865,50838
"1922","ENSACAG00000002401","2",50409275,50431399,22124
"1923","ENSACAG00000002402","5",53631039,53726913,95874
"1924","ENSACAG00000002404","GL343481.1",123192,134591,11399
"1925","ENSACAG00000002405","1",223144377,223168293,23916
"1926","ENSACAG00000002406","6",69990067,69990795,728
"1927","ENSACAG00000002407","5",82523105,82611193,88088
"1928","ENSACAG00000002408","AAWZ02038671",21,10356,10335
"1929","ENSACAG00000002409","2",54755155,54792914,37759
"1930","ENSACAG00000002410","GL343833.1",150085,154926,4841
"1931","ENSACAG00000002411","2",50471220,50486610,15390
"1932","ENSACAG00000002412","4",66784812,66839997,55185
"1933","ENSACAG00000002413","6",69727311,69962541,235230
"1934","ENSACAG00000002414","GL343374.1",67607,148665,81058
"1935","ENSACAG00000002415","2",30037164,30107844,70680
"1936","ENSACAG00000002416","GL343833.1",114887,126105,11218
"1937","ENSACAG00000002417","GL343547.1",451227,489688,38461
"1938","ENSACAG00000002418","GL343427.1",456676,474571,17895
"1939","ENSACAG00000002419","GL343423.1",755331,793853,38522
"1940","ENSACAG00000002420","3",200402601,200419283,16682
"1941","ENSACAG00000002421","3",28904526,29378453,473927
"1942","ENSACAG00000002422","4",111915408,111932253,16845
"1943","ENSACAG00000002423","2",50825323,50945499,120176
"1944","ENSACAG00000002424","4",111857282,111891995,34713
"1945","ENSACAG00000002426","3",107712111,107737617,25506
"1946","ENSACAG00000002427","2",117778191,117843277,65086
"1947","ENSACAG00000002428","1",44169055,44172309,3254
"1948","ENSACAG00000002429","GL344118.1",30058,52076,22018
"1949","ENSACAG00000002432","GL343833.1",36467,39978,3511
"1950","ENSACAG00000002433","GL343203.1",3228926,3235741,6815
"1951","ENSACAG00000002434","4",10771874,10825943,54069
"1952","ENSACAG00000002435","GL343439.1",261718,337118,75400
"1953","ENSACAG00000002437","GL343295.1",226543,228366,1823
"1954","ENSACAG00000002438","4",78570325,78649366,79041
"1955","ENSACAG00000002439","1",60972815,60992368,19553
"1956","ENSACAG00000002440","1",44119360,44144487,25127
"1957","ENSACAG00000002441","GL343833.1",8752,33883,25131
"1958","ENSACAG00000002443","GL343481.1",188614,194010,5396
"1959","ENSACAG00000002445","GL343295.1",196760,216026,19266
"1960","ENSACAG00000002446","GL344069.1",4082,4258,176
"1961","ENSACAG00000002447","GL343539.1",323,8855,8532
"1962","ENSACAG00000002448","GL344581.1",308,6057,5749
"1963","ENSACAG00000002449","6",35329105,35332516,3411
"1964","ENSACAG00000002450","GL344276.1",44481,44769,288
"1965","ENSACAG00000002451","GL344276.1",73171,85756,12585
"1966","ENSACAG00000002453","1",96261092,96313370,52278
"1967","ENSACAG00000002454","1",244532502,244543742,11240
"1968","ENSACAG00000002456","5",82891861,82902969,11108
"1969","ENSACAG00000002457","3",28765295,28765474,179
"1970","ENSACAG00000002458","3",28758330,28762354,4024
"1971","ENSACAG00000002459","1",244612826,244646895,34069
"1972","ENSACAG00000002460","GL343203.1",3319634,3368906,49272
"1973","ENSACAG00000002461","GL343365.1",640975,653911,12936
"1974","ENSACAG00000002462","GL343427.1",474256,502857,28601
"1975","ENSACAG00000002463","GL343365.1",670358,697014,26656
"1976","ENSACAG00000002464","GL343579.1",75624,85820,10196
"1977","ENSACAG00000002466","5",53825559,53904175,78616
"1978","ENSACAG00000002469","3",28732138,28745320,13182
"1979","ENSACAG00000002470","5",82934016,82939677,5661
"1980","ENSACAG00000002472","2",184563906,184717200,153294
"1981","ENSACAG00000002473","6",36945116,37036184,91068
"1982","ENSACAG00000002476","6",36766603,36854983,88380
"1983","ENSACAG00000002477","1",218926082,218963453,37371
"1984","ENSACAG00000002478","3",108283945,108318334,34389
"1985","ENSACAG00000002480","1",61119049,61163167,44118
"1986","ENSACAG00000002481","GL344420.1",699,18010,17311
"1987","ENSACAG00000002482","2",184389885,184555853,165968
"1988","ENSACAG00000002483","1",244700016,244729113,29097
"1989","ENSACAG00000002484","3",28590428,28614521,24093
"1990","ENSACAG00000002486","1",96169445,96248843,79398
"1991","ENSACAG00000002487","1",244765838,244943118,177280
"1992","ENSACAG00000002488","GL343587.1",324311,347830,23519
"1993","ENSACAG00000002489","4",10742514,10755401,12887
"1994","ENSACAG00000002490","1",44010910,44063922,53012
"1995","ENSACAG00000002492","3",84855418,84856257,839
"1996","ENSACAG00000002493","6",7625826,7950231,324405
"1997","ENSACAG00000002494","2",117850235,117888821,38586
"1998","ENSACAG00000002495","GL343722.1",113643,120426,6783
"1999","ENSACAG00000002496","6",35268481,35325915,57434
"2000","ENSACAG00000002500","3",84790980,84811049,20069
"2001","ENSACAG00000002501","GL343523.1",123783,158075,34292
"2002","ENSACAG00000002502","GL343481.1",207438,221710,14272
"2003","ENSACAG00000002503","6",69630079,69653624,23545
"2004","ENSACAG00000002504","5",119609124,119680711,71587
"2005","ENSACAG00000002505","GL343916.1",101076,102512,1436
"2006","ENSACAG00000002506","3",108316411,108401609,85198
"2007","ENSACAG00000002507","GL343916.1",131831,133021,1190
"2008","ENSACAG00000002508","GL343439.1",342210,360702,18492
"2009","ENSACAG00000002509","GL344475.1",1626,12418,10792
"2010","ENSACAG00000002510","1",43904717,44008412,103695
"2011","ENSACAG00000002511","AAWZ02038141",1691,12879,11188
"2012","ENSACAG00000002512","1",244998004,245048613,50609
"2013","ENSACAG00000002515","1",247369452,247369980,528
"2014","ENSACAG00000002516","6",36641104,36730492,89388
"2015","ENSACAG00000002517","GL343519.1",550162,567209,17047
"2016","ENSACAG00000002518","3",187534926,187548136,13210
"2017","ENSACAG00000002519","4",129721245,129733599,12354
"2018","ENSACAG00000002520","GL344118.1",70408,79629,9221
"2019","ENSACAG00000002521","1",88456066,88469713,13647
"2020","ENSACAG00000002522","6",69595881,69623222,27341
"2021","ENSACAG00000002524","4",129850149,129999934,149785
"2022","ENSACAG00000002526","3",187560853,187637136,76283
"2023","ENSACAG00000002527","4",10708651,10738992,30341
"2024","ENSACAG00000002529","GL343340.1",741665,1231333,489668
"2025","ENSACAG00000002530","1",247911374,248068073,156699
"2026","ENSACAG00000002531","1",223171140,223182759,11619
"2027","ENSACAG00000002532","3",84760667,84789601,28934
"2028","ENSACAG00000002533","GL343722.1",164743,169062,4319
"2029","ENSACAG00000002534","3",38747491,38769377,21886
"2030","ENSACAG00000002536","GL344552.1",35476,53162,17686
"2031","ENSACAG00000002537","GL343722.1",204915,212908,7993
"2032","ENSACAG00000002538","GL344182.1",21998,57269,35271
"2033","ENSACAG00000002540","1",149796475,149800054,3579
"2034","ENSACAG00000002541","6",69545041,69581271,36230
"2035","ENSACAG00000002542","GL343203.1",3370331,3423316,52985
"2036","ENSACAG00000002543","3",145662081,145667382,5301
"2037","ENSACAG00000002544","GL343481.1",234483,244198,9715
"2038","ENSACAG00000002545","AAWZ02038788",2764,10411,7647
"2039","ENSACAG00000002546","3",28396315,28542452,146137
"2040","ENSACAG00000002547","GL344217.1",24319,34857,10538
"2041","ENSACAG00000002548","GL344902.1",5772,7020,1248
"2042","ENSACAG00000002549","GL344276.1",92072,101490,9418
"2043","ENSACAG00000002551","2",130931985,130945163,13178
"2044","ENSACAG00000002552","GL343722.1",197201,200560,3359
"2045","ENSACAG00000002553","GL343423.1",812599,828822,16223
"2046","ENSACAG00000002554","3",28299368,28300288,920
"2047","ENSACAG00000002555","3",200389320,200400617,11297
"2048","ENSACAG00000002556","GL343282.1",823691,861089,37398
"2049","ENSACAG00000002557","2",130899452,130922659,23207
"2050","ENSACAG00000002558","4",10586090,10598305,12215
"2051","ENSACAG00000002559","3",28270544,28277986,7442
"2052","ENSACAG00000002560","GL343713.1",56489,80643,24154
"2053","ENSACAG00000002561","3",200357952,200389192,31240
"2054","ENSACAG00000002563","GL343722.1",227490,232981,5491
"2055","ENSACAG00000002564","1",80412051,80468137,56086
"2056","ENSACAG00000002565","2",117894163,117931758,37595
"2057","ENSACAG00000002566","GL343306.1",435884,519481,83597
"2058","ENSACAG00000002568","GL343295.1",1333213,1412875,79662
"2059","ENSACAG00000002569","3",145613751,145659416,45665
"2060","ENSACAG00000002571","GL344217.1",34378,57470,23092
"2061","ENSACAG00000002572","GL343722.1",253920,261876,7956
"2062","ENSACAG00000002573","GL343439.1",774860,786509,11649
"2063","ENSACAG00000002574","1",61258294,61279801,21507
"2064","ENSACAG00000002575","2",54794734,54805912,11178
"2065","ENSACAG00000002576","1",223183151,223192644,9493
"2066","ENSACAG00000002577","GL343439.1",794090,805132,11042
"2067","ENSACAG00000002578","GL343257.1",1708844,1713601,4757
"2068","ENSACAG00000002580","6",36574448,36603520,29072
"2069","ENSACAG00000002581","5",53952563,53955723,3160
"2070","ENSACAG00000002582","GL344080.1",43333,74699,31366
"2071","ENSACAG00000002584","5",54011178,54183402,172224
"2072","ENSACAG00000002585","AAWZ02038021",9999,13353,3354
"2073","ENSACAG00000002586","3",28240891,28260310,19419
"2074","ENSACAG00000002587","2",54806441,54811985,5544
"2075","ENSACAG00000002588","2",55054957,55094499,39542
"2076","ENSACAG00000002589","1",88390812,88412477,21665
"2077","ENSACAG00000002590","GL344006.1",298,11526,11228
"2078","ENSACAG00000002592","3",103618495,103632261,13766
"2079","ENSACAG00000002593","4",111886094,111886718,624
"2080","ENSACAG00000002594","GL343257.1",1667531,1693751,26220
"2081","ENSACAG00000002596","GL343282.1",760171,765966,5795
"2082","ENSACAG00000002597","AAWZ02040018",2678,7492,4814
"2083","ENSACAG00000002598","GL343257.1",1647596,1653639,6043
"2084","ENSACAG00000002599","GL343257.1",1419937,1603080,183143
"2085","ENSACAG00000002600","2",117966641,117991966,25325
"2086","ENSACAG00000002602","AAWZ02037520",1035,15339,14304
"2087","ENSACAG00000002603","GL343257.1",1487972,1495531,7559
"2088","ENSACAG00000002604","3",103536017,103608063,72046
"2089","ENSACAG00000002605","3",137294147,137335723,41576
"2090","ENSACAG00000002606","GL343523.1",181595,314812,133217
"2091","ENSACAG00000002607","GL343427.1",594163,627241,33078
"2092","ENSACAG00000002608","GL343282.1",739104,758326,19222
"2093","ENSACAG00000002609","GL343646.1",135107,135511,404
"2094","ENSACAG00000002610","GL343646.1",83767,103286,19519
"2095","ENSACAG00000002612","2",29781499,29781741,242
"2096","ENSACAG00000002613","GL343257.1",1417070,1435939,18869
"2097","ENSACAG00000002614","2",29605484,29727826,122342
"2098","ENSACAG00000002615","GL344006.1",14688,31503,16815
"2099","ENSACAG00000002616","4",54028349,54045922,17573
"2100","ENSACAG00000002617","4",130169301,130211392,42091
"2101","ENSACAG00000002619","GL343257.1",1326196,1409725,83529
"2102","ENSACAG00000002620","2",55155095,55401980,246885
"2103","ENSACAG00000002626","3",137350129,137395298,45169
"2104","ENSACAG00000002627","AAWZ02040490",2155,6752,4597
"2105","ENSACAG00000002628","GL343819.1",4513,15112,10599
"2106","ENSACAG00000002630","3",84712626,84745796,33170
"2107","ENSACAG00000002631","GL343221.1",1883391,1907099,23708
"2108","ENSACAG00000002632","3",200211728,200347842,136114
"2109","ENSACAG00000002633","AAWZ02039402",2445,4418,1973
"2110","ENSACAG00000002634","GL343845.1",1137,54829,53692
"2111","ENSACAG00000002635","GL343428.1",12266,17472,5206
"2112","ENSACAG00000002636","GL343221.1",1906805,1974675,67870
"2113","ENSACAG00000002637","GL343198.1",2028159,2119290,91131
"2114","ENSACAG00000002640","GL343295.1",139651,169738,30087
"2115","ENSACAG00000002641","1",223195010,223209343,14333
"2116","ENSACAG00000002642","GL343428.1",17370,28806,11436
"2117","ENSACAG00000002643","2",56035457,56305557,270100
"2118","ENSACAG00000002644","GL343890.1",1260,3826,2566
"2119","ENSACAG00000002645","GL344420.1",21009,29754,8745
"2120","ENSACAG00000002646","GL343693.1",238145,258195,20050
"2121","ENSACAG00000002647","GL343947.1",1,6712,6711
"2122","ENSACAG00000002648","5",119460578,119578716,118138
"2123","ENSACAG00000002649","3",28160170,28230511,70341
"2124","ENSACAG00000002650","GL344032.1",40102,85155,45053
"2125","ENSACAG00000002652","1",135261541,135829867,568326
"2126","ENSACAG00000002653","2",130843759,130864272,20513
"2127","ENSACAG00000002654","GL343989.1",50455,93233,42778
"2128","ENSACAG00000002657","GL343338.1",1146,5952,4806
"2129","ENSACAG00000002658","AAWZ02038746",100,10268,10168
"2130","ENSACAG00000002661","AAWZ02038711",4845,9159,4314
"2131","ENSACAG00000002662","4",119766565,119766819,254
"2132","ENSACAG00000002663","GL343433.1",528759,547330,18571
"2133","ENSACAG00000002664","4",119633766,119656113,22347
"2134","ENSACAG00000002665","GL343890.1",32031,40740,8709
"2135","ENSACAG00000002666","GL343890.1",43623,50178,6555
"2136","ENSACAG00000002668","LGa",2220704,2231450,10746
"2137","ENSACAG00000002669","GL343282.1",684960,728983,44023
"2138","ENSACAG00000002670","1",61396129,61444787,48658
"2139","ENSACAG00000002671","4",66740839,66780256,39417
"2140","ENSACAG00000002673","GL343609.1",348103,351257,3154
"2141","ENSACAG00000002674","6",69422393,69441600,19207
"2142","ENSACAG00000002675","4",66592396,66659776,67380
"2143","ENSACAG00000002676","GL344579.1",5,27937,27932
"2144","ENSACAG00000002677","GL344006.1",52100,53209,1109
"2145","ENSACAG00000002678","GL343338.1",7419,10850,3431
"2146","ENSACAG00000002680","5",131720000,131768255,48255
"2147","ENSACAG00000002681","GL343433.1",460102,463164,3062
"2148","ENSACAG00000002682","GL344006.1",71216,89120,17904
"2149","ENSACAG00000002683","5",119412299,119431810,19511
"2150","ENSACAG00000002685","GL343433.1",430937,455279,24342
"2151","ENSACAG00000002686","1",223271539,223308374,36835
"2152","ENSACAG00000002688","GL343481.1",245925,253545,7620
"2153","ENSACAG00000002689","3",179356177,179357652,1475
"2154","ENSACAG00000002690","GL343198.1",2159671,2179178,19507
"2155","ENSACAG00000002691","3",187653641,187724849,71208
"2156","ENSACAG00000002692","GL343428.1",33217,46795,13578
"2157","ENSACAG00000002693","3",101163492,101179645,16153
"2158","ENSACAG00000002694","5",113234338,113294088,59750
"2159","ENSACAG00000002695","GL343209.1",465468,468837,3369
"2160","ENSACAG00000002696","GL343214.1",1073312,1128433,55121
"2161","ENSACAG00000002697","GL343519.1",496258,525205,28947
"2162","ENSACAG00000002698","GL343209.1",469045,494825,25780
"2163","ENSACAG00000002699","LGa",2148059,2209040,60981
"2164","ENSACAG00000002700","5",113253812,113266953,13141
"2165","ENSACAG00000002701","GL343890.1",68886,89317,20431
"2166","ENSACAG00000002702","1",61451810,61473812,22002
"2167","ENSACAG00000002704","1",223340447,223356751,16304
"2168","ENSACAG00000002705","4",54051722,54088878,37156
"2169","ENSACAG00000002706","AAWZ02036348",11067,26517,15450
"2170","ENSACAG00000002707","GL343504.1",367719,435343,67624
"2171","ENSACAG00000002708","3",28102928,28104037,1109
"2172","ENSACAG00000002709","GL343833.1",1227,3817,2590
"2173","ENSACAG00000002710","GL343428.1",52719,78026,25307
"2174","ENSACAG00000002711","1",88369994,88388755,18761
"2175","ENSACAG00000002712","1",80335752,80365660,29908
"2176","ENSACAG00000002713","3",187765115,187770004,4889
"2177","ENSACAG00000002714","AAWZ02039191",901,9112,8211
"2178","ENSACAG00000002715","3",84597471,84689295,91824
"2179","ENSACAG00000002716","GL343433.1",394402,425177,30775
"2180","ENSACAG00000002718","GL343338.1",18504,20361,1857
"2181","ENSACAG00000002719","GL343203.1",3438756,3586752,147996
"2182","ENSACAG00000002720","4",130263610,130275842,12232
"2183","ENSACAG00000002721","GL343813.1",65638,82080,16442
"2184","ENSACAG00000002722","GL343989.1",117086,127080,9994
"2185","ENSACAG00000002723","2",130819318,130833477,14159
"2186","ENSACAG00000002724","5",3754592,3755056,464
"2187","ENSACAG00000002725","GL343813.1",108083,111612,3529
"2188","ENSACAG00000002726","2",56415036,56451227,36191
"2189","ENSACAG00000002728","1",221588263,221665269,77006
"2190","ENSACAG00000002729","5",3834649,3866717,32068
"2191","ENSACAG00000002730","4",119561601,119577058,15457
"2192","ENSACAG00000002731","GL343813.1",143707,157056,13349
"2193","ENSACAG00000002732","2",130679476,130809461,129985
"2194","ENSACAG00000002734","3",200137893,200155798,17905
"2195","ENSACAG00000002735","5",118990528,119241613,251085
"2196","ENSACAG00000002736","GL343337.1",1264908,1273999,9091
"2197","ENSACAG00000002737","6",36486603,36566621,80018
"2198","ENSACAG00000002739","3",200019300,200029207,9907
"2199","ENSACAG00000002741","3",137452796,137474857,22061
"2200","ENSACAG00000002743","3",145488587,145564551,75964
"2201","ENSACAG00000002744","3",28004348,28054259,49911
"2202","ENSACAG00000002745","AAWZ02035903",23888,35075,11187
"2203","ENSACAG00000002746","1",61485911,61510255,24344
"2204","ENSACAG00000002747","AAWZ02038656",5113,6469,1356
"2205","ENSACAG00000002749","GL344864.1",1336,10114,8778
"2206","ENSACAG00000002750","1",88358330,88368350,10020
"2207","ENSACAG00000002751","3",101112269,101115774,3505
"2208","ENSACAG00000002752","2",29527177,29561856,34679
"2209","ENSACAG00000002753","GL344864.1",17104,17286,182
"2210","ENSACAG00000002755","GL343282.1",648057,665153,17096
"2211","ENSACAG00000002756","3",187782135,187782290,155
"2212","ENSACAG00000002757","GL343433.1",363574,388776,25202
"2213","ENSACAG00000002758","3",187794947,187795252,305
"2214","ENSACAG00000002759","2",29347947,29514057,166110
"2215","ENSACAG00000002760","3",187801518,187856033,54515
"2216","ENSACAG00000002761","GL343209.1",651271,710922,59651
"2217","ENSACAG00000002762","GL343338.1",26845,50277,23432
"2218","ENSACAG00000002763","1",69516448,69517494,1046
"2219","ENSACAG00000002764","GL343899.1",424,26122,25698
"2220","ENSACAG00000002766","3",101065875,101099416,33541
"2221","ENSACAG00000002767","GL344032.1",28010,36129,8119
"2222","ENSACAG00000002768","6",69400603,69415614,15011
"2223","ENSACAG00000002769","1",218840061,218915535,75474
"2224","ENSACAG00000002770","GL343428.1",79466,111555,32089
"2225","ENSACAG00000002771","1",43825831,43891618,65787
"2226","ENSACAG00000002772","5",132225688,132291770,66082
"2227","ENSACAG00000002773","4",130279678,130312380,32702
"2228","ENSACAG00000002774","AAWZ02038102",882,3984,3102
"2229","ENSACAG00000002775","GL343557.1",9235,19698,10463
"2230","ENSACAG00000002776","3",39258014,39263800,5786
"2231","ENSACAG00000002777","2",163427704,163533358,105654
"2232","ENSACAG00000002778","3",137505653,137598372,92719
"2233","ENSACAG00000002779","GL343914.1",89036,111233,22197
"2234","ENSACAG00000002780","2",29307462,29336927,29465
"2235","ENSACAG00000002781","3",84257565,84258091,526
"2236","ENSACAG00000002782","1",223685143,223720713,35570
"2237","ENSACAG00000002784","AAWZ02041299",1275,1595,320
"2238","ENSACAG00000002785","GL343557.1",31179,128379,97200
"2239","ENSACAG00000002786","5",113366773,113388701,21928
"2240","ENSACAG00000002787","1",221683131,221702940,19809
"2241","ENSACAG00000002788","LGa",2114522,2139103,24581
"2242","ENSACAG00000002789","2",44577899,44743950,166051
"2243","ENSACAG00000002790","3",39245003,39255275,10272
"2244","ENSACAG00000002791","1",223722050,223726185,4135
"2245","ENSACAG00000002793","AAWZ02035903",4155,4917,762
"2246","ENSACAG00000002795","2",130560180,130589806,29626
"2247","ENSACAG00000002796","GL343433.1",294223,329407,35184
"2248","ENSACAG00000002797","GL343295.1",112990,136855,23865
"2249","ENSACAG00000002798","GL343282.1",538034,539834,1800
"2250","ENSACAG00000002799","1",223733395,223856867,123472
"2251","ENSACAG00000002800","GL343282.1",521925,522514,589
"2252","ENSACAG00000002801","GL344463.1",20622,34712,14090
"2253","ENSACAG00000002803","GL343282.1",500824,505613,4789
"2254","ENSACAG00000002805","1",221716955,221744887,27932
"2255","ENSACAG00000002806","6",36445540,36454930,9390
"2256","ENSACAG00000002807","GL343947.1",12045,12756,711
"2257","ENSACAG00000002808","GL343295.1",1249047,1272619,23572
"2258","ENSACAG00000002810","4",66580871,66583722,2851
"2259","ENSACAG00000002811","4",66560017,66574098,14081
"2260","ENSACAG00000002812","GL343295.1",75632,97970,22338
"2261","ENSACAG00000002814","3",145377006,145385992,8986
"2262","ENSACAG00000002815","4",66469352,66560511,91159
"2263","ENSACAG00000002816","GL343481.1",256810,275764,18954
"2264","ENSACAG00000002817","3",145292596,145365794,73198
"2265","ENSACAG00000002818","GL344173.1",54,20376,20322
"2266","ENSACAG00000002819","GL343947.1",17229,21665,4436
"2267","ENSACAG00000002820","GL343519.1",470048,495921,25873
"2268","ENSACAG00000002821","GL343504.1",331686,335196,3510
"2269","ENSACAG00000002822","GL344213.1",45723,49913,4190
"2270","ENSACAG00000002823","1",61511002,61573197,62195
"2271","ENSACAG00000002824","1",88270671,88297597,26926
"2272","ENSACAG00000002825","GL343282.1",469263,470327,1064
"2273","ENSACAG00000002827","GL343433.1",228837,286434,57597
"2274","ENSACAG00000002828","GL343504.1",322098,332112,10014
"2275","ENSACAG00000002829","4",54091689,54110145,18456
"2276","ENSACAG00000002830","GL343282.1",449853,465677,15824
"2277","ENSACAG00000002831","GL343491.1",313721,314522,801
"2278","ENSACAG00000002832","6",36419765,36441796,22031
"2279","ENSACAG00000002833","3",187870138,187963557,93419
"2280","ENSACAG00000002834","GL343523.1",324733,377484,52751
"2281","ENSACAG00000002835","GL344186.1",55541,56052,511
"2282","ENSACAG00000002836","GL343491.1",338024,338480,456
"2283","ENSACAG00000002837","GL343466.1",567390,569011,1621
"2284","ENSACAG00000002838","GL343491.1",327041,331957,4916
"2285","ENSACAG00000002841","GL343209.1",855182,879795,24613
"2286","ENSACAG00000002843","GL343466.1",534859,535803,944
"2287","ENSACAG00000002844","GL343214.1",901340,1055970,154630
"2288","ENSACAG00000002846","2",151900658,151901822,1164
"2289","ENSACAG00000002847","6",69322211,69338166,15955
"2290","ENSACAG00000002848","GL343947.1",27833,40161,12328
"2291","ENSACAG00000002849","GL343491.1",306115,306997,882
"2292","ENSACAG00000002850","GL344789.1",10562,15428,4866
"2293","ENSACAG00000002851","GL343466.1",480366,493852,13486
"2294","ENSACAG00000002852","AAWZ02040808",1558,5404,3846
"2295","ENSACAG00000002853","1",221751682,221761280,9598
"2296","ENSACAG00000002854","GL344186.1",32680,36051,3371
"2297","ENSACAG00000002855","4",65881915,66291735,409820
"2298","ENSACAG00000002856","GL343557.1",45708,57509,11801
"2299","ENSACAG00000002858","6",8001269,8058573,57304
"2300","ENSACAG00000002859","GL343338.1",67098,69371,2273
"2301","ENSACAG00000002860","3",27975761,27985819,10058
"2302","ENSACAG00000002861","1",223967288,224016984,49696
"2303","ENSACAG00000002862","GL343278.1",8533,113468,104935
"2304","ENSACAG00000002863","GL343257.1",1169336,1176315,6979
"2305","ENSACAG00000002864","GL343491.1",238324,239724,1400
"2306","ENSACAG00000002865","GL343338.1",71804,72517,713
"2307","ENSACAG00000002867","1",221761586,221769481,7895
"2308","ENSACAG00000002868","GL343338.1",72516,74795,2279
"2309","ENSACAG00000002869","AAWZ02039755",835,948,113
"2310","ENSACAG00000002870","GL343491.1",226365,235533,9168
"2311","ENSACAG00000002871","GL343360.1",546611,775767,229156
"2312","ENSACAG00000002872","GL343447.1",168855,169290,435
"2313","ENSACAG00000002874","4",119482423,119504888,22465
"2314","ENSACAG00000002875","GL343193.1",14301730,14308128,6398
"2315","ENSACAG00000002876","1",221813440,221825816,12376
"2316","ENSACAG00000002877","GL343338.1",73961,86753,12792
"2317","ENSACAG00000002878","GL343193.1",14275309,14299757,24448
"2318","ENSACAG00000002879","5",132303116,132402106,98990
"2319","ENSACAG00000002880","5",54594118,54610305,16187
"2320","ENSACAG00000002883","GL343890.1",89575,128828,39253
"2321","ENSACAG00000002884","3",27824432,27931495,107063
"2322","ENSACAG00000002886","LGf",2296158,2311318,15160
"2323","ENSACAG00000002887","GL343282.1",365272,409492,44220
"2324","ENSACAG00000002888","1",211240747,211564097,323350
"2325","ENSACAG00000002889","5",118707144,118726822,19678
"2326","ENSACAG00000002890","2",163347730,163366597,18867
"2327","ENSACAG00000002891","6",36384887,36413924,29037
"2328","ENSACAG00000002892","3",39228706,39243219,14513
"2329","ENSACAG00000002895","GL343205.1",4217432,4239734,22302
"2330","ENSACAG00000002896","6",36269665,36329256,59591
"2331","ENSACAG00000002897","4",77068230,77070659,2429
"2332","ENSACAG00000002898","6",69199274,69334548,135274
"2333","ENSACAG00000002899","GL343193.1",14211902,14246896,34994
"2334","ENSACAG00000002900","3",101046613,101063912,17299
"2335","ENSACAG00000002902","GL343491.1",214827,221365,6538
"2336","ENSACAG00000002903","4",119420592,119430503,9911
"2337","ENSACAG00000002904","3",188009617,188056526,46909
"2338","ENSACAG00000002906","1",88239891,88271328,31437
"2339","ENSACAG00000002907","GL343491.1",199679,200822,1143
"2340","ENSACAG00000002908","GL343491.1",183853,184449,596
"2341","ENSACAG00000002909","3",101019291,101040107,20816
"2342","ENSACAG00000002910","GL344187.1",79553,81127,1574
"2343","ENSACAG00000002911","4",54158148,54218607,60459
"2344","ENSACAG00000002914","3",145217324,145278986,61662
"2345","ENSACAG00000002915","GL343338.1",90264,91354,1090
"2346","ENSACAG00000002916","GL343538.1",78058,136417,58359
"2347","ENSACAG00000002918","GL343857.1",4617,12076,7459
"2348","ENSACAG00000002919","6",36161303,36237003,75700
"2349","ENSACAG00000002920","GL343519.1",440899,446199,5300
"2350","ENSACAG00000002921","GL343466.1",470167,485790,15623
"2351","ENSACAG00000002923","3",180483798,180505501,21703
"2352","ENSACAG00000002925","GL343257.1",1250268,1267882,17614
"2353","ENSACAG00000002926","GL343523.1",396485,409192,12707
"2354","ENSACAG00000002927","4",130353272,130371246,17974
"2355","ENSACAG00000002928","GL343257.1",1096460,1099669,3209
"2356","ENSACAG00000002930","2",163306759,163337955,31196
"2357","ENSACAG00000002931","4",54229448,54252138,22690
"2358","ENSACAG00000002932","GL343360.1",931370,998841,67471
"2359","ENSACAG00000002933","3",39210498,39225934,15436
"2360","ENSACAG00000002934","GL343338.1",92731,96210,3479
"2361","ENSACAG00000002935","3",145197198,145208038,10840
"2362","ENSACAG00000002936","GL343772.1",184481,200797,16316
"2363","ENSACAG00000002938","3",137615316,137661826,46510
"2364","ENSACAG00000002939","4",54981767,54989741,7974
"2365","ENSACAG00000002940","1",43772914,43800240,27326
"2366","ENSACAG00000002941","2",50960814,50967030,6216
"2367","ENSACAG00000002943","6",8095733,8110818,15085
"2368","ENSACAG00000002944","GL343282.1",325794,344135,18341
"2369","ENSACAG00000002947","GL343523.1",410868,428429,17561
"2370","ENSACAG00000002948","3",137675847,137699883,24036
"2371","ENSACAG00000002949","GL343481.1",279481,313393,33912
"2372","ENSACAG00000002950","3",101003408,101013233,9825
"2373","ENSACAG00000002951","5",132473218,132528492,55274
"2374","ENSACAG00000002953","5",113436375,113487578,51203
"2375","ENSACAG00000002955","5",118551911,118660263,108352
"2376","ENSACAG00000002960","GL343257.1",791014,870797,79783
"2377","ENSACAG00000002961","GL343360.1",1238800,1240541,1741
"2378","ENSACAG00000002962","3",100939898,100942012,2114
"2379","ENSACAG00000002964","3",39181971,39204008,22037
"2380","ENSACAG00000002966","GL343205.1",4130453,4201652,71199
"2381","ENSACAG00000002967","GL343319.1",1173,53757,52584
"2382","ENSACAG00000002970","1",218725252,218824780,99528
"2383","ENSACAG00000002971","GL343306.1",680348,691313,10965
"2384","ENSACAG00000002972","GL343491.1",106357,106818,461
"2385","ENSACAG00000002973","GL343433.1",197448,223495,26047
"2386","ENSACAG00000002975","GL343257.1",768414,776511,8097
"2387","ENSACAG00000002976","GL343257.1",752935,764235,11300
"2388","ENSACAG00000002977","3",188567258,188596287,29029
"2389","ENSACAG00000002978","5",132534696,132541712,7016
"2390","ENSACAG00000002979","LGa",1706526,2101343,394817
"2391","ENSACAG00000002980","GL343491.1",103391,104821,1430
"2392","ENSACAG00000002981","5",3867519,3894524,27005
"2393","ENSACAG00000002984","6",36146828,36160252,13424
"2394","ENSACAG00000002987","3",100882194,100941172,58978
"2395","ENSACAG00000002988","5",54610580,54625689,15109
"2396","ENSACAG00000002990","GL343875.1",4820,22604,17784
"2397","ENSACAG00000002991","6",36042512,36090024,47512
"2398","ENSACAG00000002993","4",119342979,119350503,7524
"2399","ENSACAG00000002994","GL343857.1",32393,55125,22732
"2400","ENSACAG00000002995","GL343338.1",97540,108056,10516
"2401","ENSACAG00000002997","1",211611475,211663709,52234
"2402","ENSACAG00000002999","GL343319.1",63834,180440,116606
"2403","ENSACAG00000003002","GL343875.1",40366,46266,5900
"2404","ENSACAG00000003003","GL343433.1",112703,138343,25640
"2405","ENSACAG00000003004","LGf",2268935,2277057,8122
"2406","ENSACAG00000003005","GL343519.1",376803,418918,42115
"2407","ENSACAG00000003006","3",145140378,145191956,51578
"2408","ENSACAG00000003008","3",137705883,137726554,20671
"2409","ENSACAG00000003010","5",113511675,113669902,158227
"2410","ENSACAG00000003011","5",50572516,50711030,138514
"2411","ENSACAG00000003012","GL343257.1",591857,686011,94154
"2412","ENSACAG00000003013","4",55344072,55344509,437
"2413","ENSACAG00000003014","GL343875.1",55620,57797,2177
"2414","ENSACAG00000003015","2",51121721,51153032,31311
"2415","ENSACAG00000003016","GL343209.1",882795,911967,29172
"2416","ENSACAG00000003018","AAWZ02040777",21,6444,6423
"2417","ENSACAG00000003019","GL343979.1",87482,93815,6333
"2418","ENSACAG00000003020","5",3916207,3934718,18511
"2419","ENSACAG00000003021","GL343197.1",56710,94878,38168
"2420","ENSACAG00000003022","3",137745074,137753569,8495
"2421","ENSACAG00000003023","5",132570001,132976714,406713
"2422","ENSACAG00000003024","4",86769476,86975320,205844
"2423","ENSACAG00000003026","6",69002467,69075908,73441
"2424","ENSACAG00000003027","4",55500333,55680524,180191
"2425","ENSACAG00000003028","1",43715166,43730601,15435
"2426","ENSACAG00000003029","1",88216974,88235186,18212
"2427","ENSACAG00000003030","GL343523.1",438314,481356,43042
"2428","ENSACAG00000003031","GL343306.1",727404,773217,45813
"2429","ENSACAG00000003034","GL343466.1",460479,470285,9806
"2430","ENSACAG00000003035","5",113676330,113713827,37497
"2431","ENSACAG00000003036","AAWZ02039281",21,4029,4008
"2432","ENSACAG00000003037","LGf",2220353,2251354,31001
"2433","ENSACAG00000003038","5",118512476,118538168,25692
"2434","ENSACAG00000003039","4",10757617,10767854,10237
"2435","ENSACAG00000003040","GL343857.1",59173,151096,91923
"2436","ENSACAG00000003041","1",61643301,61705287,61986
"2437","ENSACAG00000003044","1",135860852,135874646,13794
"2438","ENSACAG00000003045","3",188598418,188669993,71575
"2439","ENSACAG00000003046","3",39161491,39162018,527
"2440","ENSACAG00000003047","GL343193.1",14131743,14186890,55147
"2441","ENSACAG00000003048","3",39126779,39157069,30290
"2442","ENSACAG00000003049","6",36030303,36037094,6791
"2443","ENSACAG00000003051","GL343693.1",227825,234276,6451
"2444","ENSACAG00000003052","GL343205.1",3943790,4086177,142387
"2445","ENSACAG00000003054","GL344397.1",31523,43057,11534
"2446","ENSACAG00000003055","5",54627965,54648975,21010
"2447","ENSACAG00000003056","3",137828481,137880426,51945
"2448","ENSACAG00000003059","4",119280581,119292506,11925
"2449","ENSACAG00000003060","GL343282.1",302046,313144,11098
"2450","ENSACAG00000003061","AAWZ02035066",30842,42749,11907
"2451","ENSACAG00000003064","3",188730232,188764173,33941
"2452","ENSACAG00000003065","GL343295.1",1152853,1169353,16500
"2453","ENSACAG00000003067","2",163284371,163290104,5733
"2454","ENSACAG00000003068","GL344055.1",1901,57511,55610
"2455","ENSACAG00000003070","GL344210.1",29132,62567,33435
"2456","ENSACAG00000003071","5",54682436,54798574,116138
"2457","ENSACAG00000003072","GL343221.1",1992585,2038721,46136
"2458","ENSACAG00000003074","1",88194806,88210084,15278
"2459","ENSACAG00000003075","GL343914.1",32899,83736,50837
"2460","ENSACAG00000003076","GL343802.1",115686,171078,55392
"2461","ENSACAG00000003077","4",55799949,55811716,11767
"2462","ENSACAG00000003078","GL343979.1",72160,76574,4414
"2463","ENSACAG00000003079","4",119264652,119277025,12373
"2464","ENSACAG00000003080","GL343257.1",531356,572640,41284
"2465","ENSACAG00000003082","1",102061152,102317064,255912
"2466","ENSACAG00000003083","GL343306.1",803284,839200,35916
"2467","ENSACAG00000003084","1",135884049,135913779,29730
"2468","ENSACAG00000003085","GL343209.1",968989,979502,10513
"2469","ENSACAG00000003086","5",55229141,55237674,8533
"2470","ENSACAG00000003088","AAWZ02037434",7354,13029,5675
"2471","ENSACAG00000003089","GL343693.1",158724,195342,36618
"2472","ENSACAG00000003090","4",130382670,130387388,4718
"2473","ENSACAG00000003091","GL343338.1",109121,113039,3918
"2474","ENSACAG00000003093","GL343221.1",2060267,2100738,40471
"2475","ENSACAG00000003094","1",211666769,211745235,78466
"2476","ENSACAG00000003095","4",55849625,55891918,42293
"2477","ENSACAG00000003096","GL343338.1",154659,161881,7222
"2478","ENSACAG00000003097","GL343205.1",3673862,3794713,120851
"2479","ENSACAG00000003098","4",87277932,87405993,128061
"2480","ENSACAG00000003099","LGf",2157487,2158176,689
"2481","ENSACAG00000003100","6",35938280,35999197,60917
"2482","ENSACAG00000003102","4",87405300,87456804,51504
"2483","ENSACAG00000003103","GL343736.1",5912,21922,16010
"2484","ENSACAG00000003104","GL343209.1",990143,1000707,10564
"2485","ENSACAG00000003105","3",39103762,39116306,12544
"2486","ENSACAG00000003106","4",119230864,119256570,25706
"2487","ENSACAG00000003107","3",188795027,188863814,68787
"2488","ENSACAG00000003108","LGf",2088296,2106706,18410
"2489","ENSACAG00000003109","GL343257.1",447472,529197,81725
"2490","ENSACAG00000003110","1",101370540,101863805,493265
"2491","ENSACAG00000003111","2",163190574,163277762,87188
"2492","ENSACAG00000003113","1",136433007,136452699,19692
"2493","ENSACAG00000003114","GL344540.1",15939,26376,10437
"2494","ENSACAG00000003116","5",50527945,50541723,13778
"2495","ENSACAG00000003117","GL343914.1",11079,25126,14047
"2496","ENSACAG00000003118","6",35847103,35848839,1736
"2497","ENSACAG00000003119","GL343428.1",156120,172896,16776
"2498","ENSACAG00000003120","4",130396386,130423038,26652
"2499","ENSACAG00000003121","GL343428.1",199656,225683,26027
"2500","ENSACAG00000003122","AAWZ02038736",420,10574,10154
"2501","ENSACAG00000003123","3",39109486,39109946,460
"2502","ENSACAG00000003124","4",87455776,87501486,45710
"2503","ENSACAG00000003125","5",50519772,50527795,8023
"2504","ENSACAG00000003127","GL343306.1",873701,874705,1004
"2505","ENSACAG00000003128","GL343947.1",40622,58062,17440
"2506","ENSACAG00000003130","GL343306.1",1001348,1034087,32739
"2507","ENSACAG00000003131","GL343802.1",84699,104349,19650
"2508","ENSACAG00000003132","1",43683048,43711020,27972
"2509","ENSACAG00000003135","GL343193.1",13176190,13351764,175574
"2510","ENSACAG00000003136","GL343367.1",5040,12724,7684
"2511","ENSACAG00000003137","4",87507858,87521157,13299
"2512","ENSACAG00000003138","2",51206366,51219100,12734
"2513","ENSACAG00000003139","GL343466.1",403687,447705,44018
"2514","ENSACAG00000003140","GL343338.1",166738,173782,7044
"2515","ENSACAG00000003141","3",38965655,39004618,38963
"2516","ENSACAG00000003142","6",8112544,8117708,5164
"2517","ENSACAG00000003143","1",88179178,88191938,12760
"2518","ENSACAG00000003144","GL343286.1",1215386,1235574,20188
"2519","ENSACAG00000003145","1",136751313,136788919,37606
"2520","ENSACAG00000003147","LGf",2000768,2083568,82800
"2521","ENSACAG00000003148","GL343914.1",9921,11890,1969
"2522","ENSACAG00000003149","5",55241279,55278527,37248
"2523","ENSACAG00000003150","GL344770.1",11317,21435,10118
"2524","ENSACAG00000003151","GL343914.1",23,9710,9687
"2525","ENSACAG00000003152","AAWZ02035066",54944,62673,7729
"2526","ENSACAG00000003153","2",82768703,82822065,53362
"2527","ENSACAG00000003154","5",50489074,50509237,20163
"2528","ENSACAG00000003155","6",8123987,8167517,43530
"2529","ENSACAG00000003156","1",61725592,61952680,227088
"2530","ENSACAG00000003157","GL343338.1",181181,184395,3214
"2531","ENSACAG00000003158","4",87534617,87603068,68451
"2532","ENSACAG00000003159","GL343428.1",269021,270343,1322
"2533","ENSACAG00000003160","6",68929981,68944676,14695
"2534","ENSACAG00000003161","GL343941.1",1493,10585,9092
"2535","ENSACAG00000003162","1",43623691,43665251,41560
"2536","ENSACAG00000003163","GL343428.1",280573,284063,3490
"2537","ENSACAG00000003164","1",101210470,101345189,134719
"2538","ENSACAG00000003165","3",138003141,138047480,44339
"2539","ENSACAG00000003166","GL343428.1",288353,303177,14824
"2540","ENSACAG00000003167","GL343193.1",12660019,12715928,55909
"2541","ENSACAG00000003168","5",3946892,3953744,6852
"2542","ENSACAG00000003169","GL343306.1",1040195,1045766,5571
"2543","ENSACAG00000003170","4",119140502,119150508,10006
"2544","ENSACAG00000003171","GL344071.1",94246,104159,9913
"2545","ENSACAG00000003172","5",55278327,55285534,7207
"2546","ENSACAG00000003173","GL343941.1",15879,26283,10404
"2547","ENSACAG00000003174","2",51148432,51275884,127452
"2548","ENSACAG00000003176","GL343802.1",26349,60195,33846
"2549","ENSACAG00000003177","GL343771.1",40749,72442,31693
"2550","ENSACAG00000003178","GL343649.1",120362,152870,32508
"2551","ENSACAG00000003184","1",88067553,88171693,104140
"2552","ENSACAG00000003185","3",138069642,138072773,3131
"2553","ENSACAG00000003186","GL343338.1",190379,199362,8983
"2554","ENSACAG00000003187","2",82835526,82896091,60565
"2555","ENSACAG00000003188","AAWZ02040866",817,2763,1946
"2556","ENSACAG00000003189","3",138088462,138130904,42442
"2557","ENSACAG00000003190","GL343306.1",1067313,1072088,4775
"2558","ENSACAG00000003191","4",56135591,56135893,302
"2559","ENSACAG00000003192","4",119122540,119133677,11137
"2560","ENSACAG00000003193","GL343466.1",381219,401753,20534
"2561","ENSACAG00000003194","GL345114.1",1132,7901,6769
"2562","ENSACAG00000003195","1",61969794,61976690,6896
"2563","ENSACAG00000003196","3",145091296,145127269,35973
"2564","ENSACAG00000003197","1",62669268,62691209,21941
"2565","ENSACAG00000003199","1",245070312,245129928,59616
"2566","ENSACAG00000003200","GL343736.1",32014,70163,38149
"2567","ENSACAG00000003201","GL343221.1",2201676,2444592,242916
"2568","ENSACAG00000003202","GL343909.1",7757,13765,6008
"2569","ENSACAG00000003203","4",56749954,56810319,60365
"2570","ENSACAG00000003204","5",55315245,55352809,37564
"2571","ENSACAG00000003205","GL343205.1",2928176,3023363,95187
"2572","ENSACAG00000003206","5",118414608,118507635,93027
"2573","ENSACAG00000003208","LGa",1404180,1482078,77898
"2574","ENSACAG00000003209","GL343643.1",1174,17884,16710
"2575","ENSACAG00000003210","3",188868624,188872605,3981
"2576","ENSACAG00000003211","1",218469527,218571129,101602
"2577","ENSACAG00000003212","4",17344005,17356287,12282
"2578","ENSACAG00000003213","1",224243155,224442845,199690
"2579","ENSACAG00000003214","GL343649.1",166882,171829,4947
"2580","ENSACAG00000003215","GL343257.1",439921,440919,998
"2581","ENSACAG00000003216","GL343306.1",1156868,1170739,13871
"2582","ENSACAG00000003217","3",38851756,38859378,7622
"2583","ENSACAG00000003220","GL343941.1",32844,35257,2413
"2584","ENSACAG00000003221","1",99535421,99984276,448855
"2585","ENSACAG00000003222","3",188887299,188947168,59869
"2586","ENSACAG00000003223","AAWZ02038242",5364,9744,4380
"2587","ENSACAG00000003225","1",211778053,211817166,39113
"2588","ENSACAG00000003227","2",51286088,51348777,62689
"2589","ENSACAG00000003228","GL343947.1",60391,64261,3870
"2590","ENSACAG00000003229","GL344387.1",29585,43742,14157
"2591","ENSACAG00000003230","GL343197.1",47798,51495,3697
"2592","ENSACAG00000003231","6",8204506,8579831,375325
"2593","ENSACAG00000003232","5",50456954,50477532,20578
"2594","ENSACAG00000003233","4",56863232,56877686,14454
"2595","ENSACAG00000003234","1",43599498,43616397,16899
"2596","ENSACAG00000003235","GL344508.1",4050,36511,32461
"2597","ENSACAG00000003237","GL343257.1",173957,348403,174446
"2598","ENSACAG00000003238","GL343286.1",1188429,1190063,1634
"2599","ENSACAG00000003239","GL343465.1",765624,770622,4998
"2600","ENSACAG00000003240","GL343941.1",38668,93619,54951
"2601","ENSACAG00000003242","GL343947.1",68401,78772,10371
"2602","ENSACAG00000003243","1",43580704,43599325,18621
"2603","ENSACAG00000003244","GL343286.1",1162197,1174908,12711
"2604","ENSACAG00000003246","GL343649.1",177805,263715,85910
"2605","ENSACAG00000003248","GL343693.1",101564,147072,45508
"2606","ENSACAG00000003249","3",145082447,145083793,1346
"2607","ENSACAG00000003250","GL343306.1",1169225,1174335,5110
"2608","ENSACAG00000003251","1",244873141,244874203,1062
"2609","ENSACAG00000003252","GL343519.1",366887,379711,12824
"2610","ENSACAG00000003254","GL343605.1",46318,317334,271016
"2611","ENSACAG00000003255","GL343465.1",735609,750645,15036
"2612","ENSACAG00000003256","GL343306.1",1221541,1324831,103290
"2613","ENSACAG00000003258","GL343461.1",128311,154556,26245
"2614","ENSACAG00000003259","GL343193.1",12540469,12572985,32516
"2615","ENSACAG00000003260","GL343286.1",1149029,1158363,9334
"2616","ENSACAG00000003261","4",87618199,87619260,1061
"2617","ENSACAG00000003262","2",51368864,51523468,154604
"2618","ENSACAG00000003263","3",38824577,38834920,10343
"2619","ENSACAG00000003264","GL343338.1",203364,228851,25487
"2620","ENSACAG00000003265","4",17437297,17541896,104599
"2621","ENSACAG00000003266","4",87675652,87686406,10754
"2622","ENSACAG00000003267","3",100435670,100574569,138899
"2623","ENSACAG00000003268","AAWZ02037269",2715,17338,14623
"2624","ENSACAG00000003269","1",224484238,224498318,14080
"2625","ENSACAG00000003270","1",209990904,210137881,146977
"2626","ENSACAG00000003271","GL344464.1",25219,32484,7265
"2627","ENSACAG00000003273","6",68783671,68836788,53117
"2628","ENSACAG00000003274","GL343466.1",353349,381727,28378
"2629","ENSACAG00000003277","GL343461.1",163032,348814,185782
"2630","ENSACAG00000003279","GL343802.1",16736,24810,8074
"2631","ENSACAG00000003280","1",43433545,43572838,139293
"2632","ENSACAG00000003281","GL343802.1",3625,10477,6852
"2633","ENSACAG00000003282","GL343286.1",1092498,1109476,16978
"2634","ENSACAG00000003283","6",68690136,68690918,782
"2635","ENSACAG00000003284","4",56890862,56918252,27390
"2636","ENSACAG00000003286","GL343286.1",1060681,1075565,14884
"2637","ENSACAG00000003288","1",255717289,255739129,21840
"2638","ENSACAG00000003289","GL343257.1",260464,322819,62355
"2639","ENSACAG00000003290","4",87721367,87728259,6892
"2640","ENSACAG00000003292","3",27525279,27535306,10027
"2641","ENSACAG00000003293","GL343466.1",342647,343860,1213
"2642","ENSACAG00000003294","4",130445325,130452152,6827
"2643","ENSACAG00000003299","GL343580.1",485125,523731,38606
"2644","ENSACAG00000003302","1",255741229,255748489,7260
"2645","ENSACAG00000003304","2",82971566,82971985,419
"2646","ENSACAG00000003305","GL343306.1",1494109,1527270,33161
"2647","ENSACAG00000003306","GL343205.1",2885730,2886638,908
"2648","ENSACAG00000003307","GL343643.1",21145,32610,11465
"2649","ENSACAG00000003308","6",68558456,68599859,41403
"2650","ENSACAG00000003309","GL343264.1",488959,516908,27949
"2651","ENSACAG00000003311","GL343264.1",464765,487359,22594
"2652","ENSACAG00000003314","1",136796646,136811637,14991
"2653","ENSACAG00000003315","5",118049868,118130043,80175
"2654","ENSACAG00000003316","4",56922935,56939755,16820
"2655","ENSACAG00000003317","GL343947.1",83657,85469,1812
"2656","ENSACAG00000003318","1",178427592,178647326,219734
"2657","ENSACAG00000003319","1",210243833,210598529,354696
"2658","ENSACAG00000003320","GL343481.1",323435,324899,1464
"2659","ENSACAG00000003321","1",43262008,43394492,132484
"2660","ENSACAG00000003323","3",189155641,189158228,2587
"2661","ENSACAG00000003325","GL343338.1",232812,254615,21803
"2662","ENSACAG00000003326","GL343481.1",314239,490910,176671
"2663","ENSACAG00000003327","2",83059586,83085366,25780
"2664","ENSACAG00000003328","1",255751249,255773078,21829
"2665","ENSACAG00000003329","3",100319723,100417964,98241
"2666","ENSACAG00000003330","GL343205.1",2839547,2849523,9976
"2667","ENSACAG00000003331","GL343580.1",301242,312387,11145
"2668","ENSACAG00000003333","AAWZ02041427",2107,3525,1418
"2669","ENSACAG00000003335","GL343807.1",121439,201271,79832
"2670","ENSACAG00000003336","4",130492825,130518274,25449
"2671","ENSACAG00000003338","GL343286.1",1006426,1015158,8732
"2672","ENSACAG00000003339","1",136839729,136863476,23747
"2673","ENSACAG00000003340","GL343947.1",86484,95270,8786
"2674","ENSACAG00000003341","3",27506757,27524849,18092
"2675","ENSACAG00000003343","GL343614.1",322060,351360,29300
"2676","ENSACAG00000003344","GL343488.1",499154,523793,24639
"2677","ENSACAG00000003345","GL343278.1",122167,199240,77073
"2678","ENSACAG00000003346","GL344496.1",4550,5206,656
"2679","ENSACAG00000003347","GL343519.1",357140,363781,6641
"2680","ENSACAG00000003350","GL344013.1",84366,87126,2760
"2681","ENSACAG00000003351","GL343465.1",715381,721067,5686
"2682","ENSACAG00000003352","GL343803.1",64722,142160,77438
"2683","ENSACAG00000003353","GL343264.1",481651,482382,731
"2684","ENSACAG00000003354","4",17706169,17848839,142670
"2685","ENSACAG00000003355","GL343264.1",446821,461624,14803
"2686","ENSACAG00000003356","1",216153367,216236421,83054
"2687","ENSACAG00000003357","GL343612.1",298440,317860,19420
"2688","ENSACAG00000003358","6",68512743,68533019,20276
"2689","ENSACAG00000003359","GL343909.1",90878,109230,18352
"2690","ENSACAG00000003360","GL343319.1",228678,250047,21369
"2691","ENSACAG00000003362","GL343612.1",276151,295023,18872
"2692","ENSACAG00000003363","GL344013.1",101234,109988,8754
"2693","ENSACAG00000003364","5",50373845,50429041,55196
"2694","ENSACAG00000003365","GL343466.1",287338,287727,389
"2695","ENSACAG00000003367","3",38777534,38800761,23227
"2696","ENSACAG00000003368","5",117972603,118002428,29825
"2697","ENSACAG00000003369","GL343205.1",2820323,2837584,17261
"2698","ENSACAG00000003370","GL343466.1",265902,266282,380
"2699","ENSACAG00000003371","LGa",1388888,1395010,6122
"2700","ENSACAG00000003373","GL343466.1",243009,243389,380
"2701","ENSACAG00000003374","2",51628055,51837325,209270
"2702","ENSACAG00000003375","3",99931216,99957580,26364
"2703","ENSACAG00000003376","GL343465.1",664608,691352,26744
"2704","ENSACAG00000003377","4",119087442,119104236,16794
"2705","ENSACAG00000003378","GL344283.1",26799,46305,19506
"2706","ENSACAG00000003380","4",119108959,119116195,7236
"2707","ENSACAG00000003381","GL343466.1",242198,242587,389
"2708","ENSACAG00000003382","GL343286.1",990031,1001683,11652
"2709","ENSACAG00000003384","LGa",1316547,1348136,31589
"2710","ENSACAG00000003385","GL343488.1",563768,582862,19094
"2711","ENSACAG00000003386","5",117947336,117960725,13389
"2712","ENSACAG00000003388","GL343466.1",238996,239406,410
"2713","ENSACAG00000003389","GL344283.1",43435,55286,11851
"2714","ENSACAG00000003390","4",56947532,56948737,1205
"2715","ENSACAG00000003391","GL343466.1",207082,233807,26725
"2716","ENSACAG00000003392","GL343319.1",299510,397264,97754
"2717","ENSACAG00000003394","1",216290405,216299813,9408
"2718","ENSACAG00000003395","6",68478056,68510051,31995
"2719","ENSACAG00000003396","5",50340442,50364602,24160
"2720","ENSACAG00000003397","GL343205.1",2737376,2809672,72296
"2721","ENSACAG00000003398","4",56974379,57043208,68829
"2722","ENSACAG00000003399","2",83128892,83157173,28281
"2723","ENSACAG00000003401","GL343193.1",12347333,12473407,126074
"2724","ENSACAG00000003402","GL343414.1",12413,56873,44460
"2725","ENSACAG00000003403","GL343338.1",267507,272525,5018
"2726","ENSACAG00000003405","4",130645499,130661220,15721
"2727","ENSACAG00000003406","4",130662131,130678633,16502
"2728","ENSACAG00000003407","GL343264.1",420261,435775,15514
"2729","ENSACAG00000003408","GL343264.1",380127,416518,36391
"2730","ENSACAG00000003409","4",87728564,87747413,18849
"2731","ENSACAG00000003410","GL343612.1",266248,277322,11074
"2732","ENSACAG00000003412","GL343481.1",607714,608533,819
"2733","ENSACAG00000003413","1",136867520,136935223,67703
"2734","ENSACAG00000003414","GL343257.1",176952,240857,63905
"2735","ENSACAG00000003415","GL343481.1",612315,621070,8755
"2736","ENSACAG00000003417","GL343519.1",282248,338913,56665
"2737","ENSACAG00000003418","1",255790875,255792220,1345
"2738","ENSACAG00000003420","1",255800962,255940358,139396
"2739","ENSACAG00000003421","GL343278.1",245611,345803,100192
"2740","ENSACAG00000003422","1",216322905,216345855,22950
"2741","ENSACAG00000003423","1",211822897,211848883,25986
"2742","ENSACAG00000003424","GL343614.1",276060,319574,43514
"2743","ENSACAG00000003425","GL343947.1",93986,102414,8428
"2744","ENSACAG00000003426","GL343319.1",468920,484975,16055
"2745","ENSACAG00000003427","GL343193.1",12285982,12297130,11148
"2746","ENSACAG00000003428","GL343286.1",891967,921510,29543
"2747","ENSACAG00000003429","3",38688044,38739647,51603
"2748","ENSACAG00000003430","GL343278.1",408251,441175,32924
"2749","ENSACAG00000003431","GL343494.1",173381,222979,49598
"2750","ENSACAG00000003433","2",51936577,52000788,64211
"2751","ENSACAG00000003434","GL343612.1",261622,266110,4488
"2752","ENSACAG00000003435","4",130686884,130754960,68076
"2753","ENSACAG00000003436","GL343643.1",32383,33870,1487
"2754","ENSACAG00000003437","4",18287597,18431350,143753
"2755","ENSACAG00000003438","GL343643.1",38676,46203,7527
"2756","ENSACAG00000003439","GL344460.1",2124,8633,6509
"2757","ENSACAG00000003440","4",18683550,18698866,15316
"2758","ENSACAG00000003441","GL343338.1",278336,342914,64578
"2759","ENSACAG00000003442","5",50263893,50330161,66268
"2760","ENSACAG00000003443","GL343264.1",221330,336666,115336
"2761","ENSACAG00000003444","GL343257.1",110035,124101,14066
"2762","ENSACAG00000003445","GL343612.1",248601,260071,11470
"2763","ENSACAG00000003446","GL343926.1",88200,115086,26886
"2764","ENSACAG00000003447","GL343625.1",57476,86902,29426
"2765","ENSACAG00000003448","GL343612.1",233374,247891,14517
"2766","ENSACAG00000003449","GL343193.1",12206862,12285820,78958
"2767","ENSACAG00000003450","GL343519.1",250386,280030,29644
"2768","ENSACAG00000003451","GL343193.1",12173354,12204015,30661
"2769","ENSACAG00000003452","1",211874719,211897469,22750
"2770","ENSACAG00000003453","GL343711.1",1620,7209,5589
"2771","ENSACAG00000003455","GL343614.1",225716,254675,28959
"2772","ENSACAG00000003456","4",87748549,87757223,8674
"2773","ENSACAG00000003457","AAWZ02038838",1587,10211,8624
"2774","ENSACAG00000003458","4",119000203,119017951,17748
"2775","ENSACAG00000003459","GL343264.1",274159,285483,11324
"2776","ENSACAG00000003460","GL343319.1",527921,570877,42956
"2777","ENSACAG00000003462","1",216491164,216544318,53154
"2778","ENSACAG00000003463","4",18705456,18724572,19116
"2779","ENSACAG00000003464","4",130884200,130884781,581
"2780","ENSACAG00000003465","GL343909.1",121519,124272,2753
"2781","ENSACAG00000003466","1",216582886,216584154,1268
"2782","ENSACAG00000003467","GL343461.1",588141,608138,19997
"2783","ENSACAG00000003468","1",216603269,216800432,197163
"2784","ENSACAG00000003469","AAWZ02040390",1729,6529,4800
"2785","ENSACAG00000003470","LGa",1194413,1224725,30312
"2786","ENSACAG00000003471","4",131068749,131098371,29622
"2787","ENSACAG00000003473","5",50156701,50210806,54105
"2788","ENSACAG00000003474","4",18731127,18772485,41358
"2789","ENSACAG00000003475","3",27485312,27496564,11252
"2790","ENSACAG00000003476","GL343643.1",46358,49390,3032
"2791","ENSACAG00000003477","5",50101435,50132527,31092
"2792","ENSACAG00000003478","GL343580.1",215255,261394,46139
"2793","ENSACAG00000003480","LGa",1090405,1146967,56562
"2794","ENSACAG00000003482","3",99681088,99756282,75194
"2795","ENSACAG00000003483","GL343264.1",49034,68091,19057
"2796","ENSACAG00000003484","GL343278.1",448337,512683,64346
"2797","ENSACAG00000003485","6",68408242,68415673,7431
"2798","ENSACAG00000003486","GL344077.1",5429,20957,15528
"2799","ENSACAG00000003487","LGa",477486,479306,1820
"2800","ENSACAG00000003488","GL344447.1",1486,26154,24668
"2801","ENSACAG00000003489","GL343643.1",50542,53248,2706
"2802","ENSACAG00000003490","3",27439066,27452516,13450
"2803","ENSACAG00000003491","4",131135278,131135466,188
"2804","ENSACAG00000003492","GL343612.1",214229,230149,15920
"2805","ENSACAG00000003494","4",131157664,131211879,54215
"2806","ENSACAG00000003495","5",132979442,133090561,111119
"2807","ENSACAG00000003496","6",68362453,68402550,40097
"2808","ENSACAG00000003497","GL343643.1",55815,67414,11599
"2809","ENSACAG00000003498","4",87757652,87771621,13969
"2810","ENSACAG00000003499","GL343286.1",870158,891135,20977
"2811","ENSACAG00000003500","LGa",355097,361746,6649
"2812","ENSACAG00000003501","GL343947.1",105099,115742,10643
"2813","ENSACAG00000003503","GL343414.1",136385,166660,30275
"2814","ENSACAG00000003504","5",50022759,50097445,74686
"2815","ENSACAG00000003505","LGa",8427,52486,44059
"2816","ENSACAG00000003506","GL343693.1",4388,101039,96651
"2817","ENSACAG00000003507","GL343256.1",99086,231029,131943
"2818","ENSACAG00000003508","GL343711.1",17266,36784,19518
"2819","ENSACAG00000003509","4",131268581,131318455,49874
"2820","ENSACAG00000003510","GL343205.1",2728246,2733784,5538
"2821","ENSACAG00000003511","3",27291628,27394841,103213
"2822","ENSACAG00000003512","5",117906238,117943064,36826
"2823","ENSACAG00000003514","3",26660299,27047902,387603
"2824","ENSACAG00000003515","GL343614.1",204627,219897,15270
"2825","ENSACAG00000003517","GL343257.1",97489,106836,9347
"2826","ENSACAG00000003518","GL344077.1",58242,69328,11086
"2827","ENSACAG00000003520","GL343319.1",580199,614934,34735
"2828","ENSACAG00000003521","1",98826868,99112762,285894
"2829","ENSACAG00000003522","GL343643.1",82996,97930,14934
"2830","ENSACAG00000003523","GL343256.1",298124,305603,7479
"2831","ENSACAG00000003524","3",38490843,38520912,30069
"2832","ENSACAG00000003525","GL343264.1",7037,12690,5653
"2833","ENSACAG00000003527","GL343256.1",309287,317160,7873
"2834","ENSACAG00000003528","4",87782312,87804592,22280
"2835","ENSACAG00000003529","GL343465.1",635376,659621,24245
"2836","ENSACAG00000003530","GL343643.1",123922,145470,21548
"2837","ENSACAG00000003531","1",41836540,41890581,54041
"2838","ENSACAG00000003534","GL343519.1",219460,230032,10572
"2839","ENSACAG00000003535","GL343205.1",2626804,2701859,75055
"2840","ENSACAG00000003536","GL344077.1",69729,74354,4625
"2841","ENSACAG00000003537","GL343218.1",2116834,2141548,24714
"2842","ENSACAG00000003538","4",57071843,57082950,11107
"2843","ENSACAG00000003540","3",99651242,99651709,467
"2844","ENSACAG00000003541","GL343676.1",269413,271071,1658
"2845","ENSACAG00000003543","AAWZ02038342",920,12010,11090
"2846","ENSACAG00000003544","5",117791977,117840421,48444
"2847","ENSACAG00000003545","GL343535.1",269412,450507,181095
"2848","ENSACAG00000003547","GL343466.1",186207,197898,11691
"2849","ENSACAG00000003549","GL343302.1",33745,34076,331
"2850","ENSACAG00000003550","3",99366299,99649987,283688
"2851","ENSACAG00000003551","GL343733.1",236350,240581,4231
"2852","ENSACAG00000003552","4",18793095,18794705,1610
"2853","ENSACAG00000003553","4",18877410,18922494,45084
"2854","ENSACAG00000003554","GL343256.1",337627,378157,40530
"2855","ENSACAG00000003555","GL343302.1",1289,95539,94250
"2856","ENSACAG00000003556","GL343286.1",835325,840735,5410
"2857","ENSACAG00000003557","GL343414.1",176674,200110,23436
"2858","ENSACAG00000003558","GL343302.1",166670,256819,90149
"2859","ENSACAG00000003559","GL344077.1",81908,83806,1898
"2860","ENSACAG00000003560","GL343286.1",827241,829322,2081
"2861","ENSACAG00000003561","GL343711.1",154096,160077,5981
"2862","ENSACAG00000003562","GL344077.1",85909,105402,19493
"2863","ENSACAG00000003563","GL343466.1",168780,181409,12629
"2864","ENSACAG00000003564","GL343733.1",239737,277159,37422
"2865","ENSACAG00000003566","6",46963049,47003873,40824
"2866","ENSACAG00000003567","GL343488.1",601164,608571,7407
"2867","ENSACAG00000003568","GL343711.1",184516,191344,6828
"2868","ENSACAG00000003571","GL343302.1",301234,310166,8932
"2869","ENSACAG00000003572","4",87809658,87835777,26119
"2870","ENSACAG00000003573","GL343221.1",2539044,2614208,75164
"2871","ENSACAG00000003574","GL343649.1",284899,298558,13659
"2872","ENSACAG00000003576","GL343286.1",779230,806310,27080
"2873","ENSACAG00000003577","GL343283.1",1275,57379,56104
"2874","ENSACAG00000003578","2",52081687,52095268,13581
"2875","ENSACAG00000003579","GL343614.1",191216,201021,9805
"2876","ENSACAG00000003580","GL343414.1",211192,272654,61462
"2877","ENSACAG00000003581","GL343257.1",76169,84392,8223
"2878","ENSACAG00000003582","GL343466.1",159822,166064,6242
"2879","ENSACAG00000003583","3",38473516,38490723,17207
"2880","ENSACAG00000003586","GL343612.1",190696,201302,10606
"2881","ENSACAG00000003587","GL343612.1",175450,179055,3605
"2882","ENSACAG00000003589","1",255999555,256018620,19065
"2883","ENSACAG00000003590","AAWZ02036629",2465,23878,21413
"2884","ENSACAG00000003591","GL343612.1",167153,175342,8189
"2885","ENSACAG00000003592","5",117775344,117789726,14382
"2886","ENSACAG00000003593","4",131354171,131387660,33489
"2887","ENSACAG00000003594","GL343465.1",621226,634635,13409
"2888","ENSACAG00000003595","GL343256.1",377964,543894,165930
"2889","ENSACAG00000003596","GL343465.1",559025,595381,36356
"2890","ENSACAG00000003599","GL343319.1",620626,660449,39823
"2891","ENSACAG00000003600","2",199318730,199339178,20448
"2892","ENSACAG00000003601","GL343257.1",70236,71351,1115
"2893","ENSACAG00000003603","GL343257.1",1674,60736,59062
"2894","ENSACAG00000003604","4",57091947,57130816,38869
"2895","ENSACAG00000003605","2",52100619,52113293,12674
"2896","ENSACAG00000003606","GL343466.1",105004,155473,50469
"2897","ENSACAG00000003607","GL343218.1",2262304,2305363,43059
"2898","ENSACAG00000003608","GL343614.1",150633,189451,38818
"2899","ENSACAG00000003609","AAWZ02040588",2238,3211,973
"2900","ENSACAG00000003611","GL343488.1",613115,618281,5166
"2901","ENSACAG00000003612","5",133739994,133913452,173458
"2902","ENSACAG00000003613","GL343302.1",712697,743258,30561
"2903","ENSACAG00000003614","GL343612.1",162675,168042,5367
"2904","ENSACAG00000003615","GL345020.1",2697,13487,10790
"2905","ENSACAG00000003616","4",156455858,156476054,20196
"2906","ENSACAG00000003618","5",117640333,117743590,103257
"2907","ENSACAG00000003619","GL343338.1",363576,389260,25684
"2908","ENSACAG00000003620","1",256018412,256061792,43380
"2909","ENSACAG00000003621","4",49310842,49326578,15736
"2910","ENSACAG00000003622","2",199241735,199267307,25572
"2911","ENSACAG00000003624","GL343950.1",105208,107407,2199
"2912","ENSACAG00000003625","GL343950.1",90705,99532,8827
"2913","ENSACAG00000003627","4",87854978,87880791,25813
"2914","ENSACAG00000003628","1",218291482,218328005,36523
"2915","ENSACAG00000003629","2",95392446,95393942,1496
"2916","ENSACAG00000003630","GL343274.1",1268879,1309429,40550
"2917","ENSACAG00000003631","4",156380654,156449646,68992
"2918","ENSACAG00000003633","GL343488.1",622831,632022,9191
"2919","ENSACAG00000003634","5",27270816,27325510,54694
"2920","ENSACAG00000003636","AAWZ02036536",8178,24816,16638
"2921","ENSACAG00000003637","4",49231635,49258162,26527
"2922","ENSACAG00000003638","GL343649.1",302174,332378,30204
"2923","ENSACAG00000003639","1",217192274,217194085,1811
"2924","ENSACAG00000003640","2",52118715,52148406,29691
"2925","ENSACAG00000003641","GL345008.1",11239,11481,242
"2926","ENSACAG00000003642","GL343302.1",1214914,1225464,10550
"2927","ENSACAG00000003643","GL343338.1",394128,411754,17626
"2928","ENSACAG00000003644","GL343302.1",1228521,1236760,8239
"2929","ENSACAG00000003646","1",216898423,217140654,242231
"2930","ENSACAG00000003647","GL343783.1",294,43472,43178
"2931","ENSACAG00000003648","4",57161976,57179361,17385
"2932","ENSACAG00000003649","AAWZ02036351",6427,25727,19300
"2933","ENSACAG00000003650","1",211901351,211922466,21115
"2934","ENSACAG00000003652","1",245133604,245191322,57718
"2935","ENSACAG00000003653","4",49192996,49228230,35234
"2936","ENSACAG00000003654","4",18943399,18955846,12447
"2937","ENSACAG00000003655","GL343414.1",302380,423848,121468
"2938","ENSACAG00000003657","GL343711.1",198830,209072,10242
"2939","ENSACAG00000003658","GL344971.1",11783,14851,3068
"2940","ENSACAG00000003659","GL343465.1",513064,532246,19182
"2941","ENSACAG00000003660","GL343643.1",151524,157155,5631
"2942","ENSACAG00000003661","AAWZ02039660",844,7588,6744
"2943","ENSACAG00000003663","4",156248158,156284239,36081
"2944","ENSACAG00000003664","1",211936497,212030645,94148
"2945","ENSACAG00000003668","4",57230499,57231239,740
"2946","ENSACAG00000003669","4",57920278,58161348,241070
"2947","ENSACAG00000003671","4",18975516,19014898,39382
"2948","ENSACAG00000003672","4",131460969,131469155,8186
"2949","ENSACAG00000003673","2",52172417,52285421,113004
"2950","ENSACAG00000003674","GL343302.1",1289228,1317113,27885
"2951","ENSACAG00000003676","1",41790852,41812036,21184
"2952","ENSACAG00000003677","GL343519.1",195630,197177,1547
"2953","ENSACAG00000003678","LGf",1988532,1999118,10586
"2954","ENSACAG00000003679","GL343519.1",136762,194116,57354
"2955","ENSACAG00000003680","GL343338.1",430653,450808,20155
"2956","ENSACAG00000003681","3",99290144,99295679,5535
"2957","ENSACAG00000003682","GL343193.1",11785837,11805835,19998
"2958","ENSACAG00000003684","3",38400551,38400946,395
"2959","ENSACAG00000003685","GL343950.1",88559,90307,1748
"2960","ENSACAG00000003686","4",147844239,147981747,137508
"2961","ENSACAG00000003687","3",38383922,38387264,3342
"2962","ENSACAG00000003688","GL343950.1",73263,77044,3781
"2963","ENSACAG00000003689","GL343580.1",164099,213780,49681
"2964","ENSACAG00000003690","GL343205.1",2576217,2621650,45433
"2965","ENSACAG00000003692","1",256066436,256103554,37118
"2966","ENSACAG00000003693","LGf",4006707,4019213,12506
"2967","ENSACAG00000003694","1",41764837,41786093,21256
"2968","ENSACAG00000003695","GL343950.1",64924,73433,8509
"2969","ENSACAG00000003696","GL344716.1",482,15194,14712
"2970","ENSACAG00000003697","GL343643.1",158729,173007,14278
"2971","ENSACAG00000003698","GL343193.1",11729840,11748537,18697
"2972","ENSACAG00000003699","GL343649.1",345319,347055,1736
"2973","ENSACAG00000003701","3",99260063,99269560,9497
"2974","ENSACAG00000003702","3",38362680,38378430,15750
"2975","ENSACAG00000003703","LGf",3960596,3975633,15037
"2976","ENSACAG00000003704","GL343941.1",92992,112091,19099
"2977","ENSACAG00000003705","1",216843464,216895144,51680
"2978","ENSACAG00000003706","GL343218.1",2364834,2377765,12931
"2979","ENSACAG00000003707","GL343319.1",714910,742089,27179
"2980","ENSACAG00000003708","4",131522121,131522549,428
"2981","ENSACAG00000003709","GL343283.1",80382,81072,690
"2982","ENSACAG00000003710","4",131542858,131576325,33467
"2983","ENSACAG00000003711","GL343283.1",111605,174028,62423
"2984","ENSACAG00000003712","GL343569.1",56952,119638,62686
"2985","ENSACAG00000003713","GL343532.1",13578,48165,34587
"2986","ENSACAG00000003714","GL343302.1",1323368,1360771,37403
"2987","ENSACAG00000003716","AAWZ02038659",1772,10216,8444
"2988","ENSACAG00000003717","5",133922213,134069772,147559
"2989","ENSACAG00000003719","4",8980038,9346972,366934
"2990","ENSACAG00000003720","GL343221.1",758377,1021772,263395
"2991","ENSACAG00000003721","GL343535.1",12965,28168,15203
"2992","ENSACAG00000003722","GL343747.1",208461,217692,9231
"2993","ENSACAG00000003723","4",49139142,49171069,31927
"2994","ENSACAG00000003724","GL343860.1",2923,48979,46056
"2995","ENSACAG00000003726","1",41737496,41752994,15498
"2996","ENSACAG00000003727","4",49065318,49089879,24561
"2997","ENSACAG00000003728","4",19002409,19008734,6325
"2998","ENSACAG00000003732","GL343286.1",757964,768737,10773
"2999","ENSACAG00000003733","4",19037927,19068865,30938
"3000","ENSACAG00000003734","GL343414.1",463724,506372,42648
"3001","ENSACAG00000003735","1",41731000,41737326,6326
"3002","ENSACAG00000003736","GL343319.1",779898,797029,17131
"3003","ENSACAG00000003737","GL343950.1",54064,64636,10572
"3004","ENSACAG00000003738","GL343643.1",172190,214414,42224
"3005","ENSACAG00000003739","AAWZ02037012",2118,3260,1142
"3006","ENSACAG00000003740","GL344688.1",1568,11726,10158
"3007","ENSACAG00000003741","GL343580.1",155418,157600,2182
"3008","ENSACAG00000003742","AAWZ02037432",5903,11785,5882
"3009","ENSACAG00000003743","GL343950.1",31703,52971,21268
"3010","ENSACAG00000003744","GL343465.1",461128,468291,7163
"3011","ENSACAG00000003745","4",131587992,131761342,173350
"3012","ENSACAG00000003746","AAWZ02036440",3231,3596,365
"3013","ENSACAG00000003747","4",49035787,49056168,20381
"3014","ENSACAG00000003748","4",19077817,19119926,42109
"3015","ENSACAG00000003749","GL343950.1",3323,24028,20705
"3016","ENSACAG00000003751","6",68284072,68316559,32487
"3017","ENSACAG00000003752","GL344471.1",20974,22974,2000
"3018","ENSACAG00000003753","GL343414.1",511652,536409,24757
"3019","ENSACAG00000003754","GL343907.1",115196,131468,16272
"3020","ENSACAG00000003755","1",41696699,41729364,32665
"3021","ENSACAG00000003756","GL343338.1",451988,456025,4037
"3022","ENSACAG00000003757","GL343494.1",118344,132674,14330
"3023","ENSACAG00000003758","GL343580.1",105811,135519,29708
"3024","ENSACAG00000003759","LGf",1900625,1957938,57313
"3025","ENSACAG00000003761","GL343611.1",148977,150365,1388
"3026","ENSACAG00000003762","4",58136071,58241552,105481
"3027","ENSACAG00000003763","GL343226.1",2378999,2405287,26288
"3028","ENSACAG00000003766","GL343494.1",52816,59894,7078
"3029","ENSACAG00000003767","3",38338187,38346065,7878
"3030","ENSACAG00000003768","GL343430.1",686187,773002,86815
"3031","ENSACAG00000003769","GL343302.1",1360836,1567299,206463
"3032","ENSACAG00000003770","3",23583599,23670714,87115
"3033","ENSACAG00000003771","GL343319.1",812084,855750,43666
"3034","ENSACAG00000003772","GL343286.1",744860,751066,6206
"3035","ENSACAG00000003773","GL343519.1",108822,134647,25825
"3036","ENSACAG00000003776","GL344262.1",11099,26664,15565
"3037","ENSACAG00000003777","GL343747.1",201044,209983,8939
"3038","ENSACAG00000003778","4",49007743,49019165,11422
"3039","ENSACAG00000003779","GL343193.1",11672801,11725911,53110
"3040","ENSACAG00000003780","4",48981562,48998907,17345
"3041","ENSACAG00000003781","GL343284.1",1602230,1752937,150707
"3042","ENSACAG00000003782","GL343319.1",1110615,1201117,90502
"3043","ENSACAG00000003783","3",39284052,39292675,8623
"3044","ENSACAG00000003784","LGf",3933928,3960911,26983
"3045","ENSACAG00000003785","GL343747.1",82531,196635,114104
"3046","ENSACAG00000003786","GL343414.1",600475,625702,25227
"3047","ENSACAG00000003787","4",19208299,19239286,30987
"3048","ENSACAG00000003788","GL343284.1",1362242,1372712,10470
"3049","ENSACAG00000003789","4",48323857,48461751,137894
"3050","ENSACAG00000003790","1",196518684,196533404,14720
"3051","ENSACAG00000003791","GL343788.1",29355,100520,71165
"3052","ENSACAG00000003792","LGf",3872112,3902184,30072
"3053","ENSACAG00000003793","GL343193.1",11009884,11111238,101354
"3054","ENSACAG00000003794","GL343286.1",724232,740173,15941
"3055","ENSACAG00000003795","LGf",3811580,3821850,10270
"3056","ENSACAG00000003796","GL343193.1",10529507,10604609,75102
"3057","ENSACAG00000003797","3",38322519,38334738,12219
"3058","ENSACAG00000003798","3",39293908,39301299,7391
"3059","ENSACAG00000003799","GL343284.1",1226958,1247234,20276
"3060","ENSACAG00000003800","6",68289536,68297136,7600
"3061","ENSACAG00000003801","GL343575.1",377918,402975,25057
"3062","ENSACAG00000003802","GL343532.1",188055,217003,28948
"3063","ENSACAG00000003803","1",196533493,196536825,3332
"3064","ENSACAG00000003806","1",196614554,196634738,20184
"3065","ENSACAG00000003807","GL343286.1",678687,694404,15717
"3066","ENSACAG00000003808","GL343286.1",638409,669047,30638
"3067","ENSACAG00000003809","GL343360.1",270345,279745,9400
"3068","ENSACAG00000003811","GL343284.1",935912,959297,23385
"3069","ENSACAG00000003812","6",78654645,78729539,74894
"3070","ENSACAG00000003813","5",134071817,134088240,16423
"3071","ENSACAG00000003815","3",39307632,39473738,166106
"3072","ENSACAG00000003816","4",58372670,58385955,13285
"3073","ENSACAG00000003817","GL343256.1",877695,909781,32086
"3074","ENSACAG00000003818","GL343328.1",248997,249700,703
"3075","ENSACAG00000003819","GL343338.1",456686,488905,32219
"3076","ENSACAG00000003820","6",68255346,68265969,10623
"3077","ENSACAG00000003823","6",68208253,68253854,45601
"3078","ENSACAG00000003824","GL343226.1",2314446,2372767,58321
"3079","ENSACAG00000003825","GL343286.1",600869,627684,26815
"3080","ENSACAG00000003826","GL344262.1",52670,70344,17674
"3081","ENSACAG00000003827","3",23670816,23710982,40166
"3082","ENSACAG00000003828","4",48247810,48258312,10502
"3083","ENSACAG00000003829","GL343907.1",103736,104167,431
"3084","ENSACAG00000003830","3",23742830,23746420,3590
"3085","ENSACAG00000003831","GL344812.1",9673,14097,4424
"3086","ENSACAG00000003832","GL343907.1",42045,43424,1379
"3087","ENSACAG00000003834","3",149245072,149246854,1782
"3088","ENSACAG00000003835","GL343532.1",306904,373239,66335
"3089","ENSACAG00000003836","GL343907.1",39115,40443,1328
"3090","ENSACAG00000003837","GL343284.1",738555,790547,51992
"3091","ENSACAG00000003838","GL343414.1",646584,660886,14302
"3092","ENSACAG00000003839","GL344064.1",76494,77373,879
"3093","ENSACAG00000003840","GL343907.1",26521,35321,8800
"3094","ENSACAG00000003841","1",85515744,85579819,64075
"3095","ENSACAG00000003842","5",134095922,134108410,12488
"3096","ENSACAG00000003843","3",24114255,24276004,161749
"3097","ENSACAG00000003844","4",58428143,58470904,42761
"3098","ENSACAG00000003845","GL343747.1",104352,154466,50114
"3099","ENSACAG00000003846","1",196714226,196715178,952
"3100","ENSACAG00000003847","4",131779953,131966641,186688
"3101","ENSACAG00000003849","LGf",3685735,3693025,7290
"3102","ENSACAG00000003850","1",256143109,256210322,67213
"3103","ENSACAG00000003851","3",24454172,24644014,189842
"3104","ENSACAG00000003853","1",43136103,43162495,26392
"3105","ENSACAG00000003855","4",19255628,19295198,39570
"3106","ENSACAG00000003856","LGf",3651843,3684612,32769
"3107","ENSACAG00000003857","GL343580.1",79305,99724,20419
"3108","ENSACAG00000003858","GL343205.1",2568242,2568934,692
"3109","ENSACAG00000003859","1",196863916,196906983,43067
"3110","ENSACAG00000003860","1",43109050,43110444,1394
"3111","ENSACAG00000003862","GL343643.1",217269,221948,4679
"3112","ENSACAG00000003864","GL343205.1",2036753,2384640,347887
"3113","ENSACAG00000003865","GL343519.1",786,6086,5300
"3114","ENSACAG00000003867","AAWZ02038155",161,12654,12493
"3115","ENSACAG00000003870","GL343466.1",36161,52635,16474
"3116","ENSACAG00000003872","GL343284.1",334201,712669,378468
"3117","ENSACAG00000003874","LGf",3521319,3616786,95467
"3118","ENSACAG00000003875","GL343205.1",880990,896751,15761
"3119","ENSACAG00000003876","1",43045917,43077830,31913
"3120","ENSACAG00000003877","GL343489.1",431746,449929,18183
"3121","ENSACAG00000003878","GL343619.1",232052,288742,56690
"3122","ENSACAG00000003879","6",78621647,78644799,23152
"3123","ENSACAG00000003880","GL343414.1",684168,708235,24067
"3124","ENSACAG00000003881","AAWZ02039048",5938,7651,1713
"3125","ENSACAG00000003883","4",93072110,93130505,58395
"3126","ENSACAG00000003884","AAWZ02040922",1,862,861
"3127","ENSACAG00000003885","GL344580.1",6867,15398,8531
"3128","ENSACAG00000003886","3",183103239,183123856,20617
"3129","ENSACAG00000003887","GL344047.1",5599,6816,1217
"3130","ENSACAG00000003888","GL344047.1",15865,43347,27482
"3131","ENSACAG00000003889","4",19305513,19329180,23667
"3132","ENSACAG00000003890","GL343719.1",335941,337944,2003
"3133","ENSACAG00000003891","GL344260.1",27472,41436,13964
"3134","ENSACAG00000003892","GL343781.1",132828,144569,11741
"3135","ENSACAG00000003894","AAWZ02038263",22,12315,12293
"3136","ENSACAG00000003895","4",148094406,148095146,740
"3137","ENSACAG00000003896","1",85431840,85437373,5533
"3138","ENSACAG00000003897","4",148134236,148182155,47919
"3139","ENSACAG00000003898","GL343256.1",1018265,1019845,1580
"3140","ENSACAG00000003899","5",134130990,134165227,34237
"3141","ENSACAG00000003900","GL343205.1",801038,870897,69859
"3142","ENSACAG00000003901","6",78582977,78593274,10297
"3143","ENSACAG00000003902","GL343619.1",331915,364667,32752
"3144","ENSACAG00000003903","3",16151102,16215729,64627
"3145","ENSACAG00000003905","GL343226.1",2170581,2196746,26165
"3146","ENSACAG00000003907","1",85200150,85262860,62710
"3147","ENSACAG00000003908","GL343256.1",1232848,1260150,27302
"3148","ENSACAG00000003909","GL343226.1",2091166,2142621,51455
"3149","ENSACAG00000003910","GL343430.1",576255,601627,25372
"3150","ENSACAG00000003911","LGf",1892986,1899517,6531
"3151","ENSACAG00000003912","GL343580.1",52539,76617,24078
"3152","ENSACAG00000003913","GL343286.1",578393,604695,26302
"3153","ENSACAG00000003914","GL343301.1",1562468,1596122,33654
"3154","ENSACAG00000003916","5",27098391,27101609,3218
"3155","ENSACAG00000003917","3",1472164,1476437,4273
"3156","ENSACAG00000003918","3",1479847,1498638,18791
"3157","ENSACAG00000003919","4",58486131,58498446,12315
"3158","ENSACAG00000003920","GL343532.1",398388,398804,416
"3159","ENSACAG00000003921","AAWZ02037965",878,9727,8849
"3160","ENSACAG00000003922","GL343619.1",393837,408112,14275
"3161","ENSACAG00000003923","GL343283.1",199331,232974,33643
"3162","ENSACAG00000003925","4",132003597,132043808,40211
"3163","ENSACAG00000003926","5",27093313,27095283,1970
"3164","ENSACAG00000003927","GL343226.1",2010217,2081021,70804
"3165","ENSACAG00000003928","4",59223337,59225725,2388
"3166","ENSACAG00000003931","GL343226.1",2008941,2010158,1217
"3167","ENSACAG00000003932","1",197159026,197216138,57112
"3168","ENSACAG00000003933","5",134380014,134487961,107947
"3169","ENSACAG00000003934","GL343226.1",1970653,1990130,19477
"3170","ENSACAG00000003935","GL343274.1",211059,220431,9372
"3171","ENSACAG00000003936","5",27085301,27086080,779
"3172","ENSACAG00000003937","4",93219853,93294306,74453
"3173","ENSACAG00000003938","LGf",1868343,1873155,4812
"3174","ENSACAG00000003939","5",27065125,27074871,9746
"3175","ENSACAG00000003940","1",90652114,90682030,29916
"3176","ENSACAG00000003941","GL343301.1",1354966,1433299,78333
"3177","ENSACAG00000003942","3",182179825,182552431,372606
"3178","ENSACAG00000003943","1",43004922,43038625,33703
"3179","ENSACAG00000003944","GL343399.1",338515,342552,4037
"3180","ENSACAG00000003945","2",3526462,3535511,9049
"3181","ENSACAG00000003946","AAWZ02036190",21,15357,15336
"3182","ENSACAG00000003947","2",3554627,3627202,72575
"3183","ENSACAG00000003948","GL343414.1",718108,794391,76283
"3184","ENSACAG00000003950","AAWZ02037623",8303,15323,7020
"3185","ENSACAG00000003951","4",148031246,148055444,24198
"3186","ENSACAG00000003952","5",134533376,134534133,757
"3187","ENSACAG00000003953","4",19330146,19345598,15452
"3188","ENSACAG00000003954","3",39515962,39561966,46004
"3189","ENSACAG00000003955","GL343274.1",197147,202029,4882
"3190","ENSACAG00000003956","1",197218554,197267092,48538
"3191","ENSACAG00000003957","GL343430.1",465453,563051,97598
"3192","ENSACAG00000003958","4",93298824,93333916,35092
"3193","ENSACAG00000003959","5",134592131,134748323,156192
"3194","ENSACAG00000003962","4",58990795,59012234,21439
"3195","ENSACAG00000003963","1",197284072,197315449,31377
"3196","ENSACAG00000003964","LGf",1851295,1861237,9942
"3197","ENSACAG00000003965","GL343301.1",1108168,1128421,20253
"3198","ENSACAG00000003966","2",52310227,52319008,8781
"3199","ENSACAG00000003968","GL343466.1",525,33938,33413
"3200","ENSACAG00000003970","GL343301.1",972369,1097432,125063
"3201","ENSACAG00000003971","5",27045365,27058471,13106
"3202","ENSACAG00000003972","3",38272079,38308779,36700
"3203","ENSACAG00000003973","GL343400.1",22954,46608,23654
"3204","ENSACAG00000003974","5",27011389,27033459,22070
"3205","ENSACAG00000003975","GL343274.1",153293,191642,38349
"3206","ENSACAG00000003976","4",59033261,59103965,70704
"3207","ENSACAG00000003979","GL343580.1",1061,19401,18340
"3208","ENSACAG00000003980","LGf",1802592,1819788,17196
"3209","ENSACAG00000003981","GL343747.1",95075,101260,6185
"3210","ENSACAG00000003982","3",39630584,39641979,11395
"3211","ENSACAG00000003983","GL343193.1",10489542,10513205,23663
"3212","ENSACAG00000003984","GL343781.1",81688,99403,17715
"3213","ENSACAG00000003986","LGf",1759212,1788419,29207
"3214","ENSACAG00000003987","GL343256.1",1379501,1432305,52804
"3215","ENSACAG00000003988","2",52371551,52429436,57885
"3216","ENSACAG00000003989","4",93367241,93368742,1501
"3217","ENSACAG00000003990","4",93381587,93447199,65612
"3218","ENSACAG00000003991","GL343747.1",63295,117187,53892
"3219","ENSACAG00000003992","1",256344991,256515414,170423
"3220","ENSACAG00000003993","GL343430.1",343032,407530,64498
"3221","ENSACAG00000003994","6",78561336,78584418,23082
"3222","ENSACAG00000003995","GL344047.1",103835,110360,6525
"3223","ENSACAG00000003996","1",257331131,257405596,74465
"3224","ENSACAG00000003998","1",197398527,197499422,100895
"3225","ENSACAG00000003999","GL343400.1",72581,76512,3931
"3226","ENSACAG00000004000","AAWZ02038352",1873,11960,10087
"3227","ENSACAG00000004001","GL343205.1",799692,807819,8127
"3228","ENSACAG00000004002","AAWZ02039643",21,7768,7747
"3229","ENSACAG00000004003","GL343400.1",95841,99087,3246
"3230","ENSACAG00000004004","5",134798571,134806164,7593
"3231","ENSACAG00000004007","GL343400.1",114747,121175,6428
"3232","ENSACAG00000004008","GL343544.1",394018,427771,33753
"3233","ENSACAG00000004010","AAWZ02037815",4253,13599,9346
"3234","ENSACAG00000004011","LGf",1740413,1758123,17710
"3235","ENSACAG00000004012","AAWZ02037731",2417,4602,2185
"3236","ENSACAG00000004013","GL343263.1",41409,178340,136931
"3237","ENSACAG00000004015","AAWZ02037212",41,9254,9213
"3238","ENSACAG00000004016","GL344261.1",4816,21099,16283
"3239","ENSACAG00000004017","AAWZ02038744",4435,8039,3604
"3240","ENSACAG00000004018","GL343758.1",81749,129256,47507
"3241","ENSACAG00000004019","GL343962.1",77395,105178,27783
"3242","ENSACAG00000004020","GL343448.1",330051,674351,344300
"3243","ENSACAG00000004022","2",134909793,134953263,43470
"3244","ENSACAG00000004024","GL344148.1",328,21504,21176
"3245","ENSACAG00000004025","3",185057937,185085564,27627
"3246","ENSACAG00000004026","GL344213.1",21,27853,27832
"3247","ENSACAG00000004027","GL343929.1",67124,79262,12138
"3248","ENSACAG00000004028","5",72349436,72536397,186961
"3249","ENSACAG00000004030","LGf",3473255,3502054,28799
"3250","ENSACAG00000004031","GL343443.1",591835,647059,55224
"3251","ENSACAG00000004033","1",257402416,257439522,37106
"3252","ENSACAG00000004034","GL343284.1",97463,258985,161522
"3253","ENSACAG00000004036","GL343374.1",5261,11566,6305
"3254","ENSACAG00000004037","GL343496.1",23900,45415,21515
"3255","ENSACAG00000004038","GL343781.1",55211,75686,20475
"3256","ENSACAG00000004039","GL344502.1",15860,26891,11031
"3257","ENSACAG00000004040","GL343611.1",212358,284483,72125
"3258","ENSACAG00000004041","GL343706.1",6454,16554,10100
"3259","ENSACAG00000004043","GL343237.1",1749878,1826999,77121
"3260","ENSACAG00000004044","GL344541.1",21969,29886,7917
"3261","ENSACAG00000004047","GL343274.1",110526,135702,25176
"3262","ENSACAG00000004048","GL344261.1",25776,26963,1187
"3263","ENSACAG00000004049","GL343738.1",66007,112069,46062
"3264","ENSACAG00000004050","4",132378828,132394128,15300
"3265","ENSACAG00000004051","1",259625956,259653886,27930
"3266","ENSACAG00000004052","2",52436438,52474179,37741
"3267","ENSACAG00000004053","1",6274891,6329757,54866
"3268","ENSACAG00000004054","GL343759.1",725,13911,13186
"3269","ENSACAG00000004055","GL343198.1",5442068,5503809,61741
"3270","ENSACAG00000004057","GL343706.1",23935,44462,20527
"3271","ENSACAG00000004060","GL343283.1",243701,303600,59899
"3272","ENSACAG00000004061","GL343205.1",752699,764988,12289
"3273","ENSACAG00000004062","GL343611.1",320931,335142,14211
"3274","ENSACAG00000004063","3",1611691,1645217,33526
"3275","ENSACAG00000004064","GL344348.1",7308,31924,24616
"3276","ENSACAG00000004065","GL344348.1",35529,37385,1856
"3277","ENSACAG00000004066","3",24677690,24709862,32172
"3278","ENSACAG00000004068","GL344148.1",37791,59234,21443
"3279","ENSACAG00000004069","1",85070505,85096848,26343
"3280","ENSACAG00000004070","1",6333329,6339570,6241
"3281","ENSACAG00000004071","GL343205.1",683097,746012,62915
"3282","ENSACAG00000004072","AAWZ02037731",3047,14277,11230
"3283","ENSACAG00000004073","1",6351913,6365102,13189
"3284","ENSACAG00000004074","4",19359910,19376068,16158
"3285","ENSACAG00000004075","GL343611.1",354585,372746,18161
"3286","ENSACAG00000004076","LGf",1695052,1707583,12531
"3287","ENSACAG00000004077","1",42997450,43001808,4358
"3288","ENSACAG00000004078","GL343374.1",23675,48096,24421
"3289","ENSACAG00000004079","LGf",3447292,3458483,11191
"3290","ENSACAG00000004080","GL343274.1",101456,108097,6641
"3291","ENSACAG00000004081","GL344079.1",1919,40932,39013
"3292","ENSACAG00000004082","AAWZ02036695",1984,23442,21458
"3293","ENSACAG00000004084","GL343283.1",390103,391970,1867
"3294","ENSACAG00000004085","1",42796646,42974971,178325
"3295","ENSACAG00000004087","3",23361043,23401208,40165
"3296","ENSACAG00000004088","GL343649.1",3755,8654,4899
"3297","ENSACAG00000004089","GL343962.1",60033,70182,10149
"3298","ENSACAG00000004090","GL343338.1",488655,497152,8497
"3299","ENSACAG00000004091","GL343538.1",309240,313331,4091
"3300","ENSACAG00000004092","2",3643435,3686438,43003
"3301","ENSACAG00000004094","1",85010698,85023538,12840
"3302","ENSACAG00000004095","GL343208.1",703542,723697,20155
"3303","ENSACAG00000004097","GL343400.1",130083,140398,10315
"3304","ENSACAG00000004098","GL344174.1",18718,28995,10277
"3305","ENSACAG00000004099","GL343781.1",27083,45646,18563
"3306","ENSACAG00000004102","3",39670850,39769372,98522
"3307","ENSACAG00000004104","3",184999068,185044514,45446
"3308","ENSACAG00000004105","4",19425858,19448884,23026
"3309","ENSACAG00000004106","GL343400.1",152466,159687,7221
"3310","ENSACAG00000004107","LGf",1670852,1671922,1070
"3311","ENSACAG00000004108","3",1646472,1660097,13625
"3312","ENSACAG00000004110","GL343338.1",513698,527697,13999
"3313","ENSACAG00000004111","6",78524940,78547952,23012
"3314","ENSACAG00000004112","LGf",1636753,1662485,25732
"3315","ENSACAG00000004113","GL343193.1",10342565,10438071,95506
"3316","ENSACAG00000004114","4",19484955,19632343,147388
"3317","ENSACAG00000004115","4",19506964,19516780,9816
"3318","ENSACAG00000004117","GL344045.1",14278,33411,19133
"3319","ENSACAG00000004118","4",59114621,59142860,28239
"3320","ENSACAG00000004119","GL343538.1",375683,380205,4522
"3321","ENSACAG00000004120","1",42630172,42697874,67702
"3322","ENSACAG00000004122","GL343341.1",798016,1124220,326204
"3323","ENSACAG00000004124","GL343224.1",1312802,1365502,52700
"3324","ENSACAG00000004125","GL343224.1",2086998,2170474,83476
"3325","ENSACAG00000004126","GL343962.1",19085,58611,39526
"3326","ENSACAG00000004127","GL343784.1",12542,31422,18880
"3327","ENSACAG00000004128","GL343208.1",948566,1237279,288713
"3328","ENSACAG00000004129","GL343224.1",33415,54939,21524
"3329","ENSACAG00000004130","GL343544.1",268748,295200,26452
"3330","ENSACAG00000004131","2",52507620,52516853,9233
"3331","ENSACAG00000004132","2",52523327,52573937,50610
"3332","ENSACAG00000004133","1",84445433,84706446,261013
"3333","ENSACAG00000004134","4",19874254,19878976,4722
"3334","ENSACAG00000004135","5",72547773,72595744,47971
"3335","ENSACAG00000004137","GL344040.1",22905,63940,41035
"3336","ENSACAG00000004138","GL343327.1",1140561,1140809,248
"3337","ENSACAG00000004139","GL343338.1",529368,577332,47964
"3338","ENSACAG00000004140","1",42613104,42623675,10571
"3339","ENSACAG00000004142","2",52637068,52708809,71741
"3340","ENSACAG00000004143","4",19884030,19898958,14928
"3341","ENSACAG00000004144","GL343538.1",417561,468252,50691
"3342","ENSACAG00000004146","5",26748714,26785410,36696
"3343","ENSACAG00000004148","4",132396259,132420457,24198
"3344","ENSACAG00000004149","GL343274.1",22914,87924,65010
"3345","ENSACAG00000004151","LGf",3413662,3440453,26791
"3346","ENSACAG00000004156","GL343205.1",372039,381642,9603
"3347","ENSACAG00000004158","GL343773.1",15895,27886,11991
"3348","ENSACAG00000004159","GL344045.1",46201,60637,14436
"3349","ENSACAG00000004164","2",142741899,142784740,42841
"3350","ENSACAG00000004166","3",38218660,38271133,52473
"3351","ENSACAG00000004167","3",16104697,16118230,13533
"3352","ENSACAG00000004168","GL343224.1",70493,89226,18733
"3353","ENSACAG00000004169","GL343286.1",440200,549261,109061
"3354","ENSACAG00000004170","GL343400.1",202797,224194,21397
"3355","ENSACAG00000004171","1",42498607,42570076,71469
"3356","ENSACAG00000004172","GL343193.1",10224215,10334561,110346
"3357","ENSACAG00000004173","3",23419069,23426739,7670
"3358","ENSACAG00000004175","GL343237.1",1707400,1744410,37010
"3359","ENSACAG00000004176","LGf",1224303,1269328,45025
"3360","ENSACAG00000004177","GL343414.1",847302,848354,1052
"3361","ENSACAG00000004178","GL343205.1",275420,354425,79005
"3362","ENSACAG00000004179","4",19898337,19934047,35710
"3363","ENSACAG00000004180","5",75650,175999,100349
"3364","ENSACAG00000004182","GL343338.1",631916,641669,9753
"3365","ENSACAG00000004183","GL343224.1",2172674,2182114,9440
"3366","ENSACAG00000004184","5",97795495,97896985,101490
"3367","ENSACAG00000004186","GL343747.1",46603,58913,12310
"3368","ENSACAG00000004188","LGf",1127269,1140959,13690
"3369","ENSACAG00000004189","GL343301.1",694252,814337,120085
"3370","ENSACAG00000004190","GL344099.1",55967,74495,18528
"3371","ENSACAG00000004191","3",182368930,182370094,1164
"3372","ENSACAG00000004192","3",182179825,182536893,357068
"3373","ENSACAG00000004193","3",38150167,38181285,31118
"3374","ENSACAG00000004194","GL343671.1",11583,33200,21617
"3375","ENSACAG00000004195","4",132546153,132559821,13668
"3376","ENSACAG00000004196","GL344165.1",2697,18803,16106
"3377","ENSACAG00000004197","3",23430606,23458997,28391
"3378","ENSACAG00000004198","GL343706.1",55330,58279,2949
"3379","ENSACAG00000004199","GL343738.1",193912,231407,37495
"3380","ENSACAG00000004201","3",39878404,39961650,83246
"3381","ENSACAG00000004202","4",132533452,132624497,91045
"3382","ENSACAG00000004203","GL343274.1",71230,79217,7987
"3383","ENSACAG00000004204","GL343256.1",1439727,1455148,15421
"3384","ENSACAG00000004205","4",59170535,59182112,11577
"3385","ENSACAG00000004206","GL343759.1",17614,34179,16565
"3386","ENSACAG00000004207","6",78408435,78516214,107779
"3387","ENSACAG00000004208","2",134860432,134873766,13334
"3388","ENSACAG00000004209","4",132632647,132662267,29620
"3389","ENSACAG00000004210","3",1796576,1970957,174381
"3390","ENSACAG00000004212","3",24757782,24830292,72510
"3391","ENSACAG00000004214","GL343274.1",154,23575,23421
"3392","ENSACAG00000004215","5",183275,192478,9203
"3393","ENSACAG00000004216","3",32427184,32428103,919
"3394","ENSACAG00000004217","3",23464166,23573541,109375
"3395","ENSACAG00000004218","5",72814321,72932698,118377
"3396","ENSACAG00000004220","GL343194.1",291556,524287,232731
"3397","ENSACAG00000004221","3",143172671,143181968,9297
"3398","ENSACAG00000004222","GL343538.1",473895,486552,12657
"3399","ENSACAG00000004223","3",143151283,143162708,11425
"3400","ENSACAG00000004224","1",212063728,212064681,953
"3401","ENSACAG00000004228","1",6446197,6452624,6427
"3402","ENSACAG00000004229","3",143137306,143138659,1353
"3403","ENSACAG00000004230","1",6525451,6586044,60593
"3404","ENSACAG00000004231","1",123668004,123792068,124064
"3405","ENSACAG00000004232","4",93510803,93544213,33410
"3406","ENSACAG00000004234","1",205004174,205100906,96732
"3407","ENSACAG00000004235","3",143103870,143131127,27257
"3408","ENSACAG00000004236","GL343267.1",1551717,1561081,9364
"3409","ENSACAG00000004237","GL344026.1",43532,68201,24669
"3410","ENSACAG00000004239","3",15882641,16046413,163772
"3411","ENSACAG00000004241","AAWZ02039448",1974,7779,5805
"3412","ENSACAG00000004244","1",212178006,212179826,1820
"3413","ENSACAG00000004245","3",40061205,40102966,41761
"3414","ENSACAG00000004246","GL343224.1",2267032,2292182,25150
"3415","ENSACAG00000004247","2",142822069,142827887,5818
"3416","ENSACAG00000004248","3",143063002,143095091,32089
"3417","ENSACAG00000004250","GL343759.1",37864,45551,7687
"3418","ENSACAG00000004251","4",59187742,59198143,10401
"3419","ENSACAG00000004252","2",142845521,142856658,11137
"3420","ENSACAG00000004253","1",212182649,212199391,16742
"3421","ENSACAG00000004254","2",116960657,117171516,210859
"3422","ENSACAG00000004255","GL343341.1",625440,626534,1094
"3423","ENSACAG00000004256","GL343468.1",362685,568740,206055
"3424","ENSACAG00000004258","GL343747.1",20363,39389,19026
"3425","ENSACAG00000004259","2",142930592,142932190,1598
"3426","ENSACAG00000004260","GL343338.1",662592,714972,52380
"3427","ENSACAG00000004264","2",143099205,143105918,6713
"3428","ENSACAG00000004265","4",93545553,93559700,14147
"3429","ENSACAG00000004266","GL343540.1",119051,134906,15855
"3430","ENSACAG00000004267","GL343671.1",1378,8364,6986
"3431","ENSACAG00000004268","1",84261008,84305089,44081
"3432","ENSACAG00000004270","3",40102156,40140922,38766
"3433","ENSACAG00000004271","GL344026.1",72446,77538,5092
"3434","ENSACAG00000004272","3",182065511,182107198,41687
"3435","ENSACAG00000004273","GL343341.1",198526,282562,84036
"3436","ENSACAG00000004274","2",143124285,143376202,251917
"3437","ENSACAG00000004275","GL343403.1",741181,841254,100073
"3438","ENSACAG00000004276","GL343784.1",58286,133887,75601
"3439","ENSACAG00000004278","GL343540.1",15082,80123,65041
"3440","ENSACAG00000004279","GL344040.1",74013,82736,8723
"3441","ENSACAG00000004280","5",192408,205436,13028
"3442","ENSACAG00000004281","GL344165.1",19362,42329,22967
"3443","ENSACAG00000004283","GL343781.1",17430,22011,4581
"3444","ENSACAG00000004284","LGf",3407164,3410255,3091
"3445","ENSACAG00000004285","1",197521220,197522467,1247
"3446","ENSACAG00000004288","GL343237.1",1669426,1704969,35543
"3447","ENSACAG00000004289","GL343378.1",7567,30567,23000
"3448","ENSACAG00000004290","GL343759.1",77741,97693,19952
"3449","ENSACAG00000004291","GL343579.1",103246,114777,11531
"3450","ENSACAG00000004292","GL344099.1",45445,48429,2984
"3451","ENSACAG00000004293","GL343194.1",108932,129290,20358
"3452","ENSACAG00000004294","AAWZ02038515",2651,6078,3427
"3453","ENSACAG00000004295","1",197571709,197719377,147668
"3454","ENSACAG00000004296","GL343285.1",812863,814431,1568
"3455","ENSACAG00000004297","LGf",3314893,3324584,9691
"3456","ENSACAG00000004298","GL343579.1",126655,261599,134944
"3457","ENSACAG00000004299","GL343285.1",964065,999851,35786
"3458","ENSACAG00000004300","LGf",3330785,3401623,70838
"3459","ENSACAG00000004301","3",38086124,38138430,52306
"3460","ENSACAG00000004302","GL343205.1",29522,33124,3602
"3461","ENSACAG00000004303","GL343540.1",6876,12232,5356
"3462","ENSACAG00000004304","4",20103490,20112219,8729
"3463","ENSACAG00000004306","5",204250,231288,27038
"3464","ENSACAG00000004307","GL343237.1",1595395,1627718,32323
"3465","ENSACAG00000004308","GL343205.1",749,20645,19896
"3466","ENSACAG00000004310","3",40205487,40224627,19140
"3467","ENSACAG00000004312","AAWZ02038362",946,11825,10879
"3468","ENSACAG00000004313","3",181763242,181778194,14952
"3469","ENSACAG00000004314","AAWZ02038113",55,9120,9065
"3470","ENSACAG00000004316","AAWZ02037940",674,5620,4946
"3471","ENSACAG00000004317","GL343224.1",249538,296518,46980
"3472","ENSACAG00000004318","3",1983249,2089070,105821
"3473","ENSACAG00000004319","3",181727084,181753253,26169
"3474","ENSACAG00000004320","4",59250108,59313276,63168
"3475","ENSACAG00000004321","LGf",1087777,1103300,15523
"3476","ENSACAG00000004322","3",24856986,24859592,2606
"3477","ENSACAG00000004323","1",54803137,54854221,51084
"3478","ENSACAG00000004325","GL343538.1",517621,521728,4107
"3479","ENSACAG00000004327","3",183560855,183659143,98288
"3480","ENSACAG00000004328","3",24982669,25016225,33556
"3481","ENSACAG00000004330","GL343378.1",36621,45712,9091
"3482","ENSACAG00000004331","4",59327460,59338099,10639
"3483","ENSACAG00000004333","GL343671.1",70871,83247,12376
"3484","ENSACAG00000004334","AAWZ02037240",3561,4865,1304
"3485","ENSACAG00000004335","GL343256.1",1460338,1500741,40403
"3486","ENSACAG00000004336","GL343544.1",239860,259242,19382
"3487","ENSACAG00000004337","4",59355284,59510467,155183
"3488","ENSACAG00000004338","GL343448.1",290152,290643,491
"3489","ENSACAG00000004340","GL343706.1",88226,101907,13681
"3490","ENSACAG00000004341","AAWZ02038339",403,7117,6714
"3491","ENSACAG00000004342","GL344796.1",2909,19090,16181
"3492","ENSACAG00000004343","LGf",3276032,3293829,17797
"3493","ENSACAG00000004345","GL343500.1",322136,377369,55233
"3494","ENSACAG00000004346","GL343400.1",235336,256216,20880
"3495","ENSACAG00000004347","LGf",3152553,3158652,6099
"3496","ENSACAG00000004348","GL343579.1",387419,392046,4627
"3497","ENSACAG00000004350","3",40249674,40280305,30631
"3498","ENSACAG00000004351","4",93563601,93663808,100207
"3499","ENSACAG00000004352","2",3693504,3699684,6180
"3500","ENSACAG00000004353","AAWZ02036987",3866,16154,12288
"3501","ENSACAG00000004354","4",20132426,20331338,198912
"3502","ENSACAG00000004355","GL343403.1",677094,721894,44800
"3503","ENSACAG00000004358","LGf",1027776,1073014,45238
"3504","ENSACAG00000004360","GL343579.1",442519,443739,1220
"3505","ENSACAG00000004362","GL343468.1",590829,610574,19745
"3506","ENSACAG00000004363","GL343579.1",451236,461913,10677
"3507","ENSACAG00000004364","GL343378.1",49898,60865,10967
"3508","ENSACAG00000004365","1",54662845,54792389,129544
"3509","ENSACAG00000004367","GL343886.1",26074,51372,25298
"3510","ENSACAG00000004368","GL343378.1",65756,106443,40687
"3511","ENSACAG00000004369","GL343230.1",149696,339823,190127
"3512","ENSACAG00000004371","GL343194.1",74539,98883,24344
"3513","ENSACAG00000004372","GL343378.1",121146,123582,2436
"3514","ENSACAG00000004373","LGf",1022326,1023366,1040
"3515","ENSACAG00000004374","GL343378.1",140027,164581,24554
"3516","ENSACAG00000004375","GL344185.1",50070,62604,12534
"3517","ENSACAG00000004376","5",82959500,83009005,49505
"3518","ENSACAG00000004377","GL344165.1",51456,59077,7621
"3519","ENSACAG00000004378","3",181635608,181652755,17147
"3520","ENSACAG00000004379","LGf",994218,1009914,15696
"3521","ENSACAG00000004381","GL343256.1",1526494,1548578,22084
"3522","ENSACAG00000004382","GL344185.1",16905,44500,27595
"3523","ENSACAG00000004383","GL343224.1",2316556,2331062,14506
"3524","ENSACAG00000004384","GL343544.1",104959,122144,17185
"3525","ENSACAG00000004385","3",92231184,92250412,19228
"3526","ENSACAG00000004386","GL343498.1",437801,525383,87582
"3527","ENSACAG00000004387","GL343341.1",166536,195687,29151
"3528","ENSACAG00000004389","AAWZ02038915",4502,9655,5153
"3529","ENSACAG00000004390","2",4389668,4426822,37154
"3530","ENSACAG00000004391","1",206228907,206233053,4146
"3531","ENSACAG00000004392","GL343400.1",249215,258491,9276
"3532","ENSACAG00000004393","2",52713459,52765499,52040
"3533","ENSACAG00000004394","1",212197024,212213403,16379
"3534","ENSACAG00000004395","AAWZ02039332",2263,8686,6423
"3535","ENSACAG00000004396","LGf",961232,973882,12650
"3536","ENSACAG00000004397","5",26721889,26738306,16417
"3537","ENSACAG00000004398","GL343224.1",1385171,1392674,7503
"3538","ENSACAG00000004399","AAWZ02040295",347,7100,6753
"3539","ENSACAG00000004400","GL344234.1",2023,37109,35086
"3540","ENSACAG00000004401","GL343495.1",45505,218182,172677
"3541","ENSACAG00000004402","AAWZ02037616",1028,11763,10735
"3542","ENSACAG00000004403","GL343224.1",2334015,2357508,23493
"3543","ENSACAG00000004404","6",70956314,70962904,6590
"3544","ENSACAG00000004405","GL343224.1",295572,324405,28833
"3545","ENSACAG00000004408","GL343224.1",861339,897754,36415
"3546","ENSACAG00000004409","GL343544.1",63494,103975,40481
"3547","ENSACAG00000004410","GL343400.1",335189,335569,380
"3548","ENSACAG00000004413","4",132679460,132756505,77045
"3549","ENSACAG00000004414","GL343400.1",340525,340836,311
"3550","ENSACAG00000004417","GL343400.1",344844,345224,380
"3551","ENSACAG00000004419","GL343237.1",1481338,1511497,30159
"3552","ENSACAG00000004420","GL343400.1",348673,349083,410
"3553","ENSACAG00000004422","GL343495.1",277505,338133,60628
"3554","ENSACAG00000004423","GL343400.1",352714,353376,662
"3555","ENSACAG00000004425","5",26690290,26707521,17231
"3556","ENSACAG00000004426","LGf",722899,730101,7202
"3557","ENSACAG00000004427","GL343285.1",999328,1162157,162829
"3558","ENSACAG00000004428","GL343208.1",1343016,2038258,695242
"3559","ENSACAG00000004430","GL343400.1",359375,364535,5160
"3560","ENSACAG00000004431","LGf",631038,639232,8194
"3561","ENSACAG00000004433","LGf",497230,501384,4154
"3562","ENSACAG00000004434","GL343224.1",1658224,1862166,203942
"3563","ENSACAG00000004437","GL343392.1",146479,152612,6133
"3564","ENSACAG00000004438","3",143009083,143062754,53671
"3565","ENSACAG00000004439","GL343759.1",99059,124728,25669
"3566","ENSACAG00000004440","3",92510760,92513288,2528
"3567","ENSACAG00000004441","LGf",317612,321244,3632
"3568","ENSACAG00000004442","GL343503.1",413830,522243,108413
"3569","ENSACAG00000004443","GL343256.1",1569933,1574033,4100
"3570","ENSACAG00000004445","1",84024817,84222465,197648
"3571","ENSACAG00000004446","GL343307.1",284478,292704,8226
"3572","ENSACAG00000004448","5",83016132,83031263,15131
"3573","ENSACAG00000004451","GL343341.1",158817,165850,7033
"3574","ENSACAG00000004452","GL343338.1",716818,725330,8512
"3575","ENSACAG00000004453","3",38038553,38054766,16213
"3576","ENSACAG00000004456","3",25024694,25060501,35807
"3577","ENSACAG00000004457","GL343193.1",423163,433766,10603
"3578","ENSACAG00000004458","3",181512824,181513144,320
"3579","ENSACAG00000004459","GL343784.1",136667,141534,4867
"3580","ENSACAG00000004460","3",181462708,181464178,1470
"3581","ENSACAG00000004461","LGf",80022,101229,21207
"3582","ENSACAG00000004462","LGf",67565,77190,9625
"3583","ENSACAG00000004463","3",181419818,181458832,39014
"3584","ENSACAG00000004464","AAWZ02040505",955,5793,4838
"3585","ENSACAG00000004465","3",2093917,2101191,7274
"3586","ENSACAG00000004466","5",83061283,83142830,81547
"3587","ENSACAG00000004467","GL344330.1",20645,39173,18528
"3588","ENSACAG00000004468","GL343224.1",2360180,2388381,28201
"3589","ENSACAG00000004469","GL343400.1",365282,390625,25343
"3590","ENSACAG00000004470","GL343256.1",1581999,1624825,42826
"3591","ENSACAG00000004471","2",4704871,4902456,197585
"3592","ENSACAG00000004472","GL343193.1",578168,718678,140510
"3593","ENSACAG00000004473","GL343285.1",1182526,1201706,19180
"3594","ENSACAG00000004475","GL343500.1",349090,359564,10474
"3595","ENSACAG00000004476","5",26667734,26688016,20282
"3596","ENSACAG00000004477","GL343784.1",141687,144072,2385
"3597","ENSACAG00000004478","1",212216832,212237200,20368
"3598","ENSACAG00000004479","GL343503.1",391792,409474,17682
"3599","ENSACAG00000004480","3",38004797,38021238,16441
"3600","ENSACAG00000004481","GL343341.1",127486,147543,20057
"3601","ENSACAG00000004482","GL343784.1",147134,152800,5666
"3602","ENSACAG00000004483","GL343392.1",154947,160284,5337
"3603","ENSACAG00000004485","4",132886210,132940087,53877
"3604","ENSACAG00000004486","GL343208.1",2842514,2863915,21401
"3605","ENSACAG00000004487","GL343198.1",5062063,5290347,228284
"3606","ENSACAG00000004488","GL344966.1",22,14045,14023
"3607","ENSACAG00000004490","GL343784.1",158025,188486,30461
"3608","ENSACAG00000004492","GL343256.1",1643840,1653857,10017
"3609","ENSACAG00000004493","GL343392.1",197011,219266,22255
"3610","ENSACAG00000004495","GL343502.1",600888,609229,8341
"3611","ENSACAG00000004497","GL343237.1",1453029,1480135,27106
"3612","ENSACAG00000004498","4",93699778,93722805,23027
"3613","ENSACAG00000004499","2",143449986,143470806,20820
"3614","ENSACAG00000004500","GL343208.1",3010015,3092689,82674
"3615","ENSACAG00000004501","GL343886.1",79736,130414,50678
"3616","ENSACAG00000004502","GL343403.1",537383,616587,79204
"3617","ENSACAG00000004505","GL343500.1",295754,298666,2912
"3618","ENSACAG00000004506","GL343706.1",102871,109693,6822
"3619","ENSACAG00000004508","5",26622100,26637522,15422
"3620","ENSACAG00000004509","3",183672037,183680340,8303
"3621","ENSACAG00000004510","GL343338.1",729223,752994,23771
"3622","ENSACAG00000004511","GL343285.1",1230116,1242461,12345
"3623","ENSACAG00000004512","AAWZ02040392",2124,3349,1225
"3624","ENSACAG00000004513","3",181298091,181314705,16614
"3625","ENSACAG00000004514","GL343392.1",220543,239561,19018
"3626","ENSACAG00000004515","GL343500.1",284513,288012,3499
"3627","ENSACAG00000004516","1",212242952,212259695,16743
"3628","ENSACAG00000004517","3",2102704,2109710,7006
"3629","ENSACAG00000004519","GL343657.1",143623,183626,40003
"3630","ENSACAG00000004520","3",116267805,116540581,272776
"3631","ENSACAG00000004522","LGf",33570,51010,17440
"3632","ENSACAG00000004523","GL343285.1",1263440,1273912,10472
"3633","ENSACAG00000004524","GL343392.1",259903,270894,10991
"3634","ENSACAG00000004525","GL343500.1",244635,263219,18584
"3635","ENSACAG00000004526","3",183702383,183718954,16571
"3636","ENSACAG00000004527","4",113114085,113204996,90911
"3637","ENSACAG00000004528","2",143560017,143588585,28568
"3638","ENSACAG00000004529","4",93758276,93835245,76969
"3639","ENSACAG00000004530","GL343198.1",4793321,4804105,10784
"3640","ENSACAG00000004531","GL343503.1",294838,366170,71332
"3641","ENSACAG00000004532","GL343301.1",455492,663636,208144
"3642","ENSACAG00000004533","AAWZ02038532",4001,10535,6534
"3643","ENSACAG00000004537","GL343233.1",68493,103130,34637
"3644","ENSACAG00000004538","1",42239700,42347092,107392
"3645","ENSACAG00000004539","GL343208.1",3107227,3173408,66181
"3646","ENSACAG00000004541","3",183721796,183749387,27591
"3647","ENSACAG00000004542","GL343218.1",1341651,1386452,44801
"3648","ENSACAG00000004543","GL343544.1",34583,57932,23349
"3649","ENSACAG00000004544","1",54550265,54652074,101809
"3650","ENSACAG00000004545","GL343218.1",1314318,1314641,323
"3651","ENSACAG00000004546","GL343218.1",1236438,1259315,22877
"3652","ENSACAG00000004547","GL343198.1",4506679,4515379,8700
"3653","ENSACAG00000004548","3",2102704,2123054,20350
"3654","ENSACAG00000004550","GL343392.1",278248,279730,1482
"3655","ENSACAG00000004551","1",123509924,123655371,145447
"3656","ENSACAG00000004552","GL343392.1",290691,298749,8058
"3657","ENSACAG00000004553","1",212446695,212480399,33704
"3658","ENSACAG00000004554","1",123480449,123496448,15999
"3659","ENSACAG00000004555","3",40338500,40470126,131626
"3660","ENSACAG00000004556","GL343341.1",112716,119283,6567
"3661","ENSACAG00000004557","GL343198.1",4362241,4461707,99466
"3662","ENSACAG00000004560","GL343338.1",815437,821479,6042
"3663","ENSACAG00000004561","GL343759.1",131782,161032,29250
"3664","ENSACAG00000004563","1",199545100,199575379,30279
"3665","ENSACAG00000004564","GL343233.1",583056,678251,95195
"3666","ENSACAG00000004565","GL343224.1",1061566,1149146,87580
"3667","ENSACAG00000004566","GL343392.1",303001,327196,24195
"3668","ENSACAG00000004568","GL343544.1",798,35742,34944
"3669","ENSACAG00000004569","3",181283651,181296630,12979
"3670","ENSACAG00000004570","6",78382690,78398203,15513
"3671","ENSACAG00000004571","GL343240.1",664048,863978,199930
"3672","ENSACAG00000004572","GL343338.1",753895,780181,26286
"3673","ENSACAG00000004573","4",93834616,93875015,40399
"3674","ENSACAG00000004574","GL344279.1",396,44870,44474
"3675","ENSACAG00000004575","3",25066806,25106274,39468
"3676","ENSACAG00000004577","1",212590259,212602522,12263
"3677","ENSACAG00000004579","1",141748223,141748647,424
"3678","ENSACAG00000004580","5",97908253,97981067,72814
"3679","ENSACAG00000004581","GL343706.1",111467,127243,15776
"3680","ENSACAG00000004583","4",132971676,132982070,10394
"3681","ENSACAG00000004584","1",199635813,199649360,13547
"3682","ENSACAG00000004585","GL343706.1",128127,131023,2896
"3683","ENSACAG00000004586","GL343706.1",134179,143788,9609
"3684","ENSACAG00000004587","1",199680100,199762047,81947
"3685","ENSACAG00000004588","GL343674.1",93836,98561,4725
"3686","ENSACAG00000004590","1",54465166,54465660,494
"3687","ENSACAG00000004591","GL343674.1",85361,88124,2763
"3688","ENSACAG00000004592","2",52791537,53069274,277737
"3689","ENSACAG00000004594","3",183758296,183765908,7612
"3690","ENSACAG00000004595","GL343706.1",158137,166687,8550
"3691","ENSACAG00000004596","GL344061.1",96339,102077,5738
"3692","ENSACAG00000004597","5",26607054,26617151,10097
"3693","ENSACAG00000004600","GL343341.1",68934,86336,17402
"3694","ENSACAG00000004601","3",40482360,40563518,81158
"3695","ENSACAG00000004603","3",75602478,75660587,58109
"3696","ENSACAG00000004604","GL343208.1",3245339,3284489,39150
"3697","ENSACAG00000004605","1",212610067,212626004,15937
"3698","ENSACAG00000004607","1",123366738,123419914,53176
"3699","ENSACAG00000004609","GL343256.1",1657626,1658453,827
"3700","ENSACAG00000004611","GL343723.1",60456,118593,58137
"3701","ENSACAG00000004612","GL343674.1",25529,75952,50423
"3702","ENSACAG00000004614","GL343256.1",1662802,1677224,14422
"3703","ENSACAG00000004616","3",116947605,117171494,223889
"3704","ENSACAG00000004617","1",156493823,157296935,803112
"3705","ENSACAG00000004618","6",78366077,78379396,13319
"3706","ENSACAG00000004619","5",26566629,26588703,22074
"3707","ENSACAG00000004620","3",25167037,25168893,1856
"3708","ENSACAG00000004621","GL343198.1",4343420,4344829,1409
"3709","ENSACAG00000004622","1",204884106,204947626,63520
"3710","ENSACAG00000004623","GL343198.1",4294112,4339015,44903
"3711","ENSACAG00000004624","4",150769383,150800052,30669
"3712","ENSACAG00000004625","3",181237950,181243419,5469
"3713","ENSACAG00000004626","3",25348530,25353166,4636
"3714","ENSACAG00000004627","GL343237.1",1252665,1253804,1139
"3715","ENSACAG00000004628","3",25387268,25422482,35214
"3716","ENSACAG00000004629","4",132988966,132998834,9868
"3717","ENSACAG00000004632","4",133024296,133056077,31781
"3718","ENSACAG00000004634","3",180921312,181043748,122436
"3719","ENSACAG00000004635","2",143593295,143613964,20669
"3720","ENSACAG00000004636","2",143639280,143764895,125615
"3721","ENSACAG00000004637","GL343256.1",1673716,1705714,31998
"3722","ENSACAG00000004638","4",133062201,133096233,34032
"3723","ENSACAG00000004639","6",78302366,78338784,36418
"3724","ENSACAG00000004642","GL343237.1",973065,1199621,226556
"3725","ENSACAG00000004644","2",53646412,54006603,360191
"3726","ENSACAG00000004647","2",194973787,194990937,17150
"3727","ENSACAG00000004648","3",37947711,37964313,16602
"3728","ENSACAG00000004649","GL343604.1",95461,142605,47144
"3729","ENSACAG00000004650","AAWZ02037362",4,16958,16954
"3730","ENSACAG00000004652","GL343287.1",852,3936,3084
"3731","ENSACAG00000004653","1",212679026,212727084,48058
"3732","ENSACAG00000004654","GL343561.1",95224,96531,1307
"3733","ENSACAG00000004655","3",2135298,2142996,7698
"3734","ENSACAG00000004656","4",93873130,93881592,8462
"3735","ENSACAG00000004657","4",150893317,150962764,69447
"3736","ENSACAG00000004658","GL343208.1",3287096,3297175,10079
"3737","ENSACAG00000004659","4",93890512,93910962,20450
"3738","ENSACAG00000004662","3",180877282,180901635,24353
"3739","ENSACAG00000004663","AAWZ02038502",10490,10912,422
"3740","ENSACAG00000004664","GL343312.1",637922,641252,3330
"3741","ENSACAG00000004666","GL343240.1",814980,830984,16004
"3742","ENSACAG00000004667","3",2226808,2238565,11757
"3743","ENSACAG00000004668","5",26534865,26559784,24919
"3744","ENSACAG00000004670","GL343240.1",865980,899427,33447
"3745","ENSACAG00000004672","GL343392.1",339556,353100,13544
"3746","ENSACAG00000004673","GL343503.1",275083,283158,8075
"3747","ENSACAG00000004674","4",94019544,94075148,55604
"3748","ENSACAG00000004675","5",83153337,83235465,82128
"3749","ENSACAG00000004676","6",78192292,78264547,72255
"3750","ENSACAG00000004677","5",26497057,26521736,24679
"3751","ENSACAG00000004678","GL344160.1",1068,15519,14451
"3752","ENSACAG00000004680","GL343604.1",45058,46802,1744
"3753","ENSACAG00000004681","3",142960692,143004345,43653
"3754","ENSACAG00000004682","LGf",3238282,3252716,14434
"3755","ENSACAG00000004683","GL343498.1",319704,332310,12606
"3756","ENSACAG00000004684","3",21703746,21731169,27423
"3757","ENSACAG00000004685","GL343287.1",15479,24378,8899
"3758","ENSACAG00000004686","GL343604.1",35387,36460,1073
"3759","ENSACAG00000004687","3",37857868,37920026,62158
"3760","ENSACAG00000004688","GL343400.1",391936,398343,6407
"3761","ENSACAG00000004689","1",41911014,41975269,64255
"3762","ENSACAG00000004690","GL343338.1",792055,799612,7557
"3763","ENSACAG00000004691","GL343706.1",179343,200895,21552
"3764","ENSACAG00000004693","3",142938267,142957611,19344
"3765","ENSACAG00000004694","3",142897814,142934524,36710
"3766","ENSACAG00000004695","GL343256.1",1716564,1749274,32710
"3767","ENSACAG00000004696","GL343400.1",411734,412123,389
"3768","ENSACAG00000004697","3",142784178,142864993,80815
"3769","ENSACAG00000004698","GL343400.1",415743,416054,311
"3770","ENSACAG00000004699","GL343392.1",365990,379502,13512
"3771","ENSACAG00000004700","GL343400.1",418344,418733,389
"3772","ENSACAG00000004701","3",21735262,21760289,25027
"3773","ENSACAG00000004702","3",2249664,2270603,20939
"3774","ENSACAG00000004703","GL343338.1",793128,806780,13652
"3775","ENSACAG00000004704","4",133145131,133170766,25635
"3776","ENSACAG00000004706","3",180842084,180843000,916
"3777","ENSACAG00000004710","2",68468965,68471514,2549
"3778","ENSACAG00000004712","3",40591073,40593702,2629
"3779","ENSACAG00000004713","GL343287.1",45277,78637,33360
"3780","ENSACAG00000004714","GL344358.1",22867,32636,9769
"3781","ENSACAG00000004715","GL343400.1",436411,458624,22213
"3782","ENSACAG00000004716","GL343502.1",434318,450901,16583
"3783","ENSACAG00000004718","GL343198.1",4257495,4292930,35435
"3784","ENSACAG00000004719","GL343503.1",245235,269828,24593
"3785","ENSACAG00000004720","1",28471573,28473090,1517
"3786","ENSACAG00000004721","GL343208.1",3302944,3447157,144213
"3787","ENSACAG00000004722","5",83356046,83397875,41829
"3788","ENSACAG00000004723","GL343412.1",278586,354476,75890
"3789","ENSACAG00000004724","AAWZ02039885",105,7216,7111
"3790","ENSACAG00000004725","2",143790886,143864663,73777
"3791","ENSACAG00000004726","2",68501744,68511937,10193
"3792","ENSACAG00000004727","GL343687.1",34957,62308,27351
"3793","ENSACAG00000004728","3",183765981,183960420,194439
"3794","ENSACAG00000004729","GL343502.1",336658,338151,1493
"3795","ENSACAG00000004731","GL343502.1",313756,315132,1376
"3796","ENSACAG00000004732","4",150973317,150987012,13695
"3797","ENSACAG00000004733","GL343657.1",193709,198137,4428
"3798","ENSACAG00000004734","GL344429.1",8571,21707,13136
"3799","ENSACAG00000004735","1",123275685,123333127,57442
"3800","ENSACAG00000004738","GL343256.1",1755653,1819588,63935
"3801","ENSACAG00000004740","GL343657.1",218002,230741,12739
"3802","ENSACAG00000004741","GL343392.1",395467,481574,86107
"3803","ENSACAG00000004742","5",83402241,83430115,27874
"3804","ENSACAG00000004743","GL343687.1",174417,229531,55114
"3805","ENSACAG00000004744","GL343198.1",4229522,4251015,21493
"3806","ENSACAG00000004745","GL344920.1",1983,14474,12491
"3807","ENSACAG00000004746","AAWZ02037680",2219,3314,1095
"3808","ENSACAG00000004747","GL343240.1",1040514,1041197,683
"3809","ENSACAG00000004748","GL343233.1",709378,730863,21485
"3810","ENSACAG00000004749","3",25481409,25508575,27166
"3811","ENSACAG00000004751","GL343240.1",1059245,1120325,61080
"3812","ENSACAG00000004752","GL343503.1",215752,240864,25112
"3813","ENSACAG00000004754","2",68531116,68538190,7074
"3814","ENSACAG00000004755","GL343208.1",3466419,3555782,89363
"3815","ENSACAG00000004756","3",40630006,40643584,13578
"3816","ENSACAG00000004757","1",83934408,83974065,39657
"3817","ENSACAG00000004758","4",151021980,151213383,191403
"3818","ENSACAG00000004759","LGf",3055045,3140466,85421
"3819","ENSACAG00000004761","GL343657.1",245493,284780,39287
"3820","ENSACAG00000004762","GL343412.1",191870,236569,44699
"3821","ENSACAG00000004763","GL343759.1",177289,186315,9026
"3822","ENSACAG00000004764","GL343561.1",305815,321076,15261
"3823","ENSACAG00000004767","5",243144,292413,49269
"3824","ENSACAG00000004768","3",37835509,37844204,8695
"3825","ENSACAG00000004769","3",25517832,25559251,41419
"3826","ENSACAG00000004770","GL343198.1",4187159,4227733,40574
"3827","ENSACAG00000004771","6",78163988,78177141,13153
"3828","ENSACAG00000004772","GL343691.1",23381,33184,9803
"3829","ENSACAG00000004774","GL343208.1",3568522,3585851,17329
"3830","ENSACAG00000004775","5",26478943,26496593,17650
"3831","ENSACAG00000004776","2",68539886,68549343,9457
"3832","ENSACAG00000004777","1",83813647,83836047,22400
"3833","ENSACAG00000004778","LGa",3396216,3426343,30127
"3834","ENSACAG00000004779","GL343256.1",1870383,1935138,64755
"3835","ENSACAG00000004780","1",212733333,212764606,31273
"3836","ENSACAG00000004781","6",78113140,78134114,20974
"3837","ENSACAG00000004782","5",26454027,26455065,1038
"3838","ENSACAG00000004784","1",199770000,199777616,7616
"3839","ENSACAG00000004785","GL343233.1",745855,893425,147570
"3840","ENSACAG00000004786","GL343286.1",268755,434376,165621
"3841","ENSACAG00000004788","5",83451781,83461047,9266
"3842","ENSACAG00000004789","4",89558017,89580587,22570
"3843","ENSACAG00000004790","GL343706.1",215087,229318,14231
"3844","ENSACAG00000004791","3",21763555,21832507,68952
"3845","ENSACAG00000004792","GL343338.1",811139,814848,3709
"3846","ENSACAG00000004796","3",40652240,40692041,39801
"3847","ENSACAG00000004797","6",76297413,76304897,7484
"3848","ENSACAG00000004798","2",143872482,143955138,82656
"3849","ENSACAG00000004800","GL343759.1",184952,188648,3696
"3850","ENSACAG00000004801","1",200375591,200376766,1175
"3851","ENSACAG00000004802","1",111675566,112384664,709098
"3852","ENSACAG00000004803","6",78082781,78088247,5466
"3853","ENSACAG00000004804","GL343338.1",823523,843752,20229
"3854","ENSACAG00000004805","6",78013024,78027695,14671
"3855","ENSACAG00000004806","GL343561.1",319839,338146,18307
"3856","ENSACAG00000004807","LGa",3199383,3389024,189641
"3857","ENSACAG00000004808","4",89515861,89539502,23641
"3858","ENSACAG00000004809","4",133197917,133262336,64419
"3859","ENSACAG00000004810","5",26391587,26401913,10326
"3860","ENSACAG00000004811","GL343759.1",197661,201556,3895
"3861","ENSACAG00000004813","2",68552689,68586685,33996
"3862","ENSACAG00000004814","3",37795797,37820185,24388
"3863","ENSACAG00000004815","1",200996464,201021968,25504
"3864","ENSACAG00000004816","GL344964.1",2795,7468,4673
"3865","ENSACAG00000004817","1",212771690,212784664,12974
"3866","ENSACAG00000004818","4",133320820,133326597,5777
"3867","ENSACAG00000004819","GL343706.1",254395,259090,4695
"3868","ENSACAG00000004820","5",26310133,26359937,49804
"3869","ENSACAG00000004821","1",83785670,83812564,26894
"3870","ENSACAG00000004822","GL343403.1",529112,530029,917
"3871","ENSACAG00000004823","1",212790875,212829492,38617
"3872","ENSACAG00000004824","GL343237.1",849578,924697,75119
"3873","ENSACAG00000004825","1",37595269,37707358,112089
"3874","ENSACAG00000004826","GL343403.1",515334,516485,1151
"3875","ENSACAG00000004827","6",77931456,77966922,35466
"3876","ENSACAG00000004828","GL343403.1",425345,458478,33133
"3877","ENSACAG00000004829","GL343237.1",683558,776118,92560
"3878","ENSACAG00000004830","GL344964.1",10736,16249,5513
"3879","ENSACAG00000004831","1",212838425,212909956,71531
"3880","ENSACAG00000004832","GL343400.1",501601,511324,9723
"3881","ENSACAG00000004833","4",133326844,133435095,108251
"3882","ENSACAG00000004835","3",37770690,37772333,1643
"3883","ENSACAG00000004836","6",76476817,76538301,61484
"3884","ENSACAG00000004837","GL343759.1",206843,213100,6257
"3885","ENSACAG00000004838","1",201027135,201184153,157018
"3886","ENSACAG00000004840","3",37520341,37741634,221293
"3887","ENSACAG00000004842","GL343233.1",1426718,1439044,12326
"3888","ENSACAG00000004843","1",123192607,123244010,51403
"3889","ENSACAG00000004845","4",89380852,89425357,44505
"3890","ENSACAG00000004847","1",123116710,123147519,30809
"3891","ENSACAG00000004848","GL343200.1",801840,809704,7864
"3892","ENSACAG00000004849","GL343233.1",1461285,1495994,34709
"3893","ENSACAG00000004850","GL343503.1",93736,180970,87234
"3894","ENSACAG00000004851","2",143967944,144090337,122393
"3895","ENSACAG00000004852","GL343690.1",197936,206598,8662
"3896","ENSACAG00000004854","1",204862436,204882164,19728
"3897","ENSACAG00000004855","GL343904.1",3647,37167,33520
"3898","ENSACAG00000004856","4",89287734,89294314,6580
"3899","ENSACAG00000004857","GL343706.1",267330,272566,5236
"3900","ENSACAG00000004859","GL343208.1",3593654,3626337,32683
"3901","ENSACAG00000004860","GL343198.1",4046528,4103644,57116
"3902","ENSACAG00000004861","1",83566958,83674940,107982
"3903","ENSACAG00000004862","GL343200.1",841804,872278,30474
"3904","ENSACAG00000004863","4",69836887,69839010,2123
"3905","ENSACAG00000004864","GL343287.1",83111,106628,23517
"3906","ENSACAG00000004865","3",2278885,2295325,16440
"3907","ENSACAG00000004866","4",69841648,69858805,17157
"3908","ENSACAG00000004867","GL343690.1",84834,124121,39287
"3909","ENSACAG00000004868","GL343198.1",3884917,3993214,108297
"3910","ENSACAG00000004869","LGa",3033612,3078474,44862
"3911","ENSACAG00000004870","GL343691.1",31795,37502,5707
"3912","ENSACAG00000004871","6",77912315,77923378,11063
"3913","ENSACAG00000004872","3",2307494,2331193,23699
"3914","ENSACAG00000004873","1",112418126,112535471,117345
"3915","ENSACAG00000004874","GL343691.1",40214,41863,1649
"3916","ENSACAG00000004875","GL343690.1",26887,41290,14403
"3917","ENSACAG00000004876","AAWZ02037112",2066,18007,15941
"3918","ENSACAG00000004877","4",89183883,89284533,100650
"3919","ENSACAG00000004878","6",76651415,76676192,24777
"3920","ENSACAG00000004879","6",76707647,76754634,46987
"3921","ENSACAG00000004881","AAWZ02038417",567,11161,10594
"3922","ENSACAG00000004882","GL343759.1",215951,226805,10854
"3923","ENSACAG00000004883","1",194429371,194551134,121763
"3924","ENSACAG00000004884","LGa",3019773,3029849,10076
"3925","ENSACAG00000004885","GL343208.1",3653269,3750013,96744
"3926","ENSACAG00000004887","GL343750.1",4321,26696,22375
"3927","ENSACAG00000004891","GL343233.1",1583837,1605636,21799
"3928","ENSACAG00000004892","GL343691.1",64032,73437,9405
"3929","ENSACAG00000004894","GL343498.1",241021,281658,40637
"3930","ENSACAG00000004895","GL343403.1",203973,276002,72029
"3931","ENSACAG00000004897","4",69869413,69904652,35239
"3932","ENSACAG00000004898","GL343561.1",360095,421979,61884
"3933","ENSACAG00000004900","GL343338.1",845563,861392,15829
"3934","ENSACAG00000004901","1",37516058,37564958,48900
"3935","ENSACAG00000004902","GL343400.1",514729,521124,6395
"3936","ENSACAG00000004903","3",184177650,184299367,121717
"3937","ENSACAG00000004904","GL343400.1",526157,535117,8960
"3938","ENSACAG00000004906","4",69924882,69977291,52409
"3939","ENSACAG00000004907","GL343198.1",3876053,3880402,4349
"3940","ENSACAG00000004909","1",212974342,212975085,743
"3941","ENSACAG00000004910","GL343198.1",3819467,3861198,41731
"3942","ENSACAG00000004911","GL343233.1",1713109,1756455,43346
"3943","ENSACAG00000004912","1",212977953,213014569,36616
"3944","ENSACAG00000004913","GL344240.1",24870,55924,31054
"3945","ENSACAG00000004914","1",123059468,123092250,32782
"3946","ENSACAG00000004915","3",21838071,21893222,55151
"3947","ENSACAG00000004916","3",40697056,40700518,3462
"3948","ENSACAG00000004917","GL343200.1",876586,910204,33618
"3949","ENSACAG00000004919","3",40739009,40747725,8716
"3950","ENSACAG00000004920","3",40885070,40981533,96463
"3951","ENSACAG00000004921","GL343200.1",918042,920097,2055
"3952","ENSACAG00000004922","GL343200.1",944814,1015009,70195
"3953","ENSACAG00000004923","3",75722697,75809685,86988
"3954","ENSACAG00000004924","4",89102397,89117634,15237
"3955","ENSACAG00000004925","3",184320321,184348800,28479
"3956","ENSACAG00000004926","AAWZ02036910",2483,9215,6732
"3957","ENSACAG00000004927","3",37505000,37510515,5515
"3958","ENSACAG00000004928","GL343233.1",1771379,1791521,20142
"3959","ENSACAG00000004929","GL343498.1",211396,233838,22442
"3960","ENSACAG00000004930","GL343338.1",871746,886583,14837
"3961","ENSACAG00000004931","GL343403.1",152301,185988,33687
"3962","ENSACAG00000004932","3",41004831,41126118,121287
"3963","ENSACAG00000004934","LGa",2920670,2959527,38857
"3964","ENSACAG00000004935","GL343233.1",1801417,1801790,373
"3965","ENSACAG00000004936","AAWZ02039460",2318,8384,6066
"3966","ENSACAG00000004937","GL343233.1",1811308,1819886,8578
"3967","ENSACAG00000004938","1",112550768,112574864,24096
"3968","ENSACAG00000004939","3",37463881,37482853,18972
"3969","ENSACAG00000004940","GL343237.1",547308,588788,41480
"3970","ENSACAG00000004941","LGa",2896884,2916250,19366
"3971","ENSACAG00000004942","4",133499464,133513924,14460
"3972","ENSACAG00000004943","5",26276662,26299909,23247
"3973","ENSACAG00000004944","5",293352,353112,59760
"3974","ENSACAG00000004945","1",213020707,213093986,73279
"3975","ENSACAG00000004947","4",89036993,89085566,48573
"3976","ENSACAG00000004948","6",77902640,77909053,6413
"3977","ENSACAG00000004949","GL343400.1",642615,662822,20207
"3978","ENSACAG00000004950","LGa",2861929,2889082,27153
"3979","ENSACAG00000004951","GL343753.1",84100,119256,35156
"3980","ENSACAG00000004952","5",363720,440166,76446
"3981","ENSACAG00000004954","3",41310977,41338668,27691
"3982","ENSACAG00000004955","GL344125.1",75533,82292,6759
"3983","ENSACAG00000004956","AAWZ02036910",9590,16518,6928
"3984","ENSACAG00000004957","2",144102739,144111233,8494
"3985","ENSACAG00000004959","3",25566719,25603247,36528
"3986","ENSACAG00000004960","GL343759.1",238609,245328,6719
"3987","ENSACAG00000004961","GL343683.1",13053,33071,20018
"3988","ENSACAG00000004962","1",158395438,158487702,92264
"3989","ENSACAG00000004963","5",58054236,58243765,189529
"3990","ENSACAG00000004964","2",144116959,144163051,46092
"3991","ENSACAG00000004966","6",76772751,76793125,20374
"3992","ENSACAG00000004967","6",77845819,77851118,5299
"3993","ENSACAG00000004968","3",76240477,76250370,9893
"3994","ENSACAG00000004969","GL343287.1",133654,158173,24519
"3995","ENSACAG00000004970","GL343683.1",36315,48348,12033
"3996","ENSACAG00000004971","GL343338.1",883486,895273,11787
"3997","ENSACAG00000004972","6",77760869,77823669,62800
"3998","ENSACAG00000004973","GL343691.1",113393,134037,20644
"3999","ENSACAG00000004974","4",70103226,70242970,139744
"4000","ENSACAG00000004976","GL343237.1",475646,541951,66305
"4001","ENSACAG00000004977","3",36516604,36771113,254509
"4002","ENSACAG00000004978","4",133550548,133558449,7901
"4003","ENSACAG00000004980","1",123011059,123058460,47401
"4004","ENSACAG00000004981","3",25696957,25827330,130373
"4005","ENSACAG00000004982","3",36411431,36469479,58048
"4006","ENSACAG00000004983","4",133566172,133574118,7946
"4007","ENSACAG00000004984","3",79602283,79709477,107194
"4008","ENSACAG00000004985","3",21894620,21943293,48673
"4009","ENSACAG00000004988","3",41369698,41407836,38138
"4010","ENSACAG00000004989","1",201192860,201298713,105853
"4011","ENSACAG00000004991","3",81488384,81690829,202445
"4012","ENSACAG00000004992","6",76798984,76813541,14557
"4013","ENSACAG00000004994","GL343467.1",35435,50923,15488
"4014","ENSACAG00000004995","GL343318.1",1359572,1371461,11889
"4015","ENSACAG00000004996","4",133579498,133589730,10232
"4016","ENSACAG00000004997","1",83399536,83470393,70857
"4017","ENSACAG00000004999","1",204807381,204828346,20965
"4018","ENSACAG00000005000","GL343498.1",198845,208372,9527
"4019","ENSACAG00000005001","GL343286.1",305,26785,26480
"4020","ENSACAG00000005002","GL343198.1",3801404,3811417,10013
"4021","ENSACAG00000005003","GL343683.1",121615,157551,35936
"4022","ENSACAG00000005004","GL343338.1",897252,907224,9972
"4023","ENSACAG00000005005","3",2357913,2379336,21423
"4024","ENSACAG00000005007","GL343403.1",13270,121161,107891
"4025","ENSACAG00000005011","GL343203.1",4672277,4693358,21081
"4026","ENSACAG00000005012","3",2456598,2456885,287
"4027","ENSACAG00000005014","GL343198.1",3764677,3780975,16298
"4028","ENSACAG00000005015","4",151272678,151280852,8174
"4029","ENSACAG00000005016","GL343467.1",3555,10536,6981
"4030","ENSACAG00000005017","1",83300284,83398104,97820
"4031","ENSACAG00000005018","1",213106074,213143641,37567
"4032","ENSACAG00000005019","4",133590408,133620412,30004
"4033","ENSACAG00000005020","GL343198.1",3760029,3761216,1187
"4034","ENSACAG00000005022","GL343198.1",3724970,3740819,15849
"4035","ENSACAG00000005023","GL343203.1",4632948,4667095,34147
"4036","ENSACAG00000005024","AAWZ02035997",2712,30764,28052
"4037","ENSACAG00000005025","6",76859588,76882814,23226
"4038","ENSACAG00000005026","6",77693924,77721219,27295
"4039","ENSACAG00000005027","1",112577842,112614055,36213
"4040","ENSACAG00000005028","4",133635082,133645251,10169
"4041","ENSACAG00000005029","GL343691.1",144349,172299,27950
"4042","ENSACAG00000005030","1",201389445,201439550,50105
"4043","ENSACAG00000005031","4",133704511,133726541,22030
"4044","ENSACAG00000005032","4",151285203,151346104,60901
"4045","ENSACAG00000005033","GL344178.1",48009,49839,1830
"4046","ENSACAG00000005034","GL343904.1",59829,71600,11771
"4047","ENSACAG00000005037","GL343338.1",902622,917464,14842
"4048","ENSACAG00000005038","1",204790610,204793611,3001
"4049","ENSACAG00000005040","1",204753487,204766490,13003
"4050","ENSACAG00000005041","3",21955380,21978549,23169
"4051","ENSACAG00000005042","3",142770765,142781537,10772
"4052","ENSACAG00000005044","2",116489231,116530282,41051
"4053","ENSACAG00000005046","GL343500.1",593966,616823,22857
"4054","ENSACAG00000005047","GL344178.1",64943,88147,23204
"4055","ENSACAG00000005048","GL343318.1",807200,870873,63673
"4056","ENSACAG00000005049","3",184349269,184360796,11527
"4057","ENSACAG00000005050","LGf",2986608,2996321,9713
"4058","ENSACAG00000005052","LGf",3003551,3015488,11937
"4059","ENSACAG00000005053","1",83129175,83269448,140273
"4060","ENSACAG00000005054","GL343500.1",559480,574838,15358
"4061","ENSACAG00000005055","LGf",2965467,2977604,12137
"4062","ENSACAG00000005056","5",26205572,26237680,32108
"4063","ENSACAG00000005057","1",201445523,201487392,41869
"4064","ENSACAG00000005058","GL343498.1",174750,177550,2800
"4065","ENSACAG00000005059","GL343806.1",24610,36072,11462
"4066","ENSACAG00000005060","6",18444457,18519384,74927
"4067","ENSACAG00000005061","3",26102562,26280862,178300
"4068","ENSACAG00000005062","4",151360445,151386397,25952
"4069","ENSACAG00000005063","1",204580547,204678754,98207
"4070","ENSACAG00000005064","4",151490218,151536959,46741
"4071","ENSACAG00000005065","GL343338.1",1013275,1064208,50933
"4072","ENSACAG00000005066","1",123000519,123009428,8909
"4073","ENSACAG00000005067","3",184414335,184424149,9814
"4074","ENSACAG00000005068","3",184432588,184451080,18492
"4075","ENSACAG00000005069","2",68597280,68622765,25485
"4076","ENSACAG00000005070","1",122954816,122991616,36800
"4077","ENSACAG00000005071","3",142659415,142695274,35859
"4078","ENSACAG00000005072","6",18339897,18366889,26992
"4079","ENSACAG00000005073","5",482253,516161,33908
"4080","ENSACAG00000005075","3",184489477,184505246,15769
"4081","ENSACAG00000005077","5",80415184,80436313,21129
"4082","ENSACAG00000005078","1",201527135,201667719,140584
"4083","ENSACAG00000005080","3",184517163,184537715,20552
"4084","ENSACAG00000005081","5",126231086,126237336,6250
"4085","ENSACAG00000005084","6",77523349,77568650,45301
"4086","ENSACAG00000005085","GL343287.1",213314,226747,13433
"4087","ENSACAG00000005086","3",21986097,22037251,51154
"4088","ENSACAG00000005087","3",142497086,142497844,758
"4089","ENSACAG00000005088","3",142460692,142461075,383
"4090","ENSACAG00000005089","3",142359868,142402810,42942
"4091","ENSACAG00000005090","GL343198.1",3603873,3705750,101877
"4092","ENSACAG00000005091","GL343287.1",260983,282680,21697
"4093","ENSACAG00000005092","3",184556515,184568685,12170
"4094","ENSACAG00000005094","AAWZ02036143",3162,25035,21873
"4095","ENSACAG00000005095","4",133731091,133732999,1908
"4096","ENSACAG00000005096","4",152000913,152077803,76890
"4097","ENSACAG00000005097","GL343498.1",170741,173027,2286
"4098","ENSACAG00000005098","GL343806.1",56165,176094,119929
"4099","ENSACAG00000005099","5",126155628,126158151,2523
"4100","ENSACAG00000005100","GL343904.1",101550,119830,18280
"4101","ENSACAG00000005101","4",133757991,133759797,1806
"4102","ENSACAG00000005103","GL343498.1",149248,165168,15920
"4103","ENSACAG00000005105","1",158555912,158557192,1280
"4104","ENSACAG00000005106","1",53518235,53521375,3140
"4105","ENSACAG00000005107","4",133781884,133846309,64425
"4106","ENSACAG00000005108","1",53549466,53583943,34477
"4107","ENSACAG00000005109","1",158595480,158708000,112520
"4108","ENSACAG00000005110","GL343203.1",4605215,4627520,22305
"4109","ENSACAG00000005111","GL343338.1",1124526,1154021,29495
"4110","ENSACAG00000005112","4",88871326,88952004,80678
"4111","ENSACAG00000005113","3",142300053,142342279,42226
"4112","ENSACAG00000005114","3",22053387,22110991,57604
"4113","ENSACAG00000005115","5",80348599,80408585,59986
"4114","ENSACAG00000005116","5",126086699,126087931,1232
"4115","ENSACAG00000005118","1",122922338,122946181,23843
"4116","ENSACAG00000005119","3",184608312,184655858,47546
"4117","ENSACAG00000005120","6",926243,1006300,80057
"4118","ENSACAG00000005122","AAWZ02039571",5081,6256,1175
"4119","ENSACAG00000005123","2",116438937,116471400,32463
"4120","ENSACAG00000005125","GL343449.1",195133,232310,37177
"4121","ENSACAG00000005126","6",77068112,77091500,23388
"4122","ENSACAG00000005128","GL343904.1",128858,138750,9892
"4123","ENSACAG00000005129","LGf",2944169,2959280,15111
"4124","ENSACAG00000005130","6",77129981,77147856,17875
"4125","ENSACAG00000005131","GL344430.1",9771,35366,25595
"4126","ENSACAG00000005132","1",213382248,213850510,468262
"4127","ENSACAG00000005133","GL343203.1",4407499,4553332,145833
"4128","ENSACAG00000005134","2",144194598,144206546,11948
"4129","ENSACAG00000005135","3",22193920,22200619,6699
"4130","ENSACAG00000005136","3",41416337,41482317,65980
"4131","ENSACAG00000005137","6",1012812,1024662,11850
"4132","ENSACAG00000005138","5",126023958,126057102,33144
"4133","ENSACAG00000005140","3",22228762,22274452,45690
"4134","ENSACAG00000005141","1",53593730,53678229,84499
"4135","ENSACAG00000005142","6",18296483,18332087,35604
"4136","ENSACAG00000005143","GL343318.1",700803,704651,3848
"4137","ENSACAG00000005144","5",125867385,126017348,149963
"4138","ENSACAG00000005145","GL343318.1",655538,664390,8852
"4139","ENSACAG00000005146","1",122893736,122921201,27465
"4140","ENSACAG00000005148","5",26109584,26191087,81503
"4141","ENSACAG00000005149","2",144228552,144239569,11017
"4142","ENSACAG00000005151","GL343208.1",4061741,4080818,19077
"4143","ENSACAG00000005152","GL343498.1",137709,141509,3800
"4144","ENSACAG00000005153","4",152389575,152395774,6199
"4145","ENSACAG00000005154","GL343318.1",550259,552367,2108
"4146","ENSACAG00000005155","GL343318.1",472954,512107,39153
"4147","ENSACAG00000005156","GL343449.1",343348,343911,563
"4148","ENSACAG00000005157","GL343208.1",4038808,4040586,1778
"4149","ENSACAG00000005158","GL343449.1",364842,425949,61107
"4150","ENSACAG00000005159","AAWZ02036659",6827,23920,17093
"4151","ENSACAG00000005160","5",125448959,125455871,6912
"4152","ENSACAG00000005161","GL343498.1",118186,135875,17689
"4153","ENSACAG00000005162","GL343318.1",441524,468698,27174
"4154","ENSACAG00000005163","3",41516183,41520990,4807
"4155","ENSACAG00000005164","3",142228427,142274047,45620
"4156","ENSACAG00000005165","3",41517639,41572965,55326
"4157","ENSACAG00000005166","2",116376572,116411453,34881
"4158","ENSACAG00000005167","GL343318.1",430949,440717,9768
"4159","ENSACAG00000005168","4",152407879,152429781,21902
"4160","ENSACAG00000005169","GL344593.1",3147,26084,22937
"4161","ENSACAG00000005170","5",566235,598337,32102
"4162","ENSACAG00000005171","2",116329561,116343695,14134
"4163","ENSACAG00000005172","1",88006532,88039983,33451
"4164","ENSACAG00000005173","5",125140170,125288719,148549
"4165","ENSACAG00000005174","GL343318.1",124017,397504,273487
"4166","ENSACAG00000005175","GL343208.1",3867482,3884995,17513
"4167","ENSACAG00000005176","4",80134886,80392654,257768
"4168","ENSACAG00000005177","GL343208.1",3672955,3862654,189699
"4169","ENSACAG00000005178","AAWZ02040943",2197,4963,2766
"4170","ENSACAG00000005179","1",53721440,53742093,20653
"4171","ENSACAG00000005180","1",53859856,54087876,228020
"4172","ENSACAG00000005181","GL343287.1",296824,335734,38910
"4173","ENSACAG00000005182","3",36385836,36407412,21576
"4174","ENSACAG00000005183","GL343498.1",108728,112169,3441
"4175","ENSACAG00000005184","2",116248664,116309329,60665
"4176","ENSACAG00000005185","1",87939810,87954050,14240
"4177","ENSACAG00000005186","3",111524805,111671066,146261
"4178","ENSACAG00000005188","GL343400.1",726949,745560,18611
"4179","ENSACAG00000005190","5",80317289,80335642,18353
"4180","ENSACAG00000005192","1",87893835,87926967,33132
"4181","ENSACAG00000005194","GL343208.1",3816899,3834038,17139
"4182","ENSACAG00000005195","1",158776243,158789131,12888
"4183","ENSACAG00000005196","1",214512350,214554095,41745
"4184","ENSACAG00000005198","GL343449.1",430572,441180,10608
"4185","ENSACAG00000005200","4",88728876,88858884,130008
"4186","ENSACAG00000005201","6",1026174,1063396,37222
"4187","ENSACAG00000005202","1",158852330,159000434,148104
"4188","ENSACAG00000005203","GL343400.1",745754,848632,102878
"4189","ENSACAG00000005205","2",47043636,47090177,46541
"4190","ENSACAG00000005207","5",80260757,80297267,36510
"4191","ENSACAG00000005208","5",26051993,26057350,5357
"4192","ENSACAG00000005210","3",41577873,41589423,11550
"4193","ENSACAG00000005211","2",144245369,144492396,247027
"4194","ENSACAG00000005212","GL344186.1",60737,62494,1757
"4195","ENSACAG00000005213","4",152432481,152496503,64022
"4196","ENSACAG00000005214","GL343449.1",447546,480791,33245
"4197","ENSACAG00000005215","5",26014704,26046818,32114
"4198","ENSACAG00000005216","GL343853.1",113172,126817,13645
"4199","ENSACAG00000005217","5",57767909,57770035,2126
"4200","ENSACAG00000005218","5",57374847,57675212,300365
"4201","ENSACAG00000005219","1",87821571,87832118,10547
"4202","ENSACAG00000005220","2",68672297,68707627,35330
"4203","ENSACAG00000005221","6",1082904,1127895,44991
"4204","ENSACAG00000005222","GL343285.1",195937,338812,142875
"4205","ENSACAG00000005223","6",18217621,18265549,47928
"4206","ENSACAG00000005224","3",41619064,41620713,1649
"4207","ENSACAG00000005225","3",41654738,41756946,102208
"4208","ENSACAG00000005226","4",80457274,80500280,43006
"4209","ENSACAG00000005227","5",25992119,26014076,21957
"4210","ENSACAG00000005228","AAWZ02038786",1938,7696,5758
"4211","ENSACAG00000005229","GL343498.1",96838,99481,2643
"4212","ENSACAG00000005230","2",46935244,47007521,72277
"4213","ENSACAG00000005231","GL343498.1",82923,90129,7206
"4214","ENSACAG00000005232","1",87746714,87746953,239
"4215","ENSACAG00000005233","3",36342401,36368652,26251
"4216","ENSACAG00000005234","3",42499178,42656986,157808
"4217","ENSACAG00000005236","2",116276713,116290960,14247
"4218","ENSACAG00000005237","GL343938.1",117719,136198,18479
"4219","ENSACAG00000005239","GL343691.1",183748,192846,9098
"4220","ENSACAG00000005242","GL344230.1",23295,44057,20762
"4221","ENSACAG00000005243","GL343287.1",355559,364380,8821
"4222","ENSACAG00000005244","1",214582674,214620446,37772
"4223","ENSACAG00000005245","1",122877292,122881562,4270
"4224","ENSACAG00000005247","2",68689850,68727433,37583
"4225","ENSACAG00000005248","GL343656.1",169101,179642,10541
"4226","ENSACAG00000005249","AAWZ02038481",2177,3918,1741
"4227","ENSACAG00000005251","1",122232394,122303474,71080
"4228","ENSACAG00000005252","GL343389.1",474956,985764,510808
"4229","ENSACAG00000005253","AAWZ02038050",1463,12718,11255
"4230","ENSACAG00000005254","2",116227193,116240310,13117
"4231","ENSACAG00000005255","3",36328227,36335796,7569
"4232","ENSACAG00000005257","2",116219981,116229015,9034
"4233","ENSACAG00000005258","6",18126805,18144038,17233
"4234","ENSACAG00000005259","5",72864374,72865195,821
"4235","ENSACAG00000005260","GL343203.1",4316352,4359462,43110
"4236","ENSACAG00000005261","4",133858936,133887435,28499
"4237","ENSACAG00000005263","3",36266342,36326082,59740
"4238","ENSACAG00000005264","5",80224332,80255468,31136
"4239","ENSACAG00000005265","GL343691.1",214999,226208,11209
"4240","ENSACAG00000005266","2",116212507,116216748,4241
"4241","ENSACAG00000005267","4",88702473,88710688,8215
"4242","ENSACAG00000005270","2",68728766,68747474,18708
"4243","ENSACAG00000005271","2",116114407,116166260,51853
"4244","ENSACAG00000005272","4",80510652,80519203,8551
"4245","ENSACAG00000005273","1",214601671,214602333,662
"4246","ENSACAG00000005274","1",214616969,214763610,146641
"4247","ENSACAG00000005275","5",124994829,125026701,31872
"4248","ENSACAG00000005280","GL343498.1",71245,77866,6621
"4249","ENSACAG00000005282","1",214888798,214921536,32738
"4250","ENSACAG00000005283","1",159668495,159708192,39697
"4251","ENSACAG00000005284","4",80521890,80539313,17423
"4252","ENSACAG00000005285","1",204532396,204552128,19732
"4253","ENSACAG00000005286","1",159719802,159767479,47677
"4254","ENSACAG00000005287","2",144559999,144560937,938
"4255","ENSACAG00000005288","5",80187291,80217126,29835
"4256","ENSACAG00000005289","2",144726157,144758787,32630
"4257","ENSACAG00000005290","GL343198.1",3574028,3575446,1418
"4258","ENSACAG00000005291","AAWZ02038554",3496,11218,7722
"4259","ENSACAG00000005293","GL343377.1",718249,741128,22879
"4260","ENSACAG00000005294","GL343656.1",147435,157385,9950
"4261","ENSACAG00000005295","GL343590.1",376931,391767,14836
"4262","ENSACAG00000005296","GL343287.1",369977,372197,2220
"4263","ENSACAG00000005297","GL344601.1",6561,9404,2843
"4264","ENSACAG00000005299","AAWZ02038652",521,10900,10379
"4265","ENSACAG00000005300","GL343656.1",126842,139250,12408
"4266","ENSACAG00000005301","6",1133594,1177484,43890
"4267","ENSACAG00000005303","AAWZ02039592",4229,8281,4052
"4268","ENSACAG00000005304","GL343198.1",3555609,3559742,4133
"4269","ENSACAG00000005305","4",88648783,88666996,18213
"4270","ENSACAG00000005306","GL343318.1",40934,56311,15377
"4271","ENSACAG00000005307","4",49663910,49665310,1400
"4272","ENSACAG00000005308","4",27490188,27491300,1112
"4273","ENSACAG00000005311","AAWZ02039090",1432,9505,8073
"4274","ENSACAG00000005312","GL344427.1",11278,31103,19825
"4275","ENSACAG00000005313","GL344454.1",21848,27089,5241
"4276","ENSACAG00000005315","4",27593086,27606433,13347
"4277","ENSACAG00000005316","4",49787391,49798579,11188
"4278","ENSACAG00000005317","GL343198.1",3529307,3544473,15166
"4279","ENSACAG00000005318","5",25955231,25971244,16013
"4280","ENSACAG00000005320","6",77371655,77457611,85956
"4281","ENSACAG00000005321","GL343507.1",276255,303184,26929
"4282","ENSACAG00000005322","5",124955283,124966704,11421
"4283","ENSACAG00000005323","GL343498.1",67367,68305,938
"4284","ENSACAG00000005324","4",133896596,133928473,31877
"4285","ENSACAG00000005326","GL343498.1",55272,55682,410
"4286","ENSACAG00000005327","GL343498.1",45826,50279,4453
"4287","ENSACAG00000005328","2",46875781,46880895,5114
"4288","ENSACAG00000005329","4",49803101,49895215,92114
"4289","ENSACAG00000005331","GL343691.1",230329,242543,12214
"4290","ENSACAG00000005332","4",50577706,50699046,121340
"4291","ENSACAG00000005335","GL343786.1",58917,170574,111657
"4292","ENSACAG00000005336","1",122137216,122211511,74295
"4293","ENSACAG00000005337","GL343637.1",101470,110594,9124
"4294","ENSACAG00000005338","GL343861.1",6506,17077,10571
"4295","ENSACAG00000005340","4",50800946,50855756,54810
"4296","ENSACAG00000005341","2",144788938,144791311,2373
"4297","ENSACAG00000005342","GL343933.1",660,7619,6959
"4298","ENSACAG00000005344","AAWZ02037266",482,15684,15202
"4299","ENSACAG00000005345","GL344354.1",7298,13447,6149
"4300","ENSACAG00000005346","GL343498.1",40727,43888,3161
"4301","ENSACAG00000005347","GL343272.1",4765,56846,52081
"4302","ENSACAG00000005348","5",25830174,25923242,93068
"4303","ENSACAG00000005349","GL344209.1",2379,66795,64416
"4304","ENSACAG00000005350","4",27619625,27627137,7512
"4305","ENSACAG00000005352","1",159915077,159916168,1091
"4306","ENSACAG00000005353","2",144796668,144850743,54075
"4307","ENSACAG00000005354","1",121685347,121702449,17102
"4308","ENSACAG00000005355","GL343861.1",55301,62142,6841
"4309","ENSACAG00000005356","1",160036329,160075821,39492
"4310","ENSACAG00000005357","GL343498.1",2089,34425,32336
"4311","ENSACAG00000005358","3",138792487,139227393,434906
"4312","ENSACAG00000005359","3",36201683,36229936,28253
"4313","ENSACAG00000005360","GL343389.1",123218,145281,22063
"4314","ENSACAG00000005361","6",18062808,18115005,52197
"4315","ENSACAG00000005362","GL343389.1",81731,150477,68746
"4316","ENSACAG00000005363","GL343861.1",123215,126778,3563
"4317","ENSACAG00000005364","GL343263.1",1977376,2002609,25233
"4318","ENSACAG00000005365","AAWZ02040396",79,5482,5403
"4319","ENSACAG00000005366","GL344559.1",5687,24102,18415
"4320","ENSACAG00000005367","GL343536.1",28109,76313,48204
"4321","ENSACAG00000005368","GL343198.1",3449819,3453644,3825
"4322","ENSACAG00000005369","4",88625486,88635076,9590
"4323","ENSACAG00000005370","2",115999765,116005747,5982
"4324","ENSACAG00000005372","GL344454.1",2048,21154,19106
"4325","ENSACAG00000005374","3",138147853,138190796,42943
"4326","ENSACAG00000005375","2",116020650,116030691,10041
"4327","ENSACAG00000005376","2",115860490,115967122,106632
"4328","ENSACAG00000005377","GL343216.1",2191044,2191714,670
"4329","ENSACAG00000005378","GL343203.1",4205981,4316023,110042
"4330","ENSACAG00000005379","2",46842472,46868453,25981
"4331","ENSACAG00000005380","GL343198.1",3390349,3424355,34006
"4332","ENSACAG00000005381","GL343439.1",90,25398,25308
"4333","ENSACAG00000005382","GL343216.1",2422722,2587634,164912
"4334","ENSACAG00000005383","4",80545203,80670478,125275
"4335","ENSACAG00000005384","6",77269978,77334843,64865
"4336","ENSACAG00000005385","GL344037.1",2637,44221,41584
"4337","ENSACAG00000005388","GL343578.1",39154,195145,155991
"4338","ENSACAG00000005389","1",160075750,160097677,21927
"4339","ENSACAG00000005391","2",145012343,145101491,89148
"4340","ENSACAG00000005392","AAWZ02037456",6766,14422,7656
"4341","ENSACAG00000005393","AAWZ02037209",2177,18032,15855
"4342","ENSACAG00000005394","2",145119642,145156207,36565
"4343","ENSACAG00000005395","GL343272.1",123209,243409,120200
"4344","ENSACAG00000005396","GL344965.1",1198,12130,10932
"4345","ENSACAG00000005397","3",22289238,22292768,3530
"4346","ENSACAG00000005398","3",22369244,22396563,27319
"4347","ENSACAG00000005399","GL343287.1",394218,400780,6562
"4348","ENSACAG00000005400","5",80089437,80183478,94041
"4349","ENSACAG00000005401","3",138237713,138270799,33086
"4350","ENSACAG00000005402","GL343377.1",840762,871410,30648
"4351","ENSACAG00000005403","GL343865.1",143438,171056,27618
"4352","ENSACAG00000005404","GL343198.1",3371512,3386011,14499
"4353","ENSACAG00000005405","4",27646227,27663759,17532
"4354","ENSACAG00000005406","4",88400579,88558171,157592
"4355","ENSACAG00000005407","4",133934399,133978852,44453
"4356","ENSACAG00000005408","GL343514.1",418293,440864,22571
"4357","ENSACAG00000005409","GL343454.1",520327,536141,15814
"4358","ENSACAG00000005410","2",145246511,145275001,28490
"4359","ENSACAG00000005411","5",850708,857406,6698
"4360","ENSACAG00000005414","5",40974945,40999099,24154
"4361","ENSACAG00000005416","3",139533493,139537071,3578
"4362","ENSACAG00000005417","3",22396647,22424240,27593
"4363","ENSACAG00000005418","5",653121,665838,12717
"4364","ENSACAG00000005419","3",139595125,139638556,43431
"4365","ENSACAG00000005420","1",160107123,160122533,15410
"4366","ENSACAG00000005421","AAWZ02038597",8409,11082,2673
"4367","ENSACAG00000005422","GL344671.1",6731,20559,13828
"4368","ENSACAG00000005423","2",151775976,151776689,713
"4369","ENSACAG00000005425","GL343287.1",403003,418281,15278
"4370","ENSACAG00000005428","2",68791040,68920700,129660
"4371","ENSACAG00000005429","GL343453.1",626173,660743,34570
"4372","ENSACAG00000005430","5",25788453,25829812,41359
"4373","ENSACAG00000005431","1",160760133,161150322,390189
"4374","ENSACAG00000005432","3",144530295,144607905,77610
"4375","ENSACAG00000005433","GL343453.1",601775,610059,8284
"4376","ENSACAG00000005434","GL343263.1",2010380,2010505,125
"4377","ENSACAG00000005436","3",36212139,36221708,9569
"4378","ENSACAG00000005437","GL343268.1",120324,241900,121576
"4379","ENSACAG00000005438","3",36132720,36190208,57488
"4380","ENSACAG00000005439","4",80694045,80893818,199773
"4381","ENSACAG00000005440","3",22445564,22501647,56083
"4382","ENSACAG00000005441","GL343453.1",574178,599100,24922
"4383","ENSACAG00000005442","3",139660489,139691129,30640
"4384","ENSACAG00000005443","1",161217470,161299284,81814
"4385","ENSACAG00000005445","GL343311.1",1221497,1473987,252490
"4386","ENSACAG00000005446","3",138399391,138427594,28203
"4387","ENSACAG00000005447","2",115783039,115792175,9136
"4388","ENSACAG00000005448","GL343339.1",474411,672913,198502
"4389","ENSACAG00000005449","GL343377.1",906190,949052,42862
"4390","ENSACAG00000005450","3",138430803,138440967,10164
"4391","ENSACAG00000005451","3",139695040,139704461,9421
"4392","ENSACAG00000005452","GL343457.1",116564,668312,551748
"4393","ENSACAG00000005453","3",139707874,139718848,10974
"4394","ENSACAG00000005454","GL344147.1",19601,30098,10497
"4395","ENSACAG00000005456","1",215103884,215233604,129720
"4396","ENSACAG00000005457","1",252830628,252831023,395
"4397","ENSACAG00000005458","1",252782246,252791792,9546
"4398","ENSACAG00000005459","5",106264055,106652694,388639
"4399","ENSACAG00000005460","3",139743736,139807241,63505
"4400","ENSACAG00000005461","4",88347813,88398544,50731
"4401","ENSACAG00000005462","4",152515768,152581105,65337
"4402","ENSACAG00000005463","5",669192,686780,17588
"4403","ENSACAG00000005464","2",115719154,115728345,9191
"4404","ENSACAG00000005465","GL343400.1",853891,874437,20546
"4405","ENSACAG00000005466","GL343536.1",60428,61249,821
"4406","ENSACAG00000005467","GL344354.1",29825,46813,16988
"4407","ENSACAG00000005468","4",27665791,27696501,30710
"4408","ENSACAG00000005469","1",121596101,121610603,14502
"4409","ENSACAG00000005470","GL343536.1",68510,84778,16268
"4410","ENSACAG00000005471","GL343198.1",3338818,3364810,25992
"4411","ENSACAG00000005472","2",144862111,144877088,14977
"4412","ENSACAG00000005473","GL343454.1",493352,514011,20659
"4413","ENSACAG00000005474","GL343377.1",958623,972532,13909
"4414","ENSACAG00000005475","GL344733.1",110,13166,13056
"4415","ENSACAG00000005476","1",252721906,252776769,54863
"4416","ENSACAG00000005477","4",50865105,50973289,108184
"4417","ENSACAG00000005478","2",115617875,115718430,100555
"4418","ENSACAG00000005479","GL343454.1",486718,490830,4112
"4419","ENSACAG00000005480","3",144519090,144523561,4471
"4420","ENSACAG00000005481","4",51161839,51195455,33616
"4421","ENSACAG00000005482","GL343865.1",112865,143431,30566
"4422","ENSACAG00000005483","GL343514.1",389882,391152,1270
"4423","ENSACAG00000005484","GL343514.1",326230,363273,37043
"4424","ENSACAG00000005485","5",697932,713085,15153
"4425","ENSACAG00000005486","5",716044,734853,18809
"4426","ENSACAG00000005487","4",133981796,133994314,12518
"4427","ENSACAG00000005488","AAWZ02040058",3418,7433,4015
"4428","ENSACAG00000005489","GL343400.1",896182,937908,41726
"4429","ENSACAG00000005492","GL343454.1",467776,481329,13553
"4430","ENSACAG00000005493","AAWZ02041649",4084,5274,1190
"4431","ENSACAG00000005494","1",215254058,215276884,22826
"4432","ENSACAG00000005495","GL343514.1",314028,324305,10277
"4433","ENSACAG00000005496","1",189137826,189168029,30203
"4434","ENSACAG00000005497","3",144490791,144501702,10911
"4435","ENSACAG00000005498","3",144484779,144487267,2488
"4436","ENSACAG00000005499","6",17921954,17948288,26334
"4437","ENSACAG00000005500","3",144377788,144392493,14705
"4438","ENSACAG00000005502","GL343198.1",3218030,3334020,115990
"4439","ENSACAG00000005503","GL343662.1",258124,260871,2747
"4440","ENSACAG00000005505","GL343453.1",496168,521759,25591
"4441","ENSACAG00000005506","4",152591830,152599295,7465
"4442","ENSACAG00000005508","6",77195620,77265779,70159
"4443","ENSACAG00000005509","GL343691.1",250369,282257,31888
"4444","ENSACAG00000005510","1",252711451,252722172,10721
"4445","ENSACAG00000005512","GL343339.1",748085,770510,22425
"4446","ENSACAG00000005513","4",91498896,92145844,646948
"4447","ENSACAG00000005514","1",252659682,252703202,43520
"4448","ENSACAG00000005516","4",152608930,152646966,38036
"4449","ENSACAG00000005517","4",134005188,134017490,12302
"4450","ENSACAG00000005518","GL343377.1",975981,1024283,48302
"4451","ENSACAG00000005519","AAWZ02037237",9008,13301,4293
"4452","ENSACAG00000005520","3",144007652,144020238,12586
"4453","ENSACAG00000005521","2",115432822,115546688,113866
"4454","ENSACAG00000005524","GL344106.1",6160,18542,12382
"4455","ENSACAG00000005525","2",46220104,46572270,352166
"4456","ENSACAG00000005527","2",68925269,68955715,30446
"4457","ENSACAG00000005528","GL343287.1",437509,456432,18923
"4458","ENSACAG00000005529","GL343514.1",299372,305553,6181
"4459","ENSACAG00000005530","GL343662.1",186190,214023,27833
"4460","ENSACAG00000005531","GL343514.1",245059,254685,9626
"4461","ENSACAG00000005532","1",215714019,215795089,81070
"4462","ENSACAG00000005534","1",189204532,189241708,37176
"4463","ENSACAG00000005535","GL343536.1",88805,120017,31212
"4464","ENSACAG00000005536","5",737798,754233,16435
"4465","ENSACAG00000005537","4",60700273,60923170,222897
"4466","ENSACAG00000005538","GL343454.1",436489,441371,4882
"4467","ENSACAG00000005539","6",1195251,1218650,23399
"4468","ENSACAG00000005540","GL343194.1",9853238,9888522,35284
"4469","ENSACAG00000005541","5",756937,772273,15336
"4470","ENSACAG00000005542","GL344193.1",34598,38309,3711
"4471","ENSACAG00000005543","GL343514.1",217681,240007,22326
"4472","ENSACAG00000005545","4",88271556,88287069,15513
"4473","ENSACAG00000005550","GL343377.1",1046565,1050232,3667
"4474","ENSACAG00000005551","AAWZ02037156",6370,7067,697
"4475","ENSACAG00000005552","GL343287.1",500894,537447,36553
"4476","ENSACAG00000005553","4",88258680,88266957,8277
"4477","ENSACAG00000005554","1",161364768,161459269,94501
"4478","ENSACAG00000005555","GL343454.1",295007,427442,132435
"4479","ENSACAG00000005556","2",163098053,163188567,90514
"4480","ENSACAG00000005557","1",215804136,215812401,8265
"4481","ENSACAG00000005558","GL343691.1",286547,286813,266
"4482","ENSACAG00000005559","2",46207149,46216085,8936
"4483","ENSACAG00000005560","4",153228878,153254781,25903
"4484","ENSACAG00000005562","GL343536.1",124076,178939,54863
"4485","ENSACAG00000005563","2",145378281,145379589,1308
"4486","ENSACAG00000005564","3",143972906,143997776,24870
"4487","ENSACAG00000005565","4",81316733,81372659,55926
"4488","ENSACAG00000005566","2",145380212,145417378,37166
"4489","ENSACAG00000005567","GL343272.1",448949,814977,366028
"4490","ENSACAG00000005568","1",121579937,121590679,10742
"4491","ENSACAG00000005569","1",121558992,121579144,20152
"4492","ENSACAG00000005570","GL343574.1",23222,31762,8540
"4493","ENSACAG00000005571","4",88213912,88254150,40238
"4494","ENSACAG00000005572","2",46165246,46166556,1310
"4495","ENSACAG00000005573","4",153270174,153278000,7826
"4496","ENSACAG00000005574","GL343236.1",151830,152756,926
"4497","ENSACAG00000005576","5",774577,796637,22060
"4498","ENSACAG00000005578","AAWZ02038447",516,8292,7776
"4499","ENSACAG00000005579","AAWZ02034793",18486,64892,46406
"4500","ENSACAG00000005581","1",189407723,189441970,34247
"4501","ENSACAG00000005582","2",174402462,174434452,31990
"4502","ENSACAG00000005583","3",143880941,143909974,29033
"4503","ENSACAG00000005584","4",153458492,153480465,21973
"4504","ENSACAG00000005585","GL344171.1",65822,66097,275
"4505","ENSACAG00000005586","1",241203514,241394073,190559
"4506","ENSACAG00000005587","2",144878019,144890846,12827
"4507","ENSACAG00000005589","GL343268.1",272971,279064,6093
"4508","ENSACAG00000005591","6",1330467,1331975,1508
"4509","ENSACAG00000005593","6",17728968,17898933,169965
"4510","ENSACAG00000005600","4",91244763,91329739,84976
"4511","ENSACAG00000005601","6",1391616,1409144,17528
"4512","ENSACAG00000005602","GL343514.1",204568,205088,520
"4513","ENSACAG00000005604","2",163080871,163091236,10365
"4514","ENSACAG00000005605","5",69480606,69481876,1270
"4515","ENSACAG00000005606","GL343662.1",151389,167406,16017
"4516","ENSACAG00000005607","GL343268.1",446291,918818,472527
"4517","ENSACAG00000005611","GL343272.1",837313,891532,54219
"4518","ENSACAG00000005612","GL343574.1",47965,51903,3938
"4519","ENSACAG00000005613","GL343400.1",957550,978700,21150
"4520","ENSACAG00000005615","GL343865.1",71972,72406,434
"4521","ENSACAG00000005616","4",61055661,61067524,11863
"4522","ENSACAG00000005617","GL343272.1",928485,972722,44237
"4523","ENSACAG00000005618","GL343574.1",75493,88069,12576
"4524","ENSACAG00000005619","1",215967016,215981804,14788
"4525","ENSACAG00000005620","GL343865.1",90873,91431,558
"4526","ENSACAG00000005621","AAWZ02038933",255,9356,9101
"4527","ENSACAG00000005622","GL343194.1",9814233,9825915,11682
"4528","ENSACAG00000005623","GL343865.1",28678,29233,555
"4529","ENSACAG00000005624","GL344106.1",31471,47249,15778
"4530","ENSACAG00000005625","1",252067242,252261149,193907
"4531","ENSACAG00000005626","6",17706374,17727480,21106
"4532","ENSACAG00000005628","GL343211.1",2359106,2382986,23880
"4533","ENSACAG00000005630","GL343339.1",781091,815826,34735
"4534","ENSACAG00000005631","2",144900206,144910116,9910
"4535","ENSACAG00000005632","4",27744247,28011216,266969
"4536","ENSACAG00000005633","GL343453.1",452071,466160,14089
"4537","ENSACAG00000005634","6",17680690,17698645,17955
"4538","ENSACAG00000005635","1",215824440,215828694,4254
"4539","ENSACAG00000005636","2",46026609,46141988,115379
"4540","ENSACAG00000005638","2",145433196,145438477,5281
"4541","ENSACAG00000005639","GL343194.1",9747876,9782848,34972
"4542","ENSACAG00000005640","GL344614.1",950,10183,9233
"4543","ENSACAG00000005641","1",216000979,216002560,1581
"4544","ENSACAG00000005642","GL343574.1",106765,158513,51748
"4545","ENSACAG00000005643","5",798066,798629,563
"4546","ENSACAG00000005645","GL343259.1",1614327,1917881,303554
"4547","ENSACAG00000005646","GL344299.1",23704,42134,18430
"4548","ENSACAG00000005647","5",805980,824124,18144
"4549","ENSACAG00000005649","1",252035529,252061756,26227
"4550","ENSACAG00000005650","3",143681016,143802968,121952
"4551","ENSACAG00000005651","2",163042527,163071216,28689
"4552","ENSACAG00000005652","GL343400.1",985831,992125,6294
"4553","ENSACAG00000005654","4",125834990,125893150,58160
"4554","ENSACAG00000005655","2",45719732,45909328,189596
"4555","ENSACAG00000005657","2",174443340,174458573,15233
"4556","ENSACAG00000005658","1",241037421,241178255,140834
"4557","ENSACAG00000005659","2",174477259,175109271,632012
"4558","ENSACAG00000005660","GL343437.1",16491,28235,11744
"4559","ENSACAG00000005662","4",28364048,28416054,52006
"4560","ENSACAG00000005663","5",831754,846415,14661
"4561","ENSACAG00000005664","GL343194.1",9688384,9741064,52680
"4562","ENSACAG00000005665","GL343211.1",2280719,2319694,38975
"4563","ENSACAG00000005666","3",36101806,36121039,19233
"4564","ENSACAG00000005667","1",161467386,161679079,211693
"4565","ENSACAG00000005668","GL343842.1",8227,32438,24211
"4566","ENSACAG00000005672","GL344345.1",35069,59389,24320
"4567","ENSACAG00000005674","GL343405.1",27123,88040,60917
"4568","ENSACAG00000005675","GL343249.1",286509,305232,18723
"4569","ENSACAG00000005676","GL343194.1",9677310,9686845,9535
"4570","ENSACAG00000005677","2",145441482,145446593,5111
"4571","ENSACAG00000005678","GL343327.1",1482276,1483935,1659
"4572","ENSACAG00000005679","GL343327.1",1460905,1461966,1061
"4573","ENSACAG00000005680","GL343327.1",1445250,1446293,1043
"4574","ENSACAG00000005682","GL343453.1",422726,451118,28392
"4575","ENSACAG00000005683","1",189455785,189475724,19939
"4576","ENSACAG00000005685","4",88193284,88201981,8697
"4577","ENSACAG00000005686","4",153485000,153517759,32759
"4578","ENSACAG00000005688","2",145447702,145457718,10016
"4579","ENSACAG00000005689","5",883118,885074,1956
"4580","ENSACAG00000005690","3",143229325,143271523,42198
"4581","ENSACAG00000005691","4",134031473,134085813,54340
"4582","ENSACAG00000005693","GL343249.1",397126,428466,31340
"4583","ENSACAG00000005694","4",28447083,28496107,49024
"4584","ENSACAG00000005695","5",888113,913873,25760
"4585","ENSACAG00000005696","GL343211.1",2262335,2275812,13477
"4586","ENSACAG00000005697","4",81466043,81482718,16675
"4587","ENSACAG00000005699","3",22526473,22687623,161150
"4588","ENSACAG00000005700","3",36077375,36089835,12460
"4589","ENSACAG00000005701","GL343514.1",80647,142933,62286
"4590","ENSACAG00000005702","5",946588,968772,22184
"4591","ENSACAG00000005704","GL343405.1",120892,121827,935
"4592","ENSACAG00000005705","GL343339.1",849653,856006,6353
"4593","ENSACAG00000005706","1",121455279,121555446,100167
"4594","ENSACAG00000005707","GL343405.1",163793,181748,17955
"4595","ENSACAG00000005708","GL343272.1",978740,985865,7125
"4596","ENSACAG00000005709","GL343405.1",183574,205426,21852
"4597","ENSACAG00000005710","4",153541099,153680858,139759
"4598","ENSACAG00000005713","2",145473145,145476170,3025
"4599","ENSACAG00000005714","GL343198.1",3211707,3218184,6477
"4600","ENSACAG00000005716","4",134110479,134114429,3950
"4601","ENSACAG00000005717","2",134226888,134305541,78653
"4602","ENSACAG00000005718","1",189474632,189509430,34798
"4603","ENSACAG00000005719","2",115318527,115362750,44223
"4604","ENSACAG00000005721","GL343339.1",921615,933005,11390
"4605","ENSACAG00000005722","GL343272.1",989386,1005932,16546
"4606","ENSACAG00000005723","3",114404963,114482015,77052
"4607","ENSACAG00000005724","2",163027875,163031364,3489
"4608","ENSACAG00000005727","1",121385872,121387065,1193
"4609","ENSACAG00000005728","4",88159460,88188244,28784
"4610","ENSACAG00000005729","2",162929342,162952146,22804
"4611","ENSACAG00000005730","AAWZ02037226",5240,17627,12387
"4612","ENSACAG00000005732","GL343339.1",946179,1018982,72803
"4613","ENSACAG00000005735","4",134133553,134174974,41421
"4614","ENSACAG00000005736","1",251856306,251944297,87991
"4615","ENSACAG00000005737","2",145571281,145588819,17538
"4616","ENSACAG00000005738","1",17282031,17284887,2856
"4617","ENSACAG00000005739","1",240580889,240593109,12220
"4618","ENSACAG00000005741","6",1444869,1629025,184156
"4619","ENSACAG00000005742","4",61273581,61512842,239261
"4620","ENSACAG00000005743","GL343194.1",9617960,9621891,3931
"4621","ENSACAG00000005744","1",120911456,121218361,306905
"4622","ENSACAG00000005745","GL343514.1",20921,56511,35590
"4623","ENSACAG00000005746","GL343405.1",208466,218753,10287
"4624","ENSACAG00000005747","GL343211.1",2228509,2242048,13539
"4625","ENSACAG00000005748","3",58838256,59159485,321229
"4626","ENSACAG00000005749","3",22770659,22855947,85288
"4627","ENSACAG00000005750","GL343405.1",232864,326132,93268
"4628","ENSACAG00000005751","2",193368686,193374412,5726
"4629","ENSACAG00000005752","5",1026961,1028898,1937
"4630","ENSACAG00000005753","GL343194.1",9606944,9614127,7183
"4631","ENSACAG00000005754","5",1217864,1310173,92309
"4632","ENSACAG00000005755","GL343236.1",2085095,2110219,25124
"4633","ENSACAG00000005756","4",125895133,125933194,38061
"4634","ENSACAG00000005757","1",189624579,189628195,3616
"4635","ENSACAG00000005758","GL343236.1",2113285,2232050,118765
"4636","ENSACAG00000005759","2",162745945,162921163,175218
"4637","ENSACAG00000005760","4",28522776,28669341,146565
"4638","ENSACAG00000005761","GL343287.1",585886,589064,3178
"4639","ENSACAG00000005762","GL343287.1",609573,611144,1571
"4640","ENSACAG00000005763","1",189635345,189644176,8831
"4641","ENSACAG00000005764","1",189662573,189780615,118042
"4642","ENSACAG00000005765","GL343272.1",1006371,1024225,17854
"4643","ENSACAG00000005767","5",117448413,117534116,85703
"4644","ENSACAG00000005768","3",114176926,114217830,40904
"4645","ENSACAG00000005770","GL343211.1",2167690,2216772,49082
"4646","ENSACAG00000005772","GL343263.1",1958263,1969860,11597
"4647","ENSACAG00000005773","3",35988944,36073294,84350
"4648","ENSACAG00000005774","4",134176086,134194620,18534
"4649","ENSACAG00000005775","6",1766585,1838823,72238
"4650","ENSACAG00000005777","GL343287.1",620951,635877,14926
"4651","ENSACAG00000005778","2",145602905,145621319,18414
"4652","ENSACAG00000005779","3",114037137,114062932,25795
"4653","ENSACAG00000005780","2",193397922,193415157,17235
"4654","ENSACAG00000005781","GL343437.1",42093,71966,29873
"4655","ENSACAG00000005782","GL343194.1",9509532,9520906,11374
"4656","ENSACAG00000005783","GL343574.1",161151,176636,15485
"4657","ENSACAG00000005784","1",189797609,189980116,182507
"4658","ENSACAG00000005785","GL343574.1",174674,202038,27364
"4659","ENSACAG00000005786","3",113992166,114011589,19423
"4660","ENSACAG00000005787","5",43836459,43836674,215
"4661","ENSACAG00000005788","1",251749426,251754861,5435
"4662","ENSACAG00000005789","3",59230452,59247219,16767
"4663","ENSACAG00000005790","GL343453.1",407014,423085,16071
"4664","ENSACAG00000005791","1",190053825,190181228,127403
"4665","ENSACAG00000005792","GL343453.1",391066,403708,12642
"4666","ENSACAG00000005793","2",115290395,115301699,11304
"4667","ENSACAG00000005794","4",88106922,88130973,24051
"4668","ENSACAG00000005795","1",251708644,251726422,17778
"4669","ENSACAG00000005796","GL343272.1",1032418,1064517,32099
"4670","ENSACAG00000005798","GL343405.1",330568,361941,31373
"4671","ENSACAG00000005799","GL343272.1",1049956,1102885,52929
"4672","ENSACAG00000005800","3",138534372,138591682,57310
"4673","ENSACAG00000005804","1",162197223,162298722,101499
"4674","ENSACAG00000005806","GL343236.1",2267235,2280349,13114
"4675","ENSACAG00000005808","6",1886100,1920548,34448
"4676","ENSACAG00000005809","3",184824229,184870588,46359
"4677","ENSACAG00000005810","GL343194.1",9484951,9505964,21013
"4678","ENSACAG00000005811","2",164958505,164980000,21495
"4679","ENSACAG00000005812","1",240267561,240387277,119716
"4680","ENSACAG00000005813","GL343236.1",2285539,2309831,24292
"4681","ENSACAG00000005815","GL343437.1",103413,128333,24920
"4682","ENSACAG00000005816","GL343199.1",2005130,2244743,239613
"4683","ENSACAG00000005817","4",153720844,153833532,112688
"4684","ENSACAG00000005818","1",120890310,120905192,14882
"4685","ENSACAG00000005819","GL343194.1",3537914,3923449,385535
"4686","ENSACAG00000005820","GL343236.1",2328794,2336537,7743
"4687","ENSACAG00000005821","2",68967571,68980930,13359
"4688","ENSACAG00000005822","4",126025596,126025913,317
"4689","ENSACAG00000005823","4",126062923,126080100,17177
"4690","ENSACAG00000005826","2",162640564,162720076,79512
"4691","ENSACAG00000005827","GL343194.1",4058332,4174907,116575
"4692","ENSACAG00000005829","1",190214209,190262158,47949
"4693","ENSACAG00000005830","GL343263.1",1898530,1927499,28969
"4694","ENSACAG00000005831","2",115130615,115149011,18396
"4695","ENSACAG00000005832","1",120671917,120859317,187400
"4696","ENSACAG00000005834","4",134196754,134209680,12926
"4697","ENSACAG00000005837","2",164792968,164808635,15667
"4698","ENSACAG00000005838","GL343453.1",326197,360124,33927
"4699","ENSACAG00000005839","2",164774279,164789895,15616
"4700","ENSACAG00000005840","GL343405.1",648257,873799,225542
"4701","ENSACAG00000005841","3",59278696,59305209,26513
"4702","ENSACAG00000005842","3",113912561,113935723,23162
"4703","ENSACAG00000005844","GL343194.1",9373023,9421597,48574
"4704","ENSACAG00000005847","GL343293.1",1575895,1604451,28556
"4705","ENSACAG00000005848","GL343293.1",1560825,1570252,9427
"4706","ENSACAG00000005849","6",1946687,1962591,15904
"4707","ENSACAG00000005850","AAWZ02039932",604,807,203
"4708","ENSACAG00000005851","GL343314.1",841533,853481,11948
"4709","ENSACAG00000005856","AAWZ02040724",38,6154,6116
"4710","ENSACAG00000005857","GL343437.1",173619,201445,27826
"4711","ENSACAG00000005858","GL343287.1",684630,698752,14122
"4712","ENSACAG00000005859","5",117439578,117448183,8605
"4713","ENSACAG00000005860","GL343194.1",9214348,9317627,103279
"4714","ENSACAG00000005861","GL344728.1",1716,6387,4671
"4715","ENSACAG00000005862","GL344087.1",12379,19199,6820
"4716","ENSACAG00000005863","2",115115014,115127038,12024
"4717","ENSACAG00000005864","5",1321237,1328822,7585
"4718","ENSACAG00000005865","1",120622583,120638822,16239
"4719","ENSACAG00000005866","GL343662.1",43411,68853,25442
"4720","ENSACAG00000005867","1",162298538,162355782,57244
"4721","ENSACAG00000005868","3",59326144,59395455,69311
"4722","ENSACAG00000005869","2",68985867,68997115,11248
"4723","ENSACAG00000005870","GL343506.1",504599,525701,21102
"4724","ENSACAG00000005871","GL343486.1",5878,32760,26882
"4725","ENSACAG00000005872","4",154033759,154113799,80040
"4726","ENSACAG00000005874","GL343475.1",153358,171341,17983
"4727","ENSACAG00000005875","GL343842.1",116438,187807,71369
"4728","ENSACAG00000005877","2",115071532,115086502,14970
"4729","ENSACAG00000005878","GL343272.1",1106396,1157437,51041
"4730","ENSACAG00000005879","GL343249.1",679982,682347,2365
"4731","ENSACAG00000005880","1",254075161,254093780,18619
"4732","ENSACAG00000005882","2",68997140,69012888,15748
"4733","ENSACAG00000005883","1",251652656,251696719,44063
"4734","ENSACAG00000005884","2",162584943,162647277,62334
"4735","ENSACAG00000005885","GL343249.1",1552955,1554118,1163
"4736","ENSACAG00000005886","GL343437.1",208909,279937,71028
"4737","ENSACAG00000005887","5",117399402,117429891,30489
"4738","ENSACAG00000005888","AAWZ02040747",234,365,131
"4739","ENSACAG00000005889","GL343293.1",1385827,1423849,38022
"4740","ENSACAG00000005890","GL343194.1",4198541,4199323,782
"4741","ENSACAG00000005891","GL343249.1",1643695,1662904,19209
"4742","ENSACAG00000005892","AAWZ02038094",251,5387,5136
"4743","ENSACAG00000005894","2",162193301,162512276,318975
"4744","ENSACAG00000005895","GL343237.1",2045893,2146467,100574
"4745","ENSACAG00000005896","4",126090683,126106002,15319
"4746","ENSACAG00000005897","GL343567.1",84911,410791,325880
"4747","ENSACAG00000005898","GL343445.1",671921,706022,34101
"4748","ENSACAG00000005899","5",42234326,42278779,44453
"4749","ENSACAG00000005900","2",115019685,115074498,54813
"4750","ENSACAG00000005901","1",240010792,240052996,42204
"4751","ENSACAG00000005903","4",134213183,134262240,49057
"4752","ENSACAG00000005904","1",239848811,239931076,82265
"4753","ENSACAG00000005905","GL344087.1",38720,64263,25543
"4754","ENSACAG00000005906","GL343339.1",1030725,1088282,57557
"4755","ENSACAG00000005909","2",134110585,134219572,108987
"4756","ENSACAG00000005913","2",45524594,45634546,109952
"4757","ENSACAG00000005914","GL343194.1",4372421,4542250,169829
"4758","ENSACAG00000005917","3",113554604,113723537,168933
"4759","ENSACAG00000005919","GL344236.1",23522,45390,21868
"4760","ENSACAG00000005920","GL343506.1",375434,404598,29164
"4761","ENSACAG00000005926","4",61559782,61835606,275824
"4762","ENSACAG00000005927","4",126143612,126144424,812
"4763","ENSACAG00000005929","GL343243.1",2088251,2221051,132800
"4764","ENSACAG00000005930","GL343762.1",181365,207068,25703
"4765","ENSACAG00000005931","4",126158202,126177093,18891
"4766","ENSACAG00000005932","GL343453.1",297293,319830,22537
"4767","ENSACAG00000005933","2",145622370,145637992,15622
"4768","ENSACAG00000005935","1",162371455,162381334,9879
"4769","ENSACAG00000005936","GL343453.1",262240,262311,71
"4770","ENSACAG00000005937","GL343287.1",713980,729556,15576
"4771","ENSACAG00000005940","GL343453.1",200145,218053,17908
"4772","ENSACAG00000005941","GL343453.1",159725,166483,6758
"4773","ENSACAG00000005942","3",113364919,113384627,19708
"4774","ENSACAG00000005943","GL343249.1",1673355,1689611,16256
"4775","ENSACAG00000005944","GL343506.1",324957,368996,44039
"4776","ENSACAG00000005945","5",117373798,117390991,17193
"4777","ENSACAG00000005946","3",35962025,35976043,14018
"4778","ENSACAG00000005947","5",117244071,117296116,52045
"4779","ENSACAG00000005948","GL343237.1",1911402,1930640,19238
"4780","ENSACAG00000005949","2",69014328,69082839,68511
"4781","ENSACAG00000005951","3",45377966,45393938,15972
"4782","ENSACAG00000005952","GL343380.1",274383,275159,776
"4783","ENSACAG00000005954","GL343293.1",1232515,1257521,25006
"4784","ENSACAG00000005955","GL343482.1",554314,556260,1946
"4785","ENSACAG00000005956","3",112975877,113358806,382929
"4786","ENSACAG00000005957","1",190390302,190427909,37607
"4787","ENSACAG00000005958","AAWZ02038402",306,6820,6514
"4788","ENSACAG00000005959","GL343482.1",543493,545532,2039
"4789","ENSACAG00000005960","1",120518142,120542527,24385
"4790","ENSACAG00000005961","GL343339.1",1113128,1131234,18106
"4791","ENSACAG00000005962","GL343482.1",474782,503928,29146
"4792","ENSACAG00000005963","GL343486.1",74738,81366,6628
"4793","ENSACAG00000005966","GL343212.1",2025804,2353959,328155
"4794","ENSACAG00000005967","1",162451253,162708258,257005
"4795","ENSACAG00000005968","2",145657233,145711291,54058
"4796","ENSACAG00000005969","GL343453.1",109015,120074,11059
"4797","ENSACAG00000005970","GL343272.1",1180484,1196319,15835
"4798","ENSACAG00000005971","3",113323258,113324292,1034
"4799","ENSACAG00000005972","GL343445.1",608561,650890,42329
"4800","ENSACAG00000005973","GL343482.1",391236,457646,66410
"4801","ENSACAG00000005974","GL344172.1",28066,46542,18476
"4802","ENSACAG00000005975","GL343475.1",183111,203622,20511
"4803","ENSACAG00000005976","3",35931137,35953337,22200
"4804","ENSACAG00000005977","3",113259239,113282724,23485
"4805","ENSACAG00000005978","GL343262.1",37531,146458,108927
"4806","ENSACAG00000005979","GL344172.1",50683,67404,16721
"4807","ENSACAG00000005980","GL343249.1",1715052,1730096,15044
"4808","ENSACAG00000005981","GL343536.1",186090,224631,38541
"4809","ENSACAG00000005982","AAWZ02038008",1545,3581,2036
"4810","ENSACAG00000005983","3",45172755,45180702,7947
"4811","ENSACAG00000005984","GL343662.1",28693,35284,6591
"4812","ENSACAG00000005985","GL343249.1",1803551,1829271,25720
"4813","ENSACAG00000005986","GL343968.1",34088,50667,16579
"4814","ENSACAG00000005987","GL343211.1",2156464,2158073,1609
"4815","ENSACAG00000005988","5",116927738,116966931,39193
"4816","ENSACAG00000005989","AAWZ02039160",472,3726,3254
"4817","ENSACAG00000005991","GL343482.1",181732,390200,208468
"4818","ENSACAG00000005992","GL343262.1",208537,320934,112397
"4819","ENSACAG00000005993","2",164727893,164733829,5936
"4820","ENSACAG00000005994","GL343272.1",1210142,1220292,10150
"4821","ENSACAG00000005995","GL343469.1",664453,672445,7992
"4822","ENSACAG00000005997","1",251633049,251637912,4863
"4823","ENSACAG00000005998","2",114967528,114975688,8160
"4824","ENSACAG00000005999","GL343293.1",1206198,1233501,27303
"4825","ENSACAG00000006000","4",126191369,126214662,23293
"4826","ENSACAG00000006001","5",116893464,116911539,18075
"4827","ENSACAG00000006002","GL343469.1",643177,652143,8966
"4828","ENSACAG00000006003","GL343339.1",1142512,1168790,26278
"4829","ENSACAG00000006004","GL343662.1",6233,21570,15337
"4830","ENSACAG00000006005","GL343194.1",4547559,4608410,60851
"4831","ENSACAG00000006006","1",190430239,190451448,21209
"4832","ENSACAG00000006007","4",154186116,154224079,37963
"4833","ENSACAG00000006009","3",45062101,45163295,101194
"4834","ENSACAG00000006010","2",164703263,164703927,664
"4835","ENSACAG00000006011","1",190481061,190581943,100882
"4836","ENSACAG00000006012","1",251609377,251618482,9105
"4837","ENSACAG00000006013","4",28851823,28934852,83029
"4838","ENSACAG00000006014","GL343453.1",44780,53492,8712
"4839","ENSACAG00000006015","2",164685085,164700999,15914
"4840","ENSACAG00000006016","GL343486.1",80976,92919,11943
"4841","ENSACAG00000006017","2",145714777,145770016,55239
"4842","ENSACAG00000006018","3",113242633,113250605,7972
"4843","ENSACAG00000006019","4",126232449,126246883,14434
"4844","ENSACAG00000006020","GL343659.1",264386,288941,24555
"4845","ENSACAG00000006021","GL343506.1",291573,313644,22071
"4846","ENSACAG00000006024","1",254042201,254053699,11498
"4847","ENSACAG00000006025","GL343484.1",12940,25113,12173
"4848","ENSACAG00000006026","GL343262.1",515388,516317,929
"4849","ENSACAG00000006027","4",154261438,154276540,15102
"4850","ENSACAG00000006029","GL343211.1",2100804,2131331,30527
"4851","ENSACAG00000006031","4",154306508,154324113,17605
"4852","ENSACAG00000006032","1",86647894,87128662,480768
"4853","ENSACAG00000006033","1",120462472,120516154,53682
"4854","ENSACAG00000006034","GL343469.1",619914,637381,17467
"4855","ENSACAG00000006035","GL343194.1",4641618,4684112,42494
"4856","ENSACAG00000006036","4",28939423,29054740,115317
"4857","ENSACAG00000006037","4",126253331,126253588,257
"4858","ENSACAG00000006038","4",126285633,126327469,41836
"4859","ENSACAG00000006040","GL343272.1",1228447,1247366,18919
"4860","ENSACAG00000006041","GL343775.1",134025,135201,1176
"4861","ENSACAG00000006042","GL343659.1",244804,261358,16554
"4862","ENSACAG00000006044","2",114952634,114960580,7946
"4863","ENSACAG00000006045","GL343293.1",1166318,1202827,36509
"4864","ENSACAG00000006047","2",164652192,164683415,31223
"4865","ENSACAG00000006051","GL343742.1",74458,74844,386
"4866","ENSACAG00000006052","1",251507794,251534476,26682
"4867","ENSACAG00000006053","GL344585.1",17744,20559,2815
"4868","ENSACAG00000006055","3",112627255,112658194,30939
"4869","ENSACAG00000006056","GL343263.1",1849568,1865818,16250
"4870","ENSACAG00000006057","GL343484.1",41378,42000,622
"4871","ENSACAG00000006058","2",69091083,69114383,23300
"4872","ENSACAG00000006061","GL343577.1",6460,48912,42452
"4873","ENSACAG00000006063","6",76257405,76271029,13624
"4874","ENSACAG00000006064","GL343536.1",339101,431617,92516
"4875","ENSACAG00000006065","3",103925433,104093719,168286
"4876","ENSACAG00000006066","GL343262.1",1035028,1194831,159803
"4877","ENSACAG00000006067","3",104419789,104449378,29589
"4878","ENSACAG00000006068","GL343577.1",61199,121561,60362
"4879","ENSACAG00000006069","GL343287.1",735505,750833,15328
"4880","ENSACAG00000006070","3",44823727,44977299,153572
"4881","ENSACAG00000006071","GL343263.1",1826071,1843131,17060
"4882","ENSACAG00000006072","1",190862665,190904735,42070
"4883","ENSACAG00000006073","GL343482.1",124599,125093,494
"4884","ENSACAG00000006074","2",45446219,45473605,27386
"4885","ENSACAG00000006076","GL343486.1",111006,120976,9970
"4886","ENSACAG00000006077","GL343484.1",92432,93538,1106
"4887","ENSACAG00000006078","GL343381.1",991280,1038416,47136
"4888","ENSACAG00000006079","GL343490.1",1292,14755,13463
"4889","ENSACAG00000006080","2",69121787,69140136,18349
"4890","ENSACAG00000006081","GL343305.1",60722,68887,8165
"4891","ENSACAG00000006082","1",254028823,254037996,9173
"4892","ENSACAG00000006083","1",190904840,190971352,66512
"4893","ENSACAG00000006084","GL344949.1",2829,4372,1543
"4894","ENSACAG00000006085","GL343548.1",92987,148138,55151
"4895","ENSACAG00000006087","2",69146186,69172992,26806
"4896","ENSACAG00000006088","GL343211.1",2084162,2095540,11378
"4897","ENSACAG00000006089","GL344949.1",11239,15713,4474
"4898","ENSACAG00000006090","GL343484.1",115514,119378,3864
"4899","ENSACAG00000006091","2",69202100,69250013,47913
"4900","ENSACAG00000006092","2",114897975,114903576,5601
"4901","ENSACAG00000006093","GL343475.1",202549,256221,53672
"4902","ENSACAG00000006094","GL343469.1",205738,222186,16448
"4903","ENSACAG00000006097","GL343968.1",68107,77450,9343
"4904","ENSACAG00000006098","GL343263.1",1797713,1803135,5422
"4905","ENSACAG00000006099","GL343381.1",890229,916983,26754
"4906","ENSACAG00000006101","GL343486.1",121133,135305,14172
"4907","ENSACAG00000006102","GL343263.1",1760857,1761951,1094
"4908","ENSACAG00000006103","GL343293.1",1084937,1092420,7483
"4909","ENSACAG00000006104","5",145558204,145588750,30546
"4910","ENSACAG00000006105","GL343305.1",68102,97537,29435
"4911","ENSACAG00000006106","GL343293.1",1066098,1080754,14656
"4912","ENSACAG00000006107","GL343220.1",2513462,2522948,9486
"4913","ENSACAG00000006108","6",76222734,76225196,2462
"4914","ENSACAG00000006110","6",76199630,76217666,18036
"4915","ENSACAG00000006111","GL343263.1",1647842,1668584,20742
"4916","ENSACAG00000006112","2",114874372,114896026,21654
"4917","ENSACAG00000006113","GL343445.1",594722,606298,11576
"4918","ENSACAG00000006114","GL343220.1",2473946,2508040,34094
"4919","ENSACAG00000006115","GL343659.1",194347,239292,44945
"4920","ENSACAG00000006117","1",239783017,239840918,57901
"4921","ENSACAG00000006118","GL343437.1",295181,353098,57917
"4922","ENSACAG00000006120","GL343211.1",2035377,2073162,37785
"4923","ENSACAG00000006121","3",35819054,35910910,91856
"4924","ENSACAG00000006122","1",251480993,251502112,21119
"4925","ENSACAG00000006123","GL343484.1",127239,140768,13529
"4926","ENSACAG00000006124","2",145770978,145772565,1587
"4927","ENSACAG00000006126","GL343262.1",1237998,1388590,150592
"4928","ENSACAG00000006129","3",104452605,104489487,36882
"4929","ENSACAG00000006131","GL343293.1",890315,999187,108872
"4930","ENSACAG00000006132","AAWZ02039578",1253,7726,6473
"4931","ENSACAG00000006133","2",145811420,145844517,33097
"4932","ENSACAG00000006134","1",254025539,254027710,2171
"4933","ENSACAG00000006135","4",126353202,126370305,17103
"4934","ENSACAG00000006136","GL343263.1",1521020,1643103,122083
"4935","ENSACAG00000006137","6",2171773,2253813,82040
"4936","ENSACAG00000006138","4",134267132,134335222,68090
"4937","ENSACAG00000006139","GL343272.1",1254175,1290394,36219
"4938","ENSACAG00000006142","GL343287.1",796973,804314,7341
"4939","ENSACAG00000006143","1",253984454,254026256,41802
"4940","ENSACAG00000006144","AAWZ02038160",1673,5628,3955
"4941","ENSACAG00000006145","GL343490.1",38070,70736,32666
"4942","ENSACAG00000006146","1",34262174,34304214,42040
"4943","ENSACAG00000006150","GL343381.1",851941,859943,8002
"4944","ENSACAG00000006152","5",108077885,108080631,2746
"4945","ENSACAG00000006153","GL343524.1",298527,337770,39243
"4946","ENSACAG00000006154","5",108103800,108157991,54191
"4947","ENSACAG00000006155","4",126369517,126371479,1962
"4948","ENSACAG00000006156","GL343263.1",1397603,1398217,614
"4949","ENSACAG00000006157","GL343520.1",116839,118767,1928
"4950","ENSACAG00000006158","GL343673.1",204394,220110,15716
"4951","ENSACAG00000006159","GL343445.1",507420,555330,47910
"4952","ENSACAG00000006160","2",114804953,114820155,15202
"4953","ENSACAG00000006162","GL343220.1",2431120,2468441,37321
"4954","ENSACAG00000006163","GL343413.1",669789,766281,96492
"4955","ENSACAG00000006164","1",190993969,191014159,20190
"4956","ENSACAG00000006165","6",76112782,76153052,40270
"4957","ENSACAG00000006166","GL343968.1",88864,91232,2368
"4958","ENSACAG00000006167","GL343263.1",1368304,1379303,10999
"4959","ENSACAG00000006168","GL343548.1",218989,244965,25976
"4960","ENSACAG00000006169","2",69277910,69287353,9443
"4961","ENSACAG00000006172","4",154399839,154475227,75388
"4962","ENSACAG00000006173","GL343520.1",257373,277392,20019
"4963","ENSACAG00000006174","1",239572350,239640360,68010
"4964","ENSACAG00000006175","GL343262.1",1394417,1398883,4466
"4965","ENSACAG00000006176","GL343968.1",97529,109776,12247
"4966","ENSACAG00000006177","5",94738448,94772326,33878
"4967","ENSACAG00000006178","GL343262.1",1465667,1486172,20505
"4968","ENSACAG00000006179","GL343484.1",143718,145720,2002
"4969","ENSACAG00000006180","GL343286.1",1382307,1444172,61865
"4970","ENSACAG00000006181","1",238840457,238968557,128100
"4971","ENSACAG00000006182","GL343680.1",269646,272554,2908
"4972","ENSACAG00000006183","3",104502076,104507934,5858
"4973","ENSACAG00000006184","GL343262.1",1486847,1542765,55918
"4974","ENSACAG00000006185","GL343680.1",251270,259901,8631
"4975","ENSACAG00000006186","3",104563414,104596954,33540
"4976","ENSACAG00000006187","GL343577.1",130447,147293,16846
"4977","ENSACAG00000006188","4",126540318,126541058,740
"4978","ENSACAG00000006189","1",251418195,251468113,49918
"4979","ENSACAG00000006190","GL343263.1",1367412,1368092,680
"4980","ENSACAG00000006191","5",108169808,108205853,36045
"4981","ENSACAG00000006193","GL343211.1",1909973,2024108,114135
"4982","ENSACAG00000006194","GL343263.1",1350205,1366384,16179
"4983","ENSACAG00000006197","2",114786667,114793582,6915
"4984","ENSACAG00000006198","GL343262.1",1610783,1681642,70859
"4985","ENSACAG00000006199","6",76016809,76095415,78606
"4986","ENSACAG00000006200","GL343968.1",111086,120823,9737
"4987","ENSACAG00000006202","1",120369332,120435393,66061
"4988","ENSACAG00000006203","5",145523776,145556457,32681
"4989","ENSACAG00000006204","1",191048557,191059856,11299
"4990","ENSACAG00000006205","GL343577.1",168441,170466,2025
"4991","ENSACAG00000006206","GL343484.1",347223,451297,104074
"4992","ENSACAG00000006208","2",114759978,114772937,12959
"4993","ENSACAG00000006209","GL343381.1",833624,846386,12762
"4994","ENSACAG00000006210","GL343577.1",173104,208111,35007
"4995","ENSACAG00000006211","GL343272.1",1347742,1367456,19714
"4996","ENSACAG00000006212","2",114742718,114750546,7828
"4997","ENSACAG00000006213","GL343259.1",1338818,1578780,239962
"4998","ENSACAG00000006215","1",238834531,238835314,783
"4999","ENSACAG00000006216","3",104649861,104784981,135120
"5000","ENSACAG00000006217","4",134350243,134371855,21612
"5001","ENSACAG00000006218","3",35708141,35753834,45693
"5002","ENSACAG00000006219","GL343680.1",226616,246714,20098
"5003","ENSACAG00000006220","GL343272.1",1378002,1710686,332684
"5004","ENSACAG00000006222","1",253970545,253974164,3619
"5005","ENSACAG00000006223","1",191092784,191100862,8078
"5006","ENSACAG00000006224","1",238810538,238827433,16895
"5007","ENSACAG00000006225","GL343211.1",1864535,1881144,16609
"5008","ENSACAG00000006226","1",253927895,253960015,32120
"5009","ENSACAG00000006227","2",69358195,69369500,11305
"5010","ENSACAG00000006228","GL343381.1",799511,800878,1367
"5011","ENSACAG00000006229","4",126669992,126711680,41688
"5012","ENSACAG00000006230","2",114703818,114729270,25452
"5013","ENSACAG00000006231","GL343381.1",733743,766721,32978
"5014","ENSACAG00000006232","1",191113262,191113402,140
"5015","ENSACAG00000006233","1",191133327,191149799,16472
"5016","ENSACAG00000006235","4",126743366,126753481,10115
"5017","ENSACAG00000006236","4",154488811,154514504,25693
"5018","ENSACAG00000006237","1",253874067,253922378,48311
"5019","ENSACAG00000006239","GL343263.1",1329016,1342302,13286
"5020","ENSACAG00000006241","GL343287.1",841283,850888,9605
"5021","ENSACAG00000006242","GL343211.1",1820939,1862320,41381
"5022","ENSACAG00000006243","GL343659.1",175570,190272,14702
"5023","ENSACAG00000006244","1",238762713,238807845,45132
"5024","ENSACAG00000006247","GL343548.1",254294,266361,12067
"5025","ENSACAG00000006249","4",154535296,154594614,59318
"5026","ENSACAG00000006250","GL343316.1",1257916,1351535,93619
"5027","ENSACAG00000006252","GL343194.1",4685849,4740103,54254
"5028","ENSACAG00000006253","GL343413.1",295953,300924,4971
"5029","ENSACAG00000006254","2",69433493,69461873,28380
"5030","ENSACAG00000006255","5",94842020,94842406,386
"5031","ENSACAG00000006256","5",108213796,108228304,14508
"5032","ENSACAG00000006257","AAWZ02038542",2256,11247,8991
"5033","ENSACAG00000006258","GL343413.1",311114,327636,16522
"5034","ENSACAG00000006259","5",94848925,94880497,31572
"5035","ENSACAG00000006260","GL343413.1",245216,256791,11575
"5036","ENSACAG00000006261","GL343413.1",198549,201776,3227
"5037","ENSACAG00000006263","GL343413.1",139369,142004,2635
"5038","ENSACAG00000006264","1",191154417,191162188,7771
"5039","ENSACAG00000006265","GL343259.1",1185258,1283320,98062
"5040","ENSACAG00000006266","GL344107.1",14116,45452,31336
"5041","ENSACAG00000006267","GL343413.1",3342,24215,20873
"5042","ENSACAG00000006268","GL343659.1",132121,165257,33136
"5043","ENSACAG00000006269","GL343680.1",207465,219784,12319
"5044","ENSACAG00000006270","GL343212.1",1832672,1833421,749
"5045","ENSACAG00000006271","5",94901654,94902301,647
"5046","ENSACAG00000006272","2",145877168,145902279,25111
"5047","ENSACAG00000006274","GL343194.1",4745632,4800375,54743
"5048","ENSACAG00000006275","GL343259.1",1143869,1166567,22698
"5049","ENSACAG00000006278","AAWZ02035000",51557,64949,13392
"5050","ENSACAG00000006279","GL343263.1",1302602,1324099,21497
"5051","ENSACAG00000006281","5",108243146,108252831,9685
"5052","ENSACAG00000006283","GL343212.1",1740134,1769844,29710
"5053","ENSACAG00000006284","5",95018720,95091032,72312
"5054","ENSACAG00000006285","GL343548.1",302366,325127,22761
"5055","ENSACAG00000006286","GL343211.1",1731511,1734147,2636
"5056","ENSACAG00000006287","3",44714675,44761914,47239
"5057","ENSACAG00000006288","2",114678906,114700735,21829
"5058","ENSACAG00000006290","AAWZ02035000",5652,47670,42018
"5059","ENSACAG00000006292","GL343316.1",1086571,1239908,153337
"5060","ENSACAG00000006293","5",95088731,95118971,30240
"5061","ENSACAG00000006295","3",35681136,35701836,20700
"5062","ENSACAG00000006296","GL343680.1",78349,104768,26419
"5063","ENSACAG00000006297","6",75968571,75982586,14015
"5064","ENSACAG00000006298","GL343659.1",37987,62859,24872
"5065","ENSACAG00000006299","1",191167879,191251647,83768
"5066","ENSACAG00000006300","3",35608710,35674538,65828
"5067","ENSACAG00000006301","GL343211.1",1413223,1562437,149214
"5068","ENSACAG00000006302","4",154963527,154964441,914
"5069","ENSACAG00000006303","2",69469801,69503616,33815
"5070","ENSACAG00000006305","4",154996630,155030763,34133
"5071","ENSACAG00000006306","GL343259.1",1172645,1179288,6643
"5072","ENSACAG00000006308","GL343490.1",79865,85120,5255
"5073","ENSACAG00000006309","GL344355.1",2439,13924,11485
"5074","ENSACAG00000006310","GL343194.1",4801696,4831828,30132
"5075","ENSACAG00000006311","6",75952159,75969979,17820
"5076","ENSACAG00000006313","5",108260003,108318049,58046
"5077","ENSACAG00000006314","GL343490.1",96354,106332,9978
"5078","ENSACAG00000006315","1",238696477,238709729,13252
"5079","ENSACAG00000006316","2",133931068,134045630,114562
"5080","ENSACAG00000006317","GL343259.1",1130076,1133659,3583
"5081","ENSACAG00000006319","GL343520.1",290486,314805,24319
"5082","ENSACAG00000006320","2",145952828,145954135,1307
"5083","ENSACAG00000006321","2",69508238,69518799,10561
"5084","ENSACAG00000006322","4",126771451,126900737,129286
"5085","ENSACAG00000006323","GL343316.1",1050120,1070733,20613
"5086","ENSACAG00000006324","GL343259.1",1111045,1116690,5645
"5087","ENSACAG00000006325","3",170815551,170889257,73706
"5088","ENSACAG00000006326","2",145958443,145985116,26673
"5089","ENSACAG00000006327","GL343287.1",866751,874910,8159
"5090","ENSACAG00000006328","4",155223851,155229883,6032
"5091","ENSACAG00000006329","GL343548.1",335362,337136,1774
"5092","ENSACAG00000006330","4",134399306,134403049,3743
"5093","ENSACAG00000006331","GL343484.1",471526,475371,3845
"5094","ENSACAG00000006332","4",155269153,155345879,76726
"5095","ENSACAG00000006333","GL343548.1",337502,344448,6946
"5096","ENSACAG00000006334","5",136004214,136073986,69772
"5097","ENSACAG00000006335","GL343262.1",1707911,1802855,94944
"5098","ENSACAG00000006336","1",238672110,238696319,24209
"5099","ENSACAG00000006337","4",134413471,134430895,17424
"5100","ENSACAG00000006338","1",191256604,191325261,68657
"5101","ENSACAG00000006339","GL343577.1",237229,244340,7111
"5102","ENSACAG00000006340","GL343259.1",791994,943117,151123
"5103","ENSACAG00000006341","6",75946647,75949886,3239
"5104","ENSACAG00000006342","2",69521922,69544119,22197
"5105","ENSACAG00000006343","GL343263.1",1285491,1298519,13028
"5106","ENSACAG00000006344","GL343484.1",478458,501838,23380
"5107","ENSACAG00000006345","1",238656004,238660273,4269
"5108","ENSACAG00000006346","3",105298539,105299823,1284
"5109","ENSACAG00000006347","GL344595.1",3663,15448,11785
"5110","ENSACAG00000006348","5",95123256,95129607,6351
"5111","ENSACAG00000006349","GL343316.1",995542,1030750,35208
"5112","ENSACAG00000006350","GL343548.1",347134,354997,7863
"5113","ENSACAG00000006351","4",155353864,155374485,20621
"5114","ENSACAG00000006352","6",75917227,75939347,22120
"5115","ENSACAG00000006353","1",238611997,238623623,11626
"5116","ENSACAG00000006354","GL343293.1",878005,884661,6656
"5117","ENSACAG00000006355","GL343287.1",878648,884648,6000
"5118","ENSACAG00000006356","5",145419936,145454114,34178
"5119","ENSACAG00000006357","GL343287.1",892261,949365,57104
"5120","ENSACAG00000006358","5",95162168,95175168,13000
"5121","ENSACAG00000006359","GL343212.1",1713800,1716389,2589
"5122","ENSACAG00000006360","GL343548.1",363072,372075,9003
"5123","ENSACAG00000006361","GL343212.1",1167023,1202043,35020
"5124","ENSACAG00000006362","3",105515703,105584701,68998
"5125","ENSACAG00000006363","6",75881864,75900145,18281
"5126","ENSACAG00000006364","GL343324.1",215253,223013,7760
"5127","ENSACAG00000006365","GL343211.1",522728,659144,136416
"5128","ENSACAG00000006366","1",238523110,238527967,4857
"5129","ENSACAG00000006367","5",95236883,95294005,57122
"5130","ENSACAG00000006368","GL344355.1",13286,14781,1495
"5131","ENSACAG00000006369","GL343293.1",868629,877096,8467
"5132","ENSACAG00000006370","AAWZ02037530",1207,15819,14612
"5133","ENSACAG00000006373","GL343627.1",129426,130086,660
"5134","ENSACAG00000006375","6",2260856,2286820,25964
"5135","ENSACAG00000006376","GL343445.1",417938,448559,30621
"5136","ENSACAG00000006377","1",251255138,251330365,75227
"5137","ENSACAG00000006378","GL344020.1",35556,44260,8704
"5138","ENSACAG00000006380","AAWZ02037376",2602,15801,13199
"5139","ENSACAG00000006381","1",238495061,238511622,16561
"5140","ENSACAG00000006382","GL343983.1",28,22781,22753
"5141","ENSACAG00000006384","GL343536.1",439437,466716,27279
"5142","ENSACAG00000006385","GL343293.1",763927,802624,38697
"5143","ENSACAG00000006386","1",251273962,251276177,2215
"5144","ENSACAG00000006387","GL344128.1",5133,5405,272
"5145","ENSACAG00000006388","GL343212.1",1056092,1164014,107922
"5146","ENSACAG00000006389","GL343577.1",275613,301626,26013
"5147","ENSACAG00000006390","GL344128.1",9300,35477,26177
"5148","ENSACAG00000006391","GL343520.1",320149,320904,755
"5149","ENSACAG00000006392","GL343395.1",349058,369585,20527
"5150","ENSACAG00000006393","1",251140767,251222496,81729
"5151","ENSACAG00000006394","GL343548.1",370386,389729,19343
"5152","ENSACAG00000006395","GL345013.1",480,13720,13240
"5153","ENSACAG00000006396","GL343677.1",273890,321911,48021
"5154","ENSACAG00000006397","GL343381.1",707783,731960,24177
"5155","ENSACAG00000006398","1",3334397,3402896,68499
"5156","ENSACAG00000006399","GL343716.1",170008,188769,18761
"5157","ENSACAG00000006400","GL343366.1",445316,481504,36188
"5158","ENSACAG00000006401","GL343983.1",92334,113993,21659
"5159","ENSACAG00000006402","AAWZ02036029",20139,31562,11423
"5160","ENSACAG00000006403","2",69547239,69559169,11930
"5161","ENSACAG00000006404","GL343473.1",4889,21373,16484
"5162","ENSACAG00000006405","LGd",12899,19220,6321
"5163","ENSACAG00000006406","2",69578857,69645929,67072
"5164","ENSACAG00000006407","GL344036.1",2200,8166,5966
"5165","ENSACAG00000006408","6",75781126,75781712,586
"5166","ENSACAG00000006409","GL343484.1",529744,580868,51124
"5167","ENSACAG00000006410","GL343263.1",1212288,1285416,73128
"5168","ENSACAG00000006411","GL343395.1",360548,388041,27493
"5169","ENSACAG00000006412","6",75637047,75645469,8422
"5170","ENSACAG00000006413","GL344175.1",19913,28008,8095
"5171","ENSACAG00000006414","GL343577.1",303709,328998,25289
"5172","ENSACAG00000006415","GL343473.1",32012,92226,60214
"5173","ENSACAG00000006417","1",253798501,253863498,64997
"5174","ENSACAG00000006418","GL343497.1",348186,361583,13397
"5175","ENSACAG00000006419","AAWZ02039224",205,9121,8916
"5176","ENSACAG00000006420","GL343497.1",489398,518721,29323
"5177","ENSACAG00000006422","GL344175.1",30878,34180,3302
"5178","ENSACAG00000006423","6",75623536,75629522,5986
"5179","ENSACAG00000006424","GL343262.1",1835395,1885582,50187
"5180","ENSACAG00000006425","GL344036.1",27859,39727,11868
"5181","ENSACAG00000006426","GL343395.1",575209,578359,3150
"5182","ENSACAG00000006427","GL343293.1",653842,733346,79504
"5183","ENSACAG00000006428","4",155430093,155444946,14853
"5184","ENSACAG00000006430","4",134432790,134434109,1319
"5185","ENSACAG00000006432","5",95265539,95273158,7619
"5186","ENSACAG00000006433","GL343577.1",424693,425547,854
"5187","ENSACAG00000006434","6",75614839,75621679,6840
"5188","ENSACAG00000006435","2",146011676,146037627,25951
"5189","ENSACAG00000006436","4",134443720,134472258,28538
"5190","ENSACAG00000006437","5",145396887,145409179,12292
"5191","ENSACAG00000006439","3",35627826,35629569,1743
"5192","ENSACAG00000006440","LGa",2580594,2581075,481
"5193","ENSACAG00000006441","2",114656620,114662887,6267
"5194","ENSACAG00000006443","5",108899129,108945275,46146
"5195","ENSACAG00000006445","GL343220.1",2388207,2422669,34462
"5196","ENSACAG00000006446","3",43477451,43781702,304251
"5197","ENSACAG00000006448","GL343490.1",126977,167284,40307
"5198","ENSACAG00000006449","GL343548.1",410674,419279,8605
"5199","ENSACAG00000006450","3",35531552,35582655,51103
"5200","ENSACAG00000006451","GL343381.1",665583,700924,35341
"5201","ENSACAG00000006453","3",170645491,170775331,129840
"5202","ENSACAG00000006455","1",251060893,251076684,15791
"5203","ENSACAG00000006456","5",95300984,95312074,11090
"5204","ENSACAG00000006457","4",155518610,155520073,1463
"5205","ENSACAG00000006458","GL343731.1",212613,264040,51427
"5206","ENSACAG00000006459","AAWZ02036833",13779,18076,4297
"5207","ENSACAG00000006460","GL344128.1",41285,52696,11411
"5208","ENSACAG00000006461","GL343395.1",591871,615633,23762
"5209","ENSACAG00000006462","GL343262.1",1888820,1946765,57945
"5210","ENSACAG00000006463","2",114644979,114652357,7378
"5211","ENSACAG00000006464","4",155542418,155581922,39504
"5212","ENSACAG00000006465","GL343954.1",3107,28802,25695
"5213","ENSACAG00000006466","1",191397923,191398906,983
"5214","ENSACAG00000006467","GL343520.1",399660,415353,15693
"5215","ENSACAG00000006468","GL343395.1",615212,646586,31374
"5216","ENSACAG00000006469","GL343194.1",4850499,4862966,12467
"5217","ENSACAG00000006470","GL343521.1",16605,20289,3684
"5218","ENSACAG00000006471","GL344250.1",24227,32067,7840
"5219","ENSACAG00000006473","GL343521.1",32522,33000,478
"5220","ENSACAG00000006474","6",75598780,75603650,4870
"5221","ENSACAG00000006475","GL343484.1",585793,597419,11626
"5222","ENSACAG00000006476","GL343490.1",185774,201589,15815
"5223","ENSACAG00000006477","GL343520.1",434128,444904,10776
"5224","ENSACAG00000006478","GL344125.1",19225,59294,40069
"5225","ENSACAG00000006479","GL344585.1",21,12440,12419
"5226","ENSACAG00000006480","3",35460683,35461075,392
"5227","ENSACAG00000006481","GL344036.1",46053,70159,24106
"5228","ENSACAG00000006482","GL343287.1",938192,942470,4278
"5229","ENSACAG00000006483","3",35442129,35455723,13594
"5230","ENSACAG00000006484","6",75593542,75596979,3437
"5231","ENSACAG00000006485","GL343287.1",982410,988189,5779
"5232","ENSACAG00000006486","GL343194.1",4878266,4908791,30525
"5233","ENSACAG00000006487","2",146082773,146086715,3942
"5234","ENSACAG00000006488","GL343356.1",260502,315109,54607
"5235","ENSACAG00000006489","5",95316212,95332540,16328
"5236","ENSACAG00000006490","3",105622834,105763922,141088
"5237","ENSACAG00000006491","GL344128.1",56659,65376,8717
"5238","ENSACAG00000006492","GL343520.1",462225,477123,14898
"5239","ENSACAG00000006493","2",114622173,114630505,8332
"5240","ENSACAG00000006494","GL343263.1",1040129,1070363,30234
"5241","ENSACAG00000006498","GL343520.1",545025,569298,24273
"5242","ENSACAG00000006499","6",75565658,75568767,3109
"5243","ENSACAG00000006500","GL343332.1",1387724,1392695,4971
"5244","ENSACAG00000006501","5",67568208,67645467,77259
"5245","ENSACAG00000006502","GL343381.1",640486,655783,15297
"5246","ENSACAG00000006503","GL343521.1",34797,37053,2256
"5247","ENSACAG00000006504","5",95364737,95380667,15930
"5248","ENSACAG00000006506","6",2460335,2567982,107647
"5249","ENSACAG00000006507","GL343716.1",138129,143165,5036
"5250","ENSACAG00000006508","6",75513232,75520712,7480
"5251","ENSACAG00000006509","GL343999.1",7133,20126,12993
"5252","ENSACAG00000006510","2",146090019,146094580,4561
"5253","ENSACAG00000006511","GL343332.1",1361662,1363413,1751
"5254","ENSACAG00000006512","GL344243.1",1051,58033,56982
"5255","ENSACAG00000006513","5",67706435,67764512,58077
"5256","ENSACAG00000006514","GL343521.1",41906,75835,33929
"5257","ENSACAG00000006515","GL343332.1",1343535,1352048,8513
"5258","ENSACAG00000006516","GL343261.1",454752,521380,66628
"5259","ENSACAG00000006517","AAWZ02039808",564,6894,6330
"5260","ENSACAG00000006518","6",12050085,12209652,159567
"5261","ENSACAG00000006519","3",35403516,35433581,30065
"5262","ENSACAG00000006520","AAWZ02035524",6936,7805,869
"5263","ENSACAG00000006521","6",75492178,75495933,3755
"5264","ENSACAG00000006522","1",250954945,251002263,47318
"5265","ENSACAG00000006524","2",114557797,114613731,55934
"5266","ENSACAG00000006525","GL343761.1",177239,198233,20994
"5267","ENSACAG00000006527","GL343194.1",4992051,5050754,58703
"5268","ENSACAG00000006528","GL343395.1",701413,702186,773
"5269","ENSACAG00000006529","6",75455961,75466574,10613
"5270","ENSACAG00000006530","GL343761.1",209204,215074,5870
"5271","ENSACAG00000006531","GL343395.1",752776,762832,10056
"5272","ENSACAG00000006532","3",169769084,169923636,154552
"5273","ENSACAG00000006533","GL343261.1",520790,529612,8822
"5274","ENSACAG00000006534","6",75121061,75133567,12506
"5275","ENSACAG00000006536","5",108948124,108981998,33874
"5276","ENSACAG00000006537","GL343332.1",1140640,1225010,84370
"5277","ENSACAG00000006538","GL343731.1",88729,171224,82495
"5278","ENSACAG00000006540","4",134493066,134604414,111348
"5279","ENSACAG00000006541","GL343212.1",667292,841801,174509
"5280","ENSACAG00000006542","GL343194.1",5168586,5175593,7007
"5281","ENSACAG00000006543","GL343356.1",360930,363482,2552
"5282","ENSACAG00000006544","GL343670.1",5494,68849,63355
"5283","ENSACAG00000006545","LGd",1076898,1077242,344
"5284","ENSACAG00000006546","GL343261.1",534306,663480,129174
"5285","ENSACAG00000006547","3",35378345,35397959,19614
"5286","ENSACAG00000006548","5",95375984,95399546,23562
"5287","ENSACAG00000006549","GL343521.1",84621,143399,58778
"5288","ENSACAG00000006550","GL344476.1",12919,27489,14570
"5289","ENSACAG00000006551","GL343194.1",5183105,5195414,12309
"5290","ENSACAG00000006553","GL343872.1",106646,132295,25649
"5291","ENSACAG00000006554","GL343490.1",205540,213676,8136
"5292","ENSACAG00000006556","6",75001101,75024588,23487
"5293","ENSACAG00000006558","2",146098106,146106086,7980
"5294","ENSACAG00000006559","GL343194.1",5342234,5491169,148935
"5295","ENSACAG00000006562","3",35362300,35375939,13639
"5296","ENSACAG00000006565","4",134622560,134673562,51002
"5297","ENSACAG00000006566","GL343194.1",5892980,5894236,1256
"5298","ENSACAG00000006568","GL343527.1",256159,293412,37253
"5299","ENSACAG00000006571","5",67927995,68305410,377415
"5300","ENSACAG00000006572","GL343194.1",7459226,7671974,212748
"5301","ENSACAG00000006573","3",35340946,35358785,17839
"5302","ENSACAG00000006575","4",134678505,134687916,9411
"5303","ENSACAG00000006576","5",60983477,61016703,33226
"5304","ENSACAG00000006577","GL343395.1",773695,790173,16478
"5305","ENSACAG00000006578","4",134696351,134730964,34613
"5306","ENSACAG00000006579","5",109056416,109117182,60766
"5307","ENSACAG00000006580","GL343381.1",569205,618091,48886
"5308","ENSACAG00000006581","GL343293.1",633520,648619,15099
"5309","ENSACAG00000006582","2",114408911,114510485,101574
"5310","ENSACAG00000006584","GL343212.1",628646,661797,33151
"5311","ENSACAG00000006586","GL343521.1",153774,188945,35171
"5312","ENSACAG00000006587","5",60951470,60970122,18652
"5313","ENSACAG00000006589","GL343473.1",100180,113447,13267
"5314","ENSACAG00000006590","1",162892731,162947846,55115
"5315","ENSACAG00000006591","GL343824.1",996,1925,929
"5316","ENSACAG00000006593","GL343261.1",729273,761613,32340
"5317","ENSACAG00000006594","6",74984824,74996671,11847
"5318","ENSACAG00000006595","GL343287.1",1017241,1025451,8210
"5319","ENSACAG00000006596","GL343312.1",1475106,1482200,7094
"5320","ENSACAG00000006599","2",146109433,146116524,7091
"5321","ENSACAG00000006600","GL343670.1",98511,111451,12940
"5322","ENSACAG00000006601","GL343473.1",115522,139742,24220
"5323","ENSACAG00000006602","GL343332.1",1103615,1109661,6046
"5324","ENSACAG00000006603","GL343259.1",638809,780461,141652
"5325","ENSACAG00000006606","3",169409067,169436789,27722
"5326","ENSACAG00000006607","1",90978972,90993875,14903
"5327","ENSACAG00000006608","GL343521.1",206487,209977,3490
"5328","ENSACAG00000006609","GL343473.1",154175,193417,39242
"5329","ENSACAG00000006610","3",169209421,169365919,156498
"5330","ENSACAG00000006611","5",60741318,60793674,52356
"5331","ENSACAG00000006612","4",155844360,155916991,72631
"5332","ENSACAG00000006613","GL343249.1",1835205,1850589,15384
"5333","ENSACAG00000006614","3",35194294,35325882,131588
"5334","ENSACAG00000006615","6",74950138,74978690,28552
"5335","ENSACAG00000006617","GL343490.1",227341,238894,11553
"5336","ENSACAG00000006618","GL343527.1",106366,154868,48502
"5337","ENSACAG00000006619","2",153298541,153309535,10994
"5338","ENSACAG00000006620","GL343249.1",1863196,1879999,16803
"5339","ENSACAG00000006621","GL343219.1",2533223,2565024,31801
"5340","ENSACAG00000006622","GL343293.1",592340,603518,11178
"5341","ENSACAG00000006623","GL343249.1",1880734,1908444,27710
"5342","ENSACAG00000006624","1",250767844,251002990,235146
"5343","ENSACAG00000006625","GL343263.1",974625,1029808,55183
"5344","ENSACAG00000006626","GL344582.1",21,10339,10318
"5345","ENSACAG00000006627","GL343840.1",181946,197256,15310
"5346","ENSACAG00000006628","1",238332217,238360696,28479
"5347","ENSACAG00000006629","GL343521.1",323530,349032,25502
"5348","ENSACAG00000006630","2",146135305,146141364,6059
"5349","ENSACAG00000006631","GL343473.1",206640,309434,102794
"5350","ENSACAG00000006632","2",146169536,146198703,29167
"5351","ENSACAG00000006633","GL343490.1",251761,310969,59208
"5352","ENSACAG00000006634","GL343332.1",1040726,1045940,5214
"5353","ENSACAG00000006636","2",69678977,69684060,5083
"5354","ENSACAG00000006638","GL344852.1",5744,15746,10002
"5355","ENSACAG00000006639","2",153322573,153340683,18110
"5356","ENSACAG00000006640","GL343293.1",517433,587868,70435
"5357","ENSACAG00000006641","GL343521.1",385358,400120,14762
"5358","ENSACAG00000006642","GL343287.1",1045659,1052531,6872
"5359","ENSACAG00000006643","GL343677.1",263852,271581,7729
"5360","ENSACAG00000006644","GL343332.1",987428,999083,11655
"5361","ENSACAG00000006645","5",109208959,109263140,54181
"5362","ENSACAG00000006646","1",162955644,162967463,11819
"5363","ENSACAG00000006647","GL343521.1",402825,410630,7805
"5364","ENSACAG00000006648","GL343332.1",950974,963098,12124
"5365","ENSACAG00000006649","GL343840.1",169943,181785,11842
"5366","ENSACAG00000006650","2",69688166,69774985,86819
"5367","ENSACAG00000006651","6",74901552,74922123,20571
"5368","ENSACAG00000006654","GL343670.1",114376,128760,14384
"5369","ENSACAG00000006655","2",146207326,146216830,9504
"5370","ENSACAG00000006656","1",162975857,163007886,32029
"5371","ENSACAG00000006657","GL343435.1",132903,212889,79986
"5372","ENSACAG00000006658","1",91002190,91043929,41739
"5373","ENSACAG00000006659","GL343840.1",101129,159668,58539
"5374","ENSACAG00000006660","GL343219.1",2483929,2508879,24950
"5375","ENSACAG00000006661","GL343293.1",365038,504289,139251
"5376","ENSACAG00000006663","GL343395.1",799115,835006,35891
"5377","ENSACAG00000006664","6",2611661,2623590,11929
"5378","ENSACAG00000006665","GL343220.1",2369790,2385135,15345
"5379","ENSACAG00000006666","GL343905.1",115608,137758,22150
"5380","ENSACAG00000006667","GL343249.1",1942574,1982744,40170
"5381","ENSACAG00000006668","1",238280644,238332335,51691
"5382","ENSACAG00000006669","GL343521.1",411671,430888,19217
"5383","ENSACAG00000006670","5",95406878,95419776,12898
"5384","ENSACAG00000006671","2",114303331,114402517,99186
"5385","ENSACAG00000006672","5",60452344,60575950,123606
"5386","ENSACAG00000006673","GL343219.1",2285866,2426139,140273
"5387","ENSACAG00000006674","GL344036.1",79482,89681,10199
"5388","ENSACAG00000006675","5",40851891,40870747,18856
"5389","ENSACAG00000006676","2",153346236,153376725,30489
"5390","ENSACAG00000006677","GL343381.1",564968,567246,2278
"5391","ENSACAG00000006678","GL343381.1",508924,551858,42934
"5392","ENSACAG00000006679","2",153395087,153478261,83174
"5393","ENSACAG00000006680","GL343677.1",233478,252107,18629
"5394","ENSACAG00000006681","GL343840.1",56515,93741,37226
"5395","ENSACAG00000006682","1",163009850,163102028,92178
"5396","ENSACAG00000006683","6",2642798,2675051,32253
"5397","ENSACAG00000006685","5",109285774,109333834,48060
"5398","ENSACAG00000006686","6",74795487,74815579,20092
"5399","ENSACAG00000006690","GL343220.1",2341931,2344972,3041
"5400","ENSACAG00000006691","1",163543177,163974148,430971
"5401","ENSACAG00000006692","2",146220681,146253912,33231
"5402","ENSACAG00000006693","GL343395.1",872168,899883,27715
"5403","ENSACAG00000006694","GL343521.1",435398,474697,39299
"5404","ENSACAG00000006695","5",68319465,68337050,17585
"5405","ENSACAG00000006696","5",40797125,40850942,53817
"5406","ENSACAG00000006697","GL343220.1",2330463,2336819,6356
"5407","ENSACAG00000006698","GL343212.1",580052,617518,37466
"5408","ENSACAG00000006700","2",146253686,146303131,49445
"5409","ENSACAG00000006701","GL343670.1",138316,145351,7035
"5410","ENSACAG00000006702","GL343259.1",555824,567133,11309
"5411","ENSACAG00000006703","5",68396724,68443642,46918
"5412","ENSACAG00000006704","GL343381.1",503093,544128,41035
"5413","ENSACAG00000006705","6",2703474,2712272,8798
"5414","ENSACAG00000006706","GL343731.1",29023,44889,15866
"5415","ENSACAG00000006707","GL343670.1",150179,158943,8764
"5416","ENSACAG00000006708","GL343220.1",2316255,2325376,9121
"5417","ENSACAG00000006709","3",105829694,105912779,83085
"5418","ENSACAG00000006710","GL343490.1",326246,337215,10969
"5419","ENSACAG00000006712","5",59670379,59719441,49062
"5420","ENSACAG00000006713","5",59136066,59503430,367364
"5421","ENSACAG00000006714","2",114121365,114140023,18658
"5422","ENSACAG00000006715","2",153489943,153522871,32928
"5423","ENSACAG00000006717","6",57752584,57893023,140439
"5424","ENSACAG00000006718","GL343259.1",487267,492989,5722
"5425","ENSACAG00000006719","GL343259.1",357604,386242,28638
"5426","ENSACAG00000006720","GL343285.1",492046,659629,167583
"5427","ENSACAG00000006721","GL343263.1",942518,965750,23232
"5428","ENSACAG00000006722","GL343730.1",4342,23375,19033
"5429","ENSACAG00000006723","GL343193.1",1827807,1828433,626
"5430","ENSACAG00000006724","2",133849409,133850221,812
"5431","ENSACAG00000006726","2",133824758,133841266,16508
"5432","ENSACAG00000006727","GL343193.1",1892946,1947573,54627
"5433","ENSACAG00000006728","2",114031706,114109297,77591
"5434","ENSACAG00000006729","1",91142412,91144562,2150
"5435","ENSACAG00000006730","1",91153330,91197302,43972
"5436","ENSACAG00000006731","5",95425931,95457636,31705
"5437","ENSACAG00000006732","GL343730.1",51210,227647,176437
"5438","ENSACAG00000006734","GL343259.1",322986,345933,22947
"5439","ENSACAG00000006735","6",2721074,2733208,12134
"5440","ENSACAG00000006736","GL343212.1",570984,579441,8457
"5441","ENSACAG00000006738","GL343677.1",220197,231193,10996
"5442","ENSACAG00000006739","4",134780928,134841256,60328
"5443","ENSACAG00000006740","GL343212.1",458537,506636,48099
"5444","ENSACAG00000006742","GL343872.1",78162,97020,18858
"5445","ENSACAG00000006743","2",153543874,153558592,14718
"5446","ENSACAG00000006744","GL343490.1",352282,359290,7008
"5447","ENSACAG00000006745","GL343473.1",330955,368392,37437
"5448","ENSACAG00000006746","2",133678899,133724475,45576
"5449","ENSACAG00000006747","2",133180560,133529318,348758
"5450","ENSACAG00000006748","GL343220.1",2290775,2314067,23292
"5451","ENSACAG00000006749","GL343263.1",923928,929574,5646
"5452","ENSACAG00000006750","GL344537.1",1100,28956,27856
"5453","ENSACAG00000006751","GL343473.1",380771,398953,18182
"5454","ENSACAG00000006752","GL343193.1",1974189,1996092,21903
"5455","ENSACAG00000006753","4",155965561,155967312,1751
"5456","ENSACAG00000006754","GL343840.1",33966,34854,888
"5457","ENSACAG00000006755","GL343526.1",1010,12327,11317
"5458","ENSACAG00000006756","GL343263.1",913405,920017,6612
"5459","ENSACAG00000006757","GL343840.1",11402,14718,3316
"5460","ENSACAG00000006759","GL343670.1",159150,168526,9376
"5461","ENSACAG00000006760","6",2742818,2767979,25161
"5462","ENSACAG00000006761","2",69787475,69788833,1358
"5463","ENSACAG00000006762","6",74774441,74774764,323
"5464","ENSACAG00000006763","GL343293.1",318579,328205,9626
"5465","ENSACAG00000006764","6",74755617,74761277,5660
"5466","ENSACAG00000006765","2",69871162,69884244,13082
"5467","ENSACAG00000006766","GL343473.1",404661,456143,51482
"5468","ENSACAG00000006767","3",14827969,14986402,158433
"5469","ENSACAG00000006768","GL343293.1",153699,301301,147602
"5470","ENSACAG00000006769","GL343840.1",1393,8494,7101
"5471","ENSACAG00000006770","GL343490.1",364590,366690,2100
"5472","ENSACAG00000006771","4",103273525,103391105,117580
"5473","ENSACAG00000006772","GL343677.1",209245,220010,10765
"5474","ENSACAG00000006773","GL344738.1",154,4708,4554
"5475","ENSACAG00000006774","6",57700492,57715006,14514
"5476","ENSACAG00000006775","5",109337336,109372006,34670
"5477","ENSACAG00000006776","GL343220.1",2260486,2273600,13114
"5478","ENSACAG00000006777","GL343259.1",305586,314979,9393
"5479","ENSACAG00000006778","GL343490.1",368700,373263,4563
"5480","ENSACAG00000006779","GL343527.1",70599,80243,9644
"5481","ENSACAG00000006780","3",14843506,14852392,8886
"5482","ENSACAG00000006781","2",153674332,153713909,39577
"5483","ENSACAG00000006783","GL343193.1",4477849,4703575,225726
"5484","ENSACAG00000006784","4",156096346,156144324,47978
"5485","ENSACAG00000006787","6",2779775,2799748,19973
"5486","ENSACAG00000006788","6",12274686,12325701,51015
"5487","ENSACAG00000006789","3",14433463,14447877,14414
"5488","ENSACAG00000006790","5",40655286,40708699,53413
"5489","ENSACAG00000006791","GL343490.1",375982,389023,13041
"5490","ENSACAG00000006792","GL343670.1",170456,235758,65302
"5491","ENSACAG00000006793","6",74714580,74744909,30329
"5492","ENSACAG00000006795","1",91216226,91227509,11283
"5493","ENSACAG00000006796","2",69894306,69898928,4622
"5494","ENSACAG00000006799","GL343527.1",34642,68916,34274
"5495","ENSACAG00000006800","1",91266272,91271918,5646
"5496","ENSACAG00000006802","GL343285.1",632334,633679,1345
"5497","ENSACAG00000006803","5",68456267,68576228,119961
"5498","ENSACAG00000006805","GL343285.1",350263,477467,127204
"5499","ENSACAG00000006806","3",14184330,14419369,235039
"5500","ENSACAG00000006808","GL344560.1",19282,21737,2455
"5501","ENSACAG00000006809","6",2923128,2925207,2079
"5502","ENSACAG00000006810","2",146311007,146326862,15855
"5503","ENSACAG00000006811","1",91283282,91298305,15023
"5504","ENSACAG00000006812","GL343527.1",1977,19274,17297
"5505","ENSACAG00000006813","GL343212.1",344151,432785,88634
"5506","ENSACAG00000006816","6",2933697,3131806,198109
"5507","ENSACAG00000006818","2",113908539,113934781,26242
"5508","ENSACAG00000006821","GL343193.1",4800816,5043709,242893
"5509","ENSACAG00000006823","GL343435.1",245317,307359,62042
"5510","ENSACAG00000006825","GL343287.1",1069366,1103265,33899
"5511","ENSACAG00000006826","AAWZ02037309",703,17424,16721
"5512","ENSACAG00000006827","GL344184.1",60128,63551,3423
"5513","ENSACAG00000006829","3",14113841,14148531,34690
"5514","ENSACAG00000006830","6",57668395,57677851,9456
"5515","ENSACAG00000006831","6",74601683,74602786,1103
"5516","ENSACAG00000006832","2",70050662,70209183,158521
"5517","ENSACAG00000006836","GL343872.1",49259,76891,27632
"5518","ENSACAG00000006837","6",74557329,74568655,11326
"5519","ENSACAG00000006839","GL343193.1",5106706,5255823,149117
"5520","ENSACAG00000006840","GL343259.1",271601,296867,25266
"5521","ENSACAG00000006841","4",156152262,156234090,81828
"5522","ENSACAG00000006842","4",134972594,135042555,69961
"5523","ENSACAG00000006843","6",57567083,57609567,42484
"5524","ENSACAG00000006844","GL343263.1",907400,969610,62210
"5525","ENSACAG00000006845","GL343293.1",31975,92679,60704
"5526","ENSACAG00000006846","GL343263.1",890096,908475,18379
"5527","ENSACAG00000006847","4",135049892,135079292,29400
"5528","ENSACAG00000006849","3",16704689,16787484,82795
"5529","ENSACAG00000006851","4",103239427,103285012,45585
"5530","ENSACAG00000006852","GL344184.1",2372,52076,49704
"5531","ENSACAG00000006853","GL343381.1",164188,185377,21189
"5532","ENSACAG00000006854","4",103177587,103222509,44922
"5533","ENSACAG00000006855","1",91302270,91320736,18466
"5534","ENSACAG00000006857","GL343435.1",310107,362033,51926
"5535","ENSACAG00000006858","GL343560.1",298304,312117,13813
"5536","ENSACAG00000006861","2",153857315,153869399,12084
"5537","ENSACAG00000006862","GL343287.1",1160107,1202961,42854
"5538","ENSACAG00000006864","AAWZ02038161",913,1944,1031
"5539","ENSACAG00000006865","6",2933697,3125588,191891
"5540","ENSACAG00000006866","GL343259.1",246589,257612,11023
"5541","ENSACAG00000006867","GL343207.1",1903226,1966617,63391
"5542","ENSACAG00000006868","1",250635454,250699325,63871
"5543","ENSACAG00000006870","GL343937.1",14589,86683,72094
"5544","ENSACAG00000006871","6",3144339,3156580,12241
"5545","ENSACAG00000006872","GL343207.1",1974442,2017301,42859
"5546","ENSACAG00000006873","AAWZ02036658",721,2420,1699
"5547","ENSACAG00000006874","6",3159478,3163549,4071
"5548","ENSACAG00000006875","2",113833225,113915806,82581
"5549","ENSACAG00000006876","6",3167105,3168361,1256
"5550","ENSACAG00000006877","5",109409454,109422601,13147
"5551","ENSACAG00000006878","GL343219.1",2259506,2279483,19977
"5552","ENSACAG00000006879","6",3238928,3249911,10983
"5553","ENSACAG00000006880","2",146326984,146341225,14241
"5554","ENSACAG00000006881","GL344018.1",10407,11384,977
"5555","ENSACAG00000006882","GL343287.1",1210691,1240629,29938
"5556","ENSACAG00000006883","GL343332.1",901693,947682,45989
"5557","ENSACAG00000006884","GL343872.1",34825,45925,11100
"5558","ENSACAG00000006885","GL343381.1",99877,157598,57721
"5559","ENSACAG00000006887","6",74546704,74555792,9088
"5560","ENSACAG00000006888","2",154528207,154531195,2988
"5561","ENSACAG00000006889","6",74534231,74545834,11603
"5562","ENSACAG00000006891","2",154538225,154545190,6965
"5563","ENSACAG00000006892","2",150060100,150087790,27690
"5564","ENSACAG00000006893","GL343287.1",1241740,1250377,8637
"5565","ENSACAG00000006894","GL344286.1",11339,52314,40975
"5566","ENSACAG00000006895","1",91370872,91371516,644
"5567","ENSACAG00000006896","5",95486244,95727642,241398
"5568","ENSACAG00000006897","6",3256681,3262242,5561
"5569","ENSACAG00000006898","2",154547556,154558352,10796
"5570","ENSACAG00000006899","6",3265477,3275679,10202
"5571","ENSACAG00000006900","GL343823.1",80165,159045,78880
"5572","ENSACAG00000006901","5",103032219,103134422,102203
"5573","ENSACAG00000006902","4",102940614,103165612,224998
"5574","ENSACAG00000006903","GL343764.1",1102,26809,25707
"5575","ENSACAG00000006905","3",16658575,16697818,39243
"5576","ENSACAG00000006906","6",74486570,74532101,45531
"5577","ENSACAG00000006907","GL343219.1",2208160,2227392,19232
"5578","ENSACAG00000006908","GL343287.1",1340428,1341072,644
"5579","ENSACAG00000006911","GL343207.1",2128465,2318396,189931
"5580","ENSACAG00000006912","GL343287.1",1380876,1400189,19313
"5581","ENSACAG00000006913","GL343220.1",2235690,2245861,10171
"5582","ENSACAG00000006914","3",14122082,14131739,9657
"5583","ENSACAG00000006915","GL343435.1",393149,406960,13811
"5584","ENSACAG00000006916","AAWZ02036658",3402,9934,6532
"5585","ENSACAG00000006917","3",105945146,105965778,20632
"5586","ENSACAG00000006918","5",95896666,95992984,96318
"5587","ENSACAG00000006919","GL343259.1",228818,245404,16586
"5588","ENSACAG00000006920","GL343517.1",148939,221279,72340
"5589","ENSACAG00000006921","AAWZ02038446",2395,10174,7779
"5590","ENSACAG00000006922","6",57422084,57488332,66248
"5591","ENSACAG00000006923","6",3287210,3306634,19424
"5592","ENSACAG00000006924","5",40559945,40619366,59421
"5593","ENSACAG00000006925","GL343767.1",16056,78765,62709
"5594","ENSACAG00000006926","1",91371679,91411752,40073
"5595","ENSACAG00000006929","GL343526.1",13711,45710,31999
"5596","ENSACAG00000006930","5",111295551,111450492,154941
"5597","ENSACAG00000006931","2",70224983,70276130,51147
"5598","ENSACAG00000006932","3",14047751,14063226,15475
"5599","ENSACAG00000006933","6",57403931,57414534,10603
"5600","ENSACAG00000006934","GL344218.1",2986,46208,43222
"5601","ENSACAG00000006935","6",3404801,3441426,36625
"5602","ENSACAG00000006936","GL343259.1",191016,216268,25252
"5603","ENSACAG00000006937","2",146430818,146452190,21372
"5604","ENSACAG00000006938","GL343193.1",5356791,5421072,64281
"5605","ENSACAG00000006939","2",154564768,154601963,37195
"5606","ENSACAG00000006940","3",19999913,20010193,10280
"5607","ENSACAG00000006941","GL343219.1",2004479,2115738,111259
"5608","ENSACAG00000006942","6",57272732,57305047,32315
"5609","ENSACAG00000006943","5",68796322,68815630,19308
"5610","ENSACAG00000006944","GL343263.1",863948,869942,5994
"5611","ENSACAG00000006946","GL343763.1",202249,202407,158
"5612","ENSACAG00000006947","3",19986827,19992389,5562
"5613","ENSACAG00000006948","GL343763.1",174930,197547,22617
"5614","ENSACAG00000006949","GL343263.1",849663,855718,6055
"5615","ENSACAG00000006950","2",150090887,150107728,16841
"5616","ENSACAG00000006951","GL343490.1",395934,411124,15190
"5617","ENSACAG00000006952","GL344794.1",13573,21304,7731
"5618","ENSACAG00000006954","AAWZ02039968",1222,4417,3195
"5619","ENSACAG00000006957","2",146477960,146501230,23270
"5620","ENSACAG00000006958","GL343287.1",1437653,1440819,3166
"5621","ENSACAG00000006959","3",19290601,19291689,1088
"5622","ENSACAG00000006961","GL343220.1",2194689,2208128,13439
"5623","ENSACAG00000006962","GL343887.1",33128,53170,20042
"5624","ENSACAG00000006963","3",19235202,19261456,26254
"5625","ENSACAG00000006964","GL343287.1",1470248,1480509,10261
"5626","ENSACAG00000006965","GL343193.1",5571738,5664700,92962
"5627","ENSACAG00000006967","2",113795540,113834367,38827
"5628","ENSACAG00000006968","GL343490.1",413157,414489,1332
"5629","ENSACAG00000006969","GL343490.1",417575,422070,4495
"5630","ENSACAG00000006970","GL343767.1",26187,33718,7531
"5631","ENSACAG00000006971","GL343391.1",930536,959214,28678
"5632","ENSACAG00000006973","5",113810896,113817387,6491
"5633","ENSACAG00000006974","3",16586872,16629822,42950
"5634","ENSACAG00000006975","3",13338468,13556842,218374
"5635","ENSACAG00000006976","5",113826720,113831499,4779
"5636","ENSACAG00000006978","GL343193.1",1551924,1664255,112331
"5637","ENSACAG00000006979","5",68819099,68824696,5597
"5638","ENSACAG00000006980","GL343776.1",154135,185065,30930
"5639","ENSACAG00000006981","5",113903197,114094522,191325
"5640","ENSACAG00000006982","6",57098560,57203114,104554
"5641","ENSACAG00000006983","AAWZ02038407",4848,10882,6034
"5642","ENSACAG00000006984","GL343259.1",168996,182261,13265
"5643","ENSACAG00000006985","GL343287.1",1541510,1611085,69575
"5644","ENSACAG00000006986","2",113711990,113784505,72515
"5645","ENSACAG00000006987","5",96423085,96482143,59058
"5646","ENSACAG00000006988","2",154607397,154743767,136370
"5647","ENSACAG00000006989","GL343598.1",25459,83884,58425
"5648","ENSACAG00000006991","GL343490.1",429457,446293,16836
"5649","ENSACAG00000006992","GL343887.1",45990,85523,39533
"5650","ENSACAG00000006993","2",70274844,70284824,9980
"5651","ENSACAG00000006994","GL343218.1",4832,14630,9798
"5652","ENSACAG00000006995","2",150112732,150117495,4763
"5653","ENSACAG00000006996","GL343526.1",327782,358692,30910
"5654","ENSACAG00000006997","GL343361.1",856939,944244,87305
"5655","ENSACAG00000006998","GL343391.1",796410,873987,77577
"5656","ENSACAG00000006999","GL343259.1",94399,160137,65738
"5657","ENSACAG00000007000","5",63598549,63748136,149587
"5658","ENSACAG00000007001","GL343275.1",52,194740,194688
"5659","ENSACAG00000007002","5",58975086,59011864,36778
"5660","ENSACAG00000007003","GL343763.1",60422,172086,111664
"5661","ENSACAG00000007005","5",58700217,58701329,1112
"5662","ENSACAG00000007007","4",135087284,135115922,28638
"5663","ENSACAG00000007008","3",13046159,13137950,91791
"5664","ENSACAG00000007011","5",58592939,58621648,28709
"5665","ENSACAG00000007012","2",146512900,146513373,473
"5666","ENSACAG00000007014","GL343767.1",48798,70588,21790
"5667","ENSACAG00000007015","6",12508749,12534509,25760
"5668","ENSACAG00000007016","2",146527580,146538077,10497
"5669","ENSACAG00000007017","GL343361.1",766898,846888,79990
"5670","ENSACAG00000007019","2",150125883,150132856,6973
"5671","ENSACAG00000007020","GL343361.1",722721,755710,32989
"5672","ENSACAG00000007021","2",70297982,70319798,21816
"5673","ENSACAG00000007022","GL343219.1",1971250,1998301,27051
"5674","ENSACAG00000007023","1",91508962,91520161,11199
"5675","ENSACAG00000007024","5",102816178,102938177,121999
"5676","ENSACAG00000007025","GL343220.1",2177077,2183114,6037
"5677","ENSACAG00000007027","GL343219.1",1934901,1955964,21063
"5678","ENSACAG00000007028","1",208867976,209027284,159308
"5679","ENSACAG00000007029","GL343764.1",43823,63744,19921
"5680","ENSACAG00000007030","2",150148204,150279193,130989
"5681","ENSACAG00000007031","5",58582852,58591964,9112
"5682","ENSACAG00000007032","3",126013204,126057512,44308
"5683","ENSACAG00000007035","5",102297520,102310685,13165
"5684","ENSACAG00000007036","4",102030481,102064286,33805
"5685","ENSACAG00000007037","5",58489558,58502192,12634
"5686","ENSACAG00000007038","GL343361.1",597928,656125,58197
"5687","ENSACAG00000007039","2",146539881,146555657,15776
"5688","ENSACAG00000007041","GL343764.1",90203,166317,76114
"5689","ENSACAG00000007042","GL343887.1",115529,119304,3775
"5690","ENSACAG00000007043","GL343219.1",1902388,1928997,26609
"5691","ENSACAG00000007044","6",74470000,74477010,7010
"5692","ENSACAG00000007045","1",149131783,149132133,350
"5693","ENSACAG00000007046","AAWZ02040743",74,6379,6305
"5694","ENSACAG00000007047","5",63574169,63595894,21725
"5695","ENSACAG00000007048","1",150038558,150106781,68223
"5696","ENSACAG00000007050","1",208686696,208778522,91826
"5697","ENSACAG00000007053","5",111605694,111606563,869
"5698","ENSACAG00000007054","1",91520550,91528927,8377
"5699","ENSACAG00000007055","GL343526.1",376160,388705,12545
"5700","ENSACAG00000007056","5",102256697,102293757,37060
"5701","ENSACAG00000007057","4",101941554,101942495,941
"5702","ENSACAG00000007058","AAWZ02037457",7587,15315,7728
"5703","ENSACAG00000007059","1",154288646,154320646,32000
"5704","ENSACAG00000007060","3",19214283,19230765,16482
"5705","ENSACAG00000007061","1",150120144,150136379,16235
"5706","ENSACAG00000007062","4",101775944,101777496,1552
"5707","ENSACAG00000007063","3",125856853,125989894,133041
"5708","ENSACAG00000007065","GL343249.1",2046837,2074534,27697
"5709","ENSACAG00000007066","1",153748565,153761810,13245
"5710","ENSACAG00000007067","2",93392538,93425334,32796
"5711","ENSACAG00000007068","4",101520806,101724421,203615
"5712","ENSACAG00000007069","GL343219.1",1838622,1902781,64159
"5713","ENSACAG00000007070","1",91536510,91569142,32632
"5714","ENSACAG00000007071","6",12561846,12592253,30407
"5715","ENSACAG00000007072","GL343526.1",400339,432460,32121
"5716","ENSACAG00000007073","GL343526.1",439687,463559,23872
"5717","ENSACAG00000007074","3",12995253,13043223,47970
"5718","ENSACAG00000007075","3",19130125,19163195,33070
"5719","ENSACAG00000007076","2",146563872,146625306,61434
"5720","ENSACAG00000007077","GL343490.1",462502,505657,43155
"5721","ENSACAG00000007078","1",150144151,150154818,10667
"5722","ENSACAG00000007079","6",74276973,74326865,49892
"5723","ENSACAG00000007080","2",154746934,154783236,36302
"5724","ENSACAG00000007082","GL344677.1",3354,6513,3159
"5725","ENSACAG00000007083","GL343193.1",5979504,6150305,170801
"5726","ENSACAG00000007084","5",102140270,102197447,57177
"5727","ENSACAG00000007085","GL343220.1",2121815,2129282,7467
"5728","ENSACAG00000007086","GL343275.1",193732,231934,38202
"5729","ENSACAG00000007087","GL343287.1",1707797,1719951,12154
"5730","ENSACAG00000007088","1",153736433,153745014,8581
"5731","ENSACAG00000007089","GL344644.1",40910,55008,14098
"5732","ENSACAG00000007090","GL343517.1",227271,308602,81331
"5733","ENSACAG00000007091","GL343249.1",2086410,2104411,18001
"5734","ENSACAG00000007092","GL343193.1",6164864,6183683,18819
"5735","ENSACAG00000007093","4",135120059,135134361,14302
"5736","ENSACAG00000007094","5",63496701,63519409,22708
"5737","ENSACAG00000007095","1",153519464,153561204,41740
"5738","ENSACAG00000007096","6",57059385,57092492,33107
"5739","ENSACAG00000007097","6",74188491,74226390,37899
"5740","ENSACAG00000007098","5",101995807,102066928,71121
"5741","ENSACAG00000007099","GL344715.1",566,12212,11646
"5742","ENSACAG00000007100","5",58378253,58427189,48936
"5743","ENSACAG00000007102","GL343361.1",558546,579377,20831
"5744","ENSACAG00000007103","1",250590827,250617732,26905
"5745","ENSACAG00000007105","GL343888.1",21,5418,5397
"5746","ENSACAG00000007106","GL343287.1",1724210,1737027,12817
"5747","ENSACAG00000007107","5",101513095,101584449,71354
"5748","ENSACAG00000007108","GL343220.1",2111410,2115474,4064
"5749","ENSACAG00000007109","1",208075115,208084161,9046
"5750","ENSACAG00000007110","GL343193.1",1676961,1697241,20280
"5751","ENSACAG00000007111","4",101436546,101483348,46802
"5752","ENSACAG00000007112","GL343767.1",82830,94841,12011
"5753","ENSACAG00000007113","GL343287.1",1748238,1753776,5538
"5754","ENSACAG00000007114","1",207863474,208028351,164877
"5755","ENSACAG00000007116","3",19103511,19126426,22915
"5756","ENSACAG00000007117","2",144931239,144942062,10823
"5757","ENSACAG00000007118","5",101305132,101416264,111132
"5758","ENSACAG00000007119","3",35140909,35151273,10364
"5759","ENSACAG00000007120","4",135171938,135269098,97160
"5760","ENSACAG00000007122","2",154785916,154786665,749
"5761","ENSACAG00000007123","2",71191196,71199537,8341
"5762","ENSACAG00000007124","5",63344124,63439387,95263
"5763","ENSACAG00000007125","GL343490.1",526213,566755,40542
"5764","ENSACAG00000007126","GL343337.1",582119,588313,6194
"5765","ENSACAG00000007127","5",96487225,96615733,128508
"5766","ENSACAG00000007128","2",70410966,70424596,13630
"5767","ENSACAG00000007129","2",154791602,154792886,1284
"5768","ENSACAG00000007130","AAWZ02036656",546,6601,6055
"5769","ENSACAG00000007131","2",93443233,93482956,39723
"5770","ENSACAG00000007132","2",154796718,154852564,55846
"5771","ENSACAG00000007133","2",151378452,151396972,18520
"5772","ENSACAG00000007134","AAWZ02037714",6042,7089,1047
"5773","ENSACAG00000007135","GL343888.1",8280,25243,16963
"5774","ENSACAG00000007136","GL343212.1",296895,340327,43432
"5775","ENSACAG00000007137","GL343275.1",288447,290714,2267
"5776","ENSACAG00000007138","GL343741.1",2308,67542,65234
"5777","ENSACAG00000007139","1",91588369,91592959,4590
"5778","ENSACAG00000007140","GL343789.1",1257,25243,23986
"5779","ENSACAG00000007141","GL343193.1",6226539,6281609,55070
"5780","ENSACAG00000007142","GL343391.1",698396,774740,76344
"5781","ENSACAG00000007143","4",79984275,80003753,19478
"5782","ENSACAG00000007144","GL343275.1",364116,703330,339214
"5783","ENSACAG00000007146","GL343193.1",1706491,1781399,74908
"5784","ENSACAG00000007147","GL344715.1",15096,22955,7859
"5785","ENSACAG00000007148","4",135304943,135364816,59873
"5786","ENSACAG00000007150","GL343490.1",570376,581678,11302
"5787","ENSACAG00000007151","1",91609150,91614366,5216
"5788","ENSACAG00000007152","AAWZ02036116",14771,15415,644
"5789","ENSACAG00000007154","1",91663216,91694744,31528
"5790","ENSACAG00000007156","GL343888.1",37488,43665,6177
"5791","ENSACAG00000007157","3",52659348,52723320,63972
"5792","ENSACAG00000007158","GL343453.1",666274,675680,9406
"5793","ENSACAG00000007160","4",71221035,71244291,23256
"5794","ENSACAG00000007161","GL343855.1",57202,63877,6675
"5795","ENSACAG00000007162","2",151560588,151574288,13700
"5796","ENSACAG00000007163","GL344876.1",1818,9990,8172
"5797","ENSACAG00000007164","5",38174127,38197717,23590
"5798","ENSACAG00000007165","AAWZ02036656",10370,23594,13224
"5799","ENSACAG00000007166","2",151606274,151726809,120535
"5800","ENSACAG00000007168","4",79952615,79971812,19197
"5801","ENSACAG00000007169","2",71258665,71268894,10229
"5802","ENSACAG00000007170","GL344292.1",99,27567,27468
"5803","ENSACAG00000007172","GL343855.1",109695,121547,11852
"5804","ENSACAG00000007173","3",34978312,35136808,158496
"5805","ENSACAG00000007174","GL343275.1",827265,944083,116818
"5806","ENSACAG00000007175","GL343364.1",465,6546,6081
"5807","ENSACAG00000007176","GL343855.1",138442,160048,21606
"5808","ENSACAG00000007177","GL343675.1",5408,26005,20597
"5809","ENSACAG00000007179","AAWZ02037921",304,11307,11003
"5810","ENSACAG00000007180","GL343391.1",635643,673054,37411
"5811","ENSACAG00000007181","GL343212.1",114489,209016,94527
"5812","ENSACAG00000007183","AAWZ02040127",21,5861,5840
"5813","ENSACAG00000007185","5",99670120,99676278,6158
"5814","ENSACAG00000007187","3",129628738,129691533,62795
"5815","ENSACAG00000007188","GL343956.1",82711,106149,23438
"5816","ENSACAG00000007189","GL343483.1",21236,51953,30717
"5817","ENSACAG00000007190","GL343776.1",88829,121408,32579
"5818","ENSACAG00000007191","1",91716499,91720951,4452
"5819","ENSACAG00000007192","GL343517.1",326666,362383,35717
"5820","ENSACAG00000007193","5",38288926,38375561,86635
"5821","ENSACAG00000007194","GL344119.1",21402,56452,35050
"5822","ENSACAG00000007195","GL343789.1",58647,80017,21370
"5823","ENSACAG00000007196","1",117284701,117286067,1366
"5824","ENSACAG00000007199","GL343361.1",430750,535565,104815
"5825","ENSACAG00000007200","GL343888.1",103990,113091,9101
"5826","ENSACAG00000007201","2",165682959,165705360,22401
"5827","ENSACAG00000007202","2",146640103,146665251,25148
"5828","ENSACAG00000007204","GL343275.1",944544,979342,34798
"5829","ENSACAG00000007205","1",91725073,91742481,17408
"5830","ENSACAG00000007206","5",25755055,25780035,24980
"5831","ENSACAG00000007207","5",62965506,62966621,1115
"5832","ENSACAG00000007208","5",62007363,62048102,40739
"5833","ENSACAG00000007209","AAWZ02041081",2345,4258,1913
"5834","ENSACAG00000007210","GL343218.1",34750,41909,7159
"5835","ENSACAG00000007211","1",91753871,91756973,3102
"5836","ENSACAG00000007212","GL343517.1",369428,394325,24897
"5837","ENSACAG00000007213","1",91781430,91807859,26429
"5838","ENSACAG00000007215","2",195533449,195593278,59829
"5839","ENSACAG00000007216","3",12990790,12992010,1220
"5840","ENSACAG00000007217","3",12949957,12975187,25230
"5841","ENSACAG00000007218","3",129401126,129408641,7515
"5842","ENSACAG00000007219","6",64798969,64875323,76354
"5843","ENSACAG00000007220","GL343364.1",9969,44957,34988
"5844","ENSACAG00000007221","LGg",41249,183688,142439
"5845","ENSACAG00000007222","GL343391.1",490954,631035,140081
"5846","ENSACAG00000007224","GL343218.1",44457,66207,21750
"5847","ENSACAG00000007225","AAWZ02038578",1022,10100,9078
"5848","ENSACAG00000007226","GL343789.1",96073,106535,10462
"5849","ENSACAG00000007227","3",125817728,125832276,14548
"5850","ENSACAG00000007229","3",129190722,129191597,875
"5851","ENSACAG00000007230","GL343767.1",93549,102143,8594
"5852","ENSACAG00000007232","GL343888.1",119593,167099,47506
"5853","ENSACAG00000007233","GL343847.1",116414,158913,42499
"5854","ENSACAG00000007235","3",129108066,129147074,39008
"5855","ENSACAG00000007236","2",113696596,113706981,10385
"5856","ENSACAG00000007237","GL343517.1",445579,446241,662
"5857","ENSACAG00000007238","GL343275.1",1006441,1109923,103482
"5858","ENSACAG00000007239","GL343763.1",29332,55251,25919
"5859","ENSACAG00000007240","4",101402466,101430317,27851
"5860","ENSACAG00000007241","2",195780266,195786107,5841
"5861","ENSACAG00000007242","6",74082401,74177355,94954
"5862","ENSACAG00000007243","2",151825165,152070900,245735
"5863","ENSACAG00000007244","GL343964.1",143,16964,16821
"5864","ENSACAG00000007245","GL343789.1",110462,163801,53339
"5865","ENSACAG00000007246","5",61985113,61985990,877
"5866","ENSACAG00000007248","2",165734457,165749810,15353
"5867","ENSACAG00000007250","3",238573,328604,90031
"5868","ENSACAG00000007251","GL343675.1",58770,85166,26396
"5869","ENSACAG00000007252","5",61655815,61723515,67700
"5870","ENSACAG00000007253","6",12645221,12708452,63231
"5871","ENSACAG00000007254","2",193441220,193455451,14231
"5872","ENSACAG00000007255","GL343767.1",104246,112199,7953
"5873","ENSACAG00000007256","GL343193.1",6299952,6426516,126564
"5874","ENSACAG00000007257","3",129002267,129043991,41724
"5875","ENSACAG00000007259","2",70433875,70548357,114482
"5876","ENSACAG00000007260","5",99651414,99665961,14547
"5877","ENSACAG00000007261","3",35013156,35046153,32997
"5878","ENSACAG00000007262","GL343218.1",93834,117480,23646
"5879","ENSACAG00000007264","2",146811198,146901552,90354
"5880","ENSACAG00000007265","GL343776.1",75177,76639,1462
"5881","ENSACAG00000007267","2",146929536,146968038,38502
"5882","ENSACAG00000007268","GL343776.1",56712,62519,5807
"5883","ENSACAG00000007269","3",127543461,128905705,1362244
"5884","ENSACAG00000007270","GL343243.1",1357691,1409141,51450
"5885","ENSACAG00000007271","1",207531456,207645627,114171
"5886","ENSACAG00000007272","GL343275.1",1240832,1256504,15672
"5887","ENSACAG00000007273","GL343483.1",65931,70795,4864
"5888","ENSACAG00000007274","GL343220.1",2082475,2086501,4026
"5889","ENSACAG00000007276","GL343648.1",168801,221847,53046
"5890","ENSACAG00000007277","1",91955142,91961793,6651
"5891","ENSACAG00000007279","GL343243.1",1416673,1436530,19857
"5892","ENSACAG00000007281","5",25676793,25735991,59198
"5893","ENSACAG00000007282","GL343356.1",556257,559822,3565
"5894","ENSACAG00000007283","3",163228798,163229911,1113
"5895","ENSACAG00000007284","2",93486467,93515820,29353
"5896","ENSACAG00000007286","GL343275.1",1440520,1440768,248
"5897","ENSACAG00000007287","GL343220.1",2046571,2078348,31777
"5898","ENSACAG00000007288","3",125777817,125792105,14288
"5899","ENSACAG00000007290","1",207491492,207528288,36796
"5900","ENSACAG00000007292","3",53061460,53063032,1572
"5901","ENSACAG00000007294","GL343219.1",1792523,1828008,35485
"5902","ENSACAG00000007295","GL343483.1",72382,102208,29826
"5903","ENSACAG00000007296","GL343767.1",114910,119351,4441
"5904","ENSACAG00000007297","2",113659975,113666965,6990
"5905","ENSACAG00000007298","3",53088987,53155924,66937
"5906","ENSACAG00000007299","3",52899277,53436624,537347
"5907","ENSACAG00000007300","GL343776.1",37418,55327,17909
"5908","ENSACAG00000007301","1",92028910,92066967,38057
"5909","ENSACAG00000007302","GL343243.1",1436907,1479055,42148
"5910","ENSACAG00000007303","2",113576457,113653673,77216
"5911","ENSACAG00000007304","2",93532943,93583075,50132
"5912","ENSACAG00000007305","1",207222140,207449169,227029
"5913","ENSACAG00000007306","GL343789.1",195815,215875,20060
"5914","ENSACAG00000007307","6",46919161,46938818,19657
"5915","ENSACAG00000007308","4",113537776,113786554,248778
"5916","ENSACAG00000007309","GL343767.1",132001,144099,12098
"5917","ENSACAG00000007311","GL343483.1",112517,128265,15748
"5918","ENSACAG00000007313","GL343364.1",84687,96763,12076
"5919","ENSACAG00000007314","1",250181031,250468520,287489
"5920","ENSACAG00000007315","2",146971516,147000577,29061
"5921","ENSACAG00000007317","5",99645713,99649693,3980
"5922","ENSACAG00000007318","2",195307631,195324583,16952
"5923","ENSACAG00000007319","AAWZ02039089",5202,7733,2531
"5924","ENSACAG00000007320","2",147030628,147101885,71257
"5925","ENSACAG00000007321","2",165802572,165854965,52393
"5926","ENSACAG00000007322","6",46839696,46908417,68721
"5927","ENSACAG00000007323","GL343675.1",95464,103025,7561
"5928","ENSACAG00000007324","GL343361.1",171417,184759,13342
"5929","ENSACAG00000007326","2",193529071,193533661,4590
"5930","ENSACAG00000007327","5",38387908,38427109,39201
"5931","ENSACAG00000007328","GL343763.1",18409,20390,1981
"5932","ENSACAG00000007329","1",92073743,92112473,38730
"5933","ENSACAG00000007330","GL343193.1",6432183,6442387,10204
"5934","ENSACAG00000007331","GL343763.1",5255,17567,12312
"5935","ENSACAG00000007333","3",12912732,12913310,578
"5936","ENSACAG00000007334","2",165909774,166034150,124376
"5937","ENSACAG00000007336","3",12878263,12879219,956
"5938","ENSACAG00000007339","GL343767.1",162598,171477,8879
"5939","ENSACAG00000007340","GL343680.1",52196,63299,11103
"5940","ENSACAG00000007341","6",46678898,46731403,52505
"5941","ENSACAG00000007342","GL343361.1",162095,164458,2363
"5942","ENSACAG00000007343","6",74047232,74057337,10105
"5943","ENSACAG00000007344","4",117287939,117290089,2150
"5944","ENSACAG00000007345","GL343219.1",1735883,1755442,19559
"5945","ENSACAG00000007346","GL343741.1",68976,95969,26993
"5946","ENSACAG00000007348","6",64771979,64791408,19429
"5947","ENSACAG00000007349","3",12587932,12607909,19977
"5948","ENSACAG00000007350","4",117383373,117406647,23274
"5949","ENSACAG00000007353","6",12786118,12808207,22089
"5950","ENSACAG00000007354","GL343361.1",67361,121065,53704
"5951","ENSACAG00000007355","3",34822909,34953926,131017
"5952","ENSACAG00000007356","3",19046295,19074760,28465
"5953","ENSACAG00000007357","2",154860086,154875509,15423
"5954","ENSACAG00000007358","GL343364.1",113177,145888,32711
"5955","ENSACAG00000007359","2",95280752,95282851,2099
"5956","ENSACAG00000007361","GL343193.1",6676304,6790936,114632
"5957","ENSACAG00000007362","2",95291762,95292832,1070
"5958","ENSACAG00000007363","2",193614428,193628225,13797
"5959","ENSACAG00000007364","GL343763.1",329,5375,5046
"5960","ENSACAG00000007365","GL343675.1",103865,119911,16046
"5961","ENSACAG00000007367","GL343364.1",152557,154663,2106
"5962","ENSACAG00000007369","2",166068640,166109113,40473
"5963","ENSACAG00000007370","2",95689544,95704356,14812
"5964","ENSACAG00000007373","GL343741.1",178616,193522,14906
"5965","ENSACAG00000007374","6",73989446,74039115,49669
"5966","ENSACAG00000007375","5",99428747,99632935,204188
"5967","ENSACAG00000007376","1",250011031,250146104,135073
"5968","ENSACAG00000007377","2",113500107,113564402,64295
"5969","ENSACAG00000007378","GL343364.1",163123,220000,56877
"5970","ENSACAG00000007379","GL343776.1",10884,12347,1463
"5971","ENSACAG00000007380","GL343776.1",533,2765,2232
"5972","ENSACAG00000007381","GL343680.1",15685,29581,13896
"5973","ENSACAG00000007382","GL343243.1",1550668,1573314,22646
"5974","ENSACAG00000007383","GL344042.1",35593,55931,20338
"5975","ENSACAG00000007385","GL343774.1",3571,49393,45822
"5976","ENSACAG00000007386","1",207133276,207185823,52547
"5977","ENSACAG00000007387","5",25561728,25595865,34137
"5978","ENSACAG00000007388","4",135364886,135387709,22823
"5979","ENSACAG00000007390","3",12448674,12454253,5579
"5980","ENSACAG00000007391","2",193676709,193682086,5377
"5981","ENSACAG00000007392","AAWZ02037732",1273,13830,12557
"5982","ENSACAG00000007393","4",113805102,113818121,13019
"5983","ENSACAG00000007395","GL343219.1",1637441,1661860,24419
"5984","ENSACAG00000007396","5",38447118,38474712,27594
"5985","ENSACAG00000007401","2",193727637,193750747,23110
"5986","ENSACAG00000007402","GL343243.1",1582854,1609154,26300
"5987","ENSACAG00000007403","1",207070383,207075700,5317
"5988","ENSACAG00000007404","GL343219.1",1336451,1499515,163064
"5989","ENSACAG00000007405","3",125745300,125764182,18882
"5990","ENSACAG00000007406","1",206989886,207061524,71638
"5991","ENSACAG00000007407","5",25471269,25539376,68107
"5992","ENSACAG00000007409","GL343675.1",121687,146647,24960
"5993","ENSACAG00000007410","4",113909400,113942346,32946
"5994","ENSACAG00000007411","GL344196.1",4889,6338,1449
"5995","ENSACAG00000007412","5",73193557,73225956,32399
"5996","ENSACAG00000007413","3",204826,223809,18983
"5997","ENSACAG00000007414","GL344065.1",21,8737,8716
"5998","ENSACAG00000007416","3",125724463,125737430,12967
"5999","ENSACAG00000007417","2",154878299,154890336,12037
"6000","ENSACAG00000007418","6",73953671,73960250,6579
"6001","ENSACAG00000007419","4",117432525,117536579,104054
"6002","ENSACAG00000007420","GL344065.1",8629,19124,10495
"6003","ENSACAG00000007421","1",249839076,249945304,106228
"6004","ENSACAG00000007422","GL343677.1",328312,328502,190
"6005","ENSACAG00000007423","6",13106655,13219387,112732
"6006","ENSACAG00000007424","2",147109367,147118440,9073
"6007","ENSACAG00000007426","AAWZ02036043",28933,31999,3066
"6008","ENSACAG00000007428","GL343220.1",1994677,2045969,51292
"6009","ENSACAG00000007429","3",125678340,125685320,6980
"6010","ENSACAG00000007430","2",13375588,13558293,182705
"6011","ENSACAG00000007432","5",38495983,38508940,12957
"6012","ENSACAG00000007433","4",113993467,114075163,81696
"6013","ENSACAG00000007434","GL343243.1",1635929,1658987,23058
"6014","ENSACAG00000007435","2",166125657,166192804,67147
"6015","ENSACAG00000007436","6",46565263,46593032,27769
"6016","ENSACAG00000007437","1",249635963,249656385,20422
"6017","ENSACAG00000007438","GL343483.1",162738,167736,4998
"6018","ENSACAG00000007439","5",38518972,38548454,29482
"6019","ENSACAG00000007440","2",147120504,147129249,8745
"6020","ENSACAG00000007441","1",206121610,206617227,495617
"6021","ENSACAG00000007442","GL344185.1",805,11872,11067
"6022","ENSACAG00000007443","1",249577521,249578336,815
"6023","ENSACAG00000007444","1",249547564,249569340,21776
"6024","ENSACAG00000007445","GL343552.1",392719,576144,183425
"6025","ENSACAG00000007446","1",249380156,249380597,441
"6026","ENSACAG00000007447","2",195103375,195113539,10164
"6027","ENSACAG00000007448","6",73716023,73762282,46259
"6028","ENSACAG00000007449","GL344065.1",19078,27027,7949
"6029","ENSACAG00000007450","3",172281,194076,21795
"6030","ENSACAG00000007451","AAWZ02036043",4602,13828,9226
"6031","ENSACAG00000007452","AAWZ02039909",2843,6893,4050
"6032","ENSACAG00000007454","GL343243.1",1720514,1747264,26750
"6033","ENSACAG00000007455","2",166209259,166230612,21353
"6034","ENSACAG00000007456","GL343483.1",178106,178819,713
"6035","ENSACAG00000007457","AAWZ02036993",2734,19631,16897
"6036","ENSACAG00000007458","GL343483.1",53378,221240,167862
"6037","ENSACAG00000007461","3",53569447,53569635,188
"6038","ENSACAG00000007463","GL344065.1",65934,69473,3539
"6039","ENSACAG00000007466","3",53789038,53810261,21223
"6040","ENSACAG00000007467","3",53985971,54007555,21584
"6041","ENSACAG00000007468","GL343767.1",185802,187679,1877
"6042","ENSACAG00000007469","GL343903.1",44498,117924,73426
"6043","ENSACAG00000007471","GL343767.1",82830,201895,119065
"6044","ENSACAG00000007472","3",125643204,125673321,30117
"6045","ENSACAG00000007473","6",46249211,46307694,58483
"6046","ENSACAG00000007474","5",25191713,25379833,188120
"6047","ENSACAG00000007475","GL343335.1",1183685,1209131,25446
"6048","ENSACAG00000007476","6",64753584,64765545,11961
"6049","ENSACAG00000007477","GL343243.1",1782367,1797806,15439
"6050","ENSACAG00000007478","AAWZ02039747",53,7541,7488
"6051","ENSACAG00000007479","GL343364.1",220738,233520,12782
"6052","ENSACAG00000007481","2",154899994,154920263,20269
"6053","ENSACAG00000007482","GL343193.1",6920773,6928072,7299
"6054","ENSACAG00000007483","2",113471926,113493453,21527
"6055","ENSACAG00000007486","6",64477615,64509405,31790
"6056","ENSACAG00000007488","1",92125567,92137425,11858
"6057","ENSACAG00000007489","3",125627283,125643103,15820
"6058","ENSACAG00000007490","GL343193.1",6928765,6980589,51824
"6059","ENSACAG00000007491","AAWZ02038425",2887,8111,5224
"6060","ENSACAG00000007492","2",147133788,147140841,7053
"6061","ENSACAG00000007493","GL343364.1",231255,301632,70377
"6062","ENSACAG00000007494","GL343961.1",63384,103000,39616
"6063","ENSACAG00000007495","GL343741.1",240259,250004,9745
"6064","ENSACAG00000007497","4",135420905,135474809,53904
"6065","ENSACAG00000007498","6",73272088,73699150,427062
"6066","ENSACAG00000007499","2",154929165,154963400,34235
"6067","ENSACAG00000007500","3",160686,171150,10464
"6068","ENSACAG00000007501","2",166232347,166271328,38981
"6069","ENSACAG00000007502","6",46177198,46229191,51993
"6070","ENSACAG00000007503","3",19036582,19044615,8033
"6071","ENSACAG00000007504","6",46122642,46154964,32322
"6072","ENSACAG00000007506","GL343483.1",228421,232539,4118
"6073","ENSACAG00000007508","5",73133080,73182117,49037
"6074","ENSACAG00000007509","GL343483.1",243792,249396,5604
"6075","ENSACAG00000007510","2",70550445,70589891,39446
"6076","ENSACAG00000007511","GL343675.1",182526,186438,3912
"6077","ENSACAG00000007512","6",13342014,13380971,38957
"6078","ENSACAG00000007513","6",13462011,13475249,13238
"6079","ENSACAG00000007514","GL343675.1",192484,199473,6989
"6080","ENSACAG00000007515","3",15942,152944,137002
"6081","ENSACAG00000007516","GL344632.1",4205,12858,8653
"6082","ENSACAG00000007517","GL344042.1",55995,70935,14940
"6083","ENSACAG00000007519","3",125469296,125550186,80890
"6084","ENSACAG00000007520","3",18949094,18968156,19062
"6085","ENSACAG00000007521","6",64367156,64393446,26290
"6086","ENSACAG00000007522","6",13484667,13510644,25977
"6087","ENSACAG00000007523","2",147143428,147151212,7784
"6088","ENSACAG00000007524","3",124663703,124811917,148214
"6089","ENSACAG00000007525","GL343243.1",1824480,2017575,193095
"6090","ENSACAG00000007527","3",18832973,18930646,97673
"6091","ENSACAG00000007528","GL343218.1",122477,141950,19473
"6092","ENSACAG00000007529","GL343379.1",969612,1052365,82753
"6093","ENSACAG00000007530","5",101291366,101296093,4727
"6094","ENSACAG00000007531","5",38551005,38659163,108158
"6095","ENSACAG00000007533","2",113456526,113468846,12320
"6096","ENSACAG00000007537","1",182961505,183218358,256853
"6097","ENSACAG00000007538","GL343892.1",2190,20845,18655
"6098","ENSACAG00000007539","2",93620758,93636797,16039
"6099","ENSACAG00000007540","GL343335.1",1153920,1175839,21919
"6100","ENSACAG00000007541","GL343326.1",1134769,1229754,94985
"6101","ENSACAG00000007543","2",166283041,166589190,306149
"6102","ENSACAG00000007544","2",166765491,167150556,385065
"6103","ENSACAG00000007545","GL343892.1",43424,98001,54577
"6104","ENSACAG00000007546","GL343218.1",166906,200181,33275
"6105","ENSACAG00000007547","GL343483.1",254701,260172,5471
"6106","ENSACAG00000007548","3",18818893,18829841,10948
"6107","ENSACAG00000007549","AAWZ02040441",21,6850,6829
"6108","ENSACAG00000007550","GL343193.1",7004196,7010117,5921
"6109","ENSACAG00000007551","GL343219.1",1305143,1330951,25808
"6110","ENSACAG00000007552","GL343193.1",7013148,7039225,26077
"6111","ENSACAG00000007554","2",73855886,74105707,249821
"6112","ENSACAG00000007555","GL343483.1",262354,266866,4512
"6113","ENSACAG00000007556","2",93634154,93679731,45577
"6114","ENSACAG00000007557","2",147153269,147285743,132474
"6115","ENSACAG00000007558","GL343964.1",36405,58218,21813
"6116","ENSACAG00000007559","GL343220.1",1914842,1967478,52636
"6117","ENSACAG00000007560","GL343964.1",94620,95678,1058
"6118","ENSACAG00000007562","GL343254.1",176273,276982,100709
"6119","ENSACAG00000007563","2",113415193,113432042,16849
"6120","ENSACAG00000007564","GL343335.1",1111631,1127134,15503
"6121","ENSACAG00000007566","GL343675.1",209995,277084,67089
"6122","ENSACAG00000007567","3",58497730,58561374,63644
"6123","ENSACAG00000007568","3",18793511,18817078,23567
"6124","ENSACAG00000007569","3",18720332,18767362,47030
"6125","ENSACAG00000007570","AAWZ02035082",193,41575,41382
"6126","ENSACAG00000007571","5",24915324,24918460,3136
"6127","ENSACAG00000007573","5",24911810,24913115,1305
"6128","ENSACAG00000007574","4",114107811,114201962,94151
"6129","ENSACAG00000007575","GL343751.1",23468,42334,18866
"6130","ENSACAG00000007576","3",58422260,58483305,61045
"6131","ENSACAG00000007577","AAWZ02038681",584,9956,9372
"6132","ENSACAG00000007579","5",73052259,73096819,44560
"6133","ENSACAG00000007580","6",13786022,13790949,4927
"6134","ENSACAG00000007583","6",13819205,13888072,68867
"6135","ENSACAG00000007585","1",92168758,92189692,20934
"6136","ENSACAG00000007586","3",58129411,58226441,97030
"6137","ENSACAG00000007587","GL343193.1",7053773,7072012,18239
"6138","ENSACAG00000007589","1",92207955,92209076,1121
"6139","ENSACAG00000007590","1",92262753,92272569,9816
"6140","ENSACAG00000007591","5",24891468,24897644,6176
"6141","ENSACAG00000007592","GL343364.1",355783,779424,423641
"6142","ENSACAG00000007593","3",34792921,34814923,22002
"6143","ENSACAG00000007594","2",70784835,70885613,100778
"6144","ENSACAG00000007596","GL343326.1",1253225,1290080,36855
"6145","ENSACAG00000007598","GL343369.1",329053,329430,377
"6146","ENSACAG00000007599","4",117547129,117549582,2453
"6147","ENSACAG00000007601","GL343675.1",293720,309399,15679
"6148","ENSACAG00000007602","4",117565671,117816395,250724
"6149","ENSACAG00000007603","GL343369.1",411816,412301,485
"6150","ENSACAG00000007605","GL343335.1",966991,1018086,51095
"6151","ENSACAG00000007606","GL343220.1",1873149,1900528,27379
"6152","ENSACAG00000007608","GL343751.1",19940,23310,3370
"6153","ENSACAG00000007610","5",24861022,24863521,2499
"6154","ENSACAG00000007616","5",24706847,24726981,20134
"6155","ENSACAG00000007617","GL343335.1",941331,960852,19521
"6156","ENSACAG00000007618","GL343218.1",203636,216900,13264
"6157","ENSACAG00000007619","5",38803957,39133264,329307
"6158","ENSACAG00000007621","2",113377656,113405539,27883
"6159","ENSACAG00000007623","5",72993273,73033823,40550
"6160","ENSACAG00000007625","1",182897779,182898927,1148
"6161","ENSACAG00000007627","GL343751.1",1344,132627,131283
"6162","ENSACAG00000007629","6",64332498,64339237,6739
"6163","ENSACAG00000007630","1",92641293,92702276,60983
"6164","ENSACAG00000007631","GL343220.1",1845020,1858078,13058
"6165","ENSACAG00000007632","GL343326.1",1309499,1324129,14630
"6166","ENSACAG00000007633","3",54973,56118,1145
"6167","ENSACAG00000007635","2",70910827,70911978,1151
"6168","ENSACAG00000007637","6",64260190,64330078,69888
"6169","ENSACAG00000007638","2",93681247,93695495,14248
"6170","ENSACAG00000007640","GL343321.1",80312,110295,29983
"6171","ENSACAG00000007641","GL343553.1",319353,325150,5797
"6172","ENSACAG00000007647","GL343892.1",109527,124537,15010
"6173","ENSACAG00000007648","6",13883337,13883693,356
"6174","ENSACAG00000007649","6",13982787,14026074,43287
"6175","ENSACAG00000007650","2",93699417,93710806,11389
"6176","ENSACAG00000007651","GL343220.1",1809604,1833799,24195
"6177","ENSACAG00000007652","5",61523687,61638585,114898
"6178","ENSACAG00000007653","GL343193.1",7084892,7333915,249023
"6179","ENSACAG00000007654","1",15393538,15395523,1985
"6180","ENSACAG00000007655","GL343364.1",802105,824642,22537
"6181","ENSACAG00000007657","5",149655955,149856883,200928
"6182","ENSACAG00000007658","GL343218.1",232728,257346,24618
"6183","ENSACAG00000007660","3",18701331,18707023,5692
"6184","ENSACAG00000007661","5",5565454,5753670,188216
"6185","ENSACAG00000007663","1",92749325,92781716,32391
"6186","ENSACAG00000007667","GL343542.1",48512,58923,10411
"6187","ENSACAG00000007669","GL343219.1",1266016,1303090,37074
"6188","ENSACAG00000007670","2",152083937,152095093,11156
"6189","ENSACAG00000007673","GL344053.1",81633,101973,20340
"6190","ENSACAG00000007675","AAWZ02035537",3063,34005,30942
"6191","ENSACAG00000007677","4",100413917,100586323,172406
"6192","ENSACAG00000007678","GL345066.1",223,11945,11722
"6193","ENSACAG00000007679","2",93723309,93751259,27950
"6194","ENSACAG00000007680","3",18420901,18459983,39082
"6195","ENSACAG00000007681","GL343228.1",1459532,1577763,118231
"6196","ENSACAG00000007682","GL343321.1",111888,124050,12162
"6197","ENSACAG00000007683","GL343959.1",15482,15577,95
"6198","ENSACAG00000007684","GL344691.1",17272,20873,3601
"6199","ENSACAG00000007685","3",18367033,18392145,25112
"6200","ENSACAG00000007686","AAWZ02038267",1851,10724,8873
"6201","ENSACAG00000007687","GL343892.1",133474,152676,19202
"6202","ENSACAG00000007688","5",24633492,24644688,11196
"6203","ENSACAG00000007689","2",152095769,152098597,2828
"6204","ENSACAG00000007690","5",138011606,138012766,1160
"6205","ENSACAG00000007691","5",40072330,40149287,76957
"6206","ENSACAG00000007692","2",152102138,152167394,65256
"6207","ENSACAG00000007693","GL343220.1",1775123,1786467,11344
"6208","ENSACAG00000007694","2",113329069,113369463,40394
"6209","ENSACAG00000007695","2",13857654,13870597,12943
"6210","ENSACAG00000007697","4",117848168,117862471,14303
"6211","ENSACAG00000007698","GL344691.1",4986,5585,599
"6212","ENSACAG00000007699","GL344691.1",21,4089,4068
"6213","ENSACAG00000007700","GL343542.1",78994,102698,23704
"6214","ENSACAG00000007701","GL343220.1",1753549,1756795,3246
"6215","ENSACAG00000007702","GL343326.1",1332081,1347758,15677
"6216","ENSACAG00000007703","3",58060138,58110153,50015
"6217","ENSACAG00000007705","GL343220.1",1716531,1729286,12755
"6218","ENSACAG00000007708","GL343483.1",278387,279430,1043
"6219","ENSACAG00000007709","GL343483.1",281789,282967,1178
"6220","ENSACAG00000007710","6",35105847,35130421,24574
"6221","ENSACAG00000007711","GL343542.1",107344,120200,12856
"6222","ENSACAG00000007712","GL343483.1",284967,291626,6659
"6223","ENSACAG00000007713","3",34783983,34785215,1232
"6224","ENSACAG00000007714","2",93776710,93803205,26495
"6225","ENSACAG00000007715","3",34617997,34755747,137750
"6226","ENSACAG00000007716","5",40250663,40285158,34495
"6227","ENSACAG00000007717","2",13927777,13944675,16898
"6228","ENSACAG00000007718","GL343542.1",138426,153543,15117
"6229","ENSACAG00000007719","3",10250775,10312993,62218
"6230","ENSACAG00000007720","5",99396106,99414377,18271
"6231","ENSACAG00000007721","GL343335.1",688643,895856,207213
"6232","ENSACAG00000007722","GL343849.1",5810,7450,1640
"6233","ENSACAG00000007724","GL343228.1",1583632,1614397,30765
"6234","ENSACAG00000007725","GL343220.1",1692978,1696563,3585
"6235","ENSACAG00000007726","GL343220.1",1668065,1680734,12669
"6236","ENSACAG00000007727","GL343465.1",46181,58029,11848
"6237","ENSACAG00000007728","GL343326.1",1350037,1358033,7996
"6238","ENSACAG00000007729","GL343849.1",19683,36734,17051
"6239","ENSACAG00000007730","3",18342604,18347621,5017
"6240","ENSACAG00000007731","GL343297.1",483895,484911,1016
"6241","ENSACAG00000007732","GL343542.1",178573,227910,49337
"6242","ENSACAG00000007733","GL343297.1",436661,437791,1130
"6243","ENSACAG00000007734","GL343254.1",399429,429767,30338
"6244","ENSACAG00000007735","GL343297.1",359191,399942,40751
"6245","ENSACAG00000007736","GL343220.1",1649808,1663437,13629
"6246","ENSACAG00000007741","4",114203956,114244246,40290
"6247","ENSACAG00000007742","GL343849.1",33781,59617,25836
"6248","ENSACAG00000007743","5",40336988,40343592,6604
"6249","ENSACAG00000007744","2",147178129,147179670,1541
"6250","ENSACAG00000007745","GL343219.1",1203755,1205460,1705
"6251","ENSACAG00000007746","6",35096256,35101548,5292
"6252","ENSACAG00000007747","2",147355849,147415273,59424
"6253","ENSACAG00000007748","2",13947879,14014708,66829
"6254","ENSACAG00000007749","5",40356655,40363964,7309
"6255","ENSACAG00000007750","GL343335.1",396081,598374,202293
"6256","ENSACAG00000007751","3",18335371,18336878,1507
"6257","ENSACAG00000007752","6",35086952,35090896,3944
"6258","ENSACAG00000007753","AAWZ02035537",30352,43397,13045
"6259","ENSACAG00000007754","GL343193.1",7347220,7380577,33357
"6260","ENSACAG00000007755","3",18282708,18333937,51229
"6261","ENSACAG00000007756","1",69480371,69509444,29073
"6262","ENSACAG00000007757","6",35061614,35085590,23976
"6263","ENSACAG00000007759","GL343364.1",858394,880617,22223
"6264","ENSACAG00000007760","GL343219.1",1184816,1185589,773
"6265","ENSACAG00000007761","GL343321.1",147308,173846,26538
"6266","ENSACAG00000007762","GL343219.1",1110852,1153980,43128
"6267","ENSACAG00000007763","5",40368179,40377729,9550
"6268","ENSACAG00000007764","2",86240660,86247684,7024
"6269","ENSACAG00000007766","1",163580958,163582505,1547
"6270","ENSACAG00000007768","4",38458446,38504376,45930
"6271","ENSACAG00000007771","3",18270308,18270966,658
"6272","ENSACAG00000007772","GL343218.1",261563,303937,42374
"6273","ENSACAG00000007774","GL343297.1",325230,354411,29181
"6274","ENSACAG00000007776","5",5818838,5967484,148646
"6275","ENSACAG00000007777","GL343961.1",42871,54220,11349
"6276","ENSACAG00000007778","3",34518297,34539405,21108
"6277","ENSACAG00000007779","GL343254.1",462516,462962,446
"6278","ENSACAG00000007780","GL343254.1",473391,530258,56867
"6279","ENSACAG00000007783","5",99383765,99394339,10574
"6280","ENSACAG00000007784","6",34925705,35054635,128930
"6281","ENSACAG00000007785","6",14055560,14149004,93444
"6282","ENSACAG00000007786","4",38666351,38710544,44193
"6283","ENSACAG00000007787","5",99342254,99350976,8722
"6284","ENSACAG00000007788","5",40378201,40390041,11840
"6285","ENSACAG00000007789","3",18208757,18220694,11937
"6286","ENSACAG00000007791","5",149918756,149920324,1568
"6287","ENSACAG00000007792","4",100116045,100312720,196675
"6288","ENSACAG00000007793","5",150133853,150135713,1860
"6289","ENSACAG00000007794","3",18189005,18189274,269
"6290","ENSACAG00000007795","5",150177817,150375157,197340
"6291","ENSACAG00000007796","5",24408541,24429234,20693
"6292","ENSACAG00000007797","GL343961.1",42418,44931,2513
"6293","ENSACAG00000007799","GL343228.1",1652871,1654421,1550
"6294","ENSACAG00000007800","5",99025209,99105097,79888
"6295","ENSACAG00000007801","GL343335.1",235661,279733,44072
"6296","ENSACAG00000007802","GL343483.1",301317,310631,9314
"6297","ENSACAG00000007803","GL343228.1",1708353,1811248,102895
"6298","ENSACAG00000007804","GL343852.1",21494,150610,129116
"6299","ENSACAG00000007805","GL343961.1",33306,41170,7864
"6300","ENSACAG00000007807","4",100053937,100081139,27202
"6301","ENSACAG00000007808","GL343218.1",331057,367064,36007
"6302","ENSACAG00000007809","GL343193.1",7686908,7779821,92913
"6303","ENSACAG00000007811","5",24307274,24385885,78611
"6304","ENSACAG00000007813","2",86247368,86249240,1872
"6305","ENSACAG00000007814","3",17993620,18157698,164078
"6306","ENSACAG00000007815","4",38839670,38892333,52663
"6307","ENSACAG00000007817","3",34459994,34482303,22309
"6308","ENSACAG00000007818","GL343335.1",188408,213995,25587
"6309","ENSACAG00000007819","GL343297.1",252371,272178,19807
"6310","ENSACAG00000007821","GL343297.1",193594,236383,42789
"6311","ENSACAG00000007822","6",34873464,34894381,20917
"6312","ENSACAG00000007823","2",86265723,86278000,12277
"6313","ENSACAG00000007826","AAWZ02038002",246,11176,10930
"6314","ENSACAG00000007827","GL343297.1",127866,163756,35890
"6315","ENSACAG00000007828","GL343364.1",899884,910424,10540
"6316","ENSACAG00000007829","6",14173003,14238954,65951
"6317","ENSACAG00000007830","GL343321.1",198439,212892,14453
"6318","ENSACAG00000007833","4",99954107,99970633,16526
"6319","ENSACAG00000007834","AAWZ02036029",186,5534,5348
"6320","ENSACAG00000007836","6",34681018,34783485,102467
"6321","ENSACAG00000007837","2",113322083,113329722,7639
"6322","ENSACAG00000007838","GL345104.1",67,10590,10523
"6323","ENSACAG00000007839","GL343321.1",218916,262352,43436
"6324","ENSACAG00000007841","2",113303478,113320825,17347
"6325","ENSACAG00000007842","GL344028.1",56468,58309,1841
"6326","ENSACAG00000007843","GL343465.1",57718,75842,18124
"6327","ENSACAG00000007845","4",91121742,91140941,19199
"6328","ENSACAG00000007847","2",14036522,14054965,18443
"6329","ENSACAG00000007848","GL343220.1",1565248,1575670,10422
"6330","ENSACAG00000007849","AAWZ02041122",21,4712,4691
"6331","ENSACAG00000007850","6",64295621,64298521,2900
"6332","ENSACAG00000007851","6",14381343,14391743,10400
"6333","ENSACAG00000007852","GL343880.1",114532,125396,10864
"6334","ENSACAG00000007854","GL343254.1",831984,1003935,171951
"6335","ENSACAG00000007855","GL343807.1",16588,55860,39272
"6336","ENSACAG00000007856","AAWZ02040453",2363,3352,989
"6337","ENSACAG00000007857","GL343218.1",377756,400280,22524
"6338","ENSACAG00000007858","1",30071875,30084686,12811
"6339","ENSACAG00000007859","GL344173.1",55697,58061,2364
"6340","ENSACAG00000007860","GL344660.1",1899,24055,22156
"6341","ENSACAG00000007861","6",14472149,14492086,19937
"6342","ENSACAG00000007863","GL343253.1",1791011,1814256,23245
"6343","ENSACAG00000007864","6",34298821,34592210,293389
"6344","ENSACAG00000007865","GL343220.1",1548408,1562207,13799
"6345","ENSACAG00000007867","3",169146330,169175769,29439
"6346","ENSACAG00000007868","GL344432.1",9445,28346,18901
"6347","ENSACAG00000007869","GL344028.1",14068,49153,35085
"6348","ENSACAG00000007870","4",99807799,99951111,143312
"6349","ENSACAG00000007871","2",86308578,86331326,22748
"6350","ENSACAG00000007873","GL343961.1",8281,9078,797
"6351","ENSACAG00000007875","GL343792.1",7520,21283,13763
"6352","ENSACAG00000007876","2",93814860,93823920,9060
"6353","ENSACAG00000007878","AAWZ02037395",616,3484,2868
"6354","ENSACAG00000007879","GL344433.1",312,29691,29379
"6355","ENSACAG00000007880","GL343335.1",121245,160141,38896
"6356","ENSACAG00000007881","5",98885648,98968757,83109
"6357","ENSACAG00000007882","GL343364.1",914076,923931,9855
"6358","ENSACAG00000007883","AAWZ02039940",21,5971,5950
"6359","ENSACAG00000007884","GL345057.1",603,13286,12683
"6360","ENSACAG00000007885","5",24278257,24283888,5631
"6361","ENSACAG00000007886","GL343219.1",1054807,1055769,962
"6362","ENSACAG00000007887","4",38903372,38929835,26463
"6363","ENSACAG00000007888","AAWZ02037395",4994,16834,11840
"6364","ENSACAG00000007889","GL345031.1",1363,14139,12776
"6365","ENSACAG00000007890","GL343219.1",906792,960595,53803
"6366","ENSACAG00000007891","5",24245174,24270619,25445
"6367","ENSACAG00000007892","2",86353046,86417358,64312
"6368","ENSACAG00000007893","GL343499.1",516263,524830,8567
"6369","ENSACAG00000007894","GL343220.1",1531632,1532063,431
"6370","ENSACAG00000007895","GL343220.1",1519672,1520085,413
"6371","ENSACAG00000007896","1",92789613,92816775,27162
"6372","ENSACAG00000007898","GL343220.1",1449001,1449435,434
"6373","ENSACAG00000007899","AAWZ02036280",7573,21430,13857
"6374","ENSACAG00000007900","GL343219.1",818098,844053,25955
"6375","ENSACAG00000007901","GL343364.1",939356,1016550,77194
"6376","ENSACAG00000007902","1",166502563,166918711,416148
"6377","ENSACAG00000007904","3",34441527,34450696,9169
"6378","ENSACAG00000007905","GL343297.1",48655,125580,76925
"6379","ENSACAG00000007906","6",53507985,53523154,15169
"6380","ENSACAG00000007907","GL344223.1",29224,63220,33996
"6381","ENSACAG00000007908","GL343321.1",275057,308714,33657
"6382","ENSACAG00000007912","4",38939244,38956764,17520
"6383","ENSACAG00000007913","4",38963268,39151009,187741
"6384","ENSACAG00000007914","GL343542.1",229159,238968,9809
"6385","ENSACAG00000007915","GL343220.1",1412168,1415580,3412
"6386","ENSACAG00000007916","2",14091617,14107306,15689
"6387","ENSACAG00000007917","2",113189612,113216929,27317
"6388","ENSACAG00000007918","GL344190.1",42736,53904,11168
"6389","ENSACAG00000007919","GL343219.1",702946,723192,20246
"6390","ENSACAG00000007921","6",53652888,53807636,154748
"6391","ENSACAG00000007922","5",24199467,24241009,41542
"6392","ENSACAG00000007923","LGg",292780,338860,46080
"6393","ENSACAG00000007924","2",113170432,113182116,11684
"6394","ENSACAG00000007925","5",98694265,98829783,135518
"6395","ENSACAG00000007929","3",34416214,34442597,26383
"6396","ENSACAG00000007931","2",93851484,93926043,74559
"6397","ENSACAG00000007932","3",57880239,58018819,138580
"6398","ENSACAG00000007933","GL343499.1",431047,445005,13958
"6399","ENSACAG00000007935","GL343408.1",53304,54239,935
"6400","ENSACAG00000007936","2",113110404,113116948,6544
"6401","ENSACAG00000007937","GL343451.1",50809,52940,2131
"6402","ENSACAG00000007938","GL344110.1",1207,46748,45541
"6403","ENSACAG00000007939","GL343193.1",8047857,8089026,41169
"6404","ENSACAG00000007940","GL343408.1",210810,230599,19789
"6405","ENSACAG00000007941","6",33665512,33751418,85906
"6406","ENSACAG00000007942","3",169133512,169142444,8932
"6407","ENSACAG00000007943","AAWZ02038369",3504,11698,8194
"6408","ENSACAG00000007944","1",206100484,206101350,866
"6409","ENSACAG00000007946","GL343542.1",244589,337732,93143
"6410","ENSACAG00000007948","1",206065912,206066169,257
"6411","ENSACAG00000007949","GL343321.1",1033689,1156235,122546
"6412","ENSACAG00000007951","2",113065664,113104464,38800
"6413","ENSACAG00000007952","AAWZ02037267",1464,15044,13580
"6414","ENSACAG00000007953","2",95732411,95749301,16890
"6415","ENSACAG00000007955","2",154998971,155035401,36430
"6416","ENSACAG00000007957","3",168976686,169015737,39051
"6417","ENSACAG00000007958","GL343499.1",468698,476089,7391
"6418","ENSACAG00000007959","2",95825623,95839095,13472
"6419","ENSACAG00000007960","GL343196.1",5402355,5405415,3060
"6420","ENSACAG00000007961","2",95868214,95891633,23419
"6421","ENSACAG00000007962","GL343451.1",74862,82669,7807
"6422","ENSACAG00000007963","GL343451.1",88113,105148,17035
"6423","ENSACAG00000007964","1",206046096,206057695,11599
"6424","ENSACAG00000007966","GL343364.1",1027192,1031590,4398
"6425","ENSACAG00000007967","2",147416804,147434599,17795
"6426","ENSACAG00000007968","3",168862538,168950135,87597
"6427","ENSACAG00000007969","GL343228.1",1970265,1984974,14709
"6428","ENSACAG00000007970","GL343408.1",243814,381357,137543
"6429","ENSACAG00000007971","3",18113672,18115284,1612
"6430","ENSACAG00000007973","3",18104637,18105647,1010
"6431","ENSACAG00000007974","GL343335.1",99621,117811,18190
"6432","ENSACAG00000007975","GL344259.1",9393,10830,1437
"6433","ENSACAG00000007976","2",14135194,14144790,9596
"6434","ENSACAG00000007977","3",18046654,18047589,935
"6435","ENSACAG00000007980","2",14160629,14161715,1086
"6436","ENSACAG00000007981","3",17950284,17977236,26952
"6437","ENSACAG00000007982","GL344259.1",23815,27036,3221
"6438","ENSACAG00000007983","1",92824512,92856785,32273
"6439","ENSACAG00000007984","GL343220.1",1363198,1373964,10766
"6440","ENSACAG00000007985","GL343196.1",5352906,5398188,45282
"6441","ENSACAG00000007987","2",14202163,14220165,18002
"6442","ENSACAG00000007988","GL343193.1",8126349,8167997,41648
"6443","ENSACAG00000007989","GL343220.1",1307193,1311228,4035
"6444","ENSACAG00000007990","4",39196758,39283917,87159
"6445","ENSACAG00000007991","AAWZ02040417",804,2539,1735
"6446","ENSACAG00000007992","2",14222427,14348986,126559
"6447","ENSACAG00000007993","GL343253.1",1880857,1898093,17236
"6448","ENSACAG00000007994","GL343364.1",1007484,1051176,43692
"6449","ENSACAG00000007995","3",34329656,34407658,78002
"6450","ENSACAG00000007996","GL343219.1",667722,703964,36242
"6451","ENSACAG00000007997","GL343254.1",1061974,1081404,19430
"6452","ENSACAG00000007998","GL344259.1",29549,37528,7979
"6453","ENSACAG00000007999","GL343483.1",323196,328534,5338
"6454","ENSACAG00000008000","GL343499.1",174954,367930,192976
"6455","ENSACAG00000008002","3",17851732,17873020,21288
"6456","ENSACAG00000008003","GL343220.1",1296818,1299765,2947
"6457","ENSACAG00000008004","GL343483.1",329183,335550,6367
"6458","ENSACAG00000008005","GL343710.1",81404,151014,69610
"6459","ENSACAG00000008006","2",147433039,147436023,2984
"6460","ENSACAG00000008007","2",147443881,147491161,47280
"6461","ENSACAG00000008008","GL343814.1",42398,164454,122056
"6462","ENSACAG00000008010","3",168236503,168265898,29395
"6463","ENSACAG00000008011","GL343297.1",9687,36941,27254
"6464","ENSACAG00000008012","GL343193.1",8168222,8179684,11462
"6465","ENSACAG00000008018","6",9232582,9302440,69858
"6466","ENSACAG00000008021","1",92919492,92925496,6004
"6467","ENSACAG00000008023","GL343193.1",8272090,8282207,10117
"6468","ENSACAG00000008024","GL343608.1",39752,69149,29397
"6469","ENSACAG00000008026","GL343537.1",413294,458521,45227
"6470","ENSACAG00000008027","2",3538419,3543080,4661
"6471","ENSACAG00000008029","GL343593.1",257019,350250,93231
"6472","ENSACAG00000008030","GL343543.1",473467,526347,52880
"6473","ENSACAG00000008031","GL343364.1",1058390,1077230,18840
"6474","ENSACAG00000008033","GL343220.1",1237094,1262614,25520
"6475","ENSACAG00000008035","GL343877.1",139327,141038,1711
"6476","ENSACAG00000008036","1",92898135,92913194,15059
"6477","ENSACAG00000008038","GL343193.1",8316331,8326984,10653
"6478","ENSACAG00000008039","6",14492716,14512293,19577
"6479","ENSACAG00000008040","GL343697.1",230435,241275,10840
"6480","ENSACAG00000008041","1",92959531,92970970,11439
"6481","ENSACAG00000008044","GL343849.1",68594,75410,6816
"6482","ENSACAG00000008046","3",57826045,57832670,6625
"6483","ENSACAG00000008047","2",93942418,93948207,5789
"6484","ENSACAG00000008048","GL343219.1",58253,142556,84303
"6485","ENSACAG00000008050","GL343384.1",157198,293842,136644
"6486","ENSACAG00000008051","1",92986903,92996727,9824
"6487","ENSACAG00000008052","GL343849.1",96540,116852,20312
"6488","ENSACAG00000008055","GL343483.1",336740,346755,10015
"6489","ENSACAG00000008056","5",61450121,61488186,38065
"6490","ENSACAG00000008057","GL343193.1",8359708,8377266,17558
"6491","ENSACAG00000008058","1",93031859,93073686,41827
"6492","ENSACAG00000008059","GL343814.1",25633,27745,2112
"6493","ENSACAG00000008060","GL343877.1",85591,110111,24520
"6494","ENSACAG00000008061","GL343451.1",148658,182137,33479
"6495","ENSACAG00000008062","1",203899738,203905208,5470
"6496","ENSACAG00000008063","6",53856876,53867301,10425
"6497","ENSACAG00000008064","GL343383.1",31969,39247,7278
"6498","ENSACAG00000008065","GL343849.1",126730,129488,2758
"6499","ENSACAG00000008066","1",93122861,93137847,14986
"6500","ENSACAG00000008067","GL343554.1",448537,456000,7463
"6501","ENSACAG00000008068","3",57791995,57819193,27198
"6502","ENSACAG00000008069","2",93955524,93976480,20956
"6503","ENSACAG00000008070","5",24171347,24196383,25036
"6504","ENSACAG00000008071","GL344093.1",17504,37321,19817
"6505","ENSACAG00000008072","GL343897.1",13080,125101,112021
"6506","ENSACAG00000008073","4",114376184,114387545,11361
"6507","ENSACAG00000008074","GL343220.1",1207614,1223360,15746
"6508","ENSACAG00000008075","GL343219.1",21,35733,35712
"6509","ENSACAG00000008076","GL343193.1",8384423,8392969,8546
"6510","ENSACAG00000008077","6",53876086,53907146,31060
"6511","ENSACAG00000008078","GL344707.1",6588,21092,14504
"6512","ENSACAG00000008079","6",14512420,14545358,32938
"6513","ENSACAG00000008081","GL343542.1",413230,427917,14687
"6514","ENSACAG00000008082","4",114394738,114405538,10800
"6515","ENSACAG00000008083","GL343697.1",64992,91377,26385
"6516","ENSACAG00000008085","GL343483.1",366412,370631,4219
"6517","ENSACAG00000008086","GL343877.1",71502,81133,9631
"6518","ENSACAG00000008087","GL343697.1",5075,34228,29153
"6519","ENSACAG00000008089","GL343383.1",49242,234776,185534
"6520","ENSACAG00000008090","GL343608.1",71153,78644,7491
"6521","ENSACAG00000008091","GL344290.1",25101,33314,8213
"6522","ENSACAG00000008092","GL343196.1",5174514,5322659,148145
"6523","ENSACAG00000008093","1",203878292,203896831,18539
"6524","ENSACAG00000008094","GL343218.1",413351,419268,5917
"6525","ENSACAG00000008097","1",232891110,232906567,15457
"6526","ENSACAG00000008098","2",86423253,86454523,31270
"6527","ENSACAG00000008099","GL343220.1",1204334,1212440,8106
"6528","ENSACAG00000008100","GL343733.1",218282,219890,1608
"6529","ENSACAG00000008101","4",99736650,99765867,29217
"6530","ENSACAG00000008102","6",53925584,53958536,32952
"6531","ENSACAG00000008103","GL344093.1",45034,63286,18252
"6532","ENSACAG00000008104","5",98814482,98815299,817
"6533","ENSACAG00000008105","GL343220.1",1187750,1198342,10592
"6534","ENSACAG00000008106","GL343308.1",705802,719362,13560
"6535","ENSACAG00000008107","4",114430678,114504738,74060
"6536","ENSACAG00000008108","GL343542.1",434443,434856,413
"6537","ENSACAG00000008110","6",14588682,14660287,71605
"6538","ENSACAG00000008111","GL343456.1",625180,639748,14568
"6539","ENSACAG00000008112","GL343193.1",8444200,8487754,43554
"6540","ENSACAG00000008113","1",93138239,93156073,17834
"6541","ENSACAG00000008115","GL343483.1",371307,394056,22749
"6542","ENSACAG00000008116","1",232744807,232782615,37808
"6543","ENSACAG00000008117","5",24158080,24166393,8313
"6544","ENSACAG00000008118","GL343440.1",440801,727196,286395
"6545","ENSACAG00000008119","5",98586114,98640608,54494
"6546","ENSACAG00000008120","GL343218.1",427549,444221,16672
"6547","ENSACAG00000008122","GL343218.1",550391,577260,26869
"6548","ENSACAG00000008123","2",113021439,113032744,11305
"6549","ENSACAG00000008124","GL344093.1",56978,80882,23904
"6550","ENSACAG00000008125","GL343608.1",100315,112352,12037
"6551","ENSACAG00000008126","GL343456.1",570668,614234,43566
"6552","ENSACAG00000008127","5",24144229,24155133,10904
"6553","ENSACAG00000008128","3",34199906,34249601,49695
"6554","ENSACAG00000008129","6",53962631,53984555,21924
"6555","ENSACAG00000008130","2",49994144,49994639,495
"6556","ENSACAG00000008131","GL343218.1",597898,671828,73930
"6557","ENSACAG00000008132","4",99309556,99358749,49193
"6558","ENSACAG00000008133","GL343593.1",166170,230155,63985
"6559","ENSACAG00000008135","GL343220.1",1161203,1187842,26639
"6560","ENSACAG00000008136","3",56922740,57137211,214471
"6561","ENSACAG00000008137","2",112843417,113003341,159924
"6562","ENSACAG00000008138","6",14658171,14672051,13880
"6563","ENSACAG00000008139","GL343877.1",504,36291,35787
"6564","ENSACAG00000008140","AAWZ02037300",1196,17044,15848
"6565","ENSACAG00000008142","5",24135280,24142203,6923
"6566","ENSACAG00000008144","4",99187678,99219363,31685
"6567","ENSACAG00000008145","GL344734.1",1715,22858,21143
"6568","ENSACAG00000008148","5",24080499,24097484,16985
"6569","ENSACAG00000008149","GL343346.1",1187530,1215428,27898
"6570","ENSACAG00000008150","GL343537.1",214932,238261,23329
"6571","ENSACAG00000008151","GL343346.1",1170034,1180124,10090
"6572","ENSACAG00000008152","GL343408.1",436940,570161,133221
"6573","ENSACAG00000008153","GL343451.1",202876,209273,6397
"6574","ENSACAG00000008154","5",61311291,61442833,131542
"6575","ENSACAG00000008155","1",93168091,93180967,12876
"6576","ENSACAG00000008157","1",232677672,232733975,56303
"6577","ENSACAG00000008158","GL343460.1",630869,648061,17192
"6578","ENSACAG00000008159","AAWZ02041144",2362,3491,1129
"6579","ENSACAG00000008160","6",54040688,54074427,33739
"6580","ENSACAG00000008161","GL343537.1",60060,61720,1660
"6581","ENSACAG00000008162","GL343456.1",551842,553286,1444
"6582","ENSACAG00000008163","6",14710219,14758328,48109
"6583","ENSACAG00000008164","GL343456.1",158065,488154,330089
"6584","ENSACAG00000008165","GL343537.1",54670,60453,5783
"6585","ENSACAG00000008166","GL343193.1",8524092,8538602,14510
"6586","ENSACAG00000008167","1",167029138,167114258,85120
"6587","ENSACAG00000008168","GL343608.1",123187,126837,3650
"6588","ENSACAG00000008169","GL343193.1",8691171,8874162,182991
"6589","ENSACAG00000008170","5",98376346,98513767,137421
"6590","ENSACAG00000008171","3",33992501,34166740,174239
"6591","ENSACAG00000008172","GL343384.1",296036,314140,18104
"6592","ENSACAG00000008176","GL343543.1",451221,471253,20032
"6593","ENSACAG00000008177","GL343346.1",1139219,1140190,971
"6594","ENSACAG00000008179","GL343543.1",410399,438715,28316
"6595","ENSACAG00000008181","4",99125070,99165948,40878
"6596","ENSACAG00000008182","GL343218.1",775082,872424,97342
"6597","ENSACAG00000008183","1",203687209,203817516,130307
"6598","ENSACAG00000008184","GL343267.1",1174801,1214764,39963
"6599","ENSACAG00000008185","4",114508600,114546606,38006
"6600","ENSACAG00000008186","GL344290.1",680,19238,18558
"6601","ENSACAG00000008187","1",203441314,203448161,6847
"6602","ENSACAG00000008188","GL343346.1",1052507,1054239,1732
"6603","ENSACAG00000008189","GL344333.1",5343,41546,36203
"6604","ENSACAG00000008190","6",54105067,54130333,25266
"6605","ENSACAG00000008192","2",86474899,86478644,3745
"6606","ENSACAG00000008193","6",14802068,14844648,42580
"6607","ENSACAG00000008194","GL343384.1",340502,350537,10035
"6608","ENSACAG00000008195","GL343346.1",1012180,1030566,18386
"6609","ENSACAG00000008196","5",61269444,61303202,33758
"6610","ENSACAG00000008197","6",54151446,54189174,37728
"6611","ENSACAG00000008198","2",155052393,155054672,2279
"6612","ENSACAG00000008199","4",114550694,114572314,21620
"6613","ENSACAG00000008200","GL343444.1",680749,714576,33827
"6614","ENSACAG00000008201","2",155064679,155091122,26443
"6615","ENSACAG00000008202","2",94044491,94074793,30302
"6616","ENSACAG00000008203","GL343451.1",210232,221694,11462
"6617","ENSACAG00000008205","GL343537.1",43878,50548,6670
"6618","ENSACAG00000008206","1",203242111,203311982,69871
"6619","ENSACAG00000008207","5",98165490,98290914,125424
"6620","ENSACAG00000008208","2",112539559,112848836,309277
"6621","ENSACAG00000008210","GL343218.1",879296,910320,31024
"6622","ENSACAG00000008212","LGc",3988063,3988791,728
"6623","ENSACAG00000008213","4",39289789,39316560,26771
"6624","ENSACAG00000008214","2",112471964,112494244,22280
"6625","ENSACAG00000008216","GL343196.1",4382572,4905918,523346
"6626","ENSACAG00000008217","AAWZ02037033",11383,12843,1460
"6627","ENSACAG00000008218","GL343456.1",79152,134386,55234
"6628","ENSACAG00000008219","GL343255.1",1970429,1983402,12973
"6629","ENSACAG00000008220","2",86478992,86499557,20565
"6630","ENSACAG00000008221","3",126075796,126190824,115028
"6631","ENSACAG00000008222","GL344987.1",9863,14914,5051
"6632","ENSACAG00000008223","GL343255.1",1786103,1831688,45585
"6633","ENSACAG00000008224","GL343807.1",1913,13984,12071
"6634","ENSACAG00000008227","2",94100765,94116887,16122
"6635","ENSACAG00000008228","2",155130582,155171363,40781
"6636","ENSACAG00000008230","2",112395616,112428826,33210
"6637","ENSACAG00000008231","1",93260639,93281137,20498
"6638","ENSACAG00000008232","GL343692.1",168504,188853,20349
"6639","ENSACAG00000008236","6",54285713,54384157,98444
"6640","ENSACAG00000008237","4",135478144,135505838,27694
"6641","ENSACAG00000008238","GL343483.1",436139,486325,50186
"6642","ENSACAG00000008239","5",98069653,98143338,73685
"6643","ENSACAG00000008240","2",94127673,94145297,17624
"6644","ENSACAG00000008242","1",93292206,93310690,18484
"6645","ENSACAG00000008243","GL343384.1",366290,397823,31533
"6646","ENSACAG00000008244","GL343444.1",648402,679389,30987
"6647","ENSACAG00000008245","GL343460.1",615231,626740,11509
"6648","ENSACAG00000008246","GL343346.1",984473,1012852,28379
"6649","ENSACAG00000008247","GL343383.1",237135,320605,83470
"6650","ENSACAG00000008249","4",114575187,114580026,4839
"6651","ENSACAG00000008250","1",232599124,232656645,57521
"6652","ENSACAG00000008251","GL343383.1",338680,370840,32160
"6653","ENSACAG00000008253","GL343975.1",634,51728,51094
"6654","ENSACAG00000008255","1",167240397,167410048,169651
"6655","ENSACAG00000008256","GL343267.1",1134156,1135418,1262
"6656","ENSACAG00000008257","GL343593.1",101146,150050,48904
"6657","ENSACAG00000008259","GL343460.1",565251,600193,34942
"6658","ENSACAG00000008260","GL343267.1",1219775,1223389,3614
"6659","ENSACAG00000008261","3",33884693,33908531,23838
"6660","ENSACAG00000008262","5",98002905,98040607,37702
"6661","ENSACAG00000008263","GL343267.1",1230078,1240012,9934
"6662","ENSACAG00000008264","GL343460.1",472783,524159,51376
"6663","ENSACAG00000008265","AAWZ02041417",323,5689,5366
"6664","ENSACAG00000008266","2",94169342,94183733,14391
"6665","ENSACAG00000008267","GL343537.1",34785,37527,2742
"6666","ENSACAG00000008268","3",126342054,126358198,16144
"6667","ENSACAG00000008269","1",224949666,225058970,109304
"6668","ENSACAG00000008270","2",112293474,112338472,44998
"6669","ENSACAG00000008271","GL343384.1",462194,507203,45009
"6670","ENSACAG00000008272","6",54416220,54482195,65975
"6671","ENSACAG00000008273","GL343444.1",583928,632929,49001
"6672","ENSACAG00000008274","GL343451.1",224191,231556,7365
"6673","ENSACAG00000008276","GL343346.1",959623,978727,19104
"6674","ENSACAG00000008278","2",94181178,94192131,10953
"6675","ENSACAG00000008279","GL343537.1",5938,16579,10641
"6676","ENSACAG00000008280","2",86499620,86553295,53675
"6677","ENSACAG00000008281","3",33862880,33876380,13500
"6678","ENSACAG00000008282","4",114583567,114623394,39827
"6679","ENSACAG00000008283","3",33838700,33858072,19372
"6680","ENSACAG00000008284","GL343593.1",68302,98065,29763
"6681","ENSACAG00000008285","AAWZ02036218",9955,18348,8393
"6682","ENSACAG00000008286","6",9304416,9331346,26930
"6683","ENSACAG00000008287","GL343354.1",608176,754576,146400
"6684","ENSACAG00000008288","GL343218.1",915069,933959,18890
"6685","ENSACAG00000008290","4",98856403,99091284,234881
"6686","ENSACAG00000008293","2",147492705,147499692,6987
"6687","ENSACAG00000008296","GL343220.1",1075013,1125335,50322
"6688","ENSACAG00000008297","2",147510464,147522987,12523
"6689","ENSACAG00000008298","GL343451.1",234133,246433,12300
"6690","ENSACAG00000008300","4",114632562,114641513,8951
"6691","ENSACAG00000008301","GL343220.1",1064801,1076820,12019
"6692","ENSACAG00000008303","AAWZ02037778",4553,4945,392
"6693","ENSACAG00000008304","2",27703741,27705606,1865
"6694","ENSACAG00000008305","GL343456.1",35008,77540,42532
"6695","ENSACAG00000008306","GL343267.1",1246898,1267947,21049
"6696","ENSACAG00000008307","4",39319167,39341108,21941
"6697","ENSACAG00000008308","2",94200823,94237886,37063
"6698","ENSACAG00000008309","5",61092084,61236231,144147
"6699","ENSACAG00000008310","2",27705187,27723446,18259
"6700","ENSACAG00000008311","4",114645428,114697945,52517
"6701","ENSACAG00000008312","2",14263666,14266547,2881
"6702","ENSACAG00000008313","AAWZ02040296",11,6804,6793
"6703","ENSACAG00000008314","1",167454638,167518315,63677
"6704","ENSACAG00000008315","2",14444087,14540091,96004
"6705","ENSACAG00000008316","2",147561445,147594712,33267
"6706","ENSACAG00000008317","GL343456.1",10622,25581,14959
"6707","ENSACAG00000008318","2",112189610,112286050,96440
"6708","ENSACAG00000008322","GL343346.1",952748,953768,1020
"6709","ENSACAG00000008323","GL343346.1",874566,875912,1346
"6710","ENSACAG00000008325","3",33767887,33795332,27445
"6711","ENSACAG00000008327","GL343346.1",835070,843264,8194
"6712","ENSACAG00000008328","AAWZ02040095",1464,4441,2977
"6713","ENSACAG00000008330","GL343384.1",699686,770007,70321
"6714","ENSACAG00000008331","4",114708126,114721299,13173
"6715","ENSACAG00000008332","4",114777362,114781435,4073
"6716","ENSACAG00000008333","GL343765.1",43777,56609,12832
"6717","ENSACAG00000008334","4",114784571,114817459,32888
"6718","ENSACAG00000008335","GL343593.1",37258,59184,21926
"6719","ENSACAG00000008336","2",199167583,199168815,1232
"6720","ENSACAG00000008337","GL343661.1",164,219742,219578
"6721","ENSACAG00000008338","4",135515085,135539716,24631
"6722","ENSACAG00000008339","GL343456.1",21,5712,5691
"6723","ENSACAG00000008340","GL343384.1",808758,813886,5128
"6724","ENSACAG00000008341","GL343375.1",583,18080,17497
"6725","ENSACAG00000008342","1",62792847,62854668,61821
"6726","ENSACAG00000008343","GL343375.1",21921,122209,100288
"6727","ENSACAG00000008345","GL344270.1",963,16808,15845
"6728","ENSACAG00000008346","GL343269.1",132321,396612,264291
"6729","ENSACAG00000008348","GL343460.1",395485,449463,53978
"6730","ENSACAG00000008349","GL343313.1",1189119,1189415,296
"6731","ENSACAG00000008350","GL344501.1",5522,5635,113
"6732","ENSACAG00000008352","1",232581545,232587981,6436
"6733","ENSACAG00000008354","4",98568633,98740260,171627
"6734","ENSACAG00000008356","GL343218.1",938623,948877,10254
"6735","ENSACAG00000008357","GL343346.1",765752,821065,55313
"6736","ENSACAG00000008358","GL343220.1",1053786,1058676,4890
"6737","ENSACAG00000008359","2",147612574,147675985,63411
"6738","ENSACAG00000008361","GL343826.1",128070,162230,34160
"6739","ENSACAG00000008362","GL343499.1",35241,159052,123811
"6740","ENSACAG00000008363","6",14849268,14972096,122828
"6741","ENSACAG00000008364","6",59608050,59620203,12153
"6742","ENSACAG00000008365","1",93322652,93355399,32747
"6743","ENSACAG00000008367","2",27730578,27739658,9080
"6744","ENSACAG00000008368","AAWZ02038015",7210,11181,3971
"6745","ENSACAG00000008369","3",33761324,33762100,776
"6746","ENSACAG00000008370","GL343458.1",237540,564627,327087
"6747","ENSACAG00000008371","GL343618.1",417634,438214,20580
"6748","ENSACAG00000008372","3",33699172,33744819,45647
"6749","ENSACAG00000008373","AAWZ02040788",2801,5913,3112
"6750","ENSACAG00000008374","AAWZ02039474",21,7422,7401
"6751","ENSACAG00000008376","2",155568005,155596714,28709
"6752","ENSACAG00000008378","2",86564919,86688943,124024
"6753","ENSACAG00000008379","1",232538520,232575193,36673
"6754","ENSACAG00000008380","2",112173017,112182041,9024
"6755","ENSACAG00000008382","1",167592416,167660958,68542
"6756","ENSACAG00000008383","2",112098893,112172397,73504
"6757","ENSACAG00000008384","3",50989659,51127035,137376
"6758","ENSACAG00000008385","GL343593.1",4439,14253,9814
"6759","ENSACAG00000008386","2",27775566,27836596,61030
"6760","ENSACAG00000008388","3",50947915,50969657,21742
"6761","ENSACAG00000008389","GL344501.1",25004,41030,16026
"6762","ENSACAG00000008390","GL343218.1",1005280,1126632,121352
"6763","ENSACAG00000008392","2",95942009,95980050,38041
"6764","ENSACAG00000008393","2",14645459,14693788,48329
"6765","ENSACAG00000008395","GL343220.1",1023211,1030261,7050
"6766","ENSACAG00000008396","4",39363120,39459939,96819
"6767","ENSACAG00000008397","GL343267.1",1403842,1409323,5481
"6768","ENSACAG00000008398","1",63293791,63305706,11915
"6769","ENSACAG00000008399","3",50911098,50933538,22440
"6770","ENSACAG00000008400","GL344373.1",250,15572,15322
"6771","ENSACAG00000008401","3",40725917,40729283,3366
"6772","ENSACAG00000008404","1",151315951,151356897,40946
"6773","ENSACAG00000008405","GL343832.1",124146,132538,8392
"6774","ENSACAG00000008406","3",50680224,50877692,197468
"6775","ENSACAG00000008407","GL343346.1",708439,752353,43914
"6776","ENSACAG00000008408","2",155711970,155751256,39286
"6777","ENSACAG00000008410","2",147875611,147953639,78028
"6778","ENSACAG00000008411","2",111847203,111891744,44541
"6779","ENSACAG00000008412","1",151408652,151445680,37028
"6780","ENSACAG00000008413","GL343420.1",238601,267296,28695
"6781","ENSACAG00000008414","2",14697484,14725448,27964
"6782","ENSACAG00000008416","GL343712.1",207755,222114,14359
"6783","ENSACAG00000008417","2",96022644,96027277,4633
"6784","ENSACAG00000008418","6",59527327,59547107,19780
"6785","ENSACAG00000008419","GL344083.1",55384,62997,7613
"6786","ENSACAG00000008420","1",203087688,203138427,50739
"6787","ENSACAG00000008421","2",27842966,27900265,57299
"6788","ENSACAG00000008422","GL343346.1",665827,681383,15556
"6789","ENSACAG00000008423","6",59380111,59400752,20641
"6790","ENSACAG00000008424","GL343460.1",354481,383954,29473
"6791","ENSACAG00000008425","2",96044362,96088726,44364
"6792","ENSACAG00000008426","3",94940196,94940315,119
"6793","ENSACAG00000008427","GL344373.1",24654,35527,10873
"6794","ENSACAG00000008428","AAWZ02039361",2127,5746,3619
"6795","ENSACAG00000008429","4",39494128,39511606,17478
"6796","ENSACAG00000008430","6",54497330,54584373,87043
"6797","ENSACAG00000008434","4",114844414,114854955,10541
"6798","ENSACAG00000008435","2",94460752,94526698,65946
"6799","ENSACAG00000008436","GL343486.1",221428,260641,39213
"6800","ENSACAG00000008437","GL343375.1",151932,216414,64482
"6801","ENSACAG00000008438","1",232500184,232517568,17384
"6802","ENSACAG00000008439","1",224892533,224942244,49711
"6803","ENSACAG00000008440","GL343310.1",719719,741822,22103
"6804","ENSACAG00000008441","2",96116437,96131450,15013
"6805","ENSACAG00000008442","GL343269.1",567282,658598,91316
"6806","ENSACAG00000008443","4",98512151,98557779,45628
"6807","ENSACAG00000008445","GL343269.1",716524,732995,16471
"6808","ENSACAG00000008446","4",135897782,136167817,270035
"6809","ENSACAG00000008449","GL343460.1",328058,346088,18030
"6810","ENSACAG00000008451","2",111802512,111830540,28028
"6811","ENSACAG00000008452","1",232451473,232457684,6211
"6812","ENSACAG00000008454","1",232393223,232397185,3962
"6813","ENSACAG00000008455","GL343832.1",92406,123216,30810
"6814","ENSACAG00000008456","4",39515191,39527743,12552
"6815","ENSACAG00000008458","2",14734021,14765136,31115
"6816","ENSACAG00000008459","6",59363519,59380260,16741
"6817","ENSACAG00000008460","2",147975937,147993932,17995
"6818","ENSACAG00000008461","GL343209.1",3436193,3446148,9955
"6819","ENSACAG00000008462","GL343241.1",2067223,2090224,23001
"6820","ENSACAG00000008463","3",50500473,50604209,103736
"6821","ENSACAG00000008464","GL343420.1",642829,688317,45488
"6822","ENSACAG00000008465","2",165500837,165501562,725
"6823","ENSACAG00000008466","GL343618.1",403900,407663,3763
"6824","ENSACAG00000008467","1",224803293,224864157,60864
"6825","ENSACAG00000008469","4",114859131,114902273,43142
"6826","ENSACAG00000008470","GL343269.1",785102,811918,26816
"6827","ENSACAG00000008472","2",8139037,8212221,73184
"6828","ENSACAG00000008473","1",232351479,232385365,33886
"6829","ENSACAG00000008474","1",167669810,167671613,1803
"6830","ENSACAG00000008475","4",136241362,136331849,90487
"6831","ENSACAG00000008476","1",203040801,203067610,26809
"6832","ENSACAG00000008477","1",167706875,167809696,102821
"6833","ENSACAG00000008478","4",98445272,98508127,62855
"6834","ENSACAG00000008479","GL343618.1",375450,397302,21852
"6835","ENSACAG00000008480","2",148014812,148078382,63570
"6836","ENSACAG00000008481","1",93363954,93379594,15640
"6837","ENSACAG00000008482","GL344463.1",6015,12463,6448
"6838","ENSACAG00000008483","GL343661.1",225254,257962,32708
"6839","ENSACAG00000008484","6",59317036,59360113,43077
"6840","ENSACAG00000008486","2",111755900,111755992,92
"6841","ENSACAG00000008487","4",39529854,39547551,17697
"6842","ENSACAG00000008488","2",111674359,111693362,19003
"6843","ENSACAG00000008489","1",93381970,93393185,11215
"6844","ENSACAG00000008490","GL344117.1",42293,94216,51923
"6845","ENSACAG00000008491","1",167808812,167848701,39889
"6846","ENSACAG00000008492","GL344314.1",7700,51235,43535
"6847","ENSACAG00000008493","4",6865287,6890521,25234
"6848","ENSACAG00000008494","GL343209.1",3359925,3403974,44049
"6849","ENSACAG00000008495","GL343218.1",1191736,1231454,39718
"6850","ENSACAG00000008496","GL343269.1",836520,863126,26606
"6851","ENSACAG00000008497","GL343241.1",2051368,2065672,14304
"6852","ENSACAG00000008498","6",15035612,15163204,127592
"6853","ENSACAG00000008499","GL343460.1",300456,326685,26229
"6854","ENSACAG00000008500","GL343269.1",875981,876213,232
"6855","ENSACAG00000008501","1",151536588,151561034,24446
"6856","ENSACAG00000008502","AAWZ02041261",868,2338,1470
"6857","ENSACAG00000008504","2",8229606,8238950,9344
"6858","ENSACAG00000008505","GL343269.1",903327,926561,23234
"6859","ENSACAG00000008507","2",8244688,8322450,77762
"6860","ENSACAG00000008508","GL343375.1",218401,272606,54205
"6861","ENSACAG00000008509","1",224625963,224644378,18415
"6862","ENSACAG00000008510","GL343196.1",3191590,3197857,6267
"6863","ENSACAG00000008512","2",191470343,191486657,16314
"6864","ENSACAG00000008513","GL343568.1",347088,358586,11498
"6865","ENSACAG00000008514","AAWZ02039478",2133,8202,6069
"6866","ENSACAG00000008516","AAWZ02041359",21,5530,5509
"6867","ENSACAG00000008517","GL343821.1",272505,273890,1385
"6868","ENSACAG00000008519","GL343609.1",378037,386575,8538
"6869","ENSACAG00000008520","AAWZ02038357",52,5323,5271
"6870","ENSACAG00000008521","GL343196.1",2723060,2753934,30874
"6871","ENSACAG00000008522","GL344038.1",87534,93917,6383
"6872","ENSACAG00000008523","AAWZ02037391",9758,14216,4458
"6873","ENSACAG00000008524","1",174180273,174234955,54682
"6874","ENSACAG00000008525","GL343460.1",272057,279518,7461
"6875","ENSACAG00000008526","AAWZ02038570",4748,9523,4775
"6876","ENSACAG00000008527","1",232199318,232200088,770
"6877","ENSACAG00000008530","GL343209.1",3167227,3208347,41120
"6878","ENSACAG00000008531","GL344254.1",32809,67294,34485
"6879","ENSACAG00000008532","1",168049663,168072530,22867
"6880","ENSACAG00000008533","2",111637172,111644030,6858
"6881","ENSACAG00000008534","1",232094976,232111552,16576
"6882","ENSACAG00000008535","GL343505.1",570138,580171,10033
"6883","ENSACAG00000008536","6",15197494,15202552,5058
"6884","ENSACAG00000008537","GL343451.1",251978,259213,7235
"6885","ENSACAG00000008538","GL343618.1",349579,368900,19321
"6886","ENSACAG00000008539","2",86748836,86765502,16666
"6887","ENSACAG00000008540","GL343375.1",272083,284287,12204
"6888","ENSACAG00000008542","GL343420.1",695860,760375,64515
"6889","ENSACAG00000008543","6",15207401,15214079,6678
"6890","ENSACAG00000008544","AAWZ02037392",13248,13886,638
"6891","ENSACAG00000008545","1",10295412,10313224,17812
"6892","ENSACAG00000008546","AAWZ02038436",4451,5581,1130
"6893","ENSACAG00000008547","GL344776.1",966,2506,1540
"6894","ENSACAG00000008548","AAWZ02040148",1849,6661,4812
"6895","ENSACAG00000008549","1",93405876,93411919,6043
"6896","ENSACAG00000008550","6",54638172,54743742,105570
"6897","ENSACAG00000008552","GL344502.1",59,11494,11435
"6898","ENSACAG00000008553","2",111632773,111634794,2021
"6899","ENSACAG00000008555","GL343265.1",1965856,2000344,34488
"6900","ENSACAG00000008556","2",14779127,14859071,79944
"6901","ENSACAG00000008557","GL343486.1",388286,580626,192340
"6902","ENSACAG00000008558","GL343609.1",355909,382911,27002
"6903","ENSACAG00000008559","GL343196.1",2699019,2712106,13087
"6904","ENSACAG00000008560","GL344832.1",1954,19497,17543
"6905","ENSACAG00000008561","1",151588795,151593682,4887
"6906","ENSACAG00000008562","GL343241.1",2044878,2052437,7559
"6907","ENSACAG00000008563","GL343568.1",413014,415146,2132
"6908","ENSACAG00000008564","GL344038.1",52434,78241,25807
"6909","ENSACAG00000008565","6",54765821,54795635,29814
"6910","ENSACAG00000008566","GL343209.1",3105146,3116245,11099
"6911","ENSACAG00000008567","4",136410959,136507090,96131
"6912","ENSACAG00000008569","1",232077871,232090391,12520
"6913","ENSACAG00000008570","GL343209.1",2897060,2974836,77776
"6914","ENSACAG00000008571","GL343269.1",935079,991388,56309
"6915","ENSACAG00000008572","GL343420.1",770020,782193,12173
"6916","ENSACAG00000008573","AAWZ02040563",2276,4308,2032
"6917","ENSACAG00000008574","GL343867.1",41533,50188,8655
"6918","ENSACAG00000008576","1",151626696,151658789,32093
"6919","ENSACAG00000008577","2",111609409,111627053,17644
"6920","ENSACAG00000008578","1",224542388,224554299,11911
"6921","ENSACAG00000008579","GL343340.1",451284,546516,95232
"6922","ENSACAG00000008580","2",148084298,148107079,22781
"6923","ENSACAG00000008581","6",15219125,15260492,41367
"6924","ENSACAG00000008582","GL344194.1",5842,9738,3896
"6925","ENSACAG00000008583","GL343340.1",399517,410617,11100
"6926","ENSACAG00000008584","GL343568.1",433554,435193,1639
"6927","ENSACAG00000008585","3",55377044,55641252,264208
"6928","ENSACAG00000008586","GL343241.1",2031442,2039813,8371
"6929","ENSACAG00000008587","GL343375.1",289488,329907,40419
"6930","ENSACAG00000008589","GL343832.1",81620,87257,5637
"6931","ENSACAG00000008590","3",55729466,55929656,200190
"6932","ENSACAG00000008591","2",195919842,195929549,9707
"6933","ENSACAG00000008592","GL343505.1",523320,563072,39752
"6934","ENSACAG00000008593","1",168188001,168230317,42316
"6935","ENSACAG00000008594","GL343501.1",316305,317708,1403
"6936","ENSACAG00000008595","GL343486.1",617367,646352,28985
"6937","ENSACAG00000008596","6",15289129,15419344,130215
"6938","ENSACAG00000008598","6",59145652,59172007,26355
"6939","ENSACAG00000008599","GL343196.1",2624790,2660279,35489
"6940","ENSACAG00000008600","GL344194.1",12465,43013,30548
"6941","ENSACAG00000008601","GL343505.1",502436,515277,12841
"6942","ENSACAG00000008602","GL343289.1",568803,1445397,876594
"6943","ENSACAG00000008603","AAWZ02041583",1100,3477,2377
"6944","ENSACAG00000008604","1",93415903,93436466,20563
"6945","ENSACAG00000008605","GL343832.1",42690,59142,16452
"6946","ENSACAG00000008606","GL343375.1",355521,398422,42901
"6947","ENSACAG00000008607","1",231870572,232074217,203645
"6948","ENSACAG00000008608","GL343626.1",93308,95281,1973
"6949","ENSACAG00000008609","GL343375.1",410831,426272,15441
"6950","ENSACAG00000008610","GL343618.1",270462,350953,80491
"6951","ENSACAG00000008611","1",63340042,63368194,28152
"6952","ENSACAG00000008612","GL343417.1",21,4851,4830
"6953","ENSACAG00000008613","GL343486.1",662809,666304,3495
"6954","ENSACAG00000008615","GL343832.1",8885,37047,28162
"6955","ENSACAG00000008616","GL343209.1",2745000,2841181,96181
"6956","ENSACAG00000008618","AAWZ02039894",1774,6281,4507
"6957","ENSACAG00000008619","GL344281.1",22178,49548,27370
"6958","ENSACAG00000008620","GL343867.1",59544,68200,8656
"6959","ENSACAG00000008621","GL343310.1",1054059,1055256,1197
"6960","ENSACAG00000008622","AAWZ02038790",1731,2327,596
"6961","ENSACAG00000008623","4",114939236,115019956,80720
"6962","ENSACAG00000008624","GL343661.1",266405,272451,6046
"6963","ENSACAG00000008625","1",10361788,10398034,36246
"6964","ENSACAG00000008627","AAWZ02036459",14990,22806,7816
"6965","ENSACAG00000008628","GL343340.1",385147,391071,5924
"6966","ENSACAG00000008629","2",86782841,86836622,53781
"6967","ENSACAG00000008631","GL343310.1",1056810,1061875,5065
"6968","ENSACAG00000008632","3",50445707,50488782,43075
"6969","ENSACAG00000008633","GL345001.1",223,13756,13533
"6970","ENSACAG00000008635","GL344408.1",2703,13080,10377
"6971","ENSACAG00000008636","GL343220.1",1002583,1014665,12082
"6972","ENSACAG00000008637","GL343310.1",1062943,1066391,3448
"6973","ENSACAG00000008638","2",149999901,150023240,23339
"6974","ENSACAG00000008639","4",39553339,39618391,65052
"6975","ENSACAG00000008640","2",155763814,155838804,74990
"6976","ENSACAG00000008641","GL343420.1",782258,838889,56631
"6977","ENSACAG00000008642","3",162474568,162574684,100116
"6978","ENSACAG00000008644","GL343334.1",672918,708986,36068
"6979","ENSACAG00000008646","2",196941050,196942198,1148
"6980","ENSACAG00000008649","2",94551837,94562526,10689
"6981","ENSACAG00000008650","2",27903393,27925752,22359
"6982","ENSACAG00000008651","2",191414205,191463572,49367
"6983","ENSACAG00000008652","GL343196.1",2582298,2592049,9751
"6984","ENSACAG00000008655","6",15427654,15444115,16461
"6985","ENSACAG00000008656","6",15452046,15533841,81795
"6986","ENSACAG00000008657","GL343451.1",276761,300326,23565
"6987","ENSACAG00000008658","GL343354.1",553247,590124,36877
"6988","ENSACAG00000008659","GL343417.1",8636,29177,20541
"6989","ENSACAG00000008660","GL343505.1",459421,469163,9742
"6990","ENSACAG00000008661","GL343862.1",74320,91999,17679
"6991","ENSACAG00000008662","1",151668906,151692366,23460
"6992","ENSACAG00000008664","2",197100183,197116141,15958
"6993","ENSACAG00000008665","1",10532100,10532778,678
"6994","ENSACAG00000008666","GL343196.1",2451149,2505885,54736
"6995","ENSACAG00000008667","1",10607295,10750118,142823
"6996","ENSACAG00000008668","GL343241.1",1991431,2016092,24661
"6997","ENSACAG00000008669","2",197122174,197140418,18244
"6998","ENSACAG00000008673","2",191386179,191406105,19926
"6999","ENSACAG00000008675","2",197473777,197498776,24999
"7000","ENSACAG00000008678","3",33679053,33686607,7554
"7001","ENSACAG00000008679","GL343334.1",322863,404811,81948
"7002","ENSACAG00000008680","3",33629439,33673706,44267
"7003","ENSACAG00000008682","2",197641990,197736896,94906
"7004","ENSACAG00000008683","GL343661.1",279017,281200,2183
"7005","ENSACAG00000008684","GL343661.1",290099,292055,1956
"7006","ENSACAG00000008686","GL343196.1",2375866,2414693,38827
"7007","ENSACAG00000008687","GL343340.1",364815,375725,10910
"7008","ENSACAG00000008688","GL344443.1",21,32014,31993
"7009","ENSACAG00000008690","GL344755.1",13434,21360,7926
"7010","ENSACAG00000008691","2",86877658,86918354,40696
"7011","ENSACAG00000008692","GL343221.1",1865523,1881296,15773
"7012","ENSACAG00000008693","2",149984340,149993090,8750
"7013","ENSACAG00000008694","4",14559762,14593157,33395
"7014","ENSACAG00000008695","6",59101180,59140123,38943
"7015","ENSACAG00000008697","4",136555671,136662287,106616
"7016","ENSACAG00000008698","2",14885587,14911381,25794
"7017","ENSACAG00000008700","GL343583.1",101357,134444,33087
"7018","ENSACAG00000008702","2",149919774,149928317,8543
"7019","ENSACAG00000008703","GL343862.1",16639,38667,22028
"7020","ENSACAG00000008704","AAWZ02036345",10260,14998,4738
"7021","ENSACAG00000008707","GL344332.1",9724,33157,23433
"7022","ENSACAG00000008708","GL343209.1",2593160,2629247,36087
"7023","ENSACAG00000008709","GL343196.1",2267250,2374741,107491
"7024","ENSACAG00000008710","6",54897246,54925148,27902
"7025","ENSACAG00000008711","GL343867.1",70080,123318,53238
"7026","ENSACAG00000008712","4",115022801,115033281,10480
"7027","ENSACAG00000008713","GL344836.1",1378,18441,17063
"7028","ENSACAG00000008715","5",105631597,106049384,417787
"7029","ENSACAG00000008717","6",15956689,15960300,3611
"7030","ENSACAG00000008719","GL343258.1",704764,731268,26504
"7031","ENSACAG00000008720","GL343220.1",861914,903981,42067
"7032","ENSACAG00000008721","GL344141.1",3099,25240,22141
"7033","ENSACAG00000008722","6",16028888,16088746,59858
"7034","ENSACAG00000008723","2",148600633,148655010,54377
"7035","ENSACAG00000008725","AAWZ02040267",1262,6371,5109
"7036","ENSACAG00000008726","GL344332.1",112,9000,8888
"7037","ENSACAG00000008727","AAWZ02038357",8021,10526,2505
"7038","ENSACAG00000008728","1",93468360,93510336,41976
"7039","ENSACAG00000008729","4",39652763,39674253,21490
"7040","ENSACAG00000008730","GL343340.1",341042,361807,20765
"7041","ENSACAG00000008732","GL343641.1",57495,139618,82123
"7042","ENSACAG00000008733","3",50407686,50444525,36839
"7043","ENSACAG00000008734","2",28469915,28547520,77605
"7044","ENSACAG00000008735","2",149872157,149873095,938
"7045","ENSACAG00000008736","GL344078.1",2271,11353,9082
"7046","ENSACAG00000008737","GL343241.1",1870618,1977874,107256
"7047","ENSACAG00000008739","GL343213.1",26574,98535,71961
"7048","ENSACAG00000008740","3",50344342,50402950,58608
"7049","ENSACAG00000008741","GL344078.1",15346,21021,5675
"7050","ENSACAG00000008742","4",40247977,40272573,24596
"7051","ENSACAG00000008743","GL343505.1",445271,448730,3459
"7052","ENSACAG00000008744","2",149861725,149866002,4277
"7053","ENSACAG00000008745","GL343340.1",259146,300094,40948
"7054","ENSACAG00000008746","4",115035359,115046181,10822
"7055","ENSACAG00000008747","GL343505.1",422739,435278,12539
"7056","ENSACAG00000008748","GL343451.1",302855,303847,992
"7057","ENSACAG00000008749","GL343451.1",308653,321101,12448
"7058","ENSACAG00000008750","1",10835153,10891364,56211
"7059","ENSACAG00000008752","AAWZ02039506",2740,8425,5685
"7060","ENSACAG00000008753","4",14440731,14445970,5239
"7061","ENSACAG00000008754","GL343554.1",25173,52965,27792
"7062","ENSACAG00000008755","GL343779.1",45963,137682,91719
"7063","ENSACAG00000008756","GL343213.1",111309,125217,13908
"7064","ENSACAG00000008758","2",149823577,149848202,24625
"7065","ENSACAG00000008759","4",14254642,14344506,89864
"7066","ENSACAG00000008760","1",63435458,63479138,43680
"7067","ENSACAG00000008761","4",136781529,136793423,11894
"7068","ENSACAG00000008763","AAWZ02038494",1421,3733,2312
"7069","ENSACAG00000008765","3",141145317,141206848,61531
"7070","ENSACAG00000008766","4",40271650,40321843,50193
"7071","ENSACAG00000008768","GL343354.1",422378,460712,38334
"7072","ENSACAG00000008769","AAWZ02038765",129,10444,10315
"7073","ENSACAG00000008770","GL344422.1",5362,18493,13131
"7074","ENSACAG00000008771","GL343862.1",1552,9064,7512
"7075","ENSACAG00000008772","2",8617723,8721584,103861
"7076","ENSACAG00000008773","6",16137833,16206911,69078
"7077","ENSACAG00000008774","6",54968388,55022018,53630
"7078","ENSACAG00000008776","2",94569239,94588451,19212
"7079","ENSACAG00000008777","GL343258.1",339414,343587,4173
"7080","ENSACAG00000008778","4",115050211,115054192,3981
"7081","ENSACAG00000008779","4",115063613,115297371,233758
"7082","ENSACAG00000008780","LGc",5521569,5529762,8193
"7083","ENSACAG00000008781","1",10897097,10915816,18719
"7084","ENSACAG00000008782","AAWZ02038618",9559,9669,110
"7085","ENSACAG00000008783","LGc",5594613,5645096,50483
"7086","ENSACAG00000008785","GL343902.1",9311,84230,74919
"7087","ENSACAG00000008786","GL343220.1",852503,857458,4955
"7088","ENSACAG00000008787","1",63491401,63505439,14038
"7089","ENSACAG00000008788","GL343417.1",30352,31182,830
"7090","ENSACAG00000008789","4",98331422,98356417,24995
"7091","ENSACAG00000008791","GL343864.1",50857,117579,66722
"7092","ENSACAG00000008792","AAWZ02037236",2089,2610,521
"7093","ENSACAG00000008793","GL343779.1",66135,80351,14216
"7094","ENSACAG00000008796","GL343213.1",130231,144688,14457
"7095","ENSACAG00000008797","1",63517547,63525635,8088
"7096","ENSACAG00000008798","GL344141.1",30135,54188,24053
"7097","ENSACAG00000008799","GL344222.1",30621,55038,24417
"7098","ENSACAG00000008800","GL343626.1",294595,296194,1599
"7099","ENSACAG00000008801","GL343209.1",2365639,2393629,27990
"7100","ENSACAG00000008802","4",136880298,136887817,7519
"7101","ENSACAG00000008803","GL343417.1",29555,37782,8227
"7102","ENSACAG00000008804","2",94628411,94660957,32546
"7103","ENSACAG00000008807","6",55027608,55101344,73736
"7104","ENSACAG00000008808","GL343220.1",787369,832107,44738
"7105","ENSACAG00000008809","GL343902.1",84646,124007,39361
"7106","ENSACAG00000008810","1",236167345,236227328,59983
"7107","ENSACAG00000008811","AAWZ02039190",6779,7060,281
"7108","ENSACAG00000008812","GL343213.1",148307,158159,9852
"7109","ENSACAG00000008814","1",151705719,151770639,64920
"7110","ENSACAG00000008815","GL343340.1",209013,250732,41719
"7111","ENSACAG00000008816","GL344536.1",2709,3710,1001
"7112","ENSACAG00000008817","AAWZ02035675",9713,15543,5830
"7113","ENSACAG00000008818","4",136894621,136914334,19713
"7114","ENSACAG00000008819","GL343451.1",321419,327064,5645
"7115","ENSACAG00000008821","2",94667792,94675342,7550
"7116","ENSACAG00000008823","GL343505.1",359386,396188,36802
"7117","ENSACAG00000008824","GL343213.1",321304,330825,9521
"7118","ENSACAG00000008826","AAWZ02037026",1522,19719,18197
"7119","ENSACAG00000008827","GL343828.1",107252,120183,12931
"7120","ENSACAG00000008829","GL343417.1",36616,41958,5342
"7121","ENSACAG00000008830","3",141020365,141143345,122980
"7122","ENSACAG00000008831","4",98239471,98300791,61320
"7123","ENSACAG00000008832","1",10928309,10928701,392
"7124","ENSACAG00000008833","5",105570790,105601013,30223
"7125","ENSACAG00000008834","1",10957020,11114968,157948
"7126","ENSACAG00000008835","GL344689.1",16378,22433,6055
"7127","ENSACAG00000008836","1",93594217,93627357,33140
"7128","ENSACAG00000008837","GL343196.1",2055039,2239339,184300
"7129","ENSACAG00000008838","AAWZ02035960",18307,32521,14214
"7130","ENSACAG00000008839","GL344689.1",1719,10588,8869
"7131","ENSACAG00000008840","GL343354.1",307252,318507,11255
"7132","ENSACAG00000008841","GL343420.1",843947,846255,2308
"7133","ENSACAG00000008842","2",149767493,149806532,39039
"7134","ENSACAG00000008843","3",50326988,50341902,14914
"7135","ENSACAG00000008844","1",63536981,63583088,46107
"7136","ENSACAG00000008845","5",105434178,105457927,23749
"7137","ENSACAG00000008846","GL343380.1",684697,691802,7105
"7138","ENSACAG00000008848","GL343864.1",4870,48030,43160
"7139","ENSACAG00000008849","GL343451.1",331337,337886,6549
"7140","ENSACAG00000008850","AAWZ02034579",7156,77277,70121
"7141","ENSACAG00000008852","GL343380.1",698381,729395,31014
"7142","ENSACAG00000008853","GL343213.1",338618,371877,33259
"7143","ENSACAG00000008854","GL343245.1",631503,639595,8092
"7144","ENSACAG00000008855","LGc",5660948,5663403,2455
"7145","ENSACAG00000008856","GL343451.1",340986,346993,6007
"7146","ENSACAG00000008857","GL343418.1",378766,454420,75654
"7147","ENSACAG00000008858","4",14161827,14238527,76700
"7148","ENSACAG00000008859","LGc",5665462,5677898,12436
"7149","ENSACAG00000008861","3",140997206,141003486,6280
"7150","ENSACAG00000008862","GL343340.1",68338,69612,1274
"7151","ENSACAG00000008863","GL343213.1",524011,985687,461676
"7152","ENSACAG00000008865","AAWZ02040047",2690,5715,3025
"7153","ENSACAG00000008867","GL343451.1",347489,361647,14158
"7154","ENSACAG00000008868","3",140949760,140958113,8353
"7155","ENSACAG00000008869","1",231725767,231817806,92039
"7156","ENSACAG00000008871","2",8819653,8819868,215
"7157","ENSACAG00000008872","GL343650.1",223955,243708,19753
"7158","ENSACAG00000008874","GL343340.1",41712,52758,11046
"7159","ENSACAG00000008878","GL343269.1",1045853,1095419,49566
"7160","ENSACAG00000008879","2",8823308,8870862,47554
"7161","ENSACAG00000008880","5",64624632,64626040,1408
"7162","ENSACAG00000008881","3",98895605,98929991,34386
"7163","ENSACAG00000008882","4",42710737,42735190,24453
"7164","ENSACAG00000008883","1",11127559,11153033,25474
"7165","ENSACAG00000008884","GL344073.1",18368,48211,29843
"7166","ENSACAG00000008885","LGc",5681509,5687968,6459
"7167","ENSACAG00000008887","AAWZ02038456",8620,10165,1545
"7168","ENSACAG00000008890","1",11220692,11245407,24715
"7169","ENSACAG00000008891","4",136918313,136933965,15652
"7170","ENSACAG00000008892","GL343209.1",1199661,1229185,29524
"7171","ENSACAG00000008894","2",148660840,148682972,22132
"7172","ENSACAG00000008895","GL343245.1",640997,721112,80115
"7173","ENSACAG00000008896","5",105374733,105434594,59861
"7174","ENSACAG00000008897","4",115470473,115471396,923
"7175","ENSACAG00000008898","1",151781701,151787309,5608
"7176","ENSACAG00000008899","2",8871115,8887625,16510
"7177","ENSACAG00000008901","GL343241.1",1702929,1757044,54115
"7178","ENSACAG00000008905","LGc",5730228,5742580,12352
"7179","ENSACAG00000008906","GL343241.1",1619291,1651310,32019
"7180","ENSACAG00000008907","GL343243.1",157682,159046,1364
"7181","ENSACAG00000008908","GL344382.1",30248,34812,4564
"7182","ENSACAG00000008909","GL343658.1",216562,218715,2153
"7183","ENSACAG00000008910","4",115519993,115665673,145680
"7184","ENSACAG00000008911","AAWZ02038767",844,1299,455
"7185","ENSACAG00000008913","4",14010501,14028404,17903
"7186","ENSACAG00000008914","6",59045791,59095089,49298
"7187","ENSACAG00000008917","6",55104037,55169600,65563
"7188","ENSACAG00000008920","GL343543.1",660,14337,13677
"7189","ENSACAG00000008921","GL343496.1",525586,537301,11715
"7190","ENSACAG00000008922","AAWZ02036528",637,19026,18389
"7191","ENSACAG00000008923","2",155879949,155915544,35595
"7192","ENSACAG00000008924","AAWZ02038767",5014,8844,3830
"7193","ENSACAG00000008925","AAWZ02038146",789,12830,12041
"7194","ENSACAG00000008926","GL343357.1",682188,771153,88965
"7195","ENSACAG00000008928","GL343828.1",128883,152327,23444
"7196","ENSACAG00000008929","GL343650.1",252153,268774,16621
"7197","ENSACAG00000008930","GL343196.1",2041961,2050453,8492
"7198","ENSACAG00000008931","GL343650.1",277458,291313,13855
"7199","ENSACAG00000008932","GL344890.1",1337,21507,20170
"7200","ENSACAG00000008933","2",14957892,14966835,8943
"7201","ENSACAG00000008934","AAWZ02038163",168,10400,10232
"7202","ENSACAG00000008935","GL343196.1",1936220,2038227,102007
"7203","ENSACAG00000008936","2",155923062,155923799,737
"7204","ENSACAG00000008937","GL344202.1",3371,50075,46704
"7205","ENSACAG00000008938","GL344338.1",15371,36421,21050
"7206","ENSACAG00000008939","GL343380.1",735894,789560,53666
"7207","ENSACAG00000008940","2",94694702,94811311,116609
"7208","ENSACAG00000008941","4",137636396,137638478,2082
"7209","ENSACAG00000008942","2",15038153,15039517,1364
"7210","ENSACAG00000008943","GL344023.1",16794,44469,27675
"7211","ENSACAG00000008944","6",16249202,16304091,54889
"7212","ENSACAG00000008945","AAWZ02040726",1639,6496,4857
"7213","ENSACAG00000008947","2",155927561,155954229,26668
"7214","ENSACAG00000008948","1",93645197,93676840,31643
"7215","ENSACAG00000008949","GL344367.1",8520,11306,2786
"7216","ENSACAG00000008950","GL343618.1",283811,326514,42703
"7217","ENSACAG00000008951","4",115814024,115841806,27782
"7218","ENSACAG00000008952","2",15085981,15115461,29480
"7219","ENSACAG00000008953","GL343650.1",342586,353826,11240
"7220","ENSACAG00000008954","GL343455.1",592230,641495,49265
"7221","ENSACAG00000008955","LGc",5744709,5791782,47073
"7222","ENSACAG00000008956","4",115840980,115854369,13389
"7223","ENSACAG00000008957","GL343543.1",78532,97063,18531
"7224","ENSACAG00000008958","1",248598424,248757216,158792
"7225","ENSACAG00000008960","GL343543.1",112236,112895,659
"7226","ENSACAG00000008961","GL343543.1",146731,148032,1301
"7227","ENSACAG00000008962","GL344367.1",29442,41888,12446
"7228","ENSACAG00000008963","GL343543.1",186580,194510,7930
"7229","ENSACAG00000008965","GL343496.1",539129,579289,40160
"7230","ENSACAG00000008966","GL343354.1",288636,338143,49507
"7231","ENSACAG00000008967","GL344488.1",802,16059,15257
"7232","ENSACAG00000008968","2",149568679,149591774,23095
"7233","ENSACAG00000008969","2",15114798,15127059,12261
"7234","ENSACAG00000008970","GL343650.1",353075,386671,33596
"7235","ENSACAG00000008971","GL343618.1",238327,258939,20612
"7236","ENSACAG00000008972","GL343277.1",620434,626545,6111
"7237","ENSACAG00000008973","2",87014719,87044271,29552
"7238","ENSACAG00000008974","GL343953.1",66189,95496,29307
"7239","ENSACAG00000008976","GL343245.1",767337,789124,21787
"7240","ENSACAG00000008979","GL343349.1",203383,446115,242732
"7241","ENSACAG00000008980","GL343282.1",780,16217,15437
"7242","ENSACAG00000008981","GL343543.1",214250,222007,7757
"7243","ENSACAG00000008982","5",105341137,105357016,15879
"7244","ENSACAG00000008983","4",137790059,137863510,73451
"7245","ENSACAG00000008984","1",118289679,118331307,41628
"7246","ENSACAG00000008987","1",11264148,11285360,21212
"7247","ENSACAG00000008988","6",55233036,55270157,37121
"7248","ENSACAG00000008989","GL343241.1",1595150,1604797,9647
"7249","ENSACAG00000008991","2",28571441,28601562,30121
"7250","ENSACAG00000008992","4",98227286,98235907,8621
"7251","ENSACAG00000008993","2",48833458,48991879,158421
"7252","ENSACAG00000008995","4",13958200,14010086,51886
"7253","ENSACAG00000008996","2",8937557,9004723,67166
"7254","ENSACAG00000008997","4",98101983,98131298,29315
"7255","ENSACAG00000008998","3",164221230,164356525,135295
"7256","ENSACAG00000008999","GL343245.1",847341,865347,18006
"7257","ENSACAG00000009000","2",9013733,9040247,26514
"7258","ENSACAG00000009001","GL343868.1",10574,14329,3755
"7259","ENSACAG00000009002","GL343269.1",1098198,1108048,9850
"7260","ENSACAG00000009003","6",58977618,59017286,39668
"7261","ENSACAG00000009005","1",63667169,63999029,331860
"7262","ENSACAG00000009007","1",231434176,231648255,214079
"7263","ENSACAG00000009008","1",93704194,93733692,29498
"7264","ENSACAG00000009009","GL343417.1",53873,60992,7119
"7265","ENSACAG00000009010","GL344092.1",55759,69276,13517
"7266","ENSACAG00000009011","2",15126931,15150910,23979
"7267","ENSACAG00000009013","GL343418.1",535130,540485,5355
"7268","ENSACAG00000009014","GL344881.1",2639,16092,13453
"7269","ENSACAG00000009015","GL343340.1",12381,26345,13964
"7270","ENSACAG00000009016","GL344103.1",17270,87780,70510
"7271","ENSACAG00000009018","GL343277.1",235162,255882,20720
"7272","ENSACAG00000009019","GL343543.1",251944,277243,25299
"7273","ENSACAG00000009021","GL343349.1",523292,553557,30265
"7274","ENSACAG00000009022","GL343269.1",1151324,1225157,73833
"7275","ENSACAG00000009024","GL343451.1",363697,378696,14999
"7276","ENSACAG00000009025","6",58947871,58977097,29226
"7277","ENSACAG00000009027","AAWZ02037107",12596,15803,3207
"7278","ENSACAG00000009029","GL344266.1",15020,57772,42752
"7279","ENSACAG00000009030","AAWZ02036852",1170,12766,11596
"7280","ENSACAG00000009032","1",148460397,148466448,6051
"7281","ENSACAG00000009033","GL343530.1",318510,465139,146629
"7282","ENSACAG00000009034","2",156015859,156059081,43222
"7283","ENSACAG00000009038","3",33612803,33622411,9608
"7284","ENSACAG00000009039","AAWZ02038152",116,12310,12194
"7285","ENSACAG00000009040","GL343953.1",29227,47847,18620
"7286","ENSACAG00000009041","4",137866678,137890942,24264
"7287","ENSACAG00000009042","2",28679735,28854064,174329
"7288","ENSACAG00000009043","GL343701.1",1897,23970,22073
"7289","ENSACAG00000009044","GL343269.1",1276114,1386370,110256
"7290","ENSACAG00000009045","3",33600771,33613311,12540
"7291","ENSACAG00000009046","GL343196.1",1862161,1883022,20861
"7292","ENSACAG00000009047","GL344899.1",4016,16582,12566
"7293","ENSACAG00000009050","GL343220.1",785052,788514,3462
"7294","ENSACAG00000009051","GL343241.1",1568155,1590250,22095
"7295","ENSACAG00000009052","6",16354011,16360427,6416
"7296","ENSACAG00000009053","1",151855291,151860151,4860
"7297","ENSACAG00000009054","6",16471164,16561492,90328
"7298","ENSACAG00000009055","LGc",5809537,5835833,26296
"7299","ENSACAG00000009057","1",93752461,93765926,13465
"7300","ENSACAG00000009058","GL343701.1",42267,45004,2737
"7301","ENSACAG00000009059","6",55622256,55625478,3222
"7302","ENSACAG00000009060","GL343701.1",53195,67246,14051
"7303","ENSACAG00000009061","GL343196.1",1538320,1739726,201406
"7304","ENSACAG00000009062","6",55626830,55631389,4559
"7305","ENSACAG00000009064","GL343451.1",410954,422466,11512
"7306","ENSACAG00000009065","GL343340.1",5456,8110,2654
"7307","ENSACAG00000009067","GL343354.1",282206,284445,2239
"7308","ENSACAG00000009068","1",93839104,93917797,78693
"7309","ENSACAG00000009069","GL343206.1",2745887,3569148,823261
"7310","ENSACAG00000009070","GL344665.1",1509,25099,23590
"7311","ENSACAG00000009071","1",151919229,151953742,34513
"7312","ENSACAG00000009072","3",98943234,99171613,228379
"7313","ENSACAG00000009074","2",94821606,94845923,24317
"7314","ENSACAG00000009075","AAWZ02037909",7553,8839,1286
"7315","ENSACAG00000009076","GL343618.1",206498,225361,18863
"7316","ENSACAG00000009077","GL343220.1",777892,784603,6711
"7317","ENSACAG00000009078","4",42663725,42664501,776
"7318","ENSACAG00000009079","6",58912473,58940401,27928
"7319","ENSACAG00000009081","2",9331294,9331716,422
"7320","ENSACAG00000009082","AAWZ02037823",6168,8108,1940
"7321","ENSACAG00000009083","3",140899034,140932805,33771
"7322","ENSACAG00000009084","6",55678156,55692881,14725
"7323","ENSACAG00000009086","GL343277.1",211891,232576,20685
"7324","ENSACAG00000009087","2",156062409,156286636,224227
"7325","ENSACAG00000009088","2",9592183,9852488,260305
"7326","ENSACAG00000009089","GL343340.1",713,2910,2197
"7327","ENSACAG00000009090","3",140822926,140900385,77459
"7328","ENSACAG00000009091","GL343282.1",19269,33915,14646
"7329","ENSACAG00000009092","GL343354.1",235562,260196,24634
"7330","ENSACAG00000009093","2",156115417,156143897,28480
"7331","ENSACAG00000009094","GL344027.1",41192,44476,3284
"7332","ENSACAG00000009095","5",105307390,105335455,28065
"7333","ENSACAG00000009097","6",55739974,55809477,69503
"7334","ENSACAG00000009098","AAWZ02041380",2101,4518,2417
"7335","ENSACAG00000009099","GL344498.1",935,25604,24669
"7336","ENSACAG00000009100","6",16561580,16710014,148434
"7337","ENSACAG00000009103","3",33582310,33592868,10558
"7338","ENSACAG00000009104","GL343349.1",558070,576698,18628
"7339","ENSACAG00000009105","GL343220.1",751412,765283,13871
"7340","ENSACAG00000009106","GL343198.1",204352,320796,116444
"7341","ENSACAG00000009107","GL343241.1",1551654,1563808,12154
"7342","ENSACAG00000009108","2",149274869,149553385,278516
"7343","ENSACAG00000009109","GL344139.1",3877,49044,45167
"7344","ENSACAG00000009112","GL343562.1",5566,19168,13602
"7345","ENSACAG00000009113","4",138039671,138085035,45364
"7346","ENSACAG00000009114","GL343198.1",325709,347938,22229
"7347","ENSACAG00000009115","1",152033217,152101931,68714
"7348","ENSACAG00000009116","3",140718560,140857690,139130
"7349","ENSACAG00000009117","GL343417.1",60084,68279,8195
"7350","ENSACAG00000009118","GL343198.1",406299,407015,716
"7351","ENSACAG00000009119","LGc",5843841,5869432,25591
"7352","ENSACAG00000009120","1",248535133,248589714,54581
"7353","ENSACAG00000009121","GL343213.1",1436858,1458601,21743
"7354","ENSACAG00000009122","5",105290145,105301953,11808
"7355","ENSACAG00000009123","GL343198.1",584797,590356,5559
"7356","ENSACAG00000009124","GL343198.1",597987,621886,23899
"7357","ENSACAG00000009125","GL343519.1",94185,105647,11462
"7358","ENSACAG00000009126","2",156164035,156184692,20657
"7359","ENSACAG00000009127","GL343417.1",70279,86314,16035
"7360","ENSACAG00000009128","GL343418.1",540018,545460,5442
"7361","ENSACAG00000009129","3",33565289,33570151,4862
"7362","ENSACAG00000009130","2",94890180,94906645,16465
"7363","ENSACAG00000009131","GL344027.1",35241,39997,4756
"7364","ENSACAG00000009132","3",33246256,33246983,727
"7365","ENSACAG00000009133","GL343277.1",200738,204250,3512
"7366","ENSACAG00000009135","GL343220.1",729546,734108,4562
"7367","ENSACAG00000009136","GL343277.1",125082,164651,39569
"7368","ENSACAG00000009137","5",105039647,105094250,54603
"7369","ENSACAG00000009138","GL343530.1",275740,302401,26661
"7370","ENSACAG00000009139","GL343451.1",428100,434999,6899
"7371","ENSACAG00000009140","2",28996709,29017143,20434
"7372","ENSACAG00000009141","1",11297491,11353290,55799
"7373","ENSACAG00000009142","4",124217125,124255451,38326
"7374","ENSACAG00000009143","GL343701.1",70245,74813,4568
"7375","ENSACAG00000009144","GL343418.1",557904,594761,36857
"7376","ENSACAG00000009145","GL343424.1",642518,643291,773
"7377","ENSACAG00000009146","2",148689899,148811953,122054
"7378","ENSACAG00000009147","2",15151287,15176761,25474
"7379","ENSACAG00000009148","GL343349.1",578851,612235,33384
"7380","ENSACAG00000009149","LGc",6002761,6037675,34914
"7381","ENSACAG00000009150","AAWZ02039955",3072,7005,3933
"7382","ENSACAG00000009151","4",42613174,42637070,23896
"7383","ENSACAG00000009152","GL345126.1",1509,8192,6683
"7384","ENSACAG00000009153","2",149229017,149246231,17214
"7385","ENSACAG00000009154","GL343701.1",77665,85256,7591
"7386","ENSACAG00000009157","5",94324840,94573422,248582
"7387","ENSACAG00000009158","GL343701.1",136559,160851,24292
"7388","ENSACAG00000009159","GL343530.1",7110,146192,139082
"7389","ENSACAG00000009160","5",81613396,81763457,150061
"7390","ENSACAG00000009161","AAWZ02037515",2344,15485,13141
"7391","ENSACAG00000009162","GL344815.1",308,15707,15399
"7392","ENSACAG00000009163","3",33101028,33110958,9930
"7393","ENSACAG00000009164","GL343241.1",1521612,1546583,24971
"7394","ENSACAG00000009165","GL343618.1",194891,201697,6806
"7395","ENSACAG00000009166","2",156204671,156222543,17872
"7396","ENSACAG00000009167","GL343701.1",166589,187761,21172
"7397","ENSACAG00000009168","3",140658588,140678260,19672
"7398","ENSACAG00000009169","GL343213.1",1474292,1684611,210319
"7399","ENSACAG00000009170","2",156236502,156257262,20760
"7400","ENSACAG00000009171","2",29028413,29041032,12619
"7401","ENSACAG00000009172","GL343215.1",2427255,2437270,10015
"7402","ENSACAG00000009173","6",58874172,58911017,36845
"7403","ENSACAG00000009174","GL343618.1",177099,191446,14347
"7404","ENSACAG00000009175","GL343215.1",2269500,2317754,48254
"7405","ENSACAG00000009176","4",13907726,13917938,10212
"7406","ENSACAG00000009177","4",13891911,13896454,4543
"7407","ENSACAG00000009178","2",87080879,87101837,20958
"7408","ENSACAG00000009179","3",164154300,164173015,18715
"7409","ENSACAG00000009180","6",45947439,45947969,530
"7410","ENSACAG00000009181","6",45726927,45940161,213234
"7411","ENSACAG00000009182","3",164072678,164112095,39417
"7412","ENSACAG00000009183","GL343701.1",242141,251340,9199
"7413","ENSACAG00000009184","1",11398121,11433810,35689
"7414","ENSACAG00000009185","GL343463.1",77,8314,8237
"7415","ENSACAG00000009187","5",105000072,105039105,39033
"7416","ENSACAG00000009188","3",185864344,185941774,77430
"7417","ENSACAG00000009189","GL344027.1",4609,18806,14197
"7418","ENSACAG00000009190","2",87148632,87161456,12824
"7419","ENSACAG00000009191","3",33041740,33077913,36173
"7420","ENSACAG00000009192","3",140302996,140304129,1133
"7421","ENSACAG00000009193","GL343198.1",638917,649124,10207
"7422","ENSACAG00000009195","6",55820487,55853282,32795
"7423","ENSACAG00000009196","1",72416633,72464090,47457
"7424","ENSACAG00000009197","GL343451.1",438918,459210,20292
"7425","ENSACAG00000009199","3",140169440,140264337,94897
"7426","ENSACAG00000009200","LGc",6047640,6104245,56605
"7427","ENSACAG00000009201","2",156289733,156312851,23118
"7428","ENSACAG00000009204","1",71248499,71497130,248631
"7429","ENSACAG00000009205","2",185945692,186211580,265888
"7430","ENSACAG00000009207","4",13827205,13859491,32286
"7431","ENSACAG00000009208","GL343440.1",798097,827033,28936
"7432","ENSACAG00000009209","AAWZ02039867",21,7738,7717
"7433","ENSACAG00000009210","2",87175151,87350273,175122
"7434","ENSACAG00000009211","1",152076897,152081639,4742
"7435","ENSACAG00000009212","2",156384735,156498568,113833
"7436","ENSACAG00000009213","1",64098628,64137624,38996
"7437","ENSACAG00000009214","GL343354.1",177825,190433,12608
"7438","ENSACAG00000009215","GL343562.1",18470,62253,43783
"7439","ENSACAG00000009216","GL343198.1",658779,676108,17329
"7440","ENSACAG00000009217","2",29041806,29048114,6308
"7441","ENSACAG00000009218","6",58867960,58871990,4030
"7442","ENSACAG00000009219","6",16717694,16720269,2575
"7443","ENSACAG00000009220","GL343277.1",65272,67744,2472
"7444","ENSACAG00000009221","GL343377.1",639649,697219,57570
"7445","ENSACAG00000009222","4",138101190,138167461,66271
"7446","ENSACAG00000009223","2",94974620,95001618,26998
"7447","ENSACAG00000009224","GL343451.1",465193,509525,44332
"7448","ENSACAG00000009226","6",58845830,58851229,5399
"7449","ENSACAG00000009228","1",248474139,248491764,17625
"7450","ENSACAG00000009229","GL343562.1",101446,125149,23703
"7451","ENSACAG00000009230","GL343220.1",653220,697542,44322
"7452","ENSACAG00000009232","2",29078476,29122324,43848
"7453","ENSACAG00000009233","GL343241.1",1491813,1505912,14099
"7454","ENSACAG00000009235","6",16858004,16926315,68311
"7455","ENSACAG00000009236","AAWZ02038227",4104,7307,3203
"7456","ENSACAG00000009238","6",58752966,58788600,35634
"7457","ENSACAG00000009241","3",31663931,32101219,437288
"7458","ENSACAG00000009242","3",164055169,164070151,14982
"7459","ENSACAG00000009243","GL343266.1",278955,292123,13168
"7460","ENSACAG00000009245","1",11624081,11639973,15892
"7461","ENSACAG00000009246","4",42503243,42590914,87671
"7462","ENSACAG00000009247","2",149164376,149226522,62146
"7463","ENSACAG00000009248","GL343198.1",683283,691699,8416
"7464","ENSACAG00000009250","6",55866411,56023235,156824
"7465","ENSACAG00000009251","2",89264771,89274104,9333
"7466","ENSACAG00000009253","GL343241.1",1296315,1364237,67922
"7467","ENSACAG00000009255","GL343269.1",1398100,1428053,29953
"7468","ENSACAG00000009256","GL343215.1",2226923,2264312,37389
"7469","ENSACAG00000009257","GL343380.1",790801,902499,111698
"7470","ENSACAG00000009258","GL343266.1",322958,367707,44749
"7471","ENSACAG00000009259","GL343349.1",620232,671553,51321
"7472","ENSACAG00000009260","1",64142847,64158598,15751
"7473","ENSACAG00000009261","6",45417136,45674907,257771
"7474","ENSACAG00000009262","GL343432.1",114427,178236,63809
"7475","ENSACAG00000009263","1",71126131,71259959,133828
"7476","ENSACAG00000009264","1",248317000,248354687,37687
"7477","ENSACAG00000009265","AAWZ02037285",9111,10280,1169
"7478","ENSACAG00000009267","GL343432.1",225922,249641,23719
"7479","ENSACAG00000009268","GL343436.1",246053,391276,145223
"7480","ENSACAG00000009269","3",140000013,140023723,23710
"7481","ENSACAG00000009270","4",124269525,124283302,13777
"7482","ENSACAG00000009271","GL343269.1",1427469,1464091,36622
"7483","ENSACAG00000009272","3",164026224,164042749,16525
"7484","ENSACAG00000009273","4",13777679,13805823,28144
"7485","ENSACAG00000009274","GL343417.1",83832,92901,9069
"7486","ENSACAG00000009276","GL343215.1",2186380,2210989,24609
"7487","ENSACAG00000009278","3",185774620,185852770,78150
"7488","ENSACAG00000009279","GL343198.1",700258,729171,28913
"7489","ENSACAG00000009280","5",81509242,81569258,60016
"7490","ENSACAG00000009282","GL343206.1",3674344,3727762,53418
"7491","ENSACAG00000009283","GL343418.1",598118,623334,25216
"7492","ENSACAG00000009284","5",81412340,81490293,77953
"7493","ENSACAG00000009285","GL343436.1",550470,587018,36548
"7494","ENSACAG00000009286","1",70995116,71067675,72559
"7495","ENSACAG00000009287","2",9922132,9997594,75462
"7496","ENSACAG00000009289","GL343269.1",1468143,1510773,42630
"7497","ENSACAG00000009290","6",45311947,45328042,16095
"7498","ENSACAG00000009292","AAWZ02040966",725,2425,1700
"7499","ENSACAG00000009293","AAWZ02038275",6,12260,12254
"7500","ENSACAG00000009295","GL344539.1",28836,32313,3477
"7501","ENSACAG00000009296","GL343282.1",37793,62633,24840
"7502","ENSACAG00000009297","2",15235708,15237477,1769
"7503","ENSACAG00000009298","GL343417.1",98659,110655,11996
"7504","ENSACAG00000009301","1",228758965,229100355,341390
"7505","ENSACAG00000009302","GL344641.1",1033,26588,25555
"7506","ENSACAG00000009303","GL343266.1",376161,821359,445198
"7507","ENSACAG00000009304","6",58696591,58717281,20690
"7508","ENSACAG00000009305","2",15680921,15839990,159069
"7509","ENSACAG00000009306","1",72326061,72343344,17283
"7510","ENSACAG00000009308","4",124287054,124340136,53082
"7511","ENSACAG00000009309","GL343206.1",3769985,3818669,48684
"7512","ENSACAG00000009310","AAWZ02039086",4730,9532,4802
"7513","ENSACAG00000009311","AAWZ02036837",52,21968,21916
"7514","ENSACAG00000009312","GL343241.1",1064207,1169539,105332
"7515","ENSACAG00000009314","GL344386.1",1643,31217,29574
"7516","ENSACAG00000009315","5",104831427,104841082,9655
"7517","ENSACAG00000009316","AAWZ02036728",249,19192,18943
"7518","ENSACAG00000009318","AAWZ02037394",164,14027,13863
"7519","ENSACAG00000009319","2",95003068,95011458,8390
"7520","ENSACAG00000009320","GL343637.1",84596,95869,11273
"7521","ENSACAG00000009321","AAWZ02039011",677,9420,8743
"7522","ENSACAG00000009322","GL343383.1",953196,994484,41288
"7523","ENSACAG00000009323","GL343618.1",171121,177721,6600
"7524","ENSACAG00000009324","6",56050049,56072977,22928
"7525","ENSACAG00000009325","GL344989.1",768,12781,12013
"7526","ENSACAG00000009326","GL343215.1",2042832,2079174,36342
"7527","ENSACAG00000009328","6",17061745,17277295,215550
"7528","ENSACAG00000009329","3",163953859,164003640,49781
"7529","ENSACAG00000009330","GL344272.1",2482,32785,30303
"7530","ENSACAG00000009332","GL343432.1",254266,288658,34392
"7531","ENSACAG00000009333","GL343618.1",132672,165850,33178
"7532","ENSACAG00000009334","2",10098977,10110660,11683
"7533","ENSACAG00000009335","5",104767119,104794656,27537
"7534","ENSACAG00000009336","GL343867.1",157196,161799,4603
"7535","ENSACAG00000009337","2",89290922,89294528,3606
"7536","ENSACAG00000009338","1",64167261,64186932,19671
"7537","ENSACAG00000009339","GL343780.1",714,806,92
"7538","ENSACAG00000009340","GL343196.1",1421790,1502256,80466
"7539","ENSACAG00000009341","GL343780.1",23000,57140,34140
"7540","ENSACAG00000009342","6",45372794,45415091,42297
"7541","ENSACAG00000009343","GL343867.1",165334,182318,16984
"7542","ENSACAG00000009344","3",185650783,185772043,121260
"7543","ENSACAG00000009345","1",248303365,248309673,6308
"7544","ENSACAG00000009346","GL343562.1",152393,162377,9984
"7545","ENSACAG00000009347","GL343213.1",1963848,1987253,23405
"7546","ENSACAG00000009348","2",148912292,149003256,90964
"7547","ENSACAG00000009349","GL343220.1",543233,601328,58095
"7548","ENSACAG00000009350","GL344349.1",11997,36127,24130
"7549","ENSACAG00000009351","2",15860296,15877523,17227
"7550","ENSACAG00000009352","5",81183503,81343669,160166
"7551","ENSACAG00000009353","1",70905680,70946365,40685
"7552","ENSACAG00000009354","GL343248.1",2011410,2022107,10697
"7553","ENSACAG00000009355","1",70860243,70895741,35498
"7554","ENSACAG00000009356","1",248297006,248301696,4690
"7555","ENSACAG00000009357","1",231359792,231390524,30732
"7556","ENSACAG00000009358","2",89290922,89317644,26722
"7557","ENSACAG00000009359","1",248252909,248285191,32282
"7558","ENSACAG00000009360","GL343639.1",223884,274945,51061
"7559","ENSACAG00000009361","4",138172348,138180996,8648
"7560","ENSACAG00000009363","4",13769032,13769182,150
"7561","ENSACAG00000009364","4",13719089,13742527,23438
"7562","ENSACAG00000009365","GL343266.1",1515664,1524125,8461
"7563","ENSACAG00000009366","1",93923302,93988075,64773
"7564","ENSACAG00000009367","GL343269.1",1828808,1867583,38775
"7565","ENSACAG00000009368","AAWZ02036458",64,1600,1536
"7566","ENSACAG00000009369","1",11674864,11723069,48205
"7567","ENSACAG00000009370","GL343282.1",70132,72231,2099
"7568","ENSACAG00000009373","1",264453,286857,22404
"7569","ENSACAG00000009374","4",138184500,138223679,39179
"7570","ENSACAG00000009375","GL343637.1",52194,61439,9245
"7571","ENSACAG00000009376","6",76935,193327,116392
"7572","ENSACAG00000009377","AAWZ02037213",2769,15201,12432
"7573","ENSACAG00000009378","GL343282.1",75210,95564,20354
"7574","ENSACAG00000009379","4",138232062,138272155,40093
"7575","ENSACAG00000009380","2",95123951,95128355,4404
"7576","ENSACAG00000009381","6",204897,253425,48528
"7577","ENSACAG00000009382","2",95070303,95081992,11689
"7578","ENSACAG00000009383","6",56079009,56105918,26909
"7579","ENSACAG00000009384","6",58626676,58649813,23137
"7580","ENSACAG00000009385","GL343212.1",2853076,2901698,48622
"7581","ENSACAG00000009386","6",17356169,17443454,87285
"7582","ENSACAG00000009388","GL343436.1",602067,648101,46034
"7583","ENSACAG00000009389","5",81150641,81157317,6676
"7584","ENSACAG00000009390","6",17455324,17509670,54346
"7585","ENSACAG00000009391","GL344386.1",25692,31217,5525
"7586","ENSACAG00000009392","GL343282.1",107011,112657,5646
"7587","ENSACAG00000009394","1",77380,183510,106130
"7588","ENSACAG00000009395","AAWZ02037638",9937,10239,302
"7589","ENSACAG00000009396","GL343978.1",51675,84185,32510
"7590","ENSACAG00000009397","6",45339750,45371649,31899
"7591","ENSACAG00000009399","GL343206.1",3960229,4152149,191920
"7592","ENSACAG00000009400","GL343562.1",171769,171957,188
"7593","ENSACAG00000009401","GL343562.1",246798,320232,73434
"7594","ENSACAG00000009402","GL343581.1",375189,377588,2399
"7595","ENSACAG00000009403","GL344272.1",55821,62967,7146
"7596","ENSACAG00000009404","2",89317710,89353774,36064
"7597","ENSACAG00000009405","GL343756.1",217795,264032,46237
"7598","ENSACAG00000009406","GL343248.1",1522792,1851002,328210
"7599","ENSACAG00000009407","GL344694.1",676,3541,2865
"7600","ENSACAG00000009408","GL343282.1",112724,152370,39646
"7601","ENSACAG00000009409","GL343645.1",51349,136689,85340
"7602","ENSACAG00000009410","GL343213.1",2025117,2092535,67418
"7603","ENSACAG00000009413","GL343198.1",760986,976295,215309
"7604","ENSACAG00000009414","GL343645.1",186578,217872,31294
"7605","ENSACAG00000009415","GL343417.1",117453,124205,6752
"7606","ENSACAG00000009416","6",326270,350267,23997
"7607","ENSACAG00000009417","GL343436.1",652403,663588,11185
"7608","ENSACAG00000009418","4",124394828,124402962,8134
"7609","ENSACAG00000009420","4",13697502,13701997,4495
"7610","ENSACAG00000009421","6",56161991,56209166,47175
"7611","ENSACAG00000009422","3",163939192,163953009,13817
"7612","ENSACAG00000009423","GL343581.1",383539,406924,23385
"7613","ENSACAG00000009424","GL343213.1",2141622,2170695,29073
"7614","ENSACAG00000009425","1",118435072,118562758,127686
"7615","ENSACAG00000009426","1",11729219,11792694,63475
"7616","ENSACAG00000009427","4",140207876,140209240,1364
"7617","ENSACAG00000009428","GL344694.1",6882,23010,16128
"7618","ENSACAG00000009431","4",23086113,23106287,20174
"7619","ENSACAG00000009432","5",81114063,81144669,30606
"7620","ENSACAG00000009433","1",72270738,72303048,32310
"7621","ENSACAG00000009434","2",15878644,15889035,10391
"7622","ENSACAG00000009435","1",231342208,231356042,13834
"7623","ENSACAG00000009436","4",13681586,13693998,12412
"7624","ENSACAG00000009437","1",94010651,94054379,43728
"7625","ENSACAG00000009438","GL343531.1",341426,382463,41037
"7626","ENSACAG00000009439","5",81077931,81088098,10167
"7627","ENSACAG00000009440","GL343859.1",47209,62391,15182
"7628","ENSACAG00000009441","6",45308550,45309544,994
"7629","ENSACAG00000009442","1",70773322,70792550,19228
"7630","ENSACAG00000009445","4",138376153,138414693,38540
"7631","ENSACAG00000009446","LGc",6102465,6188435,85970
"7632","ENSACAG00000009448","AAWZ02036108",13030,31699,18669
"7633","ENSACAG00000009449","6",45275152,45280296,5144
"7634","ENSACAG00000009451","3",163918442,163931585,13143
"7635","ENSACAG00000009452","1",64204351,64248879,44528
"7636","ENSACAG00000009453","4",124411201,124434859,23658
"7637","ENSACAG00000009454","2",125928897,126036275,107378
"7638","ENSACAG00000009455","4",138424793,138460725,35932
"7639","ENSACAG00000009457","GL344267.1",14679,51971,37292
"7640","ENSACAG00000009458","6",45232688,45268247,35559
"7641","ENSACAG00000009459","GL343432.1",295887,312312,16425
"7642","ENSACAG00000009460","6",56341685,56400690,59005
"7643","ENSACAG00000009461","GL343402.1",651658,673229,21571
"7644","ENSACAG00000009464","1",70734689,70762046,27357
"7645","ENSACAG00000009465","4",13646296,13681296,35000
"7646","ENSACAG00000009466","AAWZ02038772",4783,7290,2507
"7647","ENSACAG00000009467","5",81042423,81052503,10080
"7648","ENSACAG00000009468","1",94056672,94082954,26282
"7649","ENSACAG00000009469","GL343402.1",678506,686747,8241
"7650","ENSACAG00000009470","2",118071977,118120473,48496
"7651","ENSACAG00000009471","GL343581.1",405688,433827,28139
"7652","ENSACAG00000009472","GL343198.1",1406789,1430906,24117
"7653","ENSACAG00000009473","GL343418.1",676211,709277,33066
"7654","ENSACAG00000009474","GL343208.1",540160,551525,11365
"7655","ENSACAG00000009475","5",80995631,81005991,10360
"7656","ENSACAG00000009477","GL343208.1",435056,496120,61064
"7657","ENSACAG00000009478","GL343859.1",64254,64790,536
"7658","ENSACAG00000009479","5",80959328,80988502,29174
"7659","ENSACAG00000009480","GL343859.1",67710,76914,9204
"7660","ENSACAG00000009481","3",163825318,163831683,6365
"7661","ENSACAG00000009482","GL343436.1",676964,685290,8326
"7662","ENSACAG00000009483","GL343204.1",1940633,1961983,21350
"7663","ENSACAG00000009484","GL343497.1",179323,188458,9135
"7664","ENSACAG00000009485","GL343417.1",125133,128548,3415
"7665","ENSACAG00000009486","1",11807795,11869240,61445
"7666","ENSACAG00000009487","GL343432.1",391654,482186,90532
"7667","ENSACAG00000009488","GL343859.1",87408,97455,10047
"7668","ENSACAG00000009489","GL343204.1",1964896,1987009,22113
"7669","ENSACAG00000009490","4",22906921,22925500,18579
"7670","ENSACAG00000009492","4",124435422,124445704,10282
"7671","ENSACAG00000009493","GL343354.1",369059,371782,2723
"7672","ENSACAG00000009494","AAWZ02038622",1169,10902,9733
"7673","ENSACAG00000009495","3",163782762,163784628,1866
"7674","ENSACAG00000009496","GL343465.1",293183,349405,56222
"7675","ENSACAG00000009497","1",231303633,231326981,23348
"7676","ENSACAG00000009498","3",163681372,163689097,7725
"7677","ENSACAG00000009500","GL343497.1",169418,174828,5410
"7678","ENSACAG00000009501","1",94091379,94128503,37124
"7679","ENSACAG00000009502","GL343645.1",224799,256392,31593
"7680","ENSACAG00000009503","GL343417.1",129011,133015,4004
"7681","ENSACAG00000009504","GL343198.1",1446010,1479682,33672
"7682","ENSACAG00000009505","GL343436.1",690520,708494,17974
"7683","ENSACAG00000009506","2",125823843,125848478,24635
"7684","ENSACAG00000009507","1",163713489,163714533,1044
"7685","ENSACAG00000009508","4",138508823,138542940,34117
"7686","ENSACAG00000009509","2",15925881,15934597,8716
"7687","ENSACAG00000009511","4",13195324,13591666,396342
"7688","ENSACAG00000009512","3",21550453,21595089,44636
"7689","ENSACAG00000009513","GL343497.1",135753,136343,590
"7690","ENSACAG00000009514","GL343859.1",137096,166485,29389
"7691","ENSACAG00000009515","GL343418.1",758291,758602,311
"7692","ENSACAG00000009516","GL343497.1",35964,80090,44126
"7693","ENSACAG00000009518","6",356053,369797,13744
"7694","ENSACAG00000009520","4",124468798,124552020,83222
"7695","ENSACAG00000009521","GL343417.1",136904,146295,9391
"7696","ENSACAG00000009522","GL343196.1",1364281,1414841,50560
"7697","ENSACAG00000009524","1",77375404,77391399,15995
"7698","ENSACAG00000009525","6",56466360,56551716,85356
"7699","ENSACAG00000009527","GL343639.1",35404,137651,102247
"7700","ENSACAG00000009528","1",231265368,231291840,26472
"7701","ENSACAG00000009529","1",64267555,64278194,10639
"7702","ENSACAG00000009530","AAWZ02041982",111,2941,2830
"7703","ENSACAG00000009531","GL344711.1",5551,14148,8597
"7704","ENSACAG00000009533","GL343618.1",68699,128930,60231
"7705","ENSACAG00000009535","1",11879018,11970593,91575
"7706","ENSACAG00000009536","1",72199509,72262441,62932
"7707","ENSACAG00000009537","6",44766895,45112856,345961
"7708","ENSACAG00000009539","GL343213.1",2180349,2211378,31029
"7709","ENSACAG00000009540","GL343885.1",30314,36484,6170
"7710","ENSACAG00000009542","1",70692590,70708569,15979
"7711","ENSACAG00000009543","GL343866.1",101598,102674,1076
"7712","ENSACAG00000009544","GL343432.1",504020,712642,208622
"7713","ENSACAG00000009545","AAWZ02037618",89,14469,14380
"7714","ENSACAG00000009546","GL343866.1",112286,119828,7542
"7715","ENSACAG00000009548","5",80909936,80948329,38393
"7716","ENSACAG00000009549","GL343282.1",151165,182823,31658
"7717","ENSACAG00000009550","GL343282.1",182112,259546,77434
"7718","ENSACAG00000009551","GL343562.1",327293,337930,10637
"7719","ENSACAG00000009552","2",125542024,125729088,187064
"7720","ENSACAG00000009554","4",22820727,22854465,33738
"7721","ENSACAG00000009555","1",94133800,94155901,22101
"7722","ENSACAG00000009556","2",156765311,157098641,333330
"7723","ENSACAG00000009557","GL343780.1",131294,154560,23266
"7724","ENSACAG00000009558","3",31500331,31540989,40658
"7725","ENSACAG00000009559","2",16127880,16130330,2450
"7726","ENSACAG00000009560","GL343196.1",1319177,1352348,33171
"7727","ENSACAG00000009562","6",58560593,58594758,34165
"7728","ENSACAG00000009563","GL343208.1",345990,372301,26311
"7729","ENSACAG00000009564","2",16135597,16155590,19993
"7730","ENSACAG00000009565","3",163498672,163661906,163234
"7731","ENSACAG00000009566","2",89414438,89604826,190388
"7732","ENSACAG00000009569","1",64294654,64353998,59344
"7733","ENSACAG00000009571","4",42479416,42482824,3408
"7734","ENSACAG00000009572","2",16170494,16252029,81535
"7735","ENSACAG00000009573","6",56556572,56568836,12264
"7736","ENSACAG00000009574","6",372487,399075,26588
"7737","ENSACAG00000009575","GL343212.1",2793454,2842692,49238
"7738","ENSACAG00000009576","6",56572378,56594714,22336
"7739","ENSACAG00000009577","3",31462278,31489088,26810
"7740","ENSACAG00000009578","4",42441104,42459123,18019
"7741","ENSACAG00000009579","GL343344.1",1047541,1074824,27283
"7742","ENSACAG00000009581","5",104745953,104759160,13207
"7743","ENSACAG00000009582","GL343581.1",444694,454731,10037
"7744","ENSACAG00000009583","GL343885.1",18663,30561,11898
"7745","ENSACAG00000009584","GL343866.1",123120,135667,12547
"7746","ENSACAG00000009585","5",80890592,80903611,13019
"7747","ENSACAG00000009586","1",11988407,12014666,26259
"7748","ENSACAG00000009588","5",80850662,80874337,23675
"7749","ENSACAG00000009590","4",42301821,42436448,134627
"7750","ENSACAG00000009592","1",70573800,70689617,115817
"7751","ENSACAG00000009593","GL343198.1",1486355,1512523,26168
"7752","ENSACAG00000009594","GL343581.1",454065,464654,10589
"7753","ENSACAG00000009596","1",72015518,72092559,77041
"7754","ENSACAG00000009597","GL343344.1",956755,1024818,68063
"7755","ENSACAG00000009598","GL343436.1",710088,714514,4426
"7756","ENSACAG00000009599","2",16274254,16307859,33605
"7757","ENSACAG00000009601","5",104729160,104738969,9809
"7758","ENSACAG00000009603","3",21516652,21518668,2016
"7759","ENSACAG00000009604","GL343212.1",2718583,2739208,20625
"7760","ENSACAG00000009605","3",31363088,31384361,21273
"7761","ENSACAG00000009606","GL343198.1",1517039,1550593,33554
"7762","ENSACAG00000009607","1",77393380,77407172,13792
"7763","ENSACAG00000009608","4",6847434,6850022,2588
"7764","ENSACAG00000009610","GL343208.1",328019,346081,18062
"7765","ENSACAG00000009612","GL343436.1",731405,778773,47368
"7766","ENSACAG00000009614","5",104592599,104655768,63169
"7767","ENSACAG00000009615","2",87393940,87426153,32213
"7768","ENSACAG00000009617","GL343220.1",538077,539210,1133
"7769","ENSACAG00000009618","4",6795919,6828489,32570
"7770","ENSACAG00000009619","GL343402.1",689242,725322,36080
"7771","ENSACAG00000009620","GL343220.1",523846,528833,4987
"7772","ENSACAG00000009621","GL344011.1",149,9069,8920
"7773","ENSACAG00000009622","1",70503906,70546416,42510
"7774","ENSACAG00000009624","2",89609327,89629919,20592
"7775","ENSACAG00000009625","GL343402.1",765062,773631,8569
"7776","ENSACAG00000009626","GL343220.1",505006,509175,4169
"7777","ENSACAG00000009627","1",231184936,231220461,35525
"7778","ENSACAG00000009628","GL343465.1",371699,417489,45790
"7779","ENSACAG00000009630","1",231075398,231102847,27449
"7780","ENSACAG00000009631","AAWZ02036828",7939,22052,14113
"7781","ENSACAG00000009633","GL343198.1",1552840,1557077,4237
"7782","ENSACAG00000009634","4",138548668,138561277,12609
"7783","ENSACAG00000009635","1",115622672,116173857,551185
"7784","ENSACAG00000009636","2",125468000,125541963,73963
"7785","ENSACAG00000009637","GL343402.1",772080,781442,9362
"7786","ENSACAG00000009638","GL343212.1",2645586,2667479,21893
"7787","ENSACAG00000009640","GL343198.1",1572445,1573460,1015
"7788","ENSACAG00000009641","GL343562.1",344221,384160,39939
"7789","ENSACAG00000009642","GL343208.1",149792,237692,87900
"7790","ENSACAG00000009643","GL343220.1",487856,493317,5461
"7791","ENSACAG00000009644","3",163450300,163456853,6553
"7792","ENSACAG00000009645","GL343198.1",1580161,1622766,42605
"7793","ENSACAG00000009646","GL343618.1",19987,37398,17411
"7794","ENSACAG00000009650","GL343220.1",476974,482874,5900
"7795","ENSACAG00000009651","GL344011.1",15673,16506,833
"7796","ENSACAG00000009652","LGc",6193338,6207844,14506
"7797","ENSACAG00000009653","4",41886690,41888036,1346
"7798","ENSACAG00000009654","GL343213.1",2215121,2298749,83628
"7799","ENSACAG00000009655","GL343636.1",12442,95391,82949
"7800","ENSACAG00000009656","GL344011.1",25275,92168,66893
"7801","ENSACAG00000009657","GL343618.1",187,11728,11541
"7802","ENSACAG00000009658","GL343220.1",464786,470320,5534
"7803","ENSACAG00000009659","4",41795834,41872508,76674
"7804","ENSACAG00000009660","4",13131239,13149733,18494
"7805","ENSACAG00000009661","1",231060185,231070150,9965
"7806","ENSACAG00000009662","3",31231349,31269889,38540
"7807","ENSACAG00000009664","GL343220.1",432209,439856,7647
"7808","ENSACAG00000009666","4",13092817,13133494,40677
"7809","ENSACAG00000009669","2",125217249,125239237,21988
"7810","ENSACAG00000009670","1",12032305,12167448,135143
"7811","ENSACAG00000009671","3",185573606,185580655,7049
"7812","ENSACAG00000009672","GL343343.1",76381,90847,14466
"7813","ENSACAG00000009675","3",163399577,163419719,20142
"7814","ENSACAG00000009676","GL343220.1",397023,403406,6383
"7815","ENSACAG00000009677","3",185553298,185564488,11190
"7816","ENSACAG00000009678","GL343193.1",2704133,2707188,3055
"7817","ENSACAG00000009679","1",77411071,77424653,13582
"7818","ENSACAG00000009680","GL343212.1",2609909,2645790,35881
"7819","ENSACAG00000009682","3",185057522,185492599,435077
"7820","ENSACAG00000009683","GL343248.1",581706,612498,30792
"7821","ENSACAG00000009684","3",21054329,21436115,381786
"7822","ENSACAG00000009685","GL343215.1",2010885,2036827,25942
"7823","ENSACAG00000009686","4",6784754,6792246,7492
"7824","ENSACAG00000009687","1",231033128,231054355,21227
"7825","ENSACAG00000009688","GL343248.1",114481,208717,94236
"7826","ENSACAG00000009689","GL344450.1",4471,32852,28381
"7827","ENSACAG00000009690","GL343196.1",1301525,1302818,1293
"7828","ENSACAG00000009691","1",94150009,94161010,11001
"7829","ENSACAG00000009692","3",163279612,163354666,75054
"7830","ENSACAG00000009693","1",94169271,94177527,8256
"7831","ENSACAG00000009694","GL343417.1",149208,152075,2867
"7832","ENSACAG00000009696","GL343866.1",144965,147965,3000
"7833","ENSACAG00000009697","6",58521263,58566156,44893
"7834","ENSACAG00000009699","6",44530862,44531875,1013
"7835","ENSACAG00000009700","1",70487817,70494027,6210
"7836","ENSACAG00000009701","GL343196.1",1275749,1287143,11394
"7837","ENSACAG00000009702","GL344107.1",72917,83549,10632
"7838","ENSACAG00000009703","6",44033690,44406588,372898
"7839","ENSACAG00000009704","1",64381896,64425345,43449
"7840","ENSACAG00000009705","GL343977.1",15128,31123,15995
"7841","ENSACAG00000009706","GL343866.1",169595,179319,9724
"7842","ENSACAG00000009707","1",70065893,70077039,11146
"7843","ENSACAG00000009708","1",77427906,77442600,14694
"7844","ENSACAG00000009709","4",90751557,90751682,125
"7845","ENSACAG00000009710","4",90596958,90665709,68751
"7846","ENSACAG00000009711","4",6740590,6773788,33198
"7847","ENSACAG00000009712","6",56606331,56775450,169119
"7848","ENSACAG00000009713","2",16402168,16420052,17884
"7849","ENSACAG00000009714","4",138567511,138573783,6272
"7850","ENSACAG00000009715","1",118628463,118628948,485
"7851","ENSACAG00000009716","4",138601674,138609385,7711
"7852","ENSACAG00000009717","GL343417.1",166392,168467,2075
"7853","ENSACAG00000009718","1",118737176,118758808,21632
"7854","ENSACAG00000009719","3",163244570,163261115,16545
"7855","ENSACAG00000009720","1",69965277,69969077,3800
"7856","ENSACAG00000009721","AAWZ02039589",1152,5061,3909
"7857","ENSACAG00000009723","GL343417.1",175637,182828,7191
"7858","ENSACAG00000009724","3",162969244,163051159,81915
"7859","ENSACAG00000009725","GL343655.1",9972,136016,126044
"7860","ENSACAG00000009727","GL343196.1",1222810,1266575,43765
"7861","ENSACAG00000009728","LGc",6226246,6236756,10510
"7862","ENSACAG00000009729","1",118770028,118792934,22906
"7863","ENSACAG00000009730","2",125195445,125214238,18793
"7864","ENSACAG00000009731","GL343343.1",101196,108465,7269
"7865","ENSACAG00000009732","1",77444413,77454717,10304
"7866","ENSACAG00000009733","4",138634975,138659172,24197
"7867","ENSACAG00000009734","GL344115.1",1056,62995,61939
"7868","ENSACAG00000009735","GL344521.1",363,11049,10686
"7869","ENSACAG00000009736","GL343958.1",19732,41830,22098
"7870","ENSACAG00000009737","4",6696654,6705604,8950
"7871","ENSACAG00000009738","3",20979547,20980816,1269
"7872","ENSACAG00000009739","3",150962412,151137572,175160
"7873","ENSACAG00000009740","3",10892267,10917136,24869
"7874","ENSACAG00000009741","1",77462137,77475312,13175
"7875","ENSACAG00000009743","GL343402.1",782763,791274,8511
"7876","ENSACAG00000009744","GL343402.1",790491,806194,15703
"7877","ENSACAG00000009745","1",71857794,71896495,38701
"7878","ENSACAG00000009746","GL343636.1",103791,138111,34320
"7879","ENSACAG00000009747","2",16440682,16452595,11913
"7880","ENSACAG00000009748","GL343958.1",46192,104927,58735
"7881","ENSACAG00000009749","3",31013525,31165221,151696
"7882","ENSACAG00000009750","4",138665743,138873344,207601
"7883","ENSACAG00000009751","4",6671243,6682567,11324
"7884","ENSACAG00000009752","GL343343.1",120213,182588,62375
"7885","ENSACAG00000009753","1",69910150,69939848,29698
"7886","ENSACAG00000009754","AAWZ02038318",3020,11682,8662
"7887","ENSACAG00000009755","LGc",6238828,6240441,1613
"7888","ENSACAG00000009756","6",414568,454413,39845
"7889","ENSACAG00000009757","LGc",6243383,6261283,17900
"7890","ENSACAG00000009758","GL343215.1",1993863,2005644,11781
"7891","ENSACAG00000009759","GL343467.1",140755,148348,7593
"7892","ENSACAG00000009760","1",118796969,118840855,43886
"7893","ENSACAG00000009761","AAWZ02039401",478,8178,7700
"7894","ENSACAG00000009762","GL343995.1",65672,95631,29959
"7895","ENSACAG00000009764","1",231025167,231032758,7591
"7896","ENSACAG00000009765","GL343417.1",183668,188487,4819
"7897","ENSACAG00000009766","GL343206.1",2296305,2587033,290728
"7898","ENSACAG00000009767","2",87538518,87547399,8881
"7899","ENSACAG00000009768","GL343198.1",1716909,1796159,79250
"7900","ENSACAG00000009769","1",77512205,77554564,42359
"7901","ENSACAG00000009770","GL343241.1",802081,927217,125136
"7902","ENSACAG00000009771","6",716883,722630,5747
"7903","ENSACAG00000009772","1",77558584,77587889,29305
"7904","ENSACAG00000009773","GL343873.1",121908,140377,18469
"7905","ENSACAG00000009774","4",22799411,22814259,14848
"7906","ENSACAG00000009775","GL343417.1",189952,193345,3393
"7907","ENSACAG00000009776","GL343344.1",948217,949836,1619
"7908","ENSACAG00000009777","6",737567,752877,15310
"7909","ENSACAG00000009778","GL343977.1",32423,40404,7981
"7910","ENSACAG00000009779","2",87603415,87624203,20788
"7911","ENSACAG00000009782","GL343215.1",1931421,1944586,13165
"7912","ENSACAG00000009783","3",162933901,162943108,9207
"7913","ENSACAG00000009784","AAWZ02035329",6247,25050,18803
"7914","ENSACAG00000009785","GL343417.1",197291,197857,566
"7915","ENSACAG00000009786","GL343383.1",795420,828330,32910
"7916","ENSACAG00000009787","2",16452426,16509506,57080
"7917","ENSACAG00000009789","GL343344.1",905313,931840,26527
"7918","ENSACAG00000009790","GL344312.1",2824,17753,14929
"7919","ENSACAG00000009791","GL343417.1",199796,201281,1485
"7920","ENSACAG00000009792","GL343248.1",66000,80148,14148
"7921","ENSACAG00000009794","GL343343.1",194929,196683,1754
"7922","ENSACAG00000009795","GL343417.1",203202,232218,29016
"7923","ENSACAG00000009796","GL344378.1",1384,11439,10055
"7924","ENSACAG00000009797","GL343343.1",240591,330691,90100
"7925","ENSACAG00000009799","6",56670043,56689325,19282
"7926","ENSACAG00000009800","2",87690245,87796658,106413
"7927","ENSACAG00000009801","GL343977.1",40423,53266,12843
"7928","ENSACAG00000009803","GL343402.1",809754,827116,17362
"7929","ENSACAG00000009804","1",77594057,77605180,11123
"7930","ENSACAG00000009806","GL343200.1",2909477,3054177,144700
"7931","ENSACAG00000009808","1",230969708,231021048,51340
"7932","ENSACAG00000009809","GL343383.1",786420,793409,6989
"7933","ENSACAG00000009810","GL343665.1",40128,56092,15964
"7934","ENSACAG00000009811","1",12183346,12184416,1070
"7935","ENSACAG00000009812","4",90575194,90593447,18253
"7936","ENSACAG00000009813","GL343402.1",843170,845043,1873
"7937","ENSACAG00000009814","1",12187568,12212731,25163
"7938","ENSACAG00000009816","2",191348119,191348748,629
"7939","ENSACAG00000009818","GL344971.1",40,7820,7780
"7940","ENSACAG00000009819","6",56688182,56788271,100089
"7941","ENSACAG00000009821","GL343343.1",625007,798391,173384
"7942","ENSACAG00000009822","GL343241.1",752895,778070,25175
"7943","ENSACAG00000009823","2",191340384,191344915,4531
"7944","ENSACAG00000009824","GL343221.1",1556184,1560925,4741
"7945","ENSACAG00000009825","GL343977.1",70366,75754,5388
"7946","ENSACAG00000009826","GL343344.1",859293,884173,24880
"7947","ENSACAG00000009827","GL343601.1",1703,19134,17431
"7948","ENSACAG00000009829","GL343215.1",1871445,1926394,54949
"7949","ENSACAG00000009830","GL343383.1",749010,773042,24032
"7950","ENSACAG00000009831","GL343198.1",1806711,1823123,16412
"7951","ENSACAG00000009833","GL343204.1",8169,65497,57328
"7952","ENSACAG00000009834","GL343383.1",521843,680205,158362
"7953","ENSACAG00000009836","2",191325156,191341310,16154
"7954","ENSACAG00000009837","AAWZ02038318",45,7986,7941
"7955","ENSACAG00000009839","LGc",6294915,6334390,39475
"7956","ENSACAG00000009840","4",13062025,13080400,18375
"7957","ENSACAG00000009841","GL343212.1",2149026,2156519,7493
"7958","ENSACAG00000009842","GL343241.1",272243,369895,97652
"7959","ENSACAG00000009843","1",77633295,77701141,67846
"7960","ENSACAG00000009844","GL343467.1",148078,173578,25500
"7961","ENSACAG00000009845","1",64441513,64481310,39797
"7962","ENSACAG00000009847","4",22761999,22792447,30448
"7963","ENSACAG00000009848","GL344378.1",19095,30274,11179
"7964","ENSACAG00000009849","2",171089053,171564217,475164
"7965","ENSACAG00000009850","2",191293942,191322780,28838
"7966","ENSACAG00000009851","3",176647333,176688379,41046
"7967","ENSACAG00000009852","GL343601.1",330353,384741,54388
"7968","ENSACAG00000009853","AAWZ02037037",695,14950,14255
"7969","ENSACAG00000009854","GL343204.1",72570,135908,63338
"7970","ENSACAG00000009855","2",16522473,16605181,82708
"7971","ENSACAG00000009857","3",176551888,176591711,39823
"7972","ENSACAG00000009858","4",12445081,12794309,349228
"7973","ENSACAG00000009859","6",783388,871142,87754
"7974","ENSACAG00000009860","1",64503219,64509713,6494
"7975","ENSACAG00000009861","GL343200.1",3090037,3137452,47415
"7976","ENSACAG00000009863","GL343782.1",104365,134893,30528
"7977","ENSACAG00000009864","GL343198.1",1688511,1836658,148147
"7978","ENSACAG00000009865","GL343206.1",2089487,2120129,30642
"7979","ENSACAG00000009870","AAWZ02035329",26054,29508,3454
"7980","ENSACAG00000009873","4",90485783,90514624,28841
"7981","ENSACAG00000009874","2",191275011,191284232,9221
"7982","ENSACAG00000009875","2",157191536,157344310,152774
"7983","ENSACAG00000009876","1",90900035,90942806,42771
"7984","ENSACAG00000009877","GL343213.1",2382440,2655715,273275
"7985","ENSACAG00000009878","1",12236421,12264083,27662
"7986","ENSACAG00000009879","1",64515564,64517977,2413
"7987","ENSACAG00000009880","1",64526235,64527544,1309
"7988","ENSACAG00000009881","2",119496000,119498199,2199
"7989","ENSACAG00000009882","4",12016877,12288056,271179
"7990","ENSACAG00000009884","1",64597827,64731020,133193
"7991","ENSACAG00000009885","2",119533237,119545610,12373
"7992","ENSACAG00000009886","3",91191998,91194877,2879
"7993","ENSACAG00000009888","1",152369324,152401409,32085
"7994","ENSACAG00000009890","4",41530509,41532185,1676
"7995","ENSACAG00000009891","GL343665.1",57203,83710,26507
"7996","ENSACAG00000009892","2",191263694,191271315,7621
"7997","ENSACAG00000009893","GL343977.1",75936,118072,42136
"7998","ENSACAG00000009894","GL343873.1",90755,115107,24352
"7999","ENSACAG00000009895","GL343196.1",1143454,1194916,51462
"8000","ENSACAG00000009896","6",43851261,43982199,130938
"8001","ENSACAG00000009897","GL343431.1",12784,41019,28235
"8002","ENSACAG00000009898","GL343417.1",237294,242292,4998
"8003","ENSACAG00000009899","GL343467.1",205561,242910,37349
"8004","ENSACAG00000009900","LGc",6350352,6414271,63919
"8005","ENSACAG00000009901","AAWZ02038313",1247,2368,1121
"8006","ENSACAG00000009902","5",104401434,104457107,55673
"8007","ENSACAG00000009903","GL343417.1",252126,268798,16672
"8008","ENSACAG00000009906","GL343245.1",1102176,1118343,16167
"8009","ENSACAG00000009908","GL343667.1",7896,8141,245
"8010","ENSACAG00000009909","1",77701496,77720154,18658
"8011","ENSACAG00000009911","GL343396.1",25,15248,15223
"8012","ENSACAG00000009912","4",6628794,6664681,35887
"8013","ENSACAG00000009914","GL343467.1",315873,333517,17644
"8014","ENSACAG00000009915","1",169802045,169988453,186408
"8015","ENSACAG00000009916","GL343383.1",498886,507694,8808
"8016","ENSACAG00000009917","4",90371996,90478503,106507
"8017","ENSACAG00000009918","1",69747415,69748006,591
"8018","ENSACAG00000009919","GL343344.1",816461,841080,24619
"8019","ENSACAG00000009920","3",176478343,176541091,62748
"8020","ENSACAG00000009921","1",114201462,114930727,729265
"8021","ENSACAG00000009922","GL343196.1",1045409,1105193,59784
"8022","ENSACAG00000009923","GL343383.1",428998,495440,66442
"8023","ENSACAG00000009924","GL343215.1",1829839,1868401,38562
"8024","ENSACAG00000009926","2",191180306,191214572,34266
"8025","ENSACAG00000009927","GL343215.1",1787362,1815243,27881
"8026","ENSACAG00000009928","2",119588508,119599044,10536
"8027","ENSACAG00000009930","GL343204.1",138597,175935,37338
"8028","ENSACAG00000009931","GL343782.1",135001,158400,23399
"8029","ENSACAG00000009932","GL343204.1",2018630,2074780,56150
"8030","ENSACAG00000009933","2",16752214,16756800,4586
"8031","ENSACAG00000009934","GL343766.1",65282,85745,20463
"8032","ENSACAG00000009936","1",69690114,69698244,8130
"8033","ENSACAG00000009937","1",69531278,69543934,12656
"8034","ENSACAG00000009938","3",30949265,30974075,24810
"8035","ENSACAG00000009939","GL343196.1",917664,1004669,87005
"8036","ENSACAG00000009940","3",176496609,176517308,20699
"8037","ENSACAG00000009942","GL343241.1",85679,134567,48888
"8038","ENSACAG00000009944","2",119618495,119659686,41191
"8039","ENSACAG00000009945","2",118133209,118151039,17830
"8040","ENSACAG00000009947","GL343655.1",160673,162319,1646
"8041","ENSACAG00000009948","2",16763345,16807874,44529
"8042","ENSACAG00000009949","GL343655.1",233302,325411,92109
"8043","ENSACAG00000009950","GL343665.1",86348,110995,24647
"8044","ENSACAG00000009951","4",117870798,117902598,31800
"8045","ENSACAG00000009952","1",90887052,90889700,2648
"8046","ENSACAG00000009953","GL343480.1",629321,637004,7683
"8047","ENSACAG00000009954","GL343431.1",45011,174616,129605
"8048","ENSACAG00000009955","4",6435893,6479286,43393
"8049","ENSACAG00000009957","GL343198.1",1866155,1918460,52305
"8050","ENSACAG00000009959","LGc",6441489,6442523,1034
"8051","ENSACAG00000009960","GL343241.1",7680,69695,62015
"8052","ENSACAG00000009961","LGc",6464056,6508624,44568
"8053","ENSACAG00000009963","4",124567118,124643524,76406
"8054","ENSACAG00000009964","1",90861309,90873330,12021
"8055","ENSACAG00000009965","4",6324371,6350323,25952
"8056","ENSACAG00000009967","6",43779617,43837619,58002
"8057","ENSACAG00000009969","2",119698450,119710285,11835
"8058","ENSACAG00000009971","6",882558,890643,8085
"8059","ENSACAG00000009972","3",176384009,176467308,83299
"8060","ENSACAG00000009973","AAWZ02041358",4858,5680,822
"8061","ENSACAG00000009974","4",118853386,118857385,3999
"8062","ENSACAG00000009975","5",60525537,60542660,17123
"8063","ENSACAG00000009976","1",90842492,90860879,18387
"8064","ENSACAG00000009977","GL343274.1",1825436,1841007,15571
"8065","ENSACAG00000009979","4",6276458,6289256,12798
"8066","ENSACAG00000009980","1",230949661,230963934,14273
"8067","ENSACAG00000009981","2",112678398,112678973,575
"8068","ENSACAG00000009982","2",112667925,112671412,3487
"8069","ENSACAG00000009983","4",12002838,12012877,10039
"8070","ENSACAG00000009985","4",6265679,6275258,9579
"8071","ENSACAG00000009986","GL344208.1",1343,55065,53722
"8072","ENSACAG00000009987","2",173164155,173356640,192485
"8073","ENSACAG00000009988","GL343425.1",231463,319827,88364
"8074","ENSACAG00000009989","GL343198.1",1891627,1905319,13692
"8075","ENSACAG00000009990","1",90830340,90843428,13088
"8076","ENSACAG00000009991","GL343204.1",291498,292796,1298
"8077","ENSACAG00000009992","2",191168349,191180714,12365
"8078","ENSACAG00000009993","GL343204.1",464195,520634,56439
"8079","ENSACAG00000009996","2",118159561,118176833,17272
"8080","ENSACAG00000009998","GL344104.1",2275,21376,19101
"8081","ENSACAG00000010001","2",16853701,16870970,17269
"8082","ENSACAG00000010002","GL343237.1",2905,279114,276209
"8083","ENSACAG00000010003","2",137854834,137866999,12165
"8084","ENSACAG00000010004","GL343431.1",198515,199405,890
"8085","ENSACAG00000010005","GL343431.1",416550,762722,346172
"8086","ENSACAG00000010006","GL343467.1",341515,356810,15295
"8087","ENSACAG00000010008","GL343196.1",864594,913286,48692
"8088","ENSACAG00000010010","2",137841084,137944473,103389
"8089","ENSACAG00000010011","3",176343572,176350914,7342
"8090","ENSACAG00000010012","4",11840916,11901971,61055
"8091","ENSACAG00000010013","3",176324433,176328755,4322
"8092","ENSACAG00000010014","2",112577231,112645520,68289
"8093","ENSACAG00000010015","GL343198.1",1909010,1921088,12078
"8094","ENSACAG00000010016","GL343471.1",51412,52274,862
"8095","ENSACAG00000010017","2",16889501,16899457,9956
"8096","ENSACAG00000010018","GL343213.1",2703710,2780328,76618
"8097","ENSACAG00000010019","GL344255.1",8955,25378,16423
"8098","ENSACAG00000010020","2",157489157,157611931,122774
"8099","ENSACAG00000010021","1",90775988,90810060,34072
"8100","ENSACAG00000010022","4",6255912,6262170,6258
"8101","ENSACAG00000010023","GL343471.1",197150,219417,22267
"8102","ENSACAG00000010025","GL343213.1",2788991,2832854,43863
"8103","ENSACAG00000010026","4",6082134,6251587,169453
"8104","ENSACAG00000010027","GL343204.1",2144030,2219860,75830
"8105","ENSACAG00000010028","4",117913677,117950429,36752
"8106","ENSACAG00000010029","1",170037122,170319456,282334
"8107","ENSACAG00000010030","GL343198.1",1937702,2010926,73224
"8108","ENSACAG00000010031","5",144375189,144381442,6253
"8109","ENSACAG00000010032","GL343471.1",218908,259701,40793
"8110","ENSACAG00000010033","GL343281.1",33185,66604,33419
"8111","ENSACAG00000010035","2",191129089,191167023,37934
"8112","ENSACAG00000010036","1",230931391,230945385,13994
"8113","ENSACAG00000010038","4",82566999,82713101,146102
"8114","ENSACAG00000010041","GL343417.1",352160,380330,28170
"8115","ENSACAG00000010043","AAWZ02041939",370,4308,3938
"8116","ENSACAG00000010044","GL343344.1",759446,799620,40174
"8117","ENSACAG00000010046","GL343665.1",143759,312977,169218
"8118","ENSACAG00000010047","1",77867145,77890913,23768
"8119","ENSACAG00000010048","6",43631662,43672812,41150
"8120","ENSACAG00000010049","1",12278404,12398464,120060
"8121","ENSACAG00000010050","4",11613060,11773040,159980
"8122","ENSACAG00000010051","3",176314907,176315917,1010
"8123","ENSACAG00000010052","GL343467.1",357049,458398,101349
"8124","ENSACAG00000010053","GL343204.1",525082,545960,20878
"8125","ENSACAG00000010054","3",176295249,176299115,3866
"8126","ENSACAG00000010055","GL345033.1",1,11972,11971
"8127","ENSACAG00000010056","3",176283291,176290492,7201
"8128","ENSACAG00000010057","GL343471.1",268234,290160,21926
"8129","ENSACAG00000010058","GL344104.1",24101,42690,18589
"8130","ENSACAG00000010059","5",144386843,144404450,17607
"8131","ENSACAG00000010060","GL344144.1",44071,66729,22658
"8132","ENSACAG00000010061","4",41114829,41165676,50847
"8133","ENSACAG00000010062","4",40941249,40950830,9581
"8134","ENSACAG00000010063","4",124649602,124684270,34668
"8135","ENSACAG00000010065","GL343206.1",1900869,1976782,75913
"8136","ENSACAG00000010066","GL343471.1",373626,408119,34493
"8137","ENSACAG00000010067","4",118051895,118059533,7638
"8138","ENSACAG00000010068","LGc",6589998,6738205,148207
"8139","ENSACAG00000010069","GL343204.1",586495,596194,9699
"8140","ENSACAG00000010070","3",98709053,98710821,1768
"8141","ENSACAG00000010071","1",118936013,119001224,65211
"8142","ENSACAG00000010072","GL343467.1",482111,622276,140165
"8143","ENSACAG00000010073","GL343204.1",600281,637624,37343
"8144","ENSACAG00000010074","4",40666294,40928230,261936
"8145","ENSACAG00000010077","4",118062486,118098807,36321
"8146","ENSACAG00000010078","3",176186135,176196904,10769
"8147","ENSACAG00000010080","1",170788060,171143205,355145
"8148","ENSACAG00000010081","AAWZ02037426",981,2798,1817
"8149","ENSACAG00000010082","GL343344.1",568049,742179,174130
"8150","ENSACAG00000010083","4",40554473,40556163,1690
"8151","ENSACAG00000010084","4",22722671,22755492,32821
"8152","ENSACAG00000010085","GL343281.1",77515,96668,19153
"8153","ENSACAG00000010086","2",16903786,16924343,20557
"8154","ENSACAG00000010087","1",119149092,119149670,578
"8155","ENSACAG00000010088","AAWZ02039081",4549,5643,1094
"8156","ENSACAG00000010089","4",124716470,124717423,953
"8157","ENSACAG00000010090","GL343994.1",6910,9881,2971
"8158","ENSACAG00000010091","4",40390661,40414732,24071
"8159","ENSACAG00000010092","GL343658.1",310393,317902,7509
"8160","ENSACAG00000010093","1",119299304,119365176,65872
"8161","ENSACAG00000010094","2",118178712,118188604,9892
"8162","ENSACAG00000010095","4",124727731,124737731,10000
"8163","ENSACAG00000010098","GL344144.1",41421,44569,3148
"8164","ENSACAG00000010099","1",230920800,230926257,5457
"8165","ENSACAG00000010101","GL344144.1",22650,33134,10484
"8166","ENSACAG00000010103","GL344183.1",26663,32768,6105
"8167","ENSACAG00000010106","GL343425.1",365023,386430,21407
"8168","ENSACAG00000010107","4",5811505,5817703,6198
"8169","ENSACAG00000010109","2",16892487,16947416,54929
"8170","ENSACAG00000010110","3",176111564,176188967,77403
"8171","ENSACAG00000010111","1",77957827,77992994,35167
"8172","ENSACAG00000010112","AAWZ02038458",3623,4559,936
"8173","ENSACAG00000010113","2",137947988,137960498,12510
"8174","ENSACAG00000010114","5",144365885,144373133,7248
"8175","ENSACAG00000010115","GL343417.1",384204,396845,12641
"8176","ENSACAG00000010116","1",230904625,230918866,14241
"8177","ENSACAG00000010117","4",5772450,5808567,36117
"8178","ENSACAG00000010118","GL344494.1",13884,25905,12021
"8179","ENSACAG00000010119","LGc",6753811,6790261,36450
"8180","ENSACAG00000010120","GL343200.1",3191565,3238352,46787
"8181","ENSACAG00000010121","2",138085523,138086642,1119
"8182","ENSACAG00000010122","4",124745410,124749096,3686
"8183","ENSACAG00000010123","GL343471.1",421691,462387,40696
"8184","ENSACAG00000010125","4",124769602,124894765,125163
"8185","ENSACAG00000010126","2",138092351,138103635,11284
"8186","ENSACAG00000010127","GL344494.1",30310,32155,1845
"8187","ENSACAG00000010128","GL343425.1",424005,456815,32810
"8188","ENSACAG00000010130","GL343333.1",1332463,1350074,17611
"8189","ENSACAG00000010131","GL343215.1",1689107,1766274,77167
"8190","ENSACAG00000010132","GL343281.1",102290,111615,9325
"8191","ENSACAG00000010133","1",90749138,90756155,7017
"8192","ENSACAG00000010134","GL343215.1",1603079,1639892,36813
"8193","ENSACAG00000010135","GL343204.1",640233,728265,88032
"8194","ENSACAG00000010136","GL344183.1",123,7882,7759
"8195","ENSACAG00000010137","GL343215.1",1559343,1595449,36106
"8196","ENSACAG00000010139","1",78058801,78085872,27071
"8197","ENSACAG00000010140","GL343206.1",1783094,1843630,60536
"8198","ENSACAG00000010141","2",191052501,191106680,54179
"8199","ENSACAG00000010143","GL343425.1",470915,775664,304749
"8200","ENSACAG00000010144","GL344008.1",4721,27345,22624
"8201","ENSACAG00000010147","2",118191017,118196883,5866
"8202","ENSACAG00000010148","2",7586361,7632592,46231
"8203","ENSACAG00000010149","GL343196.1",848343,860908,12565
"8204","ENSACAG00000010150","1",90714671,90725494,10823
"8205","ENSACAG00000010151","4",118124025,118228762,104737
"8206","ENSACAG00000010153","5",144288193,144337195,49002
"8207","ENSACAG00000010154","6",43523882,43621953,98071
"8208","ENSACAG00000010155","GL343206.1",1643108,1782709,139601
"8209","ENSACAG00000010156","3",175990545,176008200,17655
"8210","ENSACAG00000010157","3",175970476,175987470,16994
"8211","ENSACAG00000010158","GL343281.1",109976,137239,27263
"8212","ENSACAG00000010159","2",138105368,138130039,24671
"8213","ENSACAG00000010160","GL343333.1",1204826,1310041,105215
"8214","ENSACAG00000010161","1",12510658,12522508,11850
"8215","ENSACAG00000010162","5",42396640,42408931,12291
"8216","ENSACAG00000010163","GL344791.1",32,8332,8300
"8217","ENSACAG00000010165","GL344045.1",95887,126444,30557
"8218","ENSACAG00000010167","6",43423759,43429967,6208
"8219","ENSACAG00000010168","1",78142882,78227422,84540
"8220","ENSACAG00000010170","1",113616223,113784982,168759
"8221","ENSACAG00000010171","GL343606.1",348060,348632,572
"8222","ENSACAG00000010172","5",42419469,42477035,57566
"8223","ENSACAG00000010173","2",7530455,7575333,44878
"8224","ENSACAG00000010175","GL343447.1",302315,351826,49511
"8225","ENSACAG00000010176","GL343606.1",329912,342935,13023
"8226","ENSACAG00000010177","3",175965548,175970142,4594
"8227","ENSACAG00000010178","GL343471.1",466040,472236,6196
"8228","ENSACAG00000010179","GL343606.1",315701,329533,13832
"8229","ENSACAG00000010180","GL343204.1",2226175,2265087,38912
"8230","ENSACAG00000010181","GL343333.1",1106842,1205009,98167
"8231","ENSACAG00000010182","1",16287664,16303364,15700
"8232","ENSACAG00000010183","GL343467.1",708014,727932,19918
"8233","ENSACAG00000010184","GL343417.1",397054,400458,3404
"8234","ENSACAG00000010185","6",43209135,43245700,36565
"8235","ENSACAG00000010186","GL343471.1",494708,519318,24610
"8236","ENSACAG00000010188","4",11355689,11474047,118358
"8237","ENSACAG00000010189","3",175953150,175962451,9301
"8238","ENSACAG00000010190","GL343417.1",420256,422394,2138
"8239","ENSACAG00000010191","2",195888391,195907551,19160
"8240","ENSACAG00000010192","2",118197926,118205548,7622
"8241","ENSACAG00000010193","GL343215.1",1526247,1551938,25691
"8242","ENSACAG00000010194","GL343417.1",424647,430396,5749
"8243","ENSACAG00000010195","GL343447.1",356341,390495,34154
"8244","ENSACAG00000010196","AAWZ02037771",1424,14229,12805
"8245","ENSACAG00000010197","GL343206.1",1542686,1556634,13948
"8246","ENSACAG00000010198","4",22032016,22227899,195883
"8247","ENSACAG00000010199","GL343204.1",2295507,2333207,37700
"8248","ENSACAG00000010201","4",82543653,82556692,13039
"8249","ENSACAG00000010202","GL343606.1",252295,311669,59374
"8250","ENSACAG00000010203","4",11247364,11338716,91352
"8251","ENSACAG00000010204","GL343200.1",3239606,3268517,28911
"8252","ENSACAG00000010206","GL344008.1",57400,61011,3611
"8253","ENSACAG00000010208","GL343952.1",85443,103208,17765
"8254","ENSACAG00000010209","3",175805757,175833569,27812
"8255","ENSACAG00000010210","4",5743048,5772864,29816
"8256","ENSACAG00000010211","4",82510544,82538408,27864
"8257","ENSACAG00000010212","GL343206.1",1367534,1416159,48625
"8258","ENSACAG00000010213","2",7073225,7088150,14925
"8259","ENSACAG00000010214","GL343204.1",2381158,2505207,124049
"8260","ENSACAG00000010215","2",118218950,118240942,21992
"8261","ENSACAG00000010216","2",138143791,138212918,69127
"8262","ENSACAG00000010217","1",90638607,90646283,7676
"8263","ENSACAG00000010218","6",42606196,42783108,176912
"8264","ENSACAG00000010219","2",157913858,157915342,1484
"8265","ENSACAG00000010220","2",195991217,196034905,43688
"8266","ENSACAG00000010224","2",157934343,158078618,144275
"8267","ENSACAG00000010225","2",196082230,196103274,21044
"8268","ENSACAG00000010226","GL343200.1",3617268,3712618,95350
"8269","ENSACAG00000010227","1",119408261,119408422,161
"8270","ENSACAG00000010228","GL343333.1",972781,1089524,116743
"8271","ENSACAG00000010229","1",119629499,119789786,160287
"8272","ENSACAG00000010230","2",7014924,7066922,51998
"8273","ENSACAG00000010232","GL343447.1",515825,547797,31972
"8274","ENSACAG00000010233","GL343714.1",336,58101,57765
"8275","ENSACAG00000010234","GL344791.1",14835,16301,1466
"8276","ENSACAG00000010235","5",144157907,144256087,98180
"8277","ENSACAG00000010236","2",6966585,7007886,41301
"8278","ENSACAG00000010237","5",144017983,144065792,47809
"8279","ENSACAG00000010238","LGc",6791359,6798329,6970
"8280","ENSACAG00000010239","4",21554203,21580215,26012
"8281","ENSACAG00000010241","GL343304.1",2140,45005,42865
"8282","ENSACAG00000010242","3",175786389,175798722,12333
"8283","ENSACAG00000010244","GL343304.1",54570,78496,23926
"8284","ENSACAG00000010246","GL343952.1",73165,73555,390
"8285","ENSACAG00000010247","2",118261684,118357322,95638
"8286","ENSACAG00000010248","GL343333.1",829672,841200,11528
"8287","ENSACAG00000010249","LGc",6804695,6826105,21410
"8288","ENSACAG00000010251","GL343952.1",58739,69336,10597
"8289","ENSACAG00000010252","GL343245.1",1060109,1065566,5457
"8290","ENSACAG00000010253","GL344072.1",69448,78985,9537
"8291","ENSACAG00000010254","2",17037777,17059478,21701
"8292","ENSACAG00000010256","1",171178018,171266903,88885
"8293","ENSACAG00000010257","GL343952.1",8855,20641,11786
"8294","ENSACAG00000010258","2",191528129,191552930,24801
"8295","ENSACAG00000010259","GL343467.1",735087,741986,6899
"8296","ENSACAG00000010260","GL343196.1",811784,822734,10950
"8297","ENSACAG00000010261","3",175764454,175786320,21866
"8298","ENSACAG00000010263","GL343245.1",1344953,1361354,16401
"8299","ENSACAG00000010265","GL343471.1",530251,539270,9019
"8300","ENSACAG00000010267","GL343298.1",283065,284039,974
"8301","ENSACAG00000010269","4",124900718,124924821,24103
"8302","ENSACAG00000010270","2",118406271,118407209,938
"8303","ENSACAG00000010271","GL343298.1",19583,268535,248952
"8304","ENSACAG00000010272","GL343467.1",750932,758149,7217
"8305","ENSACAG00000010273","1",90395003,90458517,63514
"8306","ENSACAG00000010276","GL343591.1",243043,256518,13475
"8307","ENSACAG00000010277","GL344084.1",57787,70147,12360
"8308","ENSACAG00000010278","2",118377462,118400345,22883
"8309","ENSACAG00000010279","5",42549705,42815405,265700
"8310","ENSACAG00000010281","GL343245.1",1393826,1422727,28901
"8311","ENSACAG00000010283","GL343446.1",108385,271765,163380
"8312","ENSACAG00000010287","GL343281.1",383478,385890,2412
"8313","ENSACAG00000010288","2",190906735,190983762,77027
"8314","ENSACAG00000010289","GL343606.1",179481,181885,2404
"8315","ENSACAG00000010290","GL343281.1",468064,469085,1021
"8316","ENSACAG00000010291","2",6954344,6964534,10190
"8317","ENSACAG00000010293","GL343281.1",761922,789367,27445
"8318","ENSACAG00000010294","2",173468877,173559110,90233
"8319","ENSACAG00000010295","4",21525609,21539371,13762
"8320","ENSACAG00000010296","GL343606.1",167510,172772,5262
"8321","ENSACAG00000010297","5",104062109,104109091,46982
"8322","ENSACAG00000010299","2",158094041,158180516,86475
"8323","ENSACAG00000010300","GL343606.1",144404,160817,16413
"8324","ENSACAG00000010301","GL343215.1",1505677,1521807,16130
"8325","ENSACAG00000010302","GL343275.1",1375087,1379934,4847
"8326","ENSACAG00000010303","2",6916178,6947156,30978
"8327","ENSACAG00000010304","GL343275.1",1402995,1409378,6383
"8328","ENSACAG00000010305","GL343417.1",432562,459794,27232
"8329","ENSACAG00000010308","GL343198.1",2017002,2026146,9144
"8330","ENSACAG00000010309","GL343447.1",615026,631059,16033
"8331","ENSACAG00000010310","4",11116931,11175486,58555
"8332","ENSACAG00000010312","3",175701753,175761188,59435
"8333","ENSACAG00000010313","GL343200.1",3718296,3758862,40566
"8334","ENSACAG00000010314","2",6856574,6882807,26233
"8335","ENSACAG00000010315","GL343275.1",1422825,1428549,5724
"8336","ENSACAG00000010316","2",118425525,118442804,17279
"8337","ENSACAG00000010317","GL343204.1",2516918,2535687,18769
"8338","ENSACAG00000010318","2",158245000,158273402,28402
"8339","ENSACAG00000010321","2",190380221,190402122,21901
"8340","ENSACAG00000010322","GL343275.1",1454822,1457870,3048
"8341","ENSACAG00000010323","2",17061839,17066528,4689
"8342","ENSACAG00000010324","GL343206.1",1305279,1361740,56461
"8343","ENSACAG00000010325","GL343200.1",3768471,3774524,6053
"8344","ENSACAG00000010326","1",78230900,78241092,10192
"8345","ENSACAG00000010328","4",5512082,5737760,225678
"8346","ENSACAG00000010329","3",108951072,108952187,1115
"8347","ENSACAG00000010331","3",108921707,108946741,25034
"8348","ENSACAG00000010339","GL343206.1",1109603,1135606,26003
"8349","ENSACAG00000010340","GL343204.1",2650531,2656564,6033
"8350","ENSACAG00000010341","GL343516.1",478923,488835,9912
"8351","ENSACAG00000010342","5",42878058,42883441,5383
"8352","ENSACAG00000010344","4",5473344,5488432,15088
"8353","ENSACAG00000010345","GL343620.1",306121,417630,111509
"8354","ENSACAG00000010346","GL343200.1",3915031,4042246,127215
"8355","ENSACAG00000010347","GL343446.1",77470,88184,10714
"8356","ENSACAG00000010348","2",173660193,173660990,797
"8357","ENSACAG00000010349","GL343275.1",1466716,1467155,439
"8358","ENSACAG00000010350","4",82305237,82501588,196351
"8359","ENSACAG00000010351","1",171704373,171724246,19873
"8360","ENSACAG00000010352","GL343204.1",722206,786605,64399
"8361","ENSACAG00000010353","2",17068268,17085954,17686
"8362","ENSACAG00000010356","GL343330.1",1228538,1260645,32107
"8363","ENSACAG00000010357","5",96071075,96071675,600
"8364","ENSACAG00000010358","GL343446.1",43899,63903,20004
"8365","ENSACAG00000010359","1",171721582,171725062,3480
"8366","ENSACAG00000010360","GL343206.1",649407,679804,30397
"8367","ENSACAG00000010361","1",119835491,119838572,3081
"8368","ENSACAG00000010362","1",225317209,225373208,55999
"8369","ENSACAG00000010363","4",5059333,5060169,836
"8370","ENSACAG00000010364","GL343275.1",1471904,1474322,2418
"8371","ENSACAG00000010365","GL343215.1",1485372,1492946,7574
"8372","ENSACAG00000010366","GL343400.1",53222,64987,11765
"8373","ENSACAG00000010368","2",190718553,190783194,64641
"8374","ENSACAG00000010369","2",191809880,191810494,614
"8375","ENSACAG00000010370","2",191899771,191910091,10320
"8376","ENSACAG00000010371","1",171734280,171806846,72566
"8377","ENSACAG00000010372","4",4599220,4610850,11630
"8378","ENSACAG00000010374","GL343206.1",387983,421736,33753
"8379","ENSACAG00000010376","4",3896739,3954368,57629
"8380","ENSACAG00000010377","GL343281.1",884957,903915,18958
"8381","ENSACAG00000010378","GL343714.1",81017,108756,27739
"8382","ENSACAG00000010379","2",17093009,17122348,29339
"8383","ENSACAG00000010381","1",78246630,78880120,633490
"8384","ENSACAG00000010384","1",119878785,119923750,44965
"8385","ENSACAG00000010386","GL343434.1",730965,746895,15930
"8386","ENSACAG00000010387","GL344885.1",331,17711,17380
"8387","ENSACAG00000010388","3",149141941,149143357,1416
"8388","ENSACAG00000010390","GL343275.1",1489989,1492053,2064
"8389","ENSACAG00000010391","GL343281.1",924786,928669,3883
"8390","ENSACAG00000010392","2",190317972,190343922,25950
"8391","ENSACAG00000010393","4",124951340,125077089,125749
"8392","ENSACAG00000010395","2",191912794,191954773,41979
"8393","ENSACAG00000010398","4",21492586,21507712,15126
"8394","ENSACAG00000010400","3",108910176,108919134,8958
"8395","ENSACAG00000010401","GL343275.1",1494486,1527894,33408
"8396","ENSACAG00000010402","GL343516.1",457123,464117,6994
"8397","ENSACAG00000010410","GL343281.1",1123064,1138592,15528
"8398","ENSACAG00000010411","AAWZ02040249",1048,3180,2132
"8399","ENSACAG00000010412","GL343379.1",799183,956371,157188
"8400","ENSACAG00000010413","2",118464020,118464706,686
"8401","ENSACAG00000010415","4",3711435,3874506,163071
"8402","ENSACAG00000010416","5",42900651,42908629,7978
"8403","ENSACAG00000010417","4",11054005,11054748,743
"8404","ENSACAG00000010418","4",10885850,10916556,30706
"8405","ENSACAG00000010419","5",42909871,42935984,26113
"8406","ENSACAG00000010420","GL343215.1",1470410,1477842,7432
"8407","ENSACAG00000010421","1",171814889,171847107,32218
"8408","ENSACAG00000010422","3",108872874,108909824,36950
"8409","ENSACAG00000010423","GL343206.1",80785,82599,1814
"8410","ENSACAG00000010425","2",175893136,176216916,323780
"8411","ENSACAG00000010426","GL344824.1",5284,18012,12728
"8412","ENSACAG00000010427","GL343681.1",198715,199770,1055
"8413","ENSACAG00000010428","GL344072.1",46733,64407,17674
"8414","ENSACAG00000010429","1",191539369,191540659,1290
"8415","ENSACAG00000010430","GL343275.1",1530375,1532456,2081
"8416","ENSACAG00000010431","1",225476371,225489524,13153
"8417","ENSACAG00000010432","1",120000323,120054786,54463
"8418","ENSACAG00000010433","GL343204.1",1234849,1479528,244679
"8419","ENSACAG00000010434","2",118482249,118490171,7922
"8420","ENSACAG00000010435","GL343516.1",424327,443693,19366
"8421","ENSACAG00000010436","GL343681.1",204801,230877,26076
"8422","ENSACAG00000010437","2",193493147,193519599,26452
"8423","ENSACAG00000010438","2",196129203,196129856,653
"8424","ENSACAG00000010440","4",21463102,21484645,21543
"8425","ENSACAG00000010441","GL343215.1",1447009,1447458,449
"8426","ENSACAG00000010442","2",195256558,195278379,21821
"8427","ENSACAG00000010443","GL343215.1",1389226,1438920,49694
"8428","ENSACAG00000010444","AAWZ02041587",1090,4649,3559
"8429","ENSACAG00000010445","GL343714.1",115135,214110,98975
"8430","ENSACAG00000010447","GL343379.1",602515,750015,147500
"8431","ENSACAG00000010449","GL343891.1",47120,50241,3121
"8432","ENSACAG00000010451","GL343434.1",670616,700655,30039
"8433","ENSACAG00000010453","GL343516.1",392295,414902,22607
"8434","ENSACAG00000010454","2",6803921,6825837,21916
"8435","ENSACAG00000010455","GL343275.1",1657982,1786821,128839
"8436","ENSACAG00000010457","GL343926.1",1520,45625,44105
"8437","ENSACAG00000010458","3",153714260,153758173,43913
"8438","ENSACAG00000010459","GL343281.1",1239815,1441736,201921
"8439","ENSACAG00000010461","2",6594740,6669297,74557
"8440","ENSACAG00000010464","LGc",6883422,6884756,1334
"8441","ENSACAG00000010465","1",225512476,225546348,33872
"8442","ENSACAG00000010466","3",108603203,108647179,43976
"8443","ENSACAG00000010469","GL343397.1",285973,506948,220975
"8444","ENSACAG00000010470","LGc",6922942,6936247,13305
"8445","ENSACAG00000010471","GL343379.1",249625,510771,261146
"8446","ENSACAG00000010472","4",21450950,21462995,12045
"8447","ENSACAG00000010473","GL343891.1",55297,85193,29896
"8448","ENSACAG00000010474","4",82255598,82262191,6593
"8449","ENSACAG00000010475","2",190551950,190651879,99929
"8450","ENSACAG00000010477","1",90367414,90393866,26452
"8451","ENSACAG00000010478","2",195289528,195304595,15067
"8452","ENSACAG00000010479","GL343200.1",4366532,4375672,9140
"8453","ENSACAG00000010481","5",43083014,43142183,59169
"8454","ENSACAG00000010483","GL343358.1",94974,114691,19717
"8455","ENSACAG00000010484","2",195168035,195181499,13464
"8456","ENSACAG00000010485","3",108516913,108523288,6375
"8457","ENSACAG00000010486","GL344674.1",46,10798,10752
"8458","ENSACAG00000010487","2",195149710,195161161,11451
"8459","ENSACAG00000010488","4",82221188,82249310,28122
"8460","ENSACAG00000010489","1",155040582,155080290,39708
"8461","ENSACAG00000010490","1",120160338,120161432,1094
"8462","ENSACAG00000010491","1",155114854,155172944,58090
"8463","ENSACAG00000010492","2",118494947,118520398,25451
"8464","ENSACAG00000010493","GL343215.1",1307729,1349020,41291
"8465","ENSACAG00000010495","1",120295512,120321722,26210
"8466","ENSACAG00000010496","3",108454967,108514903,59936
"8467","ENSACAG00000010497","5",103977761,103985160,7399
"8468","ENSACAG00000010498","1",171857651,171863506,5855
"8469","ENSACAG00000010500","3",154400131,154477727,77596
"8470","ENSACAG00000010501","5",103910764,103944717,33953
"8471","ENSACAG00000010502","GL343200.1",4388066,4417033,28967
"8472","ENSACAG00000010503","2",17131212,17139553,8341
"8473","ENSACAG00000010504","GL343358.1",186260,346795,160535
"8474","ENSACAG00000010505","1",225557366,225580060,22694
"8475","ENSACAG00000010506","GL343443.1",18612,68893,50281
"8476","ENSACAG00000010508","2",17183439,17203894,20455
"8477","ENSACAG00000010509","GL343516.1",357601,389538,31937
"8478","ENSACAG00000010510","GL343281.1",1713612,1719083,5471
"8479","ENSACAG00000010511","1",171868531,171903374,34843
"8480","ENSACAG00000010512","GL343358.1",364183,972391,608208
"8481","ENSACAG00000010513","GL343245.1",1542363,1582464,40101
"8482","ENSACAG00000010514","5",103511228,103642126,130898
"8483","ENSACAG00000010515","AAWZ02038667",89,7557,7468
"8484","ENSACAG00000010516","4",21412363,21443997,31634
"8485","ENSACAG00000010517","2",191956777,192012930,56153
"8486","ENSACAG00000010518","GL343281.1",1620882,1642546,21664
"8487","ENSACAG00000010519","2",198156778,198164455,7677
"8488","ENSACAG00000010521","2",194937440,194954490,17050
"8489","ENSACAG00000010522","GL343200.1",4437940,4448295,10355
"8490","ENSACAG00000010523","GL343327.1",1345,526928,525583
"8491","ENSACAG00000010524","1",172088627,172150007,61380
"8492","ENSACAG00000010526","2",118563537,118566808,3271
"8493","ENSACAG00000010527","3",175681573,175699943,18370
"8494","ENSACAG00000010529","2",194840020,194915535,75515
"8495","ENSACAG00000010532","2",194885249,194899810,14561
"8496","ENSACAG00000010533","2",17203742,17274996,71254
"8497","ENSACAG00000010535","2",194779151,194808567,29416
"8498","ENSACAG00000010536","1",173346650,173449649,102999
"8499","ENSACAG00000010538","GL343822.1",8910,24351,15441
"8500","ENSACAG00000010539","2",118584879,118588892,4013
"8501","ENSACAG00000010540","GL343531.1",181078,182849,1771
"8502","ENSACAG00000010543","2",190284345,190296407,12062
"8503","ENSACAG00000010544","4",21219688,21228532,8844
"8504","ENSACAG00000010547","GL343775.1",20845,38928,18083
"8505","ENSACAG00000010548","5",43147073,43161147,14074
"8506","ENSACAG00000010549","GL343253.1",10374,24003,13629
"8507","ENSACAG00000010551","4",21118966,21167592,48626
"8508","ENSACAG00000010552","GL343245.1",1590000,1638462,48462
"8509","ENSACAG00000010555","GL343379.1",220304,248813,28509
"8510","ENSACAG00000010556","5",103463737,103514447,50710
"8511","ENSACAG00000010558","GL343215.1",1273714,1294087,20373
"8512","ENSACAG00000010559","GL343891.1",91820,124423,32603
"8513","ENSACAG00000010560","3",175662456,175676301,13845
"8514","ENSACAG00000010561","GL343397.1",763272,774591,11319
"8515","ENSACAG00000010562","GL344238.1",6227,9201,2974
"8516","ENSACAG00000010564","GL343304.1",97013,115299,18286
"8517","ENSACAG00000010566","1",113528592,113590555,61963
"8518","ENSACAG00000010567","3",120920883,121096130,175247
"8519","ENSACAG00000010569","GL343200.1",4463427,4464437,1010
"8520","ENSACAG00000010570","2",118615571,118636374,20803
"8521","ENSACAG00000010571","GL344238.1",26000,35192,9192
"8522","ENSACAG00000010572","GL343443.1",89935,150175,60240
"8523","ENSACAG00000010574","GL343200.1",4484200,4485258,1058
"8524","ENSACAG00000010575","GL343397.1",844474,862627,18153
"8525","ENSACAG00000010576","3",175648907,175663334,14427
"8526","ENSACAG00000010578","2",194724311,194762482,38171
"8527","ENSACAG00000010579","GL343200.1",4505253,4532948,27695
"8528","ENSACAG00000010581","GL343831.1",18894,53668,34774
"8529","ENSACAG00000010582","GL343636.1",181341,194241,12900
"8530","ENSACAG00000010583","GL343236.1",282176,319698,37522
"8531","ENSACAG00000010585","GL343379.1",89991,209841,119850
"8532","ENSACAG00000010586","2",194656934,194715179,58245
"8533","ENSACAG00000010587","GL344238.1",45779,67042,21263
"8534","ENSACAG00000010588","GL343397.1",865341,901460,36119
"8535","ENSACAG00000010589","GL343636.1",210138,275375,65237
"8536","ENSACAG00000010590","5",143911632,143980716,69084
"8537","ENSACAG00000010591","4",125098538,125101726,3188
"8538","ENSACAG00000010592","GL343443.1",155784,170476,14692
"8539","ENSACAG00000010593","GL343215.1",1241059,1257710,16651
"8540","ENSACAG00000010595","GL343516.1",352103,356354,4251
"8541","ENSACAG00000010597","3",175559948,175648592,88644
"8542","ENSACAG00000010598","4",3427098,3572891,145793
"8543","ENSACAG00000010599","2",6576670,6595166,18496
"8544","ENSACAG00000010600","5",103391406,103433008,41602
"8545","ENSACAG00000010601","5",143164385,143185491,21106
"8546","ENSACAG00000010602","GL343281.1",1719156,1730561,11405
"8547","ENSACAG00000010604","GL343417.1",748458,758648,10190
"8548","ENSACAG00000010605","1",6142212,6143564,1352
"8549","ENSACAG00000010606","4",21080763,21093996,13233
"8550","ENSACAG00000010609","AAWZ02037261",5640,15727,10087
"8551","ENSACAG00000010611","4",105280620,105377562,96942
"8552","ENSACAG00000010612","2",6561034,6573776,12742
"8553","ENSACAG00000010614","1",155218841,155247716,28875
"8554","ENSACAG00000010616","1",78925756,78946106,20350
"8555","ENSACAG00000010617","GL343215.1",1215227,1219022,3795
"8556","ENSACAG00000010619","5",143157738,143158271,533
"8557","ENSACAG00000010620","GL343215.1",899473,922380,22907
"8558","ENSACAG00000010622","6",4502176,4512089,9913
"8559","ENSACAG00000010623","5",143082607,143154959,72352
"8560","ENSACAG00000010624","3",121143649,121169026,25377
"8561","ENSACAG00000010625","GL344906.1",1382,7292,5910
"8562","ENSACAG00000010626","5",27471543,27484767,13224
"8563","ENSACAG00000010627","GL343516.1",322262,338984,16722
"8564","ENSACAG00000010628","5",43173848,43181963,8115
"8565","ENSACAG00000010629","6",4522009,4550009,28000
"8566","ENSACAG00000010630","1",6050723,6134698,83975
"8567","ENSACAG00000010631","AAWZ02039108",1603,9454,7851
"8568","ENSACAG00000010632","3",121169436,121203896,34460
"8569","ENSACAG00000010633","2",6280518,6453235,172717
"8570","ENSACAG00000010634","2",118655076,118659001,3925
"8571","ENSACAG00000010635","GL343443.1",173242,184754,11512
"8572","ENSACAG00000010636","5",142986027,143031980,45953
"8573","ENSACAG00000010637","2",118662186,118667480,5294
"8574","ENSACAG00000010639","2",118685374,118730383,45009
"8575","ENSACAG00000010640","1",78988152,79253423,265271
"8576","ENSACAG00000010642","2",192015083,192044870,29787
"8577","ENSACAG00000010643","1",113465920,113497825,31905
"8578","ENSACAG00000010644","5",27524193,27540301,16108
"8579","ENSACAG00000010645","GL343636.1",277437,291379,13942
"8580","ENSACAG00000010646","AAWZ02038925",380,3935,3555
"8581","ENSACAG00000010647","2",190114981,190132438,17457
"8582","ENSACAG00000010648","5",27571877,27589379,17502
"8583","ENSACAG00000010649","AAWZ02040013",2204,2462,258
"8584","ENSACAG00000010650","GL343253.1",38475,45019,6544
"8585","ENSACAG00000010651","3",175500855,175535157,34302
"8586","ENSACAG00000010652","1",158047616,158048658,1042
"8587","ENSACAG00000010653","GL343485.1",190181,443077,252896
"8588","ENSACAG00000010655","GL343281.1",1797109,1798167,1058
"8589","ENSACAG00000010657","GL343443.1",186806,208491,21685
"8590","ENSACAG00000010658","AAWZ02037681",2920,4064,1144
"8591","ENSACAG00000010659","2",194563856,194613786,49930
"8592","ENSACAG00000010660","GL343215.1",658203,834975,176772
"8593","ENSACAG00000010661","AAWZ02041818",3377,5222,1845
"8594","ENSACAG00000010662","5",142951357,142979538,28181
"8595","ENSACAG00000010663","GL343417.1",760187,777215,17028
"8596","ENSACAG00000010664","GL343253.1",56039,76097,20058
"8597","ENSACAG00000010665","1",155258630,155259223,593
"8598","ENSACAG00000010667","GL343636.1",307483,326765,19282
"8599","ENSACAG00000010668","3",121348378,121366619,18241
"8600","ENSACAG00000010669","1",155443889,155487551,43662
"8601","ENSACAG00000010670","AAWZ02037681",4902,13862,8960
"8602","ENSACAG00000010673","GL343215.1",14450,565732,551282
"8603","ENSACAG00000010674","AAWZ02036802",2130,10928,8798
"8604","ENSACAG00000010675","2",138263469,138302996,39527
"8605","ENSACAG00000010676","1",155514040,155526322,12282
"8606","ENSACAG00000010677","1",113397808,113417747,19939
"8607","ENSACAG00000010678","4",170204,240231,70027
"8608","ENSACAG00000010679","GL343839.1",8233,28752,20519
"8609","ENSACAG00000010680","1",155543644,155644220,100576
"8610","ENSACAG00000010681","3",175336625,175355099,18474
"8611","ENSACAG00000010682","AAWZ02041686",279,4334,4055
"8612","ENSACAG00000010683","GL343982.1",6791,26913,20122
"8613","ENSACAG00000010684","GL343516.1",305626,314174,8548
"8614","ENSACAG00000010685","GL343996.1",23739,34667,10928
"8615","ENSACAG00000010686","1",191461288,191492470,31182
"8616","ENSACAG00000010687","2",194450333,194510770,60437
"8617","ENSACAG00000010688","GL343310.1",1157698,1383312,225614
"8618","ENSACAG00000010689","2",6264210,6273266,9056
"8619","ENSACAG00000010690","5",43196008,43198493,2485
"8620","ENSACAG00000010691","2",64182752,64184614,1862
"8621","ENSACAG00000010692","1",155809827,155867934,58107
"8622","ENSACAG00000010693","3",175139922,175161625,21703
"8623","ENSACAG00000010694","GL343253.1",90437,112852,22415
"8624","ENSACAG00000010695","1",206175441,206178712,3271
"8625","ENSACAG00000010696","2",17342498,17434827,92329
"8626","ENSACAG00000010697","2",64380844,64403289,22445
"8627","ENSACAG00000010698","GL343253.1",119455,130809,11354
"8628","ENSACAG00000010699","2",118718177,118719168,991
"8629","ENSACAG00000010700","GL343417.1",779649,782577,2928
"8630","ENSACAG00000010702","2",6211638,6229101,17463
"8631","ENSACAG00000010703","2",118760589,118776177,15588
"8632","ENSACAG00000010704","5",142563237,142660215,96978
"8633","ENSACAG00000010705","GL343310.1",1085433,1094480,9047
"8634","ENSACAG00000010707","6",5167105,5421579,254474
"8635","ENSACAG00000010708","5",43273674,43291199,17525
"8636","ENSACAG00000010709","GL343245.1",1659894,1684970,25076
"8637","ENSACAG00000010710","5",27598925,27599569,644
"8638","ENSACAG00000010711","GL343253.1",141822,146201,4379
"8639","ENSACAG00000010716","5",27642827,27643234,407
"8640","ENSACAG00000010717","5",27656127,27673259,17132
"8641","ENSACAG00000010718","GL344399.1",5845,10661,4816
"8642","ENSACAG00000010719","AAWZ02037681",14519,15066,547
"8643","ENSACAG00000010720","3",175104604,175123679,19075
"8644","ENSACAG00000010721","2",6168095,6186779,18684
"8645","ENSACAG00000010722","GL344399.1",20868,36958,16090
"8646","ENSACAG00000010723","GL343508.1",371941,372621,680
"8647","ENSACAG00000010725","3",175089188,175096042,6854
"8648","ENSACAG00000010726","GL343417.1",785376,794908,9532
"8649","ENSACAG00000010727","1",113358751,113395510,36759
"8650","ENSACAG00000010728","1",79255965,79271479,15514
"8651","ENSACAG00000010730","GL343575.1",4722,7769,3047
"8652","ENSACAG00000010731","5",43297880,43323215,25335
"8653","ENSACAG00000010732","GL343529.1",329382,415199,85817
"8654","ENSACAG00000010734","GL343516.1",301415,304397,2982
"8655","ENSACAG00000010735","1",6024977,6038048,13071
"8656","ENSACAG00000010737","2",6150939,6167805,16866
"8657","ENSACAG00000010739","1",191545086,191612701,67615
"8658","ENSACAG00000010740","GL343417.1",795284,804962,9678
"8659","ENSACAG00000010743","2",118783577,118791167,7590
"8660","ENSACAG00000010744","GL343253.1",224859,226632,1773
"8661","ENSACAG00000010745","GL343516.1",290808,293314,2506
"8662","ENSACAG00000010746","GL344095.1",15620,28012,12392
"8663","ENSACAG00000010748","GL343253.1",318758,332387,13629
"8664","ENSACAG00000010749","GL343969.1",180762,201594,20832
"8665","ENSACAG00000010750","1",113346107,113354783,8676
"8666","ENSACAG00000010751","GL343317.1",705627,709955,4328
"8667","ENSACAG00000010752","2",189705254,189925347,220093
"8668","ENSACAG00000010753","GL343529.1",139518,291274,151756
"8669","ENSACAG00000010754","GL343516.1",283987,292080,8093
"8670","ENSACAG00000010755","2",192052143,192060319,8176
"8671","ENSACAG00000010756","2",118795205,118817357,22152
"8672","ENSACAG00000010758","GL343443.1",226233,237335,11102
"8673","ENSACAG00000010759","GL343236.1",440323,516732,76409
"8674","ENSACAG00000010760","GL343253.1",344362,345318,956
"8675","ENSACAG00000010761","2",64416410,64534365,117955
"8676","ENSACAG00000010763","1",6002325,6024410,22085
"8677","ENSACAG00000010764","GL343417.1",803944,812697,8753
"8678","ENSACAG00000010767","GL343529.1",74398,126070,51672
"8679","ENSACAG00000010768","1",79289270,79290680,1410
"8680","ENSACAG00000010769","3",175028680,175056390,27710
"8681","ENSACAG00000010771","GL343245.1",1716202,1776649,60447
"8682","ENSACAG00000010772","GL343253.1",493847,512660,18813
"8683","ENSACAG00000010773","AAWZ02040488",128,4390,4262
"8684","ENSACAG00000010774","1",79492168,79570603,78435
"8685","ENSACAG00000010776","4",105394305,105489223,94918
"8686","ENSACAG00000010778","GL343538.1",37061,62541,25480
"8687","ENSACAG00000010780","AAWZ02037795",3613,9894,6281
"8688","ENSACAG00000010781","2",64605388,64623839,18451
"8689","ENSACAG00000010782","GL343443.1",246923,295042,48119
"8690","ENSACAG00000010783","4",240687,266052,25365
"8691","ENSACAG00000010784","5",27684518,27685294,776
"8692","ENSACAG00000010785","1",5946652,5996215,49563
"8693","ENSACAG00000010786","5",27679164,27680661,1497
"8694","ENSACAG00000010788","1",113141563,113343720,202157
"8695","ENSACAG00000010789","AAWZ02039226",1244,1757,513
"8696","ENSACAG00000010790","GL344419.1",635,12224,11589
"8697","ENSACAG00000010791","GL343839.1",33350,42398,9048
"8698","ENSACAG00000010792","5",27709526,27723015,13489
"8699","ENSACAG00000010793","AAWZ02038835",63,10242,10179
"8700","ENSACAG00000010795","5",27756556,27790802,34246
"8701","ENSACAG00000010796","AAWZ02040460",2022,6141,4119
"8702","ENSACAG00000010797","2",6073409,6084722,11313
"8703","ENSACAG00000010798","GL343388.1",136231,151024,14793
"8704","ENSACAG00000010800","2",192062443,192097522,35079
"8705","ENSACAG00000010801","2",6038279,6063564,25285
"8706","ENSACAG00000010802","GL343988.1",3306,4400,1094
"8707","ENSACAG00000010805","GL343988.1",4165,47292,43127
"8708","ENSACAG00000010806","GL343676.1",226652,245929,19277
"8709","ENSACAG00000010807","4",268852,299768,30916
"8710","ENSACAG00000010808","GL344606.1",1170,5601,4431
"8711","ENSACAG00000010809","GL343529.1",38766,74916,36150
"8712","ENSACAG00000010811","5",27794455,27803171,8716
"8713","ENSACAG00000010812","GL343607.1",349239,367943,18704
"8714","ENSACAG00000010813","GL343204.1",2893149,2925520,32371
"8715","ENSACAG00000010814","4",319630,489150,169520
"8716","ENSACAG00000010815","GL343410.1",505548,591291,85743
"8717","ENSACAG00000010816","1",51914548,51918536,3988
"8718","ENSACAG00000010817","GL344600.1",21,11327,11306
"8719","ENSACAG00000010818","AAWZ02037473",2202,6151,3949
"8720","ENSACAG00000010820","GL344288.1",16254,43885,27631
"8721","ENSACAG00000010821","AAWZ02041529",3693,5527,1834
"8722","ENSACAG00000010823","GL343422.1",686763,721256,34493
"8723","ENSACAG00000010826","GL343229.1",118119,118403,284
"8724","ENSACAG00000010828","AAWZ02039400",317,7728,7411
"8725","ENSACAG00000010829","2",72155534,72161803,6269
"8726","ENSACAG00000010831","GL344606.1",8966,12824,3858
"8727","ENSACAG00000010832","2",118814120,118876266,62146
"8728","ENSACAG00000010833","GL343304.1",119261,141798,22537
"8729","ENSACAG00000010834","3",175006051,175015589,9538
"8730","ENSACAG00000010835","GL344288.1",4014,6319,2305
"8731","ENSACAG00000010836","1",155918925,155923253,4328
"8732","ENSACAG00000010837","2",118927379,119032461,105082
"8733","ENSACAG00000010838","4",35844295,36003382,159087
"8734","ENSACAG00000010841","4",6974384,6987759,13375
"8735","ENSACAG00000010842","5",43338252,43357290,19038
"8736","ENSACAG00000010843","2",64685422,64709908,24486
"8737","ENSACAG00000010844","GL344301.1",21,38950,38929
"8738","ENSACAG00000010846","GL344007.1",85722,96786,11064
"8739","ENSACAG00000010847","GL343538.1",116389,131026,14637
"8740","ENSACAG00000010848","2",72097982,72102430,4448
"8741","ENSACAG00000010849","5",27857234,27915974,58740
"8742","ENSACAG00000010850","GL344326.1",14339,40474,26135
"8743","ENSACAG00000010851","GL343204.1",2958326,3008993,50667
"8744","ENSACAG00000010852","GL344497.1",9235,18565,9330
"8745","ENSACAG00000010853","GL344606.1",14107,16473,2366
"8746","ENSACAG00000010854","GL343529.1",980,42535,41555
"8747","ENSACAG00000010855","2",72078969,72085579,6610
"8748","ENSACAG00000010856","GL344703.1",2951,22795,19844
"8749","ENSACAG00000010857","2",17440355,17478109,37754
"8750","ENSACAG00000010858","GL343346.1",493482,497561,4079
"8751","ENSACAG00000010860","AAWZ02038207",3409,9140,5731
"8752","ENSACAG00000010861","1",144564424,144751417,186993
"8753","ENSACAG00000010862","1",5765810,5884874,119064
"8754","ENSACAG00000010865","AAWZ02036468",1901,24750,22849
"8755","ENSACAG00000010866","GL343422.1",524445,536839,12394
"8756","ENSACAG00000010867","2",6011909,6037800,25891
"8757","ENSACAG00000010868","GL343479.1",25971,56763,30792
"8758","ENSACAG00000010869","GL344606.1",19049,26968,7919
"8759","ENSACAG00000010870","AAWZ02037270",105,17549,17444
"8760","ENSACAG00000010872","GL343388.1",202405,226057,23652
"8761","ENSACAG00000010873","4",105516122,105536216,20094
"8762","ENSACAG00000010875","3",189305678,189332307,26629
"8763","ENSACAG00000010877","1",191619626,191721777,102151
"8764","ENSACAG00000010878","GL344007.1",72318,80429,8111
"8765","ENSACAG00000010879","GL343538.1",146258,158851,12593
"8766","ENSACAG00000010881","GL343847.1",38,11860,11822
"8767","ENSACAG00000010883","2",194389053,194444873,55820
"8768","ENSACAG00000010885","2",160044020,160085807,41787
"8769","ENSACAG00000010887","AAWZ02039479",558,7763,7205
"8770","ENSACAG00000010888","GL343236.1",531484,532791,1307
"8771","ENSACAG00000010889","GL343291.1",732962,828849,95887
"8772","ENSACAG00000010891","3",174911192,174949257,38065
"8773","ENSACAG00000010892","GL343194.1",3378016,3405609,27593
"8774","ENSACAG00000010893","GL343346.1",423369,435343,11974
"8775","ENSACAG00000010894","AAWZ02037276",279,14202,13923
"8776","ENSACAG00000010895","2",72063430,72065916,2486
"8777","ENSACAG00000010896","1",191741401,191753554,12153
"8778","ENSACAG00000010897","5",27929166,27929714,548
"8779","ENSACAG00000010899","5",12878043,13040564,162521
"8780","ENSACAG00000010900","GL344239.1",1549,67214,65665
"8781","ENSACAG00000010902","GL343236.1",557675,591110,33435
"8782","ENSACAG00000010904","5",27941160,27964468,23308
"8783","ENSACAG00000010905","6",5437876,5460293,22417
"8784","ENSACAG00000010906","2",72050329,72055688,5359
"8785","ENSACAG00000010909","4",7050808,7082307,31499
"8786","ENSACAG00000010910","GL343304.1",161038,189468,28430
"8787","ENSACAG00000010912","GL343676.1",254814,255488,674
"8788","ENSACAG00000010913","2",5939493,5998221,58728
"8789","ENSACAG00000010914","1",113000007,113122231,122224
"8790","ENSACAG00000010916","4",105565530,105583684,18154
"8791","ENSACAG00000010917","2",72026523,72028135,1612
"8792","ENSACAG00000010918","GL344365.1",447,6133,5686
"8793","ENSACAG00000010920","GL343330.1",1093706,1292239,198533
"8794","ENSACAG00000010921","GL345063.1",533,5916,5383
"8795","ENSACAG00000010922","GL343204.1",3047114,3303204,256090
"8796","ENSACAG00000010923","2",192101603,192113494,11891
"8797","ENSACAG00000010925","GL344313.1",393,19087,18694
"8798","ENSACAG00000010927","2",72020531,72022726,2195
"8799","ENSACAG00000010928","GL343388.1",251132,260400,9268
"8800","ENSACAG00000010930","GL343253.1",927463,936122,8659
"8801","ENSACAG00000010932","2",68349533,68381138,31605
"8802","ENSACAG00000010933","GL343236.1",602673,619854,17181
"8803","ENSACAG00000010934","5",15411205,15441612,30407
"8804","ENSACAG00000010935","GL343236.1",653554,660176,6622
"8805","ENSACAG00000010936","GL344221.1",25,20967,20942
"8806","ENSACAG00000010939","GL343746.1",7339,64060,56721
"8807","ENSACAG00000010941","1",191757812,191784001,26189
"8808","ENSACAG00000010943","AAWZ02035238",29412,44997,15585
"8809","ENSACAG00000010944","5",35045700,35098179,52479
"8810","ENSACAG00000010946","3",189387188,189618089,230901
"8811","ENSACAG00000010947","GL343551.1",200465,218220,17755
"8812","ENSACAG00000010949","5",43359712,43373489,13777
"8813","ENSACAG00000010950","GL343619.1",122304,221724,99420
"8814","ENSACAG00000010952","2",192116099,192148981,32882
"8815","ENSACAG00000010954","GL343253.1",1075554,1076525,971
"8816","ENSACAG00000010955","2",71987091,71988948,1857
"8817","ENSACAG00000010957","GL343236.1",668200,680830,12630
"8818","ENSACAG00000010958","GL343443.1",353591,390584,36993
"8819","ENSACAG00000010959","GL344007.1",58141,66403,8262
"8820","ENSACAG00000010960","4",105650469,105651851,1382
"8821","ENSACAG00000010961","AAWZ02037420",1270,12171,10901
"8822","ENSACAG00000010962","1",5642332,5731139,88807
"8823","ENSACAG00000010963","4",105735873,105737237,1364
"8824","ENSACAG00000010964","GL344313.1",22075,43850,21775
"8825","ENSACAG00000010965","2",17481686,17487106,5420
"8826","ENSACAG00000010966","GL343443.1",394065,411678,17613
"8827","ENSACAG00000010967","GL343275.1",1540176,1545152,4976
"8828","ENSACAG00000010968","GL343388.1",271368,284967,13599
"8829","ENSACAG00000010969","3",174771283,174897688,126405
"8830","ENSACAG00000010970","4",105749998,105780337,30339
"8831","ENSACAG00000010972","6",5482249,5492133,9884
"8832","ENSACAG00000010973","1",206001639,206011792,10153
"8833","ENSACAG00000010974","GL343551.1",224860,253558,28698
"8834","ENSACAG00000010976","GL343204.1",3554375,3563123,8748
"8835","ENSACAG00000010980","GL343253.1",531468,549616,18148
"8836","ENSACAG00000010981","GL343422.1",428479,514047,85568
"8837","ENSACAG00000010982","GL343479.1",102736,166029,63293
"8838","ENSACAG00000010984","GL343304.1",201488,224822,23334
"8839","ENSACAG00000010985","3",174563295,174606959,43664
"8840","ENSACAG00000010987","AAWZ02040106",21,5874,5853
"8841","ENSACAG00000010989","GL343740.1",65557,185596,120039
"8842","ENSACAG00000010992","GL343516.1",235225,282822,47597
"8843","ENSACAG00000010993","GL344007.1",2097,42528,40431
"8844","ENSACAG00000010994","2",68138387,68157352,18965
"8845","ENSACAG00000010995","4",517269,559198,41929
"8846","ENSACAG00000010996","2",189658291,189667266,8975
"8847","ENSACAG00000010997","6",5579862,5590325,10463
"8848","ENSACAG00000010998","2",17489364,17537800,48436
"8849","ENSACAG00000010999","2",71533048,71547058,14010
"8850","ENSACAG00000011000","6",5774071,5822281,48210
"8851","ENSACAG00000011002","GL343253.1",1238570,1243986,5416
"8852","ENSACAG00000011003","1",205895974,205908226,12252
"8853","ENSACAG00000011004","1",191837089,191977741,140652
"8854","ENSACAG00000011005","GL343204.1",3676397,3718001,41604
"8855","ENSACAG00000011006","GL343884.1",123099,138373,15274
"8856","ENSACAG00000011009","GL343236.1",699312,733480,34168
"8857","ENSACAG00000011010","1",205796466,205827759,31293
"8858","ENSACAG00000011011","2",64717580,64924025,206445
"8859","ENSACAG00000011013","1",5369370,5554696,185326
"8860","ENSACAG00000011014","5",27969423,27998089,28666
"8861","ENSACAG00000011017","GL343740.1",52156,64188,12032
"8862","ENSACAG00000011018","6",5706524,5712831,6307
"8863","ENSACAG00000011020","GL343204.1",3932421,4009127,76706
"8864","ENSACAG00000011022","5",43399150,43416058,16908
"8865","ENSACAG00000011023","GL343253.1",1357918,1361529,3611
"8866","ENSACAG00000011024","5",15482953,15558464,75511
"8867","ENSACAG00000011025","GL343212.1",250893,264063,13170
"8868","ENSACAG00000011026","GL344594.1",14413,27119,12706
"8869","ENSACAG00000011027","5",28006124,28044724,38600
"8870","ENSACAG00000011028","2",160094840,160140404,45564
"8871","ENSACAG00000011029","1",79578038,79599648,21610
"8872","ENSACAG00000011033","GL343388.1",918083,926352,8269
"8873","ENSACAG00000011034","GL343443.1",421176,501908,80732
"8874","ENSACAG00000011035","6",5834727,5910987,76260
"8875","ENSACAG00000011036","1",144534119,144561341,27222
"8876","ENSACAG00000011037","3",189653864,189658833,4969
"8877","ENSACAG00000011038","GL343236.1",732019,799188,67169
"8878","ENSACAG00000011039","3",189663731,189668326,4595
"8879","ENSACAG00000011040","GL343740.1",21048,52254,31206
"8880","ENSACAG00000011041","GL343684.1",246476,262814,16338
"8881","ENSACAG00000011042","2",189636546,189652076,15530
"8882","ENSACAG00000011043","GL343236.1",1021475,1030145,8670
"8883","ENSACAG00000011044","GL343253.1",1406205,1413587,7382
"8884","ENSACAG00000011047","4",571118,572103,985
"8885","ENSACAG00000011048","2",199452678,199472294,19616
"8886","ENSACAG00000011049","4",579017,579873,856
"8887","ENSACAG00000011050","4",587125,645636,58511
"8888","ENSACAG00000011051","GL343420.1",5736,21336,15600
"8889","ENSACAG00000011052","GL343194.1",3342089,3350409,8320
"8890","ENSACAG00000011055","GL343682.1",129620,132646,3026
"8891","ENSACAG00000011056","3",189977382,190176801,199419
"8892","ENSACAG00000011057","GL343236.1",1123926,1138603,14677
"8893","ENSACAG00000011058","GL343328.1",904714,1120404,215690
"8894","ENSACAG00000011059","GL343253.1",1494201,1495094,893
"8895","ENSACAG00000011060","6",5935657,5968913,33256
"8896","ENSACAG00000011061","4",7082438,7095660,13222
"8897","ENSACAG00000011062","GL343682.1",145355,169190,23835
"8898","ENSACAG00000011063","5",76977853,77087191,109338
"8899","ENSACAG00000011064","1",79638930,79840723,201793
"8900","ENSACAG00000011065","3",174415754,174546722,130968
"8901","ENSACAG00000011066","5",12887301,12926749,39448
"8902","ENSACAG00000011069","GL343538.1",174171,220189,46018
"8903","ENSACAG00000011070","2",199546379,199565961,19582
"8904","ENSACAG00000011072","GL343894.1",4724,6148,1424
"8905","ENSACAG00000011074","4",7106826,7165541,58715
"8906","ENSACAG00000011075","2",160190839,160388796,197957
"8907","ENSACAG00000011076","GL343239.1",75294,119621,44327
"8908","ENSACAG00000011077","5",13474468,13704933,230465
"8909","ENSACAG00000011078","GL343417.1",814741,829622,14881
"8910","ENSACAG00000011079","GL343253.1",1499058,1507233,8175
"8911","ENSACAG00000011081","1",191999931,192020756,20825
"8912","ENSACAG00000011083","GL343327.1",954034,1035050,81016
"8913","ENSACAG00000011085","GL343253.1",1532059,1556199,24140
"8914","ENSACAG00000011086","GL343204.1",4017940,4041020,23080
"8915","ENSACAG00000011087","5",34921791,34976179,54388
"8916","ENSACAG00000011088","6",6278204,6298253,20049
"8917","ENSACAG00000011090","1",205724988,205760094,35106
"8918","ENSACAG00000011092","4",90298442,90347855,49413
"8919","ENSACAG00000011093","GL343684.1",269862,322481,52619
"8920","ENSACAG00000011094","GL343550.1",218305,225019,6714
"8921","ENSACAG00000011098","3",111251653,111519021,267368
"8922","ENSACAG00000011099","GL343239.1",125309,162640,37331
"8923","ENSACAG00000011101","GL343550.1",228074,237566,9492
"8924","ENSACAG00000011102","6",6301785,6345002,43217
"8925","ENSACAG00000011105","6",59851072,59852268,1196
"8926","ENSACAG00000011107","5",77086517,77087764,1247
"8927","ENSACAG00000011108","5",34785200,34836001,50801
"8928","ENSACAG00000011109","GL343346.1",382985,384079,1094
"8929","ENSACAG00000011112","GL343304.1",248619,293623,45004
"8930","ENSACAG00000011113","AAWZ02038632",1033,10328,9295
"8931","ENSACAG00000011114","6",59862024,59872091,10067
"8932","ENSACAG00000011116","GL343551.1",258513,276749,18236
"8933","ENSACAG00000011117","3",174465558,174466841,1283
"8934","ENSACAG00000011121","3",190312527,190339315,26788
"8935","ENSACAG00000011122","GL343410.1",290054,397711,107657
"8936","ENSACAG00000011124","2",192236605,192243837,7232
"8937","ENSACAG00000011125","3",174273039,174517177,244138
"8938","ENSACAG00000011126","1",4430189,4450423,20234
"8939","ENSACAG00000011127","4",125401073,125426067,24994
"8940","ENSACAG00000011128","GL343291.1",861895,948856,86961
"8941","ENSACAG00000011129","2",5624104,5711678,87574
"8942","ENSACAG00000011132","AAWZ02036232",2523,29619,27096
"8943","ENSACAG00000011134","GL343236.1",1163113,1186590,23477
"8944","ENSACAG00000011135","GL343239.1",174377,182945,8568
"8945","ENSACAG00000011136","2",17979516,17986997,7481
"8946","ENSACAG00000011137","1",4239613,4287420,47807
"8947","ENSACAG00000011140","5",34470106,34509635,39529
"8948","ENSACAG00000011142","GL343194.1",3322615,3334846,12231
"8949","ENSACAG00000011144","4",662513,807612,145099
"8950","ENSACAG00000011145","6",59878336,59942567,64231
"8951","ENSACAG00000011146","3",190339532,190347340,7808
"8952","ENSACAG00000011147","2",189590423,189607922,17499
"8953","ENSACAG00000011148","AAWZ02038803",5348,7680,2332
"8954","ENSACAG00000011149","3",174224153,174263274,39121
"8955","ENSACAG00000011150","2",18042925,18052601,9676
"8956","ENSACAG00000011152","5",34417679,34441717,24038
"8957","ENSACAG00000011153","2",18357629,18363280,5651
"8958","ENSACAG00000011154","5",28085500,28160480,74980
"8959","ENSACAG00000011156","GL343551.1",308715,324219,15504
"8960","ENSACAG00000011157","3",190363241,190368150,4909
"8961","ENSACAG00000011158","AAWZ02038485",143,9213,9070
"8962","ENSACAG00000011160","2",18376204,18503394,127190
"8963","ENSACAG00000011161","4",7655864,7877503,221639
"8964","ENSACAG00000011162","GL343550.1",258329,307066,48737
"8965","ENSACAG00000011163","5",15567403,15574371,6968
"8966","ENSACAG00000011164","AAWZ02036934",4216,19660,15444
"8967","ENSACAG00000011165","2",5475811,5483253,7442
"8968","ENSACAG00000011166","GL343551.1",369677,391282,21605
"8969","ENSACAG00000011167","3",190375530,190707840,332310
"8970","ENSACAG00000011168","AAWZ02040154",5,3500,3495
"8971","ENSACAG00000011169","GL343239.1",280271,296952,16681
"8972","ENSACAG00000011170","GL343422.1",357129,371162,14033
"8973","ENSACAG00000011171","GL343442.1",476085,499692,23607
"8974","ENSACAG00000011172","GL343346.1",169838,170308,470
"8975","ENSACAG00000011174","5",15571821,15585445,13624
"8976","ENSACAG00000011176","5",15585525,15587138,1613
"8977","ENSACAG00000011178","5",15598353,15659736,61383
"8978","ENSACAG00000011180","GL343346.1",62790,83370,20580
"8979","ENSACAG00000011181","AAWZ02037606",263,12658,12395
"8980","ENSACAG00000011182","GL343239.1",419831,452544,32713
"8981","ENSACAG00000011183","5",34378876,34402413,23537
"8982","ENSACAG00000011186","GL343245.1",1795795,1819981,24186
"8983","ENSACAG00000011189","2",194374020,194379051,5031
"8984","ENSACAG00000011190","GL343304.1",331266,504794,173528
"8985","ENSACAG00000011191","5",33549975,33577396,27421
"8986","ENSACAG00000011192","6",6370785,6383908,13123
"8987","ENSACAG00000011194","4",125383015,125392596,9581
"8988","ENSACAG00000011195","2",18585597,18724394,138797
"8989","ENSACAG00000011196","AAWZ02040536",1804,6713,4909
"8990","ENSACAG00000011199","2",192421480,192427408,5928
"8991","ENSACAG00000011200","2",68230888,68238739,7851
"8992","ENSACAG00000011201","1",205708557,205722150,13593
"8993","ENSACAG00000011202","1",4090177,4195127,104950
"8994","ENSACAG00000011203","GL343239.1",800838,958244,157406
"8995","ENSACAG00000011204","AAWZ02040847",21,5318,5297
"8996","ENSACAG00000011205","2",5087844,5332446,244602
"8997","ENSACAG00000011206","GL343894.1",61621,70956,9335
"8998","ENSACAG00000011207","1",192035345,192047723,12378
"8999","ENSACAG00000011208","2",194249046,194357470,108424
"9000","ENSACAG00000011209","4",125354323,125370845,16522
"9001","ENSACAG00000011210","2",27407616,27455512,47896
"9002","ENSACAG00000011211","6",6396846,6403547,6701
"9003","ENSACAG00000011213","5",28163022,28169024,6002
"9004","ENSACAG00000011214","GL343550.1",311971,323170,11199
"9005","ENSACAG00000011215","GL344039.1",8066,29620,21554
"9006","ENSACAG00000011216","4",105784442,105804838,20396
"9007","ENSACAG00000011217","GL344140.1",43652,44185,533
"9008","ENSACAG00000011219","GL344612.1",27328,31045,3717
"9009","ENSACAG00000011220","GL343919.1",87639,104508,16869
"9010","ENSACAG00000011224","6",6464267,6519017,54750
"9011","ENSACAG00000011225","GL343442.1",750605,856753,106148
"9012","ENSACAG00000011226","GL343343.1",416863,431396,14533
"9013","ENSACAG00000011227","GL343768.1",636,11893,11257
"9014","ENSACAG00000011229","GL344740.1",723,11959,11236
"9015","ENSACAG00000011230","GL343826.1",18582,19760,1178
"9016","ENSACAG00000011231","AAWZ02037363",4139,6962,2823
"9017","ENSACAG00000011232","GL343243.1",6804,46943,40139
"9018","ENSACAG00000011233","GL343493.1",343439,408757,65318
"9019","ENSACAG00000011234","GL343194.1",3039341,3297262,257921
"9020","ENSACAG00000011235","GL344740.1",14147,17681,3534
"9021","ENSACAG00000011236","AAWZ02041337",1634,5304,3670
"9022","ENSACAG00000011238","GL343245.1",1827616,1848972,21356
"9023","ENSACAG00000011239","LGf",4045026,4082705,37679
"9024","ENSACAG00000011241","GL343273.1",1763300,1784557,21257
"9025","ENSACAG00000011242","GL343304.1",485870,486262,392
"9026","ENSACAG00000011244","GL343647.1",6663,35161,28498
"9027","ENSACAG00000011246","1",205678970,205705639,26669
"9028","ENSACAG00000011247","3",122032300,122113965,81665
"9029","ENSACAG00000011248","2",110100342,110215023,114681
"9030","ENSACAG00000011249","2",68096241,68132063,35822
"9031","ENSACAG00000011250","GL343734.1",130072,142398,12326
"9032","ENSACAG00000011251","GL343328.1",453565,475876,22311
"9033","ENSACAG00000011252","5",33532004,33544762,12758
"9034","ENSACAG00000011253","GL343304.1",558793,560001,1208
"9035","ENSACAG00000011254","GL343893.1",6854,47998,41144
"9036","ENSACAG00000011255","5",21254767,21257820,3053
"9037","ENSACAG00000011258","GL343250.1",1639533,1757915,118382
"9038","ENSACAG00000011259","GL343894.1",78348,112775,34427
"9039","ENSACAG00000011260","3",17061473,17062024,551
"9040","ENSACAG00000011261","GL343473.1",682690,696203,13513
"9041","ENSACAG00000011262","GL343304.1",579334,674206,94872
"9042","ENSACAG00000011263","GL343194.1",3244442,3245581,1139
"9043","ENSACAG00000011264","5",28171642,28215749,44107
"9044","ENSACAG00000011265","GL343357.1",850041,995030,144989
"9045","ENSACAG00000011266","GL343805.1",152765,191822,39057
"9046","ENSACAG00000011267","GL343455.1",131378,414149,282771
"9047","ENSACAG00000011268","2",189517483,189573343,55860
"9048","ENSACAG00000011269","GL343734.1",209757,214661,4904
"9049","ENSACAG00000011270","1",192058936,192083446,24510
"9050","ENSACAG00000011271","3",17226907,17227959,1052
"9051","ENSACAG00000011272","GL343236.1",1218277,1219686,1409
"9052","ENSACAG00000011273","GL343327.1",931105,952128,21023
"9053","ENSACAG00000011274","5",43887468,43914988,27520
"9054","ENSACAG00000011280","2",192320977,192327162,6185
"9055","ENSACAG00000011281","2",67849692,67966940,117248
"9056","ENSACAG00000011282","GL343734.1",214778,219715,4937
"9057","ENSACAG00000011283","GL343556.1",6712,90865,84153
"9058","ENSACAG00000011285","GL343884.1",98147,99478,1331
"9059","ENSACAG00000011286","3",110886386,111088892,202506
"9060","ENSACAG00000011287","GL343311.1",720723,751483,30760
"9061","ENSACAG00000011288","GL343297.1",527724,547825,20101
"9062","ENSACAG00000011289","GL343194.1",2994192,3019747,25555
"9063","ENSACAG00000011290","5",99793960,99812196,18236
"9064","ENSACAG00000011291","GL343768.1",51820,96643,44823
"9065","ENSACAG00000011292","GL343253.1",1572552,1595560,23008
"9066","ENSACAG00000011293","GL343236.1",1228527,1248334,19807
"9067","ENSACAG00000011294","GL343751.1",150847,199077,48230
"9068","ENSACAG00000011295","GL343377.1",359290,366274,6984
"9069","ENSACAG00000011296","2",4975897,5009030,33133
"9070","ENSACAG00000011297","GL343884.1",14782,74672,59890
"9071","ENSACAG00000011298","GL345017.1",21,12645,12624
"9072","ENSACAG00000011299","GL343245.1",1850426,1870838,20412
"9073","ENSACAG00000011300","5",136266363,136282535,16172
"9074","ENSACAG00000011301","GL343265.1",1130581,1420125,289544
"9075","ENSACAG00000011304","2",33660950,33778848,117898
"9076","ENSACAG00000011305","GL344039.1",38413,93562,55149
"9077","ENSACAG00000011308","GL343410.1",260994,273206,12212
"9078","ENSACAG00000011309","1",4060446,4077317,16871
"9079","ENSACAG00000011313","GL343473.1",659915,677408,17493
"9080","ENSACAG00000011314","2",33514172,33553000,38828
"9081","ENSACAG00000011315","3",112265205,112310535,45330
"9082","ENSACAG00000011317","GL343357.1",669718,682964,13246
"9083","ENSACAG00000011318","GL343410.1",208849,251333,42484
"9084","ENSACAG00000011319","GL343297.1",547889,583831,35942
"9085","ENSACAG00000011320","GL344393.1",231,15325,15094
"9086","ENSACAG00000011321","3",174205448,174222124,16676
"9087","ENSACAG00000011322","2",33461430,33484128,22698
"9088","ENSACAG00000011323","GL343323.1",1428479,1439996,11517
"9089","ENSACAG00000011324","5",33473687,33532856,59169
"9090","ENSACAG00000011326","GL343377.1",380814,444337,63523
"9091","ENSACAG00000011328","2",87858559,87868376,9817
"9092","ENSACAG00000011329","GL343323.1",1380688,1391213,10525
"9093","ENSACAG00000011330","GL343238.1",2508,12242,9734
"9094","ENSACAG00000011331","6",29308520,29374378,65858
"9095","ENSACAG00000011334","GL344953.1",7987,10537,2550
"9096","ENSACAG00000011335","2",186714593,186925155,210562
"9097","ENSACAG00000011336","GL343734.1",221654,226509,4855
"9098","ENSACAG00000011337","GL343236.1",1391723,1422178,30455
"9099","ENSACAG00000011338","5",136260541,136339463,78922
"9100","ENSACAG00000011339","GL343357.1",660504,667605,7101
"9101","ENSACAG00000011340","GL343250.1",37503,73260,35757
"9102","ENSACAG00000011341","GL344061.1",14048,37917,23869
"9103","ENSACAG00000011342","4",76123327,76149280,25953
"9104","ENSACAG00000011345","GL343550.1",328915,336592,7677
"9105","ENSACAG00000011347","GL343547.1",140714,147603,6889
"9106","ENSACAG00000011349","GL343516.1",205193,231700,26507
"9107","ENSACAG00000011350","GL343473.1",634022,650903,16881
"9108","ENSACAG00000011351","1",144257648,144264853,7205
"9109","ENSACAG00000011352","AAWZ02036690",269,19408,19139
"9110","ENSACAG00000011353","GL344569.1",358,27526,27168
"9111","ENSACAG00000011354","1",192144331,192171512,27181
"9112","ENSACAG00000011355","5",15662780,15671203,8423
"9113","ENSACAG00000011356","2",152434961,152435399,438
"9114","ENSACAG00000011357","GL343547.1",259200,313733,54533
"9115","ENSACAG00000011359","GL343422.1",332555,343163,10608
"9116","ENSACAG00000011360","GL343751.1",211256,255062,43806
"9117","ENSACAG00000011361","GL343297.1",576935,625480,48545
"9118","ENSACAG00000011362","GL344061.1",56447,67319,10872
"9119","ENSACAG00000011363","3",110466409,110565340,98931
"9120","ENSACAG00000011364","2",192908797,192934833,26036
"9121","ENSACAG00000011365","1",140532569,140964074,431505
"9122","ENSACAG00000011367","GL343409.1",145855,184977,39122
"9123","ENSACAG00000011368","2",192582206,192599704,17498
"9124","ENSACAG00000011369","GL344980.1",3161,14728,11567
"9125","ENSACAG00000011370","5",15700840,16026871,326031
"9126","ENSACAG00000011372","5",99824833,99879226,54393
"9127","ENSACAG00000011373","5",16085385,16126489,41104
"9128","ENSACAG00000011374","GL343357.1",624515,655017,30502
"9129","ENSACAG00000011375","GL344232.1",20072,40656,20584
"9130","ENSACAG00000011376","GL343202.1",3712625,3747268,34643
"9131","ENSACAG00000011378","GL343253.1",1599940,1641511,41571
"9132","ENSACAG00000011379","GL343238.1",38265,45304,7039
"9133","ENSACAG00000011380","GL343194.1",2802069,2822769,20700
"9134","ENSACAG00000011381","GL344961.1",3815,8566,4751
"9135","ENSACAG00000011382","AAWZ02035874",23277,25185,1908
"9136","ENSACAG00000011383","2",186988425,187030761,42336
"9137","ENSACAG00000011385","GL343194.1",2751458,2775533,24075
"9138","ENSACAG00000011388","GL343479.1",200009,239383,39374
"9139","ENSACAG00000011389","3",174188232,174201140,12908
"9140","ENSACAG00000011390","GL343240.1",2101117,2102346,1229
"9141","ENSACAG00000011391","6",60166039,60193531,27492
"9142","ENSACAG00000011393","3",122094802,122105685,10883
"9143","ENSACAG00000011394","1",3999708,4052304,52596
"9144","ENSACAG00000011395","2",189404875,189415760,10885
"9145","ENSACAG00000011397","GL343969.1",7108,9741,2633
"9146","ENSACAG00000011398","GL343238.1",73726,147861,74135
"9147","ENSACAG00000011399","GL343894.1",135725,143972,8247
"9148","ENSACAG00000011400","4",76168332,76223707,55375
"9149","ENSACAG00000011401","2",189358471,189469864,111393
"9150","ENSACAG00000011402","GL343516.1",222460,223059,599
"9151","ENSACAG00000011403","GL343684.1",333452,336295,2843
"9152","ENSACAG00000011404","GL343328.1",436533,450889,14356
"9153","ENSACAG00000011405","3",112191327,112258732,67405
"9154","ENSACAG00000011406","2",152767761,152855300,87539
"9155","ENSACAG00000011407","GL343515.1",68482,79147,10665
"9156","ENSACAG00000011408","GL343550.1",342936,379511,36575
"9157","ENSACAG00000011409","GL343734.1",229210,242735,13525
"9158","ENSACAG00000011410","GL343516.1",183831,187563,3732
"9159","ENSACAG00000011411","GL343401.1",109012,338022,229010
"9160","ENSACAG00000011413","2",187034218,187125140,90922
"9161","ENSACAG00000011415","GL343253.1",1707154,1752435,45281
"9162","ENSACAG00000011416","2",109822546,109823670,1124
"9163","ENSACAG00000011417","2",87870026,87885092,15066
"9164","ENSACAG00000011418","2",187139403,187179640,40237
"9165","ENSACAG00000011419","GL343516.1",159998,178550,18552
"9166","ENSACAG00000011421","AAWZ02040962",4392,5200,808
"9167","ENSACAG00000011422","5",43923342,44037663,114321
"9168","ENSACAG00000011424","GL343768.1",108479,119718,11239
"9169","ENSACAG00000011425","GL344059.1",29529,44371,14842
"9170","ENSACAG00000011427","AAWZ02040696",519,5142,4623
"9171","ENSACAG00000011428","GL343422.1",136760,191906,55146
"9172","ENSACAG00000011429","GL343746.1",117288,125888,8600
"9173","ENSACAG00000011431","GL343410.1",139208,169989,30781
"9174","ENSACAG00000011432","2",18761711,18842402,80691
"9175","ENSACAG00000011433","GL343332.1",841549,842607,1058
"9176","ENSACAG00000011435","1",192183850,192186426,2576
"9177","ENSACAG00000011436","GL343969.1",15370,22806,7436
"9178","ENSACAG00000011437","GL343547.1",330729,341997,11268
"9179","ENSACAG00000011438","5",136343421,136360462,17041
"9180","ENSACAG00000011439","GL343332.1",825629,832350,6721
"9181","ENSACAG00000011442","AAWZ02038902",501,8992,8491
"9182","ENSACAG00000011443","6",6546721,6597122,50401
"9183","ENSACAG00000011444","GL344490.1",25511,31426,5915
"9184","ENSACAG00000011445","GL343479.1",286150,307076,20926
"9185","ENSACAG00000011446","GL343547.1",391556,396272,4716
"9186","ENSACAG00000011448","1",140439231,140515902,76671
"9187","ENSACAG00000011450","GL343663.1",16846,24313,7467
"9188","ENSACAG00000011451","1",3890559,3892007,1448
"9189","ENSACAG00000011452","6",60271171,60285862,14691
"9190","ENSACAG00000011453","GL343332.1",756255,821128,64873
"9191","ENSACAG00000011454","2",18973280,19366485,393205
"9192","ENSACAG00000011455","1",3696188,3809503,113315
"9193","ENSACAG00000011456","1",192207952,192276827,68875
"9194","ENSACAG00000011457","GL343327.1",913951,916589,2638
"9195","ENSACAG00000011459","GL343768.1",157493,168168,10675
"9196","ENSACAG00000011460","GL343291.1",957249,960815,3566
"9197","ENSACAG00000011462","GL343473.1",625623,629990,4367
"9198","ENSACAG00000011463","GL343734.1",246332,251460,5128
"9199","ENSACAG00000011464","GL343291.1",1022624,1069681,47057
"9200","ENSACAG00000011465","GL343357.1",452057,583918,131861
"9201","ENSACAG00000011467","4",138927509,138928750,1241
"9202","ENSACAG00000011470","GL343768.1",185860,195170,9310
"9203","ENSACAG00000011475","GL343927.1",60167,131215,71048
"9204","ENSACAG00000011476","5",142350858,142537927,187069
"9205","ENSACAG00000011477","2",129275112,129922039,646927
"9206","ENSACAG00000011478","3",122124590,122138732,14142
"9207","ENSACAG00000011479","AAWZ02036664",3219,10668,7449
"9208","ENSACAG00000011480","2",189308830,189326936,18106
"9209","ENSACAG00000011481","GL343194.1",2655798,2745494,89696
"9210","ENSACAG00000011482","GL344732.1",9144,22166,13022
"9211","ENSACAG00000011483","GL343550.1",382213,412156,29943
"9212","ENSACAG00000011485","GL343663.1",8584,9450,866
"9213","ENSACAG00000011486","5",16133560,16162515,28955
"9214","ENSACAG00000011487","2",87951355,88034968,83613
"9215","ENSACAG00000011489","GL343327.1",892220,907093,14873
"9216","ENSACAG00000011490","2",152865488,152884128,18640
"9217","ENSACAG00000011491","GL344859.1",979,20263,19284
"9218","ENSACAG00000011492","2",192616857,192618623,1766
"9219","ENSACAG00000011493","GL343401.1",367227,397129,29902
"9220","ENSACAG00000011494","GL343554.1",195603,378176,182573
"9221","ENSACAG00000011495","GL343516.1",129011,143879,14868
"9222","ENSACAG00000011496","GL344611.1",17569,19906,2337
"9223","ENSACAG00000011497","GL343746.1",159784,187904,28120
"9224","ENSACAG00000011499","GL343473.1",582963,619074,36111
"9225","ENSACAG00000011501","GL343311.1",805954,985209,179255
"9226","ENSACAG00000011502","6",60462056,60479354,17298
"9227","ENSACAG00000011503","GL343550.1",450498,479406,28908
"9228","ENSACAG00000011504","GL343238.1",166229,185991,19762
"9229","ENSACAG00000011505","2",192714230,192719388,5158
"9230","ENSACAG00000011506","6",29206369,29260582,54213
"9231","ENSACAG00000011507","GL343326.1",213181,233324,20143
"9232","ENSACAG00000011508","GL343401.1",500630,501640,1010
"9233","ENSACAG00000011509","GL344188.1",45741,53011,7270
"9234","ENSACAG00000011511","6",60492181,60511481,19300
"9235","ENSACAG00000011513","GL343374.1",603075,655813,52738
"9236","ENSACAG00000011514","GL343401.1",565843,577473,11630
"9237","ENSACAG00000011515","GL343566.1",4471,11752,7281
"9238","ENSACAG00000011516","GL343462.1",626470,634519,8049
"9239","ENSACAG00000011517","GL343969.1",23106,44937,21831
"9240","ENSACAG00000011518","5",136362849,136377180,14331
"9241","ENSACAG00000011519","GL343401.1",582159,642154,59995
"9242","ENSACAG00000011520","GL343374.1",820023,846413,26390
"9243","ENSACAG00000011521","GL343805.1",141609,152650,11041
"9244","ENSACAG00000011522","5",16166056,16184640,18584
"9245","ENSACAG00000011523","3",174147489,174160894,13405
"9246","ENSACAG00000011525","GL343194.1",2418276,2645629,227353
"9247","ENSACAG00000011526","AAWZ02038986",3081,3359,278
"9248","ENSACAG00000011527","GL343870.1",25204,89133,63929
"9249","ENSACAG00000011528","3",174111556,174130001,18445
"9250","ENSACAG00000011529","AAWZ02039729",792,6711,5919
"9251","ENSACAG00000011531","GL343201.1",2878187,2907953,29766
"9252","ENSACAG00000011532","GL343326.1",193629,200296,6667
"9253","ENSACAG00000011533","GL343327.1",881057,883365,2308
"9254","ENSACAG00000011534","GL343473.1",552328,567654,15326
"9255","ENSACAG00000011535","2",192731455,192735520,4065
"9256","ENSACAG00000011536","GL343479.1",314112,368847,54735
"9257","ENSACAG00000011537","GL343462.1",618785,619414,629
"9258","ENSACAG00000011538","GL343804.1",148468,156166,7698
"9259","ENSACAG00000011539","GL343239.1",977861,1012536,34675
"9260","ENSACAG00000011540","GL343622.1",43002,268689,225687
"9261","ENSACAG00000011541","GL343409.1",74055,95686,21631
"9262","ENSACAG00000011542","GL343554.1",300115,303884,3769
"9263","ENSACAG00000011543","GL343326.1",140189,189500,49311
"9264","ENSACAG00000011544","GL343462.1",606419,607063,644
"9265","ENSACAG00000011545","GL343479.1",396865,397642,777
"9266","ENSACAG00000011546","2",189280671,189294792,14121
"9267","ENSACAG00000011547","GL343374.1",861368,898846,37478
"9268","ENSACAG00000011548","GL343516.1",96060,104532,8472
"9269","ENSACAG00000011549","GL343327.1",563949,566342,2393
"9270","ENSACAG00000011550","GL343871.1",80493,94195,13702
"9271","ENSACAG00000011551","GL343895.1",862,10707,9845
"9272","ENSACAG00000011552","GL343479.1",402664,480750,78086
"9273","ENSACAG00000011553","GL343566.1",35645,37372,1727
"9274","ENSACAG00000011554","2",152891963,152919350,27387
"9275","ENSACAG00000011556","5",136382434,136403939,21505
"9276","ENSACAG00000011557","GL343265.1",945366,945977,611
"9277","ENSACAG00000011559","GL343265.1",581009,751344,170335
"9278","ENSACAG00000011560","4",746961,775552,28591
"9279","ENSACAG00000011563","3",174097816,174100111,2295
"9280","ENSACAG00000011566","GL343374.1",913524,928765,15241
"9281","ENSACAG00000011567","4",105821161,105892514,71353
"9282","ENSACAG00000011568","4",47148308,47149909,1601
"9283","ENSACAG00000011569","1",192290020,192327156,37136
"9284","ENSACAG00000011571","2",192812758,192814110,1352
"9285","ENSACAG00000011572","GL343969.1",48502,49380,878
"9286","ENSACAG00000011573","GL343550.1",493587,513436,19849
"9287","ENSACAG00000011574","GL343326.1",71001,131733,60732
"9288","ENSACAG00000011575","GL343556.1",106550,330173,223623
"9289","ENSACAG00000011576","4",46996391,47085562,89171
"9290","ENSACAG00000011577","5",16186384,16196366,9982
"9291","ENSACAG00000011578","GL343409.1",44539,55087,10548
"9292","ENSACAG00000011579","GL343410.1",113714,132622,18908
"9293","ENSACAG00000011581","GL344538.1",1082,23839,22757
"9294","ENSACAG00000011582","GL343462.1",548490,560916,12426
"9295","ENSACAG00000011583","AAWZ02036422",6857,21185,14328
"9296","ENSACAG00000011584","3",174079907,174100253,20346
"9297","ENSACAG00000011585","GL343409.1",6161,44448,38287
"9298","ENSACAG00000011586","AAWZ02038891",825,6802,5977
"9299","ENSACAG00000011587","1",140392915,140410501,17586
"9300","ENSACAG00000011588","GL343291.1",1078533,1105480,26947
"9301","ENSACAG00000011589","GL343705.1",28002,32556,4554
"9302","ENSACAG00000011590","3",122156793,122255290,98497
"9303","ENSACAG00000011591","GL343308.1",1442456,1513581,71125
"9304","ENSACAG00000011592","GL343236.1",1428903,1500492,71589
"9305","ENSACAG00000011593","GL343291.1",1336709,1377304,40595
"9306","ENSACAG00000011597","6",60521535,60538730,17195
"9307","ENSACAG00000011599","GL343566.1",191675,263864,72189
"9308","ENSACAG00000011600","AAWZ02038840",24,10064,10040
"9309","ENSACAG00000011601","2",192904087,192904521,434
"9310","ENSACAG00000011602","5",28216468,28222060,5592
"9311","ENSACAG00000011603","GL343326.1",7418,75123,67705
"9312","ENSACAG00000011604","GL343805.1",101551,103790,2239
"9313","ENSACAG00000011605","GL343238.1",227328,240778,13450
"9314","ENSACAG00000011607","2",192939669,192949056,9387
"9315","ENSACAG00000011609","AAWZ02038286",4263,11388,7125
"9316","ENSACAG00000011610","GL343328.1",391321,537721,146400
"9317","ENSACAG00000011611","GL343895.1",16538,51358,34820
"9318","ENSACAG00000011612","GL343871.1",11077,31389,20312
"9319","ENSACAG00000011613","GL343401.1",660102,677357,17255
"9320","ENSACAG00000011614","GL343804.1",125687,136727,11040
"9321","ENSACAG00000011615","GL343265.1",503318,559516,56198
"9322","ENSACAG00000011616","AAWZ02039898",2012,7443,5431
"9323","ENSACAG00000011617","3",110242994,110271459,28465
"9324","ENSACAG00000011618","GL343647.1",43538,44377,839
"9325","ENSACAG00000011619","2",128689357,128941628,252271
"9326","ENSACAG00000011622","AAWZ02038293",4175,12206,8031
"9327","ENSACAG00000011623","GL343297.1",673216,673986,770
"9328","ENSACAG00000011625","GL343647.1",300773,347681,46908
"9329","ENSACAG00000011626","2",189268029,189269119,1090
"9330","ENSACAG00000011627","GL343297.1",711188,762041,50853
"9331","ENSACAG00000011628","GL343202.1",3770563,3781385,10822
"9332","ENSACAG00000011629","GL343304.1",677973,694404,16431
"9333","ENSACAG00000011630","5",137392248,137552330,160082
"9334","ENSACAG00000011631","GL343705.1",35171,41136,5965
"9335","ENSACAG00000011632","GL343895.1",77126,137994,60868
"9336","ENSACAG00000011633","GL343462.1",525671,547551,21880
"9337","ENSACAG00000011634","3",122565890,122617973,52083
"9338","ENSACAG00000011636","5",136413442,136443493,30051
"9339","ENSACAG00000011637","GL343805.1",57187,100770,43583
"9340","ENSACAG00000011640","2",189149280,189165552,16272
"9341","ENSACAG00000011641","6",78742815,78756264,13449
"9342","ENSACAG00000011642","AAWZ02040763",773,6409,5636
"9343","ENSACAG00000011643","5",16228232,16302753,74521
"9344","ENSACAG00000011645","1",140305796,140319976,14180
"9345","ENSACAG00000011646","GL343201.1",3094778,3348516,253738
"9346","ENSACAG00000011648","4",840355,869184,28829
"9347","ENSACAG00000011649","2",193036120,193041758,5638
"9348","ENSACAG00000011650","GL343328.1",302251,347781,45530
"9349","ENSACAG00000011653","2",160414480,160504197,89717
"9350","ENSACAG00000011654","1",263834474,263901082,66608
"9351","ENSACAG00000011655","GL343297.1",828832,894394,65562
"9352","ENSACAG00000011657","GL344800.1",12743,16253,3510
"9353","ENSACAG00000011658","GL343250.1",1763610,1781793,18183
"9354","ENSACAG00000011661","3",122789810,122791474,1664
"9355","ENSACAG00000011662","2",187183366,187211940,28574
"9356","ENSACAG00000011663","1",140216925,140246606,29681
"9357","ENSACAG00000011664","1",205667349,205679701,12352
"9358","ENSACAG00000011666","4",76238088,76285662,47574
"9359","ENSACAG00000011669","GL343516.1",80717,97168,16451
"9360","ENSACAG00000011671","5",28223299,28302376,79077
"9361","ENSACAG00000011672","1",3648634,3680637,32003
"9362","ENSACAG00000011674","5",90723819,90734871,11052
"9363","ENSACAG00000011675","5",33427166,33464091,36925
"9364","ENSACAG00000011676","2",187220846,187230905,10059
"9365","ENSACAG00000011677","1",140199310,140212359,13049
"9366","ENSACAG00000011678","2",194195735,194210789,15054
"9367","ENSACAG00000011679","1",140179736,140198333,18597
"9368","ENSACAG00000011680","3",122798866,122846953,48087
"9369","ENSACAG00000011681","GL343725.1",14496,23507,9011
"9370","ENSACAG00000011682","GL343566.1",274299,282520,8221
"9371","ENSACAG00000011683","GL343374.1",932597,952747,20150
"9372","ENSACAG00000011684","GL343401.1",701644,791417,89773
"9373","ENSACAG00000011685","GL343297.1",934287,987945,53658
"9374","ENSACAG00000011686","GL343804.1",103212,119255,16043
"9375","ENSACAG00000011687","3",173938052,174073307,135255
"9376","ENSACAG00000011688","GL343516.1",65389,79938,14549
"9377","ENSACAG00000011689","GL343848.1",2517,30011,27494
"9378","ENSACAG00000011690","5",90761784,91032630,270846
"9379","ENSACAG00000011691","6",60571431,60649607,78176
"9380","ENSACAG00000011692","GL343374.1",955152,957362,2210
"9381","ENSACAG00000011693","GL343308.1",1417713,1428628,10915
"9382","ENSACAG00000011694","6",6740988,7290662,549674
"9383","ENSACAG00000011695","2",160504753,160531282,26529
"9384","ENSACAG00000011696","2",193063886,193078041,14155
"9385","ENSACAG00000011698","2",152963975,152965135,1160
"9386","ENSACAG00000011700","4",872073,964033,91960
"9387","ENSACAG00000011701","2",152985084,153049427,64343
"9388","ENSACAG00000011703","GL343312.1",1154756,1203992,49236
"9389","ENSACAG00000011704","6",7299032,7329341,30309
"9390","ENSACAG00000011706","GL343332.1",635255,651897,16642
"9391","ENSACAG00000011707","1",192360997,192397398,36401
"9392","ENSACAG00000011708","3",122890920,123000894,109974
"9393","ENSACAG00000011710","GL343238.1",318839,334610,15771
"9394","ENSACAG00000011711","5",44553656,44613741,60085
"9395","ENSACAG00000011713","GL343725.1",33941,97010,63069
"9396","ENSACAG00000011715","2",193191407,193192297,890
"9397","ENSACAG00000011716","GL343870.1",120044,129712,9668
"9398","ENSACAG00000011717","GL343194.1",2596465,2617125,20660
"9399","ENSACAG00000011719","AAWZ02041607",425,5471,5046
"9400","ENSACAG00000011721","2",187232610,187302871,70261
"9401","ENSACAG00000011724","GL343566.1",302257,342392,40135
"9402","ENSACAG00000011725","GL343438.1",407137,411092,3955
"9403","ENSACAG00000011726","GL344089.1",7089,12704,5615
"9404","ENSACAG00000011727","AAWZ02036781",3246,19007,15761
"9405","ENSACAG00000011728","GL343308.1",1367711,1368455,744
"9406","ENSACAG00000011729","4",46965241,46987095,21854
"9407","ENSACAG00000011731","GL343332.1",569658,621384,51726
"9408","ENSACAG00000011732","4",46764646,46916328,151682
"9409","ENSACAG00000011733","GL343804.1",47882,80810,32928
"9410","ENSACAG00000011734","5",99900548,99928959,28411
"9411","ENSACAG00000011735","GL343323.1",1354308,1373853,19545
"9412","ENSACAG00000011736","3",123020620,123024540,3920
"9413","ENSACAG00000011737","GL343323.1",1411621,1422374,10753
"9414","ENSACAG00000011738","2",160547160,160567783,20623
"9415","ENSACAG00000011739","GL343401.1",740231,824763,84532
"9416","ENSACAG00000011740","GL343323.1",1237604,1253112,15508
"9417","ENSACAG00000011742","5",137834128,137883210,49082
"9418","ENSACAG00000011744","2",160570113,160587545,17432
"9419","ENSACAG00000011745","GL343554.1",100397,155797,55400
"9420","ENSACAG00000011746","2",194158692,194195623,36931
"9421","ENSACAG00000011747","GL343332.1",507835,536416,28581
"9422","ENSACAG00000011748","GL345026.1",3042,12234,9192
"9423","ENSACAG00000011751","5",138346599,138347561,962
"9424","ENSACAG00000011753","GL343202.1",3805078,3812768,7690
"9425","ENSACAG00000011754","5",14782085,14793565,11480
"9426","ENSACAG00000011756","2",193112946,193126895,13949
"9427","ENSACAG00000011757","3",123076707,123139766,63059
"9428","ENSACAG00000011759","4",105944541,105950815,6274
"9429","ENSACAG00000011760","5",138352804,138550605,197801
"9430","ENSACAG00000011761","GL343992.1",91940,92278,338
"9431","ENSACAG00000011762","GL343250.1",1885755,1901737,15982
"9432","ENSACAG00000011763","4",76288810,76317440,28630
"9433","ENSACAG00000011764","AAWZ02041672",1273,4576,3303
"9434","ENSACAG00000011765","GL343297.1",1122807,1129487,6680
"9435","ENSACAG00000011767","GL343297.1",1154865,1178864,23999
"9436","ENSACAG00000011770","GL343374.1",970669,1076960,106291
"9437","ENSACAG00000011771","GL343285.1",1332794,1700629,367835
"9438","ENSACAG00000011772","4",105963341,105964741,1400
"9439","ENSACAG00000011773","4",105979841,105989135,9294
"9440","ENSACAG00000011774","GL343252.1",1847896,1882311,34415
"9441","ENSACAG00000011775","6",29079369,29152558,73189
"9442","ENSACAG00000011776","6",60662495,60695115,32620
"9443","ENSACAG00000011777","GL344562.1",18130,20043,1913
"9444","ENSACAG00000011778","GL343312.1",1252913,1270217,17304
"9445","ENSACAG00000011780","GL343265.1",448168,487389,39221
"9446","ENSACAG00000011782","5",99975702,99976277,575
"9447","ENSACAG00000011783","GL343470.1",595707,660163,64456
"9448","ENSACAG00000011784","GL344401.1",22714,31664,8950
"9449","ENSACAG00000011785","GL343419.1",1232,149226,147994
"9450","ENSACAG00000011786","GL343297.1",1178558,1189047,10489
"9451","ENSACAG00000011787","GL343565.1",13324,100737,87413
"9452","ENSACAG00000011788","GL344688.1",12333,19086,6753
"9453","ENSACAG00000011790","2",188962366,188972757,10391
"9454","ENSACAG00000011791","GL344126.1",62338,65889,3551
"9455","ENSACAG00000011792","GL343725.1",106637,135204,28567
"9456","ENSACAG00000011793","1",192562845,192571150,8305
"9457","ENSACAG00000011794","GL343883.1",23142,44692,21550
"9458","ENSACAG00000011795","5",44632862,44725470,92608
"9459","ENSACAG00000011796","4",143599734,143603777,4043
"9460","ENSACAG00000011797","3",173699472,173771539,72067
"9461","ENSACAG00000011798","3",123150448,123218849,68401
"9462","ENSACAG00000011799","GL343202.1",3824090,3854303,30213
"9463","ENSACAG00000011801","GL344126.1",6522,54715,48193
"9464","ENSACAG00000011803","GL343236.1",1508493,1553867,45374
"9465","ENSACAG00000011804","6",28908225,28929164,20939
"9466","ENSACAG00000011805","GL343566.1",361981,363498,1517
"9467","ENSACAG00000011806","1",263663712,263826942,163230
"9468","ENSACAG00000011807","GL343308.1",1378446,1392791,14345
"9469","ENSACAG00000011808","GL343566.1",372077,403050,30973
"9470","ENSACAG00000011809","3",109752836,109921158,168322
"9471","ENSACAG00000011810","5",28318783,28340168,21385
"9472","ENSACAG00000011812","4",76327863,76358556,30693
"9473","ENSACAG00000011813","GL343265.1",408099,435308,27209
"9474","ENSACAG00000011814","1",205596692,205638917,42225
"9475","ENSACAG00000011815","1",192573190,192597114,23924
"9476","ENSACAG00000011816","5",14709667,14721503,11836
"9477","ENSACAG00000011817","6",28881108,28886820,5712
"9478","ENSACAG00000011819","GL343328.1",274449,275045,596
"9479","ENSACAG00000011820","GL343870.1",140465,154371,13906
"9480","ENSACAG00000011822","GL343238.1",356106,379706,23600
"9481","ENSACAG00000011823","GL343245.1",1914010,1939916,25906
"9482","ENSACAG00000011824","2",67864602,67865633,1031
"9483","ENSACAG00000011825","6",28648520,28649164,644
"9484","ENSACAG00000011826","2",67732110,67765547,33437
"9485","ENSACAG00000011827","2",27342180,27386383,44203
"9486","ENSACAG00000011829","4",46418469,46448796,30327
"9487","ENSACAG00000011830","6",28418230,28465826,47596
"9488","ENSACAG00000011831","GL344401.1",35039,44784,9745
"9489","ENSACAG00000011832","GL343328.1",164462,171169,6707
"9490","ENSACAG00000011833","5",100050009,100066588,16579
"9491","ENSACAG00000011834","3",112176510,112191266,14756
"9492","ENSACAG00000011835","5",138549727,138571846,22119
"9493","ENSACAG00000011836","GL343291.1",1375899,1383368,7469
"9494","ENSACAG00000011837","GL345028.1",4,586,582
"9495","ENSACAG00000011840","1",3564627,3577779,13152
"9496","ENSACAG00000011841","4",143556454,143588017,31563
"9497","ENSACAG00000011842","GL343297.1",1190478,1190711,233
"9498","ENSACAG00000011843","3",173647960,173692396,44436
"9499","ENSACAG00000011844","GL343297.1",1191702,1205184,13482
"9500","ENSACAG00000011845","2",160603671,160631727,28056
"9501","ENSACAG00000011846","GL344745.1",14969,15643,674
"9502","ENSACAG00000011847","GL343308.1",1343236,1377425,34189
"9503","ENSACAG00000011848","GL343755.1",48938,83986,35048
"9504","ENSACAG00000011849","AAWZ02036604",3685,8341,4656
"9505","ENSACAG00000011850","GL343239.1",1085527,1101646,16119
"9506","ENSACAG00000011851","5",14626513,14710217,83704
"9507","ENSACAG00000011852","GL344022.1",396,10801,10405
"9508","ENSACAG00000011853","GL343308.1",723206,860830,137624
"9509","ENSACAG00000011854","1",3546340,3547227,887
"9510","ENSACAG00000011855","2",170361153,170380250,19097
"9511","ENSACAG00000011856","GL344085.1",4935,34027,29092
"9512","ENSACAG00000011857","GL343883.1",63595,106223,42628
"9513","ENSACAG00000011858","2",26693727,26711760,18033
"9514","ENSACAG00000011859","GL343291.1",1434759,1542661,107902
"9515","ENSACAG00000011860","GL343359.1",1062410,1078637,16227
"9516","ENSACAG00000011861","GL343565.1",149796,175907,26111
"9517","ENSACAG00000011862","5",142267221,142309635,42414
"9518","ENSACAG00000011864","GL343265.1",125236,221791,96555
"9519","ENSACAG00000011865","5",100207884,100243399,35515
"9520","ENSACAG00000011866","5",142020167,142070906,50739
"9521","ENSACAG00000011867","3",191399725,191598474,198749
"9522","ENSACAG00000011869","GL343250.1",1923764,1966225,42461
"9523","ENSACAG00000011870","1",188752504,188831878,79374
"9524","ENSACAG00000011871","5",32944411,32958309,13898
"9525","ENSACAG00000011872","GL343470.1",579860,584414,4554
"9526","ENSACAG00000011874","3",112157063,112171512,14449
"9527","ENSACAG00000011875","GL343534.1",426032,434049,8017
"9528","ENSACAG00000011876","GL343328.1",47025,93471,46446
"9529","ENSACAG00000011877","GL343332.1",483788,502917,19129
"9530","ENSACAG00000011878","2",88205979,88209462,3483
"9531","ENSACAG00000011880","2",187318639,187323381,4742
"9532","ENSACAG00000011882","4",1009100,1098724,89624
"9533","ENSACAG00000011883","AAWZ02038071",4884,7934,3050
"9534","ENSACAG00000011884","2",160778402,161480061,701659
"9535","ENSACAG00000011887","AAWZ02038071",8677,9498,821
"9536","ENSACAG00000011888","GL343239.1",1121521,1191598,70077
"9537","ENSACAG00000011889","6",78757250,78758188,938
"9538","ENSACAG00000011890","5",138567634,138594782,27148
"9539","ENSACAG00000011892","GL344229.1",10270,26414,16144
"9540","ENSACAG00000011894","GL343201.1",3459862,3592113,132251
"9541","ENSACAG00000011895","6",78771256,78775854,4598
"9542","ENSACAG00000011896","GL343297.1",1220719,1262928,42209
"9543","ENSACAG00000011898","GL343201.1",3638486,3656570,18084
"9544","ENSACAG00000011900","GL343332.1",424653,462414,37761
"9545","ENSACAG00000011901","GL343848.1",38473,103113,64640
"9546","ENSACAG00000011902","GL343805.1",24045,56796,32751
"9547","ENSACAG00000011903","3",173623222,173624520,1298
"9548","ENSACAG00000011904","1",205559669,205596572,36903
"9549","ENSACAG00000011905","5",32876901,32909311,32410
"9550","ENSACAG00000011906","GL343882.1",39323,62152,22829
"9551","ENSACAG00000011907","3",173610383,173617788,7405
"9552","ENSACAG00000011908","GL343359.1",1112264,1171521,59257
"9553","ENSACAG00000011909","3",112098541,112108045,9504
"9554","ENSACAG00000011910","GL343479.1",481460,487029,5569
"9555","ENSACAG00000011912","GL343236.1",1594435,1635072,40637
"9556","ENSACAG00000011913","GL343565.1",306774,320403,13629
"9557","ENSACAG00000011914","5",100310178,100343103,32925
"9558","ENSACAG00000011915","GL343332.1",332198,367233,35035
"9559","ENSACAG00000011916","2",153053981,153059233,5252
"9560","ENSACAG00000011917","2",26634002,26689249,55247
"9561","ENSACAG00000011918","4",46352835,46372710,19875
"9562","ENSACAG00000011919","2",188920089,188939659,19570
"9563","ENSACAG00000011920","2",88218955,88232366,13411
"9564","ENSACAG00000011921","AAWZ02037914",2376,13155,10779
"9565","ENSACAG00000011922","GL343202.1",3863411,3887934,24523
"9566","ENSACAG00000011923","3",191759795,191949787,189992
"9567","ENSACAG00000011924","2",88241230,88274195,32965
"9568","ENSACAG00000011925","5",138649239,138651401,2162
"9569","ENSACAG00000011926","GL343516.1",34320,51489,17169
"9570","ENSACAG00000011927","GL343725.1",142704,184147,41443
"9571","ENSACAG00000011928","GL343239.1",1252702,1278083,25381
"9572","ENSACAG00000011929","2",47804835,47822960,18125
"9573","ENSACAG00000011930","GL343470.1",574603,577123,2520
"9574","ENSACAG00000011931","6",78796480,78818600,22120
"9575","ENSACAG00000011932","2",153071761,153078158,6397
"9576","ENSACAG00000011934","3",173587920,173606021,18101
"9577","ENSACAG00000011935","GL343470.1",569004,573873,4869
"9578","ENSACAG00000011936","GL343239.1",1305224,1313329,8105
"9579","ENSACAG00000011938","6",60698113,60730980,32867
"9580","ENSACAG00000011939","5",138652274,138661004,8730
"9581","ENSACAG00000011940","GL343534.1",39174,53142,13968
"9582","ENSACAG00000011941","5",145672595,145987738,315143
"9583","ENSACAG00000011942","2",170382823,170409461,26638
"9584","ENSACAG00000011943","5",136476539,136512370,35831
"9585","ENSACAG00000011944","GL343239.1",1320190,1345980,25790
"9586","ENSACAG00000011945","2",153097000,153119597,22597
"9587","ENSACAG00000011946","2",170722046,170774635,52589
"9588","ENSACAG00000011947","GL343238.1",389854,395940,6086
"9589","ENSACAG00000011948","3",123227861,123290793,62932
"9590","ENSACAG00000011949","4",1614628,1736668,122040
"9591","ENSACAG00000011950","GL343755.1",99588,111947,12359
"9592","ENSACAG00000011951","GL343755.1",117121,117519,398
"9593","ENSACAG00000011953","GL343304.1",705682,715917,10235
"9594","ENSACAG00000011954","AAWZ02036864",19760,21377,1617
"9595","ENSACAG00000011955","1",140106135,140115802,9667
"9596","ENSACAG00000011956","AAWZ02038730",4221,7737,3516
"9597","ENSACAG00000011958","1",140059711,140077704,17993
"9598","ENSACAG00000011959","GL343479.1",518771,554505,35734
"9599","ENSACAG00000011961","AAWZ02035739",4231,19902,15671
"9600","ENSACAG00000011962","GL343202.1",3855496,3970150,114654
"9601","ENSACAG00000011963","5",100567218,100576797,9579
"9602","ENSACAG00000011965","GL343201.1",3659378,3661393,2015
"9603","ENSACAG00000011966","2",198554409,198587021,32612
"9604","ENSACAG00000011967","GL343332.1",222314,231168,8854
"9605","ENSACAG00000011968","GL343748.1",166750,168575,1825
"9606","ENSACAG00000011969","GL343422.1",68618,79216,10598
"9607","ENSACAG00000011970","5",138701720,138715532,13812
"9608","ENSACAG00000011971","4",76361639,76462050,100411
"9609","ENSACAG00000011972","1",263398524,263650988,252464
"9610","ENSACAG00000011973","GL343462.1",507275,523411,16136
"9611","ENSACAG00000011974","5",14469641,14491594,21953
"9612","ENSACAG00000011977","2",188906234,188912537,6303
"9613","ENSACAG00000011979","5",32806277,32851649,45372
"9614","ENSACAG00000011981","GL344220.1",29295,53281,23986
"9615","ENSACAG00000011982","4",105993631,106029928,36297
"9616","ENSACAG00000011984","GL343371.1",516203,622203,106000
"9617","ENSACAG00000011985","GL343566.1",445263,458870,13607
"9618","ENSACAG00000011986","GL343809.1",2435,3996,1561
"9619","ENSACAG00000011987","GL343304.1",734338,976954,242616
"9620","ENSACAG00000011989","5",138723543,138858953,135410
"9621","ENSACAG00000011990","GL343207.1",1684082,1892684,208602
"9622","ENSACAG00000011991","AAWZ02036616",10955,12327,1372
"9623","ENSACAG00000011992","GL343893.1",58321,124103,65782
"9624","ENSACAG00000011994","GL343565.1",382082,441121,59039
"9625","ENSACAG00000011996","3",112070066,112091310,21244
"9626","ENSACAG00000011997","GL343893.1",124535,141147,16612
"9627","ENSACAG00000011998","2",188848522,188862893,14371
"9628","ENSACAG00000011999","1",140000590,140062060,61470
"9629","ENSACAG00000012000","2",26543961,26605860,61899
"9630","ENSACAG00000012001","5",14432738,14461535,28797
"9631","ENSACAG00000012003","GL343332.1",122207,197962,75755
"9632","ENSACAG00000012005","GL343330.1",1318554,1333631,15077
"9633","ENSACAG00000012006","GL343202.1",3963196,3970938,7742
"9634","ENSACAG00000012007","1",34345561,34359986,14425
"9635","ENSACAG00000012008","2",188772655,188790979,18324
"9636","ENSACAG00000012009","GL343207.1",1680007,1681252,1245
"9637","ENSACAG00000012010","2",187497896,187530099,32203
"9638","ENSACAG00000012011","GL343265.1",92595,116759,24164
"9639","ENSACAG00000012012","GL343238.1",409826,584494,174668
"9640","ENSACAG00000012014","5",28343214,28379937,36723
"9641","ENSACAG00000012015","GL343513.1",232793,247403,14610
"9642","ENSACAG00000012017","5",28385435,28443669,58234
"9643","ENSACAG00000012018","AAWZ02037481",8045,15511,7466
"9644","ENSACAG00000012020","GL343883.1",133296,134100,804
"9645","ENSACAG00000012021","AAWZ02036604",12902,23464,10562
"9646","ENSACAG00000012022","AAWZ02041792",158,4889,4731
"9647","ENSACAG00000012023","GL343754.1",118798,138360,19562
"9648","ENSACAG00000012024","GL343470.1",554217,564472,10255
"9649","ENSACAG00000012025","4",106203282,106211361,8079
"9650","ENSACAG00000012026","GL343207.1",1549826,1669811,119985
"9651","ENSACAG00000012027","4",106249381,106311243,61862
"9652","ENSACAG00000012028","GL343332.1",28519,84291,55772
"9653","ENSACAG00000012029","3",173579198,173584900,5702
"9654","ENSACAG00000012030","GL343337.1",13592,93459,79867
"9655","ENSACAG00000012031","3",173555298,173579275,23977
"9656","ENSACAG00000012032","GL343239.1",1356345,1515876,159531
"9657","ENSACAG00000012033","GL343291.1",1565740,1566000,260
"9658","ENSACAG00000012034","GL343291.1",1585901,1598304,12403
"9659","ENSACAG00000012035","GL343202.1",3976535,3986869,10334
"9660","ENSACAG00000012036","3",109596863,109622760,25897
"9661","ENSACAG00000012037","4",143523993,143548497,24504
"9662","ENSACAG00000012038","2",67695079,67706837,11758
"9663","ENSACAG00000012039","GL343236.1",1658704,1693226,34522
"9664","ENSACAG00000012042","4",2226149,2291894,65745
"9665","ENSACAG00000012043","GL343462.1",475100,501555,26455
"9666","ENSACAG00000012044","GL343304.1",1020499,1037940,17441
"9667","ENSACAG00000012048","GL344133.1",2701,78545,75844
"9668","ENSACAG00000012049","GL343754.1",82126,97756,15630
"9669","ENSACAG00000012050","6",78845194,78853309,8115
"9670","ENSACAG00000012052","GL343545.1",971,121593,120622
"9671","ENSACAG00000012053","GL343883.1",138983,153681,14698
"9672","ENSACAG00000012057","1",34360070,34387823,27753
"9673","ENSACAG00000012059","GL343201.1",3698354,3741213,42859
"9674","ENSACAG00000012061","6",78872251,78884510,12259
"9675","ENSACAG00000012062","GL343882.1",23451,34386,10935
"9676","ENSACAG00000012063","GL344741.1",43218,50193,6975
"9677","ENSACAG00000012064","GL344244.1",31028,61523,30495
"9678","ENSACAG00000012065","GL343650.1",87337,102614,15277
"9679","ENSACAG00000012066","GL343462.1",411352,472825,61473
"9680","ENSACAG00000012067","5",100620251,100896875,276624
"9681","ENSACAG00000012069","5",146009414,146029675,20261
"9682","ENSACAG00000012070","5",100920164,100920370,206
"9683","ENSACAG00000012071","2",194143488,194156730,13242
"9684","ENSACAG00000012072","5",44927806,45060912,133106
"9685","ENSACAG00000012076","6",3842832,3864708,21876
"9686","ENSACAG00000012077","GL343411.1",46118,291722,245604
"9687","ENSACAG00000012078","GL344033.1",1203,20921,19718
"9688","ENSACAG00000012079","GL343474.1",40839,100280,59441
"9689","ENSACAG00000012080","3",173517985,173536396,18411
"9690","ENSACAG00000012081","5",101084986,101098384,13398
"9691","ENSACAG00000012082","2",170790524,170839101,48577
"9692","ENSACAG00000012083","GL343650.1",108822,113108,4286
"9693","ENSACAG00000012084","1",34390879,34433998,43119
"9694","ENSACAG00000012085","6",78943097,78945040,1943
"9695","ENSACAG00000012086","AAWZ02038918",434,4289,3855
"9696","ENSACAG00000012087","5",101110597,101150233,39636
"9697","ENSACAG00000012088","4",143444146,143520065,75919
"9698","ENSACAG00000012089","GL344652.1",5062,14375,9313
"9699","ENSACAG00000012091","GL343470.1",548043,564855,16812
"9700","ENSACAG00000012095","6",28325300,28366358,41058
"9701","ENSACAG00000012096","3",112022548,112038823,16275
"9702","ENSACAG00000012097","GL344070.1",11328,14433,3105
"9703","ENSACAG00000012098","3",173464646,173478410,13764
"9704","ENSACAG00000012099","5",146041543,146094490,52947
"9705","ENSACAG00000012100","GL343419.1",354482,355873,1391
"9706","ENSACAG00000012101","GL343304.1",1048260,1085172,36912
"9707","ENSACAG00000012102","GL343602.1",167047,197300,30253
"9708","ENSACAG00000012103","GL344656.1",19373,23994,4621
"9709","ENSACAG00000012104","2",67617059,67691641,74582
"9710","ENSACAG00000012105","GL343602.1",299129,318587,19458
"9711","ENSACAG00000012106","GL343650.1",143221,146882,3661
"9712","ENSACAG00000012107","GL343470.1",529958,542376,12418
"9713","ENSACAG00000012108","2",47875602,47887931,12329
"9714","ENSACAG00000012109","6",79261143,79290869,29726
"9715","ENSACAG00000012110","3",111957279,112009583,52304
"9716","ENSACAG00000012115","4",16959345,17097385,138040
"9717","ENSACAG00000012116","2",194130739,194139791,9052
"9718","ENSACAG00000012117","5",141849384,141965648,116264
"9719","ENSACAG00000012119","GL343650.1",169621,179211,9590
"9720","ENSACAG00000012120","GL344720.1",768,3203,2435
"9721","ENSACAG00000012121","GL343602.1",323946,363641,39695
"9722","ENSACAG00000012124","6",79302998,79427671,124673
"9723","ENSACAG00000012125","GL344656.1",4154,13681,9527
"9724","ENSACAG00000012126","GL343291.1",1604228,1615168,10940
"9725","ENSACAG00000012127","GL343258.1",1990283,1991560,1277
"9726","ENSACAG00000012129","4",124105657,124151368,45711
"9727","ENSACAG00000012130","6",64130924,64157962,27038
"9728","ENSACAG00000012131","GL343201.1",3760700,3761605,905
"9729","ENSACAG00000012132","2",187671828,187698926,27098
"9730","ENSACAG00000012133","GL343258.1",2027364,2028638,1274
"9731","ENSACAG00000012136","GL343304.1",1183260,1199199,15939
"9732","ENSACAG00000012137","GL343291.1",1681253,1693017,11764
"9733","ENSACAG00000012138","GL343201.1",3775683,3790930,15247
"9734","ENSACAG00000012139","1",205520641,205539311,18670
"9735","ENSACAG00000012140","GL344229.1",49595,53162,3567
"9736","ENSACAG00000012141","6",60729980,60768852,38872
"9737","ENSACAG00000012142","GL343754.1",21,61803,61782
"9738","ENSACAG00000012143","GL343462.1",386173,400540,14367
"9739","ENSACAG00000012145","5",101160035,101198602,38567
"9740","ENSACAG00000012146","AAWZ02037919",21,8961,8940
"9741","ENSACAG00000012147","2",194099936,194126168,26232
"9742","ENSACAG00000012148","3",109567184,109582226,15042
"9743","ENSACAG00000012149","5",146141838,146164117,22279
"9744","ENSACAG00000012151","GL343300.1",844869,866104,21235
"9745","ENSACAG00000012152","GL343236.1",1693065,1704536,11471
"9746","ENSACAG00000012153","GL343371.1",634866,722765,87899
"9747","ENSACAG00000012154","GL343411.1",299296,301326,2030
"9748","ENSACAG00000012155","GL343201.1",3796388,3806523,10135
"9749","ENSACAG00000012156","GL343201.1",3815393,3831295,15902
"9750","ENSACAG00000012157","GL343207.1",1525837,1549259,23422
"9751","ENSACAG00000012158","GL343699.1",28943,34302,5359
"9752","ENSACAG00000012162","GL343323.1",1194141,1205815,11674
"9753","ENSACAG00000012163","4",82051447,82051876,429
"9754","ENSACAG00000012164","GL344033.1",36169,72844,36675
"9755","ENSACAG00000012165","1",187719515,187724037,4522
"9756","ENSACAG00000012166","1",139958480,139972039,13559
"9757","ENSACAG00000012167","3",121473638,121500386,26748
"9758","ENSACAG00000012168","3",173217178,173305558,88380
"9759","ENSACAG00000012169","GL343411.1",365282,434575,69293
"9760","ENSACAG00000012173","GL344018.1",38428,41710,3282
"9761","ENSACAG00000012174","1",187660274,187689509,29235
"9762","ENSACAG00000012175","2",128564793,128640581,75788
"9763","ENSACAG00000012176","GL343507.1",299508,323921,24413
"9764","ENSACAG00000012177","AAWZ02037988",3846,5468,1622
"9765","ENSACAG00000012178","GL343699.1",58189,197672,139483
"9766","ENSACAG00000012180","6",3835712,3842167,6455
"9767","ENSACAG00000012181","GL343202.1",3989034,4145144,156110
"9768","ENSACAG00000012182","GL343512.1",189584,192653,3069
"9769","ENSACAG00000012183","6",3728750,3834082,105332
"9770","ENSACAG00000012184","2",187720334,187751602,31268
"9771","ENSACAG00000012185","AAWZ02038117",2163,11118,8955
"9772","ENSACAG00000012186","GL343299.1",1471049,1497086,26037
"9773","ENSACAG00000012188","GL343201.1",3834351,3927970,93619
"9774","ENSACAG00000012189","1",2061665,2063025,1360
"9775","ENSACAG00000012190","3",123386156,123414060,27904
"9776","ENSACAG00000012191","4",16721760,16909454,187694
"9777","ENSACAG00000012192","5",45148761,45236481,87720
"9778","ENSACAG00000012193","GL345002.1",1765,10699,8934
"9779","ENSACAG00000012194","GL343323.1",1155211,1189350,34139
"9780","ENSACAG00000012196","5",13740724,13765509,24785
"9781","ENSACAG00000012198","GL343678.1",171178,220237,49059
"9782","ENSACAG00000012199","6",27926688,28005581,78893
"9783","ENSACAG00000012200","GL343556.1",368250,426151,57901
"9784","ENSACAG00000012201","5",91064458,91086223,21765
"9785","ENSACAG00000012203","6",64089842,64104896,15054
"9786","ENSACAG00000012204","GL343236.1",1774354,1815170,40816
"9787","ENSACAG00000012205","GL343882.1",5711,22504,16793
"9788","ENSACAG00000012208","AAWZ02038925",4330,5694,1364
"9789","ENSACAG00000012210","GL343316.1",640119,641762,1643
"9790","ENSACAG00000012211","GL343239.1",1548352,1706551,158199
"9791","ENSACAG00000012212","GL344642.1",802,8602,7800
"9792","ENSACAG00000012213","2",194088046,194091177,3131
"9793","ENSACAG00000012214","5",146220355,146241918,21563
"9794","ENSACAG00000012215","4",124067729,124112018,44289
"9795","ENSACAG00000012216","GL343411.1",494162,534175,40013
"9796","ENSACAG00000012217","5",13781528,13797791,16263
"9797","ENSACAG00000012218","GL343470.1",467441,481096,13655
"9798","ENSACAG00000012219","2",88312928,88318594,5666
"9799","ENSACAG00000012220","GL343308.1",445179,593713,148534
"9800","ENSACAG00000012222","2",67587374,67597819,10445
"9801","ENSACAG00000012225","GL343479.1",636199,639072,2873
"9802","ENSACAG00000012226","GL343201.1",3959797,4016237,56440
"9803","ENSACAG00000012227","GL343479.1",662958,668600,5642
"9804","ENSACAG00000012229","2",47887210,47977605,90395
"9805","ENSACAG00000012230","2",119457730,119468670,10940
"9806","ENSACAG00000012231","GL343337.1",161288,242865,81577
"9807","ENSACAG00000012232","6",79497006,79566900,69894
"9808","ENSACAG00000012233","2",88323375,88331609,8234
"9809","ENSACAG00000012234","GL343411.1",538076,549401,11325
"9810","ENSACAG00000012235","GL343470.1",452379,466406,14027
"9811","ENSACAG00000012237","GL343401.1",874091,882568,8477
"9812","ENSACAG00000012238","5",138927257,139009169,81912
"9813","ENSACAG00000012239","GL343297.1",1326734,1359275,32541
"9814","ENSACAG00000012240","2",194066457,194077229,10772
"9815","ENSACAG00000012241","3",111914340,111915115,775
"9816","ENSACAG00000012242","GL344642.1",2752,17411,14659
"9817","ENSACAG00000012243","5",14377988,14387478,9490
"9818","ENSACAG00000012244","5",91093306,91099956,6650
"9819","ENSACAG00000012246","4",143321855,143399346,77491
"9820","ENSACAG00000012247","5",13811758,13830853,19095
"9821","ENSACAG00000012248","2",67512138,67531505,19367
"9822","ENSACAG00000012250","3",109398435,109528967,130532
"9823","ENSACAG00000012251","4",106317189,106344259,27070
"9824","ENSACAG00000012252","5",45247268,45276461,29193
"9825","ENSACAG00000012253","GL343477.1",347249,348343,1094
"9826","ENSACAG00000012254","2",119356430,119367140,10710
"9827","ENSACAG00000012255","5",146258438,146379320,120882
"9828","ENSACAG00000012256","3",111842118,111869513,27395
"9829","ENSACAG00000012257","GL343299.1",805077,1075346,270269
"9830","ENSACAG00000012258","6",64000512,64058099,57587
"9831","ENSACAG00000012261","1",205373643,205435164,61521
"9832","ENSACAG00000012262","5",91106239,91143032,36793
"9833","ENSACAG00000012264","GL343300.1",878441,903555,25114
"9834","ENSACAG00000012265","5",10084262,10129441,45179
"9835","ENSACAG00000012266","AAWZ02037243",13153,15633,2480
"9836","ENSACAG00000012267","GL343625.1",302078,375056,72978
"9837","ENSACAG00000012268","2",128403831,128476847,73016
"9838","ENSACAG00000012269","GL343507.1",332855,339273,6418
"9839","ENSACAG00000012270","1",205322424,205337045,14621
"9840","ENSACAG00000012271","4",76528115,76585021,56906
"9841","ENSACAG00000012272","AAWZ02040499",3539,6843,3304
"9842","ENSACAG00000012274","2",187767514,187813492,45978
"9843","ENSACAG00000012275","1",34419410,34445606,26196
"9844","ENSACAG00000012278","GL343401.1",923707,929198,5491
"9845","ENSACAG00000012280","GL343299.1",152218,301191,148973
"9846","ENSACAG00000012281","3",109312130,109399323,87193
"9847","ENSACAG00000012282","5",28566536,28590616,24080
"9848","ENSACAG00000012283","2",88341111,88358465,17354
"9849","ENSACAG00000012284","4",143063653,143082056,18403
"9850","ENSACAG00000012285","2",170848519,170853088,4569
"9851","ENSACAG00000012287","5",32387315,32418960,31645
"9852","ENSACAG00000012289","2",67456290,67504887,48597
"9853","ENSACAG00000012290","1",205249099,205318129,69030
"9854","ENSACAG00000012292","4",123927581,123928246,665
"9855","ENSACAG00000012294","4",123804030,123924335,120305
"9856","ENSACAG00000012297","5",13878172,13984624,106452
"9857","ENSACAG00000012298","3",123412101,123502948,90847
"9858","ENSACAG00000012299","2",26484998,26512846,27848
"9859","ENSACAG00000012301","GL343280.1",1106064,1135283,29219
"9860","ENSACAG00000012302","GL343507.1",420694,455320,34626
"9861","ENSACAG00000012303","GL343227.1",54130,92957,38827
"9862","ENSACAG00000012304","5",14357512,14377121,19609
"9863","ENSACAG00000012305","2",170859109,170877868,18759
"9864","ENSACAG00000012306","GL343337.1",254075,456936,202861
"9865","ENSACAG00000012307","4",91149661,91159458,9797
"9866","ENSACAG00000012308","6",79571628,79579653,8025
"9867","ENSACAG00000012309","2",198930601,198940941,10340
"9868","ENSACAG00000012310","1",187327876,187611375,283499
"9869","ENSACAG00000012311","GL343239.1",1711822,1714194,2372
"9870","ENSACAG00000012312","2",198879184,198890512,11328
"9871","ENSACAG00000012314","5",91143422,91149863,6441
"9872","ENSACAG00000012315","GL343207.1",1481436,1494053,12617
"9873","ENSACAG00000012316","1",186458501,186510339,51838
"9874","ENSACAG00000012317","GL343239.1",1795883,1870334,74451
"9875","ENSACAG00000012318","5",91201121,91202539,1418
"9876","ENSACAG00000012320","2",187779169,187786226,7057
"9877","ENSACAG00000012321","GL343202.1",4181089,4273662,92573
"9878","ENSACAG00000012323","5",91215549,91218762,3213
"9879","ENSACAG00000012324","GL343462.1",371650,381661,10011
"9880","ENSACAG00000012326","1",263217842,263297545,79703
"9881","ENSACAG00000012327","5",14001110,14008065,6955
"9882","ENSACAG00000012328","2",187826959,187836896,9937
"9883","ENSACAG00000012329","GL343371.1",731852,812076,80224
"9884","ENSACAG00000012330","1",139915689,139939468,23779
"9885","ENSACAG00000012331","1",263082697,263175626,92929
"9886","ENSACAG00000012332","GL343207.1",1067270,1072448,5178
"9887","ENSACAG00000012333","5",28594962,28632394,37432
"9888","ENSACAG00000012334","GL343474.1",136799,155466,18667
"9889","ENSACAG00000012335","GL343300.1",956790,1022853,66063
"9890","ENSACAG00000012336","GL343300.1",1028329,1041608,13279
"9891","ENSACAG00000012337","6",79580684,79584485,3801
"9892","ENSACAG00000012338","GL343297.1",1362072,1471635,109563
"9893","ENSACAG00000012339","GL343470.1",443920,451511,7591
"9894","ENSACAG00000012342","6",79585777,79655172,69395
"9895","ENSACAG00000012343","5",91261912,91320408,58496
"9896","ENSACAG00000012344","GL343207.1",413017,582047,169030
"9897","ENSACAG00000012345","2",88363375,88371213,7838
"9898","ENSACAG00000012349","4",76610687,76613101,2414
"9899","ENSACAG00000012351","5",10145183,10151114,5931
"9900","ENSACAG00000012352","3",121455956,121470375,14419
"9901","ENSACAG00000012353","4",76632268,76634694,2426
"9902","ENSACAG00000012354","2",198816928,198859587,42659
"9903","ENSACAG00000012355","5",32369442,32376285,6843
"9904","ENSACAG00000012356","GL343228.1",436499,445737,9238
"9905","ENSACAG00000012357","2",194026272,194035470,9198
"9906","ENSACAG00000012358","GL343280.1",910044,1102279,192235
"9907","ENSACAG00000012359","5",32342766,32353400,10634
"9908","ENSACAG00000012360","5",45282097,45293148,11051
"9909","ENSACAG00000012361","1",139880321,139936140,55819
"9910","ENSACAG00000012362","4",142995318,143033173,37855
"9911","ENSACAG00000012363","GL343846.1",54134,86501,32367
"9912","ENSACAG00000012364","2",88372946,88399784,26838
"9913","ENSACAG00000012365","GL343298.1",1066119,1077843,11724
"9914","ENSACAG00000012366","4",76920849,76923332,2483
"9915","ENSACAG00000012367","5",32290281,32332514,42233
"9916","ENSACAG00000012368","GL343699.1",201655,222968,21313
"9917","ENSACAG00000012369","GL343294.1",537591,581808,44217
"9918","ENSACAG00000012370","GL344251.1",41581,53155,11574
"9919","ENSACAG00000012372","5",45297804,45307703,9899
"9920","ENSACAG00000012373","GL343228.1",467040,476175,9135
"9921","ENSACAG00000012374","GL343323.1",1063505,1084553,21048
"9922","ENSACAG00000012376","5",10154804,10190917,36113
"9923","ENSACAG00000012377","2",172871821,172896855,25034
"9924","ENSACAG00000012378","GL343507.1",470305,470661,356
"9925","ENSACAG00000012379","2",89682343,89702567,20224
"9926","ENSACAG00000012380","GL343507.1",483546,509528,25982
"9927","ENSACAG00000012381","2",193981559,194017022,35463
"9928","ENSACAG00000012384","GL343300.1",1050153,1072291,22138
"9929","ENSACAG00000012386","2",187847586,187858760,11174
"9930","ENSACAG00000012387","1",139730932,139739016,8084
"9931","ENSACAG00000012388","6",60809611,60826424,16813
"9932","ENSACAG00000012389","1",139702118,139722506,20388
"9933","ENSACAG00000012391","1",263070058,263071743,1685
"9934","ENSACAG00000012392","GL343545.1",224878,271831,46953
"9935","ENSACAG00000012393","1",263028254,263051797,23543
"9936","ENSACAG00000012394","GL343298.1",1120707,1179172,58465
"9937","ENSACAG00000012396","GL343228.1",600003,632085,32082
"9938","ENSACAG00000012397","1",34481662,34539814,58152
"9939","ENSACAG00000012398","1",139632316,139658457,26141
"9940","ENSACAG00000012399","GL343308.1",437192,445089,7897
"9941","ENSACAG00000012400","3",191953272,191978920,25648
"9942","ENSACAG00000012401","GL343296.1",134663,147756,13093
"9943","ENSACAG00000012403","5",14007255,14021280,14025
"9944","ENSACAG00000012404","GL343239.1",1892286,1922652,30366
"9945","ENSACAG00000012405","2",128387115,128388363,1248
"9946","ENSACAG00000012406","3",111762059,111821064,59005
"9947","ENSACAG00000012407","GL343337.1",465909,488562,22653
"9948","ENSACAG00000012408","GL343296.1",1627090,1642177,15087
"9949","ENSACAG00000012409","GL343882.1",32,3055,3023
"9950","ENSACAG00000012410","GL343298.1",1211312,1248794,37482
"9951","ENSACAG00000012411","5",14329014,14354199,25185
"9952","ENSACAG00000012412","GL343308.1",378039,421083,43044
"9953","ENSACAG00000012413","GL343474.1",158317,312129,153812
"9954","ENSACAG00000012414","GL343294.1",491432,521236,29804
"9955","ENSACAG00000012415","2",128193374,128251986,58612
"9956","ENSACAG00000012416","5",28645168,28670951,25783
"9957","ENSACAG00000012417","5",31906127,31915528,9401
"9958","ENSACAG00000012418","GL343470.1",395662,415829,20167
"9959","ENSACAG00000012419","3",121408953,121422277,13324
"9960","ENSACAG00000012420","GL343323.1",1056395,1060364,3969
"9961","ENSACAG00000012421","2",198806314,198815068,8754
"9962","ENSACAG00000012423","3",109222961,109296977,74016
"9963","ENSACAG00000012424","2",67412580,67450538,37958
"9964","ENSACAG00000012425","2",187882355,187887562,5207
"9965","ENSACAG00000012426","5",14331231,14339438,8207
"9966","ENSACAG00000012427","GL343296.1",255017,508964,253947
"9967","ENSACAG00000012428","GL343372.1",13163,94597,81434
"9968","ENSACAG00000012429","1",262962533,262996418,33885
"9969","ENSACAG00000012430","GL343625.1",222828,257503,34675
"9970","ENSACAG00000012432","GL343239.1",1982928,1986735,3807
"9971","ENSACAG00000012433","2",193947910,193978099,30189
"9972","ENSACAG00000012434","GL343699.1",248292,259192,10900
"9973","ENSACAG00000012435","5",31680357,31710365,30008
"9974","ENSACAG00000012437","2",89699583,89736533,36950
"9975","ENSACAG00000012438","4",76986541,76988958,2417
"9976","ENSACAG00000012439","GL343300.1",1081483,1135581,54098
"9977","ENSACAG00000012440","GL343228.1",644215,666202,21987
"9978","ENSACAG00000012441","AAWZ02039620",3234,6671,3437
"9979","ENSACAG00000012443","3",192012497,192024513,12016
"9980","ENSACAG00000012444","GL343239.1",2026377,2206341,179964
"9981","ENSACAG00000012445","GL343462.1",346819,365012,18193
"9982","ENSACAG00000012446","5",91339610,91371405,31795
"9983","ENSACAG00000012447","2",67306983,67352828,45845
"9984","ENSACAG00000012448","2",198728960,198750339,21379
"9985","ENSACAG00000012449","5",14321792,14327035,5243
"9986","ENSACAG00000012450","5",31609326,31675026,65700
"9987","ENSACAG00000012451","4",45808436,45812098,3662
"9988","ENSACAG00000012452","2",187890460,187925010,34550
"9989","ENSACAG00000012454","GL343296.1",1390359,1607105,216746
"9990","ENSACAG00000012456","4",142913934,142920374,6440
"9991","ENSACAG00000012457","1",186299189,186448832,149643
"9992","ENSACAG00000012459","4",45176524,45265168,88644
"9993","ENSACAG00000012460","GL343298.1",1305951,1327254,21303
"9994","ENSACAG00000012461","GL343225.1",734312,744438,10126
"9995","ENSACAG00000012462","2",198698983,198722628,23645
"9996","ENSACAG00000012463","AAWZ02038310",496,12035,11539
"9997","ENSACAG00000012464","GL343699.1",262445,268649,6204
"9998","ENSACAG00000012465","GL344324.1",28280,36878,8598
"9999","ENSACAG00000012466","GL343337.1",508327,509109,782
"10000","ENSACAG00000012467","GL343625.1",182928,200500,17572
"10001","ENSACAG00000012468","GL343323.1",1025765,1046634,20869
"10002","ENSACAG00000012469","GL343337.1",515590,533222,17632
"10003","ENSACAG00000012470","GL343458.1",51039,123787,72748
"10004","ENSACAG00000012471","4",77018361,77020784,2423
"10005","ENSACAG00000012472","2",88406699,88407890,1191
"10006","ENSACAG00000012473","5",146413400,146415664,2264
"10007","ENSACAG00000012474","5",146455933,146467025,11092
"10008","ENSACAG00000012475","2",88411488,88457459,45971
"10009","ENSACAG00000012476","2",13295779,13327812,32033
"10010","ENSACAG00000012477","GL343372.1",226807,385730,158923
"10011","ENSACAG00000012478","2",47993071,48060703,67632
"10012","ENSACAG00000012479","GL343337.1",537961,544068,6107
"10013","ENSACAG00000012480","AAWZ02040513",4686,6853,2167
"10014","ENSACAG00000012481","GL343372.1",385732,405685,19953
"10015","ENSACAG00000012482","GL343225.1",640781,702350,61569
"10016","ENSACAG00000012483","5",146474690,146497405,22715
"10017","ENSACAG00000012485","6",60829355,60837266,7911
"10018","ENSACAG00000012486","1",139568669,139585523,16854
"10019","ENSACAG00000012487","5",14030402,14054633,24231
"10020","ENSACAG00000012488","5",45441286,45442409,1123
"10021","ENSACAG00000012489","4",77130817,77253686,122869
"10022","ENSACAG00000012490","GL343308.1",325946,363536,37590
"10023","ENSACAG00000012491","5",45327681,45345815,18134
"10024","ENSACAG00000012492","GL343228.1",670549,711359,40810
"10025","ENSACAG00000012493","4",106384644,106429332,44688
"10026","ENSACAG00000012494","2",198588669,198608415,19746
"10027","ENSACAG00000012495","GL343555.1",16256,30093,13837
"10028","ENSACAG00000012496","GL343371.1",840700,894312,53612
"10029","ENSACAG00000012498","5",146783264,146818382,35118
"10030","ENSACAG00000012499","GL344473.1",35171,35236,65
"10031","ENSACAG00000012500","GL343337.1",552528,552941,413
"10032","ENSACAG00000012501","5",10218894,10232711,13817
"10033","ENSACAG00000012502","GL343297.1",1553617,1582710,29093
"10034","ENSACAG00000012503","1",186425305,186427176,1871
"10035","ENSACAG00000012504","3",123532775,123770742,237967
"10036","ENSACAG00000012505","GL344762.1",3854,6181,2327
"10037","ENSACAG00000012507","5",91391137,91538063,146926
"10038","ENSACAG00000012509","GL343323.1",1018331,1025703,7372
"10039","ENSACAG00000012510","GL344762.1",9508,14800,5292
"10040","ENSACAG00000012511","GL344253.1",1870,4180,2310
"10041","ENSACAG00000012512","2",172906470,172936153,29683
"10042","ENSACAG00000012513","AAWZ02037479",10792,12989,2197
"10043","ENSACAG00000012515","GL343372.1",412706,434498,21792
"10044","ENSACAG00000012516","GL343846.1",25303,51439,26136
"10045","ENSACAG00000012517","6",79745911,79768001,22090
"10046","ENSACAG00000012519","2",88474297,88595647,121350
"10047","ENSACAG00000012520","GL344111.1",22489,43572,21083
"10048","ENSACAG00000012521","5",28679670,28710973,31303
"10049","ENSACAG00000012522","6",63899937,63986053,86116
"10050","ENSACAG00000012523","GL344253.1",6987,18764,11777
"10051","ENSACAG00000012525","1",205178454,205206001,27547
"10052","ENSACAG00000012527","1",34588903,34812814,223911
"10053","ENSACAG00000012529","1",262999778,263021011,21233
"10054","ENSACAG00000012530","GL343296.1",1338833,1367056,28223
"10055","ENSACAG00000012533","GL344111.1",16092,20050,3958
"10056","ENSACAG00000012534","5",14064345,14066199,1854
"10057","ENSACAG00000012536","6",63838547,63840229,1682
"10058","ENSACAG00000012537","2",88634625,88641973,7348
"10059","ENSACAG00000012539","6",63732260,63756181,23921
"10060","ENSACAG00000012540","5",139012861,139035938,23077
"10061","ENSACAG00000012542","5",14090659,14266992,176333
"10062","ENSACAG00000012543","5",145076010,145082067,6057
"10063","ENSACAG00000012546","AAWZ02038706",3235,3907,672
"10064","ENSACAG00000012547","GL343323.1",951527,959160,7633
"10065","ENSACAG00000012548","GL343277.1",1785543,1788467,2924
"10066","ENSACAG00000012549","2",198449536,198497758,48222
"10067","ENSACAG00000012551","6",63721374,63726111,4737
"10068","ENSACAG00000012552","5",146835883,146858948,23065
"10069","ENSACAG00000012553","5",146877521,146906506,28985
"10070","ENSACAG00000012554","GL343555.1",31825,110517,78692
"10071","ENSACAG00000012558","GL343323.1",542801,755884,213083
"10072","ENSACAG00000012559","5",91543842,91544552,710
"10073","ENSACAG00000012560","5",91545172,91578903,33731
"10074","ENSACAG00000012561","1",147593421,147706274,112853
"10075","ENSACAG00000012562","GL343300.1",1138794,1167303,28509
"10076","ENSACAG00000012565","GL343545.1",287680,295503,7823
"10077","ENSACAG00000012567","3",141489941,141579631,89690
"10078","ENSACAG00000012569","5",145031488,145052273,20785
"10079","ENSACAG00000012571","GL343715.1",262665,269926,7261
"10080","ENSACAG00000012572","5",31478850,31494149,15299
"10081","ENSACAG00000012573","5",31453665,31467699,14034
"10082","ENSACAG00000012574","2",13272681,13286987,14306
"10083","ENSACAG00000012575","GL343980.1",11809,24083,12274
"10084","ENSACAG00000012576","2",187928018,187953585,25567
"10085","ENSACAG00000012577","2",173033011,173042638,9627
"10086","ENSACAG00000012578","6",63691136,63709687,18551
"10087","ENSACAG00000012579","6",27606040,27681291,75251
"10088","ENSACAG00000012581","GL343294.1",479746,487540,7794
"10089","ENSACAG00000012582","6",63586467,63681664,95197
"10090","ENSACAG00000012584","3",123780063,123816610,36547
"10091","ENSACAG00000012585","GL343228.1",749841,785432,35591
"10092","ENSACAG00000012586","2",26404018,26485096,81078
"10093","ENSACAG00000012587","6",27579559,27592728,13169
"10094","ENSACAG00000012591","GL343308.1",221509,262619,41110
"10095","ENSACAG00000012592","GL343980.1",25319,28627,3308
"10096","ENSACAG00000012593","6",60891353,60901438,10085
"10097","ENSACAG00000012594","2",89756946,89775442,18496
"10098","ENSACAG00000012595","GL343225.1",167222,375803,208581
"10099","ENSACAG00000012596","2",127844628,127882796,38168
"10100","ENSACAG00000012597","GL343715.1",214507,233084,18577
"10101","ENSACAG00000012598","AAWZ02040306",3769,5633,1864
"10102","ENSACAG00000012599","GL343980.1",27428,51756,24328
"10103","ENSACAG00000012600","1",147521088,147561049,39961
"10104","ENSACAG00000012601","GL343300.1",57305,116059,58754
"10105","ENSACAG00000012603","GL343294.1",1564494,1614728,50234
"10106","ENSACAG00000012604","GL343752.1",38867,107395,68528
"10107","ENSACAG00000012606","5",31437545,31446444,8899
"10108","ENSACAG00000012608","GL343345.1",246043,351830,105787
"10109","ENSACAG00000012609","3",123822034,123907929,85895
"10110","ENSACAG00000012611","1",34827093,34963825,136732
"10111","ENSACAG00000012612","6",60910466,60952613,42147
"10112","ENSACAG00000012613","1",139546660,139564894,18234
"10113","ENSACAG00000012614","2",89776488,89783094,6606
"10114","ENSACAG00000012615","3",141445338,141483572,38234
"10115","ENSACAG00000012616","5",31408022,31412753,4731
"10116","ENSACAG00000012617","GL343476.1",521326,554056,32730
"10117","ENSACAG00000012618","GL343345.1",424878,457055,32177
"10118","ENSACAG00000012619","AAWZ02038048",21,10407,10386
"10119","ENSACAG00000012620","GL343545.1",301208,313980,12772
"10120","ENSACAG00000012621","GL343470.1",313789,394114,80325
"10121","ENSACAG00000012622","1",34963306,34969884,6578
"10122","ENSACAG00000012623","GL343202.1",4296021,4298968,2947
"10123","ENSACAG00000012624","5",10244979,10296590,51611
"10124","ENSACAG00000012625","GL343372.1",555340,575514,20174
"10125","ENSACAG00000012626","5",146919438,146928162,8724
"10126","ENSACAG00000012627","1",35007479,35040066,32587
"10127","ENSACAG00000012628","3",192100483,192115896,15413
"10128","ENSACAG00000012629","5",31393478,31394464,986
"10129","ENSACAG00000012630","5",139042537,139049515,6978
"10130","ENSACAG00000012631","5",31206237,31255710,49473
"10131","ENSACAG00000012632","3",192130497,192142327,11830
"10132","ENSACAG00000012633","GL343846.1",11243,21061,9818
"10133","ENSACAG00000012635","3",192251865,192260286,8421
"10134","ENSACAG00000012636","GL343980.1",88963,101607,12644
"10135","ENSACAG00000012637","5",45461246,45479496,18250
"10136","ENSACAG00000012638","GL343300.1",1168244,1183995,15751
"10137","ENSACAG00000012639","6",79796611,79806283,9672
"10138","ENSACAG00000012640","6",27554398,27574523,20125
"10139","ENSACAG00000012641","5",144919423,145008819,89396
"10140","ENSACAG00000012642","GL343228.1",791752,865439,73687
"10141","ENSACAG00000012644","GL343761.1",21,44014,43993
"10142","ENSACAG00000012645","2",187979711,188014857,35146
"10143","ENSACAG00000012646","6",27505693,27531544,25851
"10144","ENSACAG00000012647","2",198340313,198430254,89941
"10145","ENSACAG00000012648","3",192281536,192303989,22453
"10146","ENSACAG00000012649","GL343202.1",4342702,4344655,1953
"10147","ENSACAG00000012650","3",192311974,192323674,11700
"10148","ENSACAG00000012651","5",28714053,28728361,14308
"10149","ENSACAG00000012652","1",35066209,35083721,17512
"10150","ENSACAG00000012653","2",48154079,48165883,11804
"10151","ENSACAG00000012654","5",31177737,31205247,27510
"10152","ENSACAG00000012656","GL343476.1",506086,513554,7468
"10153","ENSACAG00000012657","GL343476.1",483464,497588,14124
"10154","ENSACAG00000012658","1",64740256,64782057,41801
"10155","ENSACAG00000012660","3",123917068,123928920,11852
"10156","ENSACAG00000012661","GL343294.1",932669,974781,42112
"10157","ENSACAG00000012663","5",91802199,92335373,533174
"10158","ENSACAG00000012664","3",109132113,109152489,20376
"10159","ENSACAG00000012665","GL343280.1",829587,862181,32594
"10160","ENSACAG00000012666","3",111786776,111787444,668
"10161","ENSACAG00000012667","3",111742434,111756410,13976
"10162","ENSACAG00000012668","GL343202.1",4348731,4349009,278
"10163","ENSACAG00000012669","GL343202.1",4353074,4410943,57869
"10164","ENSACAG00000012670","5",45557752,45565946,8194
"10165","ENSACAG00000012671","GL343226.1",26429,74270,47841
"10166","ENSACAG00000012672","6",34120486,34142628,22142
"10167","ENSACAG00000012674","GL343300.1",1183563,1192305,8742
"10168","ENSACAG00000012675","GL343298.1",1332530,1437204,104674
"10169","ENSACAG00000012676","GL343226.1",228257,264560,36303
"10170","ENSACAG00000012677","2",89805683,89823996,18313
"10171","ENSACAG00000012678","GL343476.1",403949,464679,60730
"10172","ENSACAG00000012679","3",141421629,141435924,14295
"10173","ENSACAG00000012681","3",123939285,123988467,49182
"10174","ENSACAG00000012682","GL343294.1",817267,838725,21458
"10175","ENSACAG00000012683","GL343507.1",510934,511176,242
"10176","ENSACAG00000012684","5",144552762,144591995,39233
"10177","ENSACAG00000012686","GL343846.1",42,11812,11770
"10178","ENSACAG00000012688","GL343752.1",190008,217016,27008
"10179","ENSACAG00000012689","5",139047684,139065504,17820
"10180","ENSACAG00000012690","2",88688147,88704999,16852
"10181","ENSACAG00000012691","GL343226.1",464488,467553,3065
"10182","ENSACAG00000012692","3",109102685,109141336,38651
"10183","ENSACAG00000012693","GL343761.1",49885,56940,7055
"10184","ENSACAG00000012694","GL344250.1",35735,46368,10633
"10185","ENSACAG00000012695","5",45599248,45617326,18078
"10186","ENSACAG00000012696","GL344250.1",50105,63175,13070
"10187","ENSACAG00000012698","1",35083767,35096180,12413
"10188","ENSACAG00000012699","2",127733544,127773599,40055
"10189","ENSACAG00000012700","2",39569130,39653307,84177
"10190","ENSACAG00000012701","GL343507.1",520668,529369,8701
"10191","ENSACAG00000012702","GL343300.1",1199822,1203605,3783
"10192","ENSACAG00000012703","2",67297916,67302569,4653
"10193","ENSACAG00000012704","GL343507.1",4786,30440,25654
"10194","ENSACAG00000012705","1",64793354,64809105,15751
"10195","ENSACAG00000012706","GL343226.1",1202614,1222176,19562
"10196","ENSACAG00000012708","2",48198026,48242144,44118
"10197","ENSACAG00000012709","GL343345.1",579409,856437,277028
"10198","ENSACAG00000012710","AAWZ02037018",13154,14275,1121
"10199","ENSACAG00000012712","5",10388783,10515556,126773
"10200","ENSACAG00000012713","3",111694533,111710681,16148
"10201","ENSACAG00000012715","2",67033474,67047647,14173
"10202","ENSACAG00000012716","5",28749012,28798412,49400
"10203","ENSACAG00000012717","AAWZ02036908",773,8147,7374
"10204","ENSACAG00000012718","1",96009742,96033773,24031
"10205","ENSACAG00000012719","GL343296.1",1051750,1282751,231001
"10206","ENSACAG00000012720","5",146930474,146970670,40196
"10207","ENSACAG00000012721","4",106450817,106496883,46066
"10208","ENSACAG00000012722","GL344833.1",4884,16591,11707
"10209","ENSACAG00000012723","2",127651281,127701239,49958
"10210","ENSACAG00000012724","5",127156207,127156788,581
"10211","ENSACAG00000012725","GL343298.1",1595644,1666675,71031
"10212","ENSACAG00000012726","GL343761.1",61201,94435,33234
"10213","ENSACAG00000012728","AAWZ02036908",7661,20261,12600
"10214","ENSACAG00000012729","1",64833205,64838856,5651
"10215","ENSACAG00000012730","GL343294.1",613870,802467,188597
"10216","ENSACAG00000012731","2",26270945,26316326,45381
"10217","ENSACAG00000012732","GL343462.1",300869,333405,32536
"10218","ENSACAG00000012735","GL343507.1",41276,71152,29876
"10219","ENSACAG00000012738","1",147400870,147462074,61204
"10220","ENSACAG00000012739","6",63462911,63564233,101322
"10221","ENSACAG00000012740","1",65011660,65042902,31242
"10222","ENSACAG00000012741","4",106537185,106540134,2949
"10223","ENSACAG00000012742","3",192366647,192475998,109351
"10224","ENSACAG00000012743","6",79802832,79820107,17275
"10225","ENSACAG00000012744","6",60958040,60973446,15406
"10226","ENSACAG00000012745","4",77557844,77577994,20150
"10227","ENSACAG00000012746","5",31151841,31158579,6738
"10228","ENSACAG00000012747","4",77641242,77683884,42642
"10229","ENSACAG00000012748","GL343226.1",1367462,1391084,23622
"10230","ENSACAG00000012749","GL343372.1",643933,722001,78068
"10231","ENSACAG00000012750","AAWZ02040215",987,6935,5948
"10232","ENSACAG00000012754","1",139474631,139500452,25821
"10233","ENSACAG00000012756","3",95603733,95769860,166127
"10234","ENSACAG00000012757","2",39715410,39727241,11831
"10235","ENSACAG00000012758","2",39802641,39806113,3472
"10236","ENSACAG00000012759","4",106564284,106582306,18022
"10237","ENSACAG00000012761","3",141402322,141403029,707
"10238","ENSACAG00000012762","2",39875707,39885559,9852
"10239","ENSACAG00000012763","GL343226.1",1401643,1501342,99699
"10240","ENSACAG00000012765","5",139121488,139155748,34260
"10241","ENSACAG00000012767","5",30996864,31006253,9389
"10242","ENSACAG00000012768","4",77682055,77744183,62128
"10243","ENSACAG00000012769","6",27456662,27482753,26091
"10244","ENSACAG00000012770","GL343474.1",400567,405466,4899
"10245","ENSACAG00000012771","5",30978340,30992534,14194
"10246","ENSACAG00000012772","2",89828800,89843567,14767
"10247","ENSACAG00000012773","5",15362315,15392077,29762
"10248","ENSACAG00000012775","5",146979611,146993285,13674
"10249","ENSACAG00000012776","GL343545.1",348157,366756,18599
"10250","ENSACAG00000012777","GL343725.1",187661,199313,11652
"10251","ENSACAG00000012780","5",10629143,10652764,23621
"10252","ENSACAG00000012781","5",147007792,147027914,20122
"10253","ENSACAG00000012782","1",65750533,66066919,316386
"10254","ENSACAG00000012783","GL343300.1",1338144,1366222,28078
"10255","ENSACAG00000012784","GL343228.1",903187,913561,10374
"10256","ENSACAG00000012786","6",60982089,61144436,162347
"10257","ENSACAG00000012787","2",66980914,67021231,40317
"10258","ENSACAG00000012788","2",39908241,39952754,44513
"10259","ENSACAG00000012789","1",35108646,35164695,56049
"10260","ENSACAG00000012790","GL343300.1",172621,201806,29185
"10261","ENSACAG00000012791","1",13068336,13243881,175545
"10262","ENSACAG00000012793","2",127572427,127610906,38479
"10263","ENSACAG00000012794","GL343371.1",922319,927341,5022
"10264","ENSACAG00000012795","GL343228.1",943991,955393,11402
"10265","ENSACAG00000012796","5",10653201,10664388,11187
"10266","ENSACAG00000012797","GL343371.1",931502,949354,17852
"10267","ENSACAG00000012798","GL343323.1",35588,76357,40769
"10268","ENSACAG00000012799","5",10738946,10795567,56621
"10269","ENSACAG00000012800","GL344275.1",40640,53099,12459
"10270","ENSACAG00000012801","GL343470.1",307283,307828,545
"10271","ENSACAG00000012802","3",192485186,192502875,17689
"10272","ENSACAG00000012803","GL343761.1",97550,112007,14457
"10273","ENSACAG00000012804","6",27436648,27454519,17871
"10274","ENSACAG00000012805","GL343470.1",230532,295051,64519
"10275","ENSACAG00000012806","1",13362216,13404775,42559
"10276","ENSACAG00000012808","4",44617447,44778094,160647
"10277","ENSACAG00000012809","GL343801.1",2960,93556,90596
"10278","ENSACAG00000012810","6",27391000,27396431,5431
"10279","ENSACAG00000012811","GL343300.1",225967,517794,291827
"10280","ENSACAG00000012812","5",45655854,45690941,35087
"10281","ENSACAG00000012814","6",79824026,79849614,25588
"10282","ENSACAG00000012815","6",27315576,27384275,68699
"10283","ENSACAG00000012816","3",192509231,192541685,32454
"10284","ENSACAG00000012817","3",192553538,192576133,22595
"10285","ENSACAG00000012820","AAWZ02037713",981,13949,12968
"10286","ENSACAG00000012822","3",192700155,192785803,85648
"10287","ENSACAG00000012823","5",15251925,15309297,57372
"10288","ENSACAG00000012824","4",106583793,106588697,4904
"10289","ENSACAG00000012825","3",108991704,108999555,7851
"10290","ENSACAG00000012826","GL343761.1",137311,150974,13663
"10291","ENSACAG00000012827","2",88709332,88735372,26040
"10292","ENSACAG00000012828","2",48304019,48329936,25917
"10293","ENSACAG00000012830","GL343300.1",1401211,1427034,25823
"10294","ENSACAG00000012831","5",144468183,144548333,80150
"10295","ENSACAG00000012832","GL343725.1",222402,234534,12132
"10296","ENSACAG00000012833","2",88743440,88791849,48409
"10297","ENSACAG00000012834","GL343638.1",350074,361849,11775
"10298","ENSACAG00000012835","GL343476.1",354934,393706,38772
"10299","ENSACAG00000012836","AAWZ02037666",3272,15028,11756
"10300","ENSACAG00000012837","2",48340944,48348973,8029
"10301","ENSACAG00000012838","1",95975892,96008016,32124
"10302","ENSACAG00000012839","5",108324051,108333514,9463
"10303","ENSACAG00000012840","GL343638.1",139170,309862,170692
"10304","ENSACAG00000012841","4",106610594,106625975,15381
"10305","ENSACAG00000012843","4",106640803,106655837,15034
"10306","ENSACAG00000012844","GL343507.1",72359,85120,12761
"10307","ENSACAG00000012845","GL344097.1",55348,62249,6901
"10308","ENSACAG00000012846","1",35167000,35246714,79714
"10309","ENSACAG00000012847","GL344080.1",17737,37749,20012
"10310","ENSACAG00000012848","GL343801.1",109121,111059,1938
"10311","ENSACAG00000012851","GL343228.1",1047981,1078730,30749
"10312","ENSACAG00000012852","GL343372.1",722738,791355,68617
"10313","ENSACAG00000012853","GL343470.1",217235,225039,7804
"10314","ENSACAG00000012856","1",139465222,139475156,9934
"10315","ENSACAG00000012857","1",95953569,95977982,24413
"10316","ENSACAG00000012858","5",147078237,147093243,15006
"10317","ENSACAG00000012859","GL343673.1",117177,138884,21707
"10318","ENSACAG00000012860","5",147096044,147097465,1421
"10319","ENSACAG00000012861","2",48366509,48437676,71167
"10320","ENSACAG00000012862","GL343673.1",244617,245447,830
"10321","ENSACAG00000012863","GL344275.1",22977,31523,8546
"10322","ENSACAG00000012864","5",108365266,108402524,37258
"10323","ENSACAG00000012865","1",196835993,196836757,764
"10324","ENSACAG00000012866","1",13414017,13495690,81673
"10325","ENSACAG00000012867","GL343725.1",236112,238138,2026
"10326","ENSACAG00000012868","GL344275.1",9571,15457,5886
"10327","ENSACAG00000012869","GL344097.1",50627,55911,5284
"10328","ENSACAG00000012870","5",147115601,147159561,43960
"10329","ENSACAG00000012871","GL343725.1",237232,254715,17483
"10330","ENSACAG00000012873","2",26088007,26142231,54224
"10331","ENSACAG00000012874","1",139402674,139446390,43716
"10332","ENSACAG00000012875","5",144451517,144466776,15259
"10333","ENSACAG00000012876","GL343372.1",803367,899838,96471
"10334","ENSACAG00000012879","GL343312.1",18496,22269,3773
"10335","ENSACAG00000012880","2",127469725,127539026,69301
"10336","ENSACAG00000012881","GL344275.1",498,2561,2063
"10337","ENSACAG00000012882","6",27051956,27123735,71779
"10338","ENSACAG00000012883","GL343801.1",117172,127154,9982
"10339","ENSACAG00000012884","GL343300.1",1429951,1484029,54078
"10340","ENSACAG00000012885","GL343312.1",413870,419400,5530
"10341","ENSACAG00000012886","AAWZ02036689",11537,21022,9485
"10342","ENSACAG00000012887","GL343462.1",277824,297253,19429
"10343","ENSACAG00000012888","GL343202.1",4448766,4462322,13556
"10344","ENSACAG00000012889","AAWZ02041552",815,5418,4603
"10345","ENSACAG00000012890","2",39957374,39975216,17842
"10346","ENSACAG00000012891","GL343228.1",1259683,1340986,81303
"10347","ENSACAG00000012892","5",28822080,29232783,410703
"10348","ENSACAG00000012893","1",147363802,147393928,30126
"10349","ENSACAG00000012894","GL343312.1",335814,369088,33274
"10350","ENSACAG00000012895","GL343462.1",268859,278032,9173
"10351","ENSACAG00000012896","6",26505266,26813639,308373
"10352","ENSACAG00000012897","GL343296.1",1016271,1049930,33659
"10353","ENSACAG00000012898","GL343194.1",9940873,9964140,23267
"10354","ENSACAG00000012899","GL343194.1",10043229,10065854,22625
"10355","ENSACAG00000012900","GL343507.1",529461,543019,13558
"10356","ENSACAG00000012901","6",21513940,21518701,4761
"10357","ENSACAG00000012902","GL343300.1",567597,702788,135191
"10358","ENSACAG00000012903","GL343312.1",184413,205021,20608
"10359","ENSACAG00000012904","6",21537240,21581448,44208
"10360","ENSACAG00000012905","5",144431957,144443744,11787
"10361","ENSACAG00000012906","2",88801909,88804146,2237
"10362","ENSACAG00000012907","GL343312.1",687014,688579,1565
"10363","ENSACAG00000012908","5",45707762,45725393,17631
"10364","ENSACAG00000012909","GL343376.1",18693,89333,70640
"10365","ENSACAG00000012912","2",88891870,88893237,1367
"10366","ENSACAG00000012913","5",10800643,10816706,16063
"10367","ENSACAG00000012914","2",88905188,88960909,55721
"10368","ENSACAG00000012916","GL343312.1",877470,877655,185
"10369","ENSACAG00000012917","GL343312.1",1037109,1064987,27878
"10370","ENSACAG00000012919","GL344097.1",31422,41564,10142
"10371","ENSACAG00000012920","GL344097.1",1716,26724,25008
"10372","ENSACAG00000012921","5",147159436,147174977,15541
"10373","ENSACAG00000012923","4",77746112,77747416,1304
"10374","ENSACAG00000012925","4",77767628,77776052,8424
"10375","ENSACAG00000012926","2",159547575,159601612,54037
"10376","ENSACAG00000012928","5",45742544,45771910,29366
"10377","ENSACAG00000012929","2",39980050,39986173,6123
"10378","ENSACAG00000012930","GL343801.1",145577,149446,3869
"10379","ENSACAG00000012931","GL343470.1",194051,214697,20646
"10380","ENSACAG00000012932","5",15226562,15245847,19285
"10381","ENSACAG00000012933","5",30896191,30964091,67900
"10382","ENSACAG00000012934","6",21589110,21660905,71795
"10383","ENSACAG00000012936","2",26012860,26017094,4234
"10384","ENSACAG00000012937","4",77782860,77809207,26347
"10385","ENSACAG00000012938","2",39991421,40018558,27137
"10386","ENSACAG00000012939","GL343545.1",368343,377001,8658
"10387","ENSACAG00000012940","GL343462.1",126090,277251,151161
"10388","ENSACAG00000012941","GL343725.1",245187,255790,10603
"10389","ENSACAG00000012942","2",25968458,26010080,41622
"10390","ENSACAG00000012944","1",139010024,139304201,294177
"10391","ENSACAG00000012945","GL343376.1",121578,152711,31133
"10392","ENSACAG00000012946","2",40139637,40156571,16934
"10393","ENSACAG00000012947","2",40160647,40209665,49018
"10394","ENSACAG00000012949","GL343507.1",107208,123345,16137
"10395","ENSACAG00000012950","1",35256505,35258392,1887
"10396","ENSACAG00000012952","5",139234439,139275172,40733
"10397","ENSACAG00000012953","5",10826630,10865875,39245
"10398","ENSACAG00000012954","1",95913110,95934307,21197
"10399","ENSACAG00000012955","GL343801.1",149825,160560,10735
"10400","ENSACAG00000012956","1",35270691,35305561,34870
"10401","ENSACAG00000012957","GL344325.1",284,16709,16425
"10402","ENSACAG00000012958","2",188057543,188079012,21469
"10403","ENSACAG00000012959","5",10868902,10917486,48584
"10404","ENSACAG00000012960","GL343801.1",173579,176084,2505
"10405","ENSACAG00000012961","6",23528980,23548969,19989
"10406","ENSACAG00000012963","GL343312.1",1090528,1097121,6593
"10407","ENSACAG00000012964","GL343372.1",914088,924597,10509
"10408","ENSACAG00000012965","2",88972855,89061105,88250
"10409","ENSACAG00000012966","5",147182825,147212810,29985
"10410","ENSACAG00000012967","GL343709.1",114086,185124,71038
"10411","ENSACAG00000012968","5",45792505,45795583,3078
"10412","ENSACAG00000012969","GL343194.1",10082522,10096746,14224
"10413","ENSACAG00000012970","5",45826568,45878163,51595
"10414","ENSACAG00000012971","6",31897031,31939674,42643
"10415","ENSACAG00000012972","AAWZ02041606",3881,5460,1579
"10416","ENSACAG00000012973","6",31866784,31876263,9479
"10417","ENSACAG00000012975","GL343507.1",140215,178422,38207
"10418","ENSACAG00000012976","5",147222016,147234889,12873
"10419","ENSACAG00000012977","4",33551380,33770661,219281
"10420","ENSACAG00000012978","4",77812733,77816096,3363
"10421","ENSACAG00000012979","GL343727.1",149612,169581,19969
"10422","ENSACAG00000012980","GL343270.1",1848650,1863404,14754
"10423","ENSACAG00000012981","2",25947450,25958048,10598
"10424","ENSACAG00000012983","2",40419310,40471831,52521
"10425","ENSACAG00000012984","GL343545.1",383347,397095,13748
"10426","ENSACAG00000012985","1",147342712,147363929,21217
"10427","ENSACAG00000012986","1",95890157,95902212,12055
"10428","ENSACAG00000012987","4",77816425,77831707,15282
"10429","ENSACAG00000012989","6",63392538,63409208,16670
"10430","ENSACAG00000012990","5",139310694,139362518,51824
"10431","ENSACAG00000012991","GL343727.1",111975,149293,37318
"10432","ENSACAG00000012992","6",31853421,31864391,10970
"10433","ENSACAG00000012993","GL343300.1",1489664,1504430,14766
"10434","ENSACAG00000012994","5",139412820,139453367,40547
"10435","ENSACAG00000012995","GL343476.1",279711,318205,38494
"10436","ENSACAG00000012996","1",6723154,6736769,13615
"10437","ENSACAG00000012997","2",25934465,25941786,7321
"10438","ENSACAG00000012998","2",159508664,159532498,23834
"10439","ENSACAG00000012999","5",139479766,139576718,96952
"10440","ENSACAG00000013000","GL343372.1",957706,993963,36257
"10441","ENSACAG00000013001","GL343270.1",1816456,1832354,15898
"10442","ENSACAG00000013002","2",188158132,188160263,2131
"10443","ENSACAG00000013003","1",138869687,139054248,184561
"10444","ENSACAG00000013004","GL343283.1",1767541,1791893,24352
"10445","ENSACAG00000013005","GL343300.1",1506937,1518359,11422
"10446","ENSACAG00000013006","AAWZ02039802",4010,6700,2690
"10447","ENSACAG00000013007","5",147402862,147545608,142746
"10448","ENSACAG00000013008","4",77840668,77842038,1370
"10449","ENSACAG00000013009","4",77876878,77877810,932
"10450","ENSACAG00000013010","GL343376.1",198618,260709,62091
"10451","ENSACAG00000013011","2",25921630,25934851,13221
"10452","ENSACAG00000013012","5",29247135,29298722,51587
"10453","ENSACAG00000013013","6",63291336,63321032,29696
"10454","ENSACAG00000013014","2",188275734,188327209,51475
"10455","ENSACAG00000013015","2",25875005,25896480,21475
"10456","ENSACAG00000013016","4",77903757,77913860,10103
"10457","ENSACAG00000013017","1",95818988,95867341,48353
"10458","ENSACAG00000013018","GL343476.1",264630,273279,8649
"10459","ENSACAG00000013019","AAWZ02037556",100,14922,14822
"10460","ENSACAG00000013020","GL343300.1",1532494,1550268,17774
"10461","ENSACAG00000013021","1",13547708,13580895,33187
"10462","ENSACAG00000013022","GL344271.1",3114,20276,17162
"10463","ENSACAG00000013023","6",58196235,58205171,8936
"10464","ENSACAG00000013024","GL343372.1",993461,1022603,29142
"10465","ENSACAG00000013026","4",33801601,33812385,10784
"10466","ENSACAG00000013029","GL343194.1",10114151,10166713,52562
"10467","ENSACAG00000013030","1",138670155,138715612,45457
"10468","ENSACAG00000013031","GL343228.1",1371328,1431262,59934
"10469","ENSACAG00000013033","1",6891096,6936705,45609
"10470","ENSACAG00000013034","GL344271.1",16101,30002,13901
"10471","ENSACAG00000013037","6",58235061,58287181,52120
"10472","ENSACAG00000013038","5",108404485,108415304,10819
"10473","ENSACAG00000013039","2",198269939,198310663,40724
"10474","ENSACAG00000013040","6",23562204,23569499,7295
"10475","ENSACAG00000013042","2",127285689,127285820,131
"10476","ENSACAG00000013043","GL343476.1",23931,165299,141368
"10477","ENSACAG00000013044","2",66961606,66976869,15263
"10478","ENSACAG00000013045","1",35628255,35888099,259844
"10479","ENSACAG00000013046","2",127286436,127329932,43496
"10480","ENSACAG00000013047","GL344158.1",41929,48904,6975
"10481","ENSACAG00000013049","2",198300726,198302949,2223
"10482","ENSACAG00000013050","6",63201901,63260151,58250
"10483","ENSACAG00000013051","GL343470.1",164712,181386,16674
"10484","ENSACAG00000013052","1",10231662,10240368,8706
"10485","ENSACAG00000013053","4",33817940,33821477,3537
"10486","ENSACAG00000013054","GL343270.1",1616281,1807292,191011
"10487","ENSACAG00000013055","6",23581037,23585110,4073
"10488","ENSACAG00000013056","5",10997103,11161131,164028
"10489","ENSACAG00000013058","4",33830778,33833179,2401
"10490","ENSACAG00000013059","4",33893020,33957679,64659
"10491","ENSACAG00000013060","LGf",2366962,2368024,1062
"10492","ENSACAG00000013062","6",26369115,26454919,85804
"10493","ENSACAG00000013064","GL343270.1",1525300,1582471,57171
"10494","ENSACAG00000013065","GL343545.1",432918,437386,4468
"10495","ENSACAG00000013066","5",108426984,108438036,11052
"10496","ENSACAG00000013067","6",61163031,61223313,60282
"10497","ENSACAG00000013068","6",31847527,31848558,1031
"10498","ENSACAG00000013069","6",31362176,31382230,20054
"10499","ENSACAG00000013070","2",127174699,127197136,22437
"10500","ENSACAG00000013072","GL343558.1",153828,163222,9394
"10501","ENSACAG00000013073","GL343507.1",179242,198091,18849
"10502","ENSACAG00000013074","GL344637.1",13049,24846,11797
"10503","ENSACAG00000013075","GL343226.1",1568053,1725115,157062
"10504","ENSACAG00000013076","6",31328170,31339393,11223
"10505","ENSACAG00000013077","GL343470.1",14622,139110,124488
"10506","ENSACAG00000013078","6",23589408,23657521,68113
"10507","ENSACAG00000013079","GL343372.1",1029189,1030911,1722
"10508","ENSACAG00000013080","6",31172749,31224190,51441
"10509","ENSACAG00000013081","LGf",2370844,2386526,15682
"10510","ENSACAG00000013082","2",66950894,66957773,6879
"10511","ENSACAG00000013083","GL343545.1",446254,465637,19383
"10512","ENSACAG00000013084","AAWZ02035786",15609,38057,22448
"10513","ENSACAG00000013085","1",9966877,9968901,2024
"10514","ENSACAG00000013086","1",147292875,147294344,1469
"10515","ENSACAG00000013087","1",138637671,138643392,5721
"10516","ENSACAG00000013088","6",79905552,79980533,74981
"10517","ENSACAG00000013089","GL343300.1",643467,658447,14980
"10518","ENSACAG00000013090","2",66914868,66933895,19027
"10519","ENSACAG00000013091","2",25831152,25872904,41752
"10520","ENSACAG00000013092","2",127093088,127135197,42109
"10521","ENSACAG00000013093","4",33976960,33991691,14731
"10522","ENSACAG00000013094","5",108447303,108465268,17965
"10523","ENSACAG00000013095","GL343283.1",1547910,1557700,9790
"10524","ENSACAG00000013096","1",138598295,138632236,33941
"10525","ENSACAG00000013097","GL343462.1",81327,88150,6823
"10526","ENSACAG00000013098","4",106658909,106701296,42387
"10527","ENSACAG00000013099","GL343270.1",1499233,1521092,21859
"10528","ENSACAG00000013100","1",95789442,95807640,18198
"10529","ENSACAG00000013101","6",63181045,63200279,19234
"10530","ENSACAG00000013103","4",43439047,43440787,1740
"10531","ENSACAG00000013104","3",193338422,193950327,611905
"10532","ENSACAG00000013105","2",66875078,66891917,16839
"10533","ENSACAG00000013106","GL343727.1",96494,96664,170
"10534","ENSACAG00000013107","GL343727.1",3551,48645,45094
"10535","ENSACAG00000013108","AAWZ02036681",304,21588,21284
"10536","ENSACAG00000013109","GL343300.1",765562,790672,25110
"10537","ENSACAG00000013110","GL343487.1",137422,207985,70563
"10538","ENSACAG00000013111","GL344325.1",24535,28585,4050
"10539","ENSACAG00000013112","GL343194.1",10178810,10225072,46262
"10540","ENSACAG00000013113","6",63165305,63174093,8788
"10541","ENSACAG00000013114","GL344609.1",16140,23785,7645
"10542","ENSACAG00000013115","5",108475502,108485600,10098
"10543","ENSACAG00000013117","GL343300.1",1575512,1596183,20671
"10544","ENSACAG00000013118","GL343283.1",1515885,1526112,10227
"10545","ENSACAG00000013119","2",159477669,159509353,31684
"10546","ENSACAG00000013121","2",159394782,159402881,8099
"10547","ENSACAG00000013122","5",108516149,108517363,1214
"10548","ENSACAG00000013123","LGf",2490557,2598064,107507
"10549","ENSACAG00000013124","2",159251850,159258939,7089
"10550","ENSACAG00000013125","5",108524322,108577328,53006
"10551","ENSACAG00000013126","2",159205578,159218719,13141
"10552","ENSACAG00000013127","4",73602822,73740293,137471
"10553","ENSACAG00000013131","GL343376.1",266290,321939,55649
"10554","ENSACAG00000013132","GL343709.1",190752,205086,14334
"10555","ENSACAG00000013133","6",23668172,23680423,12251
"10556","ENSACAG00000013135","6",21687847,21828657,140810
"10557","ENSACAG00000013136","GL344325.1",35082,43874,8792
"10558","ENSACAG00000013137","GL343194.1",10290407,10300815,10408
"10559","ENSACAG00000013138","4",34094538,34120224,25686
"10560","ENSACAG00000013139","GL343507.1",209366,230316,20950
"10561","ENSACAG00000013140","6",63147557,63157529,9972
"10562","ENSACAG00000013141","4",106932713,106934512,1799
"10563","ENSACAG00000013142","2",159186965,159195671,8706
"10564","ENSACAG00000013143","GL343470.1",931,12107,11176
"10565","ENSACAG00000013144","6",58297105,58304622,7517
"10566","ENSACAG00000013145","GL343572.1",23245,66026,42781
"10567","ENSACAG00000013146","2",40497214,40582680,85466
"10568","ENSACAG00000013147","GL343350.1",397240,1090318,693078
"10569","ENSACAG00000013148","4",77923151,77926928,3777
"10570","ENSACAG00000013150","GL343260.1",1724494,1820183,95689
"10571","ENSACAG00000013151","GL343194.1",10322420,10402441,80021
"10572","ENSACAG00000013152","GL343487.1",348,24512,24164
"10573","ENSACAG00000013153","GL343916.1",122,27075,26953
"10574","ENSACAG00000013154","GL343572.1",81680,117765,36085
"10575","ENSACAG00000013155","GL344151.1",2892,20016,17124
"10576","ENSACAG00000013156","GL343270.1",1476011,1494012,18001
"10577","ENSACAG00000013158","GL343330.1",464147,489802,25655
"10578","ENSACAG00000013159","GL343558.1",204060,272081,68021
"10579","ENSACAG00000013160","5",139770893,139777655,6762
"10580","ENSACAG00000013162","4",107009481,107023317,13836
"10581","ENSACAG00000013163","1",95771503,95789436,17933
"10582","ENSACAG00000013164","6",63106838,63142079,35241
"10583","ENSACAG00000013165","5",15179677,15197377,17700
"10584","ENSACAG00000013166","2",159117262,159161392,44130
"10585","ENSACAG00000013167","5",139791554,139797320,5766
"10586","ENSACAG00000013168","4",77930894,78028396,97502
"10587","ENSACAG00000013169","4",43330569,43349000,18431
"10588","ENSACAG00000013170","1",138580940,138585978,5038
"10589","ENSACAG00000013171","AAWZ02036469",10145,26448,16303
"10590","ENSACAG00000013172","2",25806218,25827765,21547
"10591","ENSACAG00000013173","4",34164806,34207729,42923
"10592","ENSACAG00000013175","1",138537647,138563798,26151
"10593","ENSACAG00000013176","GL343709.1",245445,250721,5276
"10594","ENSACAG00000013177","5",92481221,92542103,60882
"10595","ENSACAG00000013178","6",23718910,23719134,224
"10596","ENSACAG00000013179","6",23745134,23791798,46664
"10597","ENSACAG00000013180","GL343194.1",10494567,10499263,4696
"10598","ENSACAG00000013182","4",73746163,73752519,6356
"10599","ENSACAG00000013183","4",43089488,43301711,212223
"10600","ENSACAG00000013184","GL343283.1",1401349,1429216,27867
"10601","ENSACAG00000013185","GL344151.1",24072,44358,20286
"10602","ENSACAG00000013186","AAWZ02041481",1950,4965,3015
"10603","ENSACAG00000013187","GL343300.1",1612158,1631991,19833
"10604","ENSACAG00000013189","1",138486344,138513529,27185
"10605","ENSACAG00000013190","2",25491244,25751642,260398
"10606","ENSACAG00000013191","GL343572.1",122060,192775,70715
"10607","ENSACAG00000013194","2",158964683,159074372,109689
"10608","ENSACAG00000013195","1",13604515,13658324,53809
"10609","ENSACAG00000013196","2",66821412,66821768,356
"10610","ENSACAG00000013197","4",42890506,42950166,59660
"10611","ENSACAG00000013198","GL343558.1",321265,328034,6769
"10612","ENSACAG00000013199","5",1828574,1976982,148408
"10613","ENSACAG00000013203","LGh",190227,229856,39629
"10614","ENSACAG00000013204","4",107026625,107038552,11927
"10615","ENSACAG00000013206","LGh",105838,154502,48664
"10616","ENSACAG00000013207","GL343260.1",1696461,1718380,21919
"10617","ENSACAG00000013209","2",40594746,40842272,247526
"10618","ENSACAG00000013210","1",95754577,95770618,16041
"10619","ENSACAG00000013211","5",108599381,108624751,25370
"10620","ENSACAG00000013212","AAWZ02038928",2885,9347,6462
"10621","ENSACAG00000013213","GL343194.1",10522479,10561782,39303
"10622","ENSACAG00000013214","6",23805972,23873470,67498
"10623","ENSACAG00000013216","5",139896491,139966793,70302
"10624","ENSACAG00000013217","GL343270.1",1456250,1468516,12266
"10625","ENSACAG00000013218","6",63091957,63100963,9006
"10626","ENSACAG00000013219","2",66672480,66703503,31023
"10627","ENSACAG00000013221","LGc",3733022,3774010,40988
"10628","ENSACAG00000013223","1",6972417,7067544,95127
"10629","ENSACAG00000013224","GL343209.1",12187,102820,90633
"10630","ENSACAG00000013225","5",29308746,29315699,6953
"10631","ENSACAG00000013226","GL343572.1",202498,264031,61533
"10632","ENSACAG00000013227","4",73767385,73791723,24338
"10633","ENSACAG00000013228","GL343194.1",10578900,10603470,24570
"10634","ENSACAG00000013229","GL343531.1",57615,97785,40170
"10635","ENSACAG00000013230","AAWZ02037569",3668,4138,470
"10636","ENSACAG00000013231","GL343270.1",1263774,1325445,61671
"10637","ENSACAG00000013232","5",29319392,29334070,14678
"10638","ENSACAG00000013234","6",63003747,63074166,70419
"10639","ENSACAG00000013236","4",107038443,107096874,58431
"10640","ENSACAG00000013237","6",61274590,61529073,254483
"10641","ENSACAG00000013238","GL343531.1",6289,27369,21080
"10642","ENSACAG00000013239","5",45888336,46040429,152093
"10643","ENSACAG00000013243","2",40880379,40917518,37139
"10644","ENSACAG00000013244","GL343507.1",222032,230316,8284
"10645","ENSACAG00000013245","4",34366659,34398279,31620
"10646","ENSACAG00000013246","6",31092547,31131612,39065
"10647","ENSACAG00000013247","6",80007145,80015328,8183
"10648","ENSACAG00000013249","4",107103631,107104299,668
"10649","ENSACAG00000013250","GL343948.1",4724,14319,9595
"10650","ENSACAG00000013251","GL344984.1",10017,16548,6531
"10651","ENSACAG00000013252","6",23949714,24139290,189576
"10652","ENSACAG00000013254","4",107164826,107212820,47994
"10653","ENSACAG00000013255","2",25448946,25481401,32455
"10654","ENSACAG00000013258","1",7143618,7186686,43068
"10655","ENSACAG00000013259","GL344539.1",13835,19538,5703
"10656","ENSACAG00000013260","4",125741547,125742855,1308
"10657","ENSACAG00000013261","2",188334604,188378034,43430
"10658","ENSACAG00000013262","GL344151.1",28564,35724,7160
"10659","ENSACAG00000013263","LGc",3636602,3646953,10351
"10660","ENSACAG00000013264","GL343507.1",234422,257759,23337
"10661","ENSACAG00000013266","6",25016686,25161330,144644
"10662","ENSACAG00000013267","AAWZ02037712",967,14863,13896
"10663","ENSACAG00000013268","GL343260.1",1623468,1678871,55403
"10664","ENSACAG00000013269","LGf",2599562,2639374,39812
"10665","ENSACAG00000013271","GL343310.1",586715,592908,6193
"10666","ENSACAG00000013272","5",29343116,29363871,20755
"10667","ENSACAG00000013273","GL343310.1",609775,610659,884
"10668","ENSACAG00000013274","GL343310.1",664891,672015,7124
"10669","ENSACAG00000013275","6",21937306,21948600,11294
"10670","ENSACAG00000013276","6",80015560,80034787,19227
"10671","ENSACAG00000013278","GL344151.1",43316,68492,25176
"10672","ENSACAG00000013280","2",169802796,169905769,102973
"10673","ENSACAG00000013281","2",66647334,66672453,25119
"10674","ENSACAG00000013283","5",147574960,147604204,29244
"10675","ENSACAG00000013284","2",25181992,25443625,261633
"10676","ENSACAG00000013285","6",21957604,21969169,11565
"10677","ENSACAG00000013287","1",7747242,7748551,1309
"10678","ENSACAG00000013288","6",22017499,22025944,8445
"10679","ENSACAG00000013289","GL343948.1",22246,75179,52933
"10680","ENSACAG00000013291","1",7773348,7838621,65273
"10681","ENSACAG00000013293","LGc",3597898,3632336,34438
"10682","ENSACAG00000013294","4",42878056,42883744,5688
"10683","ENSACAG00000013296","4",73798859,73802555,3696
"10684","ENSACAG00000013297","1",13668796,13711869,43073
"10685","ENSACAG00000013299","4",73812906,73827466,14560
"10686","ENSACAG00000013300","6",62927852,62928445,593
"10687","ENSACAG00000013301","6",22172811,22230473,57662
"10688","ENSACAG00000013302","6",31032228,31083417,51189
"10689","ENSACAG00000013303","6",62886809,62902890,16081
"10690","ENSACAG00000013304","AAWZ02039428",2955,3993,1038
"10691","ENSACAG00000013305","2",24977991,25165110,187119
"10692","ENSACAG00000013306","1",13794726,13887570,92844
"10693","ENSACAG00000013307","GL343558.1",347877,357044,9167
"10694","ENSACAG00000013308","GL343260.1",1477246,1625236,147990
"10695","ENSACAG00000013309","AAWZ02039088",151,8340,8189
"10696","ENSACAG00000013310","2",158935445,158957033,21588
"10697","ENSACAG00000013311","6",80043529,80071140,27611
"10698","ENSACAG00000013313","2",66469382,66556664,87282
"10699","ENSACAG00000013315","4",26310160,26330616,20456
"10700","ENSACAG00000013316","6",25222845,25549529,326684
"10701","ENSACAG00000013317","LGh",43576,98773,55197
"10702","ENSACAG00000013318","GL343283.1",1213564,1387594,174030
"10703","ENSACAG00000013320","GL343959.1",53352,72644,19292
"10704","ENSACAG00000013321","4",73841376,73859413,18037
"10705","ENSACAG00000013322","GL343544.1",448285,465263,16978
"10706","ENSACAG00000013323","6",80127662,80128276,614
"10707","ENSACAG00000013324","2",24823130,24838409,15279
"10708","ENSACAG00000013325","GL343270.1",1061955,1216228,154273
"10709","ENSACAG00000013326","1",138388539,138427907,39368
"10710","ENSACAG00000013327","6",80158039,80158659,620
"10711","ENSACAG00000013328","2",40926589,40945236,18647
"10712","ENSACAG00000013331","6",62853766,62874477,20711
"10713","ENSACAG00000013333","4",42837624,42870410,32786
"10714","ENSACAG00000013334","6",80160082,80180954,20872
"10715","ENSACAG00000013337","5",30138645,30170939,32294
"10716","ENSACAG00000013338","5",15157508,15176453,18945
"10717","ENSACAG00000013339","4",107264925,107280582,15657
"10718","ENSACAG00000013340","2",127063064,127078002,14938
"10719","ENSACAG00000013342","1",95691343,95730606,39263
"10720","ENSACAG00000013343","6",61587386,61627026,39640
"10721","ENSACAG00000013345","2",158915468,158923997,8529
"10722","ENSACAG00000013347","5",121202585,121211577,8992
"10723","ENSACAG00000013348","5",147692658,147697365,4707
"10724","ENSACAG00000013349","GL343959.1",81027,81926,899
"10725","ENSACAG00000013350","2",188389807,188463718,73911
"10726","ENSACAG00000013352","GL344233.1",39717,53822,14105
"10727","ENSACAG00000013353","5",140026497,140032841,6344
"10728","ENSACAG00000013354","GL343572.1",380262,388004,7742
"10729","ENSACAG00000013356","4",26276080,26276994,914
"10730","ENSACAG00000013357","5",15099545,15150713,51168
"10731","ENSACAG00000013358","GL343376.1",479057,496466,17409
"10732","ENSACAG00000013359","6",61635240,61696887,61647
"10733","ENSACAG00000013360","2",158798156,158864884,66728
"10734","ENSACAG00000013361","4",25466155,25468446,2291
"10735","ENSACAG00000013362","GL343376.1",498268,509538,11270
"10736","ENSACAG00000013363","1",13960651,13961727,1076
"10737","ENSACAG00000013364","4",25414014,25451169,37155
"10738","ENSACAG00000013365","1",13985366,14026494,41128
"10739","ENSACAG00000013366","5",140044741,140072838,28097
"10740","ENSACAG00000013367","4",73878753,73890364,11611
"10741","ENSACAG00000013368","GL343948.1",78639,86912,8273
"10742","ENSACAG00000013370","GL343324.1",1160709,1206927,46218
"10743","ENSACAG00000013371","5",46328774,46399041,70267
"10744","ENSACAG00000013372","5",123243133,123244267,1134
"10745","ENSACAG00000013373","GL344862.1",6543,6644,101
"10746","ENSACAG00000013374","2",127050126,127065470,15344
"10747","ENSACAG00000013375","GL344124.1",1177,60228,59051
"10748","ENSACAG00000013376","5",147749957,147808953,58996
"10749","ENSACAG00000013377","2",40963821,41082749,118928
"10750","ENSACAG00000013378","GL343558.1",368624,373353,4729
"10751","ENSACAG00000013380","4",73921938,73943071,21133
"10752","ENSACAG00000013381","1",76669153,76727202,58049
"10753","ENSACAG00000013382","1",95732960,95747445,14485
"10754","ENSACAG00000013383","GL343558.1",383891,384853,962
"10755","ENSACAG00000013384","2",23370024,23390130,20106
"10756","ENSACAG00000013385","GL343558.1",403335,449903,46568
"10757","ENSACAG00000013386","GL343376.1",529029,653555,124526
"10758","ENSACAG00000013388","6",30853219,30869567,16348
"10759","ENSACAG00000013389","5",147964477,148090243,125766
"10760","ENSACAG00000013390","2",71299394,71328158,28764
"10761","ENSACAG00000013391","4",78058705,78118940,60235
"10762","ENSACAG00000013392","GL344519.1",18279,30280,12001
"10763","ENSACAG00000013393","4",107287234,107318107,30873
"10764","ENSACAG00000013394","1",138299461,138348807,49346
"10765","ENSACAG00000013395","4",25177655,25209259,31604
"10766","ENSACAG00000013396","GL343270.1",1046905,1058899,11994
"10767","ENSACAG00000013399","6",30672266,30723424,51158
"10768","ENSACAG00000013400","GL344201.1",7875,43825,35950
"10769","ENSACAG00000013401","GL343948.1",85057,103325,18268
"10770","ENSACAG00000013402","GL343270.1",988957,993664,4707
"10771","ENSACAG00000013403","LGf",2646123,2684079,37956
"10772","ENSACAG00000013404","2",158517063,158710526,193463
"10773","ENSACAG00000013405","6",80196262,80233754,37492
"10774","ENSACAG00000013406","AAWZ02041357",611,5175,4564
"10775","ENSACAG00000013407","6",25606934,25630442,23508
"10776","ENSACAG00000013408","4",42827110,42857741,30631
"10777","ENSACAG00000013409","5",30196036,30247618,51582
"10778","ENSACAG00000013410","4",25153112,25162432,9320
"10779","ENSACAG00000013411","1",138165993,138262405,96412
"10780","ENSACAG00000013413","2",127008220,127031256,23036
"10781","ENSACAG00000013414","GL343198.1",2510602,2522950,12348
"10782","ENSACAG00000013416","6",62653206,62707544,54338
"10783","ENSACAG00000013417","1",95657122,95663295,6173
"10784","ENSACAG00000013418","5",46684375,47050130,365755
"10785","ENSACAG00000013420","2",126932490,126933392,902
"10786","ENSACAG00000013421","1",7839981,7849636,9655
"10787","ENSACAG00000013422","5",140095278,140128645,33367
"10788","ENSACAG00000013423","1",7851753,7890386,38633
"10789","ENSACAG00000013425","GL343270.1",928398,934997,6599
"10790","ENSACAG00000013426","2",169742197,169800822,58625
"10791","ENSACAG00000013427","2",126713674,126793466,79792
"10792","ENSACAG00000013428","1",76535279,76583974,48695
"10793","ENSACAG00000013429","4",42810725,42827272,16547
"10794","ENSACAG00000013431","2",22997864,23278475,280611
"10795","ENSACAG00000013432","5",30280024,30329822,49798
"10796","ENSACAG00000013435","4",107350081,107363119,13038
"10797","ENSACAG00000013436","LGf",2714003,2729374,15371
"10798","ENSACAG00000013437","5",140177147,140295186,118039
"10799","ENSACAG00000013438","LGc",3588848,3598438,9590
"10800","ENSACAG00000013440","GL343664.1",144164,190648,46484
"10801","ENSACAG00000013441","2",66446324,66464010,17686
"10802","ENSACAG00000013442","3",3268852,3414247,145395
"10803","ENSACAG00000013446","6",25655092,25672381,17289
"10804","ENSACAG00000013447","2",89071055,89108825,37770
"10805","ENSACAG00000013448","5",140305566,140373809,68243
"10806","ENSACAG00000013449","1",259534767,259553389,18622
"10807","ENSACAG00000013450","GL343594.1",244846,245127,281
"10808","ENSACAG00000013451","GL343594.1",211406,212464,1058
"10809","ENSACAG00000013452","5",30362700,30454720,92020
"10810","ENSACAG00000013453","6",25679049,25694911,15862
"10811","ENSACAG00000013454","5",48411108,48491109,80001
"10812","ENSACAG00000013456","2",126369587,126662085,292498
"10813","ENSACAG00000013457","2",158631331,158646263,14932
"10814","ENSACAG00000013458","GL343594.1",193832,194629,797
"10815","ENSACAG00000013460","4",74000972,74042406,41434
"10816","ENSACAG00000013461","6",25702126,25724015,21889
"10817","ENSACAG00000013462","GL343594.1",126863,127916,1053
"10818","ENSACAG00000013465","GL343283.1",1167396,1198491,31095
"10819","ENSACAG00000013466","LGc",3560250,3586928,26678
"10820","ENSACAG00000013469","6",25776841,25843100,66259
"10821","ENSACAG00000013470","GL343993.1",18796,78866,60070
"10822","ENSACAG00000013472","6",62567645,62603013,35368
"10823","ENSACAG00000013474","1",7891326,7939654,48328
"10824","ENSACAG00000013477","4",107378601,107445024,66423
"10825","ENSACAG00000013480","5",14947380,14996390,49010
"10826","ENSACAG00000013481","6",30657587,30669004,11417
"10827","ENSACAG00000013482","GL343270.1",908498,922488,13990
"10828","ENSACAG00000013484","1",95548451,95572222,23771
"10829","ENSACAG00000013485","2",66240756,66352726,111970
"10830","ENSACAG00000013486","GL343664.1",240492,275199,34707
"10831","ENSACAG00000013487","1",259580488,259602614,22126
"10832","ENSACAG00000013488","4",24947459,24948298,839
"10833","ENSACAG00000013490","GL343324.1",912764,1002116,89352
"10834","ENSACAG00000013492","1",76496226,76525987,29761
"10835","ENSACAG00000013493","GL343689.1",18114,115251,97137
"10836","ENSACAG00000013494","6",30652967,30654832,1865
"10837","ENSACAG00000013496","1",138082326,138122701,40375
"10838","ENSACAG00000013498","GL343387.1",264740,298125,33385
"10839","ENSACAG00000013501","4",74077369,74140206,62837
"10840","ENSACAG00000013502","6",30627836,30643424,15588
"10841","ENSACAG00000013503","2",169455727,169460685,4958
"10842","ENSACAG00000013504","4",24818640,24877323,58683
"10843","ENSACAG00000013505","GL343689.1",6390,8445,2055
"10844","ENSACAG00000013506","1",137944643,138052768,108125
"10845","ENSACAG00000013507","AAWZ02036748",9649,20246,10597
"10846","ENSACAG00000013509","6",61718875,61751525,32650
"10847","ENSACAG00000013510","GL343328.1",1243735,1275814,32079
"10848","ENSACAG00000013511","6",62507887,62524691,16804
"10849","ENSACAG00000013512","GL343239.1",764016,766584,2568
"10850","ENSACAG00000013513","4",107442496,107454084,11588
"10851","ENSACAG00000013514","3",195047280,195059201,11921
"10852","ENSACAG00000013515","2",169431085,169455314,24229
"10853","ENSACAG00000013516","GL343270.1",770981,804526,33545
"10854","ENSACAG00000013517","4",24666120,24788329,122209
"10855","ENSACAG00000013520","GL343270.1",541960,733862,191902
"10856","ENSACAG00000013523","1",137759682,137769942,10260
"10857","ENSACAG00000013524","6",62501292,62506085,4793
"10858","ENSACAG00000013525","1",95492007,95547944,55937
"10859","ENSACAG00000013526","3",195199918,195286347,86429
"10860","ENSACAG00000013527","LGf",2758272,2774244,15972
"10861","ENSACAG00000013530","GL343348.1",150537,171851,21314
"10862","ENSACAG00000013531","GL343508.1",96592,154448,57856
"10863","ENSACAG00000013532","1",76408205,76467483,59278
"10864","ENSACAG00000013535","4",108205478,108335032,129554
"10865","ENSACAG00000013536","1",51834476,51846297,11821
"10866","ENSACAG00000013538","6",30506585,30589177,82592
"10867","ENSACAG00000013539","4",78192288,78234848,42560
"10868","ENSACAG00000013541","4",97973461,97975075,1614
"10869","ENSACAG00000013544","5",48625325,48634732,9407
"10870","ENSACAG00000013545","6",62484213,62495523,11310
"10871","ENSACAG00000013546","GL343508.1",213329,213679,350
"10872","ENSACAG00000013547","GL343270.1",246311,258108,11797
"10873","ENSACAG00000013548","1",137663383,137741583,78200
"10874","ENSACAG00000013549","4",24557632,24571922,14290
"10875","ENSACAG00000013551","GL343508.1",517939,630186,112247
"10876","ENSACAG00000013552","LGc",3457049,3497158,40109
"10877","ENSACAG00000013554","5",48806553,48848051,41498
"10878","ENSACAG00000013555","3",195311323,195343730,32407
"10879","ENSACAG00000013557","LGf",2806296,2810905,4609
"10880","ENSACAG00000013558","4",78392760,78393350,590
"10881","ENSACAG00000013559","6",62455217,62479605,24388
"10882","ENSACAG00000013560","5",48905909,48960702,54793
"10883","ENSACAG00000013561","GL343348.1",174532,193446,18914
"10884","ENSACAG00000013562","4",24499582,24504668,5086
"10885","ENSACAG00000013564","4",24482953,24493834,10881
"10886","ENSACAG00000013565","GL343324.1",824088,879229,55141
"10887","ENSACAG00000013567","GL343376.1",732803,753281,20478
"10888","ENSACAG00000013568","AAWZ02040641",1827,5553,3726
"10889","ENSACAG00000013569","GL344322.1",1125,7021,5896
"10890","ENSACAG00000013570","2",169407906,169430379,22473
"10891","ENSACAG00000013572","1",76340112,76381442,41330
"10892","ENSACAG00000013573","GL343795.1",46137,60600,14463
"10893","ENSACAG00000013575","6",80233851,80277177,43326
"10894","ENSACAG00000013577","GL344719.1",1019,21693,20674
"10895","ENSACAG00000013578","LGf",2815365,2818119,2754
"10896","ENSACAG00000013579","GL344618.1",18693,21053,2360
"10897","ENSACAG00000013581","AAWZ02039879",934,6822,5888
"10898","ENSACAG00000013582","GL343376.1",758669,765867,7198
"10899","ENSACAG00000013584","LGc",3421711,3439391,17680
"10900","ENSACAG00000013585","5",14919325,14948374,29049
"10901","ENSACAG00000013586","2",181602837,181633021,30184
"10902","ENSACAG00000013588","GL344618.1",3490,9499,6009
"10903","ENSACAG00000013589","GL343510.1",33655,104617,70962
"10904","ENSACAG00000013590","3",160196386,160589324,392938
"10905","ENSACAG00000013591","GL343564.1",27221,116112,88891
"10906","ENSACAG00000013592","AAWZ02037934",7667,12637,4970
"10907","ENSACAG00000013593","4",97787151,97822290,35139
"10908","ENSACAG00000013594","3",192841818,192983342,141524
"10909","ENSACAG00000013595","GL343850.1",12752,88385,75633
"10910","ENSACAG00000013596","GL343587.1",3818,71301,67483
"10911","ENSACAG00000013597","GL343510.1",133873,391034,257161
"10912","ENSACAG00000013598","6",62426353,62435573,9220
"10913","ENSACAG00000013600","AAWZ02037458",3490,16317,12827
"10914","ENSACAG00000013601","GL343280.1",44048,218374,174326
"10915","ENSACAG00000013602","GL343715.1",1500,161739,160239
"10916","ENSACAG00000013603","AAWZ02037710",1091,13651,12560
"10917","ENSACAG00000013604","GL343348.1",198371,232301,33930
"10918","ENSACAG00000013605","GL343328.1",1197620,1229841,32221
"10919","ENSACAG00000013606","6",30495935,30502388,6453
"10920","ENSACAG00000013607","1",76256264,76320894,64630
"10921","ENSACAG00000013608","GL343557.1",257001,323524,66523
"10922","ENSACAG00000013609","LGf",2834100,2834710,610
"10923","ENSACAG00000013610","6",22243228,22273616,30388
"10924","ENSACAG00000013613","5",49000282,49336670,336388
"10925","ENSACAG00000013614","GL343609.1",137359,143660,6301
"10926","ENSACAG00000013615","6",25852470,25857454,4984
"10927","ENSACAG00000013616","GL343557.1",328922,329948,1026
"10928","ENSACAG00000013617","GL343508.1",634388,634840,452
"10929","ENSACAG00000013618","5",30462541,30506274,43733
"10930","ENSACAG00000013620","6",80273467,80296806,23339
"10931","ENSACAG00000013621","GL343283.1",1123701,1156477,32776
"10932","ENSACAG00000013622","1",8121934,8150051,28117
"10933","ENSACAG00000013623","GL343557.1",371826,420180,48354
"10934","ENSACAG00000013624","GL344407.1",2441,21048,18607
"10935","ENSACAG00000013625","6",30459487,30487867,28380
"10936","ENSACAG00000013627","4",24461616,24465632,4016
"10937","ENSACAG00000013628","AAWZ02041979",950,3507,2557
"10938","ENSACAG00000013629","2",22965210,22975845,10635
"10939","ENSACAG00000013631","5",140373875,140396560,22685
"10940","ENSACAG00000013632","4",141924829,142468952,544123
"10941","ENSACAG00000013633","5",14889006,14913724,24718
"10942","ENSACAG00000013634","GL343564.1",134362,156137,21775
"10943","ENSACAG00000013635","AAWZ02040628",2307,3241,934
"10944","ENSACAG00000013636","4",74152761,74225182,72421
"10945","ENSACAG00000013638","LGf",2855333,2864739,9406
"10946","ENSACAG00000013639","GL343376.1",782731,794717,11986
"10947","ENSACAG00000013640","GL343666.1",79690,141144,61454
"10948","ENSACAG00000013641","1",254382382,254411345,28963
"10949","ENSACAG00000013643","3",127025687,127026817,1130
"10950","ENSACAG00000013645","GL343286.1",1016832,1045870,29038
"10951","ENSACAG00000013646","2",22938238,22938621,383
"10952","ENSACAG00000013647","6",52782447,53276569,494122
"10953","ENSACAG00000013648","GL343228.1",2176397,2388531,212134
"10954","ENSACAG00000013649","6",62395837,62405196,9359
"10955","ENSACAG00000013650","GL344078.1",38851,58076,19225
"10956","ENSACAG00000013652","GL343760.1",4475,60602,56127
"10957","ENSACAG00000013653","GL343703.1",105224,108303,3079
"10958","ENSACAG00000013654","GL343328.1",1161225,1191929,30704
"10959","ENSACAG00000013657","GL343264.1",538443,571930,33487
"10960","ENSACAG00000013659","2",169396645,169402464,5819
"10961","ENSACAG00000013660","4",116474297,116665984,191687
"10962","ENSACAG00000013661","GL343795.1",6014,32862,26848
"10963","ENSACAG00000013662","GL343324.1",860484,861331,847
"10964","ENSACAG00000013663","AAWZ02040043",1680,2239,559
"10965","ENSACAG00000013664","3",161248749,161285763,37014
"10966","ENSACAG00000013666","GL343324.1",786687,817272,30585
"10967","ENSACAG00000013667","1",212140677,212172783,32106
"10968","ENSACAG00000013668","2",126275212,126336129,60917
"10969","ENSACAG00000013669","GL343564.1",177726,203956,26230
"10970","ENSACAG00000013670","GL343836.1",51152,82614,31462
"10971","ENSACAG00000013672","5",30548449,30570111,21662
"10972","ENSACAG00000013673","3",161362296,161396991,34695
"10973","ENSACAG00000013674","GL343398.1",642617,741003,98386
"10974","ENSACAG00000013675","GL343609.1",167244,190903,23659
"10975","ENSACAG00000013676","GL344199.1",1650,23448,21798
"10976","ENSACAG00000013677","GL343666.1",252919,272699,19780
"10977","ENSACAG00000013679","6",61752504,61760359,7855
"10978","ENSACAG00000013680","2",181419176,181432436,13260
"10979","ENSACAG00000013682","2",169336453,169390239,53786
"10980","ENSACAG00000013683","2",180451398,180916984,465586
"10981","ENSACAG00000013684","GL343376.1",844372,848916,4544
"10982","ENSACAG00000013685","1",95455385,95490080,34695
"10983","ENSACAG00000013686","GL343585.1",867,30666,29799
"10984","ENSACAG00000013687","6",62355879,62372988,17109
"10985","ENSACAG00000013688","6",62293798,62314400,20602
"10986","ENSACAG00000013690","GL343703.1",112797,115657,2860
"10987","ENSACAG00000013691","GL343376.1",900257,913096,12839
"10988","ENSACAG00000013692","4",74225408,74240816,15408
"10989","ENSACAG00000013693","GL343836.1",93335,122248,28913
"10990","ENSACAG00000013694","GL343703.1",120008,136413,16405
"10991","ENSACAG00000013695","6",22277574,22308691,31117
"10992","ENSACAG00000013698","GL343228.1",2114584,2150754,36170
"10993","ENSACAG00000013699","5",140419966,140485372,65406
"10994","ENSACAG00000013700","3",195343075,195376169,33094
"10995","ENSACAG00000013701","5",49268786,49425973,157187
"10996","ENSACAG00000013702","1",76130458,76226611,96153
"10997","ENSACAG00000013703","GL344662.1",8136,13591,5455
"10998","ENSACAG00000013704","LGf",2876578,2893177,16599
"10999","ENSACAG00000013705","AAWZ02037496",1699,2802,1103
"11000","ENSACAG00000013706","1",263556293,263557129,836
"11001","ENSACAG00000013707","GL344005.1",1833,45675,43842
"11002","ENSACAG00000013708","AAWZ02038145",36,5867,5831
"11003","ENSACAG00000013709","AAWZ02039383",4357,5083,726
"11004","ENSACAG00000013710","1",254471865,254488416,16551
"11005","ENSACAG00000013711","GL343376.1",921505,946420,24915
"11006","ENSACAG00000013712","AAWZ02037390",2142,14311,12169
"11007","ENSACAG00000013714","GL343217.1",168016,168948,932
"11008","ENSACAG00000013715","GL343807.1",221596,229763,8167
"11009","ENSACAG00000013716","GL344429.1",27276,34193,6917
"11010","ENSACAG00000013718","GL343252.1",30145,34882,4737
"11011","ENSACAG00000013719","6",61762152,61770831,8679
"11012","ENSACAG00000013720","GL344461.1",17557,32030,14473
"11013","ENSACAG00000013721","GL343671.1",186144,247999,61855
"11014","ENSACAG00000013722","GL343609.1",195190,202785,7595
"11015","ENSACAG00000013723","GL343836.1",124156,145668,21512
"11016","ENSACAG00000013726","4",74247872,74284175,36303
"11017","ENSACAG00000013727","GL343827.1",23923,31257,7334
"11018","ENSACAG00000013728","GL343324.1",693380,716761,23381
"11019","ENSACAG00000013729","3",161884806,161885927,1121
"11020","ENSACAG00000013732","4",24432470,24450759,18289
"11021","ENSACAG00000013734","GL343370.1",105275,295118,189843
"11022","ENSACAG00000013735","6",30426922,30436378,9456
"11023","ENSACAG00000013736","GL343836.1",155601,166047,10446
"11024","ENSACAG00000013738","GL343703.1",138378,173467,35089
"11025","ENSACAG00000013740","5",114214962,114215195,233
"11026","ENSACAG00000013741","1",254564050,254619335,55285
"11027","ENSACAG00000013742","LGc",3338906,3388211,49305
"11028","ENSACAG00000013743","AAWZ02041940",453,2586,2133
"11029","ENSACAG00000013744","2",169253875,169311655,57780
"11030","ENSACAG00000013745","6",61784897,61804740,19843
"11031","ENSACAG00000013746","GL343609.1",208402,217422,9020
"11032","ENSACAG00000013747","2",193841959,193886021,44062
"11033","ENSACAG00000013748","3",162461654,162470607,8953
"11034","ENSACAG00000013749","AAWZ02039315",4814,5725,911
"11035","ENSACAG00000013750","GL343264.1",586666,588231,1565
"11036","ENSACAG00000013751","GL343252.1",45411,52755,7344
"11037","ENSACAG00000013752","GL343401.1",902361,917580,15219
"11038","ENSACAG00000013753","3",193007778,193217408,209630
"11039","ENSACAG00000013754","3",162394812,162406054,11242
"11040","ENSACAG00000013755","6",30403805,30423384,19579
"11041","ENSACAG00000013756","6",53299772,53334634,34862
"11042","ENSACAG00000013757","GL343564.1",213829,236609,22780
"11043","ENSACAG00000013758","GL344551.1",4342,20766,16424
"11044","ENSACAG00000013759","GL343642.1",331417,337602,6185
"11045","ENSACAG00000013760","LGf",2919159,2936531,17372
"11046","ENSACAG00000013761","GL343609.1",241896,307634,65738
"11047","ENSACAG00000013762","GL344019.1",3217,6923,3706
"11048","ENSACAG00000013765","GL343324.1",586953,652869,65916
"11049","ENSACAG00000013768","GL343585.1",197313,223844,26531
"11050","ENSACAG00000013769","6",62274390,62291912,17522
"11051","ENSACAG00000013770","1",76101887,76131272,29385
"11052","ENSACAG00000013771","6",61805142,61823982,18840
"11053","ENSACAG00000013772","2",195875107,195885372,10265
"11054","ENSACAG00000013773","GL343398.1",748886,801034,52148
"11055","ENSACAG00000013775","LGc",3153509,3332800,179291
"11056","ENSACAG00000013776","GL343827.1",29647,37995,8348
"11057","ENSACAG00000013777","3",162354617,162377927,23310
"11058","ENSACAG00000013778","GL343827.1",42866,48629,5763
"11059","ENSACAG00000013779","GL343398.1",812073,921137,109064
"11060","ENSACAG00000013780","GL344019.1",102710,105881,3171
"11061","ENSACAG00000013781","GL343585.1",250167,269986,19819
"11062","ENSACAG00000013782","AAWZ02037198",80,14535,14455
"11063","ENSACAG00000013783","GL343283.1",1034262,1044640,10378
"11064","ENSACAG00000013784","1",76050626,76056489,5863
"11065","ENSACAG00000013785","4",24422463,24431310,8847
"11066","ENSACAG00000013786","GL343264.1",638487,655671,17184
"11067","ENSACAG00000013787","GL344863.1",9019,14192,5173
"11068","ENSACAG00000013788","GL343671.1",255827,265447,9620
"11069","ENSACAG00000013791","1",186233249,186281507,48258
"11070","ENSACAG00000013792","GL343564.1",373307,405155,31848
"11071","ENSACAG00000013793","4",24391346,24419726,28380
"11072","ENSACAG00000013795","1",196464921,196503267,38346
"11073","ENSACAG00000013796","GL343827.1",50693,66686,15993
"11074","ENSACAG00000013797","6",80382567,80417205,34638
"11075","ENSACAG00000013798","GL343376.1",966235,974094,7859
"11076","ENSACAG00000013799","GL343234.1",2102046,2114991,12945
"11077","ENSACAG00000013801","1",75886324,75941684,55360
"11078","ENSACAG00000013802","GL343202.1",1315144,1622834,307690
"11079","ENSACAG00000013803","GL343227.1",2250899,2486845,235946
"11080","ENSACAG00000013805","GL343280.1",240087,292287,52200
"11081","ENSACAG00000013806","GL343836.1",170067,172718,2651
"11082","ENSACAG00000013807","2",169122892,169230882,107990
"11083","ENSACAG00000013808","GL343642.1",279110,330853,51743
"11084","ENSACAG00000013809","GL343283.1",1007073,1025926,18853
"11085","ENSACAG00000013810","GL343328.1",1131752,1158370,26618
"11086","ENSACAG00000013811","GL343836.1",179910,180876,966
"11087","ENSACAG00000013812","AAWZ02038412",1497,4239,2742
"11088","ENSACAG00000013813","AAWZ02039979",21,6726,6705
"11089","ENSACAG00000013815","1",41587915,41603317,15402
"11090","ENSACAG00000013817","1",186215599,186224771,9172
"11091","ENSACAG00000013819","AAWZ02040408",447,3235,2788
"11092","ENSACAG00000013820","1",186193061,186216953,23892
"11093","ENSACAG00000013821","GL343609.1",307026,332318,25292
"11094","ENSACAG00000013822","5",140546566,140599882,53316
"11095","ENSACAG00000013823","4",24357900,24381098,23198
"11096","ENSACAG00000013824","2",198098571,198116176,17605
"11097","ENSACAG00000013825","1",137605129,137606355,1226
"11098","ENSACAG00000013826","5",37670201,37799174,128973
"11099","ENSACAG00000013827","5",49445530,49820108,374578
"11100","ENSACAG00000013828","1",137585551,137600293,14742
"11101","ENSACAG00000013831","GL343234.1",2084281,2085552,1271
"11102","ENSACAG00000013833","GL343227.1",1911383,1930741,19358
"11103","ENSACAG00000013835","2",198063250,198095686,32436
"11104","ENSACAG00000013836","1",137538971,137584476,45505
"11105","ENSACAG00000013838","GL343227.1",1872261,1895537,23276
"11106","ENSACAG00000013840","1",7880495,7881168,673
"11107","ENSACAG00000013841","5",123759137,123992504,233367
"11108","ENSACAG00000013842","3",162122064,162153631,31567
"11109","ENSACAG00000013844","GL343827.1",101698,159568,57870
"11110","ENSACAG00000013846","GL343315.1",754389,940168,185779
"11111","ENSACAG00000013847","1",95397075,95413790,16715
"11112","ENSACAG00000013849","GL343703.1",243755,257810,14055
"11113","ENSACAG00000013850","3",195525628,195540762,15134
"11114","ENSACAG00000013851","GL343234.1",833613,890906,57293
"11115","ENSACAG00000013852","GL343234.1",755793,860057,104264
"11116","ENSACAG00000013853","GL343827.1",166428,188313,21885
"11117","ENSACAG00000013854","2",198027341,198059708,32367
"11118","ENSACAG00000013855","6",61880021,61884173,4152
"11119","ENSACAG00000013857","GL343228.1",2100891,2105951,5060
"11120","ENSACAG00000013858","4",74298052,74310381,12329
"11121","ENSACAG00000013859","GL343202.1",1225836,1282192,56356
"11122","ENSACAG00000013860","1",150800929,150801006,77
"11123","ENSACAG00000013861","6",61899126,61940516,41390
"11124","ENSACAG00000013863","4",116352769,116405173,52404
"11125","ENSACAG00000013865","GL343359.1",145424,327417,181993
"11126","ENSACAG00000013866","GL344005.1",50988,57529,6541
"11127","ENSACAG00000013867","1",254627564,254645527,17963
"11128","ENSACAG00000013868","1",186178759,186193133,14374
"11129","ENSACAG00000013870","2",75017732,75035688,17956
"11130","ENSACAG00000013871","GL343671.1",278180,317699,39519
"11131","ENSACAG00000013872","2",169182843,169208953,26110
"11132","ENSACAG00000013873","6",80437670,80452196,14526
"11133","ENSACAG00000013874","GL343228.1",2060890,2074437,13547
"11134","ENSACAG00000013876","1",196340229,196436376,96147
"11135","ENSACAG00000013878","GL343760.1",84610,98520,13910
"11136","ENSACAG00000013881","3",162104656,162119235,14579
"11137","ENSACAG00000013883","GL344005.1",66947,106592,39645
"11138","ENSACAG00000013885","5",30572665,30593543,20878
"11139","ENSACAG00000013887","4",74337579,74374986,37407
"11140","ENSACAG00000013888","6",62262325,62264366,2041
"11141","ENSACAG00000013890","1",41513958,41585098,71140
"11142","ENSACAG00000013892","6",62189724,62256854,67130
"11143","ENSACAG00000013893","GL343264.1",698179,707681,9502
"11144","ENSACAG00000013894","GL344297.1",45012,45362,350
"11145","ENSACAG00000013896","GL344297.1",1163,15587,14424
"11146","ENSACAG00000013897","GL344242.1",608,48147,47539
"11147","ENSACAG00000013899","2",180152459,180186041,33582
"11148","ENSACAG00000013901","GL343264.1",712140,723382,11242
"11149","ENSACAG00000013902","GL344021.1",46006,48364,2358
"11150","ENSACAG00000013905","GL343844.1",143338,149575,6237
"11151","ENSACAG00000013906","1",186129902,186143953,14051
"11152","ENSACAG00000013907","6",22503357,22522885,19528
"11153","ENSACAG00000013909","GL343280.1",309310,360236,50926
"11154","ENSACAG00000013910","6",53336734,53412297,75563
"11155","ENSACAG00000013911","GL343450.1",656032,664419,8387
"11156","ENSACAG00000013912","GL344273.1",2127,12550,10423
"11157","ENSACAG00000013913","4",23284296,23296957,12661
"11158","ENSACAG00000013914","GL343234.1",720027,744694,24667
"11159","ENSACAG00000013915","1",254680473,254685482,5009
"11160","ENSACAG00000013916","GL343234.1",641282,709338,68056
"11161","ENSACAG00000013917","1",254690159,254808123,117964
"11162","ENSACAG00000013918","GL343846.1",113512,145914,32402
"11163","ENSACAG00000013919","GL345059.1",1423,11828,10405
"11164","ENSACAG00000013921","6",80453902,80464707,10805
"11165","ENSACAG00000013923","2",168797329,168832677,35348
"11166","ENSACAG00000013925","AAWZ02040256",21,7158,7137
"11167","ENSACAG00000013926","GL343283.1",934716,938819,4103
"11168","ENSACAG00000013927","GL343438.1",61100,123526,62426
"11169","ENSACAG00000013930","GL343438.1",213530,219132,5602
"11170","ENSACAG00000013931","AAWZ02038735",3671,8045,4374
"11171","ENSACAG00000013935","GL343438.1",349339,371095,21756
"11172","ENSACAG00000013936","3",162064623,162065735,1112
"11173","ENSACAG00000013937","GL343281.1",1089858,1105095,15237
"11174","ENSACAG00000013938","1",95241667,95323369,81702
"11175","ENSACAG00000013940","GL344037.1",75549,80348,4799
"11176","ENSACAG00000013941","LGc",2994956,3153779,158823
"11177","ENSACAG00000013944","GL343264.1",728688,738236,9548
"11178","ENSACAG00000013946","3",161995199,161996428,1229
"11179","ENSACAG00000013947","GL344134.1",77876,81760,3884
"11180","ENSACAG00000013948","GL343283.1",818892,845497,26605
"11181","ENSACAG00000013949","6",30337107,30380072,42965
"11182","ENSACAG00000013950","3",161957661,161981564,23903
"11183","ENSACAG00000013951","GL343283.1",767145,811544,44399
"11184","ENSACAG00000013952","GL343227.1",1833023,1867762,34739
"11185","ENSACAG00000013954","GL344375.1",417,2384,1967
"11186","ENSACAG00000013955","6",80559594,80572708,13114
"11187","ENSACAG00000013956","GL343672.1",16823,23266,6443
"11188","ENSACAG00000013959","GL343264.1",766198,767319,1121
"11189","ENSACAG00000013960","1",37444649,37444825,176
"11190","ENSACAG00000013961","1",37056120,37182872,126752
"11191","ENSACAG00000013962","GL344273.1",12645,19003,6358
"11192","ENSACAG00000013964","AAWZ02034995",42715,49775,7060
"11193","ENSACAG00000013966","GL343307.1",880156,1130310,250154
"11194","ENSACAG00000013967","GL343336.1",1056380,1183015,126635
"11195","ENSACAG00000013968","GL343942.1",838,16882,16044
"11196","ENSACAG00000013970","GL343760.1",100789,110501,9712
"11197","ENSACAG00000013971","GL343642.1",270174,278860,8686
"11198","ENSACAG00000013974","GL343264.1",1050574,1085379,34805
"11199","ENSACAG00000013975","GL343760.1",110632,137199,26567
"11200","ENSACAG00000013976","GL344721.1",1,12550,12549
"11201","ENSACAG00000013977","3",195560495,195585040,24545
"11202","ENSACAG00000013978","AAWZ02034995",17357,35599,18242
"11203","ENSACAG00000013979","1",186023636,186095336,71700
"11204","ENSACAG00000013981","1",137487367,137527951,40584
"11205","ENSACAG00000013982","GL343359.1",337632,360341,22709
"11206","ENSACAG00000013983","GL343307.1",1176805,1285744,108939
"11207","ENSACAG00000013984","4",23258056,23278518,20462
"11208","ENSACAG00000013985","GL343404.1",70569,157343,86774
"11209","ENSACAG00000013986","GL343942.1",30782,65340,34558
"11210","ENSACAG00000013987","3",195610784,195642688,31904
"11211","ENSACAG00000013988","1",41278327,41338560,60233
"11212","ENSACAG00000013989","GL343642.1",201400,265178,63778
"11213","ENSACAG00000013990","GL343376.1",989553,1001645,12092
"11214","ENSACAG00000013992","2",168739357,168791241,51884
"11215","ENSACAG00000013993","6",22537229,22550629,13400
"11216","ENSACAG00000013994","1",185984870,185985814,944
"11217","ENSACAG00000013995","1",185974300,185977301,3001
"11218","ENSACAG00000013996","GL343404.1",291211,329765,38554
"11219","ENSACAG00000013998","1",254332354,254357317,24963
"11220","ENSACAG00000013999","GL343202.1",1132432,1143493,11061
"11221","ENSACAG00000014000","GL343280.1",362841,413520,50679
"11222","ENSACAG00000014001","5",37610992,37615051,4059
"11223","ENSACAG00000014005","2",168581242,168623467,42225
"11224","ENSACAG00000014008","6",80596962,80611064,14102
"11225","ENSACAG00000014009","2",197866824,198020284,153460
"11226","ENSACAG00000014010","GL344273.1",18717,28032,9315
"11227","ENSACAG00000014011","AAWZ02036914",5675,20612,14937
"11228","ENSACAG00000014012","GL343677.1",725,7685,6960
"11229","ENSACAG00000014013","1",137471258,137484079,12821
"11230","ENSACAG00000014015","3",195638764,195753016,114252
"11231","ENSACAG00000014016","5",37377343,37497911,120568
"11232","ENSACAG00000014017","GL343359.1",372473,409544,37071
"11233","ENSACAG00000014018","GL343733.1",125230,159240,34010
"11234","ENSACAG00000014019","3",161929548,161954814,25266
"11235","ENSACAG00000014020","6",22566503,22580492,13989
"11236","ENSACAG00000014021","GL344005.1",111404,112460,1056
"11237","ENSACAG00000014022","GL343227.1",1708445,1812981,104536
"11238","ENSACAG00000014024","GL343846.1",152190,174153,21963
"11239","ENSACAG00000014027","6",80616269,80634298,18029
"11240","ENSACAG00000014029","5",30588740,30611618,22878
"11241","ENSACAG00000014031","GL343677.1",7627,17823,10196
"11242","ENSACAG00000014032","6",30312298,30321818,9520
"11243","ENSACAG00000014033","GL343279.1",427,36900,36473
"11244","ENSACAG00000014034","GL343202.1",1113841,1128927,15086
"11245","ENSACAG00000014036","1",137440405,137460787,20382
"11246","ENSACAG00000014037","GL343324.1",573160,574242,1082
"11247","ENSACAG00000014038","6",30064905,30188876,123971
"11248","ENSACAG00000014039","GL344721.1",14551,17596,3045
"11249","ENSACAG00000014040","GL343324.1",552381,553448,1067
"11250","ENSACAG00000014041","1",185938965,185960788,21823
"11251","ENSACAG00000014043","GL343324.1",516560,527428,10868
"11252","ENSACAG00000014045","1",137422853,137431281,8428
"11253","ENSACAG00000014046","6",80647701,80702643,54942
"11254","ENSACAG00000014047","GL343264.1",1087731,1098688,10957
"11255","ENSACAG00000014049","AAWZ02038942",156,9426,9270
"11256","ENSACAG00000014050","GL343202.1",1088534,1098219,9685
"11257","ENSACAG00000014051","GL344621.1",17828,27617,9789
"11258","ENSACAG00000014054","GL343677.1",26356,39812,13456
"11259","ENSACAG00000014055","1",137350013,137419306,69293
"11260","ENSACAG00000014056","GL343900.1",132169,132744,575
"11261","ENSACAG00000014059","GL343264.1",1104980,1139634,34654
"11262","ENSACAG00000014060","AAWZ02037962",5957,12326,6369
"11263","ENSACAG00000014061","GL343202.1",1075950,1086748,10798
"11264","ENSACAG00000014063","GL343196.1",580,77779,77199
"11265","ENSACAG00000014064","AAWZ02036849",7238,21141,13903
"11266","ENSACAG00000014065","GL343273.1",89259,241661,152402
"11267","ENSACAG00000014066","GL343280.1",488184,783114,294930
"11268","ENSACAG00000014067","4",74422091,74451521,29430
"11269","ENSACAG00000014069","GL343324.1",464498,503614,39116
"11270","ENSACAG00000014070","3",195760499,195819366,58867
"11271","ENSACAG00000014073","5",30641445,30643258,1813
"11272","ENSACAG00000014074","GL344146.1",2027,19145,17118
"11273","ENSACAG00000014075","1",254921270,254922329,1059
"11274","ENSACAG00000014076","GL344227.1",41707,51821,10114
"11275","ENSACAG00000014078","2",75200463,75339128,138665
"11276","ENSACAG00000014079","4",105150892,105154726,3834
"11277","ENSACAG00000014080","5",30687363,30728639,41276
"11278","ENSACAG00000014082","1",36467320,36682172,214852
"11279","ENSACAG00000014083","GL343264.1",1295155,1364273,69118
"11280","ENSACAG00000014084","1",255181209,255205302,24093
"11281","ENSACAG00000014086","GL343202.1",785278,1060919,275641
"11282","ENSACAG00000014088","GL343900.1",24448,80293,55845
"11283","ENSACAG00000014089","GL344273.1",37855,48368,10513
"11284","ENSACAG00000014090","6",80711854,80729518,17664
"11285","ENSACAG00000014091","AAWZ02040529",65,2852,2787
"11286","ENSACAG00000014092","GL343273.1",450246,595524,145278
"11287","ENSACAG00000014093","LGb",3410,22481,19071
"11288","ENSACAG00000014094","4",141334219,141340912,6693
"11289","ENSACAG00000014095","4",141210603,141255678,45075
"11290","ENSACAG00000014097","GL343324.1",443935,445008,1073
"11291","ENSACAG00000014098","4",23232818,23247809,14991
"11292","ENSACAG00000014099","3",195846033,195847106,1073
"11293","ENSACAG00000014100","4",105140534,105149367,8833
"11294","ENSACAG00000014101","3",195874350,195886116,11766
"11295","ENSACAG00000014102","AAWZ02040201",1235,4963,3728
"11296","ENSACAG00000014104","4",105124741,105134163,9422
"11297","ENSACAG00000014106","GL343760.1",139131,140132,1001
"11298","ENSACAG00000014107","GL344437.1",1041,34280,33239
"11299","ENSACAG00000014108","1",95197879,95214429,16550
"11300","ENSACAG00000014109","GL343315.1",664424,721655,57231
"11301","ENSACAG00000014110","3",195889100,195922709,33609
"11302","ENSACAG00000014111","GL343760.1",144905,188130,43225
"11303","ENSACAG00000014112","GL343324.1",392617,393651,1034
"11304","ENSACAG00000014113","GL343951.1",38980,71410,32430
"11305","ENSACAG00000014114","GL343252.1",230096,251104,21008
"11306","ENSACAG00000014115","1",45535229,45561979,26750
"11307","ENSACAG00000014116","GL343202.1",710727,743670,32943
"11308","ENSACAG00000014117","1",36413127,36429340,16213
"11309","ENSACAG00000014118","1",41104920,41182075,77155
"11310","ENSACAG00000014119","GL343324.1",290857,366039,75182
"11311","ENSACAG00000014120","GL343359.1",425361,488286,62925
"11312","ENSACAG00000014122","GL343305.1",1100822,1579121,478299
"11313","ENSACAG00000014123","6",53454784,53471855,17071
"11314","ENSACAG00000014124","GL343653.1",297522,353632,56110
"11315","ENSACAG00000014125","5",30774722,30785361,10639
"11316","ENSACAG00000014127","6",29972295,29995822,23527
"11317","ENSACAG00000014128","GL343196.1",260320,272639,12319
"11318","ENSACAG00000014129","LGc",2636674,2725866,89192
"11319","ENSACAG00000014130","GL343376.1",1034464,1039954,5490
"11320","ENSACAG00000014131","1",255206463,255298181,91718
"11321","ENSACAG00000014132","GL344013.1",27168,63659,36491
"11322","ENSACAG00000014133","GL343196.1",313512,413290,99778
"11323","ENSACAG00000014134","GL343573.1",459491,461216,1725
"11324","ENSACAG00000014138","4",97891543,97948965,57422
"11325","ENSACAG00000014139","GL343307.1",1294117,1384367,90250
"11326","ENSACAG00000014140","GL343315.1",480022,561136,81114
"11327","ENSACAG00000014142","1",94784394,94905081,120687
"11328","ENSACAG00000014143","GL343202.1",593749,632837,39088
"11329","ENSACAG00000014144","GL343376.1",1049574,1050284,710
"11330","ENSACAG00000014146","GL343376.1",1052652,1059869,7217
"11331","ENSACAG00000014147","4",23195161,23219138,23977
"11332","ENSACAG00000014149","AAWZ02037910",1254,7213,5959
"11333","ENSACAG00000014151","GL343573.1",455407,458724,3317
"11334","ENSACAG00000014155","4",141139069,141152371,13302
"11335","ENSACAG00000014156","GL343324.1",306530,307567,1037
"11336","ENSACAG00000014157","6",29891618,29972592,80974
"11337","ENSACAG00000014158","4",105104547,105124086,19539
"11338","ENSACAG00000014159","5",30789289,30870940,81651
"11339","ENSACAG00000014160","GL343305.1",1594561,1611243,16682
"11340","ENSACAG00000014161","GL343324.1",286121,286587,466
"11341","ENSACAG00000014162","GL343376.1",1065644,1074319,8675
"11342","ENSACAG00000014163","1",185919674,185934975,15301
"11343","ENSACAG00000014164","GL343324.1",255641,267243,11602
"11344","ENSACAG00000014166","GL343651.1",19608,118125,98517
"11345","ENSACAG00000014168","6",4229655,4256357,26702
"11346","ENSACAG00000014169","1",185888884,185912961,24077
"11347","ENSACAG00000014170","GL344146.1",20067,45958,25891
"11348","ENSACAG00000014172","4",105047268,105054759,7491
"11349","ENSACAG00000014173","GL343334.1",1787,10608,8821
"11350","ENSACAG00000014174","GL343951.1",3986,30963,26977
"11351","ENSACAG00000014175","AAWZ02038410",21,11758,11737
"11352","ENSACAG00000014176","5",37293729,37297695,3966
"11353","ENSACAG00000014177","GL343234.1",592047,637185,45138
"11354","ENSACAG00000014178","GL343307.1",1301747,1303336,1589
"11355","ENSACAG00000014179","4",104987691,104998595,10904
"11356","ENSACAG00000014180","6",22623203,22832757,209554
"11357","ENSACAG00000014181","GL343493.1",138772,176417,37645
"11358","ENSACAG00000014182","GL343359.1",520951,521685,734
"11359","ENSACAG00000014183","4",140966496,141087361,120865
"11360","ENSACAG00000014184","GL343573.1",438826,450503,11677
"11361","ENSACAG00000014185","1",185814536,185859361,44825
"11362","ENSACAG00000014186","GL343307.1",1418634,1438253,19619
"11363","ENSACAG00000014187","1",254297985,254323490,25505
"11364","ENSACAG00000014188","6",53488724,53496206,7482
"11365","ENSACAG00000014189","1",75795625,75806633,11008
"11366","ENSACAG00000014191","1",75660752,75769510,108758
"11367","ENSACAG00000014193","6",29757717,29786954,29237
"11368","ENSACAG00000014194","1",137145643,137277961,132318
"11369","ENSACAG00000014195","6",4259531,4402658,143127
"11370","ENSACAG00000014196","AAWZ02041083",574,5809,5235
"11371","ENSACAG00000014197","GL343359.1",634053,711896,77843
"11372","ENSACAG00000014198","4",74454287,74463795,9508
"11373","ENSACAG00000014199","1",45591048,45689212,98164
"11374","ENSACAG00000014201","1",196231800,196243975,12175
"11375","ENSACAG00000014203","4",108380057,108418786,38729
"11376","ENSACAG00000014204","4",104581808,104966560,384752
"11377","ENSACAG00000014205","5",37191889,37289659,97770
"11378","ENSACAG00000014206","1",94644949,94667323,22374
"11379","ENSACAG00000014207","GL343336.1",988374,1046798,58424
"11380","ENSACAG00000014208","GL343686.1",4533,4670,137
"11381","ENSACAG00000014209","GL343653.1",216920,252911,35991
"11382","ENSACAG00000014211","GL343686.1",36690,57233,20543
"11383","ENSACAG00000014212","AAWZ02038800",2502,4175,1673
"11384","ENSACAG00000014213","GL343324.1",221105,246710,25605
"11385","ENSACAG00000014214","GL343642.1",172846,187211,14365
"11386","ENSACAG00000014215","GL343196.1",414745,445347,30602
"11387","ENSACAG00000014216","4",74464495,74493903,29408
"11388","ENSACAG00000014219","LGb",84719,143160,58441
"11389","ENSACAG00000014220","GL343315.1",334698,336173,1475
"11390","ENSACAG00000014221","GL343489.1",546476,564315,17839
"11391","ENSACAG00000014222","GL344955.1",5783,14021,8238
"11392","ENSACAG00000014223","2",13783129,13819055,35926
"11393","ENSACAG00000014224","GL343315.1",34236,186256,152020
"11394","ENSACAG00000014225","1",229817993,229988698,170705
"11395","ENSACAG00000014226","3",195938005,195960999,22994
"11396","ENSACAG00000014227","4",116339137,116339916,779
"11397","ENSACAG00000014229","GL343307.1",1444971,1464499,19528
"11398","ENSACAG00000014231","1",94606868,94631679,24811
"11399","ENSACAG00000014232","4",116301007,116333210,32203
"11400","ENSACAG00000014233","GL344934.1",2074,9238,7164
"11401","ENSACAG00000014235","6",61946557,61977075,30518
"11402","ENSACAG00000014236","1",255368923,255438181,69258
"11403","ENSACAG00000014237","GL343651.1",233594,274034,40440
"11404","ENSACAG00000014238","1",185646918,185677193,30275
"11405","ENSACAG00000014239","4",74504903,74529745,24842
"11406","ENSACAG00000014240","1",196003792,196038633,34841
"11407","ENSACAG00000014241","GL344400.1",465,12183,11718
"11408","ENSACAG00000014244","GL343228.1",396439,426386,29947
"11409","ENSACAG00000014245","1",94531587,94603714,72127
"11410","ENSACAG00000014246","GL343234.1",432182,479430,47248
"11411","ENSACAG00000014247","1",195977012,196000518,23506
"11412","ENSACAG00000014250","1",255459476,255510261,50785
"11413","ENSACAG00000014252","GL343234.1",427041,428279,1238
"11414","ENSACAG00000014253","2",75507168,75528356,21188
"11415","ENSACAG00000014254","1",75592438,75648439,56001
"11416","ENSACAG00000014255","1",185538646,185591578,52932
"11417","ENSACAG00000014256","GL343234.1",164459,345689,181230
"11418","ENSACAG00000014257","3",195968408,196006010,37602
"11419","ENSACAG00000014258","GL343273.1",641352,649511,8159
"11420","ENSACAG00000014260","GL343252.1",294810,318529,23719
"11421","ENSACAG00000014261","GL343228.1",325211,384423,59212
"11422","ENSACAG00000014262","GL344400.1",17273,39078,21805
"11423","ENSACAG00000014264","4",140955185,140955531,346
"11424","ENSACAG00000014266","AAWZ02040805",6173,6298,125
"11425","ENSACAG00000014267","GL343489.1",584520,619273,34753
"11426","ENSACAG00000014268","4",74531138,74571168,40030
"11427","ENSACAG00000014270","GL343686.1",60347,61901,1554
"11428","ENSACAG00000014272","5",37063213,37159354,96141
"11429","ENSACAG00000014273","GL343252.1",406967,471863,64896
"11430","ENSACAG00000014274","4",140925095,140953979,28884
"11431","ENSACAG00000014275","2",135010404,135051639,41235
"11432","ENSACAG00000014276","1",254280486,254291950,11464
"11433","ENSACAG00000014277","GL343573.1",385087,434217,49130
"11434","ENSACAG00000014278","GL343459.1",138910,292165,153255
"11435","ENSACAG00000014279","4",108456646,108753175,296529
"11436","ENSACAG00000014280","GL343227.1",1686859,1704416,17557
"11437","ENSACAG00000014281","GL344198.1",35744,64918,29174
"11438","ENSACAG00000014282","2",75535339,75692018,156679
"11439","ENSACAG00000014283","3",133851892,133898983,47091
"11440","ENSACAG00000014284","GL343228.1",249327,282841,33514
"11441","ENSACAG00000014286","GL344198.1",2428,26016,23588
"11442","ENSACAG00000014287","1",185503198,185529993,26795
"11443","ENSACAG00000014291","4",108783127,108783909,782
"11444","ENSACAG00000014292","LGb",173812,175467,1655
"11445","ENSACAG00000014293","4",74570708,74584946,14238
"11446","ENSACAG00000014294","2",41599666,41611704,12038
"11447","ENSACAG00000014296","GL343307.1",1466912,1477025,10113
"11448","ENSACAG00000014297","1",254246286,254286376,40090
"11449","ENSACAG00000014298","4",140859207,140911417,52210
"11450","ENSACAG00000014300","4",108792606,108851988,59382
"11451","ENSACAG00000014301","1",194651238,194711939,60701
"11452","ENSACAG00000014302","LGc",2582194,2631841,49647
"11453","ENSACAG00000014303","1",230001106,230018134,17028
"11454","ENSACAG00000014304","GL343273.1",659100,747441,88341
"11455","ENSACAG00000014305","GL343279.1",45811,52941,7130
"11456","ENSACAG00000014306","2",41542007,41557203,15196
"11457","ENSACAG00000014307","1",41006818,41090113,83295
"11458","ENSACAG00000014308","1",194473449,194648050,174601
"11459","ENSACAG00000014309","GL344757.1",18233,20572,2339
"11460","ENSACAG00000014310","LGb",289226,467363,178137
"11461","ENSACAG00000014311","1",94516871,94523439,6568
"11462","ENSACAG00000014312","4",108860037,108864844,4807
"11463","ENSACAG00000014313","4",116222328,116276851,54523
"11464","ENSACAG00000014314","GL343686.1",65934,71319,5385
"11465","ENSACAG00000014317","GL343264.1",1373294,1435423,62129
"11466","ENSACAG00000014318","GL343686.1",89560,90165,605
"11467","ENSACAG00000014319","1",185488520,185498903,10383
"11468","ENSACAG00000014320","2",41562071,41579120,17049
"11469","ENSACAG00000014321","GL343279.1",49218,53721,4503
"11470","ENSACAG00000014322","1",185467044,185488446,21402
"11471","ENSACAG00000014323","GL343686.1",94091,101247,7156
"11472","ENSACAG00000014324","GL344651.1",4056,13163,9107
"11473","ENSACAG00000014325","GL344844.1",47,19376,19329
"11474","ENSACAG00000014326","GL344757.1",552,15890,15338
"11475","ENSACAG00000014327","AAWZ02039146",163,9342,9179
"11476","ENSACAG00000014328","1",94509789,94514338,4549
"11477","ENSACAG00000014329","AAWZ02037268",5300,17743,12443
"11478","ENSACAG00000014330","GL343653.1",159732,191632,31900
"11479","ENSACAG00000014331","2",135058033,135066124,8091
"11480","ENSACAG00000014332","2",135082543,135099209,16666
"11481","ENSACAG00000014333","GL344783.1",3913,20034,16121
"11482","ENSACAG00000014334","GL343489.1",46081,228441,182360
"11483","ENSACAG00000014335","4",139029033,139165763,136730
"11484","ENSACAG00000014337","1",94417441,94455419,37978
"11485","ENSACAG00000014338","GL343279.1",58388,69811,11423
"11486","ENSACAG00000014339","GL343368.1",831098,831844,746
"11487","ENSACAG00000014340","GL343617.1",228172,242456,14284
"11488","ENSACAG00000014342","1",185127869,185416501,288632
"11489","ENSACAG00000014344","2",41382738,41383634,896
"11490","ENSACAG00000014345","GL343368.1",846765,905175,58410
"11491","ENSACAG00000014348","1",255548147,255564441,16294
"11492","ENSACAG00000014349","GL343642.1",113099,147552,34453
"11493","ENSACAG00000014350","GL343600.1",112539,218477,105938
"11494","ENSACAG00000014352","1",45706675,45759496,52821
"11495","ENSACAG00000014353","4",104537433,104721139,183706
"11496","ENSACAG00000014354","3",147609082,147683920,74838
"11497","ENSACAG00000014355","4",74833389,74989143,155754
"11498","ENSACAG00000014356","4",108867023,108882319,15296
"11499","ENSACAG00000014357","GL343227.1",1313029,1492274,179245
"11500","ENSACAG00000014358","GL344709.1",991,23105,22114
"11501","ENSACAG00000014359","GL343654.1",2338,54257,51919
"11502","ENSACAG00000014360","GL343617.1",250908,268430,17522
"11503","ENSACAG00000014362","GL343686.1",126874,144759,17885
"11504","ENSACAG00000014363","4",33475549,33516185,40636
"11505","ENSACAG00000014365","AAWZ02035345",13351,46878,33527
"11506","ENSACAG00000014366","1",174493829,174604859,111030
"11507","ENSACAG00000014368","1",228286493,228302015,15522
"11508","ENSACAG00000014369","1",228248963,228281633,32670
"11509","ENSACAG00000014370","3",198696596,198717349,20753
"11510","ENSACAG00000014371","AAWZ02037388",10040,15642,5602
"11511","ENSACAG00000014372","GL343227.1",1206039,1216828,10789
"11512","ENSACAG00000014373","1",46098567,46152689,54122
"11513","ENSACAG00000014374","GL343279.1",82104,89766,7662
"11514","ENSACAG00000014375","GL343660.1",289295,302856,13561
"11515","ENSACAG00000014377","5",83718726,83824335,105609
"11516","ENSACAG00000014378","GL343336.1",852298,866952,14654
"11517","ENSACAG00000014379","LGb",526496,556913,30417
"11518","ENSACAG00000014380","1",94335768,94393092,57324
"11519","ENSACAG00000014383","GL343348.1",333719,372277,38558
"11520","ENSACAG00000014384","1",254215650,254228709,13059
"11521","ENSACAG00000014385","5",83931373,84072618,141245
"11522","ENSACAG00000014386","AAWZ02041618",201,344,143
"11523","ENSACAG00000014388","GL343227.1",1170436,1189173,18737
"11524","ENSACAG00000014389","AAWZ02039326",21,4994,4973
"11525","ENSACAG00000014390","1",174622429,174623154,725
"11526","ENSACAG00000014391","1",174629047,174657334,28287
"11527","ENSACAG00000014393","AAWZ02038725",21,10592,10571
"11528","ENSACAG00000014394","GL343792.1",125536,149798,24262
"11529","ENSACAG00000014395","GL343439.1",29412,30011,599
"11530","ENSACAG00000014396","4",33461591,33472051,10460
"11531","ENSACAG00000014397","GL343234.1",2225085,2229576,4491
"11532","ENSACAG00000014398","3",61945313,62114316,169003
"11533","ENSACAG00000014399","GL343227.1",855740,880271,24531
"11534","ENSACAG00000014400","GL343439.1",51716,67542,15826
"11535","ENSACAG00000014403","3",196015655,196033465,17810
"11536","ENSACAG00000014404","1",174677045,174809187,132142
"11537","ENSACAG00000014405","3",133826376,133840810,14434
"11538","ENSACAG00000014406","4",108893651,108908064,14413
"11539","ENSACAG00000014407","3",62129557,62146907,17350
"11540","ENSACAG00000014408","GL344596.1",631,26377,25746
"11541","ENSACAG00000014409","6",62018951,62021771,2820
"11542","ENSACAG00000014410","GL343617.1",309783,334245,24462
"11543","ENSACAG00000014411","1",75392759,75528315,135556
"11544","ENSACAG00000014413","LGc",2571329,2572501,1172
"11545","ENSACAG00000014415","3",133808036,133822437,14401
"11546","ENSACAG00000014416","GL343654.1",63185,69298,6113
"11547","ENSACAG00000014417","GL343654.1",127888,159363,31475
"11548","ENSACAG00000014420","2",137480926,137581436,100510
"11549","ENSACAG00000014422","GL343368.1",1016503,1085661,69158
"11550","ENSACAG00000014423","3",62148168,62185825,37657
"11551","ENSACAG00000014430","GL343324.1",156619,212012,55393
"11552","ENSACAG00000014431","5",37007816,37018637,10821
"11553","ENSACAG00000014432","GL343264.1",1455576,1490173,34597
"11554","ENSACAG00000014433","LGb",570551,726430,155879
"11555","ENSACAG00000014434","4",116088616,116200909,112293
"11556","ENSACAG00000014435","GL343336.1",807013,840675,33662
"11557","ENSACAG00000014436","GL343676.1",133636,262720,129084
"11558","ENSACAG00000014437","GL343231.1",31591,41196,9605
"11559","ENSACAG00000014438","GL343308.1",133429,181313,47884
"11560","ENSACAG00000014439","GL343279.1",140550,161486,20936
"11561","ENSACAG00000014440","LGb",983503,1243996,260493
"11562","ENSACAG00000014441","GL343489.1",494512,496080,1568
"11563","ENSACAG00000014442","4",73312229,73440477,128248
"11564","ENSACAG00000014443","4",33393157,33407503,14346
"11565","ENSACAG00000014445","1",40873601,40927600,53999
"11566","ENSACAG00000014446","GL343489.1",504576,520039,15463
"11567","ENSACAG00000014447","5",96645597,96675985,30388
"11568","ENSACAG00000014448","AAWZ02037157",2284,18514,16230
"11569","ENSACAG00000014449","1",174813522,174817406,3884
"11570","ENSACAG00000014450","GL344946.1",1812,2323,511
"11571","ENSACAG00000014451","1",174822272,174954363,132091
"11572","ENSACAG00000014452","5",36938987,36981762,42775
"11573","ENSACAG00000014453","1",193858835,193909339,50504
"11574","ENSACAG00000014454","GL343660.1",226386,246647,20261
"11575","ENSACAG00000014456","5",84104288,84190007,85719
"11576","ENSACAG00000014457","GL343231.1",82192,106543,24351
"11577","ENSACAG00000014459","3",196054419,196057439,3020
"11578","ENSACAG00000014460","AAWZ02040531",1406,5564,4158
"11579","ENSACAG00000014461","1",46505508,46533679,28171
"11580","ENSACAG00000014462","3",196080759,196094570,13811
"11581","ENSACAG00000014463","GL343792.1",86517,90940,4423
"11582","ENSACAG00000014464","GL344424.1",9385,10854,1469
"11583","ENSACAG00000014467","GL343642.1",6813,99512,92699
"11584","ENSACAG00000014468","4",33372521,33393409,20888
"11585","ENSACAG00000014469","5",20253475,20614633,361158
"11586","ENSACAG00000014470","GL343308.1",98878,121975,23097
"11587","ENSACAG00000014471","3",198725816,198755864,30048
"11588","ENSACAG00000014472","GL343792.1",68030,83798,15768
"11589","ENSACAG00000014473","5",36833397,36902800,69403
"11590","ENSACAG00000014474","1",154749096,154767129,18033
"11591","ENSACAG00000014475","GL343196.1",535261,628097,92836
"11592","ENSACAG00000014477","GL343721.1",10285,48380,38095
"11593","ENSACAG00000014478","GL343231.1",167244,333673,166429
"11594","ENSACAG00000014481","4",108910403,108911091,688
"11595","ENSACAG00000014482","GL343211.1",213841,299458,85617
"11596","ENSACAG00000014483","2",197714775,197717180,2405
"11597","ENSACAG00000014484","GL343575.1",139206,143374,4168
"11598","ENSACAG00000014485","3",62276525,62304559,28034
"11599","ENSACAG00000014487","3",133398858,133459421,60563
"11600","ENSACAG00000014488","4",108950799,109019948,69149
"11601","ENSACAG00000014489","AAWZ02035675",22704,32018,9314
"11602","ENSACAG00000014490","GL343393.1",14226,47260,33034
"11603","ENSACAG00000014491","4",115983297,116003834,20537
"11604","ENSACAG00000014492","GL343199.1",4430792,4644175,213383
"11605","ENSACAG00000014493","GL343336.1",716249,755855,39606
"11606","ENSACAG00000014494","GL343348.1",389812,438709,48897
"11607","ENSACAG00000014495","GL343792.1",25697,33296,7599
"11608","ENSACAG00000014496","GL343264.1",1546645,1608195,61550
"11609","ENSACAG00000014497","GL343654.1",200239,240042,39803
"11610","ENSACAG00000014499","GL343217.1",249782,261331,11549
"11611","ENSACAG00000014501","GL343591.1",288613,312054,23441
"11612","ENSACAG00000014502","1",174928143,174928619,476
"11613","ENSACAG00000014503","AAWZ02037034",210,2282,2072
"11614","ENSACAG00000014504","GL343217.1",215014,219317,4303
"11615","ENSACAG00000014506","1",254158169,254213313,55144
"11616","ENSACAG00000014508","1",174958998,174986336,27338
"11617","ENSACAG00000014509","1",46542497,46599092,56595
"11618","ENSACAG00000014510","1",137085895,137094925,9030
"11619","ENSACAG00000014512","GL343264.1",1711729,1718960,7231
"11620","ENSACAG00000014513","4",33024280,33063118,38838
"11621","ENSACAG00000014515","GL343217.1",150335,210329,59994
"11622","ENSACAG00000014517","GL343573.1",351249,373618,22369
"11623","ENSACAG00000014518","GL343336.1",659875,672966,13091
"11624","ENSACAG00000014520","GL343575.1",200163,225147,24984
"11625","ENSACAG00000014521","GL343264.1",1719050,1775713,56663
"11626","ENSACAG00000014522","GL343308.1",29461,80533,51072
"11627","ENSACAG00000014523","AAWZ02040349",988,1653,665
"11628","ENSACAG00000014525","LGb",1270638,1298603,27965
"11629","ENSACAG00000014526","GL344067.1",41810,75953,34143
"11630","ENSACAG00000014527","GL343660.1",216876,222581,5705
"11631","ENSACAG00000014529","GL343694.1",74806,86112,11306
"11632","ENSACAG00000014530","3",147713996,147731364,17368
"11633","ENSACAG00000014531","GL343274.1",928980,939848,10868
"11634","ENSACAG00000014532","GL343196.1",668930,673771,4841
"11635","ENSACAG00000014533","3",196097158,196111985,14827
"11636","ENSACAG00000014534","4",104535196,104547396,12200
"11637","ENSACAG00000014535","GL343957.1",648,20713,20065
"11638","ENSACAG00000014536","AAWZ02040337",165,3071,2906
"11639","ENSACAG00000014537","3",132698074,132698622,548
"11640","ENSACAG00000014539","GL343202.1",520000,521070,1070
"11641","ENSACAG00000014540","1",193738708,193847721,109013
"11642","ENSACAG00000014541","GL343459.1",302942,322220,19278
"11643","ENSACAG00000014542","GL343336.1",519720,585523,65803
"11644","ENSACAG00000014543","GL343199.1",4313630,4354677,41047
"11645","ENSACAG00000014544","GL343202.1",75265,96590,21325
"11646","ENSACAG00000014545","GL343196.1",690910,714043,23133
"11647","ENSACAG00000014546","3",132519863,132616714,96851
"11648","ENSACAG00000014547","3",62311319,62585910,274591
"11649","ENSACAG00000014548","1",154731307,154737823,6516
"11650","ENSACAG00000014549","AAWZ02036254",966,19857,18891
"11651","ENSACAG00000014550","5",36500401,36843480,343079
"11652","ENSACAG00000014551","GL343957.1",43524,66581,23057
"11653","ENSACAG00000014552","GL343324.1",108030,152028,43998
"11654","ENSACAG00000014553","1",154707908,154727079,19171
"11655","ENSACAG00000014555","GL343575.1",245161,260376,15215
"11656","ENSACAG00000014556","2",137384944,137471118,86174
"11657","ENSACAG00000014557","GL343660.1",134679,135698,1019
"11658","ENSACAG00000014558","GL343575.1",312504,329722,17218
"11659","ENSACAG00000014560","1",174997819,175017491,19672
"11660","ENSACAG00000014561","GL343660.1",94005,122821,28816
"11661","ENSACAG00000014562","5",9911741,9920486,8745
"11662","ENSACAG00000014563","1",46814840,46845148,30308
"11663","ENSACAG00000014564","1",137073638,137074669,1031
"11664","ENSACAG00000014565","1",252836019,252841007,4988
"11665","ENSACAG00000014566","1",137058376,137061096,2720
"11666","ENSACAG00000014567","GL343348.1",444194,452913,8719
"11667","ENSACAG00000014568","GL343211.1",6713,41905,35192
"11668","ENSACAG00000014569","2",96749989,96751107,1118
"11669","ENSACAG00000014570","1",137032501,137053331,20830
"11670","ENSACAG00000014571","1",12599842,12633452,33610
"11671","ENSACAG00000014572","4",115902973,115919124,16151
"11672","ENSACAG00000014573","5",96677158,96701530,24372
"11673","ENSACAG00000014574","4",104501098,104513748,12650
"11674","ENSACAG00000014575","2",96787027,96807947,20920
"11675","ENSACAG00000014576","GL343575.1",371492,373055,1563
"11676","ENSACAG00000014577","GL343196.1",731278,760526,29248
"11677","ENSACAG00000014578","GL343348.1",515614,569488,53874
"11678","ENSACAG00000014579","4",72962994,73248665,285671
"11679","ENSACAG00000014580","6",22834422,22959433,125011
"11680","ENSACAG00000014581","1",46870285,46916627,46342
"11681","ENSACAG00000014582","5",20223233,20228717,5484
"11682","ENSACAG00000014583","1",12640892,12652123,11231
"11683","ENSACAG00000014584","5",19955757,19992295,36538
"11684","ENSACAG00000014585","4",32939876,32946819,6943
"11685","ENSACAG00000014586","GL343573.1",315955,338829,22874
"11686","ENSACAG00000014587","3",196113651,196120481,6830
"11687","ENSACAG00000014588","1",228171688,228205320,33632
"11688","ENSACAG00000014591","3",196147747,196172928,25181
"11689","ENSACAG00000014592","GL343274.1",903177,922173,18996
"11690","ENSACAG00000014593","3",196172277,196180032,7755
"11691","ENSACAG00000014594","GL343686.1",234000,236344,2344
"11692","ENSACAG00000014595","GL343957.1",75975,79008,3033
"11693","ENSACAG00000014596","2",96806177,96812470,6293
"11694","ENSACAG00000014597","3",196298668,196298861,193
"11695","ENSACAG00000014599","AAWZ02038311",2140,2721,581
"11696","ENSACAG00000014600","3",196429715,196489271,59556
"11697","ENSACAG00000014601","GL343686.1",237404,240652,3248
"11698","ENSACAG00000014604","GL343324.1",3117,85026,81909
"11699","ENSACAG00000014605","2",1791201,1820129,28928
"11700","ENSACAG00000014609","4",32602139,32705038,102899
"11701","ENSACAG00000014610","1",136997507,137023480,25973
"11702","ENSACAG00000014612","2",96837454,96838479,1025
"11703","ENSACAG00000014614","2",96895912,96982778,86866
"11704","ENSACAG00000014615","1",108052719,108068210,15491
"11705","ENSACAG00000014617","5",41520449,41742651,222202
"11706","ENSACAG00000014619","3",132459268,132495263,35995
"11707","ENSACAG00000014620","GL343591.1",328584,358094,29510
"11708","ENSACAG00000014621","GL343264.1",1783367,1828508,45141
"11709","ENSACAG00000014622","1",46955674,46975288,19614
"11710","ENSACAG00000014623","GL343957.1",88040,104843,16803
"11711","ENSACAG00000014624","GL343217.1",125755,147118,21363
"11712","ENSACAG00000014625","5",96701245,96707254,6009
"11713","ENSACAG00000014627","1",193668509,193700783,32274
"11714","ENSACAG00000014628","GL343264.1",1835810,1908784,72974
"11715","ENSACAG00000014629","5",96711619,96800452,88833
"11716","ENSACAG00000014631","GL343591.1",375849,426961,51112
"11717","ENSACAG00000014632","GL343359.1",718134,959976,241842
"11718","ENSACAG00000014633","1",175118557,175145253,26696
"11719","ENSACAG00000014634","1",47485609,47486868,1259
"11720","ENSACAG00000014635","GL343348.1",607724,661663,53939
"11721","ENSACAG00000014636","GL343721.1",50982,63103,12121
"11722","ENSACAG00000014637","GL343459.1",334861,397380,62519
"11723","ENSACAG00000014638","LGb",1298637,1308580,9943
"11724","ENSACAG00000014639","GL343393.1",46106,58914,12808
"11725","ENSACAG00000014640","1",47772583,47779561,6978
"11726","ENSACAG00000014641","GL343573.1",273469,288435,14966
"11727","ENSACAG00000014642","LGb",1313349,1328807,15458
"11728","ENSACAG00000014643","GL343868.1",159468,169285,9817
"11729","ENSACAG00000014644","3",198775103,198822428,47325
"11730","ENSACAG00000014646","5",96824196,96872625,48429
"11731","ENSACAG00000014647","GL343686.1",244762,253496,8734
"11732","ENSACAG00000014648","GL343279.1",202846,205692,2846
"11733","ENSACAG00000014649","GL343694.1",1608,69526,67918
"11734","ENSACAG00000014651","5",96878479,96895704,17225
"11735","ENSACAG00000014653","1",47791272,47829104,37832
"11736","ENSACAG00000014654","2",138409356,138443572,34216
"11737","ENSACAG00000014657","1",107626725,107627363,638
"11738","ENSACAG00000014658","GL343592.1",265018,269164,4146
"11739","ENSACAG00000014660","GL343348.1",693480,778096,84616
"11740","ENSACAG00000014661","GL343279.1",182984,191443,8459
"11741","ENSACAG00000014662","GL343936.1",38727,50564,11837
"11742","ENSACAG00000014663","4",72806606,72949287,142681
"11743","ENSACAG00000014666","1",12712766,12778187,65421
"11744","ENSACAG00000014667","GL343393.1",58395,64949,6554
"11745","ENSACAG00000014668","3",196732589,196811594,79005
"11746","ENSACAG00000014669","3",196998938,197499686,500748
"11747","ENSACAG00000014670","1",40852223,40866052,13829
"11748","ENSACAG00000014671","GL343668.1",302865,305710,2845
"11749","ENSACAG00000014672","5",84243231,84258209,14978
"11750","ENSACAG00000014673","GL343252.1",556056,731572,175516
"11751","ENSACAG00000014674","1",12789082,12816502,27420
"11752","ENSACAG00000014675","GL343592.1",296721,309451,12730
"11753","ENSACAG00000014677","GL343649.1",16208,36086,19878
"11754","ENSACAG00000014679","1",193544284,193544442,158
"11755","ENSACAG00000014680","1",193476359,193511053,34694
"11756","ENSACAG00000014681","4",109235843,109274098,38255
"11757","ENSACAG00000014683","GL343459.1",399509,411346,11837
"11758","ENSACAG00000014684","GL343668.1",269397,271328,1931
"11759","ENSACAG00000014685","1",228051397,228069648,18251
"11760","ENSACAG00000014686","6",23063441,23072452,9011
"11761","ENSACAG00000014687","GL343599.1",825,25548,24723
"11762","ENSACAG00000014688","2",1876665,1885644,8979
"11763","ENSACAG00000014691","3",148080819,148244883,164064
"11764","ENSACAG00000014692","1",106988706,107073096,84390
"11765","ENSACAG00000014693","GL343231.1",500679,521163,20484
"11766","ENSACAG00000014694","GL343686.1",255036,268943,13907
"11767","ENSACAG00000014695","4",72640271,72715531,75260
"11768","ENSACAG00000014696","GL343202.1",20006,51358,31352
"11769","ENSACAG00000014697","5",96938974,96963822,24848
"11770","ENSACAG00000014698","GL343279.1",224366,242872,18506
"11771","ENSACAG00000014700","1",40793049,40829512,36463
"11772","ENSACAG00000014701","1",175153118,175185165,32047
"11773","ENSACAG00000014702","3",132420383,132454936,34553
"11774","ENSACAG00000014703","2",1891695,1921674,29979
"11775","ENSACAG00000014705","6",23237333,23243802,6469
"11776","ENSACAG00000014707","5",36356447,36360512,4065
"11777","ENSACAG00000014708","GL343217.1",47818,101131,53313
"11778","ENSACAG00000014709","1",228034908,228036350,1442
"11779","ENSACAG00000014712","1",175233834,175241424,7590
"11780","ENSACAG00000014713","5",36306342,36351310,44968
"11781","ENSACAG00000014714","3",132356103,132402737,46634
"11782","ENSACAG00000014715","GL343459.1",412358,420318,7960
"11783","ENSACAG00000014716","1",175280811,175512437,231626
"11784","ENSACAG00000014717","6",23265819,23277594,11775
"11785","ENSACAG00000014718","GL343922.1",100600,102369,1769
"11786","ENSACAG00000014719","GL343459.1",421468,530460,108992
"11787","ENSACAG00000014720","GL343736.1",84021,211228,127207
"11788","ENSACAG00000014721","GL343780.1",60812,83538,22726
"11789","ENSACAG00000014723","GL343393.1",75805,82980,7175
"11790","ENSACAG00000014725","GL343668.1",201606,213165,11559
"11791","ENSACAG00000014726","GL343649.1",36515,116389,79874
"11792","ENSACAG00000014727","1",75144119,75159974,15855
"11793","ENSACAG00000014728","GL343668.1",186484,200440,13956
"11794","ENSACAG00000014729","LGb",1342765,1373321,30556
"11795","ENSACAG00000014730","5",20090367,20129162,38795
"11796","ENSACAG00000014731","5",35994402,36120451,126049
"11797","ENSACAG00000014732","GL343202.1",143,11846,11703
"11798","ENSACAG00000014733","GL343273.1",747733,762741,15008
"11799","ENSACAG00000014734","1",136981731,136997875,16144
"11800","ENSACAG00000014735","AAWZ02036979",3256,5760,2504
"11801","ENSACAG00000014736","GL344509.1",32173,50831,18658
"11802","ENSACAG00000014737","GL343592.1",308887,319617,10730
"11803","ENSACAG00000014738","GL343290.1",1535974,1721555,185581
"11804","ENSACAG00000014739","1",47840635,47898899,58264
"11805","ENSACAG00000014740","GL343231.1",1495538,1499017,3479
"11806","ENSACAG00000014741","5",84260163,84315585,55422
"11807","ENSACAG00000014742","GL343279.1",241237,281131,39894
"11808","ENSACAG00000014743","6",23315073,23343884,28811
"11809","ENSACAG00000014745","GL343668.1",129460,176583,47123
"11810","ENSACAG00000014747","4",109279569,109549714,270145
"11811","ENSACAG00000014748","GL343199.1",4232896,4304238,71342
"11812","ENSACAG00000014749","GL343628.1",308973,325361,16388
"11813","ENSACAG00000014750","2",138447584,138458949,11365
"11814","ENSACAG00000014751","AAWZ02036535",383,20175,19792
"11815","ENSACAG00000014752","4",109620012,109620641,629
"11816","ENSACAG00000014754","GL343393.1",105541,117169,11628
"11817","ENSACAG00000014755","GL343348.1",841751,878725,36974
"11818","ENSACAG00000014756","AAWZ02037377",4163,13626,9463
"11819","ENSACAG00000014758","GL343231.1",1506676,1673144,166468
"11820","ENSACAG00000014759","GL343199.1",4187882,4233335,45453
"11821","ENSACAG00000014760","GL343273.1",777100,789575,12475
"11822","ENSACAG00000014761","1",136977529,136982154,4625
"11823","ENSACAG00000014762","5",19933485,19950024,16539
"11824","ENSACAG00000014763","GL343273.1",794827,810839,16012
"11825","ENSACAG00000014764","1",75044711,75076842,32131
"11826","ENSACAG00000014766","2",2199811,2230618,30807
"11827","ENSACAG00000014769","GL343199.1",4105571,4144227,38656
"11828","ENSACAG00000014770","1",136938682,136948636,9954
"11829","ENSACAG00000014771","GL343273.1",809940,839561,29621
"11830","ENSACAG00000014772","1",12817296,12860381,43085
"11831","ENSACAG00000014773","3",132272496,132349089,76593
"11832","ENSACAG00000014774","GL343628.1",263571,293406,29835
"11833","ENSACAG00000014775","1",227937103,227963633,26530
"11834","ENSACAG00000014776","GL343393.1",119958,125828,5870
"11835","ENSACAG00000014777","GL343196.1",766573,804260,37687
"11836","ENSACAG00000014779","GL343660.1",44596,70795,26199
"11837","ENSACAG00000014780","3",23251300,23288483,37183
"11838","ENSACAG00000014781","GL343299.1",1574534,1585991,11457
"11839","ENSACAG00000014782","1",193418519,193447473,28954
"11840","ENSACAG00000014783","5",97116435,97144628,28193
"11841","ENSACAG00000014784","GL343393.1",127759,155437,27678
"11842","ENSACAG00000014785","4",71897527,72045815,148288
"11843","ENSACAG00000014786","2",75798369,75880702,82333
"11844","ENSACAG00000014787","GL343308.1",6672,23566,16894
"11845","ENSACAG00000014789","2",179654002,179720103,66101
"11846","ENSACAG00000014790","GL344523.1",36,14889,14853
"11847","ENSACAG00000014791","1",227915054,227933305,18251
"11848","ENSACAG00000014792","GL343217.1",30774,39459,8685
"11849","ENSACAG00000014793","AAWZ02038453",1299,10769,9470
"11850","ENSACAG00000014794","1",40700407,40743498,43091
"11851","ENSACAG00000014797","GL343393.1",172775,181462,8687
"11852","ENSACAG00000014798","2",137225594,137333540,107946
"11853","ENSACAG00000014799","AAWZ02038023",3475,12262,8787
"11854","ENSACAG00000014800","3",148256363,148275005,18642
"11855","ENSACAG00000014801","GL343393.1",186433,203667,17234
"11856","ENSACAG00000014802","4",32441097,32451229,10132
"11857","ENSACAG00000014803","GL343333.1",654073,696497,42424
"11858","ENSACAG00000014804","AAWZ02038303",4118,9326,5208
"11859","ENSACAG00000014806","GL343599.1",26676,57586,30910
"11860","ENSACAG00000014807","4",32414134,32431769,17635
"11861","ENSACAG00000014808","GL344063.1",2660,21434,18774
"11862","ENSACAG00000014809","2",179314553,179433668,119115
"11863","ENSACAG00000014810","2",2259922,2288478,28556
"11864","ENSACAG00000014811","2",138450533,138483435,32902
"11865","ENSACAG00000014812","GL343459.1",588604,615095,26491
"11866","ENSACAG00000014813","2",138508956,138511334,2378
"11867","ENSACAG00000014815","1",47906694,47923776,17082
"11868","ENSACAG00000014816","1",74960580,74984196,23616
"11869","ENSACAG00000014817","5",19880643,19895913,15270
"11870","ENSACAG00000014818","GL344063.1",70604,82411,11807
"11871","ENSACAG00000014819","AAWZ02038633",1168,8500,7332
"11872","ENSACAG00000014820","1",175942665,175944111,1446
"11873","ENSACAG00000014822","4",110004629,110013082,8453
"11874","ENSACAG00000014823","3",196306555,196387045,80490
"11875","ENSACAG00000014825","GL343660.1",1254,7380,6126
"11876","ENSACAG00000014826","1",176001746,176032195,30449
"11877","ENSACAG00000014827","GL343299.1",1639262,1644345,5083
"11878","ENSACAG00000014828","2",57137870,57182661,44791
"11879","ENSACAG00000014830","4",110012726,110044047,31321
"11880","ENSACAG00000014831","2",138711847,138729553,17706
"11881","ENSACAG00000014832","2",57059875,57105625,45750
"11882","ENSACAG00000014833","3",153662932,153681002,18070
"11883","ENSACAG00000014834","GL343874.1",137996,139439,1443
"11884","ENSACAG00000014837","1",176256051,176274266,18215
"11885","ENSACAG00000014838","GL343668.1",105214,123480,18266
"11886","ENSACAG00000014839","4",32375467,32408969,33502
"11887","ENSACAG00000014840","1",40581229,40692736,111507
"11888","ENSACAG00000014841","3",132249715,132263323,13608
"11889","ENSACAG00000014842","GL343874.1",151281,152087,806
"11890","ENSACAG00000014843","GL343936.1",57174,102118,44944
"11891","ENSACAG00000014844","GL343758.1",1990,49090,47100
"11892","ENSACAG00000014845","2",179179927,179195477,15550
"11893","ENSACAG00000014846","GL343649.1",63439,73829,10390
"11894","ENSACAG00000014849","2",98102868,98106230,3362
"11895","ENSACAG00000014850","3",153443894,153476023,32129
"11896","ENSACAG00000014851","2",179123944,179160928,36984
"11897","ENSACAG00000014852","3",23168501,23256972,88471
"11898","ENSACAG00000014853","1",176274850,176325900,51050
"11899","ENSACAG00000014854","4",110042918,110080711,37793
"11900","ENSACAG00000014855","GL343273.1",842316,855490,13174
"11901","ENSACAG00000014857","GL344523.1",22338,32286,9948
"11902","ENSACAG00000014858","2",98163948,98238772,74824
"11903","ENSACAG00000014859","AAWZ02040132",99,7103,7004
"11904","ENSACAG00000014861","GL344658.1",123,13147,13024
"11905","ENSACAG00000014863","GL343668.1",31042,83106,52064
"11906","ENSACAG00000014864","1",40545999,40570775,24776
"11907","ENSACAG00000014865","GL343633.1",46026,125485,79459
"11908","ENSACAG00000014866","LGb",1418065,1575711,157646
"11909","ENSACAG00000014867","GL344066.1",57519,81489,23970
"11910","ENSACAG00000014868","GL343441.1",672152,751684,79532
"11911","ENSACAG00000014869","GL343736.1",220826,271553,50727
"11912","ENSACAG00000014870","GL345054.1",1323,10654,9331
"11913","ENSACAG00000014871","GL343199.1",4046915,4074805,27890
"11914","ENSACAG00000014872","GL343721.1",108802,116982,8180
"11915","ENSACAG00000014873","3",153355496,153428363,72867
"11916","ENSACAG00000014874","GL343279.1",281561,294507,12946
"11917","ENSACAG00000014875","3",198898784,199031843,133059
"11918","ENSACAG00000014876","GL343393.1",207791,215311,7520
"11919","ENSACAG00000014877","AAWZ02038895",7974,9245,1271
"11920","ENSACAG00000014880","3",132174279,132227394,53115
"11921","ENSACAG00000014881","GL344570.1",2973,39201,36228
"11922","ENSACAG00000014882","1",193362391,193410552,48161
"11923","ENSACAG00000014883","GL343573.1",239063,246153,7090
"11924","ENSACAG00000014884","GL343441.1",47252,55158,7906
"11925","ENSACAG00000014885","GL343393.1",216948,220013,3065
"11926","ENSACAG00000014886","2",57002907,57051527,48620
"11927","ENSACAG00000014890","3",132126609,132168607,41998
"11928","ENSACAG00000014891","GL343393.1",232606,235668,3062
"11929","ENSACAG00000014892","1",74862925,74883710,20785
"11930","ENSACAG00000014894","GL344268.1",3746,56714,52968
"11931","ENSACAG00000014895","3",148278752,148282133,3381
"11932","ENSACAG00000014896","1",47952472,47983547,31075
"11933","ENSACAG00000014897","GL343246.1",330729,362447,31718
"11934","ENSACAG00000014898","1",106836985,106877561,40576
"11935","ENSACAG00000014899","GL343393.1",251701,269759,18058
"11936","ENSACAG00000014900","3",148283881,148295796,11915
"11937","ENSACAG00000014901","GL343199.1",4002952,4038024,35072
"11938","ENSACAG00000014902","2",137172283,137205488,33205
"11939","ENSACAG00000014903","GL343252.1",1021060,1023597,2537
"11940","ENSACAG00000014905","GL344658.1",5248,5337,89
"11941","ENSACAG00000014906","1",242429931,242465101,35170
"11942","ENSACAG00000014907","5",19840379,19859324,18945
"11943","ENSACAG00000014909","GL343273.1",872079,882898,10819
"11944","ENSACAG00000014910","GL343252.1",1154747,1155742,995
"11945","ENSACAG00000014911","2",178928749,178960020,31271
"11946","ENSACAG00000014912","GL343279.1",314148,318422,4274
"11947","ENSACAG00000014913","1",193281447,193307914,26467
"11948","ENSACAG00000014914","GL343252.1",1213524,1239336,25812
"11949","ENSACAG00000014915","3",132072508,132113181,40673
"11950","ENSACAG00000014916","5",97161282,97253810,92528
"11951","ENSACAG00000014917","1",242028477,242096082,67605
"11952","ENSACAG00000014919","GL343279.1",323095,342310,19215
"11953","ENSACAG00000014920","1",74820659,74842582,21923
"11954","ENSACAG00000014921","LGc",7140565,7440704,300139
"11955","ENSACAG00000014923","3",132048024,132050053,2029
"11956","ENSACAG00000014925","4",110092305,110098567,6262
"11957","ENSACAG00000014926","GL344062.1",67225,74152,6927
"11958","ENSACAG00000014927","AAWZ02036535",22178,25068,2890
"11959","ENSACAG00000014928","GL343252.1",1250717,1269864,19147
"11960","ENSACAG00000014929","GL343199.1",3927216,3928991,1775
"11961","ENSACAG00000014930","GL343640.1",49346,56006,6660
"11962","ENSACAG00000014931","GL343273.1",894473,937329,42856
"11963","ENSACAG00000014932","AAWZ02040015",21,7461,7440
"11964","ENSACAG00000014933","4",110130810,110148325,17515
"11965","ENSACAG00000014934","3",131953552,131992699,39147
"11966","ENSACAG00000014935","GL343668.1",21,14162,14141
"11967","ENSACAG00000014937","AAWZ02039217",862,8359,7497
"11968","ENSACAG00000014938","2",2295845,2321527,25682
"11969","ENSACAG00000014939","AAWZ02038779",5880,6777,897
"11970","ENSACAG00000014940","3",148331621,148356539,24918
"11971","ENSACAG00000014942","AAWZ02041879",1089,3534,2445
"11972","ENSACAG00000014943","1",40431548,40455925,24377
"11973","ENSACAG00000014944","5",80450342,80496717,46375
"11974","ENSACAG00000014945","1",241876530,242029309,152779
"11975","ENSACAG00000014946","1",193215507,193271675,56168
"11976","ENSACAG00000014947","GL343866.1",16135,53259,37124
"11977","ENSACAG00000014949","GL343640.1",3197,125548,122351
"11978","ENSACAG00000014950","1",192888494,192917950,29456
"11979","ENSACAG00000014951","2",2332314,2363510,31196
"11980","ENSACAG00000014952","3",177523061,177605920,82859
"11981","ENSACAG00000014954","5",19815511,19843135,27624
"11982","ENSACAG00000014955","GL343421.1",86657,94983,8326
"11983","ENSACAG00000014956","GL343273.1",939833,946315,6482
"11984","ENSACAG00000014957","1",74722395,74763972,41577
"11985","ENSACAG00000014958","GL344004.1",5587,11180,5593
"11986","ENSACAG00000014959","2",98254488,98281154,26666
"11987","ENSACAG00000014960","2",64667595,64677384,9789
"11988","ENSACAG00000014961","2",177945009,178219500,274491
"11989","ENSACAG00000014963","3",199045604,199124140,78536
"11990","ENSACAG00000014964","3",177647559,177935525,287966
"11991","ENSACAG00000014965","GL343599.1",65574,66146,572
"11992","ENSACAG00000014967","GL343599.1",76207,104721,28514
"11993","ENSACAG00000014969","GL343669.1",155736,286680,130944
"11994","ENSACAG00000014970","1",176326227,176357166,30939
"11995","ENSACAG00000014973","GL343599.1",106922,121935,15013
"11996","ENSACAG00000014974","GL343273.1",948167,963569,15402
"11997","ENSACAG00000014975","GL343393.1",281682,312941,31259
"11998","ENSACAG00000014977","GL343279.1",347247,354208,6961
"11999","ENSACAG00000014978","1",47994223,48021222,26999
"12000","ENSACAG00000014979","GL343252.1",1274524,1352659,78135
"12001","ENSACAG00000014982","GL344411.1",5901,32396,26495
"12002","ENSACAG00000014985","GL343273.1",1063698,1291606,227908
"12003","ENSACAG00000014986","GL343246.1",570027,590678,20651
"12004","ENSACAG00000014987","GL344004.1",22764,22886,122
"12005","ENSACAG00000014988","GL344004.1",24795,34417,9622
"12006","ENSACAG00000014989","GL343203.1",4100711,4169148,68437
"12007","ENSACAG00000014990","GL344004.1",34737,73729,38992
"12008","ENSACAG00000014991","2",188475372,188551765,76393
"12009","ENSACAG00000014992","GL343421.1",560479,560936,457
"12010","ENSACAG00000014994","GL343573.1",210202,239412,29210
"12011","ENSACAG00000014995","1",74529013,74597090,68077
"12012","ENSACAG00000014996","5",84318795,84338641,19846
"12013","ENSACAG00000014997","AAWZ02040308",703,6941,6238
"12014","ENSACAG00000014999","GL343199.1",3842764,3867568,24804
"12015","ENSACAG00000015000","GL343199.1",3745614,3843137,97523
"12016","ENSACAG00000015001","GL343421.1",567039,604764,37725
"12017","ENSACAG00000015002","GL343421.1",664628,815168,150540
"12018","ENSACAG00000015003","2",98287204,98346030,58826
"12019","ENSACAG00000015004","2",138802911,138845064,42153
"12020","ENSACAG00000015005","GL344515.1",2825,4748,1923
"12021","ENSACAG00000015006","4",32160745,32307519,146774
"12022","ENSACAG00000015007","2",138852889,138871983,19094
"12023","ENSACAG00000015008","GL344449.1",3473,10902,7429
"12024","ENSACAG00000015010","1",74445250,74474246,28996
"12025","ENSACAG00000015011","2",139028674,139036258,7584
"12026","ENSACAG00000015012","1",192788684,192871457,82773
"12027","ENSACAG00000015013","GL344515.1",12937,16782,3845
"12028","ENSACAG00000015014","2",137143913,137145274,1361
"12029","ENSACAG00000015015","GL343524.1",101062,171438,70376
"12030","ENSACAG00000015016","GL343866.1",28,14075,14047
"12031","ENSACAG00000015018","2",136558481,136571131,12650
"12032","ENSACAG00000015019","5",80502695,80553498,50803
"12033","ENSACAG00000015021","GL343758.1",52226,73935,21709
"12034","ENSACAG00000015022","GL343630.1",253683,315074,61391
"12035","ENSACAG00000015023","5",97271211,97286042,14831
"12036","ENSACAG00000015024","GL343999.1",39532,76980,37448
"12037","ENSACAG00000015025","2",2372359,2426039,53680
"12038","ENSACAG00000015026","GL343599.1",127197,132835,5638
"12039","ENSACAG00000015027","GL344524.1",3381,3515,134
"12040","ENSACAG00000015028","GL343616.1",374779,404583,29804
"12041","ENSACAG00000015029","AAWZ02038880",2074,10137,8063
"12042","ENSACAG00000015031","GL343279.1",356983,365052,8069
"12043","ENSACAG00000015032","3",199188815,199427619,238804
"12044","ENSACAG00000015033","GL343261.1",1607920,1608643,723
"12045","ENSACAG00000015034","4",71753438,71821158,67720
"12046","ENSACAG00000015035","GL344515.1",24178,29852,5674
"12047","ENSACAG00000015036","2",139081729,139272065,190336
"12048","ENSACAG00000015037","2",135706417,135785398,78981
"12049","ENSACAG00000015038","GL343261.1",1588643,1595277,6634
"12050","ENSACAG00000015039","2",135531306,135613987,82681
"12051","ENSACAG00000015040","GL344029.1",63922,92771,28849
"12052","ENSACAG00000015041","GL344524.1",14614,22205,7591
"12053","ENSACAG00000015042","AAWZ02036488",4841,25880,21039
"12054","ENSACAG00000015043","1",106695728,106744132,48404
"12055","ENSACAG00000015044","1",192747288,192774007,26719
"12056","ENSACAG00000015045","GL343573.1",201102,207520,6418
"12057","ENSACAG00000015047","GL344903.1",12512,15275,2763
"12058","ENSACAG00000015048","1",259426924,259457906,30982
"12059","ENSACAG00000015049","GL344004.1",87921,96975,9054
"12060","ENSACAG00000015050","2",199024767,199103850,79083
"12061","ENSACAG00000015051","GL343309.1",177011,194545,17534
"12062","ENSACAG00000015053","1",74409264,74435798,26534
"12063","ENSACAG00000015055","3",167738395,167831611,93216
"12064","ENSACAG00000015056","GL343279.1",412242,421979,9737
"12065","ENSACAG00000015060","GL343261.1",1320507,1519332,198825
"12066","ENSACAG00000015061","2",98345804,98358105,12301
"12067","ENSACAG00000015062","GL343290.1",1466689,1531165,64476
"12068","ENSACAG00000015063","GL343393.1",315957,321522,5565
"12069","ENSACAG00000015064","2",98386267,98388582,2315
"12070","ENSACAG00000015065","GL343203.1",4063622,4101506,37884
"12071","ENSACAG00000015066","GL344898.1",230,8954,8724
"12072","ENSACAG00000015069","AAWZ02037421",264,5709,5445
"12073","ENSACAG00000015070","1",74319537,74364295,44758
"12074","ENSACAG00000015071","2",98413289,98431747,18458
"12075","ENSACAG00000015072","GL343613.1",809,9294,8485
"12076","ENSACAG00000015073","AAWZ02038666",36,7865,7829
"12077","ENSACAG00000015074","GL343652.1",134684,316494,181810
"12078","ENSACAG00000015076","1",74190534,74256891,66357
"12079","ENSACAG00000015077","4",71725884,71732467,6583
"12080","ENSACAG00000015078","GL343284.1",1734459,1735637,1178
"12081","ENSACAG00000015079","GL343252.1",1384430,1407142,22712
"12082","ENSACAG00000015080","1",40511019,40539863,28844
"12083","ENSACAG00000015081","5",97288956,97516454,227498
"12084","ENSACAG00000015082","GL343199.1",3628323,3691993,63670
"12085","ENSACAG00000015083","1",40089800,40116626,26826
"12086","ENSACAG00000015085","GL343640.1",135964,174404,38440
"12087","ENSACAG00000015087","LGc",8454091,8570657,116566
"12088","ENSACAG00000015088","GL343613.1",21643,286719,265076
"12089","ENSACAG00000015089","GL343721.1",146799,161035,14236
"12090","ENSACAG00000015090","2",98479574,98487757,8183
"12091","ENSACAG00000015091","LGb",1595171,1602861,7690
"12092","ENSACAG00000015092","2",56976601,56992074,15473
"12093","ENSACAG00000015093","LGb",1647252,1660381,13129
"12094","ENSACAG00000015094","1",176360525,176377312,16787
"12095","ENSACAG00000015095","GL343393.1",333480,535130,201650
"12096","ENSACAG00000015096","1",129678337,129708573,30236
"12097","ENSACAG00000015097","GL343246.1",614113,767632,153519
"12098","ENSACAG00000015098","GL343252.1",1497040,1770592,273552
"12099","ENSACAG00000015099","LGb",1658933,1699986,41053
"12100","ENSACAG00000015100","GL343599.1",142608,175911,33303
"12101","ENSACAG00000015101","GL343246.1",921793,993316,71523
"12102","ENSACAG00000015102","1",74134873,74169182,34309
"12103","ENSACAG00000015103","2",98502576,98506258,3682
"12104","ENSACAG00000015104","2",184156513,184172419,15906
"12105","ENSACAG00000015105","2",98509388,98516555,7167
"12106","ENSACAG00000015106","4",71544420,71716690,172270
"12107","ENSACAG00000015107","2",135298054,135310712,12658
"12108","ENSACAG00000015108","GL343309.1",147478,174357,26879
"12109","ENSACAG00000015109","2",2448381,2528295,79914
"12110","ENSACAG00000015110","GL344086.1",7614,32751,25137
"12111","ENSACAG00000015111","2",184079598,184125372,45774
"12112","ENSACAG00000015112","GL343279.1",434271,444188,9917
"12113","ENSACAG00000015113","5",19650947,19797516,146569
"12114","ENSACAG00000015114","GL343261.1",1253545,1310150,56605
"12115","ENSACAG00000015115","5",97467944,97469245,1301
"12116","ENSACAG00000015116","GL343524.1",45137,90097,44960
"12117","ENSACAG00000015118","2",56893451,56969242,75791
"12118","ENSACAG00000015119","2",98520722,98581837,61115
"12119","ENSACAG00000015120","GL343573.1",183307,197333,14026
"12120","ENSACAG00000015121","5",97522383,97553742,31359
"12121","ENSACAG00000015122","1",186813747,186813892,145
"12122","ENSACAG00000015123","4",110187267,110198218,10951
"12123","ENSACAG00000015124","1",58867801,58989611,121810
"12124","ENSACAG00000015126","2",81152127,81252023,99896
"12125","ENSACAG00000015127","1",176379652,176401803,22151
"12126","ENSACAG00000015128","GL343758.1",73652,77886,4234
"12127","ENSACAG00000015129","GL343261.1",1189591,1208633,19042
"12128","ENSACAG00000015130","GL343393.1",344984,350515,5531
"12129","ENSACAG00000015132","3",167719536,167722890,3354
"12130","ENSACAG00000015133","1",58810112,58811050,938
"12131","ENSACAG00000015134","1",106426715,106574636,147921
"12132","ENSACAG00000015135","1",58641497,58701153,59656
"12133","ENSACAG00000015138","4",110208739,110211018,2279
"12134","ENSACAG00000015139","2",80967859,81091650,123791
"12135","ENSACAG00000015140","GL343246.1",1024122,1045771,21649
"12136","ENSACAG00000015141","1",129714883,129754222,39339
"12137","ENSACAG00000015142","2",124629108,124638512,9404
"12138","ENSACAG00000015144","2",183640094,183908668,268574
"12139","ENSACAG00000015146","GL343721.1",211265,241671,30406
"12140","ENSACAG00000015147","GL343231.1",1692721,1753660,60939
"12141","ENSACAG00000015148","3",167697308,167721274,23966
"12142","ENSACAG00000015149","2",124563725,124576953,13228
"12143","ENSACAG00000015151","4",110226089,110239563,13474
"12144","ENSACAG00000015155","1",74124796,74126979,2183
"12145","ENSACAG00000015156","GL343261.1",1170445,1187720,17275
"12146","ENSACAG00000015157","1",73968305,74050737,82432
"12147","ENSACAG00000015158","3",199471328,199507738,36410
"12148","ENSACAG00000015159","1",259069235,259071244,2009
"12149","ENSACAG00000015160","AAWZ02037649",3027,15174,12147
"12150","ENSACAG00000015161","4",110217537,110257100,39563
"12151","ENSACAG00000015162","GL343640.1",174478,220161,45683
"12152","ENSACAG00000015163","GL343721.1",270387,271406,1019
"12153","ENSACAG00000015164","2",124536117,124554236,18119
"12154","ENSACAG00000015165","GL343202.1",2315634,2670635,355001
"12155","ENSACAG00000015166","GL343721.1",273579,281444,7865
"12156","ENSACAG00000015167","GL343393.1",364086,386938,22852
"12157","ENSACAG00000015168","GL343273.1",1452019,1479644,27625
"12158","ENSACAG00000015169","GL343261.1",1089852,1127193,37341
"12159","ENSACAG00000015170","GL343573.1",166562,172278,5716
"12160","ENSACAG00000015171","GL343246.1",1053215,1117788,64573
"12161","ENSACAG00000015173","3",167654581,167678919,24338
"12162","ENSACAG00000015174","2",98593391,98624214,30823
"12163","ENSACAG00000015176","4",32133655,32142672,9017
"12164","ENSACAG00000015177","2",56825251,56883711,58460
"12165","ENSACAG00000015178","4",110261035,110317315,56280
"12166","ENSACAG00000015179","GL343231.1",1756081,1793562,37481
"12167","ENSACAG00000015180","1",176404564,176413058,8494
"12168","ENSACAG00000015182","2",139309868,139346188,36320
"12169","ENSACAG00000015183","2",124488902,124510291,21389
"12170","ENSACAG00000015184","5",19436159,19475847,39688
"12171","ENSACAG00000015186","GL343599.1",187540,188379,839
"12172","ENSACAG00000015187","2",124479605,124483581,3976
"12173","ENSACAG00000015189","1",40045688,40081235,35547
"12174","ENSACAG00000015190","GL343393.1",400024,453166,53142
"12175","ENSACAG00000015191","5",97571685,97601610,29925
"12176","ENSACAG00000015192","GL343203.1",4021684,4022733,1049
"12177","ENSACAG00000015193","4",110405918,110420890,14972
"12178","ENSACAG00000015194","GL343203.1",3886091,3923940,37849
"12179","ENSACAG00000015195","2",75886737,75911134,24397
"12180","ENSACAG00000015196","GL343599.1",236274,276423,40149
"12181","ENSACAG00000015197","1",176414156,176415463,1307
"12182","ENSACAG00000015198","4",32003957,32066308,62351
"12183","ENSACAG00000015199","1",176447052,176472076,25024
"12184","ENSACAG00000015200","2",2528609,2573163,44554
"12185","ENSACAG00000015202","5",97612290,97622050,9760
"12186","ENSACAG00000015203","GL344086.1",32394,33694,1300
"12187","ENSACAG00000015204","LGb",1707177,1719598,12421
"12188","ENSACAG00000015205","1",58576067,58611061,34994
"12189","ENSACAG00000015207","3",51192354,51227204,34850
"12190","ENSACAG00000015208","GL344086.1",38023,59022,20999
"12191","ENSACAG00000015209","5",97627185,97648380,21195
"12192","ENSACAG00000015210","2",124372321,124470109,97788
"12193","ENSACAG00000015211","2",182808161,182891403,83242
"12194","ENSACAG00000015213","3",199556946,199573568,16622
"12195","ENSACAG00000015214","GL343460.1",234421,255204,20783
"12196","ENSACAG00000015216","2",98633655,98659158,25503
"12197","ENSACAG00000015217","3",167551522,167568313,16791
"12198","ENSACAG00000015221","GL343279.1",450819,455485,4666
"12199","ENSACAG00000015222","AAWZ02037538",1495,15911,14416
"12200","ENSACAG00000015223","LGb",1738215,1747410,9195
"12201","ENSACAG00000015225","3",167483839,167490399,6560
"12202","ENSACAG00000015226","2",76112704,76144833,32129
"12203","ENSACAG00000015227","3",199788879,199977403,188524
"12204","ENSACAG00000015228","GL343231.1",1792232,1807495,15263
"12205","ENSACAG00000015229","1",176496928,176497068,140
"12206","ENSACAG00000015230","4",110448111,110599097,150986
"12207","ENSACAG00000015231","2",182400926,182428216,27290
"12208","ENSACAG00000015232","1",176521736,176522830,1094
"12209","ENSACAG00000015234","1",176809197,176831539,22342
"12210","ENSACAG00000015235","4",31901558,31996907,95349
"12211","ENSACAG00000015236","5",97651941,97684502,32561
"12212","ENSACAG00000015237","1",93474583,93478804,4221
"12213","ENSACAG00000015238","2",98722875,98724624,1749
"12214","ENSACAG00000015239","1",73956107,73967590,11483
"12215","ENSACAG00000015240","5",80577461,80599213,21752
"12216","ENSACAG00000015241","GL343758.1",146813,157717,10904
"12217","ENSACAG00000015242","GL343573.1",130476,164485,34009
"12218","ENSACAG00000015243","GL343279.1",660127,671951,11824
"12219","ENSACAG00000015244","2",182362076,182390404,28328
"12220","ENSACAG00000015245","GL343246.1",1154804,1173553,18749
"12221","ENSACAG00000015246","2",124308379,124311065,2686
"12222","ENSACAG00000015247","2",76164371,76220090,55719
"12223","ENSACAG00000015249","GL343199.1",3489423,3582746,93323
"12224","ENSACAG00000015250","GL343393.1",471810,476345,4535
"12225","ENSACAG00000015253","GL343246.1",1304508,1319387,14879
"12226","ENSACAG00000015254","GL343758.1",160087,175421,15334
"12227","ENSACAG00000015255","2",99066197,99173907,107710
"12228","ENSACAG00000015256","4",110599322,110615768,16446
"12229","ENSACAG00000015257","GL343630.1",35018,149208,114190
"12230","ENSACAG00000015258","GL343758.1",184306,205519,21213
"12231","ENSACAG00000015259","LGb",1750187,1760584,10397
"12232","ENSACAG00000015260","GL343599.1",295963,342355,46392
"12233","ENSACAG00000015261","2",123983539,123996086,12547
"12234","ENSACAG00000015262","1",73940980,73975446,34466
"12235","ENSACAG00000015263","GL343393.1",484163,500360,16197
"12236","ENSACAG00000015264","1",73931126,73931545,419
"12237","ENSACAG00000015266","GL343464.1",335250,336803,1553
"12238","ENSACAG00000015267","GL344563.1",578,3490,2912
"12239","ENSACAG00000015268","2",123820961,123975276,154315
"12240","ENSACAG00000015269","GL343246.1",1350881,1396063,45182
"12241","ENSACAG00000015270","GL343613.1",241139,257530,16391
"12242","ENSACAG00000015271","4",71461051,71523455,62404
"12243","ENSACAG00000015272","5",80606727,80628340,21613
"12244","ENSACAG00000015273","6",21330537,21446873,116336
"12245","ENSACAG00000015274","GL343460.1",123233,153324,30091
"12246","ENSACAG00000015275","GL343816.1",101162,102768,1606
"12247","ENSACAG00000015278","1",176839453,176889165,49712
"12248","ENSACAG00000015279","GL343973.1",632,2594,1962
"12249","ENSACAG00000015280","GL344448.1",30131,32828,2697
"12250","ENSACAG00000015281","2",56788458,56792605,4147
"12251","ENSACAG00000015282","GL343203.1",3826745,3853048,26303
"12252","ENSACAG00000015283","GL343524.1",415120,457252,42132
"12253","ENSACAG00000015284","GL343232.1",1548,11352,9804
"12254","ENSACAG00000015286","2",56658656,56682948,24292
"12255","ENSACAG00000015287","2",182340571,182360905,20334
"12256","ENSACAG00000015288","GL343460.1",107311,116479,9168
"12257","ENSACAG00000015289","AAWZ02040125",3088,7195,4107
"12258","ENSACAG00000015290","5",19415426,19416607,1181
"12259","ENSACAG00000015291","AAWZ02041498",79,5378,5299
"12260","ENSACAG00000015294","2",123755758,123805328,49570
"12261","ENSACAG00000015295","5",19341473,19379245,37772
"12262","ENSACAG00000015296","LGb",1759453,1768496,9043
"12263","ENSACAG00000015297","GL343252.1",1811547,1811927,380
"12264","ENSACAG00000015298","1",73759679,73781713,22034
"12265","ENSACAG00000015299","GL343973.1",16623,71798,55175
"12266","ENSACAG00000015300","2",99204741,99311230,106489
"12267","ENSACAG00000015301","GL344563.1",6021,9421,3400
"12268","ENSACAG00000015302","GL343252.1",1812424,1812813,389
"12269","ENSACAG00000015304","GL343202.1",2280526,2298440,17914
"12270","ENSACAG00000015305","GL343202.1",2263915,2277500,13585
"12271","ENSACAG00000015308","GL343252.1",1827542,1827931,389
"12272","ENSACAG00000015309","5",97771705,97793169,21464
"12273","ENSACAG00000015310","GL343613.1",288488,322534,34046
"12274","ENSACAG00000015311","1",57289375,57914291,624916
"12275","ENSACAG00000015313","GL343460.1",100045,106666,6621
"12276","ENSACAG00000015314","1",40009097,40037802,28705
"12277","ENSACAG00000015316","GL343677.1",59964,66078,6114
"12278","ENSACAG00000015318","GL343252.1",1828391,1828771,380
"12279","ENSACAG00000015319","6",21302197,21313668,11471
"12280","ENSACAG00000015320","GL343393.1",518416,534089,15673
"12281","ENSACAG00000015321","4",110618391,110642884,24493
"12282","ENSACAG00000015322","GL343677.1",121503,137573,16070
"12283","ENSACAG00000015323","GL343252.1",1832062,1832373,311
"12284","ENSACAG00000015324","2",80878265,80894452,16187
"12285","ENSACAG00000015325","AAWZ02038382",2555,11799,9244
"12286","ENSACAG00000015326","AAWZ02038585",773,10905,10132
"12287","ENSACAG00000015327","GL344563.1",15121,22363,7242
"12288","ENSACAG00000015328","2",2574589,2602425,27836
"12289","ENSACAG00000015329","GL343460.1",59847,97079,37232
"12290","ENSACAG00000015330","GL343573.1",122246,127317,5071
"12291","ENSACAG00000015331","GL343613.1",313966,314352,386
"12292","ENSACAG00000015332","1",73742143,73755473,13330
"12293","ENSACAG00000015333","5",80645120,80672739,27619
"12294","ENSACAG00000015335","GL343613.1",330726,333298,2572
"12295","ENSACAG00000015336","GL343198.1",3155987,3180044,24057
"12296","ENSACAG00000015337","GL343573.1",96304,121011,24707
"12297","ENSACAG00000015339","1",33720336,33766149,45813
"12298","ENSACAG00000015340","1",39965040,39998765,33725
"12299","ENSACAG00000015342","2",76324557,76366488,41931
"12300","ENSACAG00000015343","2",99319940,99333643,13703
"12301","ENSACAG00000015344","1",225719585,225890028,170443
"12302","ENSACAG00000015346","GL343202.1",2239627,2260118,20491
"12303","ENSACAG00000015347","2",80849536,80876217,26681
"12304","ENSACAG00000015348","4",71428264,71441485,13221
"12305","ENSACAG00000015349","GL343613.1",343124,366638,23514
"12306","ENSACAG00000015350","1",33697876,33710419,12543
"12307","ENSACAG00000015351","GL343246.1",1595769,1596140,371
"12308","ENSACAG00000015352","2",139463052,139556558,93506
"12309","ENSACAG00000015353","1",73687459,73931145,243686
"12310","ENSACAG00000015354","GL343202.1",2201243,2258568,57325
"12311","ENSACAG00000015355","5",19285828,19332637,46809
"12312","ENSACAG00000015356","5",8253399,8273081,19682
"12313","ENSACAG00000015357","5",80672199,80704456,32257
"12314","ENSACAG00000015358","1",129914314,129928554,14240
"12315","ENSACAG00000015359","AAWZ02040098",2551,5379,2828
"12316","ENSACAG00000015360","6",21291331,21299230,7899
"12317","ENSACAG00000015362","GL344736.1",3534,21522,17988
"12318","ENSACAG00000015363","GL343198.1",3126720,3153563,26843
"12319","ENSACAG00000015364","GL343393.1",535664,660499,124835
"12320","ENSACAG00000015365","2",99340845,99380172,39327
"12321","ENSACAG00000015368","GL343198.1",3087248,3103105,15857
"12322","ENSACAG00000015369","1",33669708,33673567,3859
"12323","ENSACAG00000015370","AAWZ02038876",836,4351,3515
"12324","ENSACAG00000015371","GL343460.1",28446,38357,9911
"12325","ENSACAG00000015373","AAWZ02038198",1792,12558,10766
"12326","ENSACAG00000015374","1",129961311,130164974,203663
"12327","ENSACAG00000015376","2",182319021,182337589,18568
"12328","ENSACAG00000015377","GL344563.1",23219,26733,3514
"12329","ENSACAG00000015378","6",21284583,21290951,6368
"12330","ENSACAG00000015379","GL343199.1",3477625,3479199,1574
"12331","ENSACAG00000015381","1",33661407,33662993,1586
"12332","ENSACAG00000015382","LGb",1771294,1777698,6404
"12333","ENSACAG00000015383","4",110653980,110715499,61519
"12334","ENSACAG00000015384","GL343199.1",3386614,3415394,28780
"12335","ENSACAG00000015385","GL343573.1",24327,75047,50720
"12336","ENSACAG00000015386","2",80791256,80799544,8288
"12337","ENSACAG00000015387","GL343677.1",138405,142646,4241
"12338","ENSACAG00000015388","2",182276214,182312271,36057
"12339","ENSACAG00000015389","2",182067972,182253464,185492
"12340","ENSACAG00000015390","1",33513060,33655519,142459
"12341","ENSACAG00000015391","2",99486276,99509584,23308
"12342","ENSACAG00000015392","GL343677.1",162565,171638,9073
"12343","ENSACAG00000015393","GL343573.1",18802,18958,156
"12344","ENSACAG00000015394","6",21260955,21284149,23194
"12345","ENSACAG00000015395","GL343573.1",4335,17958,13623
"12346","ENSACAG00000015396","GL343973.1",59639,61532,1893
"12347","ENSACAG00000015397","GL343199.1",3295391,3335577,40186
"12348","ENSACAG00000015398","2",76375754,76409162,33408
"12349","ENSACAG00000015399","2",2606877,2612448,5571
"12350","ENSACAG00000015400","5",19168211,19229906,61695
"12351","ENSACAG00000015401","1",33246645,33516390,269745
"12352","ENSACAG00000015402","1",57161665,57258456,96791
"12353","ENSACAG00000015403","GL343199.1",3273104,3284603,11499
"12354","ENSACAG00000015404","2",123697392,123714491,17099
"12355","ENSACAG00000015406","LGb",1782913,1795965,13052
"12356","ENSACAG00000015407","GL343199.1",3190944,3255962,65018
"12357","ENSACAG00000015408","GL343640.1",222232,228677,6445
"12358","ENSACAG00000015409","GL343973.1",62978,65730,2752
"12359","ENSACAG00000015410","4",71400332,71409206,8874
"12360","ENSACAG00000015412","2",2669785,2672644,2859
"12361","ENSACAG00000015413","1",73621062,73658963,37901
"12362","ENSACAG00000015414","AAWZ02037445",13484,15344,1860
"12363","ENSACAG00000015415","2",123601380,123683199,81819
"12364","ENSACAG00000015417","2",2661010,2695587,34577
"12365","ENSACAG00000015418","2",123276969,123335027,58058
"12366","ENSACAG00000015420","GL343198.1",3034380,3059436,25056
"12367","ENSACAG00000015421","LGb",1799187,1799969,782
"12368","ENSACAG00000015422","2",99526110,99618510,92400
"12369","ENSACAG00000015423","LGb",1802113,1804687,2574
"12370","ENSACAG00000015424","GL343640.1",229012,240755,11743
"12371","ENSACAG00000015425","1",149679050,149680015,965
"12372","ENSACAG00000015426","4",71356025,71376290,20265
"12373","ENSACAG00000015427","5",80751125,80752846,1721
"12374","ENSACAG00000015428","GL343460.1",14720,26111,11391
"12375","ENSACAG00000015429","2",123096020,123167987,71967
"12376","ENSACAG00000015430","GL343973.1",75749,78910,3161
"12377","ENSACAG00000015431","5",80804519,80806003,1484
"12378","ENSACAG00000015432","LGb",1812573,1820994,8421
"12379","ENSACAG00000015435","1",116178082,116179273,1191
"12380","ENSACAG00000015436","2",80701312,80781099,79787
"12381","ENSACAG00000015437","GL343973.1",84084,89664,5580
"12382","ENSACAG00000015438","1",116419658,116492139,72481
"12383","ENSACAG00000015439","4",71335453,71355560,20107
"12384","ENSACAG00000015440","AAWZ02035514",4456,15482,11026
"12385","ENSACAG00000015441","LGb",1835711,1859967,24256
"12386","ENSACAG00000015442","GL343199.1",3124975,3140945,15970
"12387","ENSACAG00000015443","GL344717.1",29137,38200,9063
"12388","ENSACAG00000015444","GL343640.1",245101,249189,4088
"12389","ENSACAG00000015445","4",71309331,71337011,27680
"12390","ENSACAG00000015446","GL343198.1",2942947,3012723,69776
"12391","ENSACAG00000015447","5",24039165,24052404,13239
"12392","ENSACAG00000015448","GL343613.1",366642,382281,15639
"12393","ENSACAG00000015451","AAWZ02039323",5359,6227,868
"12394","ENSACAG00000015452","2",2700978,2709873,8895
"12395","ENSACAG00000015453","5",24004687,24020980,16293
"12396","ENSACAG00000015454","GL343640.1",281418,302267,20849
"12397","ENSACAG00000015455","GL343599.1",344613,357716,13103
"12398","ENSACAG00000015456","1",176888687,176906681,17994
"12399","ENSACAG00000015457","GL343198.1",2935178,2943327,8149
"12400","ENSACAG00000015458","GL343198.1",2802348,2934732,132384
"12401","ENSACAG00000015459","1",73557975,73602459,44484
"12402","ENSACAG00000015461","6",21231512,21253271,21759
"12403","ENSACAG00000015462","AAWZ02040702",1329,6591,5262
"12404","ENSACAG00000015463","GL343279.1",481916,486805,4889
"12405","ENSACAG00000015464","AAWZ02040982",689,6106,5417
"12406","ENSACAG00000015465","GL344751.1",17609,20101,2492
"12407","ENSACAG00000015466","GL343992.1",150,48652,48502
"12408","ENSACAG00000015467","GL343279.1",499081,501315,2234
"12409","ENSACAG00000015468","1",116555011,116742807,187796
"12410","ENSACAG00000015469","2",122890995,123077288,186293
"12411","ENSACAG00000015471","GL343279.1",511798,513243,1445
"12412","ENSACAG00000015473","GL343404.1",631397,710596,79199
"12413","ENSACAG00000015475","GL343279.1",541498,542142,644
"12414","ENSACAG00000015476","GL344605.1",2727,3272,545
"12415","ENSACAG00000015478","GL343279.1",544925,545236,311
"12416","ENSACAG00000015479","4",71295801,71310407,14606
"12417","ENSACAG00000015480","GL343279.1",548091,548402,311
"12418","ENSACAG00000015481","GL344621.1",65,7410,7345
"12419","ENSACAG00000015482","GL343279.1",685692,693087,7395
"12420","ENSACAG00000015483","2",2725719,2735203,9484
"12421","ENSACAG00000015484","2",76403415,76415049,11634
"12422","ENSACAG00000015485","GL343231.1",2091745,2147129,55384
"12423","ENSACAG00000015487","5",19151951,19164318,12367
"12424","ENSACAG00000015489","GL343279.1",695345,714243,18898
"12425","ENSACAG00000015491","4",71284129,71304057,19928
"12426","ENSACAG00000015492","5",23890902,23979126,88224
"12427","ENSACAG00000015493","1",39928351,39961233,32882
"12428","ENSACAG00000015495","4",110752388,110859778,107390
"12429","ENSACAG00000015497","2",2766581,2790440,23859
"12430","ENSACAG00000015498","6",21221566,21230229,8663
"12431","ENSACAG00000015499","GL343795.1",201263,216356,15093
"12432","ENSACAG00000015500","GL343202.1",2185221,2187114,1893
"12433","ENSACAG00000015501","2",76458837,76459112,275
"12434","ENSACAG00000015502","GL343202.1",2111202,2143020,31818
"12435","ENSACAG00000015503","2",76427735,76444354,16619
"12436","ENSACAG00000015505","GL343198.1",2745085,2759314,14229
"12437","ENSACAG00000015506","GL343225.1",1890220,1938223,48003
"12438","ENSACAG00000015507","2",99702892,99712077,9185
"12439","ENSACAG00000015508","2",2871710,2890970,19260
"12440","ENSACAG00000015509","1",73484073,73493256,9183
"12441","ENSACAG00000015510","GL344481.1",1160,9423,8263
"12442","ENSACAG00000015513","2",2909694,2910128,434
"12443","ENSACAG00000015514","1",72743452,73299677,556225
"12444","ENSACAG00000015515","GL343290.1",1127532,1169930,42398
"12445","ENSACAG00000015516","6",21135901,21197675,61774
"12446","ENSACAG00000015517","2",3019481,3026399,6918
"12447","ENSACAG00000015518","GL343386.1",938243,968173,29930
"12448","ENSACAG00000015519","1",72568120,72701121,133001
"12449","ENSACAG00000015521","4",71264332,71283000,18668
"12450","ENSACAG00000015522","GL343637.1",129325,145546,16221
"12451","ENSACAG00000015523","2",3184214,3259207,74993
"12452","ENSACAG00000015524","GL343795.1",150290,195699,45409
"12453","ENSACAG00000015526","GL343231.1",2165059,2188335,23276
"12454","ENSACAG00000015527","1",116782961,116837967,55006
"12455","ENSACAG00000015528","5",19117130,19125880,8750
"12456","ENSACAG00000015531","2",139573947,139613670,39723
"12457","ENSACAG00000015532","5",19031585,19095789,64204
"12458","ENSACAG00000015533","1",57036879,57112157,75278
"12459","ENSACAG00000015534","GL343279.1",720273,755498,35225
"12460","ENSACAG00000015535","2",99750863,100048351,297488
"12461","ENSACAG00000015536","GL343231.1",2186895,2234419,47524
"12462","ENSACAG00000015537","2",3285448,3306330,20882
"12463","ENSACAG00000015538","GL343637.1",169203,172408,3205
"12464","ENSACAG00000015539","GL343386.1",999531,1021205,21674
"12465","ENSACAG00000015541","GL343637.1",213186,260028,46842
"12466","ENSACAG00000015542","2",122791444,122879526,88082
"12467","ENSACAG00000015543","3",8668264,8917116,248852
"12468","ENSACAG00000015545","GL343198.1",2694519,2733148,38629
"12469","ENSACAG00000015546","GL344369.1",14614,32587,17973
"12470","ENSACAG00000015547","AAWZ02037271",1150,17210,16060
"12471","ENSACAG00000015548","2",76461810,76468893,7083
"12472","ENSACAG00000015549","5",23869997,23882771,12774
"12473","ENSACAG00000015550","6",21117323,21136660,19337
"12474","ENSACAG00000015551","LGb",1869884,1870888,1004
"12475","ENSACAG00000015554","4",110971164,110971565,401
"12476","ENSACAG00000015556","4",110974064,110995645,21581
"12477","ENSACAG00000015557","3",45432690,45467583,34893
"12478","ENSACAG00000015559","2",76471679,76497179,25500
"12479","ENSACAG00000015560","GL343198.1",2666949,2684662,17713
"12480","ENSACAG00000015561","LGb",1872621,1877443,4822
"12481","ENSACAG00000015562","AAWZ02039971",21,6707,6686
"12482","ENSACAG00000015563","LGb",1877079,1903016,25937
"12483","ENSACAG00000015564","1",225901795,225909180,7385
"12484","ENSACAG00000015565","GL343624.1",275649,363051,87402
"12485","ENSACAG00000015567","4",147746476,147747516,1040
"12486","ENSACAG00000015568","AAWZ02036670",4787,9741,4954
"12487","ENSACAG00000015569","5",18798814,18831826,33012
"12488","ENSACAG00000015570","GL344030.1",9126,86018,76892
"12489","ENSACAG00000015571","5",23856728,23868358,11630
"12490","ENSACAG00000015572","AAWZ02036089",2152,14080,11928
"12491","ENSACAG00000015573","GL343279.1",773335,778735,5400
"12492","ENSACAG00000015576","1",72477252,72510848,33596
"12493","ENSACAG00000015577","GL343829.1",74916,75819,903
"12494","ENSACAG00000015580","4",147672785,147713455,40670
"12495","ENSACAG00000015581","5",129804147,129823839,19692
"12496","ENSACAG00000015583","GL343729.1",241,102116,101875
"12497","ENSACAG00000015584","1",226151641,226152934,1293
"12498","ENSACAG00000015585","GL343835.1",7476,50717,43241
"12499","ENSACAG00000015586","GL343279.1",786081,865857,79776
"12500","ENSACAG00000015587","GL343739.1",26300,169037,142737
"12501","ENSACAG00000015588","GL343216.1",939292,964473,25181
"12502","ENSACAG00000015589","AAWZ02036670",16766,23809,7043
"12503","ENSACAG00000015590","2",80672339,80685874,13535
"12504","ENSACAG00000015591","2",76547511,76562658,15147
"12505","ENSACAG00000015592","AAWZ02038269",4539,12140,7601
"12506","ENSACAG00000015593","1",50711129,50797237,86108
"12507","ENSACAG00000015594","GL344076.1",74115,84434,10319
"12508","ENSACAG00000015595","5",129923776,129924927,1151
"12509","ENSACAG00000015596","2",122773833,122778627,4794
"12510","ENSACAG00000015598","5",92782560,93049234,266674
"12511","ENSACAG00000015599","5",130107871,130124478,16607
"12512","ENSACAG00000015600","GL343202.1",2094155,2107621,13466
"12513","ENSACAG00000015601","AAWZ02036089",17778,22115,4337
"12514","ENSACAG00000015602","1",226221712,226277061,55349
"12515","ENSACAG00000015604","2",76570031,76573317,3286
"12516","ENSACAG00000015605","GL344913.1",1481,15843,14362
"12517","ENSACAG00000015606","GL345096.1",3019,11417,8398
"12518","ENSACAG00000015607","4",147401359,147431805,30446
"12519","ENSACAG00000015608","1",130190167,130210433,20266
"12520","ENSACAG00000015609","GL344481.1",11179,11601,422
"12521","ENSACAG00000015610","5",130142216,130157238,15022
"12522","ENSACAG00000015611","LGb",1909930,2010003,100073
"12523","ENSACAG00000015612","GL344481.1",13316,19775,6459
"12524","ENSACAG00000015613","GL343829.1",48334,49959,1625
"12525","ENSACAG00000015614","GL343829.1",14562,40109,25547
"12526","ENSACAG00000015615","4",147392228,147401271,9043
"12527","ENSACAG00000015617","5",130240041,130249250,9209
"12528","ENSACAG00000015618","1",226347749,226424903,77154
"12529","ENSACAG00000015619","AAWZ02036089",26898,31814,4916
"12530","ENSACAG00000015620","3",8521985,8599306,77321
"12531","ENSACAG00000015621","1",226435334,226451391,16057
"12532","ENSACAG00000015622","2",122758005,122766591,8586
"12533","ENSACAG00000015623","GL343729.1",116369,178014,61645
"12534","ENSACAG00000015624","2",100252067,100258634,6567
"12535","ENSACAG00000015625","1",56900615,56909724,9109
"12536","ENSACAG00000015626","1",130273606,130288348,14742
"12537","ENSACAG00000015627","2",76603905,76611629,7724
"12538","ENSACAG00000015629","4",76789872,76792178,2306
"12539","ENSACAG00000015630","2",80622556,80623674,1118
"12540","ENSACAG00000015631","1",226451768,226481818,30050
"12541","ENSACAG00000015632","2",80587883,80620246,32363
"12542","ENSACAG00000015633","4",76771552,76773990,2438
"12543","ENSACAG00000015634","1",56593869,56885594,291725
"12544","ENSACAG00000015635","GL343791.1",18124,227388,209264
"12545","ENSACAG00000015636","GL343279.1",868033,877989,9956
"12546","ENSACAG00000015637","1",116842931,116943930,100999
"12547","ENSACAG00000015639","AAWZ02037440",7705,13217,5512
"12548","ENSACAG00000015640","AAWZ02039319",505,8836,8331
"12549","ENSACAG00000015641","GL343216.1",864164,890494,26330
"12550","ENSACAG00000015642","GL343216.1",803105,814120,11015
"12551","ENSACAG00000015643","5",23833652,23839057,5405
"12552","ENSACAG00000015644","2",122749366,122754558,5192
"12553","ENSACAG00000015645","2",100346863,100358663,11800
"12554","ENSACAG00000015646","6",21106998,21112688,5690
"12555","ENSACAG00000015647","5",84459143,84511978,52835
"12556","ENSACAG00000015648","GL343637.1",259326,280545,21219
"12557","ENSACAG00000015649","1",39873335,39922241,48906
"12558","ENSACAG00000015652","GL343198.1",2591245,2598398,7153
"12559","ENSACAG00000015653","2",100362209,100436514,74305
"12560","ENSACAG00000015654","4",111016468,111053580,37112
"12561","ENSACAG00000015655","GL344481.1",26807,30844,4037
"12562","ENSACAG00000015656","4",147360605,147370301,9696
"12563","ENSACAG00000015657","2",76775728,76825228,49500
"12564","ENSACAG00000015658","2",76840180,76846815,6635
"12565","ENSACAG00000015659","2",122538154,122589927,51773
"12566","ENSACAG00000015660","6",21082402,21100434,18032
"12567","ENSACAG00000015661","2",139621414,139651876,30462
"12568","ENSACAG00000015662","GL343216.1",747774,800470,52696
"12569","ENSACAG00000015663","GL343835.1",64640,77898,13258
"12570","ENSACAG00000015665","GL343202.1",2091247,2092257,1010
"12571","ENSACAG00000015666","5",23763434,23795822,32388
"12572","ENSACAG00000015667","GL343279.1",887480,909720,22240
"12573","ENSACAG00000015668","4",147199672,147279102,79430
"12574","ENSACAG00000015669","GL343202.1",2074077,2085230,11153
"12575","ENSACAG00000015670","2",10517409,10628193,110784
"12576","ENSACAG00000015671","2",76871750,76937315,65565
"12577","ENSACAG00000015672","GL344822.1",5414,19916,14502
"12578","ENSACAG00000015673","5",130255918,130266090,10172
"12579","ENSACAG00000015674","5",130267188,130279641,12453
"12580","ENSACAG00000015675","1",50689845,50709178,19333
"12581","ENSACAG00000015676","LGb",1986348,2021336,34988
"12582","ENSACAG00000015679","4",147065875,147143448,77573
"12583","ENSACAG00000015680","2",100440501,100496256,55755
"12584","ENSACAG00000015681","GL343279.1",921436,941183,19747
"12585","ENSACAG00000015683","5",84523832,84548514,24682
"12586","ENSACAG00000015684","2",100529837,100550811,20974
"12587","ENSACAG00000015685","1",39852054,39868936,16882
"12588","ENSACAG00000015687","LGb",2025809,2030961,5152
"12589","ENSACAG00000015688","GL343314.1",667873,723706,55833
"12590","ENSACAG00000015689","5",86007792,86216472,208680
"12591","ENSACAG00000015690","3",8292589,8294085,1496
"12592","ENSACAG00000015692","3",8001296,8005919,4623
"12593","ENSACAG00000015693","GL343202.1",2023560,2024420,860
"12594","ENSACAG00000015694","5",18750394,18793310,42916
"12595","ENSACAG00000015695","GL343198.1",2468531,2479251,10720
"12596","ENSACAG00000015697","4",111055199,111061900,6701
"12597","ENSACAG00000015699","3",7986430,7992875,6445
"12598","ENSACAG00000015700","GL344076.1",3888,8189,4301
"12599","ENSACAG00000015701","LGb",2037808,2053612,15804
"12600","ENSACAG00000015702","GL343506.1",1588,7895,6307
"12601","ENSACAG00000015703","5",130297741,130395026,97285
"12602","ENSACAG00000015705","GL343202.1",1822580,1837760,15180
"12603","ENSACAG00000015706","2",189054867,189090482,35615
"12604","ENSACAG00000015707","2",122434674,122500942,66268
"12605","ENSACAG00000015708","GL343637.1",289026,317879,28853
"12606","ENSACAG00000015709","2",100552938,100564219,11281
"12607","ENSACAG00000015710","4",111070414,111086106,15692
"12608","ENSACAG00000015711","GL343279.1",944795,955056,10261
"12609","ENSACAG00000015712","GL343739.1",54024,70590,16566
"12610","ENSACAG00000015714","GL343829.1",691,8119,7428
"12611","ENSACAG00000015715","5",23734692,23752177,17485
"12612","ENSACAG00000015716","1",130846527,130884848,38321
"12613","ENSACAG00000015717","6",20976052,21082355,106303
"12614","ENSACAG00000015718","5",84870594,84925283,54689
"12615","ENSACAG00000015720","GL343835.1",85152,90372,5220
"12616","ENSACAG00000015721","4",121155843,121161266,5423
"12617","ENSACAG00000015722","1",1079588,1327255,247667
"12618","ENSACAG00000015723","2",76943135,76982308,39173
"12619","ENSACAG00000015724","GL343506.1",18129,19012,883
"12620","ENSACAG00000015725","3",7970405,7981225,10820
"12621","ENSACAG00000015726","2",80492630,80563954,71324
"12622","ENSACAG00000015727","GL343506.1",29023,33655,4632
"12623","ENSACAG00000015728","1",39839252,39846092,6840
"12624","ENSACAG00000015729","5",18708372,18740392,32020
"12625","ENSACAG00000015730","5",84941827,84966554,24727
"12626","ENSACAG00000015731","GL343739.1",74870,88672,13802
"12627","ENSACAG00000015732","4",111109534,111110154,620
"12628","ENSACAG00000015733","4",111112425,111119965,7540
"12629","ENSACAG00000015735","GL343279.1",995519,1007431,11912
"12630","ENSACAG00000015736","3",56059120,56089352,30232
"12631","ENSACAG00000015737","2",122167164,122302129,134965
"12632","ENSACAG00000015738","GL343314.1",275643,276311,668
"12633","ENSACAG00000015739","GL343314.1",170059,174305,4246
"12634","ENSACAG00000015740","5",130384835,130591573,206738
"12635","ENSACAG00000015741","GL344009.1",9426,16499,7073
"12636","ENSACAG00000015742","4",121169039,121215689,46650
"12637","ENSACAG00000015743","1",56145662,56165183,19521
"12638","ENSACAG00000015744","1",39826857,39838242,11385
"12639","ENSACAG00000015745","2",100559158,100582101,22943
"12640","ENSACAG00000015746","3",45520434,45674840,154406
"12641","ENSACAG00000015747","1",1220972,1229641,8669
"12642","ENSACAG00000015748","5",130781876,130796913,15037
"12643","ENSACAG00000015749","GL343506.1",80034,127533,47499
"12644","ENSACAG00000015750","3",7946560,7957233,10673
"12645","ENSACAG00000015751","1",24007826,24046760,38934
"12646","ENSACAG00000015752","2",76994346,77012107,17761
"12647","ENSACAG00000015753","GL343202.1",1812536,1817035,4499
"12648","ENSACAG00000015755","GL344023.1",59279,87422,28143
"12649","ENSACAG00000015757","4",111136707,111156279,19572
"12650","ENSACAG00000015759","2",10664231,10685976,21745
"12651","ENSACAG00000015760","2",122090526,122112120,21594
"12652","ENSACAG00000015761","3",45698966,45731503,32537
"12653","ENSACAG00000015762","LGb",2057694,2069277,11583
"12654","ENSACAG00000015763","4",146953371,147030925,77554
"12655","ENSACAG00000015764","2",121764217,122004739,240522
"12656","ENSACAG00000015765","4",111167444,111372399,204955
"12657","ENSACAG00000015766","GL343202.1",1804475,1809245,4770
"12658","ENSACAG00000015767","3",7930258,7947055,16797
"12659","ENSACAG00000015768","1",39700213,39803463,103250
"12660","ENSACAG00000015769","1",56116552,56140945,24393
"12661","ENSACAG00000015770","4",121296072,121340577,44505
"12662","ENSACAG00000015772","2",10681307,10698041,16734
"12663","ENSACAG00000015774","1",1380946,1382853,1907
"12664","ENSACAG00000015775","5",93086123,93178186,92063
"12665","ENSACAG00000015777","6",20958382,20959572,1190
"12666","ENSACAG00000015778","GL343198.1",2342813,2389198,46385
"12667","ENSACAG00000015779","6",20755209,20757079,1870
"12668","ENSACAG00000015780","2",139690876,139692033,1157
"12669","ENSACAG00000015781","3",7890589,7908420,17831
"12670","ENSACAG00000015782","1",1397145,1399271,2126
"12671","ENSACAG00000015785","6",20475429,20677169,201740
"12672","ENSACAG00000015787","2",139794976,139814132,19156
"12673","ENSACAG00000015788","LGb",2079168,2118677,39509
"12674","ENSACAG00000015789","1",1413304,1423423,10119
"12675","ENSACAG00000015790","5",130992603,131027274,34671
"12676","ENSACAG00000015791","1",32911195,33050382,139187
"12677","ENSACAG00000015792","2",139845484,139958547,113063
"12678","ENSACAG00000015793","2",100596073,100619591,23518
"12679","ENSACAG00000015794","3",7851801,7866557,14756
"12680","ENSACAG00000015796","1",1442405,1443865,1460
"12681","ENSACAG00000015798","GL343198.1",2210421,2223850,13429
"12682","ENSACAG00000015799","GL344009.1",23067,31870,8803
"12683","ENSACAG00000015800","1",1471047,1557802,86755
"12684","ENSACAG00000015801","4",121345168,121400619,55451
"12685","ENSACAG00000015802","GL343314.1",29790,146017,116227
"12686","ENSACAG00000015804","GL343739.1",136184,168794,32610
"12687","ENSACAG00000015805","2",77013177,77075953,62776
"12688","ENSACAG00000015807","1",39652578,39696210,43632
"12689","ENSACAG00000015808","5",86455812,86708147,252335
"12690","ENSACAG00000015809","2",121727701,121755670,27969
"12691","ENSACAG00000015810","GL343202.1",1785679,1800415,14736
"12692","ENSACAG00000015811","GL343202.1",1745141,1781805,36664
"12693","ENSACAG00000015812","GL343202.1",1706299,1712383,6084
"12694","ENSACAG00000015813","3",45733703,45735226,1523
"12695","ENSACAG00000015814","1",1646467,1679450,32983
"12696","ENSACAG00000015815","3",45794078,45821837,27759
"12697","ENSACAG00000015816","1",39570871,39637451,66580
"12698","ENSACAG00000015817","2",10704893,10726538,21645
"12699","ENSACAG00000015818","1",130969316,131008059,38743
"12700","ENSACAG00000015819","5",23639122,23650610,11488
"12701","ENSACAG00000015820","GL343428.1",490966,509914,18948
"12702","ENSACAG00000015821","GL343279.1",1013841,1031491,17650
"12703","ENSACAG00000015823","3",7785848,7786885,1037
"12704","ENSACAG00000015824","5",23490064,23551465,61401
"12705","ENSACAG00000015825","3",7700903,7776389,75486
"12706","ENSACAG00000015826","1",56029782,56055067,25285
"12707","ENSACAG00000015827","4",146807129,146853188,46059
"12708","ENSACAG00000015828","GL343216.1",671284,723719,52435
"12709","ENSACAG00000015829","5",85399532,85613240,213708
"12710","ENSACAG00000015830","GL343353.1",52892,109664,56772
"12711","ENSACAG00000015831","5",85724813,85767164,42351
"12712","ENSACAG00000015832","GL343202.1",1696694,1705150,8456
"12713","ENSACAG00000015833","1",32878860,32879405,545
"12714","ENSACAG00000015834","2",121708604,121708720,116
"12715","ENSACAG00000015836","2",121555267,121603327,48060
"12716","ENSACAG00000015837","1",32823194,32856163,32969
"12717","ENSACAG00000015838","2",10727040,10754469,27429
"12718","ENSACAG00000015840","1",23990958,24005347,14389
"12719","ENSACAG00000015841","2",121523970,121540456,16486
"12720","ENSACAG00000015842","1",39531216,39537775,6559
"12721","ENSACAG00000015843","2",152315794,152368572,52778
"12722","ENSACAG00000015844","5",86721922,86753243,31321
"12723","ENSACAG00000015847","1",55991771,56017056,25285
"12724","ENSACAG00000015849","6",20418996,20419733,737
"12725","ENSACAG00000015851","GL344009.1",58670,62240,3570
"12726","ENSACAG00000015852","1",39451385,39522232,70847
"12727","ENSACAG00000015853","3",45883473,45884828,1355
"12728","ENSACAG00000015854","6",20395606,20408088,12482
"12729","ENSACAG00000015855","GL344724.1",1098,20783,19685
"12730","ENSACAG00000015856","4",111456407,111502112,45705
"12731","ENSACAG00000015857","GL343279.1",1042027,1050181,8154
"12732","ENSACAG00000015858","GL343279.1",1053114,1093318,40204
"12733","ENSACAG00000015860","GL343216.1",586186,640321,54135
"12734","ENSACAG00000015861","GL344009.1",61964,80941,18977
"12735","ENSACAG00000015862","1",26219874,26229400,9526
"12736","ENSACAG00000015863","5",18630471,18667765,37294
"12737","ENSACAG00000015864","1",32797779,32815043,17264
"12738","ENSACAG00000015868","3",47541495,47842610,301115
"12739","ENSACAG00000015869","1",131017717,131036870,19153
"12740","ENSACAG00000015870","2",80427862,80467527,39665
"12741","ENSACAG00000015871","6",20335968,20363960,27992
"12742","ENSACAG00000015872","1",23975346,23987490,12144
"12743","ENSACAG00000015873","2",10761255,10775476,14221
"12744","ENSACAG00000015875","3",7731747,7734140,2393
"12745","ENSACAG00000015876","1",32678576,32713448,34872
"12746","ENSACAG00000015877","GL343353.1",116882,137540,20658
"12747","ENSACAG00000015878","GL343506.1",127090,140083,12993
"12748","ENSACAG00000015879","5",23454225,23468687,14462
"12749","ENSACAG00000015880","5",86755491,86774618,19127
"12750","ENSACAG00000015881","4",146785839,146787137,1298
"12751","ENSACAG00000015883","2",152201449,152314983,113534
"12752","ENSACAG00000015885","GL344108.1",1304,10968,9664
"12753","ENSACAG00000015886","4",121432260,121441380,9120
"12754","ENSACAG00000015888","4",20473553,20503118,29565
"12755","ENSACAG00000015889","5",85853586,85880819,27233
"12756","ENSACAG00000015890","1",23963820,23974564,10744
"12757","ENSACAG00000015892","4",146455902,146466690,10788
"12758","ENSACAG00000015893","1",26261634,26284288,22654
"12759","ENSACAG00000015894","1",23947471,23959557,12086
"12760","ENSACAG00000015895","6",20313651,20327945,14294
"12761","ENSACAG00000015896","GL343279.1",1150330,1167144,16814
"12762","ENSACAG00000015897","5",86777850,86785537,7687
"12763","ENSACAG00000015899","GL343506.1",157358,184607,27249
"12764","ENSACAG00000015900","1",1691904,1998805,306901
"12765","ENSACAG00000015901","5",93278219,93296066,17847
"12766","ENSACAG00000015903","GL343428.1",561819,567562,5743
"12767","ENSACAG00000015904","5",86822068,86845136,23068
"12768","ENSACAG00000015905","2",121501643,121502710,1067
"12769","ENSACAG00000015906","3",7636896,7694656,57760
"12770","ENSACAG00000015908","2",120933335,120934190,855
"12771","ENSACAG00000015909","4",146412016,146455224,43208
"12772","ENSACAG00000015910","4",121529454,121563662,34208
"12773","ENSACAG00000015911","5",131115140,131146632,31492
"12774","ENSACAG00000015912","5",18382200,18612086,229886
"12775","ENSACAG00000015913","2",10784892,10817821,32929
"12776","ENSACAG00000015915","6",20282895,20303132,20237
"12777","ENSACAG00000015916","GL343506.1",235905,253476,17571
"12778","ENSACAG00000015917","1",32652698,32665655,12957
"12779","ENSACAG00000015920","5",23148232,23150646,2414
"12780","ENSACAG00000015921","1",117149487,117176114,26627
"12781","ENSACAG00000015922","5",22902612,22942136,39524
"12782","ENSACAG00000015923","GL343195.1",7484452,7879096,394644
"12783","ENSACAG00000015924","GL343429.1",777239,787370,10131
"12784","ENSACAG00000015925","5",18307727,18363691,55964
"12785","ENSACAG00000015926","GL343739.1",174552,192022,17470
"12786","ENSACAG00000015927","6",20033053,20063295,30242
"12787","ENSACAG00000015928","5",86908099,86925602,17503
"12788","ENSACAG00000015930","2",120665280,120707798,42518
"12789","ENSACAG00000015931","1",117198570,117247629,49059
"12790","ENSACAG00000015932","6",19607672,19618528,10856
"12791","ENSACAG00000015933","1",55921632,55954432,32800
"12792","ENSACAG00000015934","5",131155338,131215519,60181
"12793","ENSACAG00000015935","1",32543214,32606759,63545
"12794","ENSACAG00000015936","GL343428.1",774975,838032,63057
"12795","ENSACAG00000015937","1",117305024,117333652,28628
"12796","ENSACAG00000015938","1",117362606,117367373,4767
"12797","ENSACAG00000015939","1",117397546,117547152,149606
"12798","ENSACAG00000015941","GL343217.1",2382025,2410836,28811
"12799","ENSACAG00000015942","GL343216.1",508833,521176,12343
"12800","ENSACAG00000015943","GL343353.1",149469,212940,63471
"12801","ENSACAG00000015944","GL343279.1",1170051,1175530,5479
"12802","ENSACAG00000015945","GL343279.1",1293779,1296637,2858
"12803","ENSACAG00000015947","1",39417156,39445131,27975
"12804","ENSACAG00000015948","GL344108.1",34952,47091,12139
"12805","ENSACAG00000015949","GL344317.1",4050,13772,9722
"12806","ENSACAG00000015950","2",120523068,120525295,2227
"12807","ENSACAG00000015951","4",146378121,146405806,27685
"12808","ENSACAG00000015952","4",120008298,120022138,13840
"12809","ENSACAG00000015953","4",121782319,122140988,358669
"12810","ENSACAG00000015954","1",23887867,23944107,56240
"12811","ENSACAG00000015955","2",80414391,80420306,5915
"12812","ENSACAG00000015957","2",100625477,100646935,21458
"12813","ENSACAG00000015958","GL343216.1",466445,496797,30352
"12814","ENSACAG00000015959","5",85884549,85917398,32849
"12815","ENSACAG00000015960","4",20513100,20570208,57108
"12816","ENSACAG00000015961","GL343899.1",99372,120271,20899
"12817","ENSACAG00000015962","GL343899.1",126514,151438,24924
"12818","ENSACAG00000015963","GL343217.1",2171326,2172213,887
"12819","ENSACAG00000015965","GL343217.1",2084683,2089494,4811
"12820","ENSACAG00000015966","2",80376085,80393219,17134
"12821","ENSACAG00000015967","2",139983859,140046307,62448
"12822","ENSACAG00000015968","GL343217.1",2066971,2081521,14550
"12823","ENSACAG00000015969","AAWZ02040620",216,5509,5293
"12824","ENSACAG00000015970","GL343279.1",1304214,1322528,18314
"12825","ENSACAG00000015971","1",39375235,39414718,39483
"12826","ENSACAG00000015972","1",26601806,26737243,135437
"12827","ENSACAG00000015976","GL344607.1",10903,25384,14481
"12828","ENSACAG00000015977","GL344108.1",45549,51393,5844
"12829","ENSACAG00000015978","5",131352434,131411240,58806
"12830","ENSACAG00000015979","AAWZ02041292",21,5839,5818
"12831","ENSACAG00000015980","GL343279.1",1340204,1347131,6927
"12832","ENSACAG00000015982","GL344108.1",48247,55248,7001
"12833","ENSACAG00000015983","GL344009.1",101768,105773,4005
"12834","ENSACAG00000015984","2",100657888,100658346,458
"12835","ENSACAG00000015985","2",100679494,100726963,47469
"12836","ENSACAG00000015986","1",131713563,131816823,103260
"12837","ENSACAG00000015987","GL343279.1",1369085,1381463,12378
"12838","ENSACAG00000015988","6",70410921,70423920,12999
"12839","ENSACAG00000015989","AAWZ02039278",3748,8962,5214
"12840","ENSACAG00000015990","6",19428953,19574920,145967
"12841","ENSACAG00000015992","GL343506.1",257271,275837,18566
"12842","ENSACAG00000015993","2",80345124,80362833,17709
"12843","ENSACAG00000015994","5",131436020,131491813,55793
"12844","ENSACAG00000015995","4",106714598,106716169,1571
"12845","ENSACAG00000015996","3",47883498,47922862,39364
"12846","ENSACAG00000015997","GL343217.1",2047399,2065773,18374
"12847","ENSACAG00000015998","GL343824.1",42556,68292,25736
"12848","ENSACAG00000015999","GL344710.1",3910,21965,18055
"12849","ENSACAG00000016000","2",140080127,140119273,39146
"12850","ENSACAG00000016001","1",55295806,55312819,17013
"12851","ENSACAG00000016002","4",20579900,20650449,70549
"12852","ENSACAG00000016003","GL344108.1",61497,71478,9981
"12853","ENSACAG00000016004","GL344514.1",24138,30430,6292
"12854","ENSACAG00000016005","GL343279.1",1385129,1399145,14016
"12855","ENSACAG00000016006","AAWZ02040171",3096,4635,1539
"12856","ENSACAG00000016007","GL344108.1",71013,74914,3901
"12857","ENSACAG00000016008","1",2115917,2139382,23465
"12858","ENSACAG00000016009","AAWZ02039614",2343,8223,5880
"12859","ENSACAG00000016010","GL343216.1",130853,193356,62503
"12860","ENSACAG00000016011","GL343279.1",1415278,1428822,13544
"12861","ENSACAG00000016012","LGb",2136997,2142606,5609
"12862","ENSACAG00000016013","1",117570092,117588649,18557
"12863","ENSACAG00000016014","2",100834406,100843377,8971
"12864","ENSACAG00000016015","2",10932915,11013904,80989
"12865","ENSACAG00000016016","LGb",2143169,2147644,4475
"12866","ENSACAG00000016017","GL343195.1",6125640,6460451,334811
"12867","ENSACAG00000016018","3",7585446,7615366,29920
"12868","ENSACAG00000016019","4",146311211,146369672,58461
"12869","ENSACAG00000016020","GL343217.1",1968591,1993912,25321
"12870","ENSACAG00000016022","GL343279.1",1479429,1503770,24341
"12871","ENSACAG00000016023","5",18257248,18273485,16237
"12872","ENSACAG00000016025","1",39259975,39292914,32939
"12873","ENSACAG00000016026","GL344514.1",7150,23574,16424
"12874","ENSACAG00000016027","GL343217.1",1886762,1963347,76585
"12875","ENSACAG00000016030","1",117588153,117599760,11607
"12876","ENSACAG00000016031","2",193923294,193928746,5452
"12877","ENSACAG00000016032","1",2185321,2186469,1148
"12878","ENSACAG00000016034","GL343279.1",1534812,1536114,1302
"12879","ENSACAG00000016035","5",93360700,93387609,26909
"12880","ENSACAG00000016037","1",2232043,2317747,85704
"12881","ENSACAG00000016038","2",100943913,100949831,5918
"12882","ENSACAG00000016039","1",55265649,55270953,5304
"12883","ENSACAG00000016040","LGb",2148701,2154261,5560
"12884","ENSACAG00000016041","5",86931948,86976919,44971
"12885","ENSACAG00000016042","5",22871006,22888857,17851
"12886","ENSACAG00000016043","1",117651476,117726934,75458
"12887","ENSACAG00000016044","4",122291522,122293609,2087
"12888","ENSACAG00000016045","GL343279.1",1538266,1541399,3133
"12889","ENSACAG00000016046","3",7550342,7570209,19867
"12890","ENSACAG00000016047","4",20652134,20655026,2892
"12891","ENSACAG00000016048","1",39229405,39244102,14697
"12892","ENSACAG00000016050","2",100970557,100980317,9760
"12893","ENSACAG00000016051","5",18230240,18249537,19297
"12894","ENSACAG00000016052","1",27434011,27435459,1448
"12895","ENSACAG00000016054","GL343662.1",284742,298701,13959
"12896","ENSACAG00000016055","1",55245621,55255597,9976
"12897","ENSACAG00000016056","3",7472227,7532505,60278
"12898","ENSACAG00000016057","4",20683734,20687723,3989
"12899","ENSACAG00000016058","2",80239345,80240472,1127
"12900","ENSACAG00000016059","GL344514.1",980,4661,3681
"12901","ENSACAG00000016060","6",70359764,70386239,26475
"12902","ENSACAG00000016061","GL343279.1",1542269,1554736,12467
"12903","ENSACAG00000016062","LGb",2155741,2173913,18172
"12904","ENSACAG00000016063","GL344442.1",16239,16952,713
"12905","ENSACAG00000016064","2",80210202,80223319,13117
"12906","ENSACAG00000016066","3",96689658,96690599,941
"12907","ENSACAG00000016067","6",70322676,70352551,29875
"12908","ENSACAG00000016068","GL344167.1",27430,41103,13673
"12909","ENSACAG00000016070","1",55189348,55203114,13766
"12910","ENSACAG00000016072","4",150677372,150699512,22140
"12911","ENSACAG00000016073","3",7381107,7386009,4902
"12912","ENSACAG00000016075","3",131560407,131567992,7585
"12913","ENSACAG00000016076","GL343217.1",1911232,1916259,5027
"12914","ENSACAG00000016077","1",39211695,39218982,7287
"12915","ENSACAG00000016078","3",130977533,131023502,45969
"12916","ENSACAG00000016079","2",140123013,140130094,7081
"12917","ENSACAG00000016080","2",140132967,140144553,11586
"12918","ENSACAG00000016081","1",54886786,54968111,81325
"12919","ENSACAG00000016083","4",20701662,20720412,18750
"12920","ENSACAG00000016084","3",7367658,7376575,8917
"12921","ENSACAG00000016085","GL343279.1",1557111,1585550,28439
"12922","ENSACAG00000016086","1",117732672,117740816,8144
"12923","ENSACAG00000016087","4",150639597,150668520,28923
"12924","ENSACAG00000016088","6",19412017,19424287,12270
"12925","ENSACAG00000016089","GL343217.1",1784253,1820789,36536
"12926","ENSACAG00000016090","5",87012982,87014061,1079
"12927","ENSACAG00000016093","2",101543775,101619953,76178
"12928","ENSACAG00000016094","2",120262059,120341633,79574
"12929","ENSACAG00000016095","5",18205420,18221806,16386
"12930","ENSACAG00000016096","2",80126935,80188054,61119
"12931","ENSACAG00000016097","5",87019845,87045720,25875
"12932","ENSACAG00000016098","2",120131201,120505507,374306
"12933","ENSACAG00000016099","5",87045941,87377215,331274
"12934","ENSACAG00000016101","1",23855650,23877893,22243
"12935","ENSACAG00000016102","1",39183550,39202164,18614
"12936","ENSACAG00000016103","3",7331737,7348734,16997
"12937","ENSACAG00000016104","5",22844936,22846168,1232
"12938","ENSACAG00000016106","LGb",2169271,2203709,34438
"12939","ENSACAG00000016107","AAWZ02041189",1395,5976,4581
"12940","ENSACAG00000016108","5",22810719,22820350,9631
"12941","ENSACAG00000016109","AAWZ02038123",6144,6803,659
"12942","ENSACAG00000016110","GL344012.1",24819,47881,23062
"12943","ENSACAG00000016111","1",23822066,23834763,12697
"12944","ENSACAG00000016113","2",80104375,80116126,11751
"12945","ENSACAG00000016114","5",22752570,22783364,30794
"12946","ENSACAG00000016115","6",19355201,19392126,36925
"12947","ENSACAG00000016116","AAWZ02040995",2096,4354,2258
"12948","ENSACAG00000016117","2",111246902,111347749,100847
"12949","ENSACAG00000016119","5",22716361,22751740,35379
"12950","ENSACAG00000016121","2",140171727,140278159,106432
"12951","ENSACAG00000016123","1",39077910,39113045,35135
"12952","ENSACAG00000016124","6",70284520,70301000,16480
"12953","ENSACAG00000016126","GL343317.1",1030579,1129453,98874
"12954","ENSACAG00000016127","GL343222.1",1505169,1812400,307231
"12955","ENSACAG00000016128","3",97068034,97124879,56845
"12956","ENSACAG00000016130","GL343279.1",1588365,1592107,3742
"12957","ENSACAG00000016132","6",70223876,70246257,22381
"12958","ENSACAG00000016133","GL343217.1",1297771,1393200,95429
"12959","ENSACAG00000016134","2",80009816,80080598,70782
"12960","ENSACAG00000016135","GL344285.1",35,16065,16030
"12961","ENSACAG00000016136","GL344012.1",50317,58063,7746
"12962","ENSACAG00000016138","GL343385.1",11352,83831,72479
"12963","ENSACAG00000016139","5",55975063,56163649,188586
"12964","ENSACAG00000016140","4",122930245,122944057,13812
"12965","ENSACAG00000016141","GL343497.1",219587,265959,46372
"12966","ENSACAG00000016142","4",20736752,20782235,45483
"12967","ENSACAG00000016143","GL343279.1",1594388,1615874,21486
"12968","ENSACAG00000016144","1",2336622,2340915,4293
"12969","ENSACAG00000016145","2",110976645,111026976,50331
"12970","ENSACAG00000016146","1",2355840,2449913,94073
"12971","ENSACAG00000016147","4",122995200,123025291,30091
"12972","ENSACAG00000016148","5",18190817,18205856,15039
"12973","ENSACAG00000016149","GL343197.1",3415236,3583977,168741
"12974","ENSACAG00000016150","LGc",363118,428314,65196
"12975","ENSACAG00000016151","4",20882192,20883625,1433
"12976","ENSACAG00000016153","3",7022662,7308934,286272
"12977","ENSACAG00000016155","4",20900284,21053699,153415
"12978","ENSACAG00000016156","1",39003344,39071636,68292
"12979","ENSACAG00000016157","1",23798291,23810661,12370
"12980","ENSACAG00000016158","4",150627910,150638162,10252
"12981","ENSACAG00000016159","GL344440.1",1458,18055,16597
"12982","ENSACAG00000016160","6",70118817,70172771,53954
"12983","ENSACAG00000016161","1",2566021,2796690,230669
"12984","ENSACAG00000016162","4",146043704,146277965,234261
"12985","ENSACAG00000016163","4",123042437,123184648,142211
"12986","ENSACAG00000016164","1",23781176,23798424,17248
"12987","ENSACAG00000016165","5",87499162,87709704,210542
"12988","ENSACAG00000016166","5",22693847,22708995,15148
"12989","ENSACAG00000016167","6",19282685,19336701,54016
"12990","ENSACAG00000016168","GL343353.1",369117,377088,7971
"12991","ENSACAG00000016169","2",101627626,101642607,14981
"12992","ENSACAG00000016170","3",97483026,97513629,30603
"12993","ENSACAG00000016171","GL344685.1",12103,15590,3487
"12994","ENSACAG00000016173","GL344285.1",41627,54316,12689
"12995","ENSACAG00000016174","GL343279.1",1617918,1631496,13578
"12996","ENSACAG00000016175","GL343353.1",411831,416517,4686
"12997","ENSACAG00000016176","1",38936864,38967567,30703
"12998","ENSACAG00000016178","1",2991405,2991725,320
"12999","ENSACAG00000016179","1",3041311,3160665,119354
"13000","ENSACAG00000016180","AAWZ02037188",3405,18367,14962
"13001","ENSACAG00000016181","GL343195.1",4462353,4611415,149062
"13002","ENSACAG00000016182","GL343197.1",3831135,3845558,14423
"13003","ENSACAG00000016184","GL344282.1",12583,35160,22577
"13004","ENSACAG00000016185","3",97540490,97541614,1124
"13005","ENSACAG00000016186","GL343353.1",472542,496225,23683
"13006","ENSACAG00000016187","5",18178248,18186547,8299
"13007","ENSACAG00000016188","5",22685950,22692115,6165
"13008","ENSACAG00000016189","GL343279.1",1639877,1650957,11080
"13009","ENSACAG00000016190","5",18171869,18181959,10090
"13010","ENSACAG00000016191","1",3165631,3179050,13419
"13011","ENSACAG00000016192","5",22665627,22676373,10746
"13012","ENSACAG00000016193","GL343279.1",1651022,1661092,10070
"13013","ENSACAG00000016194","GL343353.1",572578,609699,37121
"13014","ENSACAG00000016195","4",150596932,150624233,27301
"13015","ENSACAG00000016196","2",110918759,110919385,626
"13016","ENSACAG00000016197","GL343217.1",1189864,1210621,20757
"13017","ENSACAG00000016198","2",110769568,110893206,123638
"13018","ENSACAG00000016199","GL343197.1",3996964,4121353,124389
"13019","ENSACAG00000016201","4",31577860,31677473,99613
"13020","ENSACAG00000016202","3",98046582,98070355,23773
"13021","ENSACAG00000016203","GL344735.1",1385,15034,13649
"13022","ENSACAG00000016205","1",3182652,3208207,25555
"13023","ENSACAG00000016206","2",11186512,11467206,280694
"13024","ENSACAG00000016208","5",22624398,22652867,28469
"13025","ENSACAG00000016209","GL343222.1",1950930,1952159,1229
"13026","ENSACAG00000016211","2",140297548,140307022,9474
"13027","ENSACAG00000016212","2",120099637,120126544,26907
"13028","ENSACAG00000016213","5",22600166,22615630,15464
"13029","ENSACAG00000016214","4",150442267,150548065,105798
"13030","ENSACAG00000016215","2",101703716,101716238,12522
"13031","ENSACAG00000016217","2",101738132,101774039,35907
"13032","ENSACAG00000016218","LGb",2227290,2264948,37658
"13033","ENSACAG00000016219","1",131763658,131765208,1550
"13034","ENSACAG00000016220","GL343279.1",1724800,1774857,50057
"13035","ENSACAG00000016222","2",140338701,140365625,26924
"13036","ENSACAG00000016223","GL343878.1",117465,128163,10698
"13037","ENSACAG00000016224","GL344440.1",16413,33683,17270
"13038","ENSACAG00000016225","1",23761929,23777774,15845
"13039","ENSACAG00000016226","1",131882753,131959086,76333
"13040","ENSACAG00000016227","5",87899979,88133573,233594
"13041","ENSACAG00000016228","GL343353.1",632587,720306,87719
"13042","ENSACAG00000016229","4",31403628,31548441,144813
"13043","ENSACAG00000016230","4",145941500,145943380,1880
"13044","ENSACAG00000016231","5",85959178,85985181,26003
"13045","ENSACAG00000016232","3",6855765,6972425,116660
"13046","ENSACAG00000016233","1",131965325,132000296,34971
"13047","ENSACAG00000016234","4",145320417,145439534,119117
"13048","ENSACAG00000016236","4",150132655,150318882,186227
"13049","ENSACAG00000016238","GL343217.1",1133163,1167833,34670
"13050","ENSACAG00000016239","1",38904591,38933505,28914
"13051","ENSACAG00000016240","GL343325.1",338969,356975,18006
"13052","ENSACAG00000016242","GL344282.1",44900,52925,8025
"13053","ENSACAG00000016243","GL343217.1",1033070,1048475,15405
"13054","ENSACAG00000016244","1",260496391,260911412,415021
"13055","ENSACAG00000016245","3",98154415,98196611,42196
"13056","ENSACAG00000016246","3",30876640,30895625,18985
"13057","ENSACAG00000016248","2",101780982,101803194,22212
"13058","ENSACAG00000016249","GL344135.1",67748,76866,9118
"13059","ENSACAG00000016250","5",22525081,22545720,20639
"13060","ENSACAG00000016251","3",30869452,30873884,4432
"13061","ENSACAG00000016254","GL343325.1",253445,328728,75283
"13062","ENSACAG00000016256","AAWZ02039946",278,5338,5060
"13063","ENSACAG00000016259","GL343325.1",239270,239833,563
"13064","ENSACAG00000016261","GL343374.1",160224,163955,3731
"13065","ENSACAG00000016262","5",22485271,22498149,12878
"13066","ENSACAG00000016263","3",30846625,30863195,16570
"13067","ENSACAG00000016265","GL343325.1",214945,235122,20177
"13068","ENSACAG00000016268","GL343197.1",4325581,4326765,1184
"13069","ENSACAG00000016269","LGc",430207,453916,23709
"13070","ENSACAG00000016270","GL343197.1",4343646,4401011,57365
"13071","ENSACAG00000016274","GL343325.1",191139,200162,9023
"13072","ENSACAG00000016275","2",11473210,11480052,6842
"13073","ENSACAG00000016277","GL343856.1",20064,38818,18754
"13074","ENSACAG00000016278","GL343276.1",389101,452720,63619
"13075","ENSACAG00000016280","GL343394.1",925002,933922,8920
"13076","ENSACAG00000016282","GL343276.1",572353,753685,181332
"13077","ENSACAG00000016283","5",18119318,18154208,34890
"13078","ENSACAG00000016285","5",22277684,22446240,168556
"13079","ENSACAG00000016288","3",30799381,30802689,3308
"13080","ENSACAG00000016289","1",238152440,238233503,81063
"13081","ENSACAG00000016290","2",11914900,11972983,58083
"13082","ENSACAG00000016291","3",30776395,30782895,6500
"13083","ENSACAG00000016292","3",30755274,30760878,5604
"13084","ENSACAG00000016293","1",23743109,23756162,13053
"13085","ENSACAG00000016294","LGb",2279130,2287881,8751
"13086","ENSACAG00000016295","2",101824978,101869481,44503
"13087","ENSACAG00000016297","GL343325.1",145774,147012,1238
"13088","ENSACAG00000016298","GL343217.1",983806,1003442,19636
"13089","ENSACAG00000016299","3",30749650,30755539,5889
"13090","ENSACAG00000016300","GL343325.1",84216,85526,1310
"13091","ENSACAG00000016301","GL343394.1",456136,842061,385925
"13092","ENSACAG00000016302","4",31270630,31336264,65634
"13093","ENSACAG00000016303","GL343325.1",27075,60412,33337
"13094","ENSACAG00000016304","2",140409679,140412549,2870
"13095","ENSACAG00000016306","3",30728743,30737508,8765
"13096","ENSACAG00000016307","1",23719527,23741114,21587
"13097","ENSACAG00000016308","5",22227088,22243931,16843
"13098","ENSACAG00000016309","1",38858453,38886864,28411
"13099","ENSACAG00000016311","3",6309330,6679012,369682
"13100","ENSACAG00000016312","3",30700251,30726744,26493
"13101","ENSACAG00000016313","2",79978850,80000064,21214
"13102","ENSACAG00000016314","4",31173347,31243973,70626
"13103","ENSACAG00000016317","GL343242.1",647742,662975,15233
"13104","ENSACAG00000016318","1",132005978,132036509,30531
"13105","ENSACAG00000016319","1",238093862,238109849,15987
"13106","ENSACAG00000016320","5",128003121,128117247,114126
"13107","ENSACAG00000016321","6",64978945,64979961,1016
"13108","ENSACAG00000016322","GL344967.1",1492,15604,14112
"13109","ENSACAG00000016323","2",140417161,140425189,8028
"13110","ENSACAG00000016324","6",65036178,65231117,194939
"13111","ENSACAG00000016325","1",132035835,132065686,29851
"13112","ENSACAG00000016326","GL343329.1",130748,142136,11388
"13113","ENSACAG00000016327","6",19239269,19283903,44634
"13114","ENSACAG00000016328","5",18037398,18137122,99724
"13115","ENSACAG00000016330","GL343197.1",4553735,4679135,125400
"13116","ENSACAG00000016332","GL343329.1",161209,174276,13067
"13117","ENSACAG00000016334","4",145286429,145320383,33954
"13118","ENSACAG00000016335","2",101922189,102051446,129257
"13119","ENSACAG00000016337","GL344137.1",588,33898,33310
"13120","ENSACAG00000016339","1",23662195,23719200,57005
"13121","ENSACAG00000016340","1",38835561,38851154,15593
"13122","ENSACAG00000016341","GL343332.1",889413,899256,9843
"13123","ENSACAG00000016342","5",88669385,88785094,115709
"13124","ENSACAG00000016343","1",23566104,23601930,35826
"13125","ENSACAG00000016344","GL343856.1",39309,43432,4123
"13126","ENSACAG00000016345","GL343329.1",180525,194393,13868
"13127","ENSACAG00000016346","GL343276.1",756238,798798,42560
"13128","ENSACAG00000016347","5",22201461,22221690,20229
"13129","ENSACAG00000016352","GL343856.1",60058,68964,8906
"13130","ENSACAG00000016353","1",238034214,238042154,7940
"13131","ENSACAG00000016354","2",79856458,79966876,110418
"13132","ENSACAG00000016355","GL343533.1",300058,450479,150421
"13133","ENSACAG00000016356","1",23535964,23557822,21858
"13134","ENSACAG00000016357","GL343329.1",213732,256627,42895
"13135","ENSACAG00000016359","GL343353.1",722422,766496,44074
"13136","ENSACAG00000016360","GL343329.1",280593,281411,818
"13137","ENSACAG00000016361","GL343329.1",307459,324368,16909
"13138","ENSACAG00000016362","1",237921217,237949248,28031
"13139","ENSACAG00000016363","2",12334265,12363016,28751
"13140","ENSACAG00000016364","GL343217.1",819586,904315,84729
"13141","ENSACAG00000016368","GL343329.1",327164,401723,74559
"13142","ENSACAG00000016370","3",198086963,198088352,1389
"13143","ENSACAG00000016371","1",237878020,237899978,21958
"13144","ENSACAG00000016374","5",17785453,17818933,33480
"13145","ENSACAG00000016375","AAWZ02036392",511,24244,23733
"13146","ENSACAG00000016376","GL343394.1",335190,426000,90810
"13147","ENSACAG00000016377","GL343276.1",948781,971712,22931
"13148","ENSACAG00000016379","2",140430441,140455809,25368
"13149","ENSACAG00000016380","GL343856.1",69861,83042,13181
"13150","ENSACAG00000016381","1",38547377,38787451,240074
"13151","ENSACAG00000016382","5",22176239,22196962,20723
"13152","ENSACAG00000016383","1",259689812,259692942,3130
"13153","ENSACAG00000016384","GL343394.1",256005,295486,39481
"13154","ENSACAG00000016386","GL343197.1",5928498,6120502,192004
"13155","ENSACAG00000016387","5",22047775,22130391,82616
"13156","ENSACAG00000016388","5",55663464,55800799,137335
"13157","ENSACAG00000016390","AAWZ02041954",1310,4762,3452
"13158","ENSACAG00000016391","6",19247372,19247817,445
"13159","ENSACAG00000016392","3",48449439,48464849,15410
"13160","ENSACAG00000016393","6",19233319,19234162,843
"13161","ENSACAG00000016394","GL343856.1",90771,105256,14485
"13162","ENSACAG00000016396","3",98214686,98446878,232192
"13163","ENSACAG00000016397","6",19206392,19227872,21480
"13164","ENSACAG00000016398","GL343276.1",991859,1052155,60296
"13165","ENSACAG00000016399","GL343749.1",11390,224178,212788
"13166","ENSACAG00000016400","1",132089979,132107479,17500
"13167","ENSACAG00000016401","GL343394.1",230587,249724,19137
"13168","ENSACAG00000016403","4",31114035,31171649,57614
"13169","ENSACAG00000016404","GL344137.1",37738,57943,20205
"13170","ENSACAG00000016405","3",6289864,6298332,8468
"13171","ENSACAG00000016406","1",237824268,237849252,24984
"13172","ENSACAG00000016407","2",38260894,38592818,331924
"13173","ENSACAG00000016411","3",6244923,6260846,15923
"13174","ENSACAG00000016414","3",48615297,48644505,29208
"13175","ENSACAG00000016415","AAWZ02036018",8376,9533,1157
"13176","ENSACAG00000016416","LGc",454053,474162,20109
"13177","ENSACAG00000016418","1",38215244,38460487,245243
"13178","ENSACAG00000016419","2",12368234,12378524,10290
"13179","ENSACAG00000016420","3",6182716,6195254,12538
"13180","ENSACAG00000016422","LGb",2290688,2295074,4386
"13181","ENSACAG00000016423","1",23514098,23534419,20321
"13182","ENSACAG00000016424","GL343533.1",264245,282219,17974
"13183","ENSACAG00000016425","4",31089926,31102151,12225
"13184","ENSACAG00000016426","5",55363235,55389837,26602
"13185","ENSACAG00000016427","GL343394.1",108681,116665,7984
"13186","ENSACAG00000016428","GL344973.1",21,12759,12738
"13187","ENSACAG00000016429","3",6098697,6147447,48750
"13188","ENSACAG00000016430","LGb",2294739,2310096,15357
"13189","ENSACAG00000016431","GL343394.1",52615,94039,41424
"13190","ENSACAG00000016433","6",65264524,65301942,37418
"13191","ENSACAG00000016434","1",132110939,132147920,36981
"13192","ENSACAG00000016435","GL343981.1",57092,70918,13826
"13193","ENSACAG00000016436","GL343856.1",111199,118999,7800
"13194","ENSACAG00000016439","5",128288547,128345520,56973
"13195","ENSACAG00000016440","2",12380183,12389248,9065
"13196","ENSACAG00000016441","GL344963.1",4589,5899,1310
"13197","ENSACAG00000016442","5",89672326,89736429,64103
"13198","ENSACAG00000016443","4",31058845,31086479,27634
"13199","ENSACAG00000016446","GL343615.1",321677,329382,7705
"13200","ENSACAG00000016447","2",12399392,12400359,967
"13201","ENSACAG00000016448","GL343881.1",20431,82766,62335
"13202","ENSACAG00000016449","LGb",2339025,2372226,33201
"13203","ENSACAG00000016451","GL343856.1",121936,139096,17160
"13204","ENSACAG00000016452","2",12403766,12416875,13109
"13205","ENSACAG00000016454","3",98452523,98498092,45569
"13206","ENSACAG00000016456","AAWZ02038914",24,9267,9243
"13207","ENSACAG00000016457","6",19099969,19180995,81026
"13208","ENSACAG00000016458","LGc",499559,569283,69724
"13209","ENSACAG00000016460","5",17754474,17776453,21979
"13210","ENSACAG00000016461","4",31040606,31046251,5645
"13211","ENSACAG00000016462","4",145154466,145172122,17656
"13212","ENSACAG00000016464","1",23467905,23478338,10433
"13213","ENSACAG00000016465","2",93222426,93291002,68576
"13214","ENSACAG00000016466","1",23388996,23409335,20339
"13215","ENSACAG00000016467","LGc",623981,889335,265354
"13216","ENSACAG00000016469","1",117849684,117910092,60408
"13217","ENSACAG00000016470","GL343394.1",21981,42069,20088
"13218","ENSACAG00000016472","2",140656003,140956700,300697
"13219","ENSACAG00000016473","LGb",2373786,2386431,12645
"13220","ENSACAG00000016474","GL343856.1",139846,155325,15479
"13221","ENSACAG00000016475","2",37540227,37542202,1975
"13222","ENSACAG00000016476","5",128350661,128358223,7562
"13223","ENSACAG00000016477","GL343326.1",984311,1082069,97758
"13224","ENSACAG00000016478","5",89746388,89863823,117435
"13225","ENSACAG00000016479","GL343881.1",106570,115996,9426
"13226","ENSACAG00000016480","2",37328731,37372753,44022
"13227","ENSACAG00000016481","1",132159121,132169439,10318
"13228","ENSACAG00000016482","1",23147440,23155515,8075
"13229","ENSACAG00000016483","GL343490.1",271668,272375,707
"13230","ENSACAG00000016485","4",123263467,123303953,40486
"13231","ENSACAG00000016486","GL343276.1",1229145,1264738,35593
"13232","ENSACAG00000016487","4",30940678,31007924,67246
"13233","ENSACAG00000016488","1",23119384,23135168,15784
"13234","ENSACAG00000016489","6",65313918,65408923,95005
"13235","ENSACAG00000016491","6",18898759,19032889,134130
"13236","ENSACAG00000016492","LGb",2396371,2410832,14461
"13237","ENSACAG00000016493","2",12417675,12465890,48215
"13238","ENSACAG00000016494","1",22965620,23119671,154051
"13239","ENSACAG00000016498","3",135604617,135605273,656
"13240","ENSACAG00000016499","GL343816.1",149029,164187,15158
"13241","ENSACAG00000016500","1",37958536,38135119,176583
"13242","ENSACAG00000016501","GL343353.1",811702,831166,19464
"13243","ENSACAG00000016502","5",128359013,128381843,22830
"13244","ENSACAG00000016503","GL343881.1",119100,128618,9518
"13245","ENSACAG00000016506","4",123361945,123363469,1524
"13246","ENSACAG00000016508","6",65423417,65444540,21123
"13247","ENSACAG00000016511","1",132240435,132265318,24883
"13248","ENSACAG00000016513","2",37159109,37173005,13896
"13249","ENSACAG00000016514","GL343856.1",158132,163701,5569
"13250","ENSACAG00000016515","5",17591808,17673963,82155
"13251","ENSACAG00000016516","4",123366717,123378415,11698
"13252","ENSACAG00000016517","GL345048.1",208,3690,3482
"13253","ENSACAG00000016518","3",98501789,98541014,39225
"13254","ENSACAG00000016519","GL343816.1",31311,141702,110391
"13255","ENSACAG00000016520","LGc",2265381,2309677,44296
"13256","ENSACAG00000016522","GL343329.1",414067,446737,32670
"13257","ENSACAG00000016524","3",6018494,6073751,55257
"13258","ENSACAG00000016525","2",93204104,93212593,8489
"13259","ENSACAG00000016526","LGb",2413952,2463375,49423
"13260","ENSACAG00000016527","4",123388562,123398075,9513
"13261","ENSACAG00000016528","GL343276.1",1274893,1332462,57569
"13262","ENSACAG00000016530","GL343353.1",865440,928531,63091
"13263","ENSACAG00000016532","5",17558126,17559491,1365
"13264","ENSACAG00000016533","1",132254778,132275012,20234
"13265","ENSACAG00000016534","2",37133460,37147619,14159
"13266","ENSACAG00000016535","5",21806633,22040137,233504
"13267","ENSACAG00000016536","2",36979920,36981620,1700
"13268","ENSACAG00000016538","AAWZ02039814",2055,3891,1836
"13269","ENSACAG00000016540","4",145055248,145107144,51896
"13270","ENSACAG00000016542","GL343329.1",516840,542521,25681
"13271","ENSACAG00000016543","1",132277675,132311621,33946
"13272","ENSACAG00000016545","2",12477406,12526986,49580
"13273","ENSACAG00000016546","3",4927761,5030382,102621
"13274","ENSACAG00000016548","2",141011047,141051754,40707
"13275","ENSACAG00000016550","GL343698.1",24670,37281,12611
"13276","ENSACAG00000016551","5",17510554,17536135,25581
"13277","ENSACAG00000016552","5",128385437,128432631,47194
"13278","ENSACAG00000016554","GL343757.1",650,4500,3850
"13279","ENSACAG00000016557","2",79803983,79823580,19597
"13280","ENSACAG00000016560","1",132332561,132365095,32534
"13281","ENSACAG00000016561","GL343326.1",830656,844708,14052
"13282","ENSACAG00000016562","2",93177749,93182423,4674
"13283","ENSACAG00000016563","2",93148021,93179079,31058
"13284","ENSACAG00000016565","GL343533.1",198289,204508,6219
"13285","ENSACAG00000016566","GL343329.1",607905,610929,3024
"13286","ENSACAG00000016567","2",79715660,79790730,75070
"13287","ENSACAG00000016569","GL343757.1",26841,27836,995
"13288","ENSACAG00000016570","4",123406900,123421692,14792
"13289","ENSACAG00000016571","GL343757.1",54113,63414,9301
"13290","ENSACAG00000016572","5",17485079,17505260,20181
"13291","ENSACAG00000016573","4",30912771,30922720,9949
"13292","ENSACAG00000016574","GL343276.1",1343553,1370703,27150
"13293","ENSACAG00000016575","GL343326.1",808765,819129,10364
"13294","ENSACAG00000016576","GL343329.1",624001,661115,37114
"13295","ENSACAG00000016577","4",30873961,30901920,27959
"13296","ENSACAG00000016578","5",17451623,17474170,22547
"13297","ENSACAG00000016579","GL343994.1",163047,198614,35567
"13298","ENSACAG00000016580","GL343326.1",797788,806047,8259
"13299","ENSACAG00000016581","2",36880245,36884893,4648
"13300","ENSACAG00000016583","4",123442329,123450204,7875
"13301","ENSACAG00000016584","6",65458608,65542164,83556
"13302","ENSACAG00000016585","GL343533.1",209278,222430,13152
"13303","ENSACAG00000016586","5",21745647,21750643,4996
"13304","ENSACAG00000016587","2",141186107,141211061,24954
"13305","ENSACAG00000016589","2",79626653,79656843,30190
"13306","ENSACAG00000016591","LGc",2319401,2363052,43651
"13307","ENSACAG00000016592","5",17380585,17437607,57022
"13308","ENSACAG00000016594","2",36831966,36873997,42031
"13309","ENSACAG00000016595","5",21737716,21742466,4750
"13310","ENSACAG00000016596","GL343353.1",987461,1023210,35749
"13311","ENSACAG00000016597","LGb",2553509,2665942,112433
"13312","ENSACAG00000016598","GL343326.1",778191,791467,13276
"13313","ENSACAG00000016599","GL343488.1",23,16731,16708
"13314","ENSACAG00000016601","GL343488.1",48289,103487,55198
"13315","ENSACAG00000016602","GL343329.1",661285,691427,30142
"13316","ENSACAG00000016603","5",21678469,21684629,6160
"13317","ENSACAG00000016604","5",128485235,128502078,16843
"13318","ENSACAG00000016605","GL343326.1",763154,775982,12828
"13319","ENSACAG00000016606","4",123458799,123479311,20512
"13320","ENSACAG00000016607","GL343533.1",237153,255064,17911
"13321","ENSACAG00000016608","3",98570714,98672688,101974
"13322","ENSACAG00000016609","5",21498897,21522534,23637
"13323","ENSACAG00000016610","1",22886412,22907358,20946
"13324","ENSACAG00000016611","AAWZ02037989",1972,3984,2012
"13325","ENSACAG00000016612","5",128515806,128536975,21169
"13326","ENSACAG00000016614","LGb",2703148,2718966,15818
"13327","ENSACAG00000016615","GL343326.1",722195,744244,22049
"13328","ENSACAG00000016618","GL343276.1",1438654,1444360,5706
"13329","ENSACAG00000016619","2",36783021,36808585,25564
"13330","ENSACAG00000016620","GL343353.1",1023265,1058993,35728
"13331","ENSACAG00000016621","GL343276.1",1452981,1462496,9515
"13332","ENSACAG00000016622","5",128785188,128886518,101330
"13333","ENSACAG00000016623","2",93046636,93118956,72320
"13334","ENSACAG00000016624","2",79592097,79611060,18963
"13335","ENSACAG00000016625","6",18858332,18893678,35346
"13336","ENSACAG00000016626","GL343679.1",5220,13334,8114
"13337","ENSACAG00000016627","GL343679.1",17518,27573,10055
"13338","ENSACAG00000016628","1",132471532,132519420,47888
"13339","ENSACAG00000016630","4",30816785,30836489,19704
"13340","ENSACAG00000016631","4",144878066,145042996,164930
"13341","ENSACAG00000016632","GL343679.1",51829,53136,1307
"13342","ENSACAG00000016633","GL343342.1",36339,134867,98528
"13343","ENSACAG00000016634","GL343679.1",57814,65600,7786
"13344","ENSACAG00000016635","4",123488623,123489719,1096
"13345","ENSACAG00000016636","2",12561266,12577264,15998
"13346","ENSACAG00000016637","4",123505810,123510181,4371
"13347","ENSACAG00000016638","GL343488.1",112562,118405,5843
"13348","ENSACAG00000016639","1",132548110,132567224,19114
"13349","ENSACAG00000016640","5",17345868,17372041,26173
"13350","ENSACAG00000016641","2",12623597,12683358,59761
"13351","ENSACAG00000016642","6",65550323,65582871,32548
"13352","ENSACAG00000016643","GL343353.1",1071811,1094531,22720
"13353","ENSACAG00000016644","GL343488.1",122613,140421,17808
"13354","ENSACAG00000016645","GL343276.1",1462581,1471512,8931
"13355","ENSACAG00000016646","GL343329.1",715435,726610,11175
"13356","ENSACAG00000016647","LGc",2365534,2370031,4497
"13357","ENSACAG00000016648","1",132584192,132595501,11309
"13358","ENSACAG00000016649","GL343353.1",1119943,1169628,49685
"13359","ENSACAG00000016650","GL343326.1",700620,711854,11234
"13360","ENSACAG00000016651","1",22860035,22864798,4763
"13361","ENSACAG00000016653","4",123542677,123558278,15601
"13362","ENSACAG00000016655","2",79330025,79462506,132481
"13363","ENSACAG00000016656","4",123564631,123577372,12741
"13364","ENSACAG00000016657","5",17238676,17339693,101017
"13365","ENSACAG00000016658","4",123583936,123592083,8147
"13366","ENSACAG00000016659","5",21483006,21495964,12958
"13367","ENSACAG00000016660","LGb",2718498,2726728,8230
"13368","ENSACAG00000016661","6",18696457,18720551,24094
"13369","ENSACAG00000016662","2",102049917,102091272,41355
"13370","ENSACAG00000016664","GL343276.1",1481624,1484957,3333
"13371","ENSACAG00000016665","GL343679.1",101366,110435,9069
"13372","ENSACAG00000016668","GL343326.1",617764,630830,13066
"13373","ENSACAG00000016669","GL343679.1",119574,156399,36825
"13374","ENSACAG00000016672","GL343261.1",930678,950818,20140
"13375","ENSACAG00000016674","4",30730518,30731126,608
"13376","ENSACAG00000016675","LGc",2383537,2465626,82089
"13377","ENSACAG00000016677","2",141216262,141258529,42267
"13378","ENSACAG00000016678","1",132594652,132629594,34942
"13379","ENSACAG00000016679","GL343276.1",1486148,1523466,37318
"13380","ENSACAG00000016680","6",18676703,18689428,12725
"13381","ENSACAG00000016681","4",30683945,30725180,41235
"13382","ENSACAG00000016682","GL343329.1",744887,765238,20351
"13383","ENSACAG00000016683","2",12713458,12758468,45010
"13384","ENSACAG00000016684","4",123598638,123626900,28262
"13385","ENSACAG00000016685","1",22796782,22857458,60676
"13386","ENSACAG00000016686","4",144690958,144710455,19497
"13387","ENSACAG00000016687","GL343488.1",150471,151211,740
"13388","ENSACAG00000016688","GL343276.1",1537655,1547979,10324
"13389","ENSACAG00000016689","6",18523587,18614183,90596
"13390","ENSACAG00000016692","GL343488.1",166229,170165,3936
"13391","ENSACAG00000016694","4",123659023,123664510,5487
"13392","ENSACAG00000016695","GL343326.1",614284,616034,1750
"13393","ENSACAG00000016696","GL343326.1",545429,590171,44742
"13394","ENSACAG00000016697","LGb",2751633,2758360,6727
"13395","ENSACAG00000016698","4",144672391,144675751,3360
"13396","ENSACAG00000016700","2",92962518,93030784,68266
"13397","ENSACAG00000016701","2",102112975,102118015,5040
"13398","ENSACAG00000016702","4",30654917,30668896,13979
"13399","ENSACAG00000016703","GL343568.1",251755,280380,28625
"13400","ENSACAG00000016704","GL343382.1",6742,23155,16413
"13401","ENSACAG00000016705","2",102222719,102234424,11705
"13402","ENSACAG00000016707","GL343326.1",424086,513103,89017
"13403","ENSACAG00000016709","GL343488.1",172994,181204,8210
"13404","ENSACAG00000016710","GL343342.1",205667,226541,20874
"13405","ENSACAG00000016711","4",144585717,144643425,57708
"13406","ENSACAG00000016713","2",102264153,102273198,9045
"13407","ENSACAG00000016714","1",22757932,22764794,6862
"13408","ENSACAG00000016715","GL343276.1",1578128,1583778,5650
"13409","ENSACAG00000016716","2",102282344,102286266,3922
"13410","ENSACAG00000016717","LGb",2761403,2773963,12560
"13411","ENSACAG00000016718","1",22732893,22753012,20119
"13412","ENSACAG00000016719","GL343342.1",244308,299553,55245
"13413","ENSACAG00000016720","4",30559637,30599516,39879
"13414","ENSACAG00000016722","1",132637314,132651657,14343
"13415","ENSACAG00000016724","LGb",2832962,2920266,87304
"13416","ENSACAG00000016725","4",144558667,144563750,5083
"13417","ENSACAG00000016726","GL343488.1",186128,200680,14552
"13418","ENSACAG00000016727","4",78226,82486,4260
"13419","ENSACAG00000016728","6",65691729,65706585,14856
"13420","ENSACAG00000016729","3",124498741,124500489,1748
"13421","ENSACAG00000016730","2",102294901,102303328,8427
"13422","ENSACAG00000016732","3",124547681,124558648,10967
"13423","ENSACAG00000016733","4",144320942,144402372,81430
"13424","ENSACAG00000016734","2",141529693,141563808,34115
"13425","ENSACAG00000016735","3",124563799,124602082,38283
"13426","ENSACAG00000016736","2",12797078,12887899,90821
"13427","ENSACAG00000016737","3",124627697,124646398,18701
"13428","ENSACAG00000016739","6",65733068,65740441,7373
"13429","ENSACAG00000016740","GL343790.1",8739,53919,45180
"13430","ENSACAG00000016741","6",65769675,65770013,338
"13431","ENSACAG00000016742","6",65791773,65817912,26139
"13432","ENSACAG00000016744","4",144300755,144313995,13240
"13433","ENSACAG00000016745","GL343488.1",208809,219394,10585
"13434","ENSACAG00000016746","2",102304995,102313437,8442
"13435","ENSACAG00000016747","GL343488.1",253793,265126,11333
"13436","ENSACAG00000016748","5",21405671,21425449,19778
"13437","ENSACAG00000016749","4",144264765,144301427,36662
"13438","ENSACAG00000016750","2",102320082,102342996,22914
"13439","ENSACAG00000016751","1",132655897,132672863,16966
"13440","ENSACAG00000016752","2",92924737,92933786,9049
"13441","ENSACAG00000016753","2",12905790,12937861,32071
"13442","ENSACAG00000016756","2",141586195,141596736,10541
"13443","ENSACAG00000016757","GL343276.1",1631121,1647585,16464
"13444","ENSACAG00000016759","GL343342.1",408151,427706,19555
"13445","ENSACAG00000016760","GL343276.1",1648054,1660325,12271
"13446","ENSACAG00000016761","GL343488.1",336807,355254,18447
"13447","ENSACAG00000016762","1",132683714,132711787,28073
"13448","ENSACAG00000016763","GL343399.1",60743,109865,49122
"13449","ENSACAG00000016764","GL343382.1",247657,253681,6024
"13450","ENSACAG00000016765","GL343342.1",485979,517327,31348
"13451","ENSACAG00000016766","GL343568.1",194964,233742,38778
"13452","ENSACAG00000016767","GL343488.1",413941,441419,27478
"13453","ENSACAG00000016768","2",12969460,12974630,5170
"13454","ENSACAG00000016769","1",22712470,22730188,17718
"13455","ENSACAG00000016770","4",30539355,30556954,17599
"13456","ENSACAG00000016771","GL343329.1",775403,809460,34057
"13457","ENSACAG00000016772","GL343326.1",352741,404024,51283
"13458","ENSACAG00000016773","2",92921376,92924197,2821
"13459","ENSACAG00000016774","GL343276.1",1661914,1674725,12811
"13460","ENSACAG00000016775","2",92812476,92825914,13438
"13461","ENSACAG00000016776","3",98759126,98870623,111497
"13462","ENSACAG00000016777","GL343329.1",853192,856474,3282
"13463","ENSACAG00000016778","4",144221314,144226256,4942
"13464","ENSACAG00000016779","GL343568.1",107657,109330,1673
"13465","ENSACAG00000016780","GL343329.1",871072,896748,25676
"13466","ENSACAG00000016782","4",144184323,144196140,11817
"13467","ENSACAG00000016783","GL343790.1",80813,191135,110322
"13468","ENSACAG00000016784","GL343399.1",424628,452807,28179
"13469","ENSACAG00000016785","GL343568.1",96739,97722,983
"13470","ENSACAG00000016786","5",128909899,128952557,42658
"13471","ENSACAG00000016787","GL343276.1",1674857,1688249,13392
"13472","ENSACAG00000016790","4",30511792,30533466,21674
"13473","ENSACAG00000016791","GL343382.1",268058,338850,70792
"13474","ENSACAG00000016792","2",102357259,102376620,19361
"13475","ENSACAG00000016793","GL343568.1",43859,55241,11382
"13476","ENSACAG00000016794","GL343342.1",588573,673180,84607
"13477","ENSACAG00000016795","1",22691163,22697207,6044
"13478","ENSACAG00000016796","3",98774842,98775831,989
"13479","ENSACAG00000016798","1",22622924,22632369,9445
"13480","ENSACAG00000016799","2",12996509,13040565,44056
"13481","ENSACAG00000016800","GL343200.1",1084668,1093568,8900
"13482","ENSACAG00000016801","GL343276.1",1707937,1720413,12476
"13483","ENSACAG00000016802","GL344207.1",52920,67381,14461
"13484","ENSACAG00000016803","4",144113117,144141514,28397
"13485","ENSACAG00000016804","GL343200.1",1274425,1295372,20947
"13486","ENSACAG00000016805","4",30042197,30149786,107589
"13487","ENSACAG00000016806","1",132715573,132740952,25379
"13488","ENSACAG00000016807","2",102382578,102386683,4105
"13489","ENSACAG00000016808","2",102386977,102399205,12228
"13490","ENSACAG00000016809","5",17189308,17198320,9012
"13491","ENSACAG00000016810","2",79253936,79262790,8854
"13492","ENSACAG00000016815","5",17158052,17180931,22879
"13493","ENSACAG00000016816","GL343200.1",1299746,1311903,12157
"13494","ENSACAG00000016817","2",92716462,92731044,14582
"13495","ENSACAG00000016818","1",132741258,132761897,20639
"13496","ENSACAG00000016819","GL343200.1",1359992,1439851,79859
"13497","ENSACAG00000016820","2",79196354,79205989,9635
"13498","ENSACAG00000016821","1",132765220,132791093,25873
"13499","ENSACAG00000016822","GL343276.1",1727551,1736151,8600
"13500","ENSACAG00000016823","6",66014724,66028623,13899
"13501","ENSACAG00000016824","2",79163257,79180001,16744
"13502","ENSACAG00000016825","GL343342.1",751396,844505,93109
"13503","ENSACAG00000016826","AAWZ02038103",2677,5860,3183
"13504","ENSACAG00000016827","GL343342.1",915648,1030496,114848
"13505","ENSACAG00000016828","5",128998063,129128178,130115
"13506","ENSACAG00000016829","1",132791861,132800704,8843
"13507","ENSACAG00000016831","1",132811292,132844404,33112
"13508","ENSACAG00000016832","2",102397992,102404459,6467
"13509","ENSACAG00000016834","4",30018474,30019418,944
"13510","ENSACAG00000016835","GL343518.1",682,23585,22903
"13511","ENSACAG00000016836","2",92635380,92671021,35641
"13512","ENSACAG00000016837","4",29473027,29506059,33032
"13513","ENSACAG00000016838","2",13053330,13147479,94149
"13514","ENSACAG00000016839","2",79101680,79147392,45712
"13515","ENSACAG00000016840","2",102411722,102420683,8961
"13516","ENSACAG00000016841","5",16882913,17160003,277090
"13517","ENSACAG00000016842","1",22612860,22625059,12199
"13518","ENSACAG00000016843","GL343362.1",1042441,1047381,4940
"13519","ENSACAG00000016844","1",22606332,22607526,1194
"13520","ENSACAG00000016845","2",141956730,142011862,55132
"13521","ENSACAG00000016846","1",22597007,22606710,9703
"13522","ENSACAG00000016847","GL343329.1",922431,968586,46155
"13523","ENSACAG00000016848","4",144081372,144087776,6404
"13524","ENSACAG00000016849","2",102437478,102505830,68352
"13525","ENSACAG00000016850","1",22561407,22593310,31903
"13526","ENSACAG00000016851","GL343276.1",1756111,1760844,4733
"13527","ENSACAG00000016852","GL343200.1",1495879,1509635,13756
"13528","ENSACAG00000016853","2",109564420,109604606,40186
"13529","ENSACAG00000016855","GL343200.1",1575549,1605067,29518
"13530","ENSACAG00000016856","AAWZ02037495",4044,15206,11162
"13531","ENSACAG00000016857","GL343342.1",1104782,1123221,18439
"13532","ENSACAG00000016858","GL344573.1",52125,52946,821
"13533","ENSACAG00000016861","4",29465949,29466539,590
"13534","ENSACAG00000016862","GL344573.1",1095,1734,639
"13535","ENSACAG00000016864","5",129429266,129445037,15771
"13536","ENSACAG00000016865","4",29427324,29450489,23165
"13537","ENSACAG00000016868","6",66043544,66085878,42334
"13538","ENSACAG00000016869","4",144061184,144076294,15110
"13539","ENSACAG00000016871","4",144023233,144023382,149
"13540","ENSACAG00000016872","2",109628754,109629842,1088
"13541","ENSACAG00000016873","4",143967066,144014656,47590
"13542","ENSACAG00000016874","GL343362.1",749385,1035031,285646
"13543","ENSACAG00000016875","GL343329.1",977912,1015514,37602
"13544","ENSACAG00000016876","2",92587862,92619470,31608
"13545","ENSACAG00000016880","5",129446586,129468797,22211
"13546","ENSACAG00000016881","2",109539912,109563229,23317
"13547","ENSACAG00000016882","GL343342.1",1126304,1140960,14656
"13548","ENSACAG00000016883","GL343518.1",36822,89032,52210
"13549","ENSACAG00000016884","2",79007054,79019362,12308
"13550","ENSACAG00000016885","2",109526036,109534094,8058
"13551","ENSACAG00000016886","2",78996152,79009434,13282
"13552","ENSACAG00000016888","GL343399.1",480529,529575,49046
"13553","ENSACAG00000016889","GL343382.1",527237,541679,14442
"13554","ENSACAG00000016890","GL343382.1",542553,586945,44392
"13555","ENSACAG00000016891","4",29409207,29426604,17397
"13556","ENSACAG00000016892","1",132887525,132894284,6759
"13557","ENSACAG00000016893","GL343717.1",6762,34210,27448
"13558","ENSACAG00000016894","2",109478731,109507145,28414
"13559","ENSACAG00000016895","6",66088934,66115751,26817
"13560","ENSACAG00000016896","AAWZ02037078",4417,11196,6779
"13561","ENSACAG00000016897","GL343200.1",1774654,1775187,533
"13562","ENSACAG00000016899","1",22514162,22545126,30964
"13563","ENSACAG00000016900","1",118008643,118069785,61142
"13564","ENSACAG00000016901","1",132985748,132987739,1991
"13565","ENSACAG00000016902","4",143908658,143916846,8188
"13566","ENSACAG00000016903","2",78904749,78966071,61322
"13567","ENSACAG00000016904","GL343399.1",562688,882165,319477
"13568","ENSACAG00000016905","GL344200.1",11938,58513,46575
"13569","ENSACAG00000016906","GL343329.1",1078998,1082684,3686
"13570","ENSACAG00000016907","4",143884186,143885202,1016
"13571","ENSACAG00000016908","GL343342.1",1150338,1166068,15730
"13572","ENSACAG00000016909","4",143725845,143806772,80927
"13573","ENSACAG00000016910","AAWZ02037949",297,13842,13545
"13574","ENSACAG00000016911","GL343329.1",1084428,1106544,22116
"13575","ENSACAG00000016912","5",129480187,129492740,12553
"13576","ENSACAG00000016914","GL343200.1",2060674,2069336,8662
"13577","ENSACAG00000016915","2",92537513,92556257,18744
"13578","ENSACAG00000016916","GL343382.1",590045,628318,38273
"13579","ENSACAG00000016918","GL343200.1",2083990,2160352,76362
"13580","ENSACAG00000016919","6",66164193,66337723,173530
"13581","ENSACAG00000016920","2",142021654,142034172,12518
"13582","ENSACAG00000016921","1",22458134,22462638,4504
"13583","ENSACAG00000016922","2",92358222,92360378,2156
"13584","ENSACAG00000016923","GL343200.1",2224819,2299508,74689
"13585","ENSACAG00000016924","2",92281855,92303391,21536
"13586","ENSACAG00000016925","2",78867859,78901247,33388
"13587","ENSACAG00000016926","GL343276.1",1767463,1785593,18130
"13588","ENSACAG00000016927","GL343342.1",1177733,1192657,14924
"13589","ENSACAG00000016928","GL343717.1",44007,85821,41814
"13590","ENSACAG00000016929","5",129497793,129574717,76924
"13591","ENSACAG00000016930","2",109449699,109465951,16252
"13592","ENSACAG00000016931","5",5988467,6001265,12798
"13593","ENSACAG00000016932","GL343329.1",1110754,1137735,26981
"13594","ENSACAG00000016934","1",118078194,118096840,18646
"13595","ENSACAG00000016935","GL343426.1",793660,807215,13555
"13596","ENSACAG00000016936","6",66354573,66361665,7092
"13597","ENSACAG00000016937","GL343276.1",1792176,1805530,13354
"13598","ENSACAG00000016938","6",66365565,66401337,35772
"13599","ENSACAG00000016939","2",78814173,78888831,74658
"13600","ENSACAG00000016940","5",16673140,16845817,172677
"13601","ENSACAG00000016942","5",6023887,6078955,55068
"13602","ENSACAG00000016943","GL343717.1",87705,88732,1027
"13603","ENSACAG00000016944","1",22359222,22364877,5655
"13604","ENSACAG00000016945","2",109354914,109399688,44774
"13605","ENSACAG00000016946","2",142037696,142045439,7743
"13606","ENSACAG00000016947","GL343362.1",628535,686181,57646
"13607","ENSACAG00000016948","GL344156.1",49897,86450,36553
"13608","ENSACAG00000016949","GL343552.1",43175,83082,39907
"13609","ENSACAG00000016950","GL343487.1",228248,241650,13402
"13610","ENSACAG00000016951","1",22314264,22330979,16715
"13611","ENSACAG00000016952","GL343717.1",91913,100194,8281
"13612","ENSACAG00000016953","2",102532052,102558505,26453
"13613","ENSACAG00000016954","GL343276.1",1807242,1825083,17841
"13614","ENSACAG00000016955","1",22218683,22266359,47676
"13615","ENSACAG00000016958","2",78684169,78804893,120724
"13616","ENSACAG00000016959","AAWZ02038250",3966,12383,8417
"13617","ENSACAG00000016960","GL343426.1",788504,791757,3253
"13618","ENSACAG00000016962","GL343426.1",771258,785054,13796
"13619","ENSACAG00000016963","3",121499663,121544858,45195
"13620","ENSACAG00000016964","1",118106725,118120419,13694
"13621","ENSACAG00000016965","2",78629099,78643213,14114
"13622","ENSACAG00000016966","GL343382.1",640903,679471,38568
"13623","ENSACAG00000016967","GL344156.1",40337,43961,3624
"13624","ENSACAG00000016968","GL343329.1",1197670,1218701,21031
"13625","ENSACAG00000016969","GL344505.1",1964,11758,9794
"13626","ENSACAG00000016971","2",92175914,92205951,30037
"13627","ENSACAG00000016972","5",6200951,6224671,23720
"13628","ENSACAG00000016974","GL343329.1",1248755,1262413,13658
"13629","ENSACAG00000016975","5",129593486,129640532,47046
"13630","ENSACAG00000016977","3",66417728,66432073,14345
"13631","ENSACAG00000016978","GL343426.1",764151,768701,4550
"13632","ENSACAG00000016979","GL344112.1",44,12270,12226
"13633","ENSACAG00000016980","GL343492.1",602001,609501,7500
"13634","ENSACAG00000016981","2",78615537,78625295,9758
"13635","ENSACAG00000016982","1",22039723,22188632,148909
"13636","ENSACAG00000016984","6",66410377,66419733,9356
"13637","ENSACAG00000016985","5",16492623,16638547,145924
"13638","ENSACAG00000016986","3",66341540,66368928,27388
"13639","ENSACAG00000016987","2",91704519,91741882,37363
"13640","ENSACAG00000016988","GL343362.1",571013,581798,10785
"13641","ENSACAG00000016989","GL343276.1",1834641,1840401,5760
"13642","ENSACAG00000016990","GL343329.1",1286258,1355025,68767
"13643","ENSACAG00000016991","GL343426.1",760973,762000,1027
"13644","ENSACAG00000016993","2",78561048,78612021,50973
"13645","ENSACAG00000016994","GL343200.1",2340285,2457223,116938
"13646","ENSACAG00000016997","2",109213804,109321439,107635
"13647","ENSACAG00000016998","6",66446037,66468763,22726
"13648","ENSACAG00000017001","2",78483390,78491378,7988
"13649","ENSACAG00000017002","GL344341.1",27277,33511,6234
"13650","ENSACAG00000017003","2",109022921,109052169,29248
"13651","ENSACAG00000017005","GL344112.1",17882,67755,49873
"13652","ENSACAG00000017006","GL343487.1",243167,254378,11211
"13653","ENSACAG00000017007","GL343492.1",591794,600393,8599
"13654","ENSACAG00000017008","GL343362.1",559789,570976,11187
"13655","ENSACAG00000017009","2",102556327,102570272,13945
"13656","ENSACAG00000017010","GL343426.1",738539,758705,20166
"13657","ENSACAG00000017011","GL343200.1",2482752,2509947,27195
"13658","ENSACAG00000017012","GL344156.1",21,12616,12595
"13659","ENSACAG00000017013","6",66483805,66551297,67492
"13660","ENSACAG00000017014","2",102629233,102649145,19912
"13661","ENSACAG00000017016","5",16475543,16475704,161
"13662","ENSACAG00000017018","GL343316.1",166261,349686,183425
"13663","ENSACAG00000017019","GL343505.1",48884,81762,32878
"13664","ENSACAG00000017020","1",21990965,22021438,30473
"13665","ENSACAG00000017021","GL343382.1",685442,726611,41169
"13666","ENSACAG00000017022","2",102671214,102680418,9204
"13667","ENSACAG00000017023","GL343487.1",265378,319310,53932
"13668","ENSACAG00000017024","GL343426.1",631681,636729,5048
"13669","ENSACAG00000017025","2",142147917,142274542,126625
"13670","ENSACAG00000017026","1",118122497,118136031,13534
"13671","ENSACAG00000017027","2",102710700,102752278,41578
"13672","ENSACAG00000017029","5",6299880,6343443,43563
"13673","ENSACAG00000017030","GL344336.1",6444,21018,14574
"13674","ENSACAG00000017031","3",121548246,121580468,32222
"13675","ENSACAG00000017032","3",66296469,66324550,28081
"13676","ENSACAG00000017033","GL343200.1",2527975,2528629,654
"13677","ENSACAG00000017034","3",121600569,121620123,19554
"13678","ENSACAG00000017035","GL343200.1",2517137,2722437,205300
"13679","ENSACAG00000017036","1",118137443,118145619,8176
"13680","ENSACAG00000017037","GL343426.1",612820,621291,8471
"13681","ENSACAG00000017038","2",91661768,91678770,17002
"13682","ENSACAG00000017039","GL343505.1",83082,95637,12555
"13683","ENSACAG00000017040","2",78451256,78460079,8823
"13684","ENSACAG00000017041","GL343355.1",1113982,1132574,18592
"13685","ENSACAG00000017042","GL343362.1",544684,549131,4447
"13686","ENSACAG00000017044","GL343487.1",417208,440190,22982
"13687","ENSACAG00000017046","2",78358629,78367972,9343
"13688","ENSACAG00000017047","3",66204153,66257764,53611
"13689","ENSACAG00000017048","GL343362.1",530806,531531,725
"13690","ENSACAG00000017049","GL343362.1",506395,524947,18552
"13691","ENSACAG00000017050","3",121640391,121665422,25031
"13692","ENSACAG00000017051","GL343505.1",244879,252855,7976
"13693","ENSACAG00000017052","3",121764895,121796581,31686
"13694","ENSACAG00000017053","1",21902728,21983559,80831
"13695","ENSACAG00000017054","2",78120366,78346988,226622
"13696","ENSACAG00000017055","2",102756101,102761150,5049
"13697","ENSACAG00000017057","GL343505.1",267487,281600,14113
"13698","ENSACAG00000017058","GL343426.1",602827,610392,7565
"13699","ENSACAG00000017059","GL343355.1",1053621,1080206,26585
"13700","ENSACAG00000017060","1",21799056,21830281,31225
"13701","ENSACAG00000017061","GL343316.1",451728,496848,45120
"13702","ENSACAG00000017062","2",102766152,102779611,13459
"13703","ENSACAG00000017063","2",91633778,91651523,17745
"13704","ENSACAG00000017064","GL343362.1",475506,495659,20153
"13705","ENSACAG00000017065","AAWZ02039615",3100,8206,5106
"13706","ENSACAG00000017066","GL344772.1",1143,12396,11253
"13707","ENSACAG00000017070","2",102800065,102803282,3217
"13708","ENSACAG00000017071","1",21554050,21745117,191067
"13709","ENSACAG00000017072","GL343487.1",443248,451073,7825
"13710","ENSACAG00000017073","5",2904091,3268075,363984
"13711","ENSACAG00000017074","GL343493.1",557329,586712,29383
"13712","ENSACAG00000017077","GL343492.1",574750,581829,7079
"13713","ENSACAG00000017078","AAWZ02038533",7514,8707,1193
"13714","ENSACAG00000017079","2",91623172,91623339,167
"13715","ENSACAG00000017080","2",91595611,91620288,24677
"13716","ENSACAG00000017081","GL343493.1",503751,551762,48011
"13717","ENSACAG00000017082","2",102876402,102876965,563
"13718","ENSACAG00000017083","2",102911047,102925331,14284
"13719","ENSACAG00000017085","2",142280084,142343947,63863
"13720","ENSACAG00000017086","5",6342611,6356923,14312
"13721","ENSACAG00000017087","4",100683522,100800607,117085
"13722","ENSACAG00000017088","2",77882858,77886344,3486
"13723","ENSACAG00000017089","5",6362177,6379442,17265
"13724","ENSACAG00000017090","1",21397377,21413976,16599
"13725","ENSACAG00000017091","GL343487.1",477082,517851,40769
"13726","ENSACAG00000017092","2",77836732,77877712,40980
"13727","ENSACAG00000017093","6",66556686,66560645,3959
"13728","ENSACAG00000017095","GL343492.1",564052,569333,5281
"13729","ENSACAG00000017096","AAWZ02040341",171,6327,6156
"13730","ENSACAG00000017097","6",66572145,66587311,15166
"13731","ENSACAG00000017098","3",66170104,66205716,35612
"13732","ENSACAG00000017099","2",91497040,91566020,68980
"13733","ENSACAG00000017100","GL343382.1",730686,740498,9812
"13734","ENSACAG00000017101","GL343362.1",427320,451917,24597
"13735","ENSACAG00000017102","GL343493.1",435110,457153,22043
"13736","ENSACAG00000017103","5",3360839,3460148,99309
"13737","ENSACAG00000017105","2",102976595,103015462,38867
"13738","ENSACAG00000017106","2",77788848,77811124,22276
"13739","ENSACAG00000017107","2",142403386,142405146,1760
"13740","ENSACAG00000017109","2",142427709,142429966,2257
"13741","ENSACAG00000017111","GL343492.1",557252,562409,5157
"13742","ENSACAG00000017112","GL343382.1",783982,798541,14559
"13743","ENSACAG00000017113","1",21362620,21385940,23320
"13744","ENSACAG00000017114","GL343320.1",1441695,1452914,11219
"13745","ENSACAG00000017116","GL343355.1",954211,978020,23809
"13746","ENSACAG00000017117","GL343382.1",891540,916270,24730
"13747","ENSACAG00000017118","GL343362.1",399089,428802,29713
"13748","ENSACAG00000017119","GL344088.1",4915,15100,10185
"13749","ENSACAG00000017120","2",142444140,142531627,87487
"13750","ENSACAG00000017122","GL343426.1",579879,587195,7316
"13751","ENSACAG00000017123","GL343320.1",1343097,1362156,19059
"13752","ENSACAG00000017124","GL343492.1",536077,536616,539
"13753","ENSACAG00000017125","5",3267941,3349592,81651
"13754","ENSACAG00000017126","GL343492.1",499317,512073,12756
"13755","ENSACAG00000017129","GL343684.1",351953,357595,5642
"13756","ENSACAG00000017130","GL344088.1",19679,20785,1106
"13757","ENSACAG00000017131","3",66131015,66170633,39618
"13758","ENSACAG00000017132","5",6455903,6462423,6520
"13759","ENSACAG00000017133","2",91349448,91385712,36264
"13760","ENSACAG00000017134","GL344088.1",31499,39625,8126
"13761","ENSACAG00000017136","1",21043442,21056841,13399
"13762","ENSACAG00000017137","GL343355.1",896857,939287,42430
"13763","ENSACAG00000017139","5",6477657,6542422,64765
"13764","ENSACAG00000017140","6",66594823,66617619,22796
"13765","ENSACAG00000017141","2",77770708,77779899,9191
"13766","ENSACAG00000017142","1",20884567,20920212,35645
"13767","ENSACAG00000017144","GL343355.1",869426,890128,20702
"13768","ENSACAG00000017145","GL343320.1",1155734,1291393,135659
"13769","ENSACAG00000017150","GL343355.1",850179,858077,7898
"13770","ENSACAG00000017151","GL344088.1",42986,50843,7857
"13771","ENSACAG00000017152","5",3529736,3603275,73539
"13772","ENSACAG00000017153","GL343362.1",95896,279381,183485
"13773","ENSACAG00000017155","GL343382.1",955054,984969,29915
"13774","ENSACAG00000017156","2",91143152,91338859,195707
"13775","ENSACAG00000017158","1",20850258,20871863,21605
"13776","ENSACAG00000017159","3",65191921,65251045,59124
"13777","ENSACAG00000017160","GL343492.1",488304,496782,8478
"13778","ENSACAG00000017162","GL343487.1",551467,569376,17909
"13779","ENSACAG00000017163","6",66630553,66644580,14027
"13780","ENSACAG00000017164","GL343492.1",422340,423974,1634
"13781","ENSACAG00000017166","2",77729221,77741429,12208
"13782","ENSACAG00000017167","GL343492.1",388222,397508,9286
"13783","ENSACAG00000017168","6",66648923,66657285,8362
"13784","ENSACAG00000017169","GL343487.1",574486,590703,16217
"13785","ENSACAG00000017170","1",20784433,20818051,33618
"13786","ENSACAG00000017171","GL343557.1",293866,294873,1007
"13787","ENSACAG00000017172","2",103040822,103042643,1821
"13788","ENSACAG00000017173","2",103064922,103088794,23872
"13789","ENSACAG00000017174","GL344088.1",52545,73802,21257
"13790","ENSACAG00000017175","GL343355.1",839719,843782,4063
"13791","ENSACAG00000017176","GL344059.1",43449,61539,18090
"13792","ENSACAG00000017177","6",66660004,66675693,15689
"13793","ENSACAG00000017178","GL343355.1",794951,806638,11687
"13794","ENSACAG00000017179","6",66680243,66698413,18170
"13795","ENSACAG00000017180","GL343492.1",356206,386285,30079
"13796","ENSACAG00000017181","GL343426.1",567225,575736,8511
"13797","ENSACAG00000017185","GL343834.1",15323,17196,1873
"13798","ENSACAG00000017186","6",66727345,66766255,38910
"13799","ENSACAG00000017193","GL343834.1",8745,9576,831
"13800","ENSACAG00000017194","GL343438.1",534196,548181,13985
"13801","ENSACAG00000017195","AAWZ02041254",1301,1692,391
"13802","ENSACAG00000017196","GL343438.1",553757,560635,6878
"13803","ENSACAG00000017198","1",20771862,20784630,12768
"13804","ENSACAG00000017200","GL343487.1",618254,631732,13478
"13805","ENSACAG00000017201","GL343438.1",789167,808445,19278
"13806","ENSACAG00000017202","2",91108479,91132965,24486
"13807","ENSACAG00000017203","GL343426.1",560063,564107,4044
"13808","ENSACAG00000017204","2",103087494,103140662,53168
"13809","ENSACAG00000017205","GL343355.1",726203,740750,14547
"13810","ENSACAG00000017206","3",64673978,64804116,130138
"13811","ENSACAG00000017208","GL343623.1",42,50959,50917
"13812","ENSACAG00000017209","1",20732240,20747541,15301
"13813","ENSACAG00000017210","1",20728996,20731735,2739
"13814","ENSACAG00000017211","1",20719723,20727315,7592
"13815","ENSACAG00000017213","GL343426.1",554829,556602,1773
"13816","ENSACAG00000017214","1",20691912,20719589,27677
"13817","ENSACAG00000017215","GL343355.1",703301,714031,10730
"13818","ENSACAG00000017216","GL343426.1",521062,527408,6346
"13819","ENSACAG00000017218","GL343362.1",20413,40390,19977
"13820","ENSACAG00000017220","2",103176116,103239023,62907
"13821","ENSACAG00000017223","GL343355.1",568953,585726,16773
"13822","ENSACAG00000017224","GL343426.1",460888,473959,13071
"13823","ENSACAG00000017225","2",91098855,91105160,6305
"13824","ENSACAG00000017226","2",199477238,199610298,133060
"13825","ENSACAG00000017227","GL344059.1",65772,80351,14579
"13826","ENSACAG00000017228","6",66792162,66846551,54389
"13827","ENSACAG00000017231","2",91002323,91009405,7082
"13828","ENSACAG00000017232","GL343320.1",1132814,1150748,17934
"13829","ENSACAG00000017233","GL344059.1",86119,87994,1875
"13830","ENSACAG00000017234","GL343623.1",76403,79596,3193
"13831","ENSACAG00000017236","GL343623.1",161656,164814,3158
"13832","ENSACAG00000017237","GL343623.1",189608,217472,27864
"13833","ENSACAG00000017238","2",90974012,90981437,7425
"13834","ENSACAG00000017239","1",20673932,20690649,16717
"13835","ENSACAG00000017240","5",6549843,6564885,15042
"13836","ENSACAG00000017241","2",90966006,90969458,3452
"13837","ENSACAG00000017242","3",64392055,64488833,96778
"13838","ENSACAG00000017243","2",90836564,90950950,114386
"13839","ENSACAG00000017244","GL343320.1",1114410,1125352,10942
"13840","ENSACAG00000017247","GL343623.1",262745,283452,20707
"13841","ENSACAG00000017249","GL343320.1",1101113,1109825,8712
"13842","ENSACAG00000017250","GL344998.1",810,13144,12334
"13843","ENSACAG00000017251","GL343623.1",290208,299071,8863
"13844","ENSACAG00000017252","GL343355.1",541082,563083,22001
"13845","ENSACAG00000017255","GL344192.1",54323,60579,6256
"13846","ENSACAG00000017256","GL343320.1",1059034,1082897,23863
"13847","ENSACAG00000017257","1",20649279,20660223,10944
"13848","ENSACAG00000017258","GL343623.1",305510,323263,17753
"13849","ENSACAG00000017259","5",6564967,6581512,16545
"13850","ENSACAG00000017260","GL343426.1",458517,468170,9653
"13851","ENSACAG00000017261","1",20565013,20627574,62561
"13852","ENSACAG00000017262","GL344192.1",66,37997,37931
"13853","ENSACAG00000017263","2",103294418,103304723,10305
"13854","ENSACAG00000017264","5",6632857,6705670,72813
"13855","ENSACAG00000017265","GL343355.1",512736,531938,19202
"13856","ENSACAG00000017266","GL343320.1",1038265,1042602,4337
"13857","ENSACAG00000017268","GL343426.1",454849,459582,4733
"13858","ENSACAG00000017270","2",103323245,103378309,55064
"13859","ENSACAG00000017271","GL343426.1",445312,453771,8459
"13860","ENSACAG00000017275","AAWZ02036231",17334,28010,10676
"13861","ENSACAG00000017276","1",20512145,20528545,16400
"13862","ENSACAG00000017277","5",6770952,6846107,75155
"13863","ENSACAG00000017278","3",64366090,64378885,12795
"13864","ENSACAG00000017279","GL343355.1",503203,513757,10554
"13865","ENSACAG00000017281","GL343570.1",49157,51413,2256
"13866","ENSACAG00000017285","GL343426.1",412692,429478,16786
"13867","ENSACAG00000017286","1",20483591,20506141,22550
"13868","ENSACAG00000017287","1",197739427,197742431,3004
"13869","ENSACAG00000017288","1",197743546,197767191,23645
"13870","ENSACAG00000017289","AAWZ02036383",4725,11732,7007
"13871","ENSACAG00000017290","6",66863146,66897328,34182
"13872","ENSACAG00000017293","3",64117888,64360400,242512
"13873","ENSACAG00000017294","GL343426.1",56763,138496,81733
"13874","ENSACAG00000017296","GL343355.1",469329,482337,13008
"13875","ENSACAG00000017297","GL343320.1",966203,972795,6592
"13876","ENSACAG00000017298","2",103420049,103448729,28680
"13877","ENSACAG00000017299","2",57286779,57335546,48767
"13878","ENSACAG00000017300","GL343570.1",106605,156241,49636
"13879","ENSACAG00000017304","5",6864536,6894414,29878
"13880","ENSACAG00000017306","6",66900372,66931078,30706
"13881","ENSACAG00000017307","1",197761707,197834621,72914
"13882","ENSACAG00000017309","GL343570.1",165678,176647,10969
"13883","ENSACAG00000017310","GL343320.1",550999,944482,393483
"13884","ENSACAG00000017312","GL343570.1",282473,289695,7222
"13885","ENSACAG00000017313","1",20306755,20512053,205298
"13886","ENSACAG00000017314","GL343355.1",400983,460683,59700
"13887","ENSACAG00000017315","2",103451547,103490066,38519
"13888","ENSACAG00000017316","2",57578198,57612889,34691
"13889","ENSACAG00000017318","2",103498862,103526924,28062
"13890","ENSACAG00000017319","6",66953395,67038336,84941
"13891","ENSACAG00000017320","5",7179600,7599402,419802
"13892","ENSACAG00000017325","2",109072753,109100735,27982
"13893","ENSACAG00000017326","1",198153299,198207669,54370
"13894","ENSACAG00000017327","2",108995694,108998029,2335
"13895","ENSACAG00000017328","1",19484220,20044025,559805
"13896","ENSACAG00000017331","GL343570.1",332689,381570,48881
"13897","ENSACAG00000017332","2",108951248,109016986,65738
"13898","ENSACAG00000017333","2",103611235,103656927,45692
"13899","ENSACAG00000017334","2",77227200,77330826,103626
"13900","ENSACAG00000017335","GL343355.1",375475,385644,10169
"13901","ENSACAG00000017336","3",63960005,63972690,12685
"13902","ENSACAG00000017337","GL343843.1",1343,15452,14109
"13903","ENSACAG00000017339","GL343570.1",380838,401440,20602
"13904","ENSACAG00000017340","GL343197.1",4551804,4555422,3618
"13905","ENSACAG00000017341","1",198454415,198469227,14812
"13906","ENSACAG00000017342","GL343843.1",60227,60745,518
"13907","ENSACAG00000017343","2",103663742,103678566,14824
"13908","ENSACAG00000017344","GL343843.1",105086,126684,21598
"13909","ENSACAG00000017345","1",198793459,198795139,1680
"13910","ENSACAG00000017346","6",67045952,67181879,135927
"13911","ENSACAG00000017347","1",199154509,199207313,52804
"13912","ENSACAG00000017349","GL343590.1",37675,78949,41274
"13913","ENSACAG00000017350","GL343355.1",247326,272132,24806
"13914","ENSACAG00000017351","GL343355.1",211465,234237,22772
"13915","ENSACAG00000017352","5",8145681,8206174,60493
"13916","ENSACAG00000017353","2",57671954,57709291,37337
"13917","ENSACAG00000017357","GL343843.1",128109,143083,14974
"13918","ENSACAG00000017358","6",67068976,67069555,579
"13919","ENSACAG00000017359","6",67234673,67257984,23311
"13920","ENSACAG00000017360","1",18653983,19233188,579205
"13921","ENSACAG00000017362","2",90183325,90558440,375115
"13922","ENSACAG00000017363","2",103680964,103703579,22615
"13923","ENSACAG00000017365","1",18488615,18503777,15162
"13924","ENSACAG00000017366","1",199212287,199216609,4322
"13925","ENSACAG00000017367","3",63888646,63945084,56438
"13926","ENSACAG00000017368","1",199248885,199310737,61852
"13927","ENSACAG00000017369","GL344948.1",1232,8033,6801
"13928","ENSACAG00000017371","1",17993365,18259911,266546
"13929","ENSACAG00000017372","2",57727125,57787236,60111
"13930","ENSACAG00000017373","2",103716352,103728984,12632
"13931","ENSACAG00000017374","2",57819432,57844407,24975
"13932","ENSACAG00000017376","GL344178.1",978,1532,554
"13933","ENSACAG00000017377","GL344178.1",8097,14576,6479
"13934","ENSACAG00000017380","5",8219144,8225719,6575
"13935","ENSACAG00000017381","6",51428941,51780744,351803
"13936","ENSACAG00000017383","AAWZ02038284",21,12217,12196
"13937","ENSACAG00000017384","2",57885019,57920156,35137
"13938","ENSACAG00000017386","GL344178.1",17994,24787,6793
"13939","ENSACAG00000017390","6",51408195,51413860,5665
"13940","ENSACAG00000017392","GL343242.1",1281712,1283751,2039
"13941","ENSACAG00000017394","GL343242.1",1874870,1913470,38600
"13942","ENSACAG00000017398","2",103735152,103776001,40849
"13943","ENSACAG00000017402","2",57928634,57940156,11522
"13944","ENSACAG00000017404","GL343355.1",167031,175434,8403
"13945","ENSACAG00000017405","GL343320.1",409277,549012,139735
"13946","ENSACAG00000017406","6",51109057,51161436,52379
"13947","ENSACAG00000017407","6",67285088,67297824,12736
"13948","ENSACAG00000017408","3",63843010,63895087,52077
"13949","ENSACAG00000017409","1",199341929,199404717,62788
"13950","ENSACAG00000017410","GL343242.1",1943436,1950034,6598
"13951","ENSACAG00000017412","2",57950006,58269436,319430
"13952","ENSACAG00000017415","GL343320.1",314276,400252,85976
"13953","ENSACAG00000017416","GL343242.1",1964040,2105857,141817
"13954","ENSACAG00000017417","GL343242.1",2142697,2199664,56967
"13955","ENSACAG00000017418","2",58607268,58769401,162133
"13956","ENSACAG00000017419","GL343320.1",4490,218611,214121
"13957","ENSACAG00000017422","6",67321178,67361701,40523
"13958","ENSACAG00000017423","GL343355.1",98225,113689,15464
"13959","ENSACAG00000017424","1",199480286,199510749,30463
"13960","ENSACAG00000017425","3",63710713,63804495,93782
"13961","ENSACAG00000017430","AAWZ02037605",9764,12495,2731
"13962","ENSACAG00000017431","1",17893254,17904674,11420
"13963","ENSACAG00000017432","GL344189.1",13995,29085,15090
"13964","ENSACAG00000017434","2",81329232,81364300,35068
"13965","ENSACAG00000017435","2",58770963,58777732,6769
"13966","ENSACAG00000017436","2",58780455,58805593,25138
"13967","ENSACAG00000017437","AAWZ02040345",454,7035,6581
"13968","ENSACAG00000017438","3",59827942,59904198,76256
"13969","ENSACAG00000017439","2",81436029,81459930,23901
"13970","ENSACAG00000017440","5",8298582,8305508,6926
"13971","ENSACAG00000017441","2",81518110,81535131,17021
"13972","ENSACAG00000017442","5",8325221,8353497,28276
"13973","ENSACAG00000017443","1",17791858,17879714,87856
"13974","ENSACAG00000017444","GL344117.1",13876,16144,2268
"13975","ENSACAG00000017447","2",81549095,81590307,41212
"13976","ENSACAG00000017448","3",59905509,59916324,10815
"13977","ENSACAG00000017449","GL343489.1",485846,487297,1451
"13978","ENSACAG00000017450","2",108837287,108843762,6475
"13979","ENSACAG00000017451","2",108823636,108829955,6319
"13980","ENSACAG00000017452","3",59937330,59973406,36076
"13981","ENSACAG00000017453","2",161755890,161775075,19185
"13982","ENSACAG00000017454","1",17736669,17774663,37994
"13983","ENSACAG00000017455","6",67405902,67415524,9622
"13984","ENSACAG00000017456","GL344298.1",6465,24954,18489
"13985","ENSACAG00000017457","2",108743236,108794026,50790
"13986","ENSACAG00000017458","2",58819315,58820529,1214
"13987","ENSACAG00000017459","2",58847441,58894847,47406
"13988","ENSACAG00000017460","2",103777495,104067911,290416
"13989","ENSACAG00000017462","GL344298.1",26482,28332,1850
"13990","ENSACAG00000017463","6",51052644,51078406,25762
"13991","ENSACAG00000017464","2",161385257,161398024,12767
"13992","ENSACAG00000017465","GL343355.1",68638,89200,20562
"13993","ENSACAG00000017466","2",81594900,81601337,6437
"13994","ENSACAG00000017467","3",59981866,59988408,6542
"13995","ENSACAG00000017468","3",59989615,59995165,5550
"13996","ENSACAG00000017469","6",67440308,67503404,63096
"13997","ENSACAG00000017470","6",50952171,51016356,64185
"13998","ENSACAG00000017471","3",60001080,60017584,16504
"13999","ENSACAG00000017472","1",77015695,77023314,7619
"14000","ENSACAG00000017473","2",108622317,108750010,127693
"14001","ENSACAG00000017475","GL343591.1",16157,77793,61636
"14002","ENSACAG00000017476","1",77021993,77115795,93802
"14003","ENSACAG00000017477","2",81615382,81697894,82512
"14004","ENSACAG00000017478","GL343355.1",26562,34501,7939
"14005","ENSACAG00000017479","GL343717.1",159859,181571,21712
"14006","ENSACAG00000017481","6",50814562,50846178,31616
"14007","ENSACAG00000017482","6",67574902,67611383,36481
"14008","ENSACAG00000017483","1",77089333,77108440,19107
"14009","ENSACAG00000017484","5",8382878,8408937,26059
"14010","ENSACAG00000017485","GL343717.1",190415,191578,1163
"14011","ENSACAG00000017486","5",8410455,8428198,17743
"14012","ENSACAG00000017487","5",8441032,8473311,32279
"14013","ENSACAG00000017488","GL343717.1",208040,216141,8101
"14014","ENSACAG00000017489","1",77119042,77127931,8889
"14015","ENSACAG00000017490","3",60146598,60156467,9869
"14016","ENSACAG00000017491","2",108417166,108434964,17798
"14017","ENSACAG00000017492","6",50595885,50805059,209174
"14018","ENSACAG00000017493","3",60206108,60216841,10733
"14019","ENSACAG00000017494","3",60225524,60252878,27354
"14020","ENSACAG00000017495","1",77130430,77139418,8988
"14021","ENSACAG00000017496","2",108238928,108403229,164301
"14022","ENSACAG00000017497","1",77168530,77179541,11011
"14023","ENSACAG00000017499","GL343717.1",249182,253080,3898
"14024","ENSACAG00000017500","GL343355.1",5041,20804,15763
"14025","ENSACAG00000017503","3",60719014,60752637,33623
"14026","ENSACAG00000017504","3",60819892,60888936,69044
"14027","ENSACAG00000017505","6",67619713,67716979,97266
"14028","ENSACAG00000017506","2",58982189,59009472,27283
"14029","ENSACAG00000017507","GL343717.1",250955,272801,21846
"14030","ENSACAG00000017508","6",50532163,50544542,12379
"14031","ENSACAG00000017510","1",77187790,77194544,6754
"14032","ENSACAG00000017511","6",50521783,50534300,12517
"14033","ENSACAG00000017513","1",77195334,77229580,34246
"14034","ENSACAG00000017514","5",8490071,8565571,75500
"14035","ENSACAG00000017515","2",59016411,59051436,35025
"14036","ENSACAG00000017518","GL343220.1",278176,285704,7528
"14037","ENSACAG00000017520","6",67729379,67751060,21681
"14038","ENSACAG00000017521","2",60511637,60669645,158008
"14039","ENSACAG00000017522","GL343295.1",1453791,1557575,103784
"14040","ENSACAG00000017524","GL343220.1",174216,183408,9192
"14041","ENSACAG00000017526","1",77237493,77245705,8212
"14042","ENSACAG00000017527","GL343220.1",187813,190263,2450
"14043","ENSACAG00000017531","5",8970271,8988252,17981
"14044","ENSACAG00000017532","3",61065430,61090073,24643
"14045","ENSACAG00000017533","GL343220.1",113517,122601,9084
"14046","ENSACAG00000017534","GL343220.1",86772,87161,389
"14047","ENSACAG00000017536","2",108344075,108348249,4174
"14048","ENSACAG00000017537","2",61204738,61210068,5330
"14049","ENSACAG00000017538","GL343248.1",651085,651717,632
"14050","ENSACAG00000017539","1",77245880,77254130,8250
"14051","ENSACAG00000017540","GL343220.1",79800,80914,1114
"14052","ENSACAG00000017541","6",67783549,67800200,16651
"14053","ENSACAG00000017542","GL343591.1",112646,149235,36589
"14054","ENSACAG00000017543","3",61628416,61651905,23489
"14055","ENSACAG00000017544","2",61354501,61364127,9626
"14056","ENSACAG00000017545","GL343220.1",65313,78262,12949
"14057","ENSACAG00000017546","6",50513945,50515189,1244
"14058","ENSACAG00000017547","6",49909134,50165506,256372
"14059","ENSACAG00000017549","2",61441557,61470986,29429
"14060","ENSACAG00000017551","2",104100647,104276605,175958
"14061","ENSACAG00000017552","GL343235.1",2331069,2354574,23505
"14062","ENSACAG00000017553","2",107923143,107957013,33870
"14063","ENSACAG00000017556","2",104900988,104939017,38029
"14064","ENSACAG00000017557","GL343591.1",162484,176977,14493
"14065","ENSACAG00000017558","2",81818136,81823316,5180
"14066","ENSACAG00000017559","2",107734930,107753455,18525
"14067","ENSACAG00000017560","5",9017528,9221493,203965
"14068","ENSACAG00000017561","6",67945294,67946466,1172
"14069","ENSACAG00000017562","2",81840735,81849693,8958
"14070","ENSACAG00000017563","2",81871037,81895165,24128
"14071","ENSACAG00000017564","3",61692888,61922714,229826
"14072","ENSACAG00000017567","2",106956463,107110230,153767
"14073","ENSACAG00000017568","GL343591.1",180348,225973,45625
"14074","ENSACAG00000017569","2",82170608,82275900,105292
"14075","ENSACAG00000017570","GL343220.1",54351,65134,10783
"14076","ENSACAG00000017576","6",49715246,49731227,15981
"14077","ENSACAG00000017577","GL343728.1",88759,176566,87807
"14078","ENSACAG00000017578","GL343235.1",2273171,2283525,10354
"14079","ENSACAG00000017579","2",104959896,105043660,83764
"14080","ENSACAG00000017581","6",48933040,48957145,24105
"14081","ENSACAG00000017582","2",106895052,106935514,40462
"14082","ENSACAG00000017584","GL343591.1",231756,232200,444
"14083","ENSACAG00000017585","2",61727483,61962589,235106
"14084","ENSACAG00000017586","2",106438156,106478264,40108
"14085","ENSACAG00000017587","GL343235.1",2236871,2272751,35880
"14086","ENSACAG00000017588","GL344304.1",26465,27025,560
"14087","ENSACAG00000017589","GL343220.1",4000,14430,10430
"14088","ENSACAG00000017590","GL343247.1",2019994,2045752,25758
"14089","ENSACAG00000017592","5",9439658,9502081,62423
"14090","ENSACAG00000017593","GL343743.1",182374,204980,22606
"14091","ENSACAG00000017595","2",106357382,106385636,28254
"14092","ENSACAG00000017596","6",48917705,48921968,4263
"14093","ENSACAG00000017597","6",48864614,48906618,42004
"14094","ENSACAG00000017598","GL343728.1",206949,228911,21962
"14095","ENSACAG00000017599","AAWZ02038095",1819,3661,1842
"14096","ENSACAG00000017600","2",82311375,82394845,83470
"14097","ENSACAG00000017601","GL343235.1",2159671,2215633,55962
"14098","ENSACAG00000017602","GL343247.1",1986740,2010927,24187
"14099","ENSACAG00000017603","GL343235.1",2092437,2125756,33319
"14100","ENSACAG00000017604","GL343728.1",240642,275884,35242
"14101","ENSACAG00000017605","6",48833014,48848806,15792
"14102","ENSACAG00000017607","3",10755679,10858144,102465
"14103","ENSACAG00000017609","6",48790767,48799155,8388
"14104","ENSACAG00000017612","6",48684466,48703152,18686
"14105","ENSACAG00000017613","2",106172688,106179413,6725
"14106","ENSACAG00000017614","2",61994903,62152162,157259
"14107","ENSACAG00000017615","3",10614291,10617143,2852
"14108","ENSACAG00000017616","3",9586933,9660643,73710
"14109","ENSACAG00000017617","6",48028572,48180735,152163
"14110","ENSACAG00000017619","GL343247.1",1924750,1948671,23921
"14111","ENSACAG00000017620","GL343876.1",120394,182236,61842
"14112","ENSACAG00000017622","1",240524171,240580811,56640
"14113","ENSACAG00000017623","GL343743.1",175914,181386,5472
"14114","ENSACAG00000017625","2",62282114,62397912,115798
"14115","ENSACAG00000017627","2",106145348,106170865,25517
"14116","ENSACAG00000017628","GL343743.1",161823,172544,10721
"14117","ENSACAG00000017629","2",62424966,62450138,25172
"14118","ENSACAG00000017630","2",106117970,106141370,23400
"14119","ENSACAG00000017632","GL343743.1",136566,137636,1070
"14120","ENSACAG00000017633","GL343235.1",2024884,2061882,36998
"14121","ENSACAG00000017634","2",62461302,62470296,8994
"14122","ENSACAG00000017635","GL343743.1",85865,111075,25210
"14123","ENSACAG00000017636","2",105955241,105992727,37486
"14124","ENSACAG00000017639","2",82488529,82532883,44354
"14125","ENSACAG00000017640","GL343235.1",1979066,2012173,33107
"14126","ENSACAG00000017641","GL343247.1",1727253,1737245,9992
"14127","ENSACAG00000017642","GL343247.1",1696198,1710891,14693
"14128","ENSACAG00000017643","2",62476030,62579985,103955
"14129","ENSACAG00000017644","GL343743.1",79684,83975,4291
"14130","ENSACAG00000017645","GL343743.1",63482,70782,7300
"14131","ENSACAG00000017646","2",105931736,105939562,7826
"14132","ENSACAG00000017648","2",82531360,82552642,21282
"14133","ENSACAG00000017650","GL343247.1",1577593,1601856,24263
"14134","ENSACAG00000017651","6",47909090,48019797,110707
"14135","ENSACAG00000017652","2",105789219,105920659,131440
"14136","ENSACAG00000017653","GL343743.1",52034,61000,8966
"14137","ENSACAG00000017654","GL343197.1",175368,214055,38687
"14138","ENSACAG00000017655","GL345029.1",652,13129,12477
"14139","ENSACAG00000017657","GL343235.1",1849741,1868414,18673
"14140","ENSACAG00000017658","6",47875665,47904779,29114
"14141","ENSACAG00000017659","GL344458.1",12108,27729,15621
"14142","ENSACAG00000017660","GL343247.1",1391041,1433975,42934
"14143","ENSACAG00000017661","GL343620.1",84683,106217,21534
"14144","ENSACAG00000017662","GL343247.1",1132804,1250195,117391
"14145","ENSACAG00000017663","2",82552997,82574280,21283
"14146","ENSACAG00000017664","GL343743.1",40787,50983,10196
"14147","ENSACAG00000017665","6",47811855,47825308,13453
"14148","ENSACAG00000017667","GL343743.1",27275,36062,8787
"14149","ENSACAG00000017668","6",47778949,47788666,9717
"14150","ENSACAG00000017669","2",105110163,105120855,10692
"14151","ENSACAG00000017670","GL343247.1",1065224,1078450,13226
"14152","ENSACAG00000017671","GL343197.1",215040,235837,20797
"14153","ENSACAG00000017672","2",62618318,62659301,40983
"14154","ENSACAG00000017673","2",82595621,82615288,19667
"14155","ENSACAG00000017674","GL343743.1",16295,21765,5470
"14156","ENSACAG00000017675","2",105139978,105174103,34125
"14157","ENSACAG00000017676","1",184936340,185067375,131035
"14158","ENSACAG00000017677","GL343247.1",1045759,1055254,9495
"14159","ENSACAG00000017680","GL343235.1",1794007,1795155,1148
"14160","ENSACAG00000017681","2",105188555,105190522,1967
"14161","ENSACAG00000017682","2",105202885,105235090,32205
"14162","ENSACAG00000017684","GL343235.1",1787800,1790385,2585
"14163","ENSACAG00000017686","2",82699886,82747244,47358
"14164","ENSACAG00000017687","GL343197.1",239961,290311,50350
"14165","ENSACAG00000017688","1",184997977,184998132,155
"14166","ENSACAG00000017689","1",184821277,184860603,39326
"14167","ENSACAG00000017690","6",47159539,47460549,301010
"14168","ENSACAG00000017691","GL343235.1",1670051,1779263,109212
"14169","ENSACAG00000017692","GL343247.1",1017320,1044452,27132
"14170","ENSACAG00000017693","GL343247.1",964569,998113,33544
"14171","ENSACAG00000017694","2",105263903,105304192,40289
"14172","ENSACAG00000017695","GL343235.1",1578185,1640139,61954
"14173","ENSACAG00000017696","GL343620.1",191549,223015,31466
"14174","ENSACAG00000017697","GL343743.1",2775,3391,616
"14175","ENSACAG00000017698","1",184835657,184842838,7181
"14176","ENSACAG00000017699","2",62724064,63050968,326904
"14177","ENSACAG00000017700","1",184675557,184806387,130830
"14178","ENSACAG00000017701","GL343247.1",945456,950375,4919
"14179","ENSACAG00000017705","GL343247.1",837089,879278,42189
"14180","ENSACAG00000017706","GL343197.1",343815,352447,8632
"14181","ENSACAG00000017708","2",105347723,105348226,503
"14182","ENSACAG00000017709","GL343197.1",379625,403040,23415
"14183","ENSACAG00000017710","2",105387248,105536162,148914
"14184","ENSACAG00000017711","GL343247.1",765135,801451,36316
"14185","ENSACAG00000017713","GL343235.1",967443,1250731,283288
"14186","ENSACAG00000017714","GL343332.1",1327009,1338030,11021
"14187","ENSACAG00000017715","GL343247.1",642817,733765,90948
"14188","ENSACAG00000017716","2",105543026,105636062,93036
"14189","ENSACAG00000017718","1",184543979,184602541,58562
"14190","ENSACAG00000017719","2",36373756,36523572,149816
"14191","ENSACAG00000017722","GL343197.1",433549,467281,33732
"14192","ENSACAG00000017724","2",105651474,105676807,25333
"14193","ENSACAG00000017725","GL343235.1",938533,939611,1078
"14194","ENSACAG00000017726","2",105682948,105724480,41532
"14195","ENSACAG00000017727","GL343235.1",904491,933494,29003
"14196","ENSACAG00000017728","GL344974.1",955,13099,12144
"14197","ENSACAG00000017730","GL343197.1",667279,701711,34432
"14198","ENSACAG00000017732","GL343247.1",182954,203661,20707
"14199","ENSACAG00000017734","GL343609.1",106643,125414,18771
"14200","ENSACAG00000017735","3",130880519,130882665,2146
"14201","ENSACAG00000017736","AAWZ02039198",61,6858,6797
"14202","ENSACAG00000017737","4",67450406,67451038,632
"14203","ENSACAG00000017738","2",36095150,36340460,245310
"14204","ENSACAG00000017739","GL343235.1",856889,870945,14056
"14205","ENSACAG00000017741","GL343235.1",852576,854425,1849
"14206","ENSACAG00000017742","GL343197.1",1756752,2117868,361116
"14207","ENSACAG00000017743","2",35533072,35557313,24241
"14208","ENSACAG00000017744","GL343629.1",2924,61699,58775
"14209","ENSACAG00000017745","GL343235.1",838946,844877,5931
"14210","ENSACAG00000017746","GL343235.1",818837,835884,17047
"14211","ENSACAG00000017747","AAWZ02036688",747,4119,3372
"14212","ENSACAG00000017748","GL343609.1",69052,87072,18020
"14213","ENSACAG00000017749","GL344727.1",7566,9014,1448
"14214","ENSACAG00000017750","GL343235.1",784030,823242,39212
"14215","ENSACAG00000017751","AAWZ02039308",984,3325,2341
"14216","ENSACAG00000017752","2",35089607,35307382,217775
"14217","ENSACAG00000017753","AAWZ02036994",5714,16823,11109
"14218","ENSACAG00000017754","GL343197.1",2191216,2699069,507853
"14219","ENSACAG00000017755","GL343609.1",27358,59904,32546
"14220","ENSACAG00000017756","2",196185385,196203432,18047
"14221","ENSACAG00000017757","2",35032849,35076600,43751
"14222","ENSACAG00000017758","GL343235.1",747177,783410,36233
"14223","ENSACAG00000017760","2",196279916,196430803,150887
"14224","ENSACAG00000017762","GL343629.1",64839,79434,14595
"14225","ENSACAG00000017763","2",196353826,196426421,72595
"14226","ENSACAG00000017764","GL343480.1",565903,571184,5281
"14227","ENSACAG00000017765","2",34996529,35027525,30996
"14228","ENSACAG00000017766","GL343629.1",93907,108254,14347
"14229","ENSACAG00000017767","GL343480.1",486960,512682,25722
"14230","ENSACAG00000017768","3",48844590,48958494,113904
"14231","ENSACAG00000017769","GL343235.1",706284,741993,35709
"14232","ENSACAG00000017770","2",34726671,34940858,214187
"14233","ENSACAG00000017771","GL343480.1",457674,467832,10158
"14234","ENSACAG00000017773","GL343480.1",448001,453698,5697
"14235","ENSACAG00000017774","GL343480.1",428473,442606,14133
"14236","ENSACAG00000017775","GL344241.1",609,14241,13632
"14237","ENSACAG00000017776","GL344241.1",17761,49226,31465
"14238","ENSACAG00000017779","GL343235.1",670992,675618,4626
"14239","ENSACAG00000017780","2",34582468,34675284,92816
"14240","ENSACAG00000017781","GL343480.1",390850,426185,35335
"14241","ENSACAG00000017782","3",48801361,48832837,31476
"14242","ENSACAG00000017783","GL343235.1",474437,531447,57010
"14243","ENSACAG00000017784","GL343235.1",439387,458713,19326
"14244","ENSACAG00000017785","GL343235.1",410221,436627,26406
"14245","ENSACAG00000017786","3",48791144,48804765,13621
"14246","ENSACAG00000017787","GL343480.1",369411,374084,4673
"14247","ENSACAG00000017788","GL343480.1",353083,353985,902
"14248","ENSACAG00000017789","2",196481438,196582441,101003
"14249","ENSACAG00000017790","GL343480.1",330907,338625,7718
"14250","ENSACAG00000017791","GL343480.1",295141,313859,18718
"14251","ENSACAG00000017792","2",34571527,34574452,2925
"14252","ENSACAG00000017793","3",48753865,48758051,4186
"14253","ENSACAG00000017794","2",34520540,34562348,41808
"14254","ENSACAG00000017796","GL343235.1",380598,387581,6983
"14255","ENSACAG00000017797","GL343235.1",356428,372294,15866
"14256","ENSACAG00000017798","2",34156827,34354408,197581
"14257","ENSACAG00000017800","2",196625789,196705906,80117
"14258","ENSACAG00000017801","GL343480.1",275073,292818,17745
"14259","ENSACAG00000017802","2",196730213,196731991,1778
"14260","ENSACAG00000017803","AAWZ02040336",21,6884,6863
"14261","ENSACAG00000017804","GL343480.1",220624,272565,51941
"14262","ENSACAG00000017805","GL343235.1",339340,351967,12627
"14263","ENSACAG00000017806","GL343276.1",314310,322731,8421
"14264","ENSACAG00000017808","GL343276.1",196397,204183,7786
"14265","ENSACAG00000017809","GL343480.1",199586,208031,8445
"14266","ENSACAG00000017810","GL343276.1",134998,165939,30941
"14267","ENSACAG00000017811","AAWZ02037582",1094,13940,12846
"14268","ENSACAG00000017812","GL343235.1",321989,330027,8038
"14269","ENSACAG00000017813","GL343480.1",173848,182125,8277
"14270","ENSACAG00000017814","GL343235.1",312795,317274,4479
"14271","ENSACAG00000017816","GL343235.1",189177,221060,31883
"14272","ENSACAG00000017817","GL343276.1",106481,134775,28294
"14273","ENSACAG00000017818","GL343480.1",158868,159932,1064
"14274","ENSACAG00000017821","GL343480.1",135920,147423,11503
"14275","ENSACAG00000017824","GL343276.1",33115,42708,9593
"14276","ENSACAG00000017826","GL343480.1",38069,103476,65407
"14277","ENSACAG00000017828","GL343276.1",5004,22070,17066
"14278","ENSACAG00000017829","GL343464.1",439490,443980,4490
"14279","ENSACAG00000017830","GL343207.1",3994336,4032722,38386
"14280","ENSACAG00000017831","GL343464.1",378447,393469,15022
"14281","ENSACAG00000017832","3",137211335,137260627,49292
"14282","ENSACAG00000017833","GL343464.1",366359,367249,890
"14283","ENSACAG00000017835","GL343464.1",254789,329955,75166
"14284","ENSACAG00000017836","3",137175238,137194454,19216
"14285","ENSACAG00000017837","3",137146449,137151667,5218
"14286","ENSACAG00000017838","GL343207.1",3967092,3980002,12910
"14287","ENSACAG00000017840","GL343464.1",249216,257611,8395
"14288","ENSACAG00000017841","3",136952542,136967106,14564
"14289","ENSACAG00000017842","GL343207.1",3859127,3883207,24080
"14290","ENSACAG00000017843","GL343464.1",227170,230821,3651
"14291","ENSACAG00000017844","GL343464.1",208488,215084,6596
"14292","ENSACAG00000017845","GL343464.1",201857,203663,1806
"14293","ENSACAG00000017846","GL343464.1",180853,185818,4965
"14294","ENSACAG00000017847","GL343464.1",165908,167869,1961
"14295","ENSACAG00000017848","GL343464.1",142174,162265,20091
"14296","ENSACAG00000017849","3",136772009,136799621,27612
"14297","ENSACAG00000017850","GL343207.1",3805417,3839913,34496
"14298","ENSACAG00000017851","3",136735017,136765865,30848
"14299","ENSACAG00000017852","GL343464.1",102266,114237,11971
"14300","ENSACAG00000017853","3",136641341,136707658,66317
"14301","ENSACAG00000017854","GL343207.1",3774569,3780358,5789
"14302","ENSACAG00000017855","GL343464.1",6005,52673,46668
"14303","ENSACAG00000017856","3",136471240,136591481,120241
"14304","ENSACAG00000017857","GL343207.1",3762842,3774773,11931
"14305","ENSACAG00000017858","3",136374006,136441222,67216
"14306","ENSACAG00000017859","GL343207.1",3478335,3574256,95921
"14307","ENSACAG00000017860","6",70606275,70614367,8092
"14308","ENSACAG00000017861","3",136342867,136368012,25145
"14309","ENSACAG00000017862","GL343501.1",477265,564142,86877
"14310","ENSACAG00000017863","GL343207.1",3443845,3451871,8026
"14311","ENSACAG00000017865","3",136323508,136338724,15216
"14312","ENSACAG00000017867","GL343207.1",3421436,3436052,14616
"14313","ENSACAG00000017868","6",70647762,70661465,13703
"14314","ENSACAG00000017872","GL343207.1",3385285,3408408,23123
"14315","ENSACAG00000017873","3",136293340,136315406,22066
"14316","ENSACAG00000017875","3",135791376,135826081,34705
"14317","ENSACAG00000017877","3",135620858,135783794,162936
"14318","ENSACAG00000017879","6",70841228,70856140,14912
"14319","ENSACAG00000017880","GL343207.1",3311437,3374698,63261
"14320","ENSACAG00000017882","GL343207.1",3145987,3189190,43203
"14321","ENSACAG00000017883","GL343207.1",2608962,2713286,104324
"14322","ENSACAG00000017884","GL343224.1",1597405,1608069,10664
"14323","ENSACAG00000017885","GL343207.1",2437151,2583695,146544
"14324","ENSACAG00000017886","GL343501.1",461184,477252,16068
"14325","ENSACAG00000017887","6",71024354,71059526,35172
"14326","ENSACAG00000017888","GL344470.1",37989,41014,3025
"14327","ENSACAG00000017889","6",71138167,71214877,76710
"14328","ENSACAG00000017890","GL343501.1",270572,357301,86729
"14329","ENSACAG00000017891","3",9340903,9492031,151128
"14330","ENSACAG00000017892","3",9311759,9336131,24372
"14331","ENSACAG00000017893","3",9179512,9225525,46013
"14332","ENSACAG00000017894","3",135488448,135511207,22759
"14333","ENSACAG00000017895","GL343501.1",41664,122234,80570
"14334","ENSACAG00000017896","3",9134308,9143804,9496
"14335","ENSACAG00000017897","3",135343159,135439502,96343
"14336","ENSACAG00000017898","3",8959329,9101810,142481
"14337","ENSACAG00000017899","6",71292275,71314649,22374
"14338","ENSACAG00000017900","GL343794.1",3908,12010,8102
"14339","ENSACAG00000017901","AAWZ02037050",150,16592,16442
"14340","ENSACAG00000017902","3",135237657,135272503,34846
"14341","ENSACAG00000017903","3",135149801,135182394,32593
"14342","ENSACAG00000017904","GL343356.1",402731,409310,6579
"14343","ENSACAG00000017905","GL343356.1",478136,480351,2215
"14344","ENSACAG00000017908","6",71352843,71360031,7188
"14345","ENSACAG00000017909","GL343356.1",518262,536480,18218
"14346","ENSACAG00000017910","GL343356.1",540758,544447,3689
"14347","ENSACAG00000017912","6",71463186,71577985,114799
"14348","ENSACAG00000017915","GL343356.1",597232,604336,7104
"14349","ENSACAG00000017916","GL343356.1",628378,632437,4059
"14350","ENSACAG00000017917","GL343356.1",733259,805986,72727
"14351","ENSACAG00000017918","3",135069134,135125415,56281
"14352","ENSACAG00000017919","6",71581944,71582837,893
"14353","ENSACAG00000017920","6",71600075,71632853,32778
"14354","ENSACAG00000017921","6",71630181,71680265,50084
"14355","ENSACAG00000017923","4",127888751,127923605,34854
"14356","ENSACAG00000017924","3",134161935,134351388,189453
"14357","ENSACAG00000017925","4",128061738,128079004,17266
"14358","ENSACAG00000017926","3",134256723,134257700,977
"14359","ENSACAG00000017927","3",134143264,134145101,1837
"14360","ENSACAG00000017928","3",134104469,134125049,20580
"14361","ENSACAG00000017929","4",128106153,128163427,57274
"14362","ENSACAG00000017930","6",71658369,71680206,21837
"14363","ENSACAG00000017932","6",71790428,71889012,98584
"14364","ENSACAG00000017933","3",134050846,134057531,6685
"14365","ENSACAG00000017934","4",128165831,128190426,24595
"14366","ENSACAG00000017936","6",72357822,72403692,45870
"14367","ENSACAG00000017937","3",133958557,134041276,82719
"14368","ENSACAG00000017938","4",128197798,128230220,32422
"14369","ENSACAG00000017939","6",72420099,72448676,28577
"14370","ENSACAG00000017940","6",72499174,72521804,22630
"14371","ENSACAG00000017941","4",128234464,128276561,42097
"14372","ENSACAG00000017942","4",128291472,128327231,35759
"14373","ENSACAG00000017945","4",129279225,129280160,935
"14374","ENSACAG00000017946","4",129282431,129317713,35282
"14375","ENSACAG00000017947","4",129422584,129467727,45143
"14376","ENSACAG00000017949","AAWZ02037612",7712,13108,5396
"14377","ENSACAG00000017950","GL343541.1",9115,428331,419216
"14378","ENSACAG00000017951","6",72573138,72675710,102572
"14379","ENSACAG00000017953","6",72701257,72760491,59234
"14380","ENSACAG00000017954","GL343541.1",325273,327234,1961
"14381","ENSACAG00000017955","GL343494.1",467334,630157,162823
"14382","ENSACAG00000017956","6",72761703,72767864,6161
"14383","ENSACAG00000017957","6",72778967,72849640,70673
"14384","ENSACAG00000017958","GL344647.1",314,25955,25641
"14385","ENSACAG00000017959","GL343207.1",35441,60652,25211
"14386","ENSACAG00000017960","6",72860441,72875384,14943
"14387","ENSACAG00000017961","GL343244.1",1850523,2098155,247632
"14388","ENSACAG00000017962","6",72877634,72901955,24321
"14389","ENSACAG00000017963","GL343244.1",1566840,1627202,60362
"14390","ENSACAG00000017964","6",72905690,72919081,13391
"14391","ENSACAG00000017965","GL343244.1",1448454,1450444,1990
"14392","ENSACAG00000017966","GL343244.1",1368090,1392525,24435
"14393","ENSACAG00000017967","6",72932077,72951309,19232
"14394","ENSACAG00000017968","6",72956736,72966418,9682
"14395","ENSACAG00000017969","GL343244.1",1243004,1286263,43259
"14396","ENSACAG00000017970","6",72993971,73122165,128194
"14397","ENSACAG00000017971","GL343244.1",1186309,1213340,27031
"14398","ENSACAG00000017972","GL343244.1",1154736,1176728,21992
"14399","ENSACAG00000017973","6",73193635,73195466,1831
"14400","ENSACAG00000017974","GL343244.1",1120454,1132924,12470
"14401","ENSACAG00000017975","AAWZ02041184",43,4277,4234
"14402","ENSACAG00000017976","2",112686812,112782318,95506
"14403","ENSACAG00000017977","GL343244.1",997248,1012035,14787
"14404","ENSACAG00000017979","GL343244.1",575214,616060,40846
"14405","ENSACAG00000017980","GL343244.1",530364,563244,32880
"14406","ENSACAG00000017984","GL343244.1",370850,377925,7075
"14407","ENSACAG00000017987","GL343244.1",252474,265876,13402
"14408","ENSACAG00000017988","GL343244.1",216027,241845,25818
"14409","ENSACAG00000017989","GL343244.1",159422,209233,49811
"14410","ENSACAG00000017990","2",9898,30605,20707
"14411","ENSACAG00000017991","GL343244.1",132393,154574,22181
"14412","ENSACAG00000017994","GL343244.1",98298,104959,6661
"14413","ENSACAG00000017995","2",117884,133256,15372
"14414","ENSACAG00000017997","GL343244.1",28297,47817,19520
"14415","ENSACAG00000017998","2",175798,176641,843
"14416","ENSACAG00000017999","GL343418.1",52530,84798,32268
"14417","ENSACAG00000018000","GL343418.1",105330,120697,15367
"14418","ENSACAG00000018002","2",196211,391078,194867
"14419","ENSACAG00000018003","GL343418.1",135918,194663,58745
"14420","ENSACAG00000018004","2",517733,573383,55650
"14421","ENSACAG00000018006","2",626324,788267,161943
"14422","ENSACAG00000018007","2",831722,1116933,285211
"14423","ENSACAG00000018008","2",1145535,1200543,55008
"14424","ENSACAG00000018017","GL343392.1",242870,242992,122
"14425","ENSACAG00000018018","1",213745503,213745820,317
"14426","ENSACAG00000018019","GL343800.1",76627,76732,105
"14427","ENSACAG00000018022","5",29776312,29776420,108
"14428","ENSACAG00000018032","1",223525537,223525654,117
"14429","ENSACAG00000018048","GL343563.1",131832,131907,75
"14430","ENSACAG00000018049","6",23964989,23965112,123
"14431","ENSACAG00000018055","6",76700796,76700920,124
"14432","ENSACAG00000018056","2",42574611,42574749,138
"14433","ENSACAG00000018058","GL343202.1",3253330,3253611,281
"14434","ENSACAG00000018060","GL343256.1",530448,530566,118
"14435","ENSACAG00000018068","2",21612988,21613082,94
"14436","ENSACAG00000018081","3",142896997,142897114,117
"14437","ENSACAG00000018085","2",189409412,189409538,126
"14438","ENSACAG00000018090","5",125466807,125466933,126
"14439","ENSACAG00000018093","GL344276.1",96295,96435,140
"14440","ENSACAG00000018099","GL343197.1",78260,78377,117
"14441","ENSACAG00000018101","5",26210744,26210854,110
"14442","ENSACAG00000018114","GL343247.1",1226228,1226346,118
"14443","ENSACAG00000018115","2",194068575,194068644,69
"14444","ENSACAG00000018117","1",137829458,137829579,121
"14445","ENSACAG00000018128","GL343647.1",283333,283434,101
"14446","ENSACAG00000018139","GL343244.1",126191,126257,66
"14447","ENSACAG00000018142","3",169296125,169296242,117
"14448","ENSACAG00000018143","1",131023335,131023402,67
"14449","ENSACAG00000018147","GL343454.1",452418,452535,117
"14450","ENSACAG00000018150","GL343308.1",91131,91194,63
"14451","ENSACAG00000018151","4",123287964,123288082,118
"14452","ENSACAG00000018155","6",60711608,60711751,143
"14453","ENSACAG00000018156","GL343293.1",1441321,1441438,117
"14454","ENSACAG00000018160","2",87048942,87049264,322
"14455","ENSACAG00000018165","5",112649688,112649807,119
"14456","ENSACAG00000018168","GL344876.1",15493,15636,143
"14457","ENSACAG00000018170","3",23454973,23455094,121
"14458","ENSACAG00000018174","1",23229665,23229784,119
"14459","ENSACAG00000018177","GL343614.1",220248,220397,149
"14460","ENSACAG00000018181","3",44827482,44827600,118
"14461","ENSACAG00000018182","2",99499966,99500048,82
"14462","ENSACAG00000018184","3",79621430,79621548,118
"14463","ENSACAG00000018187","GL343215.1",581428,581787,359
"14464","ENSACAG00000018190","GL344317.1",32683,32801,118
"14465","ENSACAG00000018193","5",2871963,2872081,118
"14466","ENSACAG00000018206","1",42505756,42505875,119
"14467","ENSACAG00000018210","GL343205.1",2893353,2893672,319
"14468","ENSACAG00000018217","GL343193.1",6671028,6671156,128
"14469","ENSACAG00000018224","5",31455419,31455537,118
"14470","ENSACAG00000018229","1",213681246,213681577,331
"14471","ENSACAG00000018233","AAWZ02041325",4597,4713,116
"14472","ENSACAG00000018236","5",44078757,44078876,119
"14473","ENSACAG00000018237","5",26329985,26330104,119
"14474","ENSACAG00000018239","GL343722.1",3532,3649,117
"14475","ENSACAG00000018242","2",176759471,176759577,106
"14476","ENSACAG00000018247","2",182519644,182519952,308
"14477","ENSACAG00000018248","3",196124700,196124831,131
"14478","ENSACAG00000018253","GL344627.1",20912,21026,114
"14479","ENSACAG00000018254","GL343198.1",1087505,1087599,94
"14480","ENSACAG00000018259","2",121791141,121791241,100
"14481","ENSACAG00000018260","GL344047.1",114025,114159,134
"14482","ENSACAG00000018266","GL343811.1",157693,157782,89
"14483","ENSACAG00000018267","3",41072491,41072609,118
"14484","ENSACAG00000018274","2",40591315,40591426,111
"14485","ENSACAG00000018277","1",198038783,198039073,290
"14486","ENSACAG00000018291","5",37507201,37507320,119
"14487","ENSACAG00000018292","GL343321.1",118621,118692,71
"14488","ENSACAG00000018294","GL343194.1",3345610,3345692,82
"14489","ENSACAG00000018297","1",19406590,19406868,278
"14490","ENSACAG00000018300","5",120335537,120335655,118
"14491","ENSACAG00000018302","3",111757210,111757332,122
"14492","ENSACAG00000018303","3",190368810,190368928,118
"14493","ENSACAG00000018307","3",135996372,135996468,96
"14494","ENSACAG00000018314","2",199214033,199214151,118
"14495","ENSACAG00000018318","1",131400895,131401015,120
"14496","ENSACAG00000018334","4",111937829,111937949,120
"14497","ENSACAG00000018337","2",122657695,122657781,86
"14498","ENSACAG00000018342","GL343202.1",4295151,4295271,120
"14499","ENSACAG00000018343","GL343275.1",1429543,1429631,88
"14500","ENSACAG00000018347","3",116429061,116429176,115
"14501","ENSACAG00000018353","2",118512073,118512191,118
"14502","ENSACAG00000018356","3",58336686,58336803,117
"14503","ENSACAG00000018357","1",219653270,219653410,140
"14504","ENSACAG00000018368","GL344750.1",18855,18946,91
"14505","ENSACAG00000018382","GL343752.1",81955,82044,89
"14506","ENSACAG00000018385","1",91616099,91616203,104
"14507","ENSACAG00000018397","GL343419.1",204934,205271,337
"14508","ENSACAG00000018398","GL343675.1",186616,186736,120
"14509","ENSACAG00000018407","1",161500300,161500600,300
"14510","ENSACAG00000018410","3",181012497,181012619,122
"14511","ENSACAG00000018413","AAWZ02037227",1022,1137,115
"14512","ENSACAG00000018419","3",5408541,5408661,120
"14513","ENSACAG00000018426","GL343199.1",3854923,3855127,204
"14514","ENSACAG00000018428","5",22093058,22093177,119
"14515","ENSACAG00000018432","5",52234084,52234428,344
"14516","ENSACAG00000018437","5",2636998,2637116,118
"14517","ENSACAG00000018442","1",95540829,95540961,132
"14518","ENSACAG00000018451","6",78226081,78226201,120
"14519","ENSACAG00000018453","4",111057003,111057076,73
"14520","ENSACAG00000018454","GL343255.1",1943470,1943568,98
"14521","ENSACAG00000018457","GL343199.1",3850159,3850363,204
"14522","ENSACAG00000018461","GL343425.1",264877,264995,118
"14523","ENSACAG00000018465","GL343456.1",636596,636714,118
"14524","ENSACAG00000018472","4",153415392,153415515,123
"14525","ENSACAG00000018476","4",123683603,123683694,91
"14526","ENSACAG00000018478","GL343355.1",163222,163341,119
"14527","ENSACAG00000018482","6",12877369,12877703,334
"14528","ENSACAG00000018483","1",220871575,220871692,117
"14529","ENSACAG00000018484","GL343194.1",2629716,2629834,118
"14530","ENSACAG00000018488","4",25406781,25406899,118
"14531","ENSACAG00000018495","GL343506.1",18017,18101,84
"14532","ENSACAG00000018501","4",12541495,12541612,117
"14533","ENSACAG00000018505","5",29326403,29326635,232
"14534","ENSACAG00000018510","3",196125303,196125423,120
"14535","ENSACAG00000018511","GL343268.1",617094,617407,313
"14536","ENSACAG00000018521","GL343245.1",220175,220257,82
"14537","ENSACAG00000018525","GL343200.1",4368162,4368237,75
"14538","ENSACAG00000018527","LGa",2522973,2523090,117
"14539","ENSACAG00000018532","6",15085939,15086057,118
"14540","ENSACAG00000018535","1",176798847,176798920,73
"14541","ENSACAG00000018537","GL343956.1",102646,102764,118
"14542","ENSACAG00000018542","5",142962978,142963047,69
"14543","ENSACAG00000018553","3",178902452,178902538,86
"14544","ENSACAG00000018558","3",41607814,41607933,119
"14545","ENSACAG00000018561","4",110081790,110081905,115
"14546","ENSACAG00000018565","GL343574.1",172969,173040,71
"14547","ENSACAG00000018568","1",74505521,74505608,87
"14548","ENSACAG00000018570","GL343417.1",80284,80381,97
"14549","ENSACAG00000018572","GL343657.1",109060,109190,130
"14550","ENSACAG00000018574","5",140492435,140492568,133
"14551","ENSACAG00000018582","GL343308.1",91293,91388,95
"14552","ENSACAG00000018586","4",112501915,112502039,124
"14553","ENSACAG00000018592","1",32819681,32819801,120
"14554","ENSACAG00000018595","GL343213.1",120966,121084,118
"14555","ENSACAG00000018597","GL343341.1",88189,88312,123
"14556","ENSACAG00000018607","GL343285.1",475980,476097,117
"14557","ENSACAG00000018608","2",189475941,189476059,118
"14558","ENSACAG00000018618","2",75302790,75302907,117
"14559","ENSACAG00000018621","GL343291.1",1608203,1608321,118
"14560","ENSACAG00000018623","LGa",2624861,2624937,76
"14561","ENSACAG00000018632","2",162864544,162864664,120
"14562","ENSACAG00000018633","2",104476801,104476919,118
"14563","ENSACAG00000018638","1",251427517,251427812,295
"14564","ENSACAG00000018640","4",119763357,119763646,289
"14565","ENSACAG00000018647","1",38558695,38558814,119
"14566","ENSACAG00000018650","GL343343.1",826383,826574,191
"14567","ENSACAG00000018656","1",263220479,263220586,107
"14568","ENSACAG00000018657","6",74123467,74123586,119
"14569","ENSACAG00000018663","3",196122356,196122495,139
"14570","ENSACAG00000018669","4",40554185,40554269,84
"14571","ENSACAG00000018686","GL343193.1",8155923,8156048,125
"14572","ENSACAG00000018687","4",104324075,104324194,119
"14573","ENSACAG00000018688","5",287849,287970,121
"14574","ENSACAG00000018692","5",1036127,1036237,110
"14575","ENSACAG00000018693","GL343280.1",233904,234032,128
"14576","ENSACAG00000018698","AAWZ02036627",8492,8803,311
"14577","ENSACAG00000018700","4",92342045,92342117,72
"14578","ENSACAG00000018711","4",116373606,116373725,119
"14579","ENSACAG00000018718","3",94013208,94013515,307
"14580","ENSACAG00000018721","GL343287.1",353458,353547,89
"14581","ENSACAG00000018727","4",146471688,146471778,90
"14582","ENSACAG00000018728","GL343193.1",8857842,8857961,119
"14583","ENSACAG00000018730","1",32549224,32549314,90
"14584","ENSACAG00000018732","GL344283.1",24106,24225,119
"14585","ENSACAG00000018733","2",87863540,87863676,136
"14586","ENSACAG00000018739","2",126637762,126637881,119
"14587","ENSACAG00000018742","AAWZ02040398",3901,3978,77
"14588","ENSACAG00000018743","3",99135940,99136284,344
"14589","ENSACAG00000018744","1",176843513,176843633,120
"14590","ENSACAG00000018747","6",77430480,77430598,118
"14591","ENSACAG00000018752","GL343326.1",409125,409263,138
"14592","ENSACAG00000018758","GL343964.1",59467,59585,118
"14593","ENSACAG00000018767","1",252826898,252827019,121
"14594","ENSACAG00000018769","5",80420529,80420635,106
"14595","ENSACAG00000018772","1",175159335,175159457,122
"14596","ENSACAG00000018774","2",76949160,76949277,117
"14597","ENSACAG00000018778","4",147971328,147971445,117
"14598","ENSACAG00000018780","2",169733942,169734061,119
"14599","ENSACAG00000018787","3",174323256,174323375,119
"14600","ENSACAG00000018788","LGa",2102909,2103032,123
"14601","ENSACAG00000018795","GL343950.1",105437,105572,135
"14602","ENSACAG00000018801","1",135514103,135514221,118
"14603","ENSACAG00000018802","GL343410.1",356942,357059,117
"14604","ENSACAG00000018805","GL343308.1",250289,250376,87
"14605","ENSACAG00000018807","AAWZ02037033",354,475,121
"14606","ENSACAG00000018811","GL343384.1",388928,389046,118
"14607","ENSACAG00000018813","1",63301506,63301699,193
"14608","ENSACAG00000018814","2",113408042,113408160,118
"14609","ENSACAG00000018822","1",3709804,3709922,118
"14610","ENSACAG00000018825","1",162594445,162594564,119
"14611","ENSACAG00000018831","GL343197.1",377994,378111,117
"14612","ENSACAG00000018833","GL343799.1",6379,6466,87
"14613","ENSACAG00000018844","2",25955570,25955689,119
"14614","ENSACAG00000018850","6",1202330,1202444,114
"14615","ENSACAG00000018854","2",181856622,181856739,117
"14616","ENSACAG00000018857","2",112676183,112676311,128
"14617","ENSACAG00000018858","6",69213640,69213759,119
"14618","ENSACAG00000018865","6",62859166,62859288,122
"14619","ENSACAG00000018867","5",83532327,83532417,90
"14620","ENSACAG00000018868","4",19277919,19278038,119
"14621","ENSACAG00000018875","GL343224.1",2176182,2176339,157
"14622","ENSACAG00000018877","2",177422,177488,66
"14623","ENSACAG00000018879","GL344276.1",87949,88078,129
"14624","ENSACAG00000018880","GL343665.1",127854,127972,118
"14625","ENSACAG00000018881","2",40591994,40592077,83
"14626","ENSACAG00000018882","GL343647.1",274649,274734,85
"14627","ENSACAG00000018885","1",231003102,231003221,119
"14628","ENSACAG00000018886","3",187850239,187850357,118
"14629","ENSACAG00000018887","GL343208.1",3821412,3821499,87
"14630","ENSACAG00000018889","2",141948119,141948238,119
"14631","ENSACAG00000018892","GL343322.1",162214,162332,118
"14632","ENSACAG00000018894","2",105143356,105143445,89
"14633","ENSACAG00000018895","GL343739.1",237644,237715,71
"14634","ENSACAG00000018909","GL343444.1",370590,370682,92
"14635","ENSACAG00000018915","5",142855014,142855132,118
"14636","ENSACAG00000018922","GL343308.1",176876,176997,121
"14637","ENSACAG00000018924","GL343297.1",19393,19710,317
"14638","ENSACAG00000018926","GL343213.1",2690939,2691039,100
"14639","ENSACAG00000018932","GL343227.1",1111758,1112074,316
"14640","ENSACAG00000018933","GL343481.1",237938,238066,128
"14641","ENSACAG00000018942","1",35883587,35883705,118
"14642","ENSACAG00000018944","GL343207.1",2311692,2311813,121
"14643","ENSACAG00000018945","GL343400.1",511910,512043,133
"14644","ENSACAG00000018946","1",69629820,69629942,122
"14645","ENSACAG00000018952","GL344007.1",66441,66580,139
"14646","ENSACAG00000018956","2",94585958,94586093,135
"14647","ENSACAG00000018958","3",40448809,40448929,120
"14648","ENSACAG00000018967","1",80950407,80950525,118
"14649","ENSACAG00000018972","GL343233.1",705962,706079,117
"14650","ENSACAG00000018974","1",84072921,84073046,125
"14651","ENSACAG00000018975","2",77879714,77880058,344
"14652","ENSACAG00000018980","2",119362247,119362364,117
"14653","ENSACAG00000018985","GL343213.1",233157,233274,117
"14654","ENSACAG00000019000","GL344943.1",11337,11455,118
"14655","ENSACAG00000019007","GL343479.1",637418,637553,135
"14656","ENSACAG00000019009","GL343220.1",1048235,1048380,145
"14657","ENSACAG00000019013","3",63506747,63506992,245
"14658","ENSACAG00000019018","GL343211.1",716889,716977,88
"14659","ENSACAG00000019020","1",212186265,212186399,134
"14660","ENSACAG00000019021","3",100679834,100679952,118
"14661","ENSACAG00000019022","AAWZ02037129",4052,4166,114
"14662","ENSACAG00000019023","2",108861679,108861978,299
"14663","ENSACAG00000019028","GL343584.1",108926,109023,97
"14664","ENSACAG00000019030","GL343210.1",2268483,2268600,117
"14665","ENSACAG00000019038","GL343467.1",143402,143501,99
"14666","ENSACAG00000019041","GL343282.1",153239,153402,163
"14667","ENSACAG00000019044","GL343193.1",6670561,6670693,132
"14668","ENSACAG00000019047","4",29946106,29946162,56
"14669","ENSACAG00000019052","2",103536451,103536741,290
"14670","ENSACAG00000019064","GL343205.1",409631,409749,118
"14671","ENSACAG00000019070","5",75669114,75669461,347
"14672","ENSACAG00000019073","GL343284.1",1018652,1018719,67
"14673","ENSACAG00000019079","GL343846.1",79555,79672,117
"14674","ENSACAG00000019081","1",198201877,198201997,120
"14675","ENSACAG00000019087","6",61942554,61942672,118
"14676","ENSACAG00000019093","GL343339.1",853170,853288,118
"14677","ENSACAG00000019094","GL343338.1",413258,413398,140
"14678","ENSACAG00000019095","2",111906851,111906929,78
"14679","ENSACAG00000019100","3",185542141,185542457,316
"14680","ENSACAG00000019107","GL343308.1",254240,254326,86
"14681","ENSACAG00000019112","1",61267171,61267288,117
"14682","ENSACAG00000019121","4",99845969,99846088,119
"14683","ENSACAG00000019122","3",196120245,196120319,74
"14684","ENSACAG00000019129","4",77708061,77708179,118
"14685","ENSACAG00000019134","GL343220.1",1231944,1232050,106
"14686","ENSACAG00000019142","GL343260.1",770072,770192,120
"14687","ENSACAG00000019143","4",135451068,135451156,88
"14688","ENSACAG00000019144","GL343294.1",820678,820796,118
"14689","ENSACAG00000019145","4",151823194,151823290,96
"14690","ENSACAG00000019149","1",47968004,47968122,118
"14691","ENSACAG00000019153","1",254056528,254056645,117
"14692","ENSACAG00000019154","GL343205.1",4260746,4260863,117
"14693","ENSACAG00000019156","4",20652375,20652508,133
"14694","ENSACAG00000019160","3",59671388,59671635,247
"14695","ENSACAG00000019162","4",111054615,111054747,132
"14696","ENSACAG00000019163","2",189237452,189237569,117
"14697","ENSACAG00000019166","GL344004.1",26733,26866,133
"14698","ENSACAG00000019168","2",49718597,49718715,118
"14699","ENSACAG00000019180","2",92928211,92928285,74
"14700","ENSACAG00000019194","GL343391.1",323291,323598,307
"14701","ENSACAG00000019195","3",183941848,183941951,103
"14702","ENSACAG00000019197","GL343243.1",1955031,1955151,120
"14703","ENSACAG00000019198","GL343298.1",50123,50214,91
"14704","ENSACAG00000019199","GL343224.1",2177427,2177582,155
"14705","ENSACAG00000019201","AAWZ02039090",4269,4334,65
"14706","ENSACAG00000019202","2",20642147,20642207,60
"14707","ENSACAG00000019212","1",217025455,217025582,127
"14708","ENSACAG00000019218","GL343306.1",1041814,1041884,70
"14709","ENSACAG00000019224","5",51024583,51024701,118
"14710","ENSACAG00000019225","GL343515.1",61876,62009,133
"14711","ENSACAG00000019228","4",101175991,101176108,117
"14712","ENSACAG00000019229","LGa",3020750,3020845,95
"14713","ENSACAG00000019232","GL343674.1",235213,235325,112
"14714","ENSACAG00000019243","1",43177211,43177322,111
"14715","ENSACAG00000019245","3",12260476,12260594,118
"14716","ENSACAG00000019262","1",109793735,109794061,326
"14717","ENSACAG00000019266","4",110604459,110604577,118
"14718","ENSACAG00000019274","GL343232.1",316526,316649,123
"14719","ENSACAG00000019282","GL343731.1",232982,233067,85
"14720","ENSACAG00000019284","4",38863214,38863315,101
"14721","ENSACAG00000019285","GL343329.1",780608,780728,120
"14722","ENSACAG00000019289","3",39596496,39596592,96
"14723","ENSACAG00000019299","GL343381.1",573889,574203,314
"14724","ENSACAG00000019303","5",84341613,84341730,117
"14725","ENSACAG00000019305","GL343739.1",236231,236357,126
"14726","ENSACAG00000019315","1",119458984,119459106,122
"14727","ENSACAG00000019321","1",204546420,204546537,117
"14728","ENSACAG00000019323","GL343380.1",853501,853805,304
"14729","ENSACAG00000019325","GL343594.1",223054,223173,119
"14730","ENSACAG00000019332","GL344106.1",11698,11841,143
"14731","ENSACAG00000019337","2",98103655,98103778,123
"14732","ENSACAG00000019346","2",119918316,119918443,127
"14733","ENSACAG00000019351","AAWZ02037129",14601,14710,109
"14734","ENSACAG00000019354","4",128301191,128301251,60
"14735","ENSACAG00000019357","6",57468268,57468380,112
"14736","ENSACAG00000019364","4",89457574,89457692,118
"14737","ENSACAG00000019369","4",39374934,39375054,120
"14738","ENSACAG00000019371","GL343604.1",264155,264247,92
"14739","ENSACAG00000019373","GL343210.1",1457477,1457594,117
"14740","ENSACAG00000019378","GL343282.1",1188351,1188478,127
"14741","ENSACAG00000019386","6",53448651,53448752,101
"14742","ENSACAG00000019388","1",151696142,151696482,340
"14743","ENSACAG00000019389","GL343334.1",47874,47992,118
"14744","ENSACAG00000019390","GL343257.1",1968931,1969273,342
"14745","ENSACAG00000019392","GL343208.1",645345,645419,74
"14746","ENSACAG00000019393","3",136581522,136581640,118
"14747","ENSACAG00000019396","2",104793810,104793928,118
"14748","ENSACAG00000019398","GL343323.1",559945,560063,118
"14749","ENSACAG00000019406","1",121170409,121170527,118
"14750","ENSACAG00000019407","5",60930781,60930898,117
"14751","ENSACAG00000019409","GL343321.1",116441,116570,129
"14752","ENSACAG00000019410","1",193772174,193772293,119
"14753","ENSACAG00000019416","GL343215.1",2516922,2517045,123
"14754","ENSACAG00000019419","3",135997310,135997417,107
"14755","ENSACAG00000019423","1",119447624,119447741,117
"14756","ENSACAG00000019424","GL344433.1",25362,25484,122
"14757","ENSACAG00000019428","4",154268922,154269042,120
"14758","ENSACAG00000019430","GL343200.1",4367555,4367644,89
"14759","ENSACAG00000019431","6",74766859,74766977,118
"14760","ENSACAG00000019432","1",73438029,73438353,324
"14761","ENSACAG00000019435","6",63169121,63169253,132
"14762","ENSACAG00000019436","5",24638877,24638970,93
"14763","ENSACAG00000019437","GL343263.1",1559681,1559803,122
"14764","ENSACAG00000019449","6",73384432,73384549,117
"14765","ENSACAG00000019458","3",19954802,19954922,120
"14766","ENSACAG00000019460","1",66624716,66624807,91
"14767","ENSACAG00000019461","LGa",3022558,3022646,88
"14768","ENSACAG00000019463","4",104504178,104504248,70
"14769","ENSACAG00000019464","1",88926969,88927087,118
"14770","ENSACAG00000019468","GL343194.1",3343401,3343485,84
"14771","ENSACAG00000019472","1",253278177,253278294,117
"14772","ENSACAG00000019490","2",109881262,109881548,286
"14773","ENSACAG00000019492","1",253298791,253298909,118
"14774","ENSACAG00000019495","6",80262188,80262308,120
"14775","ENSACAG00000019502","1",122859602,122859700,98
"14776","ENSACAG00000019508","1",250803693,250803982,289
"14777","ENSACAG00000019512","GL343495.1",125476,125796,320
"14778","ENSACAG00000019516","5",119875741,119875859,118
"14779","ENSACAG00000019522","4",71381089,71381167,78
"14780","ENSACAG00000019524","4",1751101,1751196,95
"14781","ENSACAG00000019531","GL343299.1",774805,775102,297
"14782","ENSACAG00000019532","GL343257.1",1148149,1148258,109
"14783","ENSACAG00000019533","4",81456509,81456629,120
"14784","ENSACAG00000019544","2",166885855,166885984,129
"14785","ENSACAG00000019548","4",89236848,89236965,117
"14786","ENSACAG00000019550","4",76506344,76506463,119
"14787","ENSACAG00000019556","1",29876518,29876687,169
"14788","ENSACAG00000019558","GL343569.1",33721,33827,106
"14789","ENSACAG00000019568","2",92930139,92930210,71
"14790","ENSACAG00000019574","GL343287.1",1405159,1405247,88
"14791","ENSACAG00000019584","3",110979898,110979981,83
"14792","ENSACAG00000019593","GL343223.1",1522537,1522656,119
"14793","ENSACAG00000019600","GL343367.1",302810,302928,118
"14794","ENSACAG00000019601","5",142964147,142964214,67
"14795","ENSACAG00000019603","GL343326.1",506375,506493,118
"14796","ENSACAG00000019621","3",196142191,196142259,68
"14797","ENSACAG00000019622","1",63678381,63678498,117
"14798","ENSACAG00000019624","GL343481.1",238493,238629,136
"14799","ENSACAG00000019627","6",21024204,21024322,118
"14800","ENSACAG00000019628","GL343201.1",270062,270180,118
"14801","ENSACAG00000019640","2",6960695,6960775,80
"14802","ENSACAG00000019643","GL343286.1",863924,864041,117
"14803","ENSACAG00000019651","GL343202.1",2099607,2099682,75
"14804","ENSACAG00000019659","GL343210.1",1023607,1023725,118
"14805","ENSACAG00000019679","GL343762.1",190533,190653,120
"14806","ENSACAG00000019683","2",165794287,165794407,120
"14807","ENSACAG00000019686","GL343490.1",140961,141081,120
"14808","ENSACAG00000019687","GL343632.1",103429,103560,131
"14809","ENSACAG00000019688","GL343275.1",443365,443482,117
"14810","ENSACAG00000019690","GL343356.1",481973,482083,110
"14811","ENSACAG00000019691","2",56431877,56431998,121
"14812","ENSACAG00000019693","2",138837248,138837367,119
"14813","ENSACAG00000019694","GL343205.1",694209,694328,119
"14814","ENSACAG00000019695","6",80358836,80358892,56
"14815","ENSACAG00000019696","GL343739.1",239186,239254,68
"14816","ENSACAG00000019698","GL343242.1",2169523,2169640,117
"14817","ENSACAG00000019699","GL343210.1",1431192,1431310,118
"14818","ENSACAG00000019703","GL343208.1",1389586,1389704,118
"14819","ENSACAG00000019712","5",113820494,113820799,305
"14820","ENSACAG00000019714","GL343198.1",5095914,5096031,117
"14821","ENSACAG00000019717","GL343229.1",154739,154857,118
"14822","ENSACAG00000019722","4",115552661,115552998,337
"14823","ENSACAG00000019725","3",25660170,25660289,119
"14824","ENSACAG00000019728","GL343372.1",838010,838095,85
"14825","ENSACAG00000019733","GL343634.1",247071,247364,293
"14826","ENSACAG00000019734","3",196121388,196121526,138
"14827","ENSACAG00000019736","2",88039451,88039569,118
"14828","ENSACAG00000019738","GL343536.1",462837,462957,120
"14829","ENSACAG00000019742","GL343490.1",464261,464382,121
"14830","ENSACAG00000019743","GL343372.1",831546,831630,84
"14831","ENSACAG00000019750","GL343336.1",897049,897169,120
"14832","ENSACAG00000019751","6",50627942,50628060,118
"14833","ENSACAG00000019754","3",50107208,50107460,252
"14834","ENSACAG00000019758","GL343257.1",1474349,1474542,193
"14835","ENSACAG00000019760","GL343304.1",1201516,1201633,117
"14836","ENSACAG00000019763","4",104956703,104956825,122
"14837","ENSACAG00000019778","GL343553.1",278793,278910,117
"14838","ENSACAG00000019781","1",206443890,206444205,315
"14839","ENSACAG00000019791","3",117291270,117291613,343
"14840","ENSACAG00000019792","GL343399.1",440976,441106,130
"14841","ENSACAG00000019795","GL343453.1",599950,600011,61
"14842","ENSACAG00000019800","GL343301.1",1240559,1240678,119
"14843","ENSACAG00000019804","3",189000866,189000984,118
"14844","ENSACAG00000019810","2",58704821,58704939,118
"14845","ENSACAG00000019815","5",83533330,83533421,91
"14846","ENSACAG00000019822","GL343761.1",167251,167324,73
"14847","ENSACAG00000019824","GL343298.1",704309,704457,148
"14848","ENSACAG00000019833","1",68659260,68659388,128
"14849","ENSACAG00000019838","GL343443.1",351042,351160,118
"14850","ENSACAG00000019839","GL343647.1",276647,276734,87
"14851","ENSACAG00000019844","GL343327.1",633484,633603,119
"14852","ENSACAG00000019847","GL343406.1",723434,723556,122
"14853","ENSACAG00000019855","GL343257.1",1149710,1149900,190
"14854","ENSACAG00000019858","5",51075556,51075640,84
"14855","ENSACAG00000019859","5",111294281,111294402,121
"14856","ENSACAG00000019861","3",154096887,154097007,120
"14857","ENSACAG00000019863","GL343427.1",757878,758155,277
"14858","ENSACAG00000019866","GL343262.1",1826826,1826944,118
"14859","ENSACAG00000019869","2",176333,176400,67
"14860","ENSACAG00000019870","GL343305.1",1492678,1492797,119
"14861","ENSACAG00000019871","2",93054614,93054735,121
"14862","ENSACAG00000019872","4",38859445,38859528,83
"14863","ENSACAG00000019877","2",88977359,88977477,118
"14864","ENSACAG00000019878","GL343287.1",107860,107978,118
"14865","ENSACAG00000019880","GL343453.1",579368,579486,118
"14866","ENSACAG00000019882","2",188776068,188776149,81
"14867","ENSACAG00000019883","1",81131525,81131688,163
"14868","ENSACAG00000019886","GL343355.1",510049,510134,85
"14869","ENSACAG00000019890","1",89007832,89007946,114
"14870","ENSACAG00000019892","6",34772836,34772954,118
"14871","ENSACAG00000019893","GL343202.1",2100092,2100222,130
"14872","ENSACAG00000019894","2",162659994,162660113,119
"14873","ENSACAG00000019895","GL343500.1",19230,19308,78
"14874","ENSACAG00000019898","1",211212316,211212592,276
"14875","ENSACAG00000019900","GL343204.1",975354,975460,106
"14876","ENSACAG00000019906","GL343299.1",1262278,1262396,118
"14877","ENSACAG00000019908","GL343372.1",258683,258846,163
"14878","ENSACAG00000019909","2",9615150,9615269,119
"14879","ENSACAG00000019911","2",104178431,104178549,118
"14880","ENSACAG00000019915","5",130104578,130104894,316
"14881","ENSACAG00000019921","AAWZ02040295",662,767,105
"14882","ENSACAG00000019929","4",20543452,20543569,117
"14883","ENSACAG00000019930","1",99504989,99505327,338
"14884","ENSACAG00000019942","GL344214.1",24018,24121,103
"14885","ENSACAG00000019944","2",13387383,13387502,119
"14886","ENSACAG00000019953","1",212191203,212191337,134
"14887","ENSACAG00000019954","4",33494090,33494209,119
"14888","ENSACAG00000019956","GL343390.1",260058,260175,117
"14889","ENSACAG00000019957","GL343273.1",805800,805938,138
"14890","ENSACAG00000019963","1",205254184,205254302,118
"14891","ENSACAG00000019964","4",28459527,28459645,118
"14892","ENSACAG00000019966","1",185058205,185058307,102
"14893","ENSACAG00000019967","4",107446650,107446768,118
"14894","ENSACAG00000019976","GL343342.1",1130840,1131061,221
"14895","ENSACAG00000019980","4",98411441,98411523,82
"14896","ENSACAG00000019981","2",58061986,58062104,118
"14897","ENSACAG00000019982","1",251543244,251543361,117
"14898","ENSACAG00000019986","2",29157928,29158004,76
"14899","ENSACAG00000019987","3",148357602,148357668,66
"14900","ENSACAG00000019988","AAWZ02040398",4667,4745,78
"14901","ENSACAG00000019991","3",12958209,12958539,330
"14902","ENSACAG00000020002","2",86345434,86345552,118
"14903","ENSACAG00000020003","GL343483.1",304938,305023,85
"14904","ENSACAG00000020004","6",53445894,53445991,97
"14905","ENSACAG00000020006","6",54630818,54630936,118
"14906","ENSACAG00000020010","2",112676927,112677058,131
"14907","ENSACAG00000020014","GL343567.1",45645,45762,117
"14908","ENSACAG00000020016","GL343244.1",1281738,1281860,122
"14909","ENSACAG00000020017","GL343264.1",559539,559656,117
"14910","ENSACAG00000020021","GL343321.1",116019,116197,178
"14911","ENSACAG00000020023","GL343200.1",4366820,4366949,129
"14912","ENSACAG00000020026","GL343244.1",68150,68269,119
"14913","ENSACAG00000020037","2",29157647,29157718,71
"14914","ENSACAG00000020041","2",1878126,1878246,120
"14915","ENSACAG00000020049","GL343306.1",1044489,1044620,131
"14916","ENSACAG00000020060","5",87671395,87671512,117
"14917","ENSACAG00000020063","GL344214.1",24593,24681,88
"14918","ENSACAG00000020065","3",51438528,51438646,118
"14919","ENSACAG00000020067","4",137589613,137589731,118
"14920","ENSACAG00000020068","5",55372313,55372404,91
"14921","ENSACAG00000020074","5",15512765,15512883,118
"14922","ENSACAG00000020076","GL343269.1",212644,212762,118
"14923","ENSACAG00000020078","2",109111059,109111178,119
"14924","ENSACAG00000020081","6",78470488,78470606,118
"14925","ENSACAG00000020092","3",139717035,139717153,118
"14926","ENSACAG00000020093","GL343643.1",134505,134564,59
"14927","ENSACAG00000020105","1",20867896,20868017,121
"14928","ENSACAG00000020106","GL343193.1",12699005,12699128,123
"14929","ENSACAG00000020108","6",30324306,30324395,89
"14930","ENSACAG00000020118","GL343380.1",86077,86383,306
"14931","ENSACAG00000020119","2",14033065,14033196,131
"14932","ENSACAG00000020120","2",157025310,157025579,269
"14933","ENSACAG00000020121","3",128633821,128633990,169
"14934","ENSACAG00000020125","GL344149.1",38818,38954,136
"14935","ENSACAG00000020127","GL343205.1",3878151,3878272,121
"14936","ENSACAG00000020131","6",73748903,73749023,120
"14937","ENSACAG00000020135","GL343436.1",296589,296903,314
"14938","ENSACAG00000020141","2",67040498,67040591,93
"14939","ENSACAG00000020157","1",102052658,102052783,125
"14940","ENSACAG00000020159","2",94582495,94582630,135
"14941","ENSACAG00000020166","2",28530108,28530227,119
"14942","ENSACAG00000020170","GL343298.1",707208,707357,149
"14943","ENSACAG00000020172","1",209041182,209041558,376
"14944","ENSACAG00000020174","4",71389275,71389354,79
"14945","ENSACAG00000020175","GL343419.1",442466,442581,115
"14946","ENSACAG00000020176","6",10890383,10890504,121
"14947","ENSACAG00000020177","1",170799465,170799583,118
"14948","ENSACAG00000020179","GL343360.1",602507,602624,117
"14949","ENSACAG00000020184","GL343201.1",1868617,1868717,100
"14950","ENSACAG00000020186","GL343208.1",644784,644913,129
"14951","ENSACAG00000020191","GL343604.1",262437,262523,86
"14952","ENSACAG00000020195","4",133185866,133185983,117
"14953","ENSACAG00000020200","5",134617580,134617699,119
"14954","ENSACAG00000020202","3",100220401,100220519,118
"14955","ENSACAG00000020203","GL343210.1",1178080,1178169,89
"14956","ENSACAG00000020205","GL344275.1",15957,16074,117
"14957","ENSACAG00000020206","GL343285.1",1219764,1219882,118
"14958","ENSACAG00000020207","GL343335.1",128444,128580,136
"14959","ENSACAG00000020208","4",67483626,67483746,120
"14960","ENSACAG00000020213","3",136475653,136475771,118
"14961","ENSACAG00000020215","5",61653955,61654075,120
"14962","ENSACAG00000020219","AAWZ02040385",4968,5184,216
"14963","ENSACAG00000020220","GL343701.1",93357,93454,97
"14964","ENSACAG00000020229","2",28116938,28117056,118
"14965","ENSACAG00000020237","AAWZ02037281",5205,5276,71
"14966","ENSACAG00000020238","2",86475645,86475779,134
"14967","ENSACAG00000020242","GL343904.1",141171,141375,204
"14968","ENSACAG00000020247","3",135438824,135438944,120
"14969","ENSACAG00000020249","3",105282030,105282147,117
"14970","ENSACAG00000020253","2",12802871,12802989,118
"14971","ENSACAG00000020255","4",52943799,52943917,118
"14972","ENSACAG00000020257","1",234400821,234401115,294
"14973","ENSACAG00000020267","GL344924.1",6926,7011,85
"14974","ENSACAG00000020268","GL343245.1",1554405,1554498,93
"14975","ENSACAG00000020271","1",68540452,68540570,118
"14976","ENSACAG00000020276","2",49130020,49130140,120
"14977","ENSACAG00000020289","LGa",2619225,2619315,90
"14978","ENSACAG00000020299","4",153195205,153195262,57
"14979","ENSACAG00000020303","GL343604.1",217721,217839,118
"14980","ENSACAG00000020307","1",199607314,199607410,96
"14981","ENSACAG00000020314","2",76335850,76335968,118
"14982","ENSACAG00000020316","GL343824.1",5891,6009,118
"14983","ENSACAG00000020317","GL343286.1",673107,673227,120
"14984","ENSACAG00000020320","3",59765532,59765836,304
"14985","ENSACAG00000020321","4",87343350,87343687,337
"14986","ENSACAG00000020325","1",98658153,98658445,292
"14987","ENSACAG00000020331","5",50524455,50524584,129
"14988","ENSACAG00000020334","1",41845461,41845796,335
"14989","ENSACAG00000020337","2",49631291,49631628,337
"14990","ENSACAG00000020338","5",106709372,106709483,111
"14991","ENSACAG00000020340","GL343739.1",240523,240597,74
"14992","ENSACAG00000020345","GL343763.1",95904,95997,93
"14993","ENSACAG00000020349","GL343333.1",445438,445555,117
"14994","ENSACAG00000020352","2",99587263,99587381,118
"14995","ENSACAG00000020355","GL343470.1",228448,228544,96
"14996","ENSACAG00000020357","2",103686210,103686330,120
"14997","ENSACAG00000020359","2",111901821,111901896,75
"14998","ENSACAG00000020360","2",112670156,112670284,128
"14999","ENSACAG00000020369","1",143209817,143209940,123
"15000","ENSACAG00000020372","GL343227.1",1457868,1457989,121
"15001","ENSACAG00000020377","GL343404.1",148908,149025,117
"15002","ENSACAG00000020380","GL343844.1",159549,159658,109
"15003","ENSACAG00000020381","2",187863024,187863110,86
"15004","ENSACAG00000020389","GL343693.1",230344,230434,90
"15005","ENSACAG00000020392","GL343343.1",63911,63973,62
"15006","ENSACAG00000020395","3",153979910,153980029,119
"15007","ENSACAG00000020396","1",147102485,147102574,89
"15008","ENSACAG00000020403","1",168132486,168132608,122
"15009","ENSACAG00000020407","1",159539657,159539975,318
"15010","ENSACAG00000020408","GL343282.1",1189878,1189983,105
"15011","ENSACAG00000020412","6",22687396,22687717,321
"15012","ENSACAG00000020416","1",68614625,68614753,128
"15013","ENSACAG00000020417","2",87861720,87861853,133
"15014","ENSACAG00000020418","GL343460.1",55134,55252,118
"15015","ENSACAG00000020440","GL343761.1",168370,168458,88
"15016","ENSACAG00000020444","2",40591763,40591859,96
"15017","ENSACAG00000020445","GL343411.1",556993,557270,277
"15018","ENSACAG00000020448","1",195481462,195481581,119
"15019","ENSACAG00000020449","6",31781705,31781799,94
"15020","ENSACAG00000020450","GL343288.1",1153291,1153612,321
"15021","ENSACAG00000020451","GL343542.1",134601,134710,109
"15022","ENSACAG00000020452","5",60957898,60958016,118
"15023","ENSACAG00000020453","GL343193.1",8868792,8868910,118
"15024","ENSACAG00000020454","4",71380323,71380400,77
"15025","ENSACAG00000020458","GL343194.1",3344902,3344986,84
"15026","ENSACAG00000020460","GL343204.1",2364254,2364373,119
"15027","ENSACAG00000020464","5",80359880,80360001,121
"15028","ENSACAG00000020471","2",17040341,17040459,118
"15029","ENSACAG00000020474","GL343329.1",798676,798798,122
"15030","ENSACAG00000020476","GL343983.1",99702,99822,120
"15031","ENSACAG00000020480","GL344047.1",114898,114971,73
"15032","ENSACAG00000020493","GL343344.1",80900,81017,117
"15033","ENSACAG00000020496","1",87863744,87863815,71
"15034","ENSACAG00000020500","GL343937.1",21123,21204,81
"15035","ENSACAG00000020509","GL343202.1",2101829,2102075,246
"15036","ENSACAG00000020511","GL343287.1",352550,352640,90
"15037","ENSACAG00000020512","1",152105713,152105831,118
"15038","ENSACAG00000020513","4",100643035,100643153,118
"15039","ENSACAG00000020525","2",139266026,139266148,122
"15040","ENSACAG00000020527","2",87905655,87905773,118
"15041","ENSACAG00000020528","5",1037444,1037545,101
"15042","ENSACAG00000020535","GL343226.1",2090096,2090219,123
"15043","ENSACAG00000020536","GL343202.1",2104811,2104887,76
"15044","ENSACAG00000020538","GL343308.1",705295,705413,118
"15045","ENSACAG00000020539","3",128912565,128912683,118
"15046","ENSACAG00000020542","GL343203.1",3572090,3572208,118
"15047","ENSACAG00000020543","GL343239.1",842895,843012,117
"15048","ENSACAG00000020550","2",116485827,116485945,118
"15049","ENSACAG00000020555","4",107913349,107913454,105
"15050","ENSACAG00000020556","4",31026009,31026091,82
"15051","ENSACAG00000020558","2",169107538,169107657,119
"15052","ENSACAG00000020561","GL343413.1",776340,776457,117
"15053","ENSACAG00000020562","3",128706047,128706166,119
"15054","ENSACAG00000020566","6",597758,597875,117
"15055","ENSACAG00000020568","GL343466.1",138064,138184,120
"15056","ENSACAG00000020572","3",117884296,117884658,362
"15057","ENSACAG00000020574","3",7379984,7380103,119
"15058","ENSACAG00000020576","LGa",2579061,2579147,86
"15059","ENSACAG00000020577","2",54256690,54256808,118
"15060","ENSACAG00000020581","GL343213.1",2445562,2445681,119
"15061","ENSACAG00000020583","4",111055641,111055708,67
"15062","ENSACAG00000020587","4",120764469,120764588,119
"15063","ENSACAG00000020589","3",169854078,169854200,122
"15064","ENSACAG00000020593","5",142963789,142963856,67
"15065","ENSACAG00000020594","6",67410340,67410458,118
"15066","ENSACAG00000020595","4",1747975,1748062,87
"15067","ENSACAG00000020597","GL343225.1",748260,748397,137
"15068","ENSACAG00000020598","GL343355.1",507834,507917,83
"15069","ENSACAG00000020599","GL343194.1",93379,93499,120
"15070","ENSACAG00000020600","GL343684.1",336501,336587,86
"15071","ENSACAG00000020611","3",141169335,141169455,120
"15072","ENSACAG00000020615","4",151864287,151864372,85
"15073","ENSACAG00000020619","4",101508019,101508137,118
"15074","ENSACAG00000020630","1",71731191,71731309,118
"15075","ENSACAG00000020633","GL343304.1",1631415,1631558,143
"15076","ENSACAG00000020640","4",78040245,78040363,118
"15077","ENSACAG00000020645","GL343611.1",135224,135346,122
"15078","ENSACAG00000020646","GL343302.1",1343707,1343825,118
"15079","ENSACAG00000020647","GL343359.1",336669,336787,118
"15080","ENSACAG00000020652","4",105767728,105767868,140
"15081","ENSACAG00000020653","3",196142409,196142492,83
"15082","ENSACAG00000020654","3",60528580,60528872,292
"15083","ENSACAG00000020655","GL343390.1",422529,422864,335
"15084","ENSACAG00000020656","1",193168223,193168312,89
"15085","ENSACAG00000020661","GL343904.1",142396,142606,210
"15086","ENSACAG00000020668","3",153990124,153990228,104
"15087","ENSACAG00000020672","3",196123133,196123204,71
"15088","ENSACAG00000020673","3",8008751,8009155,404
"15089","ENSACAG00000020674","2",144663971,144664309,338
"15090","ENSACAG00000020677","2",195581411,195581528,117
"15091","ENSACAG00000020692","GL343336.1",507313,507435,122
"15092","ENSACAG00000020696","GL343200.1",1171412,1171531,119
"15093","ENSACAG00000020700","GL343372.1",849428,849546,118
"15094","ENSACAG00000020707","4",128790509,128790792,283
"15095","ENSACAG00000020710","1",162546041,162546159,118
"15096","ENSACAG00000020716","2",31370585,31370703,118
"15097","ENSACAG00000020723","GL343467.1",141982,142052,70
"15098","ENSACAG00000020724","GL343504.1",479330,479448,118
"15099","ENSACAG00000020734","GL343225.1",747531,747646,115
"15100","ENSACAG00000020738","GL343255.1",1354424,1354751,327
"15101","ENSACAG00000020747","1",165674711,165675047,336
"15102","ENSACAG00000020750","2",71991616,71991709,93
"15103","ENSACAG00000020754","5",111609931,111610050,119
"15104","ENSACAG00000020755","GL343294.1",160957,161090,133
"15105","ENSACAG00000020771","GL343225.1",748895,748984,89
"15106","ENSACAG00000020777","2",79052102,79052188,86
"15107","ENSACAG00000020778","2",61607417,61607521,104
"15108","ENSACAG00000020779","GL343201.1",2373319,2373438,119
"15109","ENSACAG00000020780","GL343479.1",636452,636580,128
"15110","ENSACAG00000020781","GL344047.1",112342,112485,143
"15111","ENSACAG00000020786","4",49833624,49833744,120
"15112","ENSACAG00000020787","2",122658929,122659013,84
"15113","ENSACAG00000020807","1",64214370,64214550,180
"15114","ENSACAG00000020808","5",56828102,56828419,317
"15115","ENSACAG00000020809","2",759951,760068,117
"15116","ENSACAG00000020811","GL343623.1",189313,189406,93
"15117","ENSACAG00000020813","LGa",3022082,3022178,96
"15118","ENSACAG00000020818","2",165788064,165788182,118
"15119","ENSACAG00000020820","GL343574.1",166429,166568,139
"15120","ENSACAG00000020826","GL343539.1",83362,83444,82
"15121","ENSACAG00000020830","6",37177297,37177418,121
"15122","ENSACAG00000020834","2",8821781,8821900,119
"15123","ENSACAG00000020836","6",75666542,75666636,94
"15124","ENSACAG00000020840","6",46239115,46239234,119
"15125","ENSACAG00000020857","GL343210.1",3087970,3088090,120
"15126","ENSACAG00000020858","GL343270.1",997336,997456,120
"15127","ENSACAG00000020865","2",62447816,62447936,120
"15128","ENSACAG00000020867","5",45113296,45113414,118
"15129","ENSACAG00000020875","1",245180452,245180570,118
"15130","ENSACAG00000020880","2",39651187,39651492,305
"15131","ENSACAG00000020881","GL343293.1",191612,191732,120
"15132","ENSACAG00000020887","6",56468153,56468270,117
"15133","ENSACAG00000020889","5",36650142,36650409,267
"15134","ENSACAG00000020894","GL343216.1",603963,604054,91
"15135","ENSACAG00000020903","1",22776123,22776286,163
"15136","ENSACAG00000020910","GL343414.1",650768,650849,81
"15137","ENSACAG00000020913","1",10288521,10288643,122
"15138","ENSACAG00000020919","2",148502903,148503024,121
"15139","ENSACAG00000020921","4",89301897,89302015,118
"15140","ENSACAG00000020927","3",111785820,111785944,124
"15141","ENSACAG00000020931","5",27845002,27848269,3267
"15142","ENSACAG00000020934","GL343207.1",1405794,1474985,69191
"15143","ENSACAG00000020937","1",118848249,118849106,857
"15144","ENSACAG00000020938","4",16375057,16377201,2144
"15145","ENSACAG00000020942","2",103059200,103060456,1256
"15146","ENSACAG00000020943","GL343480.1",638060,642947,4887
"15147","ENSACAG00000020944","1",85288275,85365841,77566
"15148","ENSACAG00000020945","GL343381.1",11550,33962,22412
"15149","ENSACAG00000020946","GL343491.1",248421,249330,909
"15150","ENSACAG00000020949","GL343287.1",906014,911502,5488
"15151","ENSACAG00000020953","GL343608.1",135117,144163,9046
"15152","ENSACAG00000020960","4",22529667,22549014,19347
"15153","ENSACAG00000020961","GL343394.1",298157,303987,5830
"15154","ENSACAG00000020962","GL343475.1",560752,568412,7660
"15155","ENSACAG00000020966","AAWZ02039315",3668,4813,1145
"15156","ENSACAG00000020972","3",98798458,98799570,1112
"15157","ENSACAG00000020975","5",123438890,123439682,792
"15158","ENSACAG00000020981","LGa",6800626,6802185,1559
"15159","ENSACAG00000020984","GL343253.1",1662626,1675091,12465
"15160","ENSACAG00000020986","3",54033699,54074342,40643
"15161","ENSACAG00000020988","3",142513875,142514036,161
"15162","ENSACAG00000020994","GL344201.1",46596,54166,7570
"15163","ENSACAG00000020999","1",123501646,123505033,3387
"15164","ENSACAG00000021000","4",82555427,82563552,8125
"15165","ENSACAG00000021005","4",106835258,106836757,1499
"15166","ENSACAG00000021011","2",196204927,196205808,881
"15167","ENSACAG00000021013","6",60427484,60453148,25664
"15168","ENSACAG00000021014","1",136895442,136896416,974
"15169","ENSACAG00000021016","2",88186002,88196150,10148
"15170","ENSACAG00000021023","4",16704132,16705238,1106
"15171","ENSACAG00000021025","3",18059975,18060985,1010
"15172","ENSACAG00000021034","3",59425604,59512280,86676
"15173","ENSACAG00000021035","3",12570125,12570364,239
"15174","ENSACAG00000021036","GL343252.1",191448,192431,983
"15175","ENSACAG00000021037","GL343318.1",1259661,1331996,72335
"15176","ENSACAG00000021039","GL343833.1",131133,147014,15881
"15177","ENSACAG00000021042","6",47002640,47088872,86232
"15178","ENSACAG00000021043","GL343279.1",552493,552912,419
"15179","ENSACAG00000021047","GL343491.1",405382,405915,533
"15180","ENSACAG00000021048","2",89248786,89249898,1112
"15181","ENSACAG00000021049","GL343209.1",2583459,2588653,5194
"15182","ENSACAG00000021055","GL343239.1",2009759,2013901,4142
"15183","ENSACAG00000021057","GL343640.1",60469,66673,6204
"15184","ENSACAG00000021059","5",99328812,99340301,11489
"15185","ENSACAG00000021065","GL343770.1",108320,123838,15518
"15186","ENSACAG00000021069","4",144441509,144473013,31504
"15187","ENSACAG00000021072","4",94594205,94653782,59577
"15188","ENSACAG00000021076","1",41226764,41256283,29519
"15189","ENSACAG00000021077","3",131813921,131816746,2825
"15190","ENSACAG00000021080","GL343287.1",1328263,1328919,656
"15191","ENSACAG00000021083","3",120076414,120077268,854
"15192","ENSACAG00000021084","2",104784412,104784858,446
"15193","ENSACAG00000021095","GL343241.1",2014273,2028229,13956
"15194","ENSACAG00000021101","GL343770.1",169473,172052,2579
"15195","ENSACAG00000021103","GL343279.1",558066,558377,311
"15196","ENSACAG00000021104","GL343519.1",454683,463607,8924
"15197","ENSACAG00000021108","GL343384.1",940737,943642,2905
"15198","ENSACAG00000021110","1",151792312,151798015,5703
"15199","ENSACAG00000021111","GL343380.1",902543,902695,152
"15200","ENSACAG00000021112","4",82204275,82217421,13146
"15201","ENSACAG00000021118","GL343589.1",336532,342186,5654
"15202","ENSACAG00000021120","4",95565825,95568407,2582
"15203","ENSACAG00000021129","5",113896649,113897263,614
"15204","ENSACAG00000021130","GL343324.1",448159,449136,977
"15205","ENSACAG00000021135","5",130808868,130811195,2327
"15206","ENSACAG00000021136","GL344186.1",1657,2132,475
"15207","ENSACAG00000021137","4",16664713,16665492,779
"15208","ENSACAG00000021140","GL343241.1",374952,443112,68160
"15209","ENSACAG00000021141","GL343233.1",1634950,1643878,8928
"15210","ENSACAG00000021143","GL343267.1",1732242,1740223,7981
"15211","ENSACAG00000021144","5",37982877,38115241,132364
"15212","ENSACAG00000021146","4",16527308,16528192,884
"15213","ENSACAG00000021147","2",196847703,196925863,78160
"15214","ENSACAG00000021148","GL343319.1",1075012,1091124,16112
"15215","ENSACAG00000021151","GL343532.1",381694,477166,95472
"15216","ENSACAG00000021153","GL343354.1",260845,261495,650
"15217","ENSACAG00000021156","GL344047.1",113591,113725,134
"15218","ENSACAG00000021157","GL343446.1",634048,634165,117
"15219","ENSACAG00000021160","6",53485292,53485564,272
"15220","ENSACAG00000021163","1",174978339,174978457,118
"15221","ENSACAG00000021176","1",100485349,100485433,84
"15222","ENSACAG00000021177","GL343235.1",1129517,1129645,128
"15223","ENSACAG00000021181","2",158640214,158640331,117
"15224","ENSACAG00000021183","GL343410.1",629317,629437,120
"15225","ENSACAG00000021186","2",128450959,128451219,260
"15226","ENSACAG00000021189","GL343536.1",141997,142100,103
"15227","ENSACAG00000021191","3",196125747,196125872,125
"15228","ENSACAG00000021204","GL345028.1",5833,5902,69
"15229","ENSACAG00000021205","GL343566.1",322730,322867,137
"15230","ENSACAG00000021212","1",23782733,23782861,128
"15231","ENSACAG00000021216","2",26554195,26554283,88
"15232","ENSACAG00000021218","3",11722551,11722670,119
"15233","ENSACAG00000021221","AAWZ02037281",7779,7848,69
"15234","ENSACAG00000021224","AAWZ02036718",20684,20804,120
"15235","ENSACAG00000021226","GL344115.1",66771,66888,117
"15236","ENSACAG00000021229","3",29967609,29967734,125
"15237","ENSACAG00000021230","2",111081111,111081296,185
"15238","ENSACAG00000021231","3",104748088,104748181,93
"15239","ENSACAG00000021236","GL343320.1",1158278,1158383,105
"15240","ENSACAG00000021237","GL343203.1",3096433,3096556,123
"15241","ENSACAG00000021238","3",127995504,127995561,57
"15242","ENSACAG00000021243","GL343261.1",1445274,1445398,124
"15243","ENSACAG00000021247","2",195796302,195796426,124
"15244","ENSACAG00000021248","GL343304.1",1626077,1626144,67
"15245","ENSACAG00000021257","1",146541245,146541522,277
"15246","ENSACAG00000021259","3",65471359,65471478,119
"15247","ENSACAG00000021261","2",45614796,45614898,102
"15248","ENSACAG00000021263","GL343721.1",153869,153986,117
"15249","ENSACAG00000021266","GL343466.1",410854,410949,95
"15250","ENSACAG00000021279","6",18333993,18334112,119
"15251","ENSACAG00000021281","6",57759133,57759255,122
"15252","ENSACAG00000021287","4",124754197,124754559,362
"15253","ENSACAG00000021288","GL343305.1",1134286,1134423,137
"15254","ENSACAG00000021292","4",24486883,24487009,126
"15255","ENSACAG00000021302","GL343693.1",228883,228978,95
"15256","ENSACAG00000021321","1",167036004,167036135,131
"15257","ENSACAG00000021323","5",132534954,132535020,66
"15258","ENSACAG00000021325","3",178737585,178737640,55
"15259","ENSACAG00000021326","5",127379936,127380176,240
"15260","ENSACAG00000021334","6",8958319,8958439,120
"15261","ENSACAG00000021341","GL343210.1",1130909,1131029,120
"15262","ENSACAG00000021343","4",104540693,104540818,125
"15263","ENSACAG00000021356","6",51401783,51401909,126
"15264","ENSACAG00000021358","3",22377695,22377813,118
"15265","ENSACAG00000021359","3",142320846,142320964,118
"15266","ENSACAG00000021360","5",97796175,97796293,118
"15267","ENSACAG00000021362","4",135258099,135258227,128
"15268","ENSACAG00000021365","GL343243.1",1606236,1606540,304
"15269","ENSACAG00000021369","GL344332.1",17118,17237,119
"15270","ENSACAG00000021371","GL343198.1",1020177,1020299,122
"15271","ENSACAG00000021372","GL343207.1",3148557,3148644,87
"15272","ENSACAG00000021373","4",105608955,105609053,98
"15273","ENSACAG00000021376","4",71384505,71384570,65
"15274","ENSACAG00000021382","5",75326571,75326701,130
"15275","ENSACAG00000021384","6",6585638,6585757,119
"15276","ENSACAG00000021389","GL343519.1",489781,489907,126
"15277","ENSACAG00000021390","1",166628864,166628988,124
"15278","ENSACAG00000021396","6",69029620,69029732,112
"15279","ENSACAG00000021399","2",36973845,36973967,122
"15280","ENSACAG00000021401","1",23923362,23923480,118
"15281","ENSACAG00000021407","3",9267808,9267896,88
"15282","ENSACAG00000021411","1",228105259,228105345,86
"15283","ENSACAG00000021417","4",126365558,126365680,122
"15284","ENSACAG00000021418","5",129032797,129032927,130
"15285","ENSACAG00000021420","GL343193.1",6919260,6919359,99
"15286","ENSACAG00000021423","1",87682343,87682460,117
"15287","ENSACAG00000021429","AAWZ02041668",1529,1659,130
"15288","ENSACAG00000021430","3",35944772,35945038,266
"15289","ENSACAG00000021435","5",76860306,76860428,122
"15290","ENSACAG00000021440","1",251172328,251172430,102
"15291","ENSACAG00000021441","1",180540799,180540919,120
"15292","ENSACAG00000021448","GL343326.1",413195,413257,62
"15293","ENSACAG00000021452","GL343212.1",1924943,1925254,311
"15294","ENSACAG00000021459","GL343364.1",1027991,1028121,130
"15295","ENSACAG00000021460","6",32078570,32078689,119
"15296","ENSACAG00000021461","2",26903597,26903685,88
"15297","ENSACAG00000021463","3",187068861,187068981,120
"15298","ENSACAG00000021465","4",82258198,82258321,123
"15299","ENSACAG00000021466","GL343453.1",312120,312237,117
"15300","ENSACAG00000021472","2",116211142,116211270,128
"15301","ENSACAG00000021474","1",74810111,74810232,121
"15302","ENSACAG00000021476","2",150129846,150129969,123
"15303","ENSACAG00000021477","5",5671716,5671837,121
"15304","ENSACAG00000021480","3",204282478,204282597,119
"15305","ENSACAG00000021482","3",179433478,179433598,120
"15306","ENSACAG00000021484","GL343312.1",340620,340708,88
"15307","ENSACAG00000021485","1",228101272,228101365,93
"15308","ENSACAG00000021487","GL343671.1",7869,8003,134
"15309","ENSACAG00000021491","1",45592242,45592363,121
"15310","ENSACAG00000021495","6",36085159,36085273,114
"15311","ENSACAG00000021497","1",11707483,11707601,118
"15312","ENSACAG00000021498","1",11718129,11718250,121
"15313","ENSACAG00000021501","3",143013971,143014089,118
"15314","ENSACAG00000021511","GL343465.1",742735,742852,117
"15315","ENSACAG00000021516","1",124216697,124216817,120
"15316","ENSACAG00000021519","GL344130.1",73201,73326,125
"15317","ENSACAG00000021520","2",157095539,157095657,118
"15318","ENSACAG00000021523","GL343228.1",1119898,1120017,119
"15319","ENSACAG00000021525","1",169796966,169797213,247
"15320","ENSACAG00000021531","GL343225.1",1654685,1654810,125
"15321","ENSACAG00000021541","GL343275.1",1764911,1765028,117
"15322","ENSACAG00000021546","GL343304.1",1626727,1626808,81
"15323","ENSACAG00000021548","GL343335.1",269441,269561,120
"15324","ENSACAG00000021551","5",10555300,10555357,57
"15325","ENSACAG00000021554","4",81363498,81363556,58
"15326","ENSACAG00000021560","GL343286.1",792958,793034,76
"15327","ENSACAG00000021561","GL343468.1",360796,360913,117
"15328","ENSACAG00000021567","GL343575.1",351003,351120,117
"15329","ENSACAG00000021569","4",111059112,111059214,102
"15330","ENSACAG00000021573","GL343202.1",2105265,2105390,125
"15331","ENSACAG00000021574","2",128571479,128571602,123
"15332","ENSACAG00000021577","5",10316161,10316249,88
"15333","ENSACAG00000021580","GL343232.1",1201320,1201441,121
"15334","ENSACAG00000021588","2",99672842,99672924,82
"15335","ENSACAG00000021592","GL343273.1",1094184,1094317,133
"15336","ENSACAG00000021598","6",70376379,70376497,118
"15337","ENSACAG00000021600","GL343573.1",376155,376274,119
"15338","ENSACAG00000021602","GL343227.1",1312161,1312289,128
"15339","ENSACAG00000021603","1",204275009,204275325,316
"15340","ENSACAG00000021604","2",6307359,6307479,120
"15341","ENSACAG00000021608","4",155532793,155532921,128
"15342","ENSACAG00000021609","AAWZ02035000",30130,30214,84
"15343","ENSACAG00000021611","6",4531183,4531318,135
"15344","ENSACAG00000021613","6",24332483,24332767,284
"15345","ENSACAG00000021615","1",80005657,80005776,119
"15346","ENSACAG00000021625","5",5429707,5429825,118
"15347","ENSACAG00000021626","GL343200.1",2058713,2059004,291
"15348","ENSACAG00000021633","GL343738.1",22734,22850,116
"15349","ENSACAG00000021636","2",765018,765138,120
"15350","ENSACAG00000021640","GL343456.1",96329,96454,125
"15351","ENSACAG00000021643","GL343669.1",292726,292846,120
"15352","ENSACAG00000021649","2",110281583,110281701,118
"15353","ENSACAG00000021656","GL343203.1",552322,552584,262
"15354","ENSACAG00000021658","1",227531403,227531521,118
"15355","ENSACAG00000021666","GL343193.1",13232589,13232720,131
"15356","ENSACAG00000021670","1",83461729,83462078,349
"15357","ENSACAG00000021678","GL343321.1",114557,114686,129
"15358","ENSACAG00000021682","GL343220.1",1059598,1059918,320
"15359","ENSACAG00000021683","5",84062192,84062314,122
"15360","ENSACAG00000021690","GL343516.1",144887,145016,129
"15361","ENSACAG00000021700","GL343346.1",89950,90068,118
"15362","ENSACAG00000021703","GL343194.1",7464227,7464347,120
"15363","ENSACAG00000021704","5",1057763,1057886,123
"15364","ENSACAG00000021705","1",219041216,219041280,64
"15365","ENSACAG00000021713","3",52937748,52937914,166
"15366","ENSACAG00000021716","GL343276.1",1195901,1196032,131
"15367","ENSACAG00000021717","3",27883027,27883146,119
"15368","ENSACAG00000021726","GL343545.1",105014,105184,170
"15369","ENSACAG00000021727","GL343333.1",373532,373657,125
"15370","ENSACAG00000021732","1",73748942,73749071,129
"15371","ENSACAG00000021734","2",115149784,115149839,55
"15372","ENSACAG00000021738","1",114787754,114787971,217
"15373","ENSACAG00000021739","4",89132442,89132559,117
"15374","ENSACAG00000021742","2",37157224,37157343,119
"15375","ENSACAG00000021745","GL343404.1",539598,539676,78
"15376","ENSACAG00000021759","GL343743.1",30325,30490,165
"15377","ENSACAG00000021762","5",17358437,17358525,88
"15378","ENSACAG00000021771","1",26082172,26082293,121
"15379","ENSACAG00000021776","GL343306.1",1163467,1163602,135
"15380","ENSACAG00000021785","2",154867641,154867716,75
"15381","ENSACAG00000021794","6",69995425,69995546,121
"15382","ENSACAG00000021797","2",28552437,28552564,127
"15383","ENSACAG00000021803","4",138406967,138407093,126
"15384","ENSACAG00000021811","GL343243.1",341530,341651,121
"15385","ENSACAG00000021817","4",132802355,132802481,126
"15386","ENSACAG00000021823","GL344971.1",10449,10562,113
"15387","ENSACAG00000021824","6",65271353,65271473,120
"15388","ENSACAG00000021829","1",147382705,147382831,126
"15389","ENSACAG00000021836","1",148166989,148167107,118
"15390","ENSACAG00000021837","GL343497.1",79415,79539,124
"15391","ENSACAG00000021838","5",24641381,24641461,80
"15392","ENSACAG00000021845","6",27576773,27577046,273
"15393","ENSACAG00000021848","5",120301747,120301866,119
"15394","ENSACAG00000021853","2",160124931,160125049,118
"15395","ENSACAG00000021856","GL343337.1",305315,305440,125
"15396","ENSACAG00000021859","GL343332.1",1153747,1153871,124
"15397","ENSACAG00000021861","4",71383348,71383422,74
"15398","ENSACAG00000021870","GL343487.1",446159,446237,78
"15399","ENSACAG00000021873","5",129942829,129942947,118
"15400","ENSACAG00000021874","6",63149488,63149620,132
"15401","ENSACAG00000021876","2",28166876,28166994,118
"15402","ENSACAG00000021878","5",146988602,146988719,117
"15403","ENSACAG00000021881","GL343586.1",348417,348550,133
"15404","ENSACAG00000021889","5",6465598,6465716,118
"15405","ENSACAG00000021892","1",119760272,119760618,346
"15406","ENSACAG00000021893","GL343728.1",236607,236789,182
"15407","ENSACAG00000021896","3",1250404,1250525,121
"15408","ENSACAG00000021908","1",42363090,42363163,73
"15409","ENSACAG00000021910","3",35942651,35942930,279
"15410","ENSACAG00000021913","2",64620961,64621091,130
"15411","ENSACAG00000021914","5",27641512,27641646,134
"15412","ENSACAG00000021922","3",15482217,15482341,124
"15413","ENSACAG00000021923","3",29744520,29744644,124
"15414","ENSACAG00000021926","GL343298.1",1687644,1687771,127
"15415","ENSACAG00000021929","GL343329.1",1065568,1066083,515
"15416","ENSACAG00000021936","GL344869.1",4232,16271,12039
"15417","ENSACAG00000021937","2",89172477,89173515,1038
"15418","ENSACAG00000021938","GL343775.1",143192,171801,28609
"15419","ENSACAG00000021941","2",98724190,98724273,83
"15420","ENSACAG00000021944","AAWZ02038983",746,6748,6002
"15421","ENSACAG00000021945","AAWZ02036952",667,13450,12783
"15422","ENSACAG00000021948","3",159238401,159239147,746
"15423","ENSACAG00000021949","GL343438.1",739966,740033,67
"15424","ENSACAG00000021951","GL344417.1",2093,2614,521
"15425","ENSACAG00000021954","GL343362.1",69114,90843,21729
"15426","ENSACAG00000021957","GL343650.1",134115,138616,4501
"15427","ENSACAG00000021966","AAWZ02038832",946,1667,721
"15428","ENSACAG00000021969","2",149891038,149900639,9601
"15429","ENSACAG00000021973","2",116049007,116051722,2715
"15430","ENSACAG00000021974","AAWZ02036651",1540,17772,16232
"15431","ENSACAG00000021976","GL343220.1",976037,977397,1360
"15432","ENSACAG00000021978","3",28306514,28308990,2476
"15433","ENSACAG00000021979","4",76948948,76951380,2432
"15434","ENSACAG00000021980","GL343592.1",344775,370842,26067
"15435","ENSACAG00000021981","3",201755361,201755478,117
"15436","ENSACAG00000021982","GL343462.1",344583,345220,637
"15437","ENSACAG00000021986","1",150056025,150058363,2338
"15438","ENSACAG00000021992","1",162782104,162782895,791
"15439","ENSACAG00000021995","LGc",3440606,3453631,13025
"15440","ENSACAG00000021999","2",95666735,95685012,18277
"15441","ENSACAG00000022003","GL343405.1",5208,24479,19271
"15442","ENSACAG00000022004","2",116752294,116753085,791
"15443","ENSACAG00000022005","GL344898.1",9672,15926,6254
"15444","ENSACAG00000022006","GL343660.1",184031,186701,2670
"15445","ENSACAG00000022007","2",196783926,196788655,4729
"15446","ENSACAG00000022012","GL343724.1",172718,192335,19617
"15447","ENSACAG00000022013","3",70516751,70533388,16637
"15448","ENSACAG00000022014","4",122893960,122894058,98
"15449","ENSACAG00000022021","GL343277.1",1358494,1360024,1530
"15450","ENSACAG00000022022","4",150989811,151019232,29421
"15451","ENSACAG00000022023","GL344084.1",29727,31919,2192
"15452","ENSACAG00000022026","4",76878549,76880975,2426
"15453","ENSACAG00000022028","GL343312.1",952733,967169,14436
"15454","ENSACAG00000022029","GL343384.1",946696,993356,46660
"15455","ENSACAG00000022031","3",20144391,20145286,895
"15456","ENSACAG00000022032","GL343506.1",419551,467075,47524
"15457","ENSACAG00000022033","AAWZ02038687",45,9218,9173
"15458","ENSACAG00000022035","GL343202.1",65099,65968,869
"15459","ENSACAG00000022039","3",131466004,131466881,877
"15460","ENSACAG00000022040","GL344356.1",47896,55721,7825
"15461","ENSACAG00000022041","5",71870293,71871039,746
"15462","ENSACAG00000022044","GL343829.1",110324,160661,50337
"15463","ENSACAG00000022046","GL345117.1",1737,1937,200
"15464","ENSACAG00000022050","GL344485.1",1504,32934,31430
"15465","ENSACAG00000022055","GL344682.1",12947,13583,636
"15466","ENSACAG00000022058","6",47707631,47707915,284
"15467","ENSACAG00000022061","2",146730993,146733267,2274
"15468","ENSACAG00000022065","AAWZ02039701",522,7991,7469
"15469","ENSACAG00000022067","GL343238.1",289023,321884,32861
"15470","ENSACAG00000022068","4",77423926,77426574,2648
"15471","ENSACAG00000022072","LGb",2266525,2275583,9058
"15472","ENSACAG00000022075","2",195940193,195940846,653
"15473","ENSACAG00000022079","1",203257560,203260085,2525
"15474","ENSACAG00000022087","2",6887069,6915547,28478
"15475","ENSACAG00000022090","GL343750.1",234845,237885,3040
"15476","ENSACAG00000022091","GL343489.1",328514,370261,41747
"15477","ENSACAG00000022093","2",191552203,191586735,34532
"15478","ENSACAG00000022097","4",99388059,99389078,1019
"15479","ENSACAG00000022100","GL343245.1",1135043,1155433,20390
"15480","ENSACAG00000022111","GL344226.1",38467,66646,28179
"15481","ENSACAG00000022113","GL343260.1",1399329,1400123,794
"15482","ENSACAG00000022114","GL343640.1",33299,47988,14689
"15483","ENSACAG00000022121","GL343194.1",923461,924120,659
"15484","ENSACAG00000022125","1",118864159,118904238,40079
"15485","ENSACAG00000022126","GL343253.1",1869726,1875280,5554
"15486","ENSACAG00000022127","AAWZ02038985",8363,8747,384
"15487","ENSACAG00000022128","2",99777713,99777830,117
"15488","ENSACAG00000022129","2",119507061,119507342,281
"15489","ENSACAG00000022131","1",165254882,165260981,6099
"15490","ENSACAG00000022140","GL343326.1",959004,982604,23600
"15491","ENSACAG00000022141","1",36583294,36584297,1003
"15492","ENSACAG00000022144","GL344854.1",11157,16565,5408
"15493","ENSACAG00000022152","1",75334068,75334517,449
"15494","ENSACAG00000022154","6",36064640,36065201,561
"15495","ENSACAG00000022161","GL343997.1",33742,36032,2290
"15496","ENSACAG00000022167","AAWZ02038674",3545,10340,6795
"15497","ENSACAG00000022170","GL343931.1",39051,65856,26805
"15498","ENSACAG00000022172","AAWZ02041784",2111,5268,3157
"15499","ENSACAG00000022173","GL343532.1",256738,257895,1157
"15500","ENSACAG00000022174","GL343286.1",1672552,1673187,635
"15501","ENSACAG00000022176","GL344352.1",59894,60623,729
"15502","ENSACAG00000022181","GL343935.1",121424,123053,1629
"15503","ENSACAG00000022183","GL343933.1",88077,104792,16715
"15504","ENSACAG00000022185","GL343198.1",2625261,2625557,296
"15505","ENSACAG00000022186","4",77336007,77338451,2444
"15506","ENSACAG00000022187","1",211930830,211936039,5209
"15507","ENSACAG00000022188","AAWZ02038841",842,9886,9044
"15508","ENSACAG00000022195","GL343867.1",2099,17211,15112
"15509","ENSACAG00000022196","3",179305640,179305762,122
"15510","ENSACAG00000022200","AAWZ02038304",1516,11349,9833
"15511","ENSACAG00000022201","GL343640.1",316206,328938,12732
"15512","ENSACAG00000022204","AAWZ02040865",2910,6228,3318
"15513","ENSACAG00000022212","1",43360450,43361318,868
"15514","ENSACAG00000022217","GL343545.1",154410,154493,83
"15515","ENSACAG00000022222","AAWZ02041114",5234,5323,89
"15516","ENSACAG00000022224","AAWZ02036273",12978,14082,1104
"15517","ENSACAG00000022225","1",192114238,192115013,775
"15518","ENSACAG00000022228","GL343281.1",1553812,1580218,26406
"15519","ENSACAG00000022231","5",16608387,16609551,1164
"15520","ENSACAG00000022232","1",204227338,204227455,117
"15521","ENSACAG00000022234","GL343693.1",198380,211134,12754
"15522","ENSACAG00000022242","LGf",3365616,3366479,863
"15523","ENSACAG00000022243","GL343690.1",232632,240975,8343
"15524","ENSACAG00000022245","GL344264.1",21704,46492,24788
"15525","ENSACAG00000022247","AAWZ02039078",6751,8838,2087
"15526","ENSACAG00000022249","GL343414.1",375237,376566,1329
"15527","ENSACAG00000022250","5",48170088,48376983,206895
"15528","ENSACAG00000022253","GL343781.1",178186,183024,4838
"15529","ENSACAG00000022254","GL345028.1",7363,8654,1291
"15530","ENSACAG00000022255","3",174427406,174428571,1165
"15531","ENSACAG00000022260","1",183750647,183752573,1926
"15532","ENSACAG00000022261","GL343369.1",132837,134543,1706
"15533","ENSACAG00000022262","GL343406.1",251838,253244,1406
"15534","ENSACAG00000022265","2",160397927,160398010,83
"15535","ENSACAG00000022270","GL343329.1",1229430,1238742,9312
"15536","ENSACAG00000022272","AAWZ02040786",21,5560,5539
"15537","ENSACAG00000022278","GL343310.1",862392,863972,1580
"15538","ENSACAG00000022279","GL343406.1",790678,804075,13397
"15539","ENSACAG00000022280","GL343713.1",102551,111757,9206
"15540","ENSACAG00000022288","GL343482.1",99797,117577,17780
"15541","ENSACAG00000022289","2",39346110,39349473,3363
"15542","ENSACAG00000022291","AAWZ02038348",10328,11416,1088
"15543","ENSACAG00000022295","AAWZ02039196",21,6756,6735
"15544","ENSACAG00000022297","GL343724.1",53996,66961,12965
"15545","ENSACAG00000022298","GL344486.1",26065,32060,5995
"15546","ENSACAG00000022301","GL343482.1",53146,53253,107
"15547","ENSACAG00000022306","AAWZ02041495",3704,5129,1425
"15548","ENSACAG00000022310","GL343686.1",76431,76694,263
"15549","ENSACAG00000022317","6",53043033,53043905,872
"15550","ENSACAG00000022320","AAWZ02038354",1275,2683,1408
"15551","ENSACAG00000022321","5",124553472,124553948,476
"15552","ENSACAG00000022322","3",80895639,80896385,746
"15553","ENSACAG00000022323","1",132314232,132315547,1315
"15554","ENSACAG00000022335","AAWZ02039116",553,907,354
"15555","ENSACAG00000022336","GL343236.1",1707655,1712329,4674
"15556","ENSACAG00000022341","4",77412752,77415139,2387
"15557","ENSACAG00000022344","2",16949470,16984218,34748
"15558","ENSACAG00000022348","GL344406.1",14880,33970,19090
"15559","ENSACAG00000022350","GL343209.1",2486045,2574767,88722
"15560","ENSACAG00000022351","AAWZ02041743",1093,5038,3945
"15561","ENSACAG00000022354","4",149,1028,879
"15562","ENSACAG00000022358","2",118553556,118553693,137
"15563","ENSACAG00000022359","GL343521.1",270589,280596,10007
"15564","ENSACAG00000022360","2",71908820,71911179,2359
"15565","ENSACAG00000022361","3",61663563,61673283,9720
"15566","ENSACAG00000022363","AAWZ02038742",3984,5283,1299
"15567","ENSACAG00000022364","5",80952457,80952570,113
"15568","ENSACAG00000022366","5",12475039,12592841,117802
"15569","ENSACAG00000022369","AAWZ02038848",2994,9749,6755
"15570","ENSACAG00000022374","4",105001898,105022798,20900
"15571","ENSACAG00000022375","3",73727883,73732099,4216
"15572","ENSACAG00000022376","GL344465.1",21,10413,10392
"15573","ENSACAG00000022378","GL344760.1",2005,3288,1283
"15574","ENSACAG00000022381","GL345049.1",34613,40120,5507
"15575","ENSACAG00000022384","GL343296.1",450307,451407,1100
"15576","ENSACAG00000022389","GL343253.1",1511803,1517102,5299
"15577","ENSACAG00000022392","AAWZ02041433",81,1279,1198
"15578","ENSACAG00000022393","AAWZ02036838",5134,7102,1968
"15579","ENSACAG00000022397","4",131239563,131239644,81
"15580","ENSACAG00000022401","GL343691.1",96814,111368,14554
"15581","ENSACAG00000022405","4",40287054,40371607,84553
"15582","ENSACAG00000022407","GL343760.1",67836,78669,10833
"15583","ENSACAG00000022408","AAWZ02039442",3120,4489,1369
"15584","ENSACAG00000022410","1",76990950,76998967,8017
"15585","ENSACAG00000022415","GL343238.1",212068,227725,15657
"15586","ENSACAG00000022417","GL343706.1",65980,66066,86
"15587","ENSACAG00000022421","GL343955.1",7130,58978,51848
"15588","ENSACAG00000022428","GL343266.1",233346,234155,809
"15589","ENSACAG00000022429","AAWZ02040924",1922,3400,1478
"15590","ENSACAG00000022430","2",115555481,115556068,587
"15591","ENSACAG00000022431","GL343282.1",567355,567654,299
"15592","ENSACAG00000022432","2",194176950,194179429,2479
"15593","ENSACAG00000022434","LGc",6849338,6872565,23227
"15594","ENSACAG00000022438","GL343427.1",728036,736995,8959
"15595","ENSACAG00000022442","AAWZ02038989",1842,2498,656
"15596","ENSACAG00000022443","GL343803.1",16186,22103,5917
"15597","ENSACAG00000022448","3",23329287,23360197,30910
"15598","ENSACAG00000022454","AAWZ02037818",1478,1713,235
"15599","ENSACAG00000022462","GL343254.1",1992662,1993249,587
"15600","ENSACAG00000022463","GL343565.1",343338,361981,18643
"15601","ENSACAG00000022464","GL343650.1",276363,277349,986
"15602","ENSACAG00000022466","AAWZ02037942",4219,13551,9332
"15603","ENSACAG00000022469","GL343212.1",900694,905249,4555
"15604","ENSACAG00000022472","GL343305.1",10563,18334,7771
"15605","ENSACAG00000022474","1",6423405,6428473,5068
"15606","ENSACAG00000022476","LGc",4894704,4938839,44135
"15607","ENSACAG00000022477","GL344028.1",67753,75846,8093
"15608","ENSACAG00000022478","AAWZ02039040",730,4897,4167
"15609","ENSACAG00000022480","GL344074.1",33545,48268,14723
"15610","ENSACAG00000022486","5",120322949,120389767,66818
"15611","ENSACAG00000022489","5",3958383,3976778,18395
"15612","ENSACAG00000022492","3",145880089,145992949,112860
"15613","ENSACAG00000022493","GL344226.1",10507,22040,11533
"15614","ENSACAG00000022494","GL343777.1",11324,17462,6138
"15615","ENSACAG00000022501","GL343239.1",554933,558601,3668
"15616","ENSACAG00000022507","GL343252.1",359647,399666,40019
"15617","ENSACAG00000022510","GL343973.1",87904,106924,19020
"15618","ENSACAG00000022512","AAWZ02037740",9766,12348,2582
"15619","ENSACAG00000022515","1",210427175,210428757,1582
"15620","ENSACAG00000022516","GL343220.1",2110741,2111373,632
"15621","ENSACAG00000022518","AAWZ02037391",1317,2858,1541
"15622","ENSACAG00000022519","4",76732401,76734821,2420
"15623","ENSACAG00000022527","GL344746.1",19778,26040,6262
"15624","ENSACAG00000022528","AAWZ02038425",4705,5609,904
"15625","ENSACAG00000022530","GL343474.1",313384,326897,13513
"15626","ENSACAG00000022532","GL343211.1",2151839,2156106,4267
"15627","ENSACAG00000022533","AAWZ02038700",4261,10723,6462
"15628","ENSACAG00000022551","GL343952.1",39427,42769,3342
"15629","ENSACAG00000022555","4",66341962,66342839,877
"15630","ENSACAG00000022557","AAWZ02036395",3863,27590,23727
"15631","ENSACAG00000022559","1",109621691,109623358,1667
"15632","ENSACAG00000022560","2",57497729,57557822,60093
"15633","ENSACAG00000022562","GL343373.1",593399,593598,199
"15634","ENSACAG00000022567","GL343201.1",457716,458575,859
"15635","ENSACAG00000022568","GL343376.1",3438,5763,2325
"15636","ENSACAG00000022571","1",59608428,59782399,173971
"15637","ENSACAG00000022573","GL343274.1",1073491,1205310,131819
"15638","ENSACAG00000022574","3",128791951,128792994,1043
"15639","ENSACAG00000022577","GL343330.1",1378973,1385472,6499
"15640","ENSACAG00000022580","1",191899447,191900574,1127
"15641","ENSACAG00000022581","AAWZ02040145",229,5876,5647
"15642","ENSACAG00000022586","2",197151657,197186845,35188
"15643","ENSACAG00000022588","2",188046216,188046692,476
"15644","ENSACAG00000022589","AAWZ02039468",1655,2578,923
"15645","ENSACAG00000022590","2",113445839,113446235,396
"15646","ENSACAG00000022592","2",93830115,93844094,13979
"15647","ENSACAG00000022596","2",41899559,41939905,40346
"15648","ENSACAG00000022597","GL344572.1",4214,22141,17927
"15649","ENSACAG00000022598","4",114082566,114108300,25734
"15650","ENSACAG00000022602","GL343260.1",401132,410514,9382
"15651","ENSACAG00000022604","AAWZ02036422",2221,5057,2836
"15652","ENSACAG00000022605","2",127206654,127277595,70941
"15653","ENSACAG00000022608","5",6225941,6241743,15802
"15654","ENSACAG00000022609","AAWZ02039865",2232,4451,2219
"15655","ENSACAG00000022611","GL343434.1",592694,600791,8097
"15656","ENSACAG00000022613","GL344810.1",10201,18795,8594
"15657","ENSACAG00000022614","AAWZ02039248",1791,3413,1622
"15658","ENSACAG00000022617","GL343483.1",386963,421524,34561
"15659","ENSACAG00000022624","6",68892986,68929737,36751
"15660","ENSACAG00000022627","2",196961447,196969269,7822
"15661","ENSACAG00000022630","GL343324.1",273777,275633,1856
"15662","ENSACAG00000022633","GL343428.1",525506,534853,9347
"15663","ENSACAG00000022634","GL344714.1",2400,12173,9773
"15664","ENSACAG00000022635","4",16472577,16473407,830
"15665","ENSACAG00000022636","GL343717.1",228284,235164,6880
"15666","ENSACAG00000022637","4",29068192,29068959,767
"15667","ENSACAG00000022638","2",21849611,21850985,1374
"15668","ENSACAG00000022648","GL343626.1",212590,230675,18085
"15669","ENSACAG00000022649","GL343556.1",270552,271678,1126
"15670","ENSACAG00000022650","GL343473.1",347433,350998,3565
"15671","ENSACAG00000022652","3",186840265,186843687,3422
"15672","ENSACAG00000022657","GL343965.1",5794,84912,79118
"15673","ENSACAG00000022661","AAWZ02040028",4164,7460,3296
"15674","ENSACAG00000022662","AAWZ02037793",3041,7823,4782
"15675","ENSACAG00000022668","GL343433.1",571385,572152,767
"15676","ENSACAG00000022675","3",143623573,143624319,746
"15677","ENSACAG00000022681","1",167021181,167022048,867
"15678","ENSACAG00000022682","1",91357976,91358421,445
"15679","ENSACAG00000022686","GL344177.1",10398,22017,11619
"15680","ENSACAG00000022688","2",116058101,116082904,24803
"15681","ENSACAG00000022689","GL344289.1",50799,51132,333
"15682","ENSACAG00000022691","1",233984011,233985191,1180
"15683","ENSACAG00000022692","3",79081521,79082321,800
"15684","ENSACAG00000022693","GL343330.1",1168658,1172997,4339
"15685","ENSACAG00000022695","GL343208.1",538657,538878,221
"15686","ENSACAG00000022696","1",248332666,248332746,80
"15687","ENSACAG00000022698","GL343956.1",6522,7010,488
"15688","ENSACAG00000022699","GL343494.1",460540,460614,74
"15689","ENSACAG00000022700","GL343882.1",73354,82604,9250
"15690","ENSACAG00000022701","GL343318.1",902601,1124592,221991
"15691","ENSACAG00000022708","2",18447075,18447869,794
"15692","ENSACAG00000022711","GL343571.1",296384,298267,1883
"15693","ENSACAG00000022713","GL343487.1",634682,636149,1467
"15694","ENSACAG00000022717","6",77723252,77746985,23733
"15695","ENSACAG00000022718","GL343224.1",2192817,2192904,87
"15696","ENSACAG00000022723","GL344083.1",3312,35224,31912
"15697","ENSACAG00000022728","GL343777.1",264,7349,7085
"15698","ENSACAG00000022734","GL344883.1",21,12147,12126
"15699","ENSACAG00000022736","2",191715956,191770309,54353
"15700","ENSACAG00000022737","5",82909650,82910435,785
"15701","ENSACAG00000022738","GL343318.1",8609,34248,25639
"15702","ENSACAG00000022745","GL343915.1",63411,81262,17851
"15703","ENSACAG00000022748","2",199253127,199263409,10282
"15704","ENSACAG00000022750","GL343587.1",220575,251292,30717
"15705","ENSACAG00000022752","AAWZ02036273",24244,25516,1272
"15706","ENSACAG00000022756","GL343234.1",1807046,1807556,510
"15707","ENSACAG00000022758","GL343286.1",972344,972877,533
"15708","ENSACAG00000022760","GL343493.1",309614,310288,674
"15709","ENSACAG00000022763","AAWZ02035788",22309,24853,2544
"15710","ENSACAG00000022765","3",155979829,155980707,878
"15711","ENSACAG00000022766","GL343337.1",573573,573953,380
"15712","ENSACAG00000022771","5",136495918,136496694,776
"15713","ENSACAG00000022772","3",130483608,130488206,4598
"15714","ENSACAG00000022774","GL343282.1",573261,573849,588
"15715","ENSACAG00000022777","2",159262420,159262947,527
"15716","ENSACAG00000022780","3",186102058,186102540,482
"15717","ENSACAG00000022781","GL343266.1",1485949,1487322,1373
"15718","ENSACAG00000022788","AAWZ02040470",1821,2015,194
"15719","ENSACAG00000022789","GL343220.1",2093986,2095764,1778
"15720","ENSACAG00000022793","GL343630.1",154465,233666,79201
"15721","ENSACAG00000022796","GL343746.1",218055,223651,5596
"15722","ENSACAG00000022801","3",113939525,113989677,50152
"15723","ENSACAG00000022806","AAWZ02038480",6089,9943,3854
"15724","ENSACAG00000022808","4",107130690,107145208,14518
"15725","ENSACAG00000022809","4",77275630,77278098,2468
"15726","ENSACAG00000022810","GL343893.1",149541,150189,648
"15727","ENSACAG00000022811","AAWZ02035767",1704,11610,9906
"15728","ENSACAG00000022813","1",107001168,107001845,677
"15729","ENSACAG00000022814","GL343433.1",472869,478700,5831
"15730","ENSACAG00000022816","GL343291.1",771235,771352,117
"15731","ENSACAG00000022818","5",94756185,94758177,1992
"15732","ENSACAG00000022821","GL343673.1",9211,11346,2135
"15733","ENSACAG00000022825","1",18093100,18094015,915
"15734","ENSACAG00000022828","GL343497.1",162862,163769,907
"15735","ENSACAG00000022830","GL343313.1",1118647,1119492,845
"15736","ENSACAG00000022831","5",128791776,128791871,95
"15737","ENSACAG00000022832","GL343220.1",1399257,1406351,7094
"15738","ENSACAG00000022837","2",102858780,102865852,7072
"15739","ENSACAG00000022838","5",60846743,60847891,1148
"15740","ENSACAG00000022839","GL343279.1",242427,243100,673
"15741","ENSACAG00000022850","1",204059630,204059827,197
"15742","ENSACAG00000022851","5",37036857,37046706,9849
"15743","ENSACAG00000022852","3",193049761,193051167,1406
"15744","ENSACAG00000022853","GL343672.1",230103,243716,13613
"15745","ENSACAG00000022856","GL343224.1",1647411,1653017,5606
"15746","ENSACAG00000022860","GL343312.1",1012569,1019293,6724
"15747","ENSACAG00000022862","2",198166900,198167088,188
"15748","ENSACAG00000022863","GL343220.1",1438299,1438661,362
"15749","ENSACAG00000022864","GL344649.1",794,25227,24433
"15750","ENSACAG00000022866","GL343722.1",158417,161010,2593
"15751","ENSACAG00000022872","GL344491.1",11646,15253,3607
"15752","ENSACAG00000022875","GL343520.1",33049,35524,2475
"15753","ENSACAG00000022876","3",128569285,128570381,1096
"15754","ENSACAG00000022877","GL343547.1",4391,26245,21854
"15755","ENSACAG00000022881","AAWZ02041611",21,5275,5254
"15756","ENSACAG00000022883","GL343312.1",1323717,1324961,1244
"15757","ENSACAG00000022884","5",131497661,131498788,1127
"15758","ENSACAG00000022885","GL343734.1",205014,205951,937
"15759","ENSACAG00000022886","4",77430345,77432723,2378
"15760","ENSACAG00000022888","GL343319.1",58068,58657,589
"15761","ENSACAG00000022891","4",77073565,77076066,2501
"15762","ENSACAG00000022906","6",78733048,78742770,9722
"15763","ENSACAG00000022907","2",197062880,197068995,6115
"15764","ENSACAG00000022908","4",99869717,99882171,12454
"15765","ENSACAG00000022912","GL343680.1",166120,169995,3875
"15766","ENSACAG00000022913","AAWZ02040851",1846,3118,1272
"15767","ENSACAG00000022914","AAWZ02040896",170,1644,1474
"15768","ENSACAG00000022922","AAWZ02040809",2480,2587,107
"15769","ENSACAG00000022923","3",142529203,142529550,347
"15770","ENSACAG00000022924","5",137403969,137405702,1733
"15771","ENSACAG00000022931","5",19561001,19562165,1164
"15772","ENSACAG00000022932","AAWZ02038689",715,4378,3663
"15773","ENSACAG00000022933","1",93311018,93311533,515
"15774","ENSACAG00000022941","AAWZ02040816",552,668,116
"15775","ENSACAG00000022942","GL343245.1",1246670,1270149,23479
"15776","ENSACAG00000022944","4",74601952,74611140,9188
"15777","ENSACAG00000022948","4",123997781,123997921,140
"15778","ENSACAG00000022953","AAWZ02036545",7906,18207,10301
"15779","ENSACAG00000022957","1",162672018,162672638,620
"15780","ENSACAG00000022958","GL343337.1",750792,759810,9018
"15781","ENSACAG00000022959","AAWZ02037447",30,14667,14637
"15782","ENSACAG00000022960","1",92511904,92512886,982
"15783","ENSACAG00000022966","GL343525.1",172348,190706,18358
"15784","ENSACAG00000022970","GL344961.1",8983,12360,3377
"15785","ENSACAG00000022971","GL343354.1",31067,154451,123384
"15786","ENSACAG00000022979","AAWZ02041195",343,1705,1362
"15787","ENSACAG00000022982","AAWZ02038553",5359,6371,1012
"15788","ENSACAG00000022984","1",177210736,177212826,2090
"15789","ENSACAG00000022986","AAWZ02038334",1944,6667,4723
"15790","ENSACAG00000022988","4",87963540,87973438,9898
"15791","ENSACAG00000022990","4",76688786,76691206,2420
"15792","ENSACAG00000022991","GL343585.1",176983,186355,9372
"15793","ENSACAG00000022997","GL344800.1",6970,8655,1685
"15794","ENSACAG00000022998","GL343759.1",58399,72706,14307
"15795","ENSACAG00000022999","2",195059758,195079201,19443
"15796","ENSACAG00000023000","GL344392.1",7373,22278,14905
"15797","ENSACAG00000023001","5",108992847,108993228,381
"15798","ENSACAG00000023005","GL343312.1",1333515,1351515,18000
"15799","ENSACAG00000023009","LGf",56721,58670,1949
"15800","ENSACAG00000023013","GL343984.1",36844,63503,26659
"15801","ENSACAG00000023014","1",97113084,97114397,1313
"15802","ENSACAG00000023015","2",95789077,95799482,10405
"15803","ENSACAG00000023017","GL343193.1",6962845,6963390,545
"15804","ENSACAG00000023018","GL343312.1",516961,529344,12383
"15805","ENSACAG00000023019","AAWZ02039852",2138,7726,5588
"15806","ENSACAG00000023020","AAWZ02038341",10952,11137,185
"15807","ENSACAG00000023021","4",77008014,77010479,2465
"15808","ENSACAG00000023024","4",76914065,76916482,2417
"15809","ENSACAG00000023029","GL343253.1",1419716,1436678,16962
"15810","ENSACAG00000023036","1",248163759,248185456,21697
"15811","ENSACAG00000023038","GL343292.1",773931,784086,10155
"15812","ENSACAG00000023040","GL343532.1",82185,123726,41541
"15813","ENSACAG00000023044","1",197836370,197857026,20656
"15814","ENSACAG00000023047","1",245710337,245710421,84
"15815","ENSACAG00000023049","GL343378.1",95,7453,7358
"15816","ENSACAG00000023050","GL344354.1",365,496,131
"15817","ENSACAG00000023051","GL343291.1",1404055,1407400,3345
"15818","ENSACAG00000023058","5",130970195,130979396,9201
"15819","ENSACAG00000023059","2",197532732,197557744,25012
"15820","ENSACAG00000023062","GL343682.1",62043,69172,7129
"15821","ENSACAG00000023064","GL343434.1",139048,144986,5938
"15822","ENSACAG00000023067","AAWZ02037155",11978,18689,6711
"15823","ENSACAG00000023071","GL343193.1",11912799,12044051,131252
"15824","ENSACAG00000023072","1",24059680,24172255,112575
"15825","ENSACAG00000023076","LGa",448995,452240,3245
"15826","ENSACAG00000023080","1",162922164,162922717,553
"15827","ENSACAG00000023083","GL344082.1",44343,60020,15677
"15828","ENSACAG00000023090","GL343527.1",215889,216456,567
"15829","ENSACAG00000023091","AAWZ02041832",3233,4016,783
"15830","ENSACAG00000023095","3",170480294,170481618,1324
"15831","ENSACAG00000023096","GL343216.1",214451,225306,10855
"15832","ENSACAG00000023098","6",30714561,30716480,1919
"15833","ENSACAG00000023100","GL344343.1",452,3492,3040
"15834","ENSACAG00000023101","GL344070.1",45956,46298,342
"15835","ENSACAG00000023102","GL343757.1",36455,46044,9589
"15836","ENSACAG00000023103","5",45352864,45364662,11798
"15837","ENSACAG00000023104","GL343413.1",596146,648962,52816
"15838","ENSACAG00000023107","GL343203.1",4048542,4052283,3741
"15839","ENSACAG00000023109","AAWZ02037988",12302,13114,812
"15840","ENSACAG00000023116","GL343721.1",184127,200793,16666
"15841","ENSACAG00000023117","6",52701921,52703123,1202
"15842","ENSACAG00000023123","AAWZ02037326",1713,14988,13275
"15843","ENSACAG00000023124","2",199066870,199073164,6294
"15844","ENSACAG00000023125","5",48672536,48672870,334
"15845","ENSACAG00000023131","2",192954131,192957643,3512
"15846","ENSACAG00000023137","2",100231285,100232071,786
"15847","ENSACAG00000023141","1",5871685,5876236,4551
"15848","ENSACAG00000023143","AAWZ02036537",10689,12476,1787
"15849","ENSACAG00000023145","AAWZ02037240",5546,5616,70
"15850","ENSACAG00000023148","5",143048593,143049312,719
"15851","ENSACAG00000023149","GL343519.1",26457,73538,47081
"15852","ENSACAG00000023154","GL343434.1",315086,319035,3949
"15853","ENSACAG00000023155","AAWZ02038422",2111,3420,1309
"15854","ENSACAG00000023158","GL343330.1",1078474,1085201,6727
"15855","ENSACAG00000023160","6",77499836,77515116,15280
"15856","ENSACAG00000023162","GL343505.1",23203,29289,6086
"15857","ENSACAG00000023165","1",249437912,249438422,510
"15858","ENSACAG00000023166","GL344803.1",6947,18633,11686
"15859","ENSACAG00000023167","GL343952.1",21022,25860,4838
"15860","ENSACAG00000023169","6",16337346,16348628,11282
"15861","ENSACAG00000023173","1",206525788,206526690,902
"15862","ENSACAG00000023176","AAWZ02038921",2883,4553,1670
"15863","ENSACAG00000023178","GL343344.1",136028,136234,206
"15864","ENSACAG00000023181","GL344177.1",49646,51184,1538
"15865","ENSACAG00000023183","AAWZ02039409",1749,6873,5124
"15866","ENSACAG00000023190","1",92431748,92432701,953
"15867","ENSACAG00000023192","1",172183708,172184733,1025
"15868","ENSACAG00000023197","GL344495.1",4602,6041,1439
"15869","ENSACAG00000023200","4",76702680,76705097,2417
"15870","ENSACAG00000023202","AAWZ02036406",3371,27518,24147
"15871","ENSACAG00000023203","GL344866.1",21,7819,7798
"15872","ENSACAG00000023205","GL343710.1",250600,266853,16253
"15873","ENSACAG00000023206","GL344556.1",21374,22398,1024
"15874","ENSACAG00000023207","1",100139905,100334679,194774
"15875","ENSACAG00000023208","2",144604379,144609881,5502
"15876","ENSACAG00000023211","1",10404726,10405754,1028
"15877","ENSACAG00000023212","4",71736104,71740534,4430
"15878","ENSACAG00000023214","2",126976769,126977536,767
"15879","ENSACAG00000023215","GL343438.1",452464,452939,475
"15880","ENSACAG00000023217","GL343466.1",317297,317608,311
"15881","ENSACAG00000023218","GL344723.1",10142,19892,9750
"15882","ENSACAG00000023222","2",21871016,21871097,81
"15883","ENSACAG00000023223","GL343371.1",58837,123981,65144
"15884","ENSACAG00000023226","1",167420281,167433580,13299
"15885","ENSACAG00000023239","AAWZ02041539",411,5183,4772
"15886","ENSACAG00000023243","GL344668.1",644,22183,21539
"15887","ENSACAG00000023245","GL343204.1",3497445,3506904,9459
"15888","ENSACAG00000023247","GL343346.1",1090566,1095348,4782
"15889","ENSACAG00000023261","3",150983498,150984994,1496
"15890","ENSACAG00000023263","GL343489.1",406567,408820,2253
"15891","ENSACAG00000023264","GL343315.1",910231,912411,2180
"15892","ENSACAG00000023267","GL343779.1",157796,166014,8218
"15893","ENSACAG00000023269","GL343951.1",95106,97236,2130
"15894","ENSACAG00000023270","GL343487.1",542602,549460,6858
"15895","ENSACAG00000023272","4",79492781,79492898,117
"15896","ENSACAG00000023274","GL344507.1",38789,56281,17492
"15897","ENSACAG00000023284","1",204959731,204984242,24511
"15898","ENSACAG00000023286","GL343261.1",826113,841217,15104
"15899","ENSACAG00000023287","LGf",3763499,3801964,38465
"15900","ENSACAG00000023288","GL343935.1",73724,82633,8909
"15901","ENSACAG00000023290","1",25961818,25962727,909
"15902","ENSACAG00000023291","4",76891462,76893882,2420
"15903","ENSACAG00000023296","3",119175586,119176785,1199
"15904","ENSACAG00000023302","AAWZ02036000",3899,26479,22580
"15905","ENSACAG00000023305","AAWZ02036911",14590,17152,2562
"15906","ENSACAG00000023311","GL344659.1",148,22704,22556
"15907","ENSACAG00000023313","2",163074032,163075210,1178
"15908","ENSACAG00000023316","GL343357.1",385730,385847,117
"15909","ENSACAG00000023318","GL343473.1",439713,440450,737
"15910","ENSACAG00000023320","GL344408.1",45418,57983,12565
"15911","ENSACAG00000023321","AAWZ02039565",1027,4608,3581
"15912","ENSACAG00000023322","3",115601832,115603608,1776
"15913","ENSACAG00000023324","GL343973.1",92456,93572,1116
"15914","ENSACAG00000023325","GL343560.1",53385,53954,569
"15915","ENSACAG00000023328","1",213203315,213260136,56821
"15916","ENSACAG00000023334","AAWZ02038509",10393,11069,676
"15917","ENSACAG00000023336","1",207974821,207975606,785
"15918","ENSACAG00000023340","AAWZ02039497",3222,3500,278
"15919","ENSACAG00000023343","AAWZ02039501",2203,5738,3535
"15920","ENSACAG00000023345","GL343933.1",129762,130987,1225
"15921","ENSACAG00000023346","LGc",4110219,4110806,587
"15922","ENSACAG00000023357","GL343755.1",125242,125382,140
"15923","ENSACAG00000023359","GL344434.1",21034,22645,1611
"15924","ENSACAG00000023361","2",190373468,190379602,6134
"15925","ENSACAG00000023362","GL344469.1",3142,3489,347
"15926","ENSACAG00000023365","GL344211.1",49828,54630,4802
"15927","ENSACAG00000023371","GL344456.1",1029,2574,1545
"15928","ENSACAG00000023372","6",27808267,27808716,449
"15929","ENSACAG00000023373","4",155588422,155589318,896
"15930","ENSACAG00000023382","GL343257.1",976194,976595,401
"15931","ENSACAG00000023385","AAWZ02040729",2220,5618,3398
"15932","ENSACAG00000023386","GL343759.1",210175,210803,628
"15933","ENSACAG00000023388","AAWZ02038411",231,10643,10412
"15934","ENSACAG00000023394","AAWZ02038943",3763,7031,3268
"15935","ENSACAG00000023395","AAWZ02040759",21,6516,6495
"15936","ENSACAG00000023397","4",77380556,77382976,2420
"15937","ENSACAG00000023400","1",63681364,63682024,660
"15938","ENSACAG00000023403","2",45968406,45969179,773
"15939","ENSACAG00000023409","AAWZ02040377",41,7022,6981
"15940","ENSACAG00000023417","5",93656851,93658612,1761
"15941","ENSACAG00000023418","GL343673.1",39815,40397,582
"15942","ENSACAG00000023419","GL344294.1",19383,50845,31462
"15943","ENSACAG00000023420","LGf",4206516,4214477,7961
"15944","ENSACAG00000023422","GL344565.1",6101,23422,17321
"15945","ENSACAG00000023426","GL343281.1",1650766,1655288,4522
"15946","ENSACAG00000023435","LGf",938940,944965,6025
"15947","ENSACAG00000023439","GL344009.1",80622,84889,4267
"15948","ENSACAG00000023444","GL343400.1",482410,485981,3571
"15949","ENSACAG00000023445","1",43434875,43436074,1199
"15950","ENSACAG00000023447","4",77345314,77347761,2447
"15951","ENSACAG00000023449","2",93300027,93335722,35695
"15952","ENSACAG00000023451","AAWZ02038044",4026,13285,9259
"15953","ENSACAG00000023452","2",167009257,167010421,1164
"15954","ENSACAG00000023459","GL343267.1",1076819,1156992,80173
"15955","ENSACAG00000023461","GL344038.1",99616,99969,353
"15956","ENSACAG00000023466","GL343531.1",72787,73610,823
"15957","ENSACAG00000023469","1",49708690,49710573,1883
"15958","ENSACAG00000023472","4",146498328,146519374,21046
"15959","ENSACAG00000023475","GL343405.1",236798,238456,1658
"15960","ENSACAG00000023476","1",121628264,121655431,27167
"15961","ENSACAG00000023480","2",170627779,170630763,2984
"15962","ENSACAG00000023481","6",79699157,79727272,28115
"15963","ENSACAG00000023482","GL343717.1",238220,242361,4141
"15964","ENSACAG00000023485","1",7542020,7542787,767
"15965","ENSACAG00000023487","AAWZ02039608",2258,2469,211
"15966","ENSACAG00000023488","GL343194.1",4354062,4361651,7589
"15967","ENSACAG00000023489","3",92088605,92090708,2103
"15968","ENSACAG00000023495","1",203410572,203423204,12632
"15969","ENSACAG00000023496","GL343239.1",1721934,1773470,51536
"15970","ENSACAG00000023497","1",250408943,250409060,117
"15971","ENSACAG00000023499","4",76650877,76653291,2414
"15972","ENSACAG00000023502","GL344009.1",20228,20925,697
"15973","ENSACAG00000023503","GL343516.1",497362,502097,4735
"15974","ENSACAG00000023505","GL343443.1",564698,588394,23696
"15975","ENSACAG00000023506","5",10543965,10570876,26911
"15976","ENSACAG00000023513","3",113708106,113711543,3437
"15977","ENSACAG00000023519","3",74608022,74608767,745
"15978","ENSACAG00000023520","AAWZ02039320",574,6882,6308
"15979","ENSACAG00000023526","GL344256.1",765,8545,7780
"15980","ENSACAG00000023535","AAWZ02036616",22428,24245,1817
"15981","ENSACAG00000023540","GL343362.1",331780,397712,65932
"15982","ENSACAG00000023543","4",97569420,97581784,12364
"15983","ENSACAG00000023545","GL343194.1",10012402,10013601,1199
"15984","ENSACAG00000023546","GL343267.1",1487696,1499034,11338
"15985","ENSACAG00000023555","GL344191.1",87618,96791,9173
"15986","ENSACAG00000023556","4",76884496,76886922,2426
"15987","ENSACAG00000023562","AAWZ02036607",796,22892,22096
"15988","ENSACAG00000023566","GL343792.1",150888,166011,15123
"15989","ENSACAG00000023584","2",165498107,165500344,2237
"15990","ENSACAG00000023592","3",138462835,138488436,25601
"15991","ENSACAG00000023594","AAWZ02035903",13826,16388,2562
"15992","ENSACAG00000023598","6",27285,63895,36610
"15993","ENSACAG00000023601","GL343861.1",33512,34261,749
"15994","ENSACAG00000023612","GL344315.1",35623,37975,2352
"15995","ENSACAG00000023616","GL343226.1",2085725,2086507,782
"15996","ENSACAG00000023617","AAWZ02040264",3669,6065,2396
"15997","ENSACAG00000023618","3",71400062,71401904,1842
"15998","ENSACAG00000023620","GL343557.1",145699,146262,563
"15999","ENSACAG00000023621","GL344054.1",27241,29134,1893
"16000","ENSACAG00000023622","GL343491.1",485127,498437,13310
"16001","ENSACAG00000023623","1",182067913,182069628,1715
"16002","ENSACAG00000023624","3",15126986,15152743,25757
"16003","ENSACAG00000023632","GL343295.1",531351,536517,5166
"16004","ENSACAG00000023634","GL343771.1",12032,84600,72568
"16005","ENSACAG00000023635","GL343402.1",918700,922436,3736
"16006","ENSACAG00000023638","4",77358769,77361213,2444
"16007","ENSACAG00000023640","GL343837.1",42632,52712,10080
"16008","ENSACAG00000023646","6",79254813,79256622,1809
"16009","ENSACAG00000023648","3",157080752,157082623,1871
"16010","ENSACAG00000023649","GL343204.1",1732525,1734474,1949
"16011","ENSACAG00000023651","AAWZ02036522",38,205,167
"16012","ENSACAG00000023654","4",76966937,76969357,2420
"16013","ENSACAG00000023658","GL343682.1",17036,32345,15309
"16014","ENSACAG00000023660","GL343483.1",318434,320315,1881
"16015","ENSACAG00000023664","GL343733.1",94497,95270,773
"16016","ENSACAG00000023667","GL344164.1",21876,32715,10839
"16017","ENSACAG00000023669","GL343417.1",594131,652448,58317
"16018","ENSACAG00000023670","AAWZ02041581",68,3976,3908
"16019","ENSACAG00000023674","AAWZ02041899",1599,2505,906
"16020","ENSACAG00000023679","GL344216.1",25792,27330,1538
"16021","ENSACAG00000023681","GL344422.1",1949,6585,4636
"16022","ENSACAG00000023682","AAWZ02037398",3281,12718,9437
"16023","ENSACAG00000023684","GL343491.1",411361,412372,1011
"16024","ENSACAG00000023688","4",50923320,50924484,1164
"16025","ENSACAG00000023689","GL344726.1",5534,9163,3629
"16026","ENSACAG00000023690","GL344701.1",15277,16458,1181
"16027","ENSACAG00000023691","5",126883239,126883484,245
"16028","ENSACAG00000023697","GL343691.1",15619,20170,4551
"16029","ENSACAG00000023700","GL343222.1",2415476,2415655,179
"16030","ENSACAG00000023703","GL343282.1",578775,579364,589
"16031","ENSACAG00000023705","AAWZ02036549",10576,21960,11384
"16032","ENSACAG00000023710","GL343582.1",63056,65780,2724
"16033","ENSACAG00000023713","AAWZ02036400",8712,25166,16454
"16034","ENSACAG00000023714","AAWZ02037116",4302,12348,8046
"16035","ENSACAG00000023721","GL343434.1",1631,28076,26445
"16036","ENSACAG00000023729","AAWZ02039579",1856,3358,1502
"16037","ENSACAG00000023736","1",189445388,189453006,7618
"16038","ENSACAG00000023741","AAWZ02036810",5056,21166,16110
"16039","ENSACAG00000023742","6",67763234,67782997,19763
"16040","ENSACAG00000023749","GL343673.1",230426,238224,7798
"16041","ENSACAG00000023755","2",25904062,25904862,800
"16042","ENSACAG00000023758","AAWZ02041141",1441,2784,1343
"16043","ENSACAG00000023760","GL343717.1",288913,300418,11505
"16044","ENSACAG00000023762","3",192049389,192058962,9573
"16045","ENSACAG00000023769","GL343975.1",85693,105957,20264
"16046","ENSACAG00000023772","AAWZ02037049",11815,19822,8007
"16047","ENSACAG00000023775","6",45046948,45048610,1662
"16048","ENSACAG00000023776","AAWZ02038529",541,1194,653
"16049","ENSACAG00000023780","GL344082.1",29043,38194,9151
"16050","ENSACAG00000023781","1",180388006,180393826,5820
"16051","ENSACAG00000023782","3",111487337,111489415,2078
"16052","ENSACAG00000023788","GL343369.1",350992,351351,359
"16053","ENSACAG00000023791","GL343667.1",229582,244121,14539
"16054","ENSACAG00000023801","3",112110892,112137634,26742
"16055","ENSACAG00000023804","4",77039097,77041517,2420
"16056","ENSACAG00000023806","5",8252132,8254373,2241
"16057","ENSACAG00000023808","AAWZ02037800",3801,14463,10662
"16058","ENSACAG00000023809","1",68876430,68877836,1406
"16059","ENSACAG00000023810","GL343323.1",1227512,1228099,587
"16060","ENSACAG00000023811","1",102388596,102439102,50506
"16061","ENSACAG00000023814","GL344186.1",39222,39879,657
"16062","ENSACAG00000023817","LGf",2208199,2211558,3359
"16063","ENSACAG00000023819","AAWZ02037817",8633,10064,1431
"16064","ENSACAG00000023821","GL343276.1",1378296,1431222,52926
"16065","ENSACAG00000023822","AAWZ02038845",21,9546,9525
"16066","ENSACAG00000023823","1",216513610,216514086,476
"16067","ENSACAG00000023826","1",119461547,119529618,68071
"16068","ENSACAG00000023827","GL343553.1",67548,68757,1209
"16069","ENSACAG00000023828","3",117861737,117862672,935
"16070","ENSACAG00000023830","GL343442.1",182449,183702,1253
"16071","ENSACAG00000023831","4",131487366,131487551,185
"16072","ENSACAG00000023832","AAWZ02038347",1608,10832,9224
"16073","ENSACAG00000023833","GL343417.1",195500,196437,937
"16074","ENSACAG00000023834","GL343300.1",1647509,1648223,714
"16075","ENSACAG00000023835","GL343200.1",2429235,2429352,117
"16076","ENSACAG00000023836","2",192304343,192316423,12080
"16077","ENSACAG00000023838","GL343890.1",19126,19575,449
"16078","ENSACAG00000023839","GL344010.1",42596,44430,1834
"16079","ENSACAG00000023840","GL343626.1",55918,74789,18871
"16080","ENSACAG00000023847","4",82158614,82160362,1748
"16081","ENSACAG00000023848","4",2700154,2700921,767
"16082","ENSACAG00000023849","AAWZ02039847",662,6938,6276
"16083","ENSACAG00000023851","1",92865570,92882667,17097
"16084","ENSACAG00000023852","1",110649248,110650015,767
"16085","ENSACAG00000023855","GL343216.1",1660019,1660765,746
"16086","ENSACAG00000023856","5",16458847,16459788,941
"16087","ENSACAG00000023857","4",33707821,33792786,84965
"16088","ENSACAG00000023858","GL343498.1",525521,556629,31108
"16089","ENSACAG00000023859","GL343313.1",1193199,1193852,653
"16090","ENSACAG00000023862","1",180192184,180192808,624
"16091","ENSACAG00000023867","AAWZ02038649",3469,10656,7187
"16092","ENSACAG00000023869","GL343235.1",114976,140922,25946
"16093","ENSACAG00000023870","AAWZ02039987",21,7528,7507
"16094","ENSACAG00000023872","GL343619.1",159491,168892,9401
"16095","ENSACAG00000023873","GL343739.1",1131,23266,22135
"16096","ENSACAG00000023877","GL344195.1",38786,58936,20150
"16097","ENSACAG00000023883","6",21040874,21041278,404
"16098","ENSACAG00000023884","GL344988.1",2,11194,11192
"16099","ENSACAG00000023888","6",38059051,38059836,785
"16100","ENSACAG00000023890","GL343514.1",390268,411970,21702
"16101","ENSACAG00000023891","GL343585.1",357172,406495,49323
"16102","ENSACAG00000023892","1",74694051,74696359,2308
"16103","ENSACAG00000023895","GL343301.1",817842,818429,587
"16104","ENSACAG00000023898","AAWZ02038308",2615,12141,9526
"16105","ENSACAG00000023901","AAWZ02037424",12988,16612,3624
"16106","ENSACAG00000023904","AAWZ02039667",581,7933,7352
"16107","ENSACAG00000023906","1",67844978,67845095,117
"16108","ENSACAG00000023912","GL344221.1",22830,25355,2525
"16109","ENSACAG00000023913","GL343440.1",678890,679731,841
"16110","ENSACAG00000023914","5",109124185,109144950,20765
"16111","ENSACAG00000023921","4",115688392,115688748,356
"16112","ENSACAG00000023924","GL343841.1",151308,162318,11010
"16113","ENSACAG00000023925","GL343390.1",90320,163512,73192
"16114","ENSACAG00000023926","GL343274.1",1228542,1242539,13997
"16115","ENSACAG00000023927","GL344026.1",3460,16259,12799
"16116","ENSACAG00000023931","GL343252.1",14484,20512,6028
"16117","ENSACAG00000023939","GL343628.1",94699,95050,351
"16118","ENSACAG00000023940","GL343434.1",292314,296903,4589
"16119","ENSACAG00000023941","AAWZ02037349",8175,9560,1385
"16120","ENSACAG00000023950","GL343575.1",19040,66237,47197
"16121","ENSACAG00000023951","4",49510490,49555258,44768
"16122","ENSACAG00000023953","AAWZ02037424",9579,10169,590
"16123","ENSACAG00000023955","GL343220.1",982867,983778,911
"16124","ENSACAG00000023959","GL344207.1",37419,38304,885
"16125","ENSACAG00000023962","GL343603.1",21761,30870,9109
"16126","ENSACAG00000023969","GL343775.1",11992,13761,1769
"16127","ENSACAG00000023970","GL343438.1",107492,113029,5537
"16128","ENSACAG00000023971","5",24459268,24460040,772
"16129","ENSACAG00000023972","AAWZ02039231",44,7496,7452
"16130","ENSACAG00000023975","1",190626279,190626819,540
"16131","ENSACAG00000023976","GL343199.1",58755,59620,865
"16132","ENSACAG00000023978","LGf",3981422,3982654,1232
"16133","ENSACAG00000023980","4",42644646,42646911,2265
"16134","ENSACAG00000023981","GL343908.1",63425,100126,36701
"16135","ENSACAG00000023984","GL343312.1",997672,1003310,5638
"16136","ENSACAG00000023986","6",65889012,65910807,21795
"16137","ENSACAG00000023988","3",45472146,45472742,596
"16138","ENSACAG00000023996","5",21440266,21469371,29105
"16139","ENSACAG00000024002","GL343573.1",305930,311662,5732
"16140","ENSACAG00000024006","GL343571.1",1831,47102,45271
"16141","ENSACAG00000024007","GL344677.1",9997,22811,12814
"16142","ENSACAG00000024008","GL344423.1",8755,10267,1512
"16143","ENSACAG00000024010","AAWZ02039538",2675,5213,2538
"16144","ENSACAG00000024011","4",77309198,77311624,2426
"16145","ENSACAG00000024012","3",53827394,53974485,147091
"16146","ENSACAG00000024018","2",25434070,25434418,348
"16147","ENSACAG00000024019","GL343241.1",1005930,1050749,44819
"16148","ENSACAG00000024021","GL343507.1",220462,220629,167
"16149","ENSACAG00000024024","1",5744416,5763225,18809
"16150","ENSACAG00000024029","AAWZ02036989",14742,15734,992
"16151","ENSACAG00000024034","1",128950925,128956490,5565
"16152","ENSACAG00000024038","5",86568758,86568987,229
"16153","ENSACAG00000024039","GL343676.1",69112,82322,13210
"16154","ENSACAG00000024042","GL344222.1",50113,50208,95
"16155","ENSACAG00000024049","3",175632847,175634013,1166
"16156","ENSACAG00000024053","GL343423.1",1408,2502,1094
"16157","ENSACAG00000024054","1",28335370,28336287,917
"16158","ENSACAG00000024055","3",40480390,40480507,117
"16159","ENSACAG00000024056","GL343439.1",113187,118838,5651
"16160","ENSACAG00000024058","2",113247806,113303881,56075
"16161","ENSACAG00000024062","GL343312.1",30777,37529,6752
"16162","ENSACAG00000024063","3",131776760,131778946,2186
"16163","ENSACAG00000024064","GL344238.1",54318,54385,67
"16164","ENSACAG00000024069","GL343751.1",27535,29374,1839
"16165","ENSACAG00000024072","GL343228.1",995012,995242,230
"16166","ENSACAG00000024075","5",53958160,53958360,200
"16167","ENSACAG00000024077","GL343357.1",21825,22001,176
"16168","ENSACAG00000024078","1",66478072,66478666,594
"16169","ENSACAG00000024081","AAWZ02039289",774,2823,2049
"16170","ENSACAG00000024083","1",205439218,205490633,51415
"16171","ENSACAG00000024084","GL344307.1",746,7201,6455
"16172","ENSACAG00000024086","3",134311391,134312729,1338
"16173","ENSACAG00000024089","2",189548776,189566042,17266
"16174","ENSACAG00000024093","GL343355.1",491364,497715,6351
"16175","ENSACAG00000024094","4",77317799,77320222,2423
"16176","ENSACAG00000024096","GL343931.1",22683,35780,13097
"16177","ENSACAG00000024098","GL344402.1",18779,31078,12299
"16178","ENSACAG00000024100","GL344054.1",71151,93824,22673
"16179","ENSACAG00000024104","4",25714900,25716638,1738
"16180","ENSACAG00000024105","3",156949502,156950897,1395
"16181","ENSACAG00000024109","2",102822859,102825776,2917
"16182","ENSACAG00000024110","AAWZ02039384",4666,5910,1244
"16183","ENSACAG00000024111","GL343421.1",13037,13824,787
"16184","ENSACAG00000024113","2",130531450,130534803,3353
"16185","ENSACAG00000024115","GL343793.1",2609,45988,43379
"16186","ENSACAG00000024118","GL343812.1",1439,4616,3177
"16187","ENSACAG00000024120","3",183689772,183692823,3051
"16188","ENSACAG00000024122","GL343282.1",529695,530006,311
"16189","ENSACAG00000024126","GL343218.1",1027098,1028048,950
"16190","ENSACAG00000024130","AAWZ02037584",28,15405,15377
"16191","ENSACAG00000024132","GL344252.1",3384,46625,43241
"16192","ENSACAG00000024133","GL343442.1",880721,891971,11250
"16193","ENSACAG00000024134","GL344774.1",8565,10897,2332
"16194","ENSACAG00000024136","GL343571.1",343652,381239,37587
"16195","ENSACAG00000024140","GL343392.1",127921,131583,3662
"16196","ENSACAG00000024142","GL343568.1",452196,452325,129
"16197","ENSACAG00000024147","GL343626.1",8361,37913,29552
"16198","ENSACAG00000024148","GL344017.1",3962,4868,906
"16199","ENSACAG00000024149","4",76747788,76750205,2417
"16200","ENSACAG00000024151","1",218361691,218386606,24915
"16201","ENSACAG00000024153","GL343312.1",1285768,1290133,4365
"16202","ENSACAG00000024154","4",16410675,16414844,4169
"16203","ENSACAG00000024155","GL343253.1",1048593,1051209,2616
"16204","ENSACAG00000024163","6",76181008,76195890,14882
"16205","ENSACAG00000024164","GL343297.1",174091,188196,14105
"16206","ENSACAG00000024167","1",13522598,13541905,19307
"16207","ENSACAG00000024168","GL343728.1",8144,10319,2175
"16208","ENSACAG00000024176","AAWZ02038847",4300,6408,2108
"16209","ENSACAG00000024177","GL343313.1",1186999,1187073,74
"16210","ENSACAG00000024181","6",77508053,77508387,334
"16211","ENSACAG00000024183","GL343205.1",3982770,3983687,917
"16212","ENSACAG00000024185","GL343821.1",10031,65033,55002
"16213","ENSACAG00000024186","GL343212.1",2737527,2742986,5459
"16214","ENSACAG00000024192","GL344495.1",25312,27261,1949
"16215","ENSACAG00000024196","GL344449.1",17355,17826,471
"16216","ENSACAG00000024197","GL343579.1",74024,74884,860
"16217","ENSACAG00000024204","GL344631.1",5578,25542,19964
"16218","ENSACAG00000024206","GL343237.1",1531553,1531660,107
"16219","ENSACAG00000024210","AAWZ02037142",191,4659,4468
"16220","ENSACAG00000024211","1",212068349,212069879,1530
"16221","ENSACAG00000024213","AAWZ02037214",1173,1910,737
"16222","ENSACAG00000024219","GL343733.1",251317,252177,860
"16223","ENSACAG00000024220","6",54004838,54006119,1281
"16224","ENSACAG00000024221","GL343220.1",1255741,1255858,117
"16225","ENSACAG00000024222","1",157882361,157883053,692
"16226","ENSACAG00000024226","GL343324.1",688076,688163,87
"16227","ENSACAG00000024228","3",184576323,184577044,721
"16228","ENSACAG00000024229","AAWZ02039418",2513,8614,6101
"16229","ENSACAG00000024230","GL343286.1",1238598,1251011,12413
"16230","ENSACAG00000024231","AAWZ02039369",341,8719,8378
"16231","ENSACAG00000024235","GL343934.1",30496,57198,26702
"16232","ENSACAG00000024236","GL343194.1",9952280,9958719,6439
"16233","ENSACAG00000024240","GL343406.1",487132,495383,8251
"16234","ENSACAG00000024241","GL343625.1",140329,141560,1231
"16235","ENSACAG00000024242","GL343282.1",588802,599691,10889
"16236","ENSACAG00000024243","1",259910086,259921772,11686
"16237","ENSACAG00000024244","3",138622980,138624517,1537
"16238","ENSACAG00000024248","2",67380477,67401110,20633
"16239","ENSACAG00000024251","GL343447.1",272163,279415,7252
"16240","ENSACAG00000024255","GL343220.1",845221,848247,3026
"16241","ENSACAG00000024260","AAWZ02037037",16471,16587,116
"16242","ENSACAG00000024262","GL344147.1",81195,82805,1610
"16243","ENSACAG00000024265","GL343312.1",903843,919328,15485
"16244","ENSACAG00000024267","1",171613139,171643310,30171
"16245","ENSACAG00000024269","GL343544.1",215994,220919,4925
"16246","ENSACAG00000024271","GL343868.1",20789,28934,8145
"16247","ENSACAG00000024274","3",61169794,61170540,746
"16248","ENSACAG00000024277","4",80755276,80756064,788
"16249","ENSACAG00000024278","3",167508259,167519462,11203
"16250","ENSACAG00000024280","AAWZ02035786",13349,16549,3200
"16251","ENSACAG00000024282","4",76666184,76668601,2417
"16252","ENSACAG00000024291","GL343402.1",728096,747886,19790
"16253","ENSACAG00000024293","1",218060449,218063758,3309
"16254","ENSACAG00000024296","AAWZ02039665",396,4303,3907
"16255","ENSACAG00000024302","6",55819466,55819903,437
"16256","ENSACAG00000024303","1",245217063,245238189,21126
"16257","ENSACAG00000024305","5",118536903,118537862,959
"16258","ENSACAG00000024307","3",138885886,138886672,786
"16259","ENSACAG00000024308","2",196598697,196599565,868
"16260","ENSACAG00000024309","AAWZ02038573",7544,9660,2116
"16261","ENSACAG00000024312","GL343244.1",1133731,1150368,16637
"16262","ENSACAG00000024314","4",121517377,121524289,6912
"16263","ENSACAG00000024323","GL343645.1",42275,43339,1064
"16264","ENSACAG00000024324","1",11644897,11645022,125
"16265","ENSACAG00000024325","GL344780.1",18893,20039,1146
"16266","ENSACAG00000024335","3",39648420,39666461,18041
"16267","ENSACAG00000024337","AAWZ02041113",350,4187,3837
"16268","ENSACAG00000024338","AAWZ02038693",2592,9073,6481
"16269","ENSACAG00000024339","2",54552485,54567510,15025
"16270","ENSACAG00000024341","GL344017.1",34354,35935,1581
"16271","ENSACAG00000024342","GL343281.1",813874,835116,21242
"16272","ENSACAG00000024343","GL344384.1",22052,29750,7698
"16273","ENSACAG00000024345","GL343194.1",3618299,3618411,112
"16274","ENSACAG00000024351","GL344187.1",48289,63468,15179
"16275","ENSACAG00000024353","GL343772.1",34040,44229,10189
"16276","ENSACAG00000024355","GL344411.1",32212,38763,6551
"16277","ENSACAG00000024362","2",143880778,143881536,758
"16278","ENSACAG00000024363","GL343193.1",3591167,3592480,1313
"16279","ENSACAG00000024371","1",229383510,229385356,1846
"16280","ENSACAG00000024372","5",143203823,143204068,245
"16281","ENSACAG00000024374","5",22543369,22543486,117
"16282","ENSACAG00000024380","AAWZ02037659",14195,15169,974
"16283","ENSACAG00000024384","2",192217312,192218967,1655
"16284","ENSACAG00000024387","GL343194.1",5153726,5163316,9590
"16285","ENSACAG00000024388","GL343571.1",432018,433778,1760
"16286","ENSACAG00000024392","AAWZ02039803",745,7530,6785
"16287","ENSACAG00000024402","GL344741.1",6503,6611,108
"16288","ENSACAG00000024403","2",174420747,174420835,88
"16289","ENSACAG00000024407","GL343434.1",123112,131103,7991
"16290","ENSACAG00000024409","GL343507.1",89234,96389,7155
"16291","ENSACAG00000024412","AAWZ02041777",2166,5180,3014
"16292","ENSACAG00000024414","GL343361.1",130910,133312,2402
"16293","ENSACAG00000024417","5",45407237,45412225,4988
"16294","ENSACAG00000024419","4",148016850,148018099,1249
"16295","ENSACAG00000024422","GL344293.1",48248,48343,95
"16296","ENSACAG00000024425","GL344102.1",39014,73209,34195
"16297","ENSACAG00000024426","4",55554947,55556812,1865
"16298","ENSACAG00000024430","AAWZ02036251",15305,16957,1652
"16299","ENSACAG00000024431","GL343710.1",193640,195505,1865
"16300","ENSACAG00000024435","AAWZ02041785",4077,4215,138
"16301","ENSACAG00000024436","AAWZ02038665",3150,4763,1613
"16302","ENSACAG00000024440","GL344166.1",56326,58359,2033
"16303","ENSACAG00000024445","GL343772.1",15324,20017,4693
"16304","ENSACAG00000024450","GL344975.1",2250,4652,2402
"16305","ENSACAG00000024453","GL343882.1",106425,114940,8515
"16306","ENSACAG00000024458","AAWZ02039210",3284,8959,5675
"16307","ENSACAG00000024462","2",88804981,88870896,65915
"16308","ENSACAG00000024463","GL343256.1",1954600,2005923,51323
"16309","ENSACAG00000024464","AAWZ02041846",1222,3453,2231
"16310","ENSACAG00000024466","GL343394.1",758125,762575,4450
"16311","ENSACAG00000024471","GL343245.1",1271040,1288518,17478
"16312","ENSACAG00000024472","1",102327967,102329621,1654
"16313","ENSACAG00000024486","GL343253.1",670958,672170,1212
"16314","ENSACAG00000024488","2",120331020,120332680,1660
"16315","ENSACAG00000024490","1",77790650,77791784,1134
"16316","ENSACAG00000024492","AAWZ02040605",1726,4251,2525
"16317","ENSACAG00000024495","GL344139.1",42219,42335,116
"16318","ENSACAG00000024496","6",57338076,57386410,48334
"16319","ENSACAG00000024498","GL343392.1",628560,629327,767
"16320","ENSACAG00000024500","1",93002371,93012840,10469
"16321","ENSACAG00000024504","3",78357196,78357672,476
"16322","ENSACAG00000024505","GL343750.1",190839,191581,742
"16323","ENSACAG00000024508","GL343330.1",545272,559023,13751
"16324","ENSACAG00000024510","GL343282.1",531889,532194,305
"16325","ENSACAG00000024511","GL343713.1",235184,246484,11300
"16326","ENSACAG00000024512","AAWZ02035952",19737,21273,1536
"16327","ENSACAG00000024514","GL343672.1",107039,108040,1001
"16328","ENSACAG00000024515","GL344182.1",2496,9201,6705
"16329","ENSACAG00000024516","GL343346.1",692324,693034,710
"16330","ENSACAG00000024523","GL344346.1",29441,38098,8657
"16331","ENSACAG00000024525","AAWZ02038395",964,11788,10824
"16332","ENSACAG00000024526","5",109031968,109039991,8023
"16333","ENSACAG00000024528","GL344134.1",49398,57133,7735
"16334","ENSACAG00000024530","GL343466.1",310644,310955,311
"16335","ENSACAG00000024537","GL343317.1",794106,798560,4454
"16336","ENSACAG00000024540","6",766807,782091,15284
"16337","ENSACAG00000024545","GL343211.1",173401,174012,611
"16338","ENSACAG00000024548","GL343491.1",461752,525278,63526
"16339","ENSACAG00000024549","4",76804904,76819005,14101
"16340","ENSACAG00000024558","GL343237.1",225241,226972,1731
"16341","ENSACAG00000024559","2",189037489,189042398,4909
"16342","ENSACAG00000024561","GL343434.1",362029,368357,6328
"16343","ENSACAG00000024562","AAWZ02039815",857,6005,5148
"16344","ENSACAG00000024566","2",65959613,65960404,791
"16345","ENSACAG00000024567","AAWZ02041075",4855,5699,844
"16346","ENSACAG00000024570","GL343253.1",565120,566049,929
"16347","ENSACAG00000024574","5",128153094,128153683,589
"16348","ENSACAG00000024575","AAWZ02037881",9206,10962,1756
"16349","ENSACAG00000024578","GL343548.1",84374,85096,722
"16350","ENSACAG00000024579","GL343413.1",266156,277946,11790
"16351","ENSACAG00000024581","GL343312.1",857568,859116,1548
"16352","ENSACAG00000024584","GL344095.1",46797,78347,31550
"16353","ENSACAG00000024585","5",82759353,82760883,1530
"16354","ENSACAG00000024586","GL344353.1",3509,5758,2249
"16355","ENSACAG00000024587","2",142492457,142493246,789
"16356","ENSACAG00000024589","GL344264.1",17820,18385,565
"16357","ENSACAG00000024590","1",111866077,111867314,1237
"16358","ENSACAG00000024591","GL344758.1",4472,8956,4484
"16359","ENSACAG00000024599","GL343241.1",918027,919755,1728
"16360","ENSACAG00000024600","4",80682945,80684096,1151
"16361","ENSACAG00000024604","5",55208974,55209070,96
"16362","ENSACAG00000024609","2",172655545,172656744,1199
"16363","ENSACAG00000024611","AAWZ02038961",3938,6010,2072
"16364","ENSACAG00000024617","GL343978.1",1040,39794,38754
"16365","ENSACAG00000024618","GL343392.1",282285,284652,2367
"16366","ENSACAG00000024619","GL343359.1",302478,302575,97
"16367","ENSACAG00000024620","AAWZ02040501",4060,6813,2753
"16368","ENSACAG00000024622","3",131090721,131091585,864
"16369","ENSACAG00000024624","AAWZ02038017",1780,5447,3667
"16370","ENSACAG00000024626","6",60189210,60189275,65
"16371","ENSACAG00000024629","GL343197.1",4211998,4274141,62143
"16372","ENSACAG00000024631","AAWZ02037913",3201,8853,5652
"16373","ENSACAG00000024632","5",45310861,45326371,15510
"16374","ENSACAG00000024637","AAWZ02036909",6,9671,9665
"16375","ENSACAG00000024638","GL343520.1",520203,542297,22094
"16376","ENSACAG00000024648","AAWZ02041770",2,4316,4314
"16377","ENSACAG00000024653","5",31631354,31632455,1101
"16378","ENSACAG00000024655","GL345052.1",10318,11323,1005
"16379","ENSACAG00000024656","GL343224.1",984929,996675,11746
"16380","ENSACAG00000024658","AAWZ02040060",1652,6291,4639
"16381","ENSACAG00000024659","GL343654.1",142051,142280,229
"16382","ENSACAG00000024664","2",147333628,147343185,9557
"16383","ENSACAG00000024665","1",193607259,193610479,3220
"16384","ENSACAG00000024666","GL343279.1",637229,650798,13569
"16385","ENSACAG00000024674","AAWZ02040476",3978,4652,674
"16386","ENSACAG00000024675","GL343203.1",28393,166778,138385
"16387","ENSACAG00000024680","GL344978.1",2033,11621,9588
"16388","ENSACAG00000024682","AAWZ02037969",950,9723,8773
"16389","ENSACAG00000024683","2",196595461,196596606,1145
"16390","ENSACAG00000024685","2",91421285,91437082,15797
"16391","ENSACAG00000024691","GL344376.1",9736,13389,3653
"16392","ENSACAG00000024693","GL343934.1",100369,119417,19048
"16393","ENSACAG00000024695","AAWZ02039790",3413,7801,4388
"16394","ENSACAG00000024701","GL343434.1",413877,421746,7869
"16395","ENSACAG00000024702","2",67600328,67602952,2624
"16396","ENSACAG00000024704","4",139337238,139338641,1403
"16397","ENSACAG00000024705","5",63148378,63149698,1320
"16398","ENSACAG00000024706","GL343999.1",77085,82682,5597
"16399","ENSACAG00000024709","6",29803195,29885583,82388
"16400","ENSACAG00000024717","GL343908.1",4842,19071,14229
"16401","ENSACAG00000024718","AAWZ02036255",2048,16669,14621
"16402","ENSACAG00000024719","2",144210212,144221069,10857
"16403","ENSACAG00000024720","3",171704703,171706186,1483
"16404","ENSACAG00000024721","GL343262.1",342148,346774,4626
"16405","ENSACAG00000024726","LGc",5708793,5709620,827
"16406","ENSACAG00000024727","GL343218.1",79854,88584,8730
"16407","ENSACAG00000024731","GL343224.1",2197924,2198011,87
"16408","ENSACAG00000024733","GL344425.1",2800,51828,49028
"16409","ENSACAG00000024734","GL343884.1",112712,114268,1556
"16410","ENSACAG00000024739","AAWZ02037803",3914,7445,3531
"16411","ENSACAG00000024750","GL343723.1",138196,139137,941
"16412","ENSACAG00000024754","4",124100610,124104064,3454
"16413","ENSACAG00000024761","GL343194.1",9049298,9050149,851
"16414","ENSACAG00000024762","AAWZ02040347",2529,5436,2907
"16415","ENSACAG00000024766","GL343586.1",241840,241958,118
"16416","ENSACAG00000024767","2",138680950,138682064,1114
"16417","ENSACAG00000024768","GL343346.1",903930,904592,662
"16418","ENSACAG00000024773","GL343317.1",1119578,1120345,767
"16419","ENSACAG00000024775","AAWZ02037236",9286,10821,1535
"16420","ENSACAG00000024776","AAWZ02039800",2394,7876,5482
"16421","ENSACAG00000024778","6",77298327,77330474,32147
"16422","ENSACAG00000024779","4",14208341,14211685,3344
"16423","ENSACAG00000024780","4",76754091,76756511,2420
"16424","ENSACAG00000024781","2",195453696,195457559,3863
"16425","ENSACAG00000024783","GL343561.1",71010,78202,7192
"16426","ENSACAG00000024785","AAWZ02039297",2649,7410,4761
"16427","ENSACAG00000024787","2",70336416,70351340,14924
"16428","ENSACAG00000024788","4",119518117,119525551,7434
"16429","ENSACAG00000024790","2",189226463,189251093,24630
"16430","ENSACAG00000024792","4",23132617,23154399,21782
"16431","ENSACAG00000024793","GL344158.1",63146,63451,305
"16432","ENSACAG00000024796","GL343504.1",467817,554890,87073
"16433","ENSACAG00000024798","GL343212.1",515986,557664,41678
"16434","ENSACAG00000024802","3",87412531,87495907,83376
"16435","ENSACAG00000024804","4",155804734,155807206,2472
"16436","ENSACAG00000024808","GL343434.1",394467,394832,365
"16437","ENSACAG00000024818","AAWZ02039850",2,1320,1318
"16438","ENSACAG00000024819","GL343241.1",955151,972195,17044
"16439","ENSACAG00000024821","GL343786.1",94942,97269,2327
"16440","ENSACAG00000024825","2",29855386,29856798,1412
"16441","ENSACAG00000024827","3",158083978,158085597,1619
"16442","ENSACAG00000024834","GL343495.1",451777,487926,36149
"16443","ENSACAG00000024835","GL343197.1",1883304,1884158,854
"16444","ENSACAG00000024837","GL344616.1",76,24560,24484
"16445","ENSACAG00000024839","4",154347520,154393042,45522
"16446","ENSACAG00000024844","AAWZ02037310",5482,8732,3250
"16447","ENSACAG00000024846","6",37234373,37236037,1664
"16448","ENSACAG00000024849","GL343733.1",38386,38731,345
"16449","ENSACAG00000024852","GL343224.1",2195884,2195972,88
"16450","ENSACAG00000024854","4",85592693,85593191,498
"16451","ENSACAG00000024858","1",64362486,64369254,6768
"16452","ENSACAG00000024863","AAWZ02039310",21,4989,4968
"16453","ENSACAG00000024865","GL343311.1",668439,683640,15201
"16454","ENSACAG00000024869","4",40550529,40550632,103
"16455","ENSACAG00000024870","GL345016.1",40668,42128,1460
"16456","ENSACAG00000024871","GL344277.1",21038,21155,117
"16457","ENSACAG00000024872","AAWZ02038856",5377,6753,1376
"16458","ENSACAG00000024876","GL343321.1",176818,194507,17689
"16459","ENSACAG00000024877","GL343329.1",596627,597512,885
"16460","ENSACAG00000024878","GL343733.1",146697,147482,785
"16461","ENSACAG00000024880","GL344372.1",11341,12276,935
"16462","ENSACAG00000024888","GL344661.1",3138,4439,1301
"16463","ENSACAG00000024889","1",154969001,154973007,4006
"16464","ENSACAG00000024890","4",34279826,34281328,1502
"16465","ENSACAG00000024893","2",126990291,126991639,1348
"16466","ENSACAG00000024894","GL343279.1",543895,544305,410
"16467","ENSACAG00000024895","GL344401.1",512,1206,694
"16468","ENSACAG00000024897","2",130278888,130280816,1928
"16469","ENSACAG00000024900","GL343209.1",1862358,1881662,19304
"16470","ENSACAG00000024906","2",144157595,144158745,1150
"16471","ENSACAG00000024911","AAWZ02036721",15468,16706,1238
"16472","ENSACAG00000024914","GL343208.1",3924799,3985601,60802
"16473","ENSACAG00000024915","3",98127718,98134621,6903
"16474","ENSACAG00000024920","6",26886307,26977887,91580
"16475","ENSACAG00000024923","4",66392943,66465473,72530
"16476","ENSACAG00000024924","GL345100.1",10,12571,12561
"16477","ENSACAG00000024931","GL343731.1",233,13163,12930
"16478","ENSACAG00000024933","GL343821.1",108578,110263,1685
"16479","ENSACAG00000024934","GL343253.1",1553826,1558181,4355
"16480","ENSACAG00000024935","3",105930562,105943454,12892
"16481","ENSACAG00000024944","4",76639618,76642038,2420
"16482","ENSACAG00000024947","GL344148.1",80373,89978,9605
"16483","ENSACAG00000024948","2",187318070,187318486,416
"16484","ENSACAG00000024949","4",76897250,76899667,2417
"16485","ENSACAG00000024950","AAWZ02037779",631,1197,566
"16486","ENSACAG00000024956","GL343907.1",52128,71304,19176
"16487","ENSACAG00000024957","AAWZ02036887",17450,20480,3030
"16488","ENSACAG00000024960","4",76842659,76845073,2414
"16489","ENSACAG00000024961","GL343524.1",354059,410994,56935
"16490","ENSACAG00000024964","4",81483288,81484671,1383
"16491","ENSACAG00000024968","4",76856421,76858829,2408
"16492","ENSACAG00000024969","GL343707.1",196334,196443,109
"16493","ENSACAG00000024971","GL343312.1",8265,9200,935
"16494","ENSACAG00000024973","AAWZ02038350",7481,9862,2381
"16495","ENSACAG00000024977","3",30316007,30318471,2464
"16496","ENSACAG00000024978","GL343608.1",35060,40679,5619
"16497","ENSACAG00000024980","1",38780799,38781584,785
"16498","ENSACAG00000024981","GL343324.1",659604,659693,89
"16499","ENSACAG00000024982","3",35476449,35476634,185
"16500","ENSACAG00000024984","AAWZ02037057",2728,3246,518
"16501","ENSACAG00000024988","AAWZ02038813",6,5003,4997
"16502","ENSACAG00000024991","2",197260840,197262114,1274
"16503","ENSACAG00000024994","5",108485662,108495806,10144
"16504","ENSACAG00000024995","GL344353.1",20652,21385,733
"16505","ENSACAG00000025000","GL343417.1",114303,116663,2360
"16506","ENSACAG00000025002","GL343867.1",19453,19556,103
"16507","ENSACAG00000025004","1",107175732,107176499,767
"16508","ENSACAG00000025006","GL343393.1",678516,773514,94998
"16509","ENSACAG00000025007","AAWZ02037142",13614,16058,2444
"16510","ENSACAG00000025013","GL344903.1",2918,10175,7257
"16511","ENSACAG00000025016","GL343330.1",975390,995142,19752
"16512","ENSACAG00000025024","2",91261693,91262512,819
"16513","ENSACAG00000025026","AAWZ02039048",2558,2761,203
"16514","ENSACAG00000025027","AAWZ02035066",15638,21247,5609
"16515","ENSACAG00000025030","5",980783,992491,11708
"16516","ENSACAG00000025032","2",42934087,42939594,5507
"16517","ENSACAG00000025038","GL344777.1",2417,20887,18470
"16518","ENSACAG00000025042","GL343805.1",150575,151233,658
"16519","ENSACAG00000025046","4",76721498,76723912,2414
"16520","ENSACAG00000025047","AAWZ02041946",11,4637,4626
"16521","ENSACAG00000025054","GL343279.1",588938,610595,21657
"16522","ENSACAG00000025055","GL343235.1",230193,241360,11167
"16523","ENSACAG00000025058","1",168607969,168613556,5587
"16524","ENSACAG00000025060","GL343766.1",142286,145705,3419
"16525","ENSACAG00000025064","GL344183.1",37242,37855,613
"16526","ENSACAG00000025066","GL343675.1",166582,172851,6269
"16527","ENSACAG00000025068","GL343685.1",255796,256597,801
"16528","ENSACAG00000025074","5",19406515,19412506,5991
"16529","ENSACAG00000025078","1",152001391,152108196,106805
"16530","ENSACAG00000025080","GL344518.1",9617,11010,1393
"16531","ENSACAG00000025085","AAWZ02041384",4272,5687,1415
"16532","ENSACAG00000025087","GL343721.1",141257,142918,1661
"16533","ENSACAG00000025090","GL343518.1",400963,419098,18135
"16534","ENSACAG00000025099","4",16559596,16561330,1734
"16535","ENSACAG00000025103","1",94136602,94136685,83
"16536","ENSACAG00000025104","GL343543.1",541332,542589,1257
"16537","ENSACAG00000025106","AAWZ02036537",19219,20373,1154
"16538","ENSACAG00000025109","GL343809.1",122587,164140,41553
"16539","ENSACAG00000025111","2",188794430,188807675,13245
"16540","ENSACAG00000025114","2",196171437,196176917,5480
"16541","ENSACAG00000025115","1",110086059,110087336,1277
"16542","ENSACAG00000025118","GL343423.1",665191,665979,788
"16543","ENSACAG00000025131","LGf",2172574,2203549,30975
"16544","ENSACAG00000025134","3",111942995,111952457,9462
"16545","ENSACAG00000025135","GL343609.1",236123,236751,628
"16546","ENSACAG00000025137","GL343463.1",618142,618927,785
"16547","ENSACAG00000025141","GL343361.1",376991,377425,434
"16548","ENSACAG00000025145","GL344743.1",1320,21663,20343
"16549","ENSACAG00000025152","5",24660050,24699201,39151
"16550","ENSACAG00000025158","AAWZ02035619",31956,33647,1691
"16551","ENSACAG00000025160","4",77301761,77304211,2450
"16552","ENSACAG00000025167","AAWZ02037079",3748,5058,1310
"16553","ENSACAG00000025180","GL343895.1",140147,145911,5764
"16554","ENSACAG00000025182","GL343310.1",747138,815609,68471
"16555","ENSACAG00000025187","2",80899636,80903539,3903
"16556","ENSACAG00000025191","GL343442.1",169995,170910,915
"16557","ENSACAG00000025194","2",69290713,69293930,3217
"16558","ENSACAG00000025195","1",212404537,212418601,14064
"16559","ENSACAG00000025202","2",137800269,137843183,42914
"16560","ENSACAG00000025205","GL343674.1",98583,98645,62
"16561","ENSACAG00000025207","2",180696148,180698287,2139
"16562","ENSACAG00000025209","GL344221.1",33416,57625,24209
"16563","ENSACAG00000025210","GL344518.1",19007,20131,1124
"16564","ENSACAG00000025211","GL344602.1",287,5070,4783
"16565","ENSACAG00000025213","GL343560.1",108890,109184,294
"16566","ENSACAG00000025214","GL343285.1",1168448,1169135,687
"16567","ENSACAG00000025215","LGf",449914,450844,930
"16568","ENSACAG00000025217","GL343571.1",250709,251863,1154
"16569","ENSACAG00000025220","2",109106778,109107958,1180
"16570","ENSACAG00000025221","AAWZ02039762",310,455,145
"16571","ENSACAG00000025222","AAWZ02038493",263,2031,1768
"16572","ENSACAG00000025228","GL344017.1",26188,27540,1352
"16573","ENSACAG00000025231","4",109852230,109853394,1164
"16574","ENSACAG00000025232","GL345028.1",1224,2046,822
"16575","ENSACAG00000025242","6",44643908,44711031,67123
"16576","ENSACAG00000025244","2",95805788,95817465,11677
"16577","ENSACAG00000025245","GL343816.1",166777,173207,6430
"16578","ENSACAG00000025246","AAWZ02036887",7393,11805,4412
"16579","ENSACAG00000025247","AAWZ02040350",6007,6726,719
"16580","ENSACAG00000025250","GL345037.1",12375,14667,2292
"16581","ENSACAG00000025252","3",90727612,90731059,3447
"16582","ENSACAG00000025259","AAWZ02040353",1203,6866,5663
"16583","ENSACAG00000025260","4",22643876,22644352,476
"16584","ENSACAG00000025264","AAWZ02041616",2206,3208,1002
"16585","ENSACAG00000025266","3",172932617,172933883,1266
"16586","ENSACAG00000025269","1",210836252,210837565,1313
"16587","ENSACAG00000025271","3",130218500,130218956,456
"16588","ENSACAG00000025273","AAWZ02038391",4080,4532,452
"16589","ENSACAG00000025274","GL343434.1",336333,343771,7438
"16590","ENSACAG00000025275","GL344697.1",887,26133,25246
"16591","ENSACAG00000025279","1",91499660,91500773,1113
"16592","ENSACAG00000025283","AAWZ02041204",2890,4640,1750
"16593","ENSACAG00000025287","GL344482.1",1082,6020,4938
"16594","ENSACAG00000025288","3",162409944,162436467,26523
"16595","ENSACAG00000025291","GL343434.1",171702,186699,14997
"16596","ENSACAG00000025292","AAWZ02039190",1737,3349,1612
"16597","ENSACAG00000025298","6",60655137,60662151,7014
"16598","ENSACAG00000025299","3",124298513,124477865,179352
"16599","ENSACAG00000025300","1",156232389,156246418,14029
"16600","ENSACAG00000025301","GL343312.1",667795,672275,4480
"16601","ENSACAG00000025303","2",127902870,127973293,70423
"16602","ENSACAG00000025305","4",48070235,48074499,4264
"16603","ENSACAG00000025306","GL344943.1",8760,11096,2336
"16604","ENSACAG00000025308","AAWZ02040379",2755,4101,1346
"16605","ENSACAG00000025309","AAWZ02035903",21305,27910,6605
"16606","ENSACAG00000025310","GL343631.1",28373,28690,317
"16607","ENSACAG00000025315","3",37932189,37942698,10509
"16608","ENSACAG00000025321","2",189172451,189175111,2660
"16609","ENSACAG00000025322","5",28730079,28730864,785
"16610","ENSACAG00000025324","LGb",1336411,1336527,116
"16611","ENSACAG00000025328","AAWZ02037172",10297,10614,317
"16612","ENSACAG00000025337","GL343944.1",72047,90252,18205
"16613","ENSACAG00000025338","GL343571.1",133114,150326,17212
"16614","ENSACAG00000025341","GL343470.1",472422,472746,324
"16615","ENSACAG00000025342","GL344414.1",9908,11320,1412
"16616","ENSACAG00000025343","GL343224.1",2186677,2186764,87
"16617","ENSACAG00000025348","4",77393489,77395927,2438
"16618","ENSACAG00000025357","AAWZ02037326",8317,8432,115
"16619","ENSACAG00000025358","GL343207.1",3658777,3689090,30313
"16620","ENSACAG00000025359","GL344048.1",72332,81314,8982
"16621","ENSACAG00000025361","AAWZ02035693",7626,18062,10436
"16622","ENSACAG00000025364","GL343334.1",1263143,1264365,1222
"16623","ENSACAG00000025369","GL343667.1",89504,111625,22121
"16624","ENSACAG00000025371","GL343571.1",186223,187311,1088
"16625","ENSACAG00000025380","GL343715.1",170303,175007,4704
"16626","ENSACAG00000025381","3",76651828,76652595,767
"16627","ENSACAG00000025384","2",195685950,195692186,6236
"16628","ENSACAG00000025387","4",104327481,104334823,7342
"16629","ENSACAG00000025390","GL345024.1",47,982,935
"16630","ENSACAG00000025394","GL344002.1",16313,25652,9339
"16631","ENSACAG00000025402","GL343287.1",1454751,1470659,15908
"16632","ENSACAG00000025406","GL343394.1",470547,470664,117
"16633","ENSACAG00000025407","GL344183.1",30931,31338,407
"16634","ENSACAG00000025411","GL343777.1",211161,211254,93
"16635","ENSACAG00000025418","GL343547.1",170739,253588,82849
"16636","ENSACAG00000025421","GL344162.1",31544,63561,32017
"16637","ENSACAG00000025425","GL343535.1",416799,417575,776
"16638","ENSACAG00000025426","GL343499.1",416526,417637,1111
"16639","ENSACAG00000025429","GL343434.1",754031,756576,2545
"16640","ENSACAG00000025430","AAWZ02040758",2238,6516,4278
"16641","ENSACAG00000025431","GL343481.1",89207,89770,563
"16642","ENSACAG00000025433","GL343251.1",261048,264025,2977
"16643","ENSACAG00000025437","2",151819153,151820283,1130
"16644","ENSACAG00000025439","GL343322.1",80478,80666,188
"16645","ENSACAG00000025440","AAWZ02038288",324,2531,2207
"16646","ENSACAG00000025443","GL343231.1",230314,230869,555
"16647","ENSACAG00000025446","AAWZ02038994",3932,9795,5863
"16648","ENSACAG00000025449","2",121714796,121715213,417
"16649","ENSACAG00000025450","2",98495352,98495771,419
"16650","ENSACAG00000025451","GL344372.1",23538,24614,1076
"16651","ENSACAG00000025457","AAWZ02039031",1286,9611,8325
"16652","ENSACAG00000025458","6",54868107,54871294,3187
"16653","ENSACAG00000025459","GL344113.1",32115,81510,49395
"16654","ENSACAG00000025461","4",76716223,76718631,2408
"16655","ENSACAG00000025462","2",45233394,45235954,2560
"16656","ENSACAG00000025464","2",53994096,53994481,385
"16657","ENSACAG00000025465","GL343279.1",765616,772024,6408
"16658","ENSACAG00000025468","4",146473007,146473098,91
"16659","ENSACAG00000025470","AAWZ02038193",7953,9445,1492
"16660","ENSACAG00000025471","1",69359852,69362431,2579
"16661","ENSACAG00000025472","GL344858.1",2782,3543,761
"16662","ENSACAG00000025475","2",196736709,196754771,18062
"16663","ENSACAG00000025478","GL343287.1",1028874,1041016,12142
"16664","ENSACAG00000025480","GL343858.1",74146,75729,1583
"16665","ENSACAG00000025482","1",90483609,90485436,1827
"16666","ENSACAG00000025484","4",110884855,110953057,68202
"16667","ENSACAG00000025485","GL343625.1",276431,290426,13995
"16668","ENSACAG00000025487","2",140391785,140392192,407
"16669","ENSACAG00000025488","GL343207.1",1948731,1948929,198
"16670","ENSACAG00000025489","3",149028239,149029111,872
"16671","ENSACAG00000025490","AAWZ02040076",468,6902,6434
"16672","ENSACAG00000025491","3",153439970,153445140,5170
"16673","ENSACAG00000025493","GL344732.1",2030,5397,3367
"16674","ENSACAG00000025499","2",194768922,194769614,692
"16675","ENSACAG00000025506","GL343499.1",502420,503182,762
"16676","ENSACAG00000025511","AAWZ02038127",1656,2901,1245
"16677","ENSACAG00000025513","6",58699547,58702760,3213
"16678","ENSACAG00000025514","GL343246.1",1840604,1841713,1109
"16679","ENSACAG00000025515","1",145630749,145631665,916
"16680","ENSACAG00000025516","2",187861404,187861498,94
"16681","ENSACAG00000025519","AAWZ02038608",2339,2660,321
"16682","ENSACAG00000025521","GL344801.1",5201,15929,10728
"16683","ENSACAG00000025523","GL343263.1",1105437,1136649,31212
"16684","ENSACAG00000025525","4",77371248,77373689,2441
"16685","ENSACAG00000025527","GL343833.1",157318,161421,4103
"16686","ENSACAG00000025532","4",77029669,77032092,2423
"16687","ENSACAG00000025533","1",198107947,198108111,164
"16688","ENSACAG00000025536","GL343534.1",1593,21378,19785
"16689","ENSACAG00000025537","GL344162.1",16866,19029,2163
"16690","ENSACAG00000025539","GL344035.1",52225,52899,674
"16691","ENSACAG00000025540","1",130385587,130464666,79079
"16692","ENSACAG00000025550","GL343286.1",841247,856529,15282
"16693","ENSACAG00000025553","AAWZ02037297",3559,12909,9350
"16694","ENSACAG00000025556","GL343463.1",406332,407078,746
"16695","ENSACAG00000025558","GL343625.1",126782,127648,866
"16696","ENSACAG00000025561","GL343489.1",373106,387283,14177
"16697","ENSACAG00000025564","GL343730.1",246662,248526,1864
"16698","ENSACAG00000025567","2",65528978,65530834,1856
"16699","ENSACAG00000025568","GL343540.1",276359,279076,2717
"16700","ENSACAG00000025569","AAWZ02039759",2062,6629,4567
"16701","ENSACAG00000025572","GL343885.1",41820,44193,2373
"16702","ENSACAG00000025573","GL343667.1",56074,58020,1946
"16703","ENSACAG00000025574","GL343312.1",60609,89985,29376
"16704","ENSACAG00000025579","2",68242354,68257534,15180
"16705","ENSACAG00000025582","AAWZ02040307",248,4555,4307
"16706","ENSACAG00000025585","AAWZ02036089",12403,16258,3855
"16707","ENSACAG00000025586","GL343585.1",442453,445917,3464
"16708","ENSACAG00000025588","AAWZ02038724",4957,10619,5662
"16709","ENSACAG00000025589","2",94306767,94327160,20393
"16710","ENSACAG00000025590","5",11741978,11777904,35926
"16711","ENSACAG00000025595","GL343819.1",99048,121685,22637
"16712","ENSACAG00000025597","GL344142.1",3920,6555,2635
"16713","ENSACAG00000025600","GL343315.1",851389,855930,4541
"16714","ENSACAG00000025602","1",186884952,186885767,815
"16715","ENSACAG00000025605","GL343196.1",2602943,2611936,8993
"16716","ENSACAG00000025606","AAWZ02039005",4432,5013,581
"16717","ENSACAG00000025608","3",18612251,18612368,117
"16718","ENSACAG00000025610","4",120510085,120511671,1586
"16719","ENSACAG00000025611","2",197661483,197686571,25088
"16720","ENSACAG00000025612","4",152137996,152285374,147378
"16721","ENSACAG00000025615","AAWZ02036585",13330,23375,10045
"16722","ENSACAG00000025616","AAWZ02041321",795,2339,1544
"16723","ENSACAG00000025622","GL343287.1",857204,862788,5584
"16724","ENSACAG00000025624","GL343673.1",159753,173456,13703
"16725","ENSACAG00000025627","GL344145.1",10908,12053,1145
"16726","ENSACAG00000025630","AAWZ02037623",734,6263,5529
"16727","ENSACAG00000025634","5",28470946,28486533,15587
"16728","ENSACAG00000025636","GL343330.1",1019174,1036137,16963
"16729","ENSACAG00000025637","GL344197.1",1659,3380,1721
"16730","ENSACAG00000025639","GL343287.1",813742,831410,17668
"16731","ENSACAG00000025642","GL343282.1",587154,587477,323
"16732","ENSACAG00000025643","GL343325.1",818446,818592,146
"16733","ENSACAG00000025644","3",171192416,171192730,314
"16734","ENSACAG00000025645","GL343228.1",2338906,2339022,116
"16735","ENSACAG00000025647","1",3618459,3641945,23486
"16736","ENSACAG00000025649","3",164472379,164606391,134012
"16737","ENSACAG00000025651","GL343507.1",460723,461604,881
"16738","ENSACAG00000025654","AAWZ02038245",5337,11051,5714
"16739","ENSACAG00000025655","1",182814136,182814612,476
"16740","ENSACAG00000025656","1",6509470,6516562,7092
"16741","ENSACAG00000025658","GL344906.1",9732,12666,2934
"16742","ENSACAG00000025660","GL343617.1",346722,360808,14086
"16743","ENSACAG00000025662","GL344038.1",98410,102567,4157
"16744","ENSACAG00000025663","2",135102496,135107396,4900
"16745","ENSACAG00000025667","AAWZ02041107",2339,3090,751
"16746","ENSACAG00000025668","GL344510.1",17867,21772,3905
"16747","ENSACAG00000025671","GL343312.1",831766,839269,7503
"16748","ENSACAG00000025672","1",69037790,69040025,2235
"16749","ENSACAG00000025674","GL343889.1",630,809,179
"16750","ENSACAG00000025675","AAWZ02041057",21,5409,5388
"16751","ENSACAG00000025676","GL343281.1",434782,436670,1888
"16752","ENSACAG00000025678","4",123452497,123453375,878
"16753","ENSACAG00000025679","GL343225.1",1400819,1424122,23303
"16754","ENSACAG00000025680","4",138976329,138978557,2228
"16755","ENSACAG00000025684","GL344418.1",19462,20448,986
"16756","ENSACAG00000025686","4",155996679,156001423,4744
"16757","ENSACAG00000025687","1",77109117,77117483,8366
"16758","ENSACAG00000025688","3",201688036,201688134,98
"16759","ENSACAG00000025699","5",119930219,119930336,117
"16760","ENSACAG00000025702","GL343956.1",4989,5249,260
"16761","ENSACAG00000025703","GL343340.1",329862,330814,952
"16762","ENSACAG00000025704","AAWZ02039533",63,7286,7223
"16763","ENSACAG00000025707","GL343809.1",88732,107923,19191
"16764","ENSACAG00000025709","AAWZ02037334",220,15822,15602
"16765","ENSACAG00000025710","GL343896.1",52041,54413,2372
"16766","ENSACAG00000025712","1",165413138,165414199,1061
"16767","ENSACAG00000025714","4",16400991,16404908,3917
"16768","ENSACAG00000025717","AAWZ02038576",7249,9298,2049
"16769","ENSACAG00000025720","3",32943347,32944594,1247
"16770","ENSACAG00000025725","1",90351267,90351419,152
"16771","ENSACAG00000025729","2",32476831,32477577,746
"16772","ENSACAG00000025730","GL343915.1",39061,53530,14469
"16773","ENSACAG00000025732","1",263058040,263059335,1295
"16774","ENSACAG00000025734","GL343297.1",823290,827564,4274
"16775","ENSACAG00000025737","GL343491.1",38006,38582,576
"16776","ENSACAG00000025738","AAWZ02037225",8666,15188,6522
"16777","ENSACAG00000025741","GL343672.1",155234,156904,1670
"16778","ENSACAG00000025742","2",144964006,144964384,378
"16779","ENSACAG00000025743","GL343252.1",1823565,1823975,410
"16780","ENSACAG00000025744","1",175025620,175065935,40315
"16781","ENSACAG00000025748","4",97332961,97369109,36148
"16782","ENSACAG00000025749","GL344237.1",39845,53936,14091
"16783","ENSACAG00000025751","3",193280222,193280989,767
"16784","ENSACAG00000025755","6",18373627,18434462,60835
"16785","ENSACAG00000025758","2",196162553,196163309,756
"16786","ENSACAG00000025761","3",200531046,200531136,90
"16787","ENSACAG00000025764","5",54223743,54589361,365618
"16788","ENSACAG00000025765","2",195864875,195864994,119
"16789","ENSACAG00000025768","GL343301.1",1554839,1555804,965
"16790","ENSACAG00000025771","3",13108390,13109291,901
"16791","ENSACAG00000025773","GL344082.1",12905,13778,873
"16792","ENSACAG00000025774","4",76961240,76963660,2420
"16793","ENSACAG00000025777","AAWZ02036658",13482,21753,8271
"16794","ENSACAG00000025778","AAWZ02036797",1,20143,20142
"16795","ENSACAG00000025780","AAWZ02041313",4468,5304,836
"16796","ENSACAG00000025781","GL343312.1",704501,722916,18415
"16797","ENSACAG00000025786","5",115210033,115211852,1819
"16798","ENSACAG00000025789","4",69028825,69029502,677
"16799","ENSACAG00000025793","1",30243785,30245238,1453
"16800","ENSACAG00000025794","GL343491.1",253209,257324,4115
"16801","ENSACAG00000025799","2",10038327,10055774,17447
"16802","ENSACAG00000025801","GL344546.1",3245,29436,26191
"16803","ENSACAG00000025804","3",17916897,17917028,131
"16804","ENSACAG00000025806","1",93242474,93242862,388
"16805","ENSACAG00000025807","GL344117.1",5137,5280,143
"16806","ENSACAG00000025808","GL343382.1",745638,745781,143
"16807","ENSACAG00000025809","1",201905701,201907834,2133
"16808","ENSACAG00000025813","GL343417.1",160609,164138,3529
"16809","ENSACAG00000025814","6",28506278,28571558,65280
"16810","ENSACAG00000025815","GL343338.1",399770,400800,1030
"16811","ENSACAG00000025816","GL344219.1",13530,58778,45248
"16812","ENSACAG00000025817","GL343822.1",130621,133369,2748
"16813","ENSACAG00000025821","GL343834.1",106909,108511,1602
"16814","ENSACAG00000025824","GL343484.1",510126,528446,18320
"16815","ENSACAG00000025832","GL343450.1",18699,125581,106882
"16816","ENSACAG00000025835","GL344120.1",34113,39028,4915
"16817","ENSACAG00000025845","GL343332.1",1009461,1011648,2187
"16818","ENSACAG00000025849","4",76871006,76873432,2426
"16819","ENSACAG00000025857","AAWZ02038015",7329,9161,1832
"16820","ENSACAG00000025859","GL343268.1",435519,441030,5511
"16821","ENSACAG00000025861","4",50256592,50261390,4798
"16822","ENSACAG00000025862","GL344516.1",3581,57538,53957
"16823","ENSACAG00000025864","1",115366428,115539415,172987
"16824","ENSACAG00000025865","GL345113.1",7133,9159,2026
"16825","ENSACAG00000025867","GL343514.1",213917,214285,368
"16826","ENSACAG00000025870","LGb",485310,522604,37294
"16827","ENSACAG00000025872","1",165177167,165178379,1212
"16828","ENSACAG00000025875","3",148311029,148311635,606
"16829","ENSACAG00000025879","1",225102853,225104052,1199
"16830","ENSACAG00000025881","3",181840400,182046029,205629
"16831","ENSACAG00000025882","GL343282.1",534811,535116,305
"16832","ENSACAG00000025883","5",140170739,140171036,297
"16833","ENSACAG00000025889","GL343820.1",79242,79857,615
"16834","ENSACAG00000025892","GL343228.1",2025172,2025315,143
"16835","ENSACAG00000025893","AAWZ02037227",7465,15846,8381
"16836","ENSACAG00000025896","AAWZ02038328",49,9933,9884
"16837","ENSACAG00000025900","GL343721.1",262913,264040,1127
"16838","ENSACAG00000025908","4",148100053,148109780,9727
"16839","ENSACAG00000025910","GL343775.1",71418,73904,2486
"16840","ENSACAG00000025912","5",125032189,125034651,2462
"16841","ENSACAG00000025913","GL344076.1",49533,68790,19257
"16842","ENSACAG00000025926","2",190137217,190149568,12351
"16843","ENSACAG00000025930","GL344031.1",38645,40436,1791
"16844","ENSACAG00000025932","2",115359538,115359655,117
"16845","ENSACAG00000025936","3",184688653,184690311,1658
"16846","ENSACAG00000025937","4",147633496,147637769,4273
"16847","ENSACAG00000025943","GL343860.1",139474,149279,9805
"16848","ENSACAG00000025945","GL344010.1",91397,129425,38028
"16849","ENSACAG00000025946","GL343253.1",1523640,1530810,7170
"16850","ENSACAG00000025947","AAWZ02040156",3915,5955,2040
"16851","ENSACAG00000025948","GL343202.1",3810160,3811359,1199
"16852","ENSACAG00000025958","3",179814711,179815847,1136
"16853","ENSACAG00000025960","GL344316.1",2505,11083,8578
"16854","ENSACAG00000025962","GL343220.1",631554,645384,13830
"16855","ENSACAG00000025965","1",244286702,244288825,2123
"16856","ENSACAG00000025967","GL343237.1",1559840,1562721,2881
"16857","ENSACAG00000025977","2",197614140,197623388,9248
"16858","ENSACAG00000025978","GL343451.1",384098,388497,4399
"16859","ENSACAG00000025979","GL343724.1",139928,148758,8830
"16860","ENSACAG00000025980","GL343976.1",110183,122916,12733
"16861","ENSACAG00000025982","GL343874.1",201182,201322,140
"16862","ENSACAG00000025984","5",56967635,56970264,2629
"16863","ENSACAG00000025985","GL343438.1",568113,608771,40658
"16864","ENSACAG00000025986","4",147990126,148029472,39346
"16865","ENSACAG00000025987","AAWZ02036718",14889,21479,6590
"16866","ENSACAG00000025988","3",192164557,192179606,15049
"16867","ENSACAG00000025992","GL343285.1",393293,395721,2428
"16868","ENSACAG00000025994","5",150166555,150270371,103816
"16869","ENSACAG00000025997","AAWZ02040830",5789,5902,113
"16870","ENSACAG00000025998","AAWZ02038609",5238,8892,3654
"16871","ENSACAG00000026001","GL343483.1",236337,237652,1315
"16872","ENSACAG00000026003","GL344449.1",36442,50509,14067
"16873","ENSACAG00000026004","GL343320.1",998850,999002,152
"16874","ENSACAG00000026008","1",194407804,194408134,330
"16875","ENSACAG00000026010","1",117379088,117391203,12115
"16876","ENSACAG00000026012","AAWZ02039590",3786,8203,4417
"16877","ENSACAG00000026013","GL343735.1",219441,220529,1088
"16878","ENSACAG00000026015","AAWZ02037391",6046,7460,1414
"16879","ENSACAG00000026026","3",86712468,86713442,974
"16880","ENSACAG00000026027","GL344831.1",14549,16510,1961
"16881","ENSACAG00000026028","GL343202.1",2086373,2088440,2067
"16882","ENSACAG00000026031","GL343820.1",61370,65319,3949
"16883","ENSACAG00000026034","1",3610480,3611334,854
"16884","ENSACAG00000026035","GL343667.1",176729,193915,17186
"16885","ENSACAG00000026036","GL343282.1",569146,570830,1684
"16886","ENSACAG00000026037","GL344186.1",11355,11702,347
"16887","ENSACAG00000026038","GL343312.1",480621,488610,7989
"16888","ENSACAG00000026043","GL343279.1",1116031,1133119,17088
"16889","ENSACAG00000026047","2",59647393,59647850,457
"16890","ENSACAG00000026049","AAWZ02041410",2647,4265,1618
"16891","ENSACAG00000026054","GL343755.1",562,11209,10647
"16892","ENSACAG00000026057","GL343207.1",3612620,3614313,1693
"16893","ENSACAG00000026060","GL344015.1",7293,29550,22257
"16894","ENSACAG00000026062","1",253365545,253367242,1697
"16895","ENSACAG00000026065","AAWZ02038448",7803,10385,2582
"16896","ENSACAG00000026066","GL343282.1",560879,561187,308
"16897","ENSACAG00000026075","3",88515424,88516463,1039
"16898","ENSACAG00000026078","4",102868638,102869958,1320
"16899","ENSACAG00000026081","AAWZ02041952",1977,3125,1148
"16900","ENSACAG00000026082","GL343826.1",93338,94620,1282
"16901","ENSACAG00000026083","6",71758266,71779970,21704
"16902","ENSACAG00000026084","AAWZ02036645",894,20095,19201
"16903","ENSACAG00000026085","GL343830.1",152731,155973,3242
"16904","ENSACAG00000026087","1",169725157,169726255,1098
"16905","ENSACAG00000026088","GL343248.1",783751,785839,2088
"16906","ENSACAG00000026090","2",111665236,111669244,4008
"16907","ENSACAG00000026091","3",193398047,193398814,767
"16908","ENSACAG00000026095","4",123028225,123040052,11827
"16909","ENSACAG00000026096","GL343465.1",471595,473706,2111
"16910","ENSACAG00000026101","3",155748796,155750458,1662
"16911","ENSACAG00000026102","GL344750.1",20549,20665,116
"16912","ENSACAG00000026105","GL343672.1",271909,279192,7283
"16913","ENSACAG00000026108","GL343935.1",22548,104429,81881
"16914","ENSACAG00000026110","GL343201.1",587913,588698,785
"16915","ENSACAG00000026111","AAWZ02040868",3643,5069,1426
"16916","ENSACAG00000026118","GL343216.1",451753,464786,13033
"16917","ENSACAG00000026123","GL343196.1",2210480,2212013,1533
"16918","ENSACAG00000026127","2",153005204,153005321,117
"16919","ENSACAG00000026128","6",48235250,48478489,243239
"16920","ENSACAG00000026129","1",80183914,80184031,117
"16921","ENSACAG00000026130","2",86461477,86471621,10144
"16922","ENSACAG00000026134","AAWZ02037784",8629,10677,2048
"16923","ENSACAG00000026136","4",103003304,103004098,794
"16924","ENSACAG00000026138","GL344750.1",1949,9871,7922
"16925","ENSACAG00000026140","2",138883449,138928021,44572
"16926","ENSACAG00000026142","GL344519.1",622,19284,18662
"16927","ENSACAG00000026143","1",164858942,164862552,3610
"16928","ENSACAG00000026147","1",4086640,4087815,1175
"16929","ENSACAG00000026154","GL344771.1",788,4623,3835
"16930","ENSACAG00000026155","GL343300.1",1381150,1388978,7828
"16931","ENSACAG00000026157","AAWZ02037079",15388,16683,1295
"16932","ENSACAG00000026158","LGc",1196945,1197491,546
"16933","ENSACAG00000026164","2",190806760,190889946,83186
"16934","ENSACAG00000026165","1",158718628,158722050,3422
"16935","ENSACAG00000026166","GL343508.1",325351,325532,181
"16936","ENSACAG00000026167","2",119670195,119688933,18738
"16937","ENSACAG00000026168","1",247593317,247594278,961
"16938","ENSACAG00000026170","AAWZ02036268",3248,20559,17311
"16939","ENSACAG00000026171","2",197255080,197259199,4119
"16940","ENSACAG00000026177","GL343562.1",220906,237791,16885
"16941","ENSACAG00000026180","6",17965812,18008887,43075
"16942","ENSACAG00000026181","GL344605.1",13555,26621,13066
"16943","ENSACAG00000026182","GL343878.1",127963,145644,17681
"16944","ENSACAG00000026185","GL343554.1",399238,399611,373
"16945","ENSACAG00000026189","GL343264.1",1509416,1510615,1199
"16946","ENSACAG00000026194","AAWZ02040297",722,7119,6397
"16947","ENSACAG00000026195","AAWZ02035788",5904,7459,1555
"16948","ENSACAG00000026198","GL343432.1",1543,71625,70082
"16949","ENSACAG00000026199","GL343611.1",126057,132079,6022
"16950","ENSACAG00000026203","3",176255308,176256064,756
"16951","ENSACAG00000026209","4",73758517,73764472,5955
"16952","ENSACAG00000026212","4",76972372,76974795,2423
"16953","ENSACAG00000026224","1",251560463,251571616,11153
"16954","ENSACAG00000026225","AAWZ02038596",2229,3995,1766
"16955","ENSACAG00000026226","GL343520.1",210942,215114,4172
"16956","ENSACAG00000026228","GL343390.1",4571,5735,1164
"16957","ENSACAG00000026229","1",109544132,109547542,3410
"16958","ENSACAG00000026230","LGf",3366486,3368559,2073
"16959","ENSACAG00000026231","2",7655561,7692547,36986
"16960","ENSACAG00000026233","GL343250.1",1337091,1337154,63
"16961","ENSACAG00000026234","GL343253.1",1378943,1385279,6336
"16962","ENSACAG00000026237","2",104475197,104495089,19892
"16963","ENSACAG00000026238","5",23435343,23437876,2533
"16964","ENSACAG00000026240","AAWZ02040749",1027,5685,4658
"16965","ENSACAG00000026241","GL343438.1",739091,739158,67
"16966","ENSACAG00000026242","GL343228.1",1178368,1180427,2059
"16967","ENSACAG00000026245","5",38803505,38815575,12070
"16968","ENSACAG00000026246","GL343930.1",34104,87478,53374
"16969","ENSACAG00000026249","AAWZ02039099",219,4279,4060
"16970","ENSACAG00000026252","GL344122.1",47781,59159,11378
"16971","ENSACAG00000026254","AAWZ02036376",41,19768,19727
"16972","ENSACAG00000026260","GL344708.1",10230,23607,13377
"16973","ENSACAG00000026262","AAWZ02037244",5258,13331,8073
"16974","ENSACAG00000026264","GL344701.1",2599,5046,2447
"16975","ENSACAG00000026265","GL343430.1",618670,624542,5872
"16976","ENSACAG00000026272","GL343528.1",421305,421616,311
"16977","ENSACAG00000026276","4",144540986,144541540,554
"16978","ENSACAG00000026279","GL343200.1",1139022,1139139,117
"16979","ENSACAG00000026280","GL343660.1",198450,202067,3617
"16980","ENSACAG00000026283","AAWZ02037255",5804,7465,1661
"16981","ENSACAG00000026288","2",81945627,81947502,1875
"16982","ENSACAG00000026290","1",177316291,177317390,1099
"16983","ENSACAG00000026291","GL343206.1",98139,99662,1523
"16984","ENSACAG00000026304","GL343351.1",1124768,1127166,2398
"16985","ENSACAG00000026309","GL343299.1",525129,526090,961
"16986","ENSACAG00000026311","1",129248563,129250292,1729
"16987","ENSACAG00000026313","GL344068.1",52533,54230,1697
"16988","ENSACAG00000026315","2",196241328,196253229,11901
"16989","ENSACAG00000026322","GL343216.1",337830,364241,26411
"16990","ENSACAG00000026324","GL343329.1",604631,605137,506
"16991","ENSACAG00000026326","2",188884015,188898756,14741
"16992","ENSACAG00000026327","GL343252.1",78072,83161,5089
"16993","ENSACAG00000026328","GL343249.1",1998735,2033839,35104
"16994","ENSACAG00000026330","GL343811.1",61103,61975,872
"16995","ENSACAG00000026332","GL344035.1",34859,36307,1448
"16996","ENSACAG00000026340","4",76659821,76662238,2417
"16997","ENSACAG00000026341","4",137538220,137539138,918
"16998","ENSACAG00000026349","GL343455.1",646734,665193,18459
"16999","ENSACAG00000026350","4",101868239,101868718,479
"17000","ENSACAG00000026359","GL345062.1",6286,12140,5854
"17001","ENSACAG00000026366","GL343943.1",14565,14981,416
"17002","ENSACAG00000026371","6",50899205,50901271,2066
"17003","ENSACAG00000026375","AAWZ02037404",2979,12230,9251
"17004","ENSACAG00000026380","AAWZ02039863",3182,6736,3554
"17005","ENSACAG00000026387","GL343346.1",1208639,1210950,2311
"17006","ENSACAG00000026388","GL343787.1",63513,102095,38582
"17007","ENSACAG00000026389","GL343787.1",165711,194470,28759
"17008","ENSACAG00000026390","GL343282.1",552509,552814,305
"17009","ENSACAG00000026393","AAWZ02035238",15000,16366,1366
"17010","ENSACAG00000026397","4",117501705,117501823,118
"17011","ENSACAG00000026399","GL343575.1",72152,88611,16459
"17012","ENSACAG00000026400","GL343238.1",47984,54504,6520
"17013","ENSACAG00000026401","3",192236501,192241705,5204
"17014","ENSACAG00000026405","AAWZ02038773",1221,8229,7008
"17015","ENSACAG00000026415","GL343993.1",98110,113242,15132
"17016","ENSACAG00000026421","GL343281.1",1110888,1115542,4654
"17017","ENSACAG00000026423","2",95849894,95858037,8143
"17018","ENSACAG00000026424","2",120236151,120236943,792
"17019","ENSACAG00000026425","GL343400.1",426161,426382,221
"17020","ENSACAG00000026427","GL343216.1",2448606,2448975,369
"17021","ENSACAG00000026428","1",1455949,1457734,1785
"17022","ENSACAG00000026432","2",138495773,138496753,980
"17023","ENSACAG00000026434","2",94290846,94296865,6019
"17024","ENSACAG00000026438","GL343494.1",163248,164424,1176
"17025","ENSACAG00000026440","3",80849103,80852579,3476
"17026","ENSACAG00000026443","GL343413.1",406392,412166,5774
"17027","ENSACAG00000026444","4",47821620,47822297,677
"17028","ENSACAG00000026445","AAWZ02036974",321,18693,18372
"17029","ENSACAG00000026447","3",158321341,158322999,1658
"17030","ENSACAG00000026449","1",206862237,206863004,767
"17031","ENSACAG00000026452","GL344070.1",32196,44533,12337
"17032","ENSACAG00000026454","2",36919379,36919900,521
"17033","ENSACAG00000026455","AAWZ02038731",575,715,140
"17034","ENSACAG00000026456","GL343544.1",396511,398593,2082
"17035","ENSACAG00000026466","GL343787.1",4492,5484,992
"17036","ENSACAG00000026467","GL343282.1",512019,512834,815
"17037","ENSACAG00000026477","1",208645955,208646252,297
"17038","ENSACAG00000026479","GL343539.1",466885,468735,1850
"17039","ENSACAG00000026480","GL344552.1",266,9560,9294
"17040","ENSACAG00000026483","GL343822.1",138568,139906,1338
"17041","ENSACAG00000026488","GL344657.1",23728,25614,1886
"17042","ENSACAG00000026489","AAWZ02041356",2450,5594,3144
"17043","ENSACAG00000026494","5",132814469,132814913,444
"17044","ENSACAG00000026495","GL343588.1",274375,280281,5906
"17045","ENSACAG00000026502","GL343252.1",1818638,1821855,3217
"17046","ENSACAG00000026504","GL343432.1",90904,106115,15211
"17047","ENSACAG00000026507","AAWZ02040495",1046,5269,4223
"17048","ENSACAG00000026509","GL344032.1",4096,26041,21945
"17049","ENSACAG00000026515","GL343398.1",3897,64645,60748
"17050","ENSACAG00000026523","GL345045.1",8271,9165,894
"17051","ENSACAG00000026525","GL344068.1",67263,93573,26310
"17052","ENSACAG00000026529","AAWZ02036845",15431,16115,684
"17053","ENSACAG00000026531","5",112932873,112933176,303
"17054","ENSACAG00000026533","4",133917437,133918292,855
"17055","ENSACAG00000026534","1",129984565,129984682,117
"17056","ENSACAG00000026535","GL344755.1",4161,11342,7181
"17057","ENSACAG00000026540","4",107000084,107012847,12763
"17058","ENSACAG00000026541","GL343309.1",1272278,1274483,2205
"17059","ENSACAG00000026546","4",93958634,93973432,14798
"17060","ENSACAG00000026549","GL343466.1",297869,298249,380
"17061","ENSACAG00000026550","AAWZ02041114",264,354,90
"17062","ENSACAG00000026556","AAWZ02037370",35,1187,1152
"17063","ENSACAG00000026558","AAWZ02041223",1502,2575,1073
"17064","ENSACAG00000026559","AAWZ02039153",2554,9079,6525
"17065","ENSACAG00000026560","AAWZ02035620",32922,36352,3430
"17066","ENSACAG00000026562","GL344122.1",9664,16245,6581
"17067","ENSACAG00000026563","GL344489.1",6440,31089,24649
"17068","ENSACAG00000026564","4",16466473,16468643,2170
"17069","ENSACAG00000026565","AAWZ02038987",1,978,977
"17070","ENSACAG00000026568","3",157165403,157166733,1330
"17071","ENSACAG00000026569","GL343220.1",2172656,2173543,887
"17072","ENSACAG00000026570","4",33183548,33358294,174746
"17073","ENSACAG00000026575","AAWZ02039535",5533,6177,644
"17074","ENSACAG00000026577","GL343612.1",207552,210408,2856
"17075","ENSACAG00000026578","5",118327151,118327774,623
"17076","ENSACAG00000026579","GL343579.1",423622,424189,567
"17077","ENSACAG00000026580","4",142119219,142119294,75
"17078","ENSACAG00000026581","5",76375714,76376659,945
"17079","ENSACAG00000026582","GL343279.1",1222860,1223114,254
"17080","ENSACAG00000026583","GL343507.1",264039,267553,3514
"17081","ENSACAG00000026586","3",38352228,38354281,2053
"17082","ENSACAG00000026588","GL343627.1",342325,354270,11945
"17083","ENSACAG00000026591","GL343223.1",258050,258371,321
"17084","ENSACAG00000026593","2",160064796,160064913,117
"17085","ENSACAG00000026595","3",200532025,200532112,87
"17086","ENSACAG00000026596","GL344240.1",7954,23947,15993
"17087","ENSACAG00000026597","GL343775.1",85117,151378,66261
"17088","ENSACAG00000026600","GL343725.1",100002,103177,3175
"17089","ENSACAG00000026604","3",4321394,4322438,1044
"17090","ENSACAG00000026606","GL344452.1",42241,44649,2408
"17091","ENSACAG00000026607","3",69502559,69502889,330
"17092","ENSACAG00000026609","1",92523279,92885920,362641
"17093","ENSACAG00000026610","GL343203.1",2394949,2396046,1097
"17094","ENSACAG00000026611","GL343912.1",214663,235284,20621
"17095","ENSACAG00000026612","2",87708062,87711585,3523
"17096","ENSACAG00000026614","GL343540.1",490540,506217,15677
"17097","ENSACAG00000026617","1",151452846,151453646,800
"17098","ENSACAG00000026621","1",92939457,92950772,11315
"17099","ENSACAG00000026622","3",124361212,124362000,788
"17100","ENSACAG00000026625","AAWZ02037330",1036,1154,118
"17101","ENSACAG00000026629","6",53505582,53506706,1124
"17102","ENSACAG00000026630","2",70701882,70701999,117
"17103","ENSACAG00000026632","1",208458916,208460045,1129
"17104","ENSACAG00000026635","GL343297.1",501945,502537,592
"17105","ENSACAG00000026636","GL343842.1",60075,72580,12505
"17106","ENSACAG00000026637","AAWZ02041558",3671,4483,812
"17107","ENSACAG00000026638","GL343247.1",1017992,1018915,923
"17108","ENSACAG00000026642","5",105364333,105364656,323
"17109","ENSACAG00000026648","GL343204.1",2699014,2699106,92
"17110","ENSACAG00000026649","GL343786.1",128190,130139,1949
"17111","ENSACAG00000026650","2",6258337,6258510,173
"17112","ENSACAG00000026651","GL343515.1",81225,91211,9986
"17113","ENSACAG00000026653","AAWZ02040787",1940,4388,2448
"17114","ENSACAG00000026655","3",130133247,130139532,6285
"17115","ENSACAG00000026656","GL343220.1",739680,739797,117
"17116","ENSACAG00000026659","GL343934.1",73942,76160,2218
"17117","ENSACAG00000026661","1",77571109,77571876,767
"17118","ENSACAG00000026662","4",77284686,77287109,2423
"17119","ENSACAG00000026666","GL343414.1",204645,204725,80
"17120","ENSACAG00000026668","GL343435.1",55530,55978,448
"17121","ENSACAG00000026673","GL343261.1",368193,368558,365
"17122","ENSACAG00000026674","3",115652406,115653288,882
"17123","ENSACAG00000026675","1",255885922,255886032,110
"17124","ENSACAG00000026677","1",42597331,42597585,254
"17125","ENSACAG00000026681","1",39677119,39677358,239
"17126","ENSACAG00000026683","GL343754.1",164831,165016,185
"17127","ENSACAG00000026690","4",146883506,146884371,865
"17128","ENSACAG00000026691","GL343987.1",68581,71922,3341
"17129","ENSACAG00000026692","4",76907983,76910508,2525
"17130","ENSACAG00000026697","GL343921.1",27207,93585,66378
"17131","ENSACAG00000026698","GL343733.1",29820,51787,21967
"17132","ENSACAG00000026700","1",28992320,28993287,967
"17133","ENSACAG00000026702","GL344826.1",2150,10524,8374
"17134","ENSACAG00000026707","GL343308.1",26930,188801,161871
"17135","ENSACAG00000026709","AAWZ02039013",7499,7971,472
"17136","ENSACAG00000026711","GL343686.1",171744,176318,4574
"17137","ENSACAG00000026712","GL343282.1",556697,557005,308
"17138","ENSACAG00000026714","AAWZ02037365",2508,4385,1877
"17139","ENSACAG00000026715","2",173939108,173941258,2150
"17140","ENSACAG00000026720","2",144653915,144708741,54826
"17141","ENSACAG00000026721","GL344252.1",17357,19970,2613
"17142","ENSACAG00000026731","2",111652957,111654536,1579
"17143","ENSACAG00000026732","4",76743292,76745712,2420
"17144","ENSACAG00000026733","AAWZ02036459",4993,5232,239
"17145","ENSACAG00000026734","4",29214135,29214902,767
"17146","ENSACAG00000026737","4",101143619,101300573,156954
"17147","ENSACAG00000026740","2",196513650,196523545,9895
"17148","ENSACAG00000026743","5",46085380,46087662,2282
"17149","ENSACAG00000026746","GL343805.1",129660,139977,10317
"17150","ENSACAG00000026750","GL343741.1",154149,164739,10590
"17151","ENSACAG00000026755","2",199201236,199207114,5878
"17152","ENSACAG00000026763","GL343698.1",15996,16673,677
"17153","ENSACAG00000026765","GL345041.1",631,11363,10732
"17154","ENSACAG00000026768","1",212822801,212823429,628
"17155","ENSACAG00000026769","6",70865282,70875799,10517
"17156","ENSACAG00000026771","2",132576628,132577104,476
"17157","ENSACAG00000026772","5",12711270,12711833,563
"17158","ENSACAG00000026773","GL343318.1",1387820,1389757,1937
"17159","ENSACAG00000026774","GL343439.1",89404,99724,10320
"17160","ENSACAG00000026781","GL343335.1",713850,714710,860
"17161","ENSACAG00000026782","GL343531.1",915,4333,3418
"17162","ENSACAG00000026786","5",133324930,133325253,323
"17163","ENSACAG00000026791","LGf",2898626,2917434,18808
"17164","ENSACAG00000026793","GL343207.1",3573670,3576024,2354
"17165","ENSACAG00000026799","4",38735,100619,61884
"17166","ENSACAG00000026800","GL343658.1",11402,13545,2143
"17167","ENSACAG00000026804","GL344077.1",2205,2327,122
"17168","ENSACAG00000026805","6",38069793,38070685,892
"17169","ENSACAG00000026806","4",76623038,76625427,2389
"17170","ENSACAG00000026810","GL343279.1",562763,581526,18763
"17171","ENSACAG00000026813","GL343525.1",442077,453129,11052
"17172","ENSACAG00000026814","GL343557.1",173798,182122,8324
"17173","ENSACAG00000026819","GL343860.1",124898,125643,745
"17174","ENSACAG00000026820","6",68967305,68982430,15125
"17175","ENSACAG00000026822","GL344355.1",20356,33190,12834
"17176","ENSACAG00000026823","3",14096057,14110132,14075
"17177","ENSACAG00000026826","6",64617550,64618150,600
"17178","ENSACAG00000026827","GL343330.1",1177721,1202424,24703
"17179","ENSACAG00000026828","GL343318.1",1411700,1413799,2099
"17180","ENSACAG00000026829","GL343393.1",4196,5458,1262
"17181","ENSACAG00000026830","1",247216813,247266313,49500
"17182","ENSACAG00000026831","GL344946.1",10997,14306,3309
"17183","ENSACAG00000026832","2",196601389,196616457,15068
"17184","ENSACAG00000026834","GL343673.1",47505,49590,2085
"17185","ENSACAG00000026841","GL343585.1",338281,342900,4619
"17186","ENSACAG00000026845","GL343241.1",1687975,1689336,1361
"17187","ENSACAG00000026846","3",43427653,43462488,34835
"17188","ENSACAG00000026848","GL343312.1",678407,681097,2690
"17189","ENSACAG00000026849","GL343935.1",93409,95920,2511
"17190","ENSACAG00000026852","GL343620.1",158998,166098,7100
"17191","ENSACAG00000026857","GL343263.1",757476,761261,3785
"17192","ENSACAG00000026858","3",149514374,149515051,677
"17193","ENSACAG00000026860","4",153290459,153419805,129346
"17194","ENSACAG00000026861","GL343626.1",146473,165132,18659
"17195","ENSACAG00000026863","GL344281.1",21,7939,7918
"17196","ENSACAG00000026866","3",100010771,100225493,214722
"17197","ENSACAG00000026867","GL343434.1",236401,257660,21259
"17198","ENSACAG00000026868","GL343225.1",1610634,1611422,788
"17199","ENSACAG00000026869","AAWZ02040277",3416,5685,2269
"17200","ENSACAG00000026874","GL343615.1",369085,370096,1011
"17201","ENSACAG00000026878","GL344411.1",10825,11469,644
"17202","ENSACAG00000026879","GL343312.1",729476,762717,33241
"17203","ENSACAG00000026880","AAWZ02036710",5348,6736,1388
"17204","ENSACAG00000026884","AAWZ02039982",3706,5076,1370
"17205","ENSACAG00000026885","5",75720487,75720775,288
"17206","ENSACAG00000026886","AAWZ02038895",7269,7664,395
"17207","ENSACAG00000026891","4",76603973,76606393,2420
"17208","ENSACAG00000026893","GL343282.1",546703,551441,4738
"17209","ENSACAG00000026894","GL343212.1",2199874,2200463,589
"17210","ENSACAG00000026895","GL343493.1",38729,39217,488
"17211","ENSACAG00000026896","GL343361.1",22271,23084,813
"17212","ENSACAG00000026899","3",89037616,89038413,797
"17213","ENSACAG00000026900","GL343193.1",6246533,6246735,202
"17214","ENSACAG00000026901","GL343241.1",929682,951461,21779
"17215","ENSACAG00000026906","GL343238.1",343210,344564,1354
"17216","ENSACAG00000026913","AAWZ02040494",2058,2150,92
"17217","ENSACAG00000026914","1",165645172,165645918,746
"17218","ENSACAG00000026915","GL344125.1",1459,12373,10914
"17219","ENSACAG00000026916","GL343713.1",217331,227645,10314
"17220","ENSACAG00000026919","GL343392.1",596340,597287,947
"17221","ENSACAG00000026923","GL343786.1",198318,205882,7564
"17222","ENSACAG00000026924","AAWZ02041295",4049,4656,607
"17223","ENSACAG00000026925","5",85002245,85046713,44468
"17224","ENSACAG00000026926","LGb",981683,983806,2123
"17225","ENSACAG00000026928","GL343312.1",536554,537272,718
"17226","ENSACAG00000026932","GL344787.1",8826,10615,1789
"17227","ENSACAG00000026933","GL343585.1",417909,426215,8306
"17228","ENSACAG00000026938","4",156306895,156309922,3027
"17229","ENSACAG00000026939","GL343626.1",270283,271893,1610
"17230","ENSACAG00000026940","GL345053.1",785,9604,8819
"17231","ENSACAG00000026942","1",179494924,179496796,1872
"17232","ENSACAG00000026953","GL343819.1",71453,89806,18353
"17233","ENSACAG00000026956","GL343434.1",270222,273236,3014
"17234","ENSACAG00000026958","GL343329.1",451186,476759,25573
"17235","ENSACAG00000026959","GL343281.1",1589991,1604933,14942
"17236","ENSACAG00000026961","1",15554158,15555367,1209
"17237","ENSACAG00000026968","GL343479.1",566744,613866,47122
"17238","ENSACAG00000026969","GL343532.1",227929,242381,14452
"17239","ENSACAG00000026971","GL343385.1",661097,679295,18198
"17240","ENSACAG00000026973","GL343287.1",379300,390679,11379
"17241","ENSACAG00000026975","GL343395.1",503308,508899,5591
"17242","ENSACAG00000026980","3",149362596,149363654,1058
"17243","ENSACAG00000026984","2",94327247,94378104,50857
"17244","ENSACAG00000026986","5",116455869,116457513,1644
"17245","ENSACAG00000026995","GL343195.1",8028034,8030729,2695
"17246","ENSACAG00000026996","AAWZ02036460",62,21964,21902
"17247","ENSACAG00000026999","2",10987628,11001649,14021
"17248","ENSACAG00000027001","GL343855.1",70028,71790,1762
"17249","ENSACAG00000027005","GL344100.1",36229,61934,25705
"17250","ENSACAG00000027006","AAWZ02040475",224,6859,6635
"17251","ENSACAG00000027008","GL343706.1",260356,264773,4417
"17252","ENSACAG00000027009","GL343834.1",66228,69795,3567
"17253","ENSACAG00000027015","GL343894.1",17743,53762,36019
"17254","ENSACAG00000027021","2",112463496,112464983,1487
"17255","ENSACAG00000027024","GL343862.1",103045,134149,31104
"17256","ENSACAG00000027025","GL343285.1",1006963,1008299,1336
"17257","ENSACAG00000027028","GL343400.1",3561,17846,14285
"17258","ENSACAG00000027033","1",138465608,138485099,19491
"17259","ENSACAG00000027034","4",76680856,76683252,2396
"17260","ENSACAG00000027036","1",225373632,225386788,13156
"17261","ENSACAG00000027037","GL343698.1",47647,48306,659
"17262","ENSACAG00000027038","1",254990917,254991252,335
"17263","ENSACAG00000027042","2",115311901,115312902,1001
"17264","ENSACAG00000027045","AAWZ02041825",1814,5140,3326
"17265","ENSACAG00000027046","GL344075.1",19772,73864,54092
"17266","ENSACAG00000027048","GL343691.1",175981,180082,4101
"17267","ENSACAG00000027050","GL343362.1",586587,612184,25597
"17268","ENSACAG00000027051","GL343266.1",1838462,1839541,1079
"17269","ENSACAG00000027052","4",107230248,107252996,22748
"17270","ENSACAG00000027058","GL345060.1",1591,11364,9773
"17271","ENSACAG00000027060","GL343329.1",823590,844642,21052
"17272","ENSACAG00000027061","5",131080761,131081472,711
"17273","ENSACAG00000027062","GL344453.1",12297,14600,2303
"17274","ENSACAG00000027065","GL344037.1",22502,30440,7938
"17275","ENSACAG00000027068","5",100253191,100261067,7876
"17276","ENSACAG00000027079","1",69664277,69664342,65
"17277","ENSACAG00000027083","GL344787.1",19185,20042,857
"17278","ENSACAG00000027084","LGf",877477,883689,6212
"17279","ENSACAG00000027085","3",128192924,128193175,251
"17280","ENSACAG00000027087","AAWZ02038594",777,10405,9628
"17281","ENSACAG00000027089","GL344599.1",19673,21061,1388
"17282","ENSACAG00000027090","GL343434.1",478854,492060,13206
"17283","ENSACAG00000027091","AAWZ02039333",1411,8554,7143
"17284","ENSACAG00000027094","2",93293335,93297173,3838
"17285","ENSACAG00000027098","4",76710432,76712849,2417
"17286","ENSACAG00000027099","3",200659793,200660872,1079
"17287","ENSACAG00000027100","1",192906046,192906163,117
"17288","ENSACAG00000027104","AAWZ02035066",56,14080,14024
"17289","ENSACAG00000027109","2",172212782,172213549,767
"17290","ENSACAG00000027111","4",2788623,2789408,785
"17291","ENSACAG00000027118","GL343753.1",81294,83348,2054
"17292","ENSACAG00000027119","GL344324.1",568,26869,26301
"17293","ENSACAG00000027120","AAWZ02037527",5986,7686,1700
"17294","ENSACAG00000027124","2",127406156,127410645,4489
"17295","ENSACAG00000027125","2",191504911,191506785,1874
"17296","ENSACAG00000027128","1",162434472,162451019,16547
"17297","ENSACAG00000027129","GL343434.1",88139,103400,15261
"17298","ENSACAG00000027130","GL343281.1",335557,362900,27343
"17299","ENSACAG00000027131","GL343528.1",234387,240404,6017
"17300","ENSACAG00000027133","GL343434.1",503515,511662,8147
"17301","ENSACAG00000027135","3",115872280,115873938,1658
"17302","ENSACAG00000027137","GL343194.1",1609048,1611431,2383
"17303","ENSACAG00000027139","2",40415932,40415988,56
"17304","ENSACAG00000027143","AAWZ02040030",4393,5505,1112
"17305","ENSACAG00000027144","3",176484636,176487457,2821
"17306","ENSACAG00000027149","GL344329.1",28246,32030,3784
"17307","ENSACAG00000027152","4",132273144,132273950,806
"17308","ENSACAG00000027155","GL343786.1",248,9323,9075
"17309","ENSACAG00000027156","GL343237.1",1229371,1232544,3173
"17310","ENSACAG00000027158","1",66033827,66036235,2408
"17311","ENSACAG00000027159","GL343513.1",894,46125,45231
"17312","ENSACAG00000027163","5",82285622,82383112,97490
"17313","ENSACAG00000027170","GL343315.1",1113516,1366777,253261
"17314","ENSACAG00000027177","GL343550.1",38769,40432,1663
"17315","ENSACAG00000027185","AAWZ02041590",3103,4562,1459
"17316","ENSACAG00000027190","GL343833.1",45470,50660,5190
"17317","ENSACAG00000027193","GL343538.1",386540,387853,1313
"17318","ENSACAG00000027194","3",152233700,152233798,98
"17319","ENSACAG00000027196","GL343199.1",817083,817559,476
"17320","ENSACAG00000027200","AAWZ02040870",53,6282,6229
"17321","ENSACAG00000027203","1",133079000,133079117,117
"17322","ENSACAG00000027204","GL343585.1",95842,97611,1769
"17323","ENSACAG00000027208","4",142330245,142330442,197
"17324","ENSACAG00000027210","AAWZ02039646",1765,7900,6135
"17325","ENSACAG00000027215","GL344424.1",18988,34110,15122
"17326","ENSACAG00000027216","AAWZ02039036",4,760,756
"17327","ENSACAG00000027218","4",108367186,108372651,5465
"17328","ENSACAG00000027222","GL344486.1",4270,15739,11469
"17329","ENSACAG00000027223","GL343608.1",404108,410965,6857
"17330","ENSACAG00000027226","1",217537021,217537560,539
"17331","ENSACAG00000027227","GL343522.1",475386,475473,87
"17332","ENSACAG00000027228","GL343392.1",588313,589217,904
"17333","ENSACAG00000027231","GL343274.1",1254952,1263069,8117
"17334","ENSACAG00000027233","GL343636.1",1418,3338,1920
"17335","ENSACAG00000027234","LGf",4247110,4253138,6028
"17336","ENSACAG00000027235","1",126966145,126970707,4562
"17337","ENSACAG00000027238","AAWZ02039644",548,8064,7516
"17338","ENSACAG00000027245","4",76693892,76696309,2417
"17339","ENSACAG00000027246","GL343312.1",1404975,1415933,10958
"17340","ENSACAG00000027251","GL343672.1",50708,72164,21456
"17341","ENSACAG00000027252","1",64872869,64965641,92772
"17342","ENSACAG00000027261","GL343228.1",478273,525423,47150
"17343","ENSACAG00000027267","1",245243036,245267304,24268
"17344","ENSACAG00000027268","GL344720.1",15929,21868,5939
"17345","ENSACAG00000027271","4",61124871,61138144,13273
"17346","ENSACAG00000027272","5",28773856,28774644,788
"17347","ENSACAG00000027273","5",26264605,26274161,9556
"17348","ENSACAG00000027274","GL343466.1",314932,315312,380
"17349","ENSACAG00000027275","GL343434.1",400725,405992,5267
"17350","ENSACAG00000027289","3",167575785,167577590,1805
"17351","ENSACAG00000027292","4",146473459,146473550,91
"17352","ENSACAG00000027300","GL344204.1",36772,38647,1875
"17353","ENSACAG00000027304","GL343786.1",150338,150408,70
"17354","ENSACAG00000027307","2",193904969,193906645,1676
"17355","ENSACAG00000027310","GL343402.1",858301,858963,662
"17356","ENSACAG00000027313","GL345062.1",1975,7741,5766
"17357","ENSACAG00000027314","GL343574.1",240952,244196,3244
"17358","ENSACAG00000027324","AAWZ02039611",2733,4888,2155
"17359","ENSACAG00000027327","GL343287.1",1596059,1605349,9290
"17360","ENSACAG00000027328","AAWZ02037143",9452,15856,6404
"17361","ENSACAG00000027335","GL343226.1",2001016,2002150,1134
"17362","ENSACAG00000027342","4",133667605,133679688,12083
"17363","ENSACAG00000027343","4",119529433,119536084,6651
"17364","ENSACAG00000027346","AAWZ02038442",1211,9974,8763
"17365","ENSACAG00000027354","AAWZ02041538",658,5538,4880
"17366","ENSACAG00000027366","6",70731377,70743420,12043
"17367","ENSACAG00000027370","AAWZ02040951",519,2748,2229
"17368","ENSACAG00000027372","GL344284.1",32505,41483,8978
"17369","ENSACAG00000027379","GL343554.1",463199,468769,5570
"17370","ENSACAG00000027382","2",142257099,142258618,1519
"17371","ENSACAG00000027384","AAWZ02037858",10186,13000,2814
"17372","ENSACAG00000027387","4",143831579,143840958,9379
"17373","ENSACAG00000027388","AAWZ02036854",12031,17968,5937
"17374","ENSACAG00000027389","6",22334716,22495188,160472
"17375","ENSACAG00000027391","GL344229.1",56282,60321,4039
"17376","ENSACAG00000027392","GL343473.1",300088,301446,1358
"17377","ENSACAG00000027393","1",152248939,152312616,63677
"17378","ENSACAG00000027396","3",119450644,119451243,599
"17379","ENSACAG00000027397","GL344298.1",31304,46092,14788
"17380","ENSACAG00000027398","GL343847.1",34518,39972,5454
"17381","ENSACAG00000027401","2",16811966,16842745,30779
"17382","ENSACAG00000027402","1",178607882,178608533,651
"17383","ENSACAG00000027405","6",14115298,14116686,1388
"17384","ENSACAG00000027406","4",76866451,76868871,2420
"17385","ENSACAG00000027409","AAWZ02038598",1643,1834,191
"17386","ENSACAG00000027411","1",91486051,91494473,8422
"17387","ENSACAG00000027415","LGb",467364,468467,1103
"17388","ENSACAG00000027417","3",13769265,13776180,6915
"17389","ENSACAG00000027418","GL343509.1",171545,172312,767
"17390","ENSACAG00000027419","2",15952341,15953942,1601
"17391","ENSACAG00000027421","5",26239231,26239824,593
"17392","ENSACAG00000027430","AAWZ02039895",5757,7706,1949
"17393","ENSACAG00000027432","AAWZ02041893",21,4429,4408
"17394","ENSACAG00000027434","GL344800.1",6986,8656,1670
"17395","ENSACAG00000027437","GL343557.1",226581,228635,2054
"17396","ENSACAG00000027439","1",157578374,157579421,1047
"17397","ENSACAG00000027441","5",142662462,142698297,35835
"17398","ENSACAG00000027443","1",88869350,88870414,1064
"17399","ENSACAG00000027446","GL343525.1",409319,417920,8601
"17400","ENSACAG00000027450","GL343616.1",101425,103241,1816
"17401","ENSACAG00000027451","GL343254.1",693960,694070,110
"17402","ENSACAG00000027453","GL344038.1",18312,18392,80
"17403","ENSACAG00000027457","GL343318.1",1429392,1431386,1994
"17404","ENSACAG00000027460","GL343264.1",667043,668319,1276
"17405","ENSACAG00000027464","GL344981.1",4706,5707,1001
"17406","ENSACAG00000027465","GL343583.1",43947,73802,29855
"17407","ENSACAG00000027466","2",180745411,180746822,1411
"17408","ENSACAG00000027473","GL344499.1",4975,20645,15670
"17409","ENSACAG00000027477","3",100827266,100827475,209
"17410","ENSACAG00000027479","2",128033927,128108697,74770
"17411","ENSACAG00000027481","3",123635896,123636482,586
"17412","ENSACAG00000027484","GL344906.1",156,266,110
"17413","ENSACAG00000027493","GL344015.1",54868,85434,30566
"17414","ENSACAG00000027495","AAWZ02040519",4307,6803,2496
"17415","ENSACAG00000027496","GL343709.1",17360,102694,85334
"17416","ENSACAG00000027498","GL343801.1",83640,83769,129
"17417","ENSACAG00000027507","3",113295909,113296970,1061
"17418","ENSACAG00000027510","GL344517.1",18657,20034,1377
"17419","ENSACAG00000027511","GL344009.1",9840,10508,668
"17420","ENSACAG00000027513","2",49365799,49410433,44634
"17421","ENSACAG00000027514","GL344255.1",43391,50603,7212
"17422","ENSACAG00000027515","1",248450463,248450573,110
"17423","ENSACAG00000027516","4",26330810,26491974,161164
"17424","ENSACAG00000027519","2",198510579,198536435,25856
"17425","ENSACAG00000027521","1",112721908,112977617,255709
"17426","ENSACAG00000027528","GL343312.1",281945,282496,551
"17427","ENSACAG00000027532","6",80526222,80553001,26779
"17428","ENSACAG00000027535","1",107350483,107351250,767
"17429","ENSACAG00000027539","2",93992945,93994252,1307
"17430","ENSACAG00000027540","GL343253.1",1113268,1114679,1411
"17431","ENSACAG00000027543","GL343730.1",236689,236829,140
"17432","ENSACAG00000027544","AAWZ02041705",1098,1733,635
"17433","ENSACAG00000027545","GL344222.1",4691,7736,3045
"17434","ENSACAG00000027551","GL343557.1",197472,211604,14132
"17435","ENSACAG00000027554","AAWZ02037767",3896,11046,7150
"17436","ENSACAG00000027557","GL343868.1",108930,109133,203
"17437","ENSACAG00000027559","GL343635.1",29102,64885,35783
"17438","ENSACAG00000027560","AAWZ02037295",1902,9087,7185
"17439","ENSACAG00000027562","AAWZ02037975",5334,6648,1314
"17440","ENSACAG00000027565","5",103340898,103342073,1175
"17441","ENSACAG00000027568","3",147127300,147127779,479
"17442","ENSACAG00000027570","AAWZ02037296",209,3214,3005
"17443","ENSACAG00000027577","GL343312.1",142004,150172,8168
"17444","ENSACAG00000027584","GL343281.1",870024,877915,7891
"17445","ENSACAG00000027585","GL344103.1",581,10587,10006
"17446","ENSACAG00000027586","AAWZ02037681",694,2432,1738
"17447","ENSACAG00000027589","GL343532.1",180988,182462,1474
"17448","ENSACAG00000027592","GL343207.1",684461,684578,117
"17449","ENSACAG00000027601","2",195459088,195487171,28083
"17450","ENSACAG00000027602","AAWZ02036688",11524,14458,2934
"17451","ENSACAG00000027605","GL343330.1",962392,968070,5678
"17452","ENSACAG00000027606","3",147592155,147592943,788
"17453","ENSACAG00000027613","AAWZ02038853",220,8806,8586
"17454","ENSACAG00000027616","AAWZ02038617",5359,5429,70
"17455","ENSACAG00000027619","5",97069200,97069850,650
"17456","ENSACAG00000027620","GL343442.1",893678,894883,1205
"17457","ENSACAG00000027622","GL343591.1",22,710,688
"17458","ENSACAG00000027623","GL344562.1",26450,29114,2664
"17459","ENSACAG00000027626","GL345071.1",4429,8757,4328
"17460","ENSACAG00000027629","GL343502.1",574414,575559,1145
"17461","ENSACAG00000027630","AAWZ02037786",3777,3868,91
"17462","ENSACAG00000027631","AAWZ02038486",5412,9473,4061
"17463","ENSACAG00000027634","2",154965390,154997505,32115
"17464","ENSACAG00000027636","GL343515.1",139492,140536,1044
"17465","ENSACAG00000027639","4",76978728,76981151,2423
"17466","ENSACAG00000027642","5",85783533,85845808,62275
"17467","ENSACAG00000027644","GL344768.1",385,5466,5081
"17468","ENSACAG00000027648","GL343218.1",2169859,2193561,23702
"17469","ENSACAG00000027652","5",105282531,105283262,731
"17470","ENSACAG00000027656","GL343532.1",144517,151025,6508
"17471","ENSACAG00000027657","3",39174144,39178542,4398
"17472","ENSACAG00000027658","4",77326773,77329220,2447
"17473","ENSACAG00000027662","3",59167657,59167960,303
"17474","ENSACAG00000027663","GL343410.1",12724,51452,38728
"17475","ENSACAG00000027671","GL344778.1",38,18723,18685
"17476","ENSACAG00000027674","GL343706.1",174463,176456,1993
"17477","ENSACAG00000027677","GL344627.1",8204,12444,4240
"17478","ENSACAG00000027678","GL343253.1",478702,490825,12123
"17479","ENSACAG00000027687","2",79292320,79294134,1814
"17480","ENSACAG00000027688","1",29175688,29176565,877
"17481","ENSACAG00000027689","GL343420.1",761529,761603,74
"17482","ENSACAG00000027691","GL344658.1",17803,27321,9518
"17483","ENSACAG00000027692","GL343558.1",288340,297430,9090
"17484","ENSACAG00000027698","4",24922682,24933601,10919
"17485","ENSACAG00000027701","GL343312.1",772275,786659,14384
"17486","ENSACAG00000027704","GL343654.1",174336,175297,961
"17487","ENSACAG00000027707","GL343672.1",218561,219565,1004
"17488","ENSACAG00000027708","GL344206.1",17690,22201,4511
"17489","ENSACAG00000027709","2",188614661,188615854,1193
"17490","ENSACAG00000027710","GL343285.1",1811510,1812736,1226
"17491","ENSACAG00000027714","4",76737217,76739634,2417
"17492","ENSACAG00000027717","AAWZ02037385",3278,7302,4024
"17493","ENSACAG00000027720","3",140977049,140993715,16666
"17494","ENSACAG00000027722","GL343346.1",908466,938307,29841
"17495","ENSACAG00000027724","GL344796.1",5759,6700,941
"17496","ENSACAG00000027725","GL343489.1",457156,483576,26420
"17497","ENSACAG00000027726","AAWZ02039170",5711,5825,114
"17498","ENSACAG00000027728","4",16462731,16463477,746
"17499","ENSACAG00000027729","1",53257703,53259383,1680
"17500","ENSACAG00000027734","2",10454625,10484852,30227
"17501","ENSACAG00000027736","AAWZ02040812",1122,5775,4653
"17502","ENSACAG00000027740","AAWZ02039903",2023,7670,5647
"17503","ENSACAG00000027749","GL343236.1",1943483,1955559,12076
"17504","ENSACAG00000027751","6",41960314,41962953,2639
"17505","ENSACAG00000027759","GL343658.1",106897,136094,29197
"17506","ENSACAG00000027762","AAWZ02039722",5047,5982,935
"17507","ENSACAG00000027766","GL343220.1",1128556,1134471,5915
"17508","ENSACAG00000027770","GL343415.1",205052,206009,957
"17509","ENSACAG00000027776","GL343202.1",54234,57957,3723
"17510","ENSACAG00000027779","3",12650638,12858566,207928
"17511","ENSACAG00000027782","6",31339467,31354178,14711
"17512","ENSACAG00000027786","GL343234.1",2266119,2267820,1701
"17513","ENSACAG00000027788","GL344630.1",9137,23721,14584
"17514","ENSACAG00000027789","AAWZ02036231",13489,13615,126
"17515","ENSACAG00000027795","GL343912.1",36052,37290,1238
"17516","ENSACAG00000027796","GL343727.1",117728,118806,1078
"17517","ENSACAG00000027798","4",109868620,109970448,101828
"17518","ENSACAG00000027803","AAWZ02039121",4471,5496,1025
"17519","ENSACAG00000027804","GL343279.1",488926,490351,1425
"17520","ENSACAG00000027805","2",94950094,94971662,21568
"17521","ENSACAG00000027807","GL343741.1",223723,224535,812
"17522","ENSACAG00000027810","GL343332.1",967040,979680,12640
"17523","ENSACAG00000027813","3",85870659,85873004,2345
"17524","ENSACAG00000027814","1",91726366,91726483,117
"17525","ENSACAG00000027821","6",58396729,58445129,48400
"17526","ENSACAG00000027822","AAWZ02036029",7174,16443,9269
"17527","ENSACAG00000027823","2",127538020,127538137,117
"17528","ENSACAG00000027824","GL344529.1",5102,6798,1696
"17529","ENSACAG00000027827","4",81440598,81440702,104
"17530","ENSACAG00000027834","3",146851415,146852752,1337
"17531","ENSACAG00000027835","AAWZ02039627",1019,5662,4643
"17532","ENSACAG00000027839","1",168126932,168127051,119
"17533","ENSACAG00000027840","AAWZ02036823",9584,10871,1287
"17534","ENSACAG00000027844","GL344142.1",17782,61632,43850
"17535","ENSACAG00000027845","5",81310255,81312382,2127
"17536","ENSACAG00000027850","2",54455029,54455146,117
"17537","ENSACAG00000027856","GL343260.1",303820,304269,449
"17538","ENSACAG00000027860","GL343194.1",2367546,2380259,12713
"17539","ENSACAG00000027861","GL343575.1",355653,359582,3929
"17540","ENSACAG00000027863","GL343545.1",464762,472588,7826
"17541","ENSACAG00000027865","LGf",142747,154458,11711
"17542","ENSACAG00000027866","GL343955.1",76141,120963,44822
"17543","ENSACAG00000027867","GL343399.1",415396,415641,245
"17544","ENSACAG00000027868","AAWZ02039896",1814,5622,3808
"17545","ENSACAG00000027871","GL344798.1",8942,18016,9074
"17546","ENSACAG00000027873","GL343287.1",662714,667757,5043
"17547","ENSACAG00000027875","2",161506460,161507227,767
"17548","ENSACAG00000027877","4",110121346,110122621,1275
"17549","ENSACAG00000027880","GL343727.1",48347,84314,35967
"17550","ENSACAG00000027882","AAWZ02038614",6158,8197,2039
"17551","ENSACAG00000027884","3",9519618,9538300,18682
"17552","ENSACAG00000027886","AAWZ02040593",1252,6708,5456
"17553","ENSACAG00000027889","GL343466.1",415684,415792,108
"17554","ENSACAG00000027890","GL343235.1",2300329,2322152,21823
"17555","ENSACAG00000027893","1",165395066,165397029,1963
"17556","ENSACAG00000027899","4",73956323,73967777,11454
"17557","ENSACAG00000027902","GL343984.1",82049,96060,14011
"17558","ENSACAG00000027904","GL343323.1",114787,419354,304567
"17559","ENSACAG00000027909","AAWZ02036190",23980,27698,3718
"17560","ENSACAG00000027910","4",76955180,76957591,2411
"17561","ENSACAG00000027911","GL343896.1",88963,179075,90112
"17562","ENSACAG00000027912","AAWZ02041347",977,1628,651
"17563","ENSACAG00000027915","1",192610699,192634229,23530
"17564","ENSACAG00000027919","5",63958847,63959854,1007
"17565","ENSACAG00000027924","4",97374490,97376336,1846
"17566","ENSACAG00000027925","5",14400213,14420109,19896
"17567","ENSACAG00000027928","GL343658.1",66416,82511,16095
"17568","ENSACAG00000027930","AAWZ02038610",25,8842,8817
"17569","ENSACAG00000027934","GL343786.1",130821,130891,70
"17570","ENSACAG00000027940","GL344113.1",21435,21851,416
"17571","ENSACAG00000027944","GL343194.1",5115588,5115764,176
"17572","ENSACAG00000027947","2",195119382,195137109,17727
"17573","ENSACAG00000027952","GL343204.1",1860719,1871534,10815
"17574","ENSACAG00000027955","AAWZ02038392",5203,9321,4118
"17575","ENSACAG00000027956","GL343940.1",104877,105008,131
"17576","ENSACAG00000027959","GL344624.1",5323,21578,16255
"17577","ENSACAG00000027960","GL343426.1",594974,595091,117
"17578","ENSACAG00000027962","GL343281.1",1746329,1749123,2794
"17579","ENSACAG00000027964","GL343250.1",813232,835392,22160
"17580","ENSACAG00000027977","GL344248.1",1540,3949,2409
"17581","ENSACAG00000027982","1",201971443,201971869,426
"17582","ENSACAG00000027987","3",138626376,138628141,1765
"17583","ENSACAG00000027993","GL344865.1",4382,7629,3247
"17584","ENSACAG00000027996","AAWZ02037715",109,6824,6715
"17585","ENSACAG00000027999","3",180230781,180231660,879
"17586","ENSACAG00000028001","5",83042285,83042422,137
"17587","ENSACAG00000028002","GL344816.1",13945,19675,5730
"17588","ENSACAG00000028005","AAWZ02039022",4134,9442,5308
"17589","ENSACAG00000028009","4",156004817,156007195,2378
"17590","ENSACAG00000028010","1",34962034,34963303,1269
"17591","ENSACAG00000028012","2",23927058,23928048,990
"17592","ENSACAG00000028013","AAWZ02039084",6372,7765,1393
"17593","ENSACAG00000028015","GL343281.1",1142201,1193080,50879
"17594","ENSACAG00000028016","GL343205.1",2373694,2378080,4386
"17595","ENSACAG00000028017","GL343620.1",258025,290900,32875
"17596","ENSACAG00000028018","2",96212697,96212828,131
"17597","ENSACAG00000028019","LGf",1794357,1795040,683
"17598","ENSACAG00000028021","GL343520.1",359172,360227,1055
"17599","ENSACAG00000028022","2",196762678,196771010,8332
"17600","ENSACAG00000028023","AAWZ02040599",1026,1788,762
"17601","ENSACAG00000028030","4",6484461,6552648,68187
"17602","ENSACAG00000028031","4",76673247,76675643,2396
"17603","ENSACAG00000028034","GL343786.1",140373,141584,1211
"17604","ENSACAG00000028036","GL343626.1",358823,380096,21273
"17605","ENSACAG00000028039","2",45673405,45714532,41127
"17606","ENSACAG00000028040","4",114669404,114670180,776
"17607","ENSACAG00000028042","AAWZ02040584",39,6712,6673
"17608","ENSACAG00000028043","AAWZ02039143",6848,8092,1244
"17609","ENSACAG00000028048","2",38783937,38784413,476
"17610","ENSACAG00000028051","1",95682244,95703717,21473
"17611","ENSACAG00000028055","GL343376.1",1007986,1013523,5537
"17612","ENSACAG00000028056","1",158723497,158724661,1164
"17613","ENSACAG00000028060","GL343309.1",513037,515047,2010
"17614","ENSACAG00000028065","GL343200.1",1918299,1950636,32337
"17615","ENSACAG00000028069","AAWZ02041178",4195,5719,1524
"17616","ENSACAG00000028070","GL343301.1",1464564,1486270,21706
"17617","ENSACAG00000028075","GL343944.1",21315,23507,2192
"17618","ENSACAG00000028076","1",119945144,119998193,53049
"17619","ENSACAG00000028083","GL343933.1",38361,61328,22967
"17620","ENSACAG00000028084","GL343961.1",24860,28097,3237
"17621","ENSACAG00000028085","GL344263.1",38260,69855,31595
"17622","ENSACAG00000028089","GL344497.1",32189,33219,1030
"17623","ENSACAG00000028091","4",76994709,76997336,2627
"17624","ENSACAG00000028093","1",203054358,203055429,1071
"17625","ENSACAG00000028097","1",10103099,10103430,331
"17626","ENSACAG00000028099","GL343193.1",7598919,7599728,809
"17627","ENSACAG00000028102","AAWZ02038469",4526,10455,5929
"17628","ENSACAG00000028109","GL343312.1",1371977,1390825,18848
"17629","ENSACAG00000028111","4",77293303,77295708,2405
"17630","ENSACAG00000028114","AAWZ02041574",2031,2906,875
"17631","ENSACAG00000028116","GL343809.1",50022,51230,1208
"17632","ENSACAG00000028117","2",122504100,122506901,2801
"17633","ENSACAG00000028119","GL343210.1",1329539,1368376,38837
"17634","ENSACAG00000028121","GL343512.1",21,19879,19858
"17635","ENSACAG00000028124","GL343236.1",24223,33022,8799
"17636","ENSACAG00000028126","GL344467.1",42363,49637,7274
"17637","ENSACAG00000028131","4",114907944,114930945,23001
"17638","ENSACAG00000028133","GL343931.1",31799,109539,77740
"17639","ENSACAG00000028135","AAWZ02039807",1272,2453,1181
"17640","ENSACAG00000028136","2",60772923,60773562,639
"17641","ENSACAG00000028138","2",142172556,142236774,64218
"17642","ENSACAG00000028140","GL343205.1",2551432,2551587,155
"17643","ENSACAG00000028144","1",132197501,132198004,503
"17644","ENSACAG00000028147","3",176206604,176270420,63816
"17645","ENSACAG00000028153","6",80184805,80192746,7941
"17646","ENSACAG00000028154","5",21779188,21779424,236
"17647","ENSACAG00000028160","6",63350780,63391711,40931
"17648","ENSACAG00000028163","4",76849417,76851843,2426
"17649","ENSACAG00000028164","GL343414.1",670331,672590,2259
"17650","ENSACAG00000028166","3",28067051,28075685,8634
"17651","ENSACAG00000028172","GL343212.1",99413,100237,824
"17652","ENSACAG00000028177","2",165414146,165586359,172213
"17653","ENSACAG00000028179","2",195854446,195861250,6804
"17654","ENSACAG00000028180","AAWZ02037365",14474,16107,1633
"17655","ENSACAG00000028184","AAWZ02041389",1130,2515,1385
"17656","ENSACAG00000028193","2",71250412,71255557,5145
"17657","ENSACAG00000028195","GL343434.1",728293,731305,3012
"17658","ENSACAG00000028197","GL343994.1",246954,247931,977
"17659","ENSACAG00000028206","GL343575.1",41920,50493,8573
"17660","ENSACAG00000028207","GL343350.1",1622,2533,911
"17661","ENSACAG00000028208","3",48411948,48417720,5772
"17662","ENSACAG00000028209","GL343806.1",2696,17550,14854
"17663","ENSACAG00000028211","MT",73,1008,935
"17664","ENSACAG00000028213","MT",1077,2598,1521
"17665","ENSACAG00000028214","MT",2599,2672,73
"17666","ENSACAG00000028215","MT",2673,3633,960
"17667","ENSACAG00000028216","MT",3634,3704,70
"17668","ENSACAG00000028217","MT",3703,3772,69
"17669","ENSACAG00000028218","MT",3772,3840,68
"17670","ENSACAG00000028219","MT",3841,4876,1035
"17671","ENSACAG00000028220","MT",4877,4946,69
"17672","ENSACAG00000028221","MT",4947,5015,68
"17673","ENSACAG00000028222","MT",5017,5089,72
"17674","ENSACAG00000028223","MT",5123,5186,63
"17675","ENSACAG00000028224","MT",5187,5256,69
"17676","ENSACAG00000028225","MT",5258,6802,1544
"17677","ENSACAG00000028226","MT",6798,6868,70
"17678","ENSACAG00000028228","MT",6940,7627,687
"17679","ENSACAG00000028230","MT",7694,7861,167
"17680","ENSACAG00000028231","MT",7852,8535,683
"17681","ENSACAG00000028232","MT",8535,9318,783
"17682","ENSACAG00000028233","MT",9319,9385,66
"17683","ENSACAG00000028234","MT",9386,9731,345
"17684","ENSACAG00000028236","MT",9800,10096,296
"17685","ENSACAG00000028237","MT",10090,11454,1364
"17686","ENSACAG00000028239","MT",11532,11598,66
"17687","ENSACAG00000028241","MT",11670,13475,1805
"17688","ENSACAG00000028242","MT",13471,13995,524
"17689","ENSACAG00000028243","MT",13997,14066,69
"17690","ENSACAG00000028244","MT",14068,15207,1139
"17691","ENSACAG00000028245","MT",15208,15276,68
"17692","ENSACAG00000028246","MT",15281,15347,66
"17693","ENSACAG00000028247","GL343283.1",1487000,1501967,14967
"17694","ENSACAG00000028251","AAWZ02039025",8138,9724,1586
"17695","ENSACAG00000028252","4",14096303,14099369,3066
"17696","ENSACAG00000028253","4",138998475,139009888,11413
"17697","ENSACAG00000028254","GL343314.1",375357,376483,1126
"17698","ENSACAG00000028255","GL343429.1",537825,539364,1539
"17699","ENSACAG00000028256","GL343220.1",1339858,1347919,8061
"17700","ENSACAG00000028257","GL343300.1",903481,950041,46560
"17701","ENSACAG00000028258","GL343282.1",517709,518321,612
"17702","ENSACAG00000028259","GL343264.1",879391,897028,17637
"17703","ENSACAG00000028260","GL343232.1",479722,544430,64708
"17704","ENSACAG00000028261","5",45626486,45648232,21746
"17705","ENSACAG00000028262","GL343236.1",641567,648588,7021
"17706","ENSACAG00000028263","5",88971880,88973393,1513
"17707","ENSACAG00000028264","4",25524333,25526861,2528
"17708","ENSACAG00000028265","GL343658.1",267850,269394,1544
"17709","ENSACAG00000028266","GL343200.1",1522865,1533726,10861
"17710","ENSACAG00000028267","4",30847963,30866979,19016
"17711","ENSACAG00000028268","5",27627322,27634188,6866
"17712","ENSACAG00000028269","GL343491.1",51079,55189,4110
"17713","ENSACAG00000028270","GL343230.1",349446,351074,1628
"17714","ENSACAG00000028271","GL343324.1",720057,763841,43784
"17715","ENSACAG00000028272","1",33212790,33215071,2281
"17716","ENSACAG00000028273","GL343496.1",159103,160482,1379
"17717","ENSACAG00000028274","GL343252.1",738148,884241,146093
"17718","ENSACAG00000028275","GL343926.1",66726,67760,1034
"17719","ENSACAG00000028277","2",196935491,196936639,1148
"17720","ENSACAG00000028278","GL343305.1",436896,438014,1118
"17721","ENSACAG00000028279","6",17952727,17957779,5052
"17722","ENSACAG00000028281","GL343222.1",524959,944505,419546
"17723","ENSACAG00000028282","GL344543.1",26873,28695,1822
"17724","ENSACAG00000028283","GL343575.1",272739,281117,8378
"17725","ENSACAG00000028284","AAWZ02038314",8065,10487,2422
"17726","ENSACAG00000028286","GL343301.1",883586,886294,2708
"17727","ENSACAG00000028287","GL343620.1",955,15995,15040
"17728","ENSACAG00000028291","GL343645.1",166454,185838,19384
"17729","ENSACAG00000028292","AAWZ02037295",9437,10483,1046
"17730","ENSACAG00000028293","GL343559.1",219974,231276,11302
"17731","ENSACAG00000028294","2",108896820,108897154,334
"17732","ENSACAG00000028296","AAWZ02039956",950,6671,5721
"17733","ENSACAG00000028297","GL343491.1",57157,58005,848
"17734","ENSACAG00000028298","3",14204323,14205595,1272
"17735","ENSACAG00000028299","5",90012036,90029690,17654
"17736","ENSACAG00000028301","GL343666.1",5050,6210,1160
"17737","ENSACAG00000028302","AAWZ02037787",12376,14501,2125
"17738","ENSACAG00000028303","AAWZ02039926",2032,3375,1343
"17739","ENSACAG00000028304","3",197939033,197942343,3310
"17740","ENSACAG00000028305","2",197009814,197018018,8204
"17741","ENSACAG00000028308","AAWZ02038158",9898,12534,2636
"17742","ENSACAG00000028309","1",40108306,40109447,1141
"17743","ENSACAG00000028310","GL343473.1",698112,699156,1044
"17744","ENSACAG00000028311","GL343207.1",997368,1006089,8721
"17745","ENSACAG00000028312","6",78353154,78354224,1070
"17746","ENSACAG00000028313","AAWZ02038549",3551,9759,6208
"17747","ENSACAG00000028314","GL343511.1",126173,152445,26272
"17748","ENSACAG00000028315","GL343667.1",293566,303659,10093
"17749","ENSACAG00000028317","AAWZ02040178",21,2546,2525
"17750","ENSACAG00000028318","GL343236.1",2217040,2218231,1191
"17751","ENSACAG00000028319","GL344165.1",39915,52127,12212
"17752","ENSACAG00000028320","GL343324.1",423588,424655,1067
"17753","ENSACAG00000028321","GL343255.1",1959358,1960974,1616
"17754","ENSACAG00000028323","6",18012861,18024245,11384
"17755","ENSACAG00000028324","LGf",897907,924982,27075
"17756","ENSACAG00000028325","GL343516.1",466032,469512,3480
"17757","ENSACAG00000028326","5",3803343,3824084,20741
"17758","ENSACAG00000028327","GL343782.1",77329,90479,13150
"17759","ENSACAG00000028328","1",229525604,229707508,181904
"17760","ENSACAG00000028329","2",121987109,121988191,1082
"17761","ENSACAG00000028331","GL343261.1",1546747,1580370,33623
"17762","ENSACAG00000028332","5",131340531,131342336,1805
"17763","ENSACAG00000028333","GL343395.1",657755,747269,89514
"17764","ENSACAG00000028334","1",51289255,51293529,4274
"17765","ENSACAG00000028335","GL343322.1",846319,850984,4665
"17766","ENSACAG00000028339","GL343194.1",6149504,6150543,1039
"17767","ENSACAG00000028340","4",126538520,126592174,53654
"17768","ENSACAG00000028341","GL343667.1",167869,168975,1106
"17769","ENSACAG00000028342","GL343202.1",1663623,1665728,2105
"17770","ENSACAG00000028344","4",121456909,121489247,32338
"17771","ENSACAG00000028346","AAWZ02040715",41,1585,1544
"17772","ENSACAG00000028347","5",29639913,29645015,5102
"17773","ENSACAG00000028348","1",95617787,95631929,14142
"17774","ENSACAG00000028350","2",194604148,194605519,1371
"17775","ENSACAG00000028351","2",6107171,6118573,11402
"17776","ENSACAG00000028352","GL343491.1",309396,311654,2258
"17777","ENSACAG00000028353","GL343903.1",21,7899,7878
"17778","ENSACAG00000028354","GL343319.1",1235559,1237241,1682
"17779","ENSACAG00000028355","GL344111.1",4917,14374,9457
"17780","ENSACAG00000028356","3",40281472,40290391,8919
"17781","ENSACAG00000028357","AAWZ02040677",22,3781,3759
"17782","ENSACAG00000028358","GL343216.1",901169,930389,29220
"17783","ENSACAG00000028360","GL343194.1",2299924,2368192,68268
"17784","ENSACAG00000028361","1",203865152,203878760,13608
"17785","ENSACAG00000028363","4",109086472,109093880,7408
"17786","ENSACAG00000028364","5",26792466,26848551,56085
"17787","ENSACAG00000028365","GL343577.1",223075,233025,9950
"17788","ENSACAG00000028367","3",169026543,169063384,36841
"17789","ENSACAG00000028369","2",125284545,125345130,60585
"17790","ENSACAG00000028370","2",198788406,198804680,16274
"17791","ENSACAG00000028371","2",73123979,73137381,13402
"17792","ENSACAG00000028372","GL343329.1",145517,157230,11713
"17793","ENSACAG00000028373","GL343211.1",2672764,2674255,1491
"17794","ENSACAG00000028374","GL343270.1",958024,981973,23949
"17795","ENSACAG00000028376","GL343513.1",133871,134916,1045
"17796","ENSACAG00000028377","GL343207.1",3218984,3271191,52207
"17797","ENSACAG00000028378","AAWZ02037296",6604,7785,1181
"17798","ENSACAG00000028379","GL343281.1",18104,22914,4810
"17799","ENSACAG00000028380","GL343339.1",1092511,1094055,1544
"17800","ENSACAG00000028381","1",263318488,263335679,17191
"17801","ENSACAG00000028382","GL343545.1",209798,210799,1001
"17802","ENSACAG00000028383","4",118973309,118986277,12968
"17803","ENSACAG00000028384","GL343241.1",1606071,1632188,26117
"17804","ENSACAG00000028385","1",88995981,89018960,22979
"17805","ENSACAG00000028388","4",132945037,132963599,18562
"17806","ENSACAG00000028389","3",189688457,189698892,10435
"17807","ENSACAG00000028392","GL343264.1",1920550,1932401,11851
"17808","ENSACAG00000028393","GL343827.1",98412,99443,1031
"17809","ENSACAG00000028394","GL343653.1",293589,294647,1058
"17810","ENSACAG00000028395","6",892038,910155,18117
"17811","ENSACAG00000028397","2",75393516,75502605,109089
"17812","ENSACAG00000028399","AAWZ02037417",264,1447,1183
"17813","ENSACAG00000028401","6",62129905,62141068,11163
"17814","ENSACAG00000028403","4",123329489,123337813,8324
"17815","ENSACAG00000028405","AAWZ02039828",5484,7360,1876
"17816","ENSACAG00000028406","3",167987442,168043639,56197
"17817","ENSACAG00000028407","GL343257.1",1944880,1945938,1058
"17818","ENSACAG00000028408","GL343295.1",1128865,1150250,21385
"17819","ENSACAG00000028409","GL343730.1",256465,258627,2162
"17820","ENSACAG00000028412","4",112252149,112282535,30386
"17821","ENSACAG00000028413","GL343369.1",208619,211055,2436
"17822","ENSACAG00000028414","6",54797086,54821473,24387
"17823","ENSACAG00000028416","GL343855.1",99159,100190,1031
"17824","ENSACAG00000028418","GL343235.1",85064,109424,24360
"17825","ENSACAG00000028420","5",99699092,99730962,31870
"17826","ENSACAG00000028421","6",25927580,25928587,1007
"17827","ENSACAG00000028423","AAWZ02036584",2515,5418,2903
"17828","ENSACAG00000028425","GL343249.1",22498,253479,230981
"17829","ENSACAG00000028426","GL343299.1",4152,5466,1314
"17830","ENSACAG00000028427","GL343499.1",489244,493799,4555
"17831","ENSACAG00000028428","GL343681.1",88514,164820,76306
"17832","ENSACAG00000028429","GL343533.1",487086,488360,1274
"17833","ENSACAG00000028431","AAWZ02039718",203,1678,1475
"17834","ENSACAG00000028432","GL343402.1",753168,765768,12600
"17835","ENSACAG00000028433","GL343485.1",62608,63642,1034
"17836","ENSACAG00000028434","GL344596.1",12215,13299,1084
"17837","ENSACAG00000028435","GL344093.1",4437,8105,3668
"17838","ENSACAG00000028436","2",68330828,68348939,18111
"17839","ENSACAG00000028437","GL343392.1",426018,427216,1198
"17840","ENSACAG00000028438","2",102235847,102252978,17131
"17841","ENSACAG00000028440","4",118899740,118901135,1395
"17842","ENSACAG00000028441","GL343390.1",285518,498689,213171
"17843","ENSACAG00000028442","1",90628307,90635473,7166
"17844","ENSACAG00000028444","GL343232.1",2143824,2144954,1130
"17845","ENSACAG00000028445","2",143435865,143449755,13890
"17846","ENSACAG00000028446","GL343245.1",1365798,1385266,19468
"17847","ENSACAG00000028448","6",15869556,15872048,2492
"17848","ENSACAG00000028449","GL343714.1",12763,14207,1444
"17849","ENSACAG00000028450","AAWZ02041114",2857,3903,1046
"17850","ENSACAG00000028452","GL343540.1",112220,118735,6515
"17851","ENSACAG00000028453","3",167918625,167932247,13622
"17852","ENSACAG00000028454","GL343557.1",244950,248650,3700
"17853","ENSACAG00000028455","AAWZ02039491",244,1318,1074
"17854","ENSACAG00000028456","GL343772.1",65491,87537,22046
"17855","ENSACAG00000028457","GL343287.1",1488551,1489715,1164
"17856","ENSACAG00000028458","3",52466446,52489533,23087
"17857","ENSACAG00000028462","2",198962908,198979538,16630
"17858","ENSACAG00000028463","GL343196.1",2512485,2542534,30049
"17859","ENSACAG00000028464","4",23311991,23449062,137071
"17860","ENSACAG00000028465","AAWZ02037478",9028,10335,1307
"17861","ENSACAG00000028467","GL343245.1",1990798,2027385,36587
"17862","ENSACAG00000028468","6",18154636,18177316,22680
"17863","ENSACAG00000028469","GL343280.1",471020,472313,1293
"17864","ENSACAG00000028470","6",59796212,59796979,767
"17865","ENSACAG00000028471","GL343235.1",641054,666069,25015
"17866","ENSACAG00000028472","GL343221.1",2471267,2535838,64571
"17867","ENSACAG00000028473","3",195857886,195870172,12286
"17868","ENSACAG00000028474","4",19826432,19850791,24359
"17869","ENSACAG00000028478","2",1852221,1870124,17903
"17870","ENSACAG00000028479","GL343628.1",219059,252508,33449
"17871","ENSACAG00000028480","GL343606.1",3430,7676,4246
"17872","ENSACAG00000028481","GL343240.1",142232,277969,135737
"17873","ENSACAG00000028482","6",19396011,19407370,11359
"17874","ENSACAG00000028483","2",142784536,142818128,33592
"17875","ENSACAG00000028484","GL343295.1",415048,437626,22578
"17876","ENSACAG00000028485","GL343570.1",293367,294650,1283
"17877","ENSACAG00000028486","3",18974254,19028616,54362
"17878","ENSACAG00000028487","3",59616895,59794810,177915
"17879","ENSACAG00000028488","AAWZ02039586",5203,7855,2652
"17880","ENSACAG00000028489","4",124756713,124767746,11033
"17881","ENSACAG00000028490","GL343235.1",1800220,1807863,7643
"17882","ENSACAG00000028491","AAWZ02037189",1217,11436,10219
"17883","ENSACAG00000028492","GL343283.1",1652781,1707738,54957
"17884","ENSACAG00000028493","1",213349454,213351420,1966
"17885","ENSACAG00000028494","GL343573.1",22508,23761,1253
"17886","ENSACAG00000028495","5",47774038,47918728,144690
"17887","ENSACAG00000028496","5",26637904,26642298,4394
"17888","ENSACAG00000028497","GL343193.1",8301237,8313846,12609
"17889","ENSACAG00000028498","GL343396.1",119497,206110,86613
"17890","ENSACAG00000028499","GL343775.1",108746,109798,1052
"17891","ENSACAG00000028500","GL343451.1",765053,767522,2469
"17892","ENSACAG00000028501","GL343926.1",114767,118995,4228
"17893","ENSACAG00000028502","GL343223.1",1126942,1146713,19771
"17894","ENSACAG00000028503","GL343304.1",228271,248463,20192
"17895","ENSACAG00000028504","GL344568.1",651,28406,27755
"17896","ENSACAG00000028505","1",95217913,95233763,15850
"17897","ENSACAG00000028506","GL343788.1",124670,129754,5084
"17898","ENSACAG00000028508","GL343708.1",235700,237266,1566
"17899","ENSACAG00000028509","GL343253.1",183514,188680,5166
"17900","ENSACAG00000028511","1",108114491,108127388,12897
"17901","ENSACAG00000028513","2",190697710,190705031,7321
"17902","ENSACAG00000028514","GL343233.1",1533443,1536881,3438
"17903","ENSACAG00000028515","GL343279.1",1183989,1209191,25202
"17904","ENSACAG00000028516","4",98029366,98066643,37277
"17905","ENSACAG00000028518","GL343540.1",363292,365817,2525
"17906","ENSACAG00000028520","GL343252.1",205952,207077,1125
"17907","ENSACAG00000028521","1",78110141,78130839,20698
"17908","ENSACAG00000028522","6",54823204,54857556,34352
"17909","ENSACAG00000028523","5",44294661,44295700,1039
"17910","ENSACAG00000028524","GL343204.1",377987,379118,1131
"17911","ENSACAG00000028525","GL343200.1",3425007,3426551,1544
"17912","ENSACAG00000028526","GL343363.1",7897,9009,1112
"17913","ENSACAG00000028528","1",238736349,238743299,6950
"17914","ENSACAG00000028529","GL343196.1",5672928,5674061,1133
"17915","ENSACAG00000028530","GL343193.1",8393303,8425628,32325
"17916","ENSACAG00000028531","2",189436253,189451580,15327
"17917","ENSACAG00000028532","AAWZ02041919",496,1910,1414
"17918","ENSACAG00000028533","GL343281.1",1688576,1704527,15951
"17919","ENSACAG00000028534","GL343667.1",264294,281755,17461
"17920","ENSACAG00000028535","4",88040,92404,4364
"17921","ENSACAG00000028536","2",22565851,22567171,1320
"17922","ENSACAG00000028537","6",79782525,79794185,11660
"17923","ENSACAG00000028539","GL344070.1",23908,32103,8195
"17924","ENSACAG00000028540","AAWZ02039301",2542,8102,5560
"17925","ENSACAG00000028541","AAWZ02041078",21,1410,1389
"17926","ENSACAG00000028542","1",186000324,186015313,14989
"17927","ENSACAG00000028543","3",82289346,82291150,1804
"17928","ENSACAG00000028544","GL343297.1",276090,321809,45719
"17929","ENSACAG00000028545","GL343466.1",303433,306099,2666
"17930","ENSACAG00000028547","GL343196.1",3432242,3433265,1023
"17931","ENSACAG00000028549","GL344995.1",3760,5816,2056
"17932","ENSACAG00000028550","GL343200.1",4057831,4059855,2024
"17933","ENSACAG00000028552","2",138025818,138027176,1358
"17934","ENSACAG00000028553","5",18696456,18700075,3619
"17935","ENSACAG00000028554","4",57083644,57090151,6507
"17936","ENSACAG00000028555","4",38316227,38367762,51535
"17937","ENSACAG00000028556","GL344018.1",104305,118500,14195
"17938","ENSACAG00000028557","GL343928.1",74378,90301,15923
"17939","ENSACAG00000028558","GL343406.1",616800,632583,15783
"17940","ENSACAG00000028560","1",30616938,30618047,1109
"17941","ENSACAG00000028562","6",70918797,70935409,16612
"17942","ENSACAG00000028563","4",97644196,97672348,28152
"17943","ENSACAG00000028564","1",237390841,237468096,77255
"17944","ENSACAG00000028565","GL343209.1",530773,556326,25553
"17945","ENSACAG00000028566","GL343961.1",19362,23799,4437
"17946","ENSACAG00000028567","GL343713.1",132759,133817,1058
"17947","ENSACAG00000028568","GL343196.1",3694570,3750867,56297
"17948","ENSACAG00000028569","GL343604.1",28272,29763,1491
"17949","ENSACAG00000028571","GL343312.1",1074945,1081001,6056
"17950","ENSACAG00000028572","GL343312.1",883969,890157,6188
"17951","ENSACAG00000028573","GL343339.1",866076,867101,1025
"17952","ENSACAG00000028574","AAWZ02041814",2678,3929,1251
"17953","ENSACAG00000028575","GL343462.1",119662,120876,1214
"17954","ENSACAG00000028576","GL343434.1",648213,655931,7718
"17955","ENSACAG00000028577","6",14366629,14373646,7017
"17956","ENSACAG00000028578","2",81083205,81097885,14680
"17957","ENSACAG00000028579","3",77178210,77179237,1027
"17958","ENSACAG00000028581","AAWZ02039226",3627,8669,5042
"17959","ENSACAG00000028582","AAWZ02038596",423,1839,1416
"17960","ENSACAG00000028583","GL343635.1",219076,229772,10696
"17961","ENSACAG00000028584","6",15989875,16004378,14503
"17962","ENSACAG00000028585","3",106690893,106692007,1114
"17963","ENSACAG00000028586","1",224564334,224580508,16174
"17964","ENSACAG00000028587","GL344068.1",5323,6348,1025
"17965","ENSACAG00000028589","GL344759.1",5796,12220,6424
"17966","ENSACAG00000028591","2",192875094,192887674,12580
"17967","ENSACAG00000028592","AAWZ02040585",26,2024,1998
"17968","ENSACAG00000028593","2",115986797,115996463,9666
"17969","ENSACAG00000028594","1",40207494,40227584,20090
"17970","ENSACAG00000028595","LGf",3067459,3110300,42841
"17971","ENSACAG00000028597","GL343272.1",1071999,1086038,14039
"17972","ENSACAG00000028600","GL343822.1",44793,46400,1607
"17973","ENSACAG00000028601","5",43227416,43240492,13076
"17974","ENSACAG00000028602","GL343249.1",1766541,1783462,16921
"17975","ENSACAG00000028603","5",2601265,2829443,228178
"17976","ENSACAG00000028604","GL343231.1",1496258,1497448,1190
"17977","ENSACAG00000028605","GL343908.1",126392,127417,1025
"17978","ENSACAG00000028606","2",68950553,68964424,13871
"17979","ENSACAG00000028607","6",51423605,51429589,5984
"17980","ENSACAG00000028608","AAWZ02041975",21,2119,2098
"17981","ENSACAG00000028609","1",91087839,91095168,7329
"17982","ENSACAG00000028610","GL344472.1",11885,12892,1007
"17983","ENSACAG00000028611","4",43347803,43373018,25215
"17984","ENSACAG00000028612","GL343566.1",417177,444056,26879
"17985","ENSACAG00000028613","6",78137820,78159937,22117
"17986","ENSACAG00000028614","2",31920599,31970763,50164
"17987","ENSACAG00000028616","3",139451806,139500528,48722
"17988","ENSACAG00000028618","GL343900.1",80475,100389,19914
"17989","ENSACAG00000028621","AAWZ02039583",6086,8201,2115
"17990","ENSACAG00000028622","2",114780198,114786081,5883
"17991","ENSACAG00000028623","AAWZ02036591",3563,18463,14900
"17992","ENSACAG00000028624","GL343821.1",78860,79996,1136
"17993","ENSACAG00000028626","5",31691704,31722278,30574
"17994","ENSACAG00000028627","GL344181.1",1363,14885,13522
"17995","ENSACAG00000028628","2",192403512,192416545,13033
"17996","ENSACAG00000028629","2",194957542,194970893,13351
"17997","ENSACAG00000028631","GL343208.1",389247,403614,14367
"17998","ENSACAG00000028632","GL343287.1",991635,1002385,10750
"17999","ENSACAG00000028633","GL343592.1",242659,261764,19105
"18000","ENSACAG00000028634","AAWZ02038484",6931,7937,1006
"18001","ENSACAG00000028635","AAWZ02041624",4067,5246,1179
"18002","ENSACAG00000028636","GL343430.1",315862,317421,1559
"18003","ENSACAG00000028637","GL343291.1",1665076,1675731,10655
"18004","ENSACAG00000028638","3",117132671,117133819,1148
"18005","ENSACAG00000028640","GL343253.1",207028,211748,4720
"18006","ENSACAG00000028641","GL343384.1",446896,448226,1330
"18007","ENSACAG00000028642","4",108929107,108948188,19081
"18008","ENSACAG00000028643","GL343219.1",51337,64323,12986
"18009","ENSACAG00000028645","GL343980.1",73990,80259,6269
"18010","ENSACAG00000028646","1",148970558,148977078,6520
"18011","ENSACAG00000028647","GL343398.1",723975,725367,1392
"18012","ENSACAG00000028648","6",70390670,70404326,13656
"18013","ENSACAG00000028649","GL343713.1",34712,44764,10052
"18014","ENSACAG00000028650","GL343604.1",329430,351485,22055
"18015","ENSACAG00000028651","GL343303.1",1566046,1567181,1135
"18016","ENSACAG00000028652","5",108466229,108473282,7053
"18017","ENSACAG00000028653","GL343443.1",72137,73292,1155
"18018","ENSACAG00000028656","1",11651929,11674005,22076
"18019","ENSACAG00000028657","GL343885.1",86168,115057,28889
"18020","ENSACAG00000028658","1",178305654,178309629,3975
"18021","ENSACAG00000028659","GL343491.1",125101,125749,648
"18022","ENSACAG00000028660","GL343283.1",964238,980462,16224
"18023","ENSACAG00000028662","GL343385.1",724558,727596,3038
"18024","ENSACAG00000028663","4",129812095,129813929,1834
"18025","ENSACAG00000028664","1",194954141,195559564,605423
"18026","ENSACAG00000028665","GL343485.1",34530,36906,2376
"18027","ENSACAG00000028666","GL343295.1",1185062,1210261,25199
"18028","ENSACAG00000028667","GL343399.1",921556,923406,1850
"18029","ENSACAG00000028668","GL343830.1",166,2187,2021
"18030","ENSACAG00000028670","AAWZ02039647",502,1767,1265
"18031","ENSACAG00000028672","GL343322.1",1110612,1117274,6662
"18032","ENSACAG00000028673","GL343287.1",547531,564020,16489
"18033","ENSACAG00000028675","1",54255029,54412620,157591
"18034","ENSACAG00000028676","GL343295.1",1277600,1313000,35400
"18035","ENSACAG00000028677","GL343658.1",157797,159209,1412
"18036","ENSACAG00000028678","GL344924.1",21,12348,12327
"18037","ENSACAG00000028679","GL343495.1",428958,430756,1798
"18038","ENSACAG00000028680","GL343332.1",243565,260975,17410
"18039","ENSACAG00000028682","GL343211.1",2242000,2256308,14308
"18040","ENSACAG00000028683","2",197579869,197590718,10849
"18041","ENSACAG00000028684","GL343528.1",26461,28536,2075
"18042","ENSACAG00000028685","LGf",3035082,3170592,135510
"18043","ENSACAG00000028686","4",105598430,105613951,15521
"18044","ENSACAG00000028687","6",50850024,50872616,22592
"18045","ENSACAG00000028689","LGf",3186015,3201706,15691
"18046","ENSACAG00000028690","AAWZ02036986",4325,6170,1845
"18047","ENSACAG00000028691","GL344573.1",9520,13794,4274
"18048","ENSACAG00000028692","2",195353335,195410990,57655
"18049","ENSACAG00000028693","2",81716332,81777491,61159
"18050","ENSACAG00000028694","GL343706.1",75609,79865,4256
"18051","ENSACAG00000028695","GL343422.1",536942,678232,141290
"18052","ENSACAG00000028696","GL343329.1",1276642,1286186,9544
"18053","ENSACAG00000028697","2",77340654,77416201,75547
"18054","ENSACAG00000028698","GL343626.1",322203,323282,1079
"18055","ENSACAG00000028699","AAWZ02038886",5227,8902,3675
"18056","ENSACAG00000028700","GL343666.1",207905,233798,25893
"18057","ENSACAG00000028701","2",82618569,82682097,63528
"18058","ENSACAG00000028703","GL344813.1",20189,21827,1638
"18059","ENSACAG00000028704","AAWZ02037829",11956,14316,2360
"18060","ENSACAG00000028705","2",109406732,109438909,32177
"18061","ENSACAG00000028706","GL343672.1",223387,224417,1030
"18062","ENSACAG00000028707","1",36810309,36811931,1622
"18063","ENSACAG00000028708","2",17831214,17959106,127892
"18064","ENSACAG00000028709","GL343253.1",430974,461745,30771
"18065","ENSACAG00000028711","GL343240.1",184515,185540,1025
"18066","ENSACAG00000028712","GL343518.1",217121,249598,32477
"18067","ENSACAG00000028713","GL343711.1",38398,57291,18893
"18068","ENSACAG00000028714","GL343282.1",519914,520449,535
"18069","ENSACAG00000028715","GL343590.1",359512,361140,1628
"18070","ENSACAG00000028716","GL343442.1",500405,516265,15860
"18071","ENSACAG00000028717","4",114248010,114364175,116165
"18072","ENSACAG00000028718","1",68987306,69393295,405989
"18073","ENSACAG00000028719","AAWZ02038465",21,3255,3234
"18074","ENSACAG00000028720","6",70623216,70631496,8280
"18075","ENSACAG00000028721","GL343648.1",177875,182017,4142
"18076","ENSACAG00000028722","GL343402.1",665867,668345,2478
"18077","ENSACAG00000028723","GL343220.1",1350728,1356831,6103
"18078","ENSACAG00000028725","1",56061669,56108840,47171
"18079","ENSACAG00000028726","5",63078420,63080167,1747
"18080","ENSACAG00000028727","GL343491.1",370976,372203,1227
"18081","ENSACAG00000028729","AAWZ02040236",670,2860,2190
"18082","ENSACAG00000028730","GL343575.1",108617,115381,6764
"18083","ENSACAG00000028731","4",90538698,90553683,14985
"18084","ENSACAG00000028732","2",197393466,197400369,6903
"18085","ENSACAG00000028733","GL343588.1",420432,421577,1145
"18086","ENSACAG00000028734","2",189598257,189632608,34351
"18087","ENSACAG00000028735","5",104844281,104887272,42991
"18088","ENSACAG00000028736","3",13248055,13274877,26822
"18089","ENSACAG00000028737","GL343253.1",376467,396301,19834
"18090","ENSACAG00000028738","1",230867731,230868936,1205
"18091","ENSACAG00000028739","GL344340.1",6385,31434,25049
"18092","ENSACAG00000028741","GL344728.1",10303,11347,1044
"18093","ENSACAG00000028742","GL343856.1",12581,13589,1008
"18094","ENSACAG00000028744","GL343268.1",909671,910779,1108
"18095","ENSACAG00000028745","GL343647.1",346742,357257,10515
"18096","ENSACAG00000028746","GL343323.1",1283546,1313061,29515
"18097","ENSACAG00000028747","GL343541.1",459723,479077,19354
"18098","ENSACAG00000028748","2",188994661,189011181,16520
"18099","ENSACAG00000028749","1",3684322,3692289,7967
"18100","ENSACAG00000028750","1",74995175,75013783,18608
"18101","ENSACAG00000028751","2",189201393,189219330,17937
"18102","ENSACAG00000028755","4",126336338,126352207,15869
"18103","ENSACAG00000028757","GL343402.1",908639,917393,8754
"18104","ENSACAG00000028758","GL343295.1",609635,626317,16682
"18105","ENSACAG00000028759","GL343300.1",1636634,1660289,23655
"18106","ENSACAG00000028761","GL343916.1",108656,110221,1565
"18107","ENSACAG00000028762","5",24495542,24543730,48188
"18108","ENSACAG00000028763","2",58948408,58972805,24397
"18109","ENSACAG00000028764","2",95490801,95512216,21415
"18110","ENSACAG00000028765","GL343608.1",321527,326749,5222
"18111","ENSACAG00000028767","3",136255483,136287028,31545
"18112","ENSACAG00000028768","GL344346.1",7512,23010,15498
"18113","ENSACAG00000028770","4",53165473,53175554,10081
"18114","ENSACAG00000028771","GL343323.1",1339064,1349894,10830
"18115","ENSACAG00000028772","GL343238.1",888698,895870,7172
"18116","ENSACAG00000028773","GL343223.1",1050571,1051800,1229
"18117","ENSACAG00000028774","2",102885527,102899931,14404
"18118","ENSACAG00000028775","5",45771972,45809992,38020
"18119","ENSACAG00000028776","AAWZ02041629",33,5320,5287
"18120","ENSACAG00000028777","GL343271.1",1694512,1695514,1002
"18121","ENSACAG00000028778","AAWZ02040125",1303,2364,1061
"18122","ENSACAG00000028780","GL343196.1",2553833,2570240,16407
"18123","ENSACAG00000028782","GL343490.1",454452,459042,4590
"18124","ENSACAG00000028783","5",124976226,124987065,10839
"18125","ENSACAG00000028784","2",94532527,94544502,11975
"18126","ENSACAG00000028785","GL343297.1",1581331,1613207,31876
"18127","ENSACAG00000028786","6",62041175,62052961,11786
"18128","ENSACAG00000028787","5",26969088,26980107,11019
"18129","ENSACAG00000028788","GL343339.1",929850,931032,1182
"18130","ENSACAG00000028789","GL343448.1",541613,542728,1115
"18131","ENSACAG00000028790","GL343367.1",672708,683171,10463
"18132","ENSACAG00000028791","4",155720198,155792078,71880
"18133","ENSACAG00000028792","5",6291944,6303886,11942
"18134","ENSACAG00000028794","2",95083371,95095109,11738
"18135","ENSACAG00000028795","GL343400.1",571337,577168,5831
"18136","ENSACAG00000028796","3",37968681,37998526,29845
"18137","ENSACAG00000028798","GL344588.1",17961,19238,1277
"18138","ENSACAG00000028799","GL343194.1",10262321,10273167,10846
"18139","ENSACAG00000028800","1",256623118,256736608,113490
"18140","ENSACAG00000028801","AAWZ02037869",41,12737,12696
"18141","ENSACAG00000028807","GL343659.1",33611,35389,1778
"18142","ENSACAG00000028808","GL343263.1",2019588,2049651,30063
"18143","ENSACAG00000028809","1",108068997,108074793,5796
"18144","ENSACAG00000028810","GL343378.1",129363,131489,2126
"18145","ENSACAG00000028811","3",23292927,23296252,3325
"18146","ENSACAG00000028813","GL343487.1",596200,608662,12462
"18147","ENSACAG00000028814","GL343483.1",86650,98304,11654
"18148","ENSACAG00000028815","4",110388492,110405479,16987
"18149","ENSACAG00000028816","GL343708.1",223135,263042,39907
"18150","ENSACAG00000028818","5",91047725,91062568,14843
"18151","ENSACAG00000028819","1",1341163,1367806,26643
"18152","ENSACAG00000028820","2",112013087,112080780,67693
"18153","ENSACAG00000028821","5",113719426,113727536,8110
"18154","ENSACAG00000028822","GL343494.1",74594,75811,1217
"18155","ENSACAG00000028823","GL343713.1",171923,176923,5000
"18156","ENSACAG00000028824","2",197030362,197041669,11307
"18157","ENSACAG00000028826","GL343880.1",124499,139067,14568
"18158","ENSACAG00000028827","1",24326634,24332103,5469
"18159","ENSACAG00000028828","2",68186411,68195323,8912
"18160","ENSACAG00000028829","AAWZ02039442",21,1269,1248
"18161","ENSACAG00000028830","3",195376839,195389542,12703
"18162","ENSACAG00000028831","5",146818502,146829152,10650
"18163","ENSACAG00000028833","5",24113914,24129866,15952
"18164","ENSACAG00000028834","GL343209.1",2674713,2727553,52840
"18165","ENSACAG00000028835","GL343967.1",20962,28728,7766
"18166","ENSACAG00000028836","GL343560.1",99744,100775,1031
"18167","ENSACAG00000028837","2",102964086,102969981,5895
"18168","ENSACAG00000028838","GL344845.1",8596,9973,1377
"18169","ENSACAG00000028839","GL343253.1",246599,262203,15604
"18170","ENSACAG00000028840","AAWZ02037644",10098,11234,1136
"18171","ENSACAG00000028841","GL343194.1",3448099,3449256,1157
"18172","ENSACAG00000028842","GL343438.1",377439,402151,24712
"18173","ENSACAG00000028844","1",159460944,159573168,112224
"18174","ENSACAG00000028846","AAWZ02040944",5096,6273,1177
"18175","ENSACAG00000028847","GL343287.1",1517504,1579414,61910
"18176","ENSACAG00000028848","4",143229899,143238235,8336
"18177","ENSACAG00000028849","GL343585.1",305358,336045,30687
"18178","ENSACAG00000028850","AAWZ02039199",2292,3295,1003
"18179","ENSACAG00000028851","2",196106226,196114793,8567
"18180","ENSACAG00000028852","4",41631494,41632500,1006
"18181","ENSACAG00000028853","GL344839.1",16300,17700,1400
"18182","ENSACAG00000028855","GL343434.1",344995,353225,8230
"18183","ENSACAG00000028856","GL343355.1",334941,373089,38148
"18184","ENSACAG00000028857","GL343367.1",582515,604690,22175
"18185","ENSACAG00000028858","4",115863530,115870590,7060
"18186","ENSACAG00000028859","3",29716123,29718356,2233
"18187","ENSACAG00000028860","GL343248.1",10266,29874,19608
"18188","ENSACAG00000028861","GL343282.1",506859,507901,1042
"18189","ENSACAG00000028862","2",158629379,158630941,1562
"18190","ENSACAG00000028863","2",3427694,3428829,1135
"18191","ENSACAG00000028864","2",58955367,58966483,11116
"18192","ENSACAG00000028865","AAWZ02036718",11386,13137,1751
"18193","ENSACAG00000028866","GL344071.1",37509,45016,7507
"18194","ENSACAG00000028867","4",143178017,143184282,6265
"18195","ENSACAG00000028868","GL343394.1",233016,234326,1310
"18196","ENSACAG00000028869","4",131405997,131438908,32911
"18197","ENSACAG00000028870","GL343199.1",3572300,3574853,2553
"18198","ENSACAG00000028871","2",195082682,195099717,17035
"18199","ENSACAG00000028872","GL343493.1",511228,514074,2846
"18200","ENSACAG00000028873","GL343518.1",26764,32476,5712
"18201","ENSACAG00000028875","1",91071210,91080181,8971
"18202","ENSACAG00000028876","GL343547.1",112661,114136,1475
"18203","ENSACAG00000028877","AAWZ02038603",21,1149,1128
"18204","ENSACAG00000028878","GL343606.1",187495,191130,3635
"18205","ENSACAG00000028879","GL343303.1",1275484,1276567,1083
"18206","ENSACAG00000028881","3",189834960,189854726,19766
"18207","ENSACAG00000028882","5",119295130,119308201,13071
"18208","ENSACAG00000028883","GL343411.1",760770,761781,1011
"18209","ENSACAG00000028884","GL343437.1",381503,383047,1544
"18210","ENSACAG00000028886","GL343312.1",812105,825026,12921
"18211","ENSACAG00000028887","2",61706927,61723631,16704
"18212","ENSACAG00000028888","AAWZ02037006",15435,20170,4735
"18213","ENSACAG00000028889","LGf",1197811,1207353,9542
"18214","ENSACAG00000028890","1",67520121,67632951,112830
"18215","ENSACAG00000028892","4",70638378,70655513,17135
"18216","ENSACAG00000028894","GL343261.1",1007148,1008213,1065
"18217","ENSACAG00000028895","GL343426.1",501269,506817,5548
"18218","ENSACAG00000028896","GL343295.1",1210338,1243509,33171
"18219","ENSACAG00000028897","GL343235.1",1608918,1611532,2614
"18220","ENSACAG00000028898","GL343244.1",2087607,2088633,1026
"18221","ENSACAG00000028899","2",190673168,190694683,21515
"18222","ENSACAG00000028900","4",19017952,19033979,16027
"18223","ENSACAG00000028901","GL343238.1",2264306,2265918,1612
"18224","ENSACAG00000028904","GL343224.1",1831410,1832417,1007
"18225","ENSACAG00000028905","GL343312.1",472303,473358,1055
"18226","ENSACAG00000028906","GL343256.1",1334057,1377030,42973
"18227","ENSACAG00000028907","GL343322.1",1029120,1043477,14357
"18228","ENSACAG00000028908","3",48024293,48548047,523754
"18229","ENSACAG00000028910","GL343358.1",62644,80535,17891
"18230","ENSACAG00000028911","GL343296.1",1004664,1016558,11894
"18231","ENSACAG00000028912","6",80474588,80504318,29730
"18232","ENSACAG00000028913","5",85861857,85864524,2667
"18233","ENSACAG00000028914","6",59804098,59804818,720
"18234","ENSACAG00000028915","GL343307.1",99777,101022,1245
"18235","ENSACAG00000028916","GL343233.1",1551615,1575502,23887
"18236","ENSACAG00000028917","GL343253.1",172851,176543,3692
"18237","ENSACAG00000028922","GL343282.1",780704,803805,23101
"18238","ENSACAG00000028925","3",14152278,14171817,19539
"18239","ENSACAG00000028926","GL343402.1",891371,904950,13579
"18240","ENSACAG00000028927","AAWZ02037305",8570,10401,1831
"18241","ENSACAG00000028930","AAWZ02039062",1100,3036,1936
"18242","ENSACAG00000028931","2",151400675,151460583,59908
"18243","ENSACAG00000028932","GL343878.1",32721,34277,1556
"18244","ENSACAG00000028934","GL344699.1",5417,17168,11751
"18245","ENSACAG00000028935","2",181507173,181574286,67113
"18246","ENSACAG00000028936","GL343777.1",32907,34868,1961
"18247","ENSACAG00000028937","AAWZ02040940",21,1262,1241
"18248","ENSACAG00000028938","GL343603.1",2687,15077,12390
"18249","ENSACAG00000028939","5",37845904,37847709,1805
"18250","ENSACAG00000028941","GL343999.1",42431,43508,1077
"18251","ENSACAG00000028943","3",167596090,167611689,15599
"18252","ENSACAG00000028944","GL343997.1",65144,66259,1115
"18253","ENSACAG00000028945","GL344491.1",18591,42206,23615
"18254","ENSACAG00000028946","4",144527770,144536075,8305
"18255","ENSACAG00000028947","2",187262,191441,4179
"18256","ENSACAG00000028948","AAWZ02041260",21,2107,2086
"18257","ENSACAG00000028949","3",39027734,39043978,16244
"18258","ENSACAG00000028950","GL343553.1",395947,453018,57071
"18259","ENSACAG00000028951","5",120243546,120255210,11664
"18260","ENSACAG00000028952","3",14756622,14766343,9721
"18261","ENSACAG00000028953","GL343266.1",1135296,1140140,4844
"18262","ENSACAG00000028955","4",144653952,144669568,15616
"18263","ENSACAG00000028956","4",57295743,57310356,14613
"18264","ENSACAG00000028957","GL343849.1",64412,65449,1037
"18265","ENSACAG00000028959","GL343382.1",408434,447528,39094
"18266","ENSACAG00000028960","AAWZ02038120",2535,3664,1129
"18267","ENSACAG00000028961","2",197213303,197214862,1559
"18268","ENSACAG00000028962","GL343279.1",466880,474537,7657
"18269","ENSACAG00000028963","AAWZ02038613",173,2734,2561
"18270","ENSACAG00000028964","2",130952241,130961927,9686
"18271","ENSACAG00000028965","1",243603057,243623678,20621
"18272","ENSACAG00000028966","GL343474.1",421090,422319,1229
"18273","ENSACAG00000028967","4",107023339,107026366,3027
"18274","ENSACAG00000028969","5",58000150,58036552,36402
"18275","ENSACAG00000028970","4",32084072,32085479,1407
"18276","ENSACAG00000028972","2",170899393,170906412,7019
"18277","ENSACAG00000028973","GL343389.1",688224,692717,4493
"18278","ENSACAG00000028974","GL344918.1",5608,15587,9979
"18279","ENSACAG00000028975","6",21972458,22014057,41599
"18280","ENSACAG00000028976","AAWZ02039220",1619,2638,1019
"18281","ENSACAG00000028977","GL343525.1",239160,240466,1306
"18282","ENSACAG00000028978","2",193323692,193346185,22493
"18283","ENSACAG00000028979","3",56436206,56437695,1489
"18284","ENSACAG00000028980","1",73800900,73892597,91697
"18285","ENSACAG00000028981","GL343473.1",340848,343934,3086
"18286","ENSACAG00000028982","6",55698816,55745198,46382
"18287","ENSACAG00000028983","1",243589407,243599212,9805
"18288","ENSACAG00000028984","GL343281.1",315271,325380,10109
"18289","ENSACAG00000028985","1",218983224,218984279,1055
"18290","ENSACAG00000028986","5",135908385,135928753,20368
"18291","ENSACAG00000028987","AAWZ02038887",8044,9213,1169
"18292","ENSACAG00000028988","GL343312.1",802633,810536,7903
"18293","ENSACAG00000028989","GL343521.1",253701,255489,1788
"18294","ENSACAG00000028990","GL343682.1",240616,254262,13646
"18295","ENSACAG00000028991","AAWZ02038332",10866,12042,1176
"18296","ENSACAG00000028993","GL343245.1",757301,765240,7939
"18297","ENSACAG00000028994","4",81195212,81293521,98309
"18298","ENSACAG00000028995","6",60123888,60134622,10734
"18299","ENSACAG00000028996","4",90774408,90778157,3749
"18300","ENSACAG00000028997","3",65517439,65711710,194271
"18301","ENSACAG00000028998","2",197280835,197296981,16146
"18302","ENSACAG00000029000","GL343304.1",997652,1016525,18873
"18303","ENSACAG00000029003","GL345004.1",12665,13818,1153
"18304","ENSACAG00000029004","1",6185605,6190234,4629
"18305","ENSACAG00000029005","GL344047.1",94023,98972,4949
"18306","ENSACAG00000029006","3",19197662,19210774,13112
"18307","ENSACAG00000029007","2",95440022,95458665,18643
"18308","ENSACAG00000029008","6",44085654,44088165,2511
"18309","ENSACAG00000029009","GL343927.1",122427,123500,1073
"18310","ENSACAG00000029010","3",25140464,25143557,3093
"18311","ENSACAG00000029011","GL343400.1",579815,581167,1352
"18312","ENSACAG00000029012","GL343722.1",144753,153833,9080
"18313","ENSACAG00000029013","GL343791.1",128632,129684,1052
"18314","ENSACAG00000029015","GL343272.1",253620,281068,27448
"18315","ENSACAG00000029016","3",113837936,113878121,40185
"18316","ENSACAG00000029017","GL343219.1",567977,585051,17074
"18317","ENSACAG00000029021","GL343434.1",767582,772631,5049
"18318","ENSACAG00000029022","4",96976099,96992830,16731
"18319","ENSACAG00000029023","GL343195.1",451095,452445,1350
"18320","ENSACAG00000029024","GL343292.1",1177751,1178984,1233
"18321","ENSACAG00000029025","5",76849874,76852504,2630
"18322","ENSACAG00000029026","GL343239.1",208246,230875,22629
"18323","ENSACAG00000029027","2",190206360,190219608,13248
"18324","ENSACAG00000029028","GL343434.1",622769,642541,19772
"18325","ENSACAG00000029029","AAWZ02041242",1264,5459,4195
"18326","ENSACAG00000029030","2",28875554,28876900,1346
"18327","ENSACAG00000029031","GL344636.1",17911,25271,7360
"18328","ENSACAG00000029032","1",212072769,212073788,1019
"18329","ENSACAG00000029033","2",161875609,161877253,1644
"18330","ENSACAG00000029034","GL343214.1",2776084,2777423,1339
"18331","ENSACAG00000029036","2",96222779,96332552,109773
"18332","ENSACAG00000029037","GL344255.1",37173,38320,1147
"18333","ENSACAG00000029038","AAWZ02039185",7911,9180,1269
"18334","ENSACAG00000029039","GL343311.1",40452,80517,40065
"18335","ENSACAG00000029040","GL343532.1",23368,31793,8425
"18336","ENSACAG00000029041","GL343427.1",792573,799711,7138
"18337","ENSACAG00000029043","GL343614.1",94033,116901,22868
"18338","ENSACAG00000029044","LGd",1015819,1026672,10853
"18339","ENSACAG00000029045","2",127551568,127565606,14038
"18340","ENSACAG00000029046","GL343298.1",488191,489253,1062
"18341","ENSACAG00000029047","GL343464.1",189085,190218,1133
"18342","ENSACAG00000029048","AAWZ02038096",8628,9674,1046
"18343","ENSACAG00000029049","4",133004803,133019387,14584
"18344","ENSACAG00000029050","GL343724.1",240553,242004,1451
"18345","ENSACAG00000029051","1",10325618,10347120,21502
"18346","ENSACAG00000029052","4",101503979,101515300,11321
"18347","ENSACAG00000029053","GL343507.1",21444,27278,5834
"18348","ENSACAG00000029054","1",166352760,166354701,1941
"18349","ENSACAG00000029056","GL343564.1",162289,175138,12849
"18350","ENSACAG00000029057","3",109002059,109032561,30502
"18351","ENSACAG00000029059","GL343571.1",481776,483191,1415
"18352","ENSACAG00000029060","GL343497.1",449545,451353,1808
"18353","ENSACAG00000029061","GL344241.1",56242,57343,1101
"18354","ENSACAG00000029062","5",86240321,86368682,128361
"18355","ENSACAG00000029063","GL343660.1",16198,37951,21753
"18356","ENSACAG00000029064","GL343979.1",47722,65854,18132
"18357","ENSACAG00000029065","GL343494.1",156362,162978,6616
"18358","ENSACAG00000029066","GL343619.1",313186,322954,9768
"18359","ENSACAG00000029067","3",175260721,175262930,2209
"18360","ENSACAG00000029069","GL343929.1",15147,39074,23927
"18361","ENSACAG00000029070","3",64027501,64101264,73763
"18362","ENSACAG00000029071","2",147022400,147026522,4122
"18363","ENSACAG00000029072","3",91842748,91846406,3658
"18364","ENSACAG00000029073","1",242909446,242946028,36582
"18365","ENSACAG00000029074","GL343910.1",51,1104,1053
"18366","ENSACAG00000029075","2",52343481,52363797,20316
"18367","ENSACAG00000029076","4",98825482,98845164,19682
"18368","ENSACAG00000029077","GL343635.1",415179,429869,14690
"18369","ENSACAG00000029078","GL343727.1",87146,88690,1544
"18370","ENSACAG00000029079","GL343615.1",98087,108325,10238
"18371","ENSACAG00000029080","GL343253.1",1279998,1304414,24416
"18372","ENSACAG00000029082","GL344673.1",5836,7125,1289
"18373","ENSACAG00000029083","5",107215684,107441841,226157
"18374","ENSACAG00000029084","GL343220.1",6608,9409,2801
"18375","ENSACAG00000029087","GL343244.1",286502,294749,8247
"18376","ENSACAG00000029090","GL343363.1",365208,369231,4023
"18377","ENSACAG00000029091","GL343249.1",961670,1100681,139011
"18378","ENSACAG00000029092","GL343199.1",3836050,3837172,1122
"18379","ENSACAG00000029093","GL343466.1",320960,329899,8939
"18380","ENSACAG00000029094","AAWZ02039156",4617,6290,1673
"18381","ENSACAG00000029095","AAWZ02041861",266,4404,4138
"18382","ENSACAG00000029096","GL343343.1",431476,457956,26480
"18383","ENSACAG00000029097","GL343690.1",68270,69448,1178
"18384","ENSACAG00000029098","3",69983608,69998863,15255
"18385","ENSACAG00000029100","GL344604.1",6831,16409,9578
"18386","ENSACAG00000029101","GL343326.1",688767,698644,9877
"18387","ENSACAG00000029103","1",200133282,200234008,100726
"18388","ENSACAG00000029104","2",118243857,118255004,11147
"18389","ENSACAG00000029105","2",196799663,196806899,7236
"18390","ENSACAG00000029106","GL343412.1",131924,171169,39245
"18391","ENSACAG00000029107","GL343287.1",38301,51141,12840
"18392","ENSACAG00000029108","4",114823057,114840360,17303
"18393","ENSACAG00000029109","GL343228.1",1940681,1942125,1444
"18394","ENSACAG00000029111","AAWZ02039813",1982,3350,1368
"18395","ENSACAG00000029112","4",78154735,78176565,21830
"18396","ENSACAG00000029114","GL343667.1",67524,75108,7584
"18397","ENSACAG00000029115","3",96958173,97022742,64569
"18398","ENSACAG00000029116","3",17434932,17613436,178504
"18399","ENSACAG00000029118","GL344166.1",40912,42558,1646
"18400","ENSACAG00000029119","AAWZ02039947",6489,7586,1097
"18401","ENSACAG00000029120","1",122100806,122104120,3314
"18402","ENSACAG00000029121","3",17811819,17815998,4179
"18403","ENSACAG00000029122","6",72969606,72979212,9606
"18404","ENSACAG00000029123","GL343606.1",207730,225891,18161
"18405","ENSACAG00000029124","GL343253.1",288791,309241,20450
"18406","ENSACAG00000029126","3",40604629,40624320,19691
"18407","ENSACAG00000029127","2",199120046,199137802,17756
"18408","ENSACAG00000029128","GL343200.1",1017260,1083436,66176
"18409","ENSACAG00000029129","1",91212028,91250167,38139
"18410","ENSACAG00000029130","1",190635052,190636071,1019
"18411","ENSACAG00000029131","6",59212600,59253749,41149
"18412","ENSACAG00000029132","GL343616.1",381939,383510,1571
"18413","ENSACAG00000029133","GL343570.1",61361,95700,34339
"18414","ENSACAG00000029134","GL343323.1",1131982,1136976,4994
"18415","ENSACAG00000029135","GL343344.1",845857,846996,1139
"18416","ENSACAG00000029136","6",12328742,12431163,102421
"18417","ENSACAG00000029137","4",127134552,127135661,1109
"18418","ENSACAG00000029140","GL344022.1",56250,66844,10594
"18419","ENSACAG00000029141","GL343261.1",1616999,1732619,115620
"18420","ENSACAG00000029142","2",122671420,122675000,3580
"18421","ENSACAG00000029143","GL343323.1",852103,915955,63852
"18422","ENSACAG00000029145","GL343195.1",6738068,6739091,1023
"18423","ENSACAG00000029146","GL345041.1",3759,4903,1144
"18424","ENSACAG00000029147","AAWZ02038004",1184,2226,1042
"18425","ENSACAG00000029148","6",56621672,56639145,17473
"18426","ENSACAG00000029150","4",53154551,53163903,9352
"18427","ENSACAG00000029151","GL343831.1",161962,191137,29175
"18428","ENSACAG00000029153","1",223130280,223144100,13820
"18429","ENSACAG00000029154","GL343557.1",156107,169664,13557
"18430","ENSACAG00000029155","GL343295.1",60779,70851,10072
"18431","ENSACAG00000029156","GL343411.1",13209,22642,9433
"18432","ENSACAG00000029157","5",57299453,57302439,2986
"18433","ENSACAG00000029158","GL343393.1",166683,169191,2508
"18434","ENSACAG00000029159","GL343311.1",763485,775454,11969
"18435","ENSACAG00000029160","GL343442.1",174701,240678,65977
"18436","ENSACAG00000029161","GL343261.1",1578723,1588571,9848
"18437","ENSACAG00000029162","GL343312.1",232839,242822,9983
"18438","ENSACAG00000029163","AAWZ02038999",7326,9791,2465
"18439","ENSACAG00000029164","GL343323.1",1329784,1333636,3852
"18440","ENSACAG00000029165","GL343235.1",295317,310525,15208
"18441","ENSACAG00000029166","1",91056793,91060850,4057
"18442","ENSACAG00000029168","1",75964958,76010698,45740
"18443","ENSACAG00000029169","1",160337528,160344826,7298
"18444","ENSACAG00000029172","1",45190991,45263121,72130
"18445","ENSACAG00000029173","4",81029256,81033156,3900
"18446","ENSACAG00000029174","GL343488.1",539056,555537,16481
"18447","ENSACAG00000029176","3",189681857,189687508,5651
"18448","ENSACAG00000029177","GL343470.1",415895,420038,4143
"18449","ENSACAG00000029178","GL343282.1",576020,576647,627
"18450","ENSACAG00000029180","2",49901241,49905665,4424
"18451","ENSACAG00000029181","1",85450892,85460392,9500
"18452","ENSACAG00000029182","4",25014429,25051064,36635
"18453","ENSACAG00000029184","6",62094334,62111444,17110
"18454","ENSACAG00000029185","AAWZ02036615",5150,6289,1139
"18455","ENSACAG00000029186","GL343868.1",14614,15954,1340
"18456","ENSACAG00000029188","GL344882.1",1643,15461,13818
"18457","ENSACAG00000029190","GL343804.1",85385,97350,11965
"18458","ENSACAG00000029191","3",163860431,163861869,1438
"18459","ENSACAG00000029192","4",82992154,83031092,38938
"18460","ENSACAG00000029193","2",192290895,192297376,6481
"18461","ENSACAG00000029194","GL343300.1",1228492,1310835,82343
"18462","ENSACAG00000029195","GL343274.1",926154,1115378,189224
"18463","ENSACAG00000029197","5",128178444,128179523,1079
"18464","ENSACAG00000029199","3",158699305,158700309,1004
"18465","ENSACAG00000029200","GL344849.1",12277,18140,5863
"18466","ENSACAG00000029201","GL343480.1",669116,670240,1124
"18467","ENSACAG00000029202","GL343821.1",30908,31933,1025
"18468","ENSACAG00000029203","1",225916332,225943762,27430
"18469","ENSACAG00000029204","6",56223437,56258608,35171
"18470","ENSACAG00000029205","GL343222.1",2571795,2577768,5973
"18471","ENSACAG00000029206","2",108988880,108991392,2512
"18472","ENSACAG00000029208","2",188869979,188881528,11549
"18473","ENSACAG00000029209","2",52011855,52058728,46873
"18474","ENSACAG00000029210","GL343233.1",1190316,1191791,1475
"18475","ENSACAG00000029211","GL343204.1",558757,580439,21682
"18476","ENSACAG00000029212","GL343196.1",456336,498117,41781
"18477","ENSACAG00000029213","5",33232291,33343024,110733
"18478","ENSACAG00000029215","GL344229.1",25216,32904,7688
"18479","ENSACAG00000029216","GL343351.1",371331,372362,1031
"18480","ENSACAG00000029217","3",86240670,86339102,98432
"18481","ENSACAG00000029218","GL343559.1",297523,304536,7013
"18482","ENSACAG00000029219","AAWZ02038223",532,12073,11541
"18483","ENSACAG00000029220","LGf",177744,188266,10522
"18484","ENSACAG00000029222","GL344315.1",22218,23834,1616
"18485","ENSACAG00000029224","GL343568.1",25218,33870,8652
"18486","ENSACAG00000029225","GL343282.1",564790,565724,934
"18487","ENSACAG00000029227","2",17560428,17690683,130255
"18488","ENSACAG00000029229","GL343733.1",245386,246399,1013
"18489","ENSACAG00000029230","GL343253.1",263332,282200,18868
"18490","ENSACAG00000029231","GL343194.1",7053108,7054361,1253
"18491","ENSACAG00000029233","GL343355.1",616521,651919,35398
"18492","ENSACAG00000029234","GL343498.1",470296,471620,1324
"18493","ENSACAG00000029235","GL343233.1",1844033,1894030,49997
"18494","ENSACAG00000029236","GL343291.1",382786,383982,1196
"18495","ENSACAG00000029238","2",195969254,195977140,7886
"18496","ENSACAG00000029239","AAWZ02037650",23,1162,1139
"18497","ENSACAG00000029240","LGb",2729155,2749456,20301
"18498","ENSACAG00000029241","3",118475851,118477236,1385
"18499","ENSACAG00000029242","2",198984454,199001863,17409
"18500","ENSACAG00000029243","GL343575.1",289224,296527,7303
"18501","ENSACAG00000029244","3",196984480,196986919,2439
"18502","ENSACAG00000029246","3",169556022,169641506,85484
"18503","ENSACAG00000029247","GL343466.1",631652,633772,2120
"18504","ENSACAG00000029248","4",6617669,6625707,8038
"18505","ENSACAG00000029249","GL343590.1",78868,97573,18705
"18506","ENSACAG00000029251","GL343606.1",125004,126146,1142
"18507","ENSACAG00000029252","5",64028584,64041088,12504
"18508","ENSACAG00000029255","GL344211.1",47629,48666,1037
"18509","ENSACAG00000029256","GL343721.1",165414,184793,19379
"18510","ENSACAG00000029257","1",78869602,78919632,50030
"18511","ENSACAG00000029258","1",140330476,140382581,52105
"18512","ENSACAG00000029259","GL343234.1",903355,961385,58030
"18513","ENSACAG00000029260","GL343620.1",57304,84086,26782
"18514","ENSACAG00000029261","6",44724749,44753500,28751
"18515","ENSACAG00000029263","GL343713.1",199537,214231,14694
"18516","ENSACAG00000029264","GL344586.1",10423,11868,1445
"18517","ENSACAG00000029266","GL343206.1",3229107,3230414,1307
"18518","ENSACAG00000029267","6",20424711,20447395,22684
"18519","ENSACAG00000029268","GL343382.1",259358,268979,9621
"18520","ENSACAG00000029269","GL343479.1",58955,91743,32788
"18521","ENSACAG00000029270","GL343511.1",8025,9155,1130
"18522","ENSACAG00000029272","GL344316.1",138,1355,1217
"18523","ENSACAG00000029273","1",213280869,213298218,17349
"18524","ENSACAG00000029274","1",219649795,219660250,10455
"18525","ENSACAG00000029275","GL343673.1",245624,274482,28858
"18526","ENSACAG00000029276","2",196949722,196956403,6681
"18527","ENSACAG00000029277","4",38722257,38729785,7528
"18528","ENSACAG00000029278","GL343231.1",1857159,2026669,169510
"18529","ENSACAG00000029279","AAWZ02041423",865,3168,2303
"18530","ENSACAG00000029280","2",28599765,28608279,8514
"18531","ENSACAG00000029281","GL343301.1",1527607,1562337,34730
"18532","ENSACAG00000029282","GL343413.1",483330,490764,7434
"18533","ENSACAG00000029285","AAWZ02039070",33,7897,7864
"18534","ENSACAG00000029286","GL344382.1",15885,21562,5677
"18535","ENSACAG00000029287","GL344000.1",71373,72376,1003
"18536","ENSACAG00000029289","GL343210.1",3227354,3256326,28972
"18537","ENSACAG00000029290","GL343557.1",299576,313399,13823
"18538","ENSACAG00000029291","4",92794300,92973833,179533
"18539","ENSACAG00000029292","1",190300959,190318881,17922
"18540","ENSACAG00000029293","3",12476577,12491159,14582
"18541","ENSACAG00000029294","2",121671426,121688208,16782
"18542","ENSACAG00000029295","AAWZ02038952",8018,9894,1876
"18543","ENSACAG00000029296","GL343772.1",208588,215468,6880
"18544","ENSACAG00000029297","GL343235.1",1985754,1989845,4091
"18545","ENSACAG00000029299","AAWZ02035537",29087,30277,1190
"18546","ENSACAG00000029300","GL343646.1",77491,78547,1056
"18547","ENSACAG00000029301","AAWZ02039650",909,2537,1628
"18548","ENSACAG00000029302","4",18714459,18723538,9079
"18549","ENSACAG00000029303","GL343285.1",1218326,1225062,6736
"18550","ENSACAG00000029304","5",136533713,136552074,18361
"18551","ENSACAG00000029305","GL343506.1",139685,158191,18506
"18552","ENSACAG00000029307","GL343495.1",537418,550276,12858
"18553","ENSACAG00000029308","6",70518981,70553001,34020
"18554","ENSACAG00000029309","5",3468578,3481800,13222
"18555","ENSACAG00000029310","2",108004659,108225369,220710
"18556","ENSACAG00000029311","GL343733.1",168385,169533,1148
"18557","ENSACAG00000029312","GL343338.1",256131,263812,7681
"18558","ENSACAG00000029313","5",83430753,83469666,38913
"18559","ENSACAG00000029314","AAWZ02037537",2664,14964,12300
"18560","ENSACAG00000029315","AAWZ02041890",3858,4937,1079
"18561","ENSACAG00000029316","GL343412.1",96419,126111,29692
"18562","ENSACAG00000029317","GL343355.1",184367,187862,3495
"18563","ENSACAG00000029318","3",106798427,106811352,12925
"18564","ENSACAG00000029319","5",112874928,112900623,25695
"18565","ENSACAG00000029320","5",27600388,27623484,23096
"18566","ENSACAG00000029322","GL345088.1",2242,3471,1229
"18567","ENSACAG00000029323","GL343491.1",380065,380833,768
"18568","ENSACAG00000029324","GL343652.1",64224,65297,1073
"18569","ENSACAG00000029326","1",147162720,147185523,22803
"18570","ENSACAG00000029327","3",163364802,163389284,24482
"18571","ENSACAG00000029328","1",108079424,108111805,32381
"18572","ENSACAG00000029329","GL343323.1",1395745,1410515,14770
"18573","ENSACAG00000029330","GL343312.1",1126460,1144412,17952
"18574","ENSACAG00000029331","GL344033.1",74599,90514,15915
"18575","ENSACAG00000029332","GL344766.1",11420,21079,9659
"18576","ENSACAG00000029334","1",94184601,94208157,23556
"18577","ENSACAG00000029335","AAWZ02038780",5142,6882,1740
"18578","ENSACAG00000029336","GL343482.1",40410,41428,1018
"18579","ENSACAG00000029337","GL343772.1",100575,153206,52631
"18580","ENSACAG00000029338","GL343263.1",76779,77797,1018
"18581","ENSACAG00000029339","AAWZ02037822",30,1589,1559
"18582","ENSACAG00000029340","5",40285678,40293871,8193
"18583","ENSACAG00000029341","1",129935359,129992444,57085
"18584","ENSACAG00000029342","4",99218256,99301970,83714
"18585","ENSACAG00000029343","GL343966.1",10142,11470,1328
"18586","ENSACAG00000029344","5",89636180,89638327,2147
"18587","ENSACAG00000029345","5",42941954,42982430,40476
"18588","ENSACAG00000029346","AAWZ02041733",4217,5254,1037
"18589","ENSACAG00000029347","1",76859950,76861361,1411
"18590","ENSACAG00000029348","3",3920676,4615558,694882
"18591","ENSACAG00000029349","2",108814374,108824523,10149
"18592","ENSACAG00000029350","AAWZ02039791",2915,4169,1254
"18593","ENSACAG00000029352","GL343672.1",167670,169889,2219
"18594","ENSACAG00000029353","4",112282613,112313665,31052
"18595","ENSACAG00000029354","AAWZ02035806",14577,16670,2093
"18596","ENSACAG00000029355","1",252498412,252600451,102039
"18597","ENSACAG00000029356","2",71782318,71798885,16567
"18598","ENSACAG00000029358","GL343590.1",106492,132950,26458
"18599","ENSACAG00000029359","GL343239.1",1101184,1119468,18284
"18600","ENSACAG00000029360","LGb",2031204,2036258,5054
"18601","ENSACAG00000029361","3",104872912,104874390,1478
"18602","ENSACAG00000029362","3",187508920,187531731,22811
"18603","ENSACAG00000029363","1",197315564,197326799,11235
"18604","ENSACAG00000029365","AAWZ02041047",1428,2463,1035
"18605","ENSACAG00000029367","2",103314668,103317011,2343
"18606","ENSACAG00000029368","GL343502.1",592992,594341,1349
"18607","ENSACAG00000029369","1",236880191,236886874,6683
"18608","ENSACAG00000029370","GL343261.1",244481,247764,3283
"18609","ENSACAG00000029372","2",124752532,124774948,22416
"18610","ENSACAG00000029373","GL343237.1",971617,973001,1384
"18611","ENSACAG00000029374","2",188836168,188844266,8098
"18612","ENSACAG00000029375","GL343822.1",82933,84273,1340
"18613","ENSACAG00000029376","3",106740876,106755992,15116
"18614","ENSACAG00000029377","2",95106342,95120906,14564
"18615","ENSACAG00000029378","GL343318.1",524497,527004,2507
"18616","ENSACAG00000029379","GL343322.1",270626,294548,23922
"18617","ENSACAG00000029381","GL344689.1",16096,17643,1547
"18618","ENSACAG00000029382","GL344396.1",6550,7599,1049
"18619","ENSACAG00000029383","GL343216.1",1869471,1870811,1340
"18620","ENSACAG00000029384","GL343504.1",288082,319462,31380
"18621","ENSACAG00000029385","GL343514.1",186164,197024,10860
"18622","ENSACAG00000029386","GL343888.1",91779,107187,15408
"18623","ENSACAG00000029387","GL343341.1",226499,227748,1249
"18624","ENSACAG00000029388","GL343331.1",1067506,1068830,1324
"18625","ENSACAG00000029389","GL343323.1",1208975,1222779,13804
"18626","ENSACAG00000029390","GL344089.1",17011,28757,11746
"18627","ENSACAG00000029391","6",60320563,60341068,20505
"18628","ENSACAG00000029392","1",211539280,211540581,1301
"18629","ENSACAG00000029393","1",77772961,77824364,51403
"18630","ENSACAG00000029395","5",144409891,144427831,17940
"18631","ENSACAG00000029396","GL343748.1",107703,109025,1322
"18632","ENSACAG00000029397","2",108968258,108972339,4081
"18633","ENSACAG00000029398","GL343312.1",248428,266755,18327
"18634","ENSACAG00000029399","2",131283655,131286851,3196
"18635","ENSACAG00000029402","GL343967.1",43864,51679,7815
"18636","ENSACAG00000029403","GL344220.1",15947,17069,1122
"18637","ENSACAG00000029404","5",19963877,19967585,3708
"18638","ENSACAG00000029405","5",46218121,46294378,76257
"18639","ENSACAG00000029406","GL343231.1",1110556,1111668,1112
"18640","ENSACAG00000029407","GL343253.1",1393091,1400244,7153
"18641","ENSACAG00000029408","GL344217.1",2839,17258,14419
"18642","ENSACAG00000029409","GL343273.1",1822476,1843352,20876
"18643","ENSACAG00000029410","GL343412.1",67296,87505,20209
"18644","ENSACAG00000029411","3",72306357,72307491,1134
"18645","ENSACAG00000029413","GL343194.1",968533,969668,1135
"18646","ENSACAG00000029414","GL343829.1",53286,54431,1145
"18647","ENSACAG00000029415","2",198542039,198550677,8638
"18648","ENSACAG00000029416","4",35817916,35818969,1053
"18649","ENSACAG00000029417","3",138402292,138403302,1010
"18650","ENSACAG00000029418","2",11046844,11075504,28660
"18651","ENSACAG00000029419","2",92209161,92220422,11261
"18652","ENSACAG00000029421","1",159502738,159503973,1235
"18653","ENSACAG00000029422","1",41682324,41690943,8619
"18654","ENSACAG00000029423","3",109361766,109365599,3833
"18655","ENSACAG00000029424","GL343484.1",165510,317497,151987
"18656","ENSACAG00000029425","GL343418.1",650240,673477,23237
"18657","ENSACAG00000029426","GL343312.1",1436764,1464627,27863
"18658","ENSACAG00000029427","3",40291565,40326315,34750
"18659","ENSACAG00000029428","GL343282.1",515516,516496,980
"18660","ENSACAG00000029431","AAWZ02036809",3687,5492,1805
"18661","ENSACAG00000029432","GL343245.1",751097,752230,1133
"18662","ENSACAG00000029433","2",95246985,95275456,28471
"18663","ENSACAG00000029434","4",90516021,90530295,14274
"18664","ENSACAG00000029435","GL343193.1",1248811,1292627,43816
"18665","ENSACAG00000029436","GL343434.1",655226,665072,9846
"18666","ENSACAG00000029437","GL343300.1",1576058,1579327,3269
"18667","ENSACAG00000029439","3",53682394,53691492,9098
"18668","ENSACAG00000029442","2",46884073,46910292,26219
"18669","ENSACAG00000029443","1",6468897,6485406,16509
"18670","ENSACAG00000029444","2",68195424,68228369,32945
"18671","ENSACAG00000029445","AAWZ02037939",11955,13848,1893
"18672","ENSACAG00000029446","GL343623.1",221141,223177,2036
"18673","ENSACAG00000029447","GL343276.1",373278,378715,5437
"18674","ENSACAG00000029449","GL343977.1",49798,61473,11675
"18675","ENSACAG00000029450","GL343286.1",81808,136389,54581
"18676","ENSACAG00000029451","GL343261.1",1886624,1896458,9834
"18677","ENSACAG00000029452","GL343299.1",1590585,1616101,25516
"18678","ENSACAG00000029453","GL343532.1",502415,514951,12536
"18679","ENSACAG00000029454","5",310899,312395,1496
"18680","ENSACAG00000029455","5",17535326,17555974,20648
"18681","ENSACAG00000029456","GL344232.1",1654,20040,18386
"18682","ENSACAG00000029457","GL343312.1",112043,119099,7056
"18683","ENSACAG00000029458","GL343220.1",377057,394368,17311
"18684","ENSACAG00000029459","3",35153312,35184148,30836
"18685","ENSACAG00000029460","GL343520.1",77909,79198,1289
"18686","ENSACAG00000029461","2",122135042,122157704,22662
"18687","ENSACAG00000029465","2",193568451,193586755,18304
"18688","ENSACAG00000029466","GL343272.1",1173017,1179037,6020
"18689","ENSACAG00000029467","GL343491.1",63081,63878,797
"18690","ENSACAG00000029468","4",95424213,95427727,3514
"18691","ENSACAG00000029469","GL343516.1",51323,63683,12360
"18692","ENSACAG00000029470","GL343264.1",1179683,1238160,58477
"18693","ENSACAG00000029471","3",137770160,137780950,10790
"18694","ENSACAG00000029472","GL343279.1",624270,625394,1124
"18695","ENSACAG00000029473","GL343647.1",95031,143369,48338
"18696","ENSACAG00000029474","GL343272.1",1207433,1208488,1055
"18697","ENSACAG00000029475","GL343680.1",139568,166397,26829
"18698","ENSACAG00000029476","GL343713.1",14640,20085,5445
"18699","ENSACAG00000029477","6",62450083,62459577,9494
"18700","ENSACAG00000029478","GL343211.1",436310,467748,31438
"18701","ENSACAG00000029479","1",227632289,227656994,24705
"18702","ENSACAG00000029480","GL345012.1",44,14019,13975
"18703","ENSACAG00000029481","GL343438.1",36705,51514,14809
"18704","ENSACAG00000029482","1",183618155,183714721,96566
"18705","ENSACAG00000029483","5",9527995,9578971,50976
"18706","ENSACAG00000029484","6",79664031,79685740,21709
"18707","ENSACAG00000029485","1",68564543,68579973,15430
"18708","ENSACAG00000029486","GL343690.1",165842,176797,10955
"18709","ENSACAG00000029487","2",189504198,189505640,1442
"18710","ENSACAG00000029488","LGf",298867,310520,11653
"18711","ENSACAG00000029489","GL343331.1",1243684,1244822,1138
"18712","ENSACAG00000029490","2",120867017,120874608,7591
"18713","ENSACAG00000029491","GL343312.1",1234201,1246045,11844
"18714","ENSACAG00000029493","4",111798514,111819644,21130
"18715","ENSACAG00000029495","GL343766.1",124195,170124,45929
"18716","ENSACAG00000029497","GL343204.1",2689559,2691384,1825
"18717","ENSACAG00000029498","2",76226540,76237253,10713
"18718","ENSACAG00000029499","AAWZ02041730",2343,5297,2954
"18719","ENSACAG00000029500","GL343691.1",137983,139332,1349
"18720","ENSACAG00000029501","GL343303.1",487435,488696,1261
"18721","ENSACAG00000029502","5",85296743,85299749,3006
"18722","ENSACAG00000029503","1",186144877,186162220,17343
"18723","ENSACAG00000029505","4",118038038,118039858,1820
"18724","ENSACAG00000029506","5",15443133,15487244,44111
"18725","ENSACAG00000029507","4",123731112,123758051,26939
"18726","ENSACAG00000029510","LGf",204714,216222,11508
"18727","ENSACAG00000029511","1",78416698,78417924,1226
"18728","ENSACAG00000029512","GL344018.1",128067,146402,18335
"18729","ENSACAG00000029514","GL343239.1",553613,554932,1319
"18730","ENSACAG00000029515","1",140265979,140300679,34700
"18731","ENSACAG00000029516","GL343520.1",487392,518340,30948
"18732","ENSACAG00000029517","GL343491.1",207709,208808,1099
"18733","ENSACAG00000029518","GL343555.1",424199,447081,22882
"18734","ENSACAG00000029519","2",47585839,47587186,1347
"18735","ENSACAG00000029520","5",13264573,13266104,1531
"18736","ENSACAG00000029521","AAWZ02035520",26066,27091,1025
"18737","ENSACAG00000029522","GL343289.1",1029961,1033436,3475
"18738","ENSACAG00000029523","GL343787.1",293183,294628,1445
"18739","ENSACAG00000029524","GL343312.1",661133,662782,1649
"18740","ENSACAG00000029525","GL343521.1",360546,377727,17181
"18741","ENSACAG00000029526","GL343575.1",98974,105544,6570
"18742","ENSACAG00000029527","GL345069.1",60,1465,1405
"18743","ENSACAG00000029528","GL343392.1",251737,252801,1064
"18744","ENSACAG00000029530","GL343355.1",188533,198882,10349
"18745","ENSACAG00000029531","GL343913.1",36000,37421,1421
"18746","ENSACAG00000029532","2",158925512,158932956,7444
"18747","ENSACAG00000029533","GL343438.1",821186,822743,1557
"18748","ENSACAG00000029535","4",143245130,143250048,4918
"18749","ENSACAG00000029538","GL343400.1",684955,695029,10074
"18750","ENSACAG00000029539","GL344187.1",13759,15036,1277
"18751","ENSACAG00000029540","1",61371743,61387513,15770
"18752","ENSACAG00000029541","GL343495.1",497743,506142,8399
"18753","ENSACAG00000029542","2",93186011,93195185,9174
"18754","ENSACAG00000029543","AAWZ02040095",4620,6076,1456
"18755","ENSACAG00000029544","GL343770.1",2768,4933,2165
"18756","ENSACAG00000029545","3",6787380,6819699,32319
"18757","ENSACAG00000029546","GL343250.1",2039043,2171545,132502
"18758","ENSACAG00000029547","2",190172720,190199039,26319
"18759","ENSACAG00000029548","4",128380134,128544064,163930
"18760","ENSACAG00000029549","1",139504011,139529373,25362
"18761","ENSACAG00000029550","GL343406.1",539534,540931,1397
"18762","ENSACAG00000029551","GL343741.1",168383,169577,1194
"18763","ENSACAG00000029553","GL344152.1",39381,40510,1129
"18764","ENSACAG00000029554","GL343719.1",190095,194059,3964
"18765","ENSACAG00000029555","AAWZ02039269",808,2038,1230
"18766","ENSACAG00000029556","2",101674691,101685977,11286
"18767","ENSACAG00000029557","GL343276.1",337216,339371,2155
"18768","ENSACAG00000029558","1",193613576,193646122,32546
"18769","ENSACAG00000029559","GL343323.1",1263142,1274870,11728
"18770","ENSACAG00000029560","4",29147895,29395161,247266
"18771","ENSACAG00000029563","GL343257.1",1953142,1980877,27735
"18772","ENSACAG00000029564","GL343734.1",194097,204031,9934
"18773","ENSACAG00000029565","GL343279.1",453674,465026,11352
"18774","ENSACAG00000029566","2",76020323,76075194,54871
"18775","ENSACAG00000029567","GL343312.1",253978,255312,1334
"18776","ENSACAG00000029568","1",227837887,227905304,67417
"18777","ENSACAG00000029569","GL343261.1",1950950,1952158,1208
"18778","ENSACAG00000029570","GL343352.1",276952,280952,4000
"18779","ENSACAG00000029571","AAWZ02040288",21,1635,1614
"18780","ENSACAG00000029573","4",138293009,138294088,1079
"18781","ENSACAG00000029574","GL343322.1",1047504,1060997,13493
"18782","ENSACAG00000029575","6",60553158,60564677,11519
"18783","ENSACAG00000029576","2",192438891,192450501,11610
"18784","ENSACAG00000029577","GL343647.1",363763,368985,5222
"18785","ENSACAG00000029578","2",195045241,195055469,10228
"18786","ENSACAG00000029579","GL343194.1",9624918,9651943,27025
"18787","ENSACAG00000029581","GL343438.1",742746,770961,28215
"18788","ENSACAG00000029582","2",160028094,160043517,15423
"18789","ENSACAG00000029583","4",102784985,102786039,1054
"18790","ENSACAG00000029584","GL343832.1",63411,79086,15675
"18791","ENSACAG00000029585","5",40304194,40335427,31233
"18792","ENSACAG00000029586","GL343532.1",62000,63516,1516
"18793","ENSACAG00000029589","2",197513169,197522194,9025
"18794","ENSACAG00000029590","GL343252.1",327711,344621,16910
"18795","ENSACAG00000029591","4",93976767,94008478,31711
"18796","ENSACAG00000029593","LGf",1166298,1183768,17470
"18797","ENSACAG00000029595","2",182485772,182654190,168418
"18798","ENSACAG00000029596","1",30473797,30804384,330587
"18799","ENSACAG00000029597","5",147048073,147073721,25648
"18800","ENSACAG00000029598","AAWZ02040473",3662,6891,3229
"18801","ENSACAG00000029599","GL343723.1",219135,220613,1478
"18802","ENSACAG00000029600","2",5524848,5525959,1111
"18803","ENSACAG00000029601","3",175924347,175944837,20490
"18804","ENSACAG00000029603","GL343207.1",2778247,2962714,184467
"18805","ENSACAG00000029605","6",59813201,59814336,1135
"18806","ENSACAG00000029606","AAWZ02039297",2807,4258,1451
"18807","ENSACAG00000029607","4",117829373,117839872,10499
"18808","ENSACAG00000029608","GL343441.1",45151,46300,1149
"18809","ENSACAG00000029609","GL343244.1",396241,410463,14222
"18810","ENSACAG00000029610","GL343245.1",40745,50349,9604
"18811","ENSACAG00000029611","AAWZ02041386",28,2544,2516
"18812","ENSACAG00000029612","GL343255.1",1120611,1642275,521664
"18813","ENSACAG00000029613","GL343565.1",117483,118642,1159
"18814","ENSACAG00000029614","GL343682.1",292265,300853,8588
"18815","ENSACAG00000029615","GL343483.1",128101,151055,22954
"18816","ENSACAG00000029616","5",70684043,70986343,302300
"18817","ENSACAG00000029617","GL343491.1",185055,185764,709
"18818","ENSACAG00000029619","2",140280142,140287099,6957
"18819","ENSACAG00000029620","GL343419.1",182035,288042,106007
"18820","ENSACAG00000029621","1",235593599,235636917,43318
"18821","ENSACAG00000029622","6",20378675,20385610,6935
"18822","ENSACAG00000029623","5",139795553,139807264,11711
"18823","ENSACAG00000029624","3",133774669,133776496,1827
"18824","ENSACAG00000029625","1",205832723,205877236,44513
"18825","ENSACAG00000029626","GL343948.1",14219,23082,8863
"18826","ENSACAG00000029627","6",45296483,45306958,10475
"18827","ENSACAG00000029628","6",70702069,70711380,9311
"18828","ENSACAG00000029629","AAWZ02038878",6205,7336,1131
"18829","ENSACAG00000029630","GL343636.1",298710,299912,1202
"18830","ENSACAG00000029631","GL343437.1",718198,740996,22798
"18831","ENSACAG00000029632","GL343202.1",109237,127748,18511
"18832","ENSACAG00000029633","6",23493962,23520571,26609
"18833","ENSACAG00000029634","GL343194.1",9660184,9672217,12033
"18834","ENSACAG00000029637","6",58670244,58688082,17838
"18835","ENSACAG00000029638","GL343502.1",389387,567782,178395
"18836","ENSACAG00000029639","4",16499701,16506912,7211
"18837","ENSACAG00000029640","AAWZ02038009",11216,12663,1447
"18838","ENSACAG00000029641","GL343209.1",647252,648274,1022
"18839","ENSACAG00000029642","3",120843355,120868894,25539
"18840","ENSACAG00000029643","2",195197906,195212287,14381
"18841","ENSACAG00000029644","AAWZ02039234",3244,9102,5858
"18842","ENSACAG00000029645","GL343779.1",96597,106422,9825
"18843","ENSACAG00000029646","GL343909.1",20342,24100,3758
"18844","ENSACAG00000029647","LGc",2123680,2133028,9348
"18845","ENSACAG00000029648","AAWZ02038974",4782,6060,1278
"18846","ENSACAG00000029649","GL344469.1",33246,34610,1364
"18847","ENSACAG00000029650","GL343907.1",105047,106375,1328
"18848","ENSACAG00000029651","1",43165521,43247418,81897
"18849","ENSACAG00000029652","3",30802412,30816411,13999
"18850","ENSACAG00000029653","GL343539.1",355302,357438,2136
"18851","ENSACAG00000029657","2",144038641,144041154,2513
"18852","ENSACAG00000029658","GL343658.1",50541,51956,1415
"18853","ENSACAG00000029660","3",37995013,38001943,6930
"18854","ENSACAG00000029661","GL343276.1",469605,474646,5041
"18855","ENSACAG00000029662","6",25941274,25942281,1007
"18856","ENSACAG00000029663","AAWZ02038343",10669,11964,1295
"18857","ENSACAG00000029664","GL343915.1",26482,27552,1070
"18858","ENSACAG00000029665","GL343466.1",599983,602325,2342
"18859","ENSACAG00000029666","5",64139240,64167488,28248
"18860","ENSACAG00000029668","GL343733.1",87376,90942,3566
"18861","ENSACAG00000029669","2",135243664,135249028,5364
"18862","ENSACAG00000029670","1",98104180,98139176,34996
"18863","ENSACAG00000029671","GL344144.1",2291,3892,1601
"18864","ENSACAG00000029672","GL343320.1",1319584,1334806,15222
"18865","ENSACAG00000029673","GL343238.1",1087736,1089280,1544
"18866","ENSACAG00000029674","GL344879.1",2973,13642,10669
"18867","ENSACAG00000029675","2",197320289,197332571,12282
"18868","ENSACAG00000029676","GL343335.1",390051,393126,3075
"18869","ENSACAG00000029677","GL343421.1",94663,390183,295520
"18870","ENSACAG00000029678","2",192451352,192460719,9367
"18871","ENSACAG00000029679","GL343337.1",151618,154510,2892
"18872","ENSACAG00000029680","1",238401564,238492373,90809
"18873","ENSACAG00000029681","5",148576246,148579152,2906
"18874","ENSACAG00000029682","GL343626.1",340249,341643,1394
"18875","ENSACAG00000029683","2",195012488,195033127,20639
"18876","ENSACAG00000029684","2",95401721,95413964,12243
"18877","ENSACAG00000029685","2",189015181,189030499,15318
"18878","ENSACAG00000029686","AAWZ02039317",7063,8665,1602
"18879","ENSACAG00000029687","GL343580.1",38625,47827,9202
"18880","ENSACAG00000029688","3",34282799,34312952,30153
"18881","ENSACAG00000029689","2",95034337,95043016,8679
"18882","ENSACAG00000029691","2",102944753,102953351,8598
"18883","ENSACAG00000029692","GL343306.1",1337814,1346639,8825
"18884","ENSACAG00000029694","GL343194.1",9459665,9480652,20987
"18885","ENSACAG00000029695","GL343945.1",108972,121566,12594
"18886","ENSACAG00000029696","6",58602730,58619079,16349
"18887","ENSACAG00000029697","GL344113.1",15819,18371,2552
