"","ensembl_gene_id","chromosome_name","start_position","end_position","length"
"1","ENSBTAG00000000005","17",65389743,65505336,115593
"2","ENSBTAG00000000008","29",32214439,32244810,30371
"3","ENSBTAG00000000009","18",12338037,12342272,4235
"4","ENSBTAG00000000010","21",34209956,34223394,13438
"5","ENSBTAG00000000011","8",7950815,7971600,20785
"6","ENSBTAG00000000012","20",33708626,33732944,24318
"7","ENSBTAG00000000013","20",33674806,33703223,28417
"8","ENSBTAG00000000014","5",74883636,74893752,10116
"9","ENSBTAG00000000015","5",74905031,74919112,14081
"10","ENSBTAG00000000016","23",27720176,27721739,1563
"11","ENSBTAG00000000019","9",28722620,28756268,33648
"12","ENSBTAG00000000020","19",24239065,24273712,34647
"13","ENSBTAG00000000021","5",65820520,65886932,66412
"14","ENSBTAG00000000022","5",65900759,65952780,52021
"15","ENSBTAG00000000023","16",66079548,66123232,43684
"16","ENSBTAG00000000024","24",48722549,49123072,400523
"17","ENSBTAG00000000025","15",53150637,53241816,91179
"18","ENSBTAG00000000026","21",21647398,21672875,25477
"19","ENSBTAG00000000027","18",53529692,53531044,1352
"20","ENSBTAG00000000029","19",45222278,45251778,29500
"21","ENSBTAG00000000030","19",45209905,45220950,11045
"22","ENSBTAG00000000031","17",63410753,63447169,36416
"23","ENSBTAG00000000032","19",37351934,37361182,9248
"24","ENSBTAG00000000033","19",37344874,37351524,6650
"25","ENSBTAG00000000037","20",14466137,14726313,260176
"26","ENSBTAG00000000039","19",50976407,50982602,6195
"27","ENSBTAG00000000040","19",50967339,50972885,5546
"28","ENSBTAG00000000042","19",50957969,50962684,4715
"29","ENSBTAG00000000044","19",50953006,50956142,3136
"30","ENSBTAG00000000046","11",104263216,104266858,3642
"31","ENSBTAG00000000049","5",107294769,107321571,26802
"32","ENSBTAG00000000050","25",41386821,41387986,1165
"33","ENSBTAG00000000052","29",28809868,28892935,83067
"34","ENSBTAG00000000053","9",14918898,15136983,218085
"35","ENSBTAG00000000054","11",103832673,103855230,22557
"36","ENSBTAG00000000056","19",47979733,48007680,27947
"37","ENSBTAG00000000057","3",15414611,15425793,11182
"38","ENSBTAG00000000060","14",33786654,33805075,18421
"39","ENSBTAG00000000061","6",49958089,50426482,468393
"40","ENSBTAG00000000062","10",11993897,12010945,17048
"41","ENSBTAG00000000064","29",40236821,40241623,4802
"42","ENSBTAG00000000065","13",48186875,48209791,22916
"43","ENSBTAG00000000066","13",48213047,48233309,20262
"44","ENSBTAG00000000067","17",72112056,72114638,2582
"45","ENSBTAG00000000070","16",75944878,75966734,21856
"46","ENSBTAG00000000071","14",44644660,44649977,5317
"47","ENSBTAG00000000072","16",30802001,30820756,18755
"48","ENSBTAG00000000073","6",115369803,115384234,14431
"49","ENSBTAG00000000074","3",84203809,84620790,416981
"50","ENSBTAG00000000076","8",60326356,60410644,84288
"51","ENSBTAG00000000077","5",111674844,111692267,17423
"52","ENSBTAG00000000078","8",60421784,60442493,20709
"53","ENSBTAG00000000079","28",1263858,1279408,15550
"54","ENSBTAG00000000080","18",55124924,55130987,6063
"55","ENSBTAG00000000081","10",6796016,6925123,129107
"56","ENSBTAG00000000082","18",55136577,55140932,4355
"57","ENSBTAG00000000084","20",30060705,30070007,9302
"58","ENSBTAG00000000085","21",33923110,33930074,6964
"59","ENSBTAG00000000087","15",73781285,73958433,177148
"60","ENSBTAG00000000088","1",49930775,50160291,229516
"61","ENSBTAG00000000090","26",21378976,21411785,32809
"62","ENSBTAG00000000091","26",21414963,21420753,5790
"63","ENSBTAG00000000092","26",21422679,21431814,9135
"64","ENSBTAG00000000094","3",99466613,99491947,25334
"65","ENSBTAG00000000095","8",39246075,39263677,17602
"66","ENSBTAG00000000097","3",99421569,99457891,36322
"67","ENSBTAG00000000098","3",19801955,19834258,32303
"68","ENSBTAG00000000099","3",19792564,19804799,12235
"69","ENSBTAG00000000102","11",36562674,36569539,6865
"70","ENSBTAG00000000103","29",49542736,49549261,6525
"71","ENSBTAG00000000105","3",14853319,14862517,9198
"72","ENSBTAG00000000106","24",4042759,4060302,17543
"73","ENSBTAG00000000108","3",14834858,14852135,17277
"74","ENSBTAG00000000109","5",110424099,110445709,21610
"75","ENSBTAG00000000111","11",62288610,62345665,57055
"76","ENSBTAG00000000113","3",14781460,14813371,31911
"77","ENSBTAG00000000115","11",62347545,62449163,101618
"78","ENSBTAG00000000120","19",28895131,28947210,52079
"79","ENSBTAG00000000123","3",23732791,23763956,31165
"80","ENSBTAG00000000124","5",30728408,30733209,4801
"81","ENSBTAG00000000125","17",34422664,34747076,324412
"82","ENSBTAG00000000128","20",3226532,3263206,36674
"83","ENSBTAG00000000130","19",27292078,27294941,2863
"84","ENSBTAG00000000131","19",27296635,27304659,8024
"85","ENSBTAG00000000132","19",27305005,27311552,6547
"86","ENSBTAG00000000133","19",27312058,27314128,2070
"87","ENSBTAG00000000134","19",27315837,27319239,3402
"88","ENSBTAG00000000137","6",67179392,67325259,145867
"89","ENSBTAG00000000139","17",52211310,52228130,16820
"90","ENSBTAG00000000140","16",28833307,28874202,40895
"91","ENSBTAG00000000141","11",67778940,67807964,29024
"92","ENSBTAG00000000144","4",82533901,82573389,39488
"93","ENSBTAG00000000145","8",94282767,94283720,953
"94","ENSBTAG00000000146","12",75180883,75458745,277862
"95","ENSBTAG00000000147","5",70063366,70163866,100500
"96","ENSBTAG00000000149","3",113167613,113257470,89857
"97","ENSBTAG00000000152","11",44646703,44708627,61924
"98","ENSBTAG00000000153","18",46630276,46637137,6861
"99","ENSBTAG00000000154","X",12114840,12117263,2423
"100","ENSBTAG00000000157","11",44615244,44645726,30482
"101","ENSBTAG00000000160","1",143219189,143242441,23252
"102","ENSBTAG00000000161","22",56388054,56420506,32452
"103","ENSBTAG00000000162","28",28287394,28297656,10262
"104","ENSBTAG00000000163","28",28323892,28325899,2007
"105","ENSBTAG00000000164","8",72732208,72736000,3792
"106","ENSBTAG00000000168","11",57045486,57045764,278
"107","ENSBTAG00000000169","4",51002521,51078365,75844
"108","ENSBTAG00000000170","17",71311471,71316105,4634
"109","ENSBTAG00000000172","X",92370954,92471753,100799
"110","ENSBTAG00000000175","6",59106229,59159354,53125
"111","ENSBTAG00000000176","2",22797327,22853605,56278
"112","ENSBTAG00000000177","25",650311,653932,3621
"113","ENSBTAG00000000179","25",666146,669347,3201
"114","ENSBTAG00000000181","8",84444102,84464852,20750
"115","ENSBTAG00000000182","18",48078059,48108357,30298
"116","ENSBTAG00000000184","11",47433953,47515738,81785
"117","ENSBTAG00000000185","X",734360,840270,105910
"118","ENSBTAG00000000186","3",15602874,15609853,6979
"119","ENSBTAG00000000188","9",36081835,36375043,293208
"120","ENSBTAG00000000189","4",45537952,46117403,579451
"121","ENSBTAG00000000191","22",51045061,51080116,35055
"122","ENSBTAG00000000195","18",64632169,64640989,8820
"123","ENSBTAG00000000197","6",25073203,25099775,26572
"124","ENSBTAG00000000198","5",44297841,44302777,4936
"125","ENSBTAG00000000199","14",70358934,70367406,8472
"126","ENSBTAG00000000201","1",7183913,7240822,56909
"127","ENSBTAG00000000202","19",56205866,56217750,11884
"128","ENSBTAG00000000203","8",103783366,103792805,9439
"129","ENSBTAG00000000204","8",103800600,103825493,24893
"130","ENSBTAG00000000205","19",5612909,5642391,29482
"131","ENSBTAG00000000207","X",135627402,135693969,66567
"132","ENSBTAG00000000210","1",64083127,64203306,120179
"133","ENSBTAG00000000211","X",133143241,133282793,139552
"134","ENSBTAG00000000212","16",50937583,50955983,18400
"135","ENSBTAG00000000213","1",64211525,64240562,29037
"136","ENSBTAG00000000214","23",29910286,29911257,971
"137","ENSBTAG00000000215","16",50856300,50933400,77100
"138","ENSBTAG00000000218","10",14382469,14672701,290232
"139","ENSBTAG00000000219","5",95970070,96313866,343796
"140","ENSBTAG00000000220","22",1485764,1600233,114469
"141","ENSBTAG00000000221","28",7903182,7923038,19856
"142","ENSBTAG00000000222","28",7927929,8066468,138539
"143","ENSBTAG00000000223","11",26643590,26670025,26435
"144","ENSBTAG00000000224","28",25803071,25855714,52643
"145","ENSBTAG00000000225","27",37192520,37217387,24867
"146","ENSBTAG00000000226","27",37218555,37221940,3385
"147","ENSBTAG00000000228","23",29527909,29528871,962
"148","ENSBTAG00000000229","3",99242275,99264955,22680
"149","ENSBTAG00000000231","28",41486119,41544234,58115
"150","ENSBTAG00000000232","15",50400981,50401955,974
"151","ENSBTAG00000000233","15",50384953,50385906,953
"152","ENSBTAG00000000236","14",63393855,63427371,33516
"153","ENSBTAG00000000237","5",49017944,49018762,818
"154","ENSBTAG00000000238","7",50988391,51027492,39101
"155","ENSBTAG00000000240","9",69203273,69325807,122534
"156","ENSBTAG00000000241","13",77236072,77278921,42849
"157","ENSBTAG00000000242","1",57798617,57799321,704
"158","ENSBTAG00000000243","9",76190099,76196894,6795
"159","ENSBTAG00000000244","29",42855130,42966249,111119
"160","ENSBTAG00000000245","9",76205680,76463385,257705
"161","ENSBTAG00000000246","29",8891472,9112311,220839
"162","ENSBTAG00000000250","8",102631185,102634313,3128
"163","ENSBTAG00000000251","8",102642378,102652291,9913
"164","ENSBTAG00000000252","8",102655928,102658552,2624
"165","ENSBTAG00000000253","3",102414018,102498351,84333
"166","ENSBTAG00000000256","8",57533899,57625114,91215
"167","ENSBTAG00000000257","9",65275990,65339737,63747
"168","ENSBTAG00000000259","3",32071080,32090853,19773
"169","ENSBTAG00000000260","4",65961977,66053326,91349
"170","ENSBTAG00000000261","11",74934684,74946757,12073
"171","ENSBTAG00000000264","9",33719893,33772478,52585
"172","ENSBTAG00000000265","22",37781491,38082210,300719
"173","ENSBTAG00000000266","2",5634458,5683747,49289
"174","ENSBTAG00000000267","19",23080158,23280691,200533
"175","ENSBTAG00000000269","8",44298705,44344643,45938
"176","ENSBTAG00000000271","10",53893423,53977929,84506
"177","ENSBTAG00000000273","22",23199161,23239003,39842
"178","ENSBTAG00000000274","4",77120960,77129830,8870
"179","ENSBTAG00000000275","5",106112459,106146167,33708
"180","ENSBTAG00000000277","15",22475988,22502331,26343
"181","ENSBTAG00000000278","12",36524815,36562931,38116
"182","ENSBTAG00000000279","25",1679439,1685521,6082
"183","ENSBTAG00000000281","17",4218300,4297890,79590
"184","ENSBTAG00000000283","3",33488957,33509479,20522
"185","ENSBTAG00000000284","29",5097620,5148929,51309
"186","ENSBTAG00000000285","6",63290365,63314983,24618
"187","ENSBTAG00000000286","5",32145678,32189023,43345
"188","ENSBTAG00000000287","6",63317766,63348187,30421
"189","ENSBTAG00000000288","13",12300825,12396503,95678
"190","ENSBTAG00000000289","5",32135753,32144434,8681
"191","ENSBTAG00000000290","1",84108412,84205584,97172
"192","ENSBTAG00000000291","13",12236002,12281753,45751
"193","ENSBTAG00000000292","29",45565564,45577936,12372
"194","ENSBTAG00000000295","11",37932812,37970086,37274
"195","ENSBTAG00000000296","4",92569423,92586808,17385
"196","ENSBTAG00000000297","17",16534317,16553468,19151
"197","ENSBTAG00000000300","X",76421837,76427647,5810
"198","ENSBTAG00000000301","2",110840440,110842320,1880
"199","ENSBTAG00000000305","3",56698600,56715731,17131
"200","ENSBTAG00000000306","7",68871861,68934053,62192
"201","ENSBTAG00000000308","13",63816189,63881729,65540
"202","ENSBTAG00000000309","13",70704649,71533711,829062
"203","ENSBTAG00000000310","5",101190160,101203715,13555
"204","ENSBTAG00000000312","14",826740,830066,3326
"205","ENSBTAG00000000313","28",29189826,29206547,16721
"206","ENSBTAG00000000315","28",29208194,29236888,28694
"207","ENSBTAG00000000317","15",75918764,75938190,19426
"208","ENSBTAG00000000320","8",75580395,75650401,70006
"209","ENSBTAG00000000321","25",33639559,33645465,5906
"210","ENSBTAG00000000322","23",20602899,20689496,86597
"211","ENSBTAG00000000326","5",111159506,111251712,92206
"212","ENSBTAG00000000328","10",26072695,26074864,2169
"213","ENSBTAG00000000329","7",26554784,26762374,207590
"214","ENSBTAG00000000330","18",55910374,55924829,14455
"215","ENSBTAG00000000332","18",51021355,51028977,7622
"216","ENSBTAG00000000333","15",20598185,20812735,214550
"217","ENSBTAG00000000336","18",61158271,61171888,13617
"218","ENSBTAG00000000340","13",78817785,78845570,27785
"219","ENSBTAG00000000341","7",24975144,24993919,18775
"220","ENSBTAG00000000342","25",35480306,35488245,7939
"221","ENSBTAG00000000343","25",35473349,35479721,6372
"222","ENSBTAG00000000344","19",17238257,17247945,9688
"223","ENSBTAG00000000345","25",35463189,35468712,5523
"224","ENSBTAG00000000347","15",51229042,51242505,13463
"225","ENSBTAG00000000354","19",51158511,51160605,2094
"226","ENSBTAG00000000355","19",51154298,51156611,2313
"227","ENSBTAG00000000356","19",51148536,51154185,5649
"228","ENSBTAG00000000357","27",24422980,24471208,48228
"229","ENSBTAG00000000359","10",102954997,102972982,17985
"230","ENSBTAG00000000362","10",102974981,103055496,80515
"231","ENSBTAG00000000363","20",10017703,10086104,68401
"232","ENSBTAG00000000365","23",33082758,33094885,12127
"233","ENSBTAG00000000369","5",94125186,94321587,196401
"234","ENSBTAG00000000371","10",13201806,13234117,32311
"235","ENSBTAG00000000372","10",13235273,13252124,16851
"236","ENSBTAG00000000374","11",58509673,58513714,4041
"237","ENSBTAG00000000375","15",80527398,80537458,10060
"238","ENSBTAG00000000376","15",80539435,80570794,31359
"239","ENSBTAG00000000377","X",127954722,127992190,37468
"240","ENSBTAG00000000379","5",88683333,88697403,14070
"241","ENSBTAG00000000381","7",20652027,20653184,1157
"242","ENSBTAG00000000382","11",101945497,102165314,219817
"243","ENSBTAG00000000385","16",33149470,33155673,6203
"244","ENSBTAG00000000387","22",50688543,50692789,4246
"245","ENSBTAG00000000389","4",112326828,112343487,16659
"246","ENSBTAG00000000390","25",28081759,28188134,106375
"247","ENSBTAG00000000392","28",28177853,28287517,109664
"248","ENSBTAG00000000393","5",83676933,83723213,46280
"249","ENSBTAG00000000394","1",141381147,141486921,105774
"250","ENSBTAG00000000395","5",36905169,37122215,217046
"251","ENSBTAG00000000396","23",11066555,11071948,5393
"252","ENSBTAG00000000397","4",117261920,117301793,39873
"253","ENSBTAG00000000399","7",11807308,11809941,2633
"254","ENSBTAG00000000400","5",27519707,27531883,12176
"255","ENSBTAG00000000401","3",14247826,14254284,6458
"256","ENSBTAG00000000404","3",14237515,14244262,6747
"257","ENSBTAG00000000405","25",27201063,27204251,3188
"258","ENSBTAG00000000406","3",14232918,14240979,8061
"259","ENSBTAG00000000409","9",39988950,40037184,48234
"260","ENSBTAG00000000410","4",91836115,91840881,4766
"261","ENSBTAG00000000411","19",51123898,51137090,13192
"262","ENSBTAG00000000413","7",18518580,18532314,13734
"263","ENSBTAG00000000414","7",18515026,18516457,1431
"264","ENSBTAG00000000415","20",13529621,13613055,83434
"265","ENSBTAG00000000417","19",51118070,51122495,4425
"266","ENSBTAG00000000418","18",20894276,21016411,122135
"267","ENSBTAG00000000419","X",121080647,121291280,210633
"268","ENSBTAG00000000421","5",22650472,22777435,126963
"269","ENSBTAG00000000422","24",3403848,3482982,79134
"270","ENSBTAG00000000423","29",44692636,44702112,9476
"271","ENSBTAG00000000425","21",45341894,45342812,918
"272","ENSBTAG00000000426","15",43042081,43042631,550
"273","ENSBTAG00000000428","23",7712944,7719279,6335
"274","ENSBTAG00000000429","17",72563333,72590762,27429
"275","ENSBTAG00000000432","10",22263101,22328152,65051
"276","ENSBTAG00000000434","15",22242326,22246349,4023
"277","ENSBTAG00000000435","5",26518832,26524457,5625
"278","ENSBTAG00000000436","9",75740934,75756753,15819
"279","ENSBTAG00000000437","26",14871804,14893035,21231
"280","ENSBTAG00000000439","17",45279916,45360901,80985
"281","ENSBTAG00000000440","15",22246337,22248004,1667
"282","ENSBTAG00000000442","26",14896080,14903110,7030
"283","ENSBTAG00000000445","26",14911696,14964875,53179
"284","ENSBTAG00000000446","12",86288141,86389324,101183
"285","ENSBTAG00000000447","26",14968609,15042514,73905
"286","ENSBTAG00000000448","1",71964668,72000537,35869
"287","ENSBTAG00000000451","29",9897293,9905845,8552
"288","ENSBTAG00000000454","5",32318296,32323859,5563
"289","ENSBTAG00000000455","29",9887736,9893142,5406
"290","ENSBTAG00000000456","1",119339499,119376792,37293
"291","ENSBTAG00000000457","29",9869248,9870661,1413
"292","ENSBTAG00000000458","18",34440414,34478171,37757
"293","ENSBTAG00000000459","22",15060378,15080375,19997
"294","ENSBTAG00000000460","29",9741771,9862422,120651
"295","ENSBTAG00000000462","18",25499255,25521488,22233
"296","ENSBTAG00000000469","7",45843018,45867877,24859
"297","ENSBTAG00000000470","6",36880054,36893805,13751
"298","ENSBTAG00000000472","18",47452859,47471033,18174
"299","ENSBTAG00000000473","6",66135880,66272135,136255
"300","ENSBTAG00000000475","15",62222483,62296459,73976
"301","ENSBTAG00000000476","1",82816651,82821567,4916
"302","ENSBTAG00000000477","16",26601165,26603780,2615
"303","ENSBTAG00000000478","22",50067283,50069527,2244
"304","ENSBTAG00000000480","22",50039840,50066774,26934
"305","ENSBTAG00000000483","22",50029859,50032903,3044
"306","ENSBTAG00000000484","22",50016339,50026835,10496
"307","ENSBTAG00000000489","11",10201853,10205764,3911
"308","ENSBTAG00000000490","11",10187533,10202365,14832
"309","ENSBTAG00000000492","2",6665574,6676526,10952
"310","ENSBTAG00000000494","20",20014955,20315593,300638
"311","ENSBTAG00000000495","7",68784734,68800460,15726
"312","ENSBTAG00000000496","1",69521456,69670381,148925
"313","ENSBTAG00000000497","3",100505194,100517388,12194
"314","ENSBTAG00000000500","8",8476519,8542392,65873
"315","ENSBTAG00000000501","X",2100820,2298436,197616
"316","ENSBTAG00000000502","1",153640084,153663068,22984
"317","ENSBTAG00000000504","3",55014449,55045556,31107
"318","ENSBTAG00000000505","3",54928686,54989008,60322
"319","ENSBTAG00000000507","5",27820352,27839685,19333
"320","ENSBTAG00000000510","5",27808212,27814034,5822
"321","ENSBTAG00000000511","16",30706515,30802133,95618
"322","ENSBTAG00000000512","13",62888941,62915182,26241
"323","ENSBTAG00000000516","13",10585742,10589026,3284
"324","ENSBTAG00000000517","24",33007030,33041024,33994
"325","ENSBTAG00000000518","29",41639954,41642024,2070
"326","ENSBTAG00000000520","X",36747183,36807481,60298
"327","ENSBTAG00000000521","4",66266959,66328519,61560
"328","ENSBTAG00000000522","1",80611849,80618915,7066
"329","ENSBTAG00000000524","1",143846935,143850428,3493
"330","ENSBTAG00000000526","1",135753514,135824423,70909
"331","ENSBTAG00000000527","23",11729171,12057180,328009
"332","ENSBTAG00000000528","13",66243119,66271549,28430
"333","ENSBTAG00000000529","23",12062334,12436221,373887
"334","ENSBTAG00000000531","24",59288382,59317571,29189
"335","ENSBTAG00000000532","3",105632530,105644310,11780
"336","ENSBTAG00000000533","3",105615007,105622276,7269
"337","ENSBTAG00000000534","8",10385710,10415330,29620
"338","ENSBTAG00000000535","28",5877005,6186839,309834
"339","ENSBTAG00000000536","8",10335582,10384049,48467
"340","ENSBTAG00000000539","21",7226600,7416484,189884
"341","ENSBTAG00000000540","19",34063776,34069380,5604
"342","ENSBTAG00000000541","21",46701290,46705898,4608
"343","ENSBTAG00000000542","11",38211758,38282970,71212
"344","ENSBTAG00000000545","11",38244239,38297064,52825
"345","ENSBTAG00000000546","19",35883032,35886936,3904
"346","ENSBTAG00000000548","4",93862090,93922707,60617
"347","ENSBTAG00000000550","7",43683704,43685876,2172
"348","ENSBTAG00000000551","26",30880218,30890590,10372
"349","ENSBTAG00000000552","10",35975164,35985917,10753
"350","ENSBTAG00000000555","8",11611595,11674522,62927
"351","ENSBTAG00000000558","4",65090702,65093899,3197
"352","ENSBTAG00000000559","13",74654889,74665860,10971
"353","ENSBTAG00000000560","19",13214920,13216355,1435
"354","ENSBTAG00000000561","20",10230183,10276416,46233
"355","ENSBTAG00000000562","28",7883317,7898012,14695
"356","ENSBTAG00000000563","22",11609349,11613789,4440
"357","ENSBTAG00000000564","20",5750258,5822147,71889
"358","ENSBTAG00000000565","10",54224948,54365426,140478
"359","ENSBTAG00000000566","1",68289450,68332524,43074
"360","ENSBTAG00000000568","25",1129364,1137303,7939
"361","ENSBTAG00000000569","1",73362759,73365438,2679
"362","ENSBTAG00000000570","28",13467070,13522040,54970
"363","ENSBTAG00000000571","19",45042256,45058084,15828
"364","ENSBTAG00000000573","19",41627702,41634832,7130
"365","ENSBTAG00000000575","8",104208978,104311676,102698
"366","ENSBTAG00000000576","X",124420342,124463689,43347
"367","ENSBTAG00000000578","23",27599348,27618039,18691
"368","ENSBTAG00000000579","20",37164880,37370342,205462
"369","ENSBTAG00000000580","23",27599221,27602913,3692
"370","ENSBTAG00000000581","2",112861987,113100311,238324
"371","ENSBTAG00000000582","23",27595986,27598654,2668
"372","ENSBTAG00000000585","23",27589914,27592606,2692
"373","ENSBTAG00000000586","20",37045115,37150094,104979
"374","ENSBTAG00000000588","1",18712589,18736860,24271
"375","ENSBTAG00000000590","17",44523016,44583195,60179
"376","ENSBTAG00000000593","5",87876155,88043505,167350
"377","ENSBTAG00000000595","7",16782097,16851987,69890
"378","ENSBTAG00000000597","1",18567977,18710975,142998
"379","ENSBTAG00000000598","13",42185268,42189284,4016
"380","ENSBTAG00000000599","6",91881488,91920400,38912
"381","ENSBTAG00000000601","23",7350323,7378810,28487
"382","ENSBTAG00000000602","23",7380014,7386725,6711
"383","ENSBTAG00000000603","1",10702387,10787934,85547
"384","ENSBTAG00000000604","4",31876899,31903130,26231
"385","ENSBTAG00000000605","1",10690694,10698960,8266
"386","ENSBTAG00000000606","5",76301501,76417740,116239
"387","ENSBTAG00000000607","4",113788348,113803468,15120
"388","ENSBTAG00000000608","3",14042676,14070433,27757
"389","ENSBTAG00000000609","9",62732688,62733179,491
"390","ENSBTAG00000000613","7",16714677,16752222,37545
"391","ENSBTAG00000000616","3",507209,561418,54209
"392","ENSBTAG00000000620","14",31063582,31102416,38834
"393","ENSBTAG00000000621","18",48153486,48177891,24405
"394","ENSBTAG00000000622","21",22839036,22842669,3633
"395","ENSBTAG00000000623","21",22846025,22955571,109546
"396","ENSBTAG00000000625","10",13478777,13621037,142260
"397","ENSBTAG00000000626","7",58457553,58586994,129441
"398","ENSBTAG00000000629","9",52495548,52617857,122309
"399","ENSBTAG00000000630","18",44607827,44661349,53522
"400","ENSBTAG00000000632","14",69858330,69976418,118088
"401","ENSBTAG00000000634","3",116959554,117005443,45889
"402","ENSBTAG00000000638","18",14008412,14012515,4103
"403","ENSBTAG00000000639","18",14013051,14015824,2773
"404","ENSBTAG00000000640","21",5244997,5254196,9199
"405","ENSBTAG00000000641","19",38060253,38364401,304148
"406","ENSBTAG00000000642","25",41429465,41453280,23815
"407","ENSBTAG00000000644","3",16829295,16832678,3383
"408","ENSBTAG00000000646","6",44921531,44955049,33518
"409","ENSBTAG00000000647","5",119568730,119589195,20465
"410","ENSBTAG00000000648","1",9440973,9491324,50351
"411","ENSBTAG00000000650","5",119589228,119612001,22773
"412","ENSBTAG00000000653","13",67598734,67706157,107423
"413","ENSBTAG00000000654","13",36593248,36754850,161602
"414","ENSBTAG00000000655","21",47398496,47734138,335642
"415","ENSBTAG00000000656","24",779627,866891,87264
"416","ENSBTAG00000000658","14",720987,723829,2842
"417","ENSBTAG00000000660","13",67709013,67732524,23511
"418","ENSBTAG00000000662","5",113102494,113195472,92978
"419","ENSBTAG00000000664","3",27261018,27363147,102129
"420","ENSBTAG00000000665","19",42302320,42303571,1251
"421","ENSBTAG00000000666","19",42307188,42312293,5105
"422","ENSBTAG00000000667","5",74694651,74711373,16722
"423","ENSBTAG00000000668","7",22033885,22060149,26264
"424","ENSBTAG00000000670","22",48990198,48998979,8781
"425","ENSBTAG00000000671","22",48984160,48989507,5347
"426","ENSBTAG00000000672","20",58565052,58594909,29857
"427","ENSBTAG00000000675","19",53787203,53824616,37413
"428","ENSBTAG00000000676","9",22963808,23089404,125596
"429","ENSBTAG00000000678","3",28579009,28614809,35800
"430","ENSBTAG00000000679","9",23088493,23116895,28402
"431","ENSBTAG00000000682","7",22826247,23051768,225521
"432","ENSBTAG00000000683","13",46289405,46322491,33086
"433","ENSBTAG00000000684","2",134985221,135154958,169737
"434","ENSBTAG00000000686","13",10697268,10705509,8241
"435","ENSBTAG00000000687","5",19295432,19400057,104625
"436","ENSBTAG00000000690","3",18921958,18932193,10235
"437","ENSBTAG00000000694","15",46453641,46455094,1453
"438","ENSBTAG00000000695","8",75335452,75454151,118699
"439","ENSBTAG00000000696","15",46455063,46462510,7447
"440","ENSBTAG00000000697","15",46462641,46466203,3562
"441","ENSBTAG00000000698","17",65530211,65744827,214616
"442","ENSBTAG00000000699","8",81197389,81619574,422185
"443","ENSBTAG00000000700","15",40167676,40347859,180183
"444","ENSBTAG00000000703","11",45551844,45607498,55654
"445","ENSBTAG00000000704","25",27898147,27918749,20602
"446","ENSBTAG00000000705","11",24756935,24769582,12647
"447","ENSBTAG00000000706","1",9583345,9592271,8926
"448","ENSBTAG00000000707","14",8137189,8169248,32059
"449","ENSBTAG00000000710","7",20261476,20311632,50156
"450","ENSBTAG00000000711","14",8073208,8129604,56396
"451","ENSBTAG00000000712","8",110162117,110188746,26629
"452","ENSBTAG00000000713","25",35991389,36012002,20613
"453","ENSBTAG00000000715","4",113349198,113356352,7154
"454","ENSBTAG00000000717","7",43016868,43028554,11686
"455","ENSBTAG00000000718","7",21164683,21194842,30159
"456","ENSBTAG00000000719","4",110185261,110439133,253872
"457","ENSBTAG00000000720","8",80974612,80980412,5800
"458","ENSBTAG00000000721","18",43488169,43545013,56844
"459","ENSBTAG00000000725","25",38091964,38131352,39388
"460","ENSBTAG00000000727","15",54063709,54147686,83977
"461","ENSBTAG00000000728","25",2855140,2859275,4135
"462","ENSBTAG00000000730","2",34292569,34302949,10380
"463","ENSBTAG00000000731","19",35907559,35913414,5855
"464","ENSBTAG00000000735","21",25981584,25994592,13008
"465","ENSBTAG00000000736","3",92919163,92996508,77345
"466","ENSBTAG00000000737","10",58738961,58904048,165087
"467","ENSBTAG00000000738","8",80710910,80921735,210825
"468","ENSBTAG00000000742","1",134947902,134965883,17981
"469","ENSBTAG00000000743","27",26306486,26315497,9011
"470","ENSBTAG00000000744","27",26320484,26342212,21728
"471","ENSBTAG00000000745","4",65433649,65447871,14222
"472","ENSBTAG00000000746","1",157277141,157374828,97687
"473","ENSBTAG00000000748","6",15597411,15604174,6763
"474","ENSBTAG00000000749","5",84446036,84472173,26137
"475","ENSBTAG00000000750","1",133084511,133113773,29262
"476","ENSBTAG00000000751","6",15577365,15590078,12713
"477","ENSBTAG00000000752","1",157392691,157410804,18113
"478","ENSBTAG00000000753","7",19978943,20004157,25214
"479","ENSBTAG00000000754","16",71180690,71252919,72229
"480","ENSBTAG00000000755","7",20132959,20178566,45607
"481","ENSBTAG00000000758","16",71143193,71178800,35607
"482","ENSBTAG00000000759","16",71127134,71133739,6605
"483","ENSBTAG00000000764","7",11294341,11298380,4039
"484","ENSBTAG00000000765","26",37019951,37039831,19880
"485","ENSBTAG00000000767","10",995927,1043639,47712
"486","ENSBTAG00000000770","15",53707096,53759583,52487
"487","ENSBTAG00000000771","4",118628470,118690018,61548
"488","ENSBTAG00000000772","16",63533641,63536686,3045
"489","ENSBTAG00000000773","29",41042979,41052771,9792
"490","ENSBTAG00000000778","23",17752495,17758156,5661
"491","ENSBTAG00000000781","25",33881985,34015826,133841
"492","ENSBTAG00000000782","6",70564927,70612683,47756
"493","ENSBTAG00000000783","11",13861144,13975868,114724
"494","ENSBTAG00000000784","3",120329405,120335084,5679
"495","ENSBTAG00000000785","3",120335887,120364423,28536
"496","ENSBTAG00000000786","23",50621892,50632743,10851
"497","ENSBTAG00000000789","3",120373077,120389112,16035
"498","ENSBTAG00000000791","26",25666273,25678297,12024
"499","ENSBTAG00000000792","16",48572113,48653428,81315
"500","ENSBTAG00000000793","16",64223528,64289609,66081
"501","ENSBTAG00000000795","16",64296837,64514197,217360
"502","ENSBTAG00000000797","3",19021833,19028884,7051
"503","ENSBTAG00000000799","4",16192292,16355628,163336
"504","ENSBTAG00000000801","18",63750840,63757996,7156
"505","ENSBTAG00000000802","15",42102179,42116460,14281
"506","ENSBTAG00000000803","18",63719243,63741526,22283
"507","ENSBTAG00000000804","8",16757261,16972790,215529
"508","ENSBTAG00000000805","22",49003339,49006034,2695
"509","ENSBTAG00000000806","26",9379274,9420154,40880
"510","ENSBTAG00000000807","21",25517769,25528645,10876
"511","ENSBTAG00000000808","5",29782810,29787103,4293
"512","ENSBTAG00000000809","20",69312348,69335913,23565
"513","ENSBTAG00000000810","7",4291940,4310862,18922
"514","ENSBTAG00000000811","7",4284747,4292511,7764
"515","ENSBTAG00000000812","19",56935114,56953144,18030
"516","ENSBTAG00000000813","7",4275960,4283926,7966
"517","ENSBTAG00000000815","2",135934234,135972074,37840
"518","ENSBTAG00000000816","9",43843907,43866544,22637
"519","ENSBTAG00000000817","9",94544473,94653549,109076
"520","ENSBTAG00000000818","5",22559005,22644686,85681
"521","ENSBTAG00000000819","8",41012203,41258537,246334
"522","ENSBTAG00000000820","4",11242533,11247552,5019
"523","ENSBTAG00000000821","10",11555686,11615749,60063
"524","ENSBTAG00000000824","19",56020690,56027838,7148
"525","ENSBTAG00000000825","13",52129502,52131796,2294
"526","ENSBTAG00000000827","19",20700379,20801731,101352
"527","ENSBTAG00000000828","X",59413796,59439573,25777
"528","ENSBTAG00000000829","19",24321971,24339712,17741
"529","ENSBTAG00000000830","28",8841688,8897393,55705
"530","ENSBTAG00000000831","19",24339844,24360349,20505
"531","ENSBTAG00000000833","19",24360140,24365269,5129
"532","ENSBTAG00000000835","13",81424938,81524746,99808
"533","ENSBTAG00000000836","5",27039437,27047690,8253
"534","ENSBTAG00000000837","16",29365008,29406357,41349
"535","ENSBTAG00000000838","21",56040106,56183841,143735
"536","ENSBTAG00000000841","8",67361739,67428893,67154
"537","ENSBTAG00000000842","15",33291675,33440714,149039
"538","ENSBTAG00000000843","10",26078548,26087333,8785
"539","ENSBTAG00000000845","3",41271697,41494156,222459
"540","ENSBTAG00000000848","11",2375182,2400447,25265
"541","ENSBTAG00000000851","2",91483594,91527751,44157
"542","ENSBTAG00000000853","29",20705434,20705802,368
"543","ENSBTAG00000000854","16",59319810,59394521,74711
"544","ENSBTAG00000000855","19",21889110,22053102,163992
"545","ENSBTAG00000000856","14",580951,583957,3006
"546","ENSBTAG00000000857","14",578057,580805,2748
"547","ENSBTAG00000000859","5",33940564,33993305,52741
"548","ENSBTAG00000000861","3",13767022,13773423,6401
"549","ENSBTAG00000000868","18",2499180,2502934,3754
"550","ENSBTAG00000000869","12",53756338,53801246,44908
"551","ENSBTAG00000000871","23",30047159,30061046,13887
"552","ENSBTAG00000000873","13",75255202,75339020,83818
"553","ENSBTAG00000000874","7",96033978,96167151,133173
"554","ENSBTAG00000000875","19",51500747,51517013,16266
"555","ENSBTAG00000000877","5",78272231,78279920,7689
"556","ENSBTAG00000000878","14",21493003,21523152,30149
"557","ENSBTAG00000000879","14",303633,305704,2071
"558","ENSBTAG00000000880","9",86800152,86818093,17941
"559","ENSBTAG00000000885","8",98172180,98176461,4281
"560","ENSBTAG00000000888","3",10996224,11091367,95143
"561","ENSBTAG00000000892","9",12934833,12958092,23259
"562","ENSBTAG00000000893","11",103206270,103208678,2408
"563","ENSBTAG00000000894","X",74244893,74267571,22678
"564","ENSBTAG00000000895","X",74231999,74256028,24029
"565","ENSBTAG00000000897","10",7624974,7934460,309486
"566","ENSBTAG00000000898","10",7846836,7854604,7768
"567","ENSBTAG00000000899","11",61003740,61011375,7635
"568","ENSBTAG00000000900","3",53555337,53648204,92867
"569","ENSBTAG00000000902","X",79093648,79135279,41631
"570","ENSBTAG00000000905","1",135468728,135526439,57711
"571","ENSBTAG00000000908","17",52790484,52791491,1007
"572","ENSBTAG00000000910","7",61545949,61566540,20591
"573","ENSBTAG00000000911","4",93649542,93748886,99344
"574","ENSBTAG00000000913","17",68887320,68889515,2195
"575","ENSBTAG00000000914","14",21713331,21737924,24593
"576","ENSBTAG00000000916","9",103525415,103548203,22788
"577","ENSBTAG00000000917","8",69478799,69526082,47283
"578","ENSBTAG00000000918","9",103548775,103577979,29204
"579","ENSBTAG00000000919","9",25550030,25561094,11064
"580","ENSBTAG00000000920","19",53691404,53787907,96503
"581","ENSBTAG00000000923","5",26085798,26093573,7775
"582","ENSBTAG00000000924","5",26076092,26077683,1591
"583","ENSBTAG00000000925","5",67653907,67696157,42250
"584","ENSBTAG00000000928","19",33522158,33592103,69945
"585","ENSBTAG00000000933","11",105898128,105908460,10332
"586","ENSBTAG00000000936","10",26094678,26097587,2909
"587","ENSBTAG00000000937","2",14654230,14751034,96804
"588","ENSBTAG00000000939","13",10069353,10418278,348925
"589","ENSBTAG00000000940","23",16396728,16399349,2621
"590","ENSBTAG00000000941","2",1920239,1969794,49555
"591","ENSBTAG00000000942","28",5218869,5463512,244643
"592","ENSBTAG00000000943","19",33071705,33086901,15196
"593","ENSBTAG00000000944","20",71006062,71048066,42004
"594","ENSBTAG00000000945","18",10607005,10683673,76668
"595","ENSBTAG00000000946","18",10690109,10751195,61086
"596","ENSBTAG00000000948","14",26181071,26253265,72194
"597","ENSBTAG00000000949","28",29287220,29293350,6130
"598","ENSBTAG00000000950","28",29296801,29298632,1831
"599","ENSBTAG00000000951","26",51737604,51822703,85099
"600","ENSBTAG00000000955","X",55642103,55717924,75821
"601","ENSBTAG00000000957","27",14260409,14263949,3540
"602","ENSBTAG00000000958","13",74621353,74639617,18264
"603","ENSBTAG00000000959","13",74640691,74643705,3014
"604","ENSBTAG00000000960","13",74644447,74645479,1032
"605","ENSBTAG00000000961","13",74646008,74648793,2785
"606","ENSBTAG00000000962","6",83291686,83347989,56303
"607","ENSBTAG00000000964","3",12804191,12868240,64049
"608","ENSBTAG00000000966","5",99671846,99678614,6768
"609","ENSBTAG00000000967","21",19522497,19547431,24934
"610","ENSBTAG00000000970","5",29812653,29835158,22505
"611","ENSBTAG00000000973","1",150591084,150595749,4665
"612","ENSBTAG00000000974","8",83837389,83918620,81231
"613","ENSBTAG00000000977","15",25721022,26071036,350014
"614","ENSBTAG00000000978","27",33285825,33311648,25823
"615","ENSBTAG00000000979","27",37368840,37383626,14786
"616","ENSBTAG00000000981","22",50854957,50859766,4809
"617","ENSBTAG00000000982","22",50846267,50854259,7992
"618","ENSBTAG00000000983","15",35030366,35109463,79097
"619","ENSBTAG00000000985","11",73343471,73408822,65351
"620","ENSBTAG00000000986","15",34963010,35011752,48742
"621","ENSBTAG00000000987","15",34872513,34959346,86833
"622","ENSBTAG00000000988","12",28616747,28667820,51073
"623","ENSBTAG00000000990","4",78127061,78137712,10651
"624","ENSBTAG00000000991","4",78121755,78126851,5096
"625","ENSBTAG00000000992","11",67211523,67219184,7661
"626","ENSBTAG00000000993","12",28591476,28614349,22873
"627","ENSBTAG00000000995","9",21497810,21504915,7105
"628","ENSBTAG00000000998","24",21007215,21026670,19455
"629","ENSBTAG00000001000","14",77321661,77371770,50109
"630","ENSBTAG00000001001","20",22986548,23096396,109848
"631","ENSBTAG00000001002","7",45768913,45800957,32044
"632","ENSBTAG00000001003","7",81249419,81275010,25591
"633","ENSBTAG00000001004","29",28232748,28241470,8722
"634","ENSBTAG00000001005","17",70979569,70990872,11303
"635","ENSBTAG00000001006","26",42929603,42931348,1745
"636","ENSBTAG00000001007","X",3801158,3841711,40553
"637","ENSBTAG00000001008","28",26783286,26788539,5253
"638","ENSBTAG00000001009","1",66112082,66145729,33647
"639","ENSBTAG00000001010","18",4522898,4666475,143577
"640","ENSBTAG00000001013","20",10532186,10564537,32351
"641","ENSBTAG00000001014","19",34084511,34090250,5739
"642","ENSBTAG00000001015","13",61622078,61675062,52984
"643","ENSBTAG00000001016","8",79167865,79255810,87945
"644","ENSBTAG00000001017","26",24528292,24587108,58816
"645","ENSBTAG00000001019","28",42278915,42291696,12781
"646","ENSBTAG00000001020","5",105499533,105523869,24336
"647","ENSBTAG00000001021","21",33951654,33955241,3587
"648","ENSBTAG00000001022","25",2016991,2025775,8784
"649","ENSBTAG00000001023","25",1550964,1561670,10706
"650","ENSBTAG00000001024","2",126408497,126477461,68964
"651","ENSBTAG00000001026","18",7897717,7928436,30719
"652","ENSBTAG00000001027","15",54737997,54748417,10420
"653","ENSBTAG00000001028","15",54763503,54846909,83406
"654","ENSBTAG00000001029","29",42969386,42984628,15242
"655","ENSBTAG00000001030","17",68971211,69102722,131511
"656","ENSBTAG00000001032","29",42985611,42997675,12064
"657","ENSBTAG00000001034","11",7165278,7193294,28016
"658","ENSBTAG00000001035","29",43002801,43016362,13561
"659","ENSBTAG00000001036","4",68473794,68614954,141160
"660","ENSBTAG00000001037","29",43028075,43040939,12864
"661","ENSBTAG00000001038","13",52666467,52675560,9093
"662","ENSBTAG00000001041","19",42921502,42933320,11818
"663","ENSBTAG00000001042","11",68259932,68282685,22753
"664","ENSBTAG00000001043","29",20080973,20365371,284398
"665","ENSBTAG00000001044","28",25555682,25580735,25053
"666","ENSBTAG00000001049","X",134225187,134369044,143857
"667","ENSBTAG00000001050","2",127482749,127508799,26050
"668","ENSBTAG00000001051","18",63283496,63290397,6901
"669","ENSBTAG00000001052","3",809356,843304,33948
"670","ENSBTAG00000001055","18",48557658,48569498,11840
"671","ENSBTAG00000001057","5",113619171,113671084,51913
"672","ENSBTAG00000001058","X",36998262,37002903,4641
"673","ENSBTAG00000001059","X",37002947,37011510,8563
"674","ENSBTAG00000001060","2",61250082,61253877,3795
"675","ENSBTAG00000001061","19",62664531,62970305,305774
"676","ENSBTAG00000001063","4",68911991,68914205,2214
"677","ENSBTAG00000001066","25",36137411,36154811,17400
"678","ENSBTAG00000001067","22",49118416,49127374,8958
"679","ENSBTAG00000001068","25",36114316,36138223,23907
"680","ENSBTAG00000001069","19",27376072,27388416,12344
"681","ENSBTAG00000001071","19",27388364,27401531,13167
"682","ENSBTAG00000001074","23",12969790,12976488,6698
"683","ENSBTAG00000001075","18",39673114,39702531,29417
"684","ENSBTAG00000001076","11",82948817,82954244,5427
"685","ENSBTAG00000001077","29",48450137,48518334,68197
"686","ENSBTAG00000001078","25",3397612,3432198,34586
"687","ENSBTAG00000001079","5",39416844,39421896,5052
"688","ENSBTAG00000001080","3",25000724,25256686,255962
"689","ENSBTAG00000001081","8",702606,1069003,366397
"690","ENSBTAG00000001082","2",131902269,131915138,12869
"691","ENSBTAG00000001083","2",23405489,23558475,152986
"692","ENSBTAG00000001085","19",61658599,61698312,39713
"693","ENSBTAG00000001086","11",9268665,9316088,47423
"694","ENSBTAG00000001088","5",64296337,64335689,39352
"695","ENSBTAG00000001090","2",26618950,26643168,24218
"696","ENSBTAG00000001092","2",26613246,26618722,5476
"697","ENSBTAG00000001093","2",26570154,26618014,47860
"698","ENSBTAG00000001094","12",31001535,31388275,386740
"699","ENSBTAG00000001096","2",18437895,18454695,16800
"700","ENSBTAG00000001097","2",18418695,18426410,7715
"701","ENSBTAG00000001098","2",18388139,18415849,27710
"702","ENSBTAG00000001099","5",103746808,103750911,4103
"703","ENSBTAG00000001100","2",128753716,128780202,26486
"704","ENSBTAG00000001101","2",128718562,128742668,24106
"705","ENSBTAG00000001104","18",34357740,34436354,78614
"706","ENSBTAG00000001105","11",68096833,68171538,74705
"707","ENSBTAG00000001107","16",56231860,56242610,10750
"708","ENSBTAG00000001108","11",68176875,68232649,55774
"709","ENSBTAG00000001109","16",56248846,56268263,19417
"710","ENSBTAG00000001110","19",56339626,56360049,20423
"711","ENSBTAG00000001112","13",50950179,50985484,35305
"712","ENSBTAG00000001113","11",19659154,19675873,16719
"713","ENSBTAG00000001114","11",19680235,19765027,84792
"714","ENSBTAG00000001116","7",22185073,22218084,33011
"715","ENSBTAG00000001117","17",33093747,33168247,74500
"716","ENSBTAG00000001119","19",20847902,20864213,16311
"717","ENSBTAG00000001120","19",20865348,20873587,8239
"718","ENSBTAG00000001123","23",47800492,47816538,16046
"719","ENSBTAG00000001124","10",99667901,99724558,56657
"720","ENSBTAG00000001125","8",71596638,71622275,25637
"721","ENSBTAG00000001126","6",93534456,93652748,118292
"722","ENSBTAG00000001128","24",46063103,46173894,110791
"723","ENSBTAG00000001131","25",35789614,35799221,9607
"724","ENSBTAG00000001132","2",52388547,52825730,437183
"725","ENSBTAG00000001133","12",11675264,12071822,396558
"726","ENSBTAG00000001134","25",35768779,35784480,15701
"727","ENSBTAG00000001135","3",34274613,34280108,5495
"728","ENSBTAG00000001136","3",34200677,34215659,14982
"729","ENSBTAG00000001137","8",60474074,60491846,17772
"730","ENSBTAG00000001139","25",35762361,35768977,6616
"731","ENSBTAG00000001140","11",87961968,87973214,11246
"732","ENSBTAG00000001141","11",87917749,87960440,42691
"733","ENSBTAG00000001142","8",60494277,60528253,33976
"734","ENSBTAG00000001143","3",54148968,54165067,16099
"735","ENSBTAG00000001144","13",39584264,39602876,18612
"736","ENSBTAG00000001146","9",80196707,80237534,40827
"737","ENSBTAG00000001150","1",1040523,1047017,6494
"738","ENSBTAG00000001151","18",46566807,46576567,9760
"739","ENSBTAG00000001152","7",20778581,20790166,11585
"740","ENSBTAG00000001153","7",20747877,20777774,29897
"741","ENSBTAG00000001156","14",7865552,7951420,85868
"742","ENSBTAG00000001160","2",124758268,124785888,27620
"743","ENSBTAG00000001161","5",78658638,78688163,29525
"744","ENSBTAG00000001163","28",26293095,26345874,52779
"745","ENSBTAG00000001164","17",55349801,55448734,98933
"746","ENSBTAG00000001165","28",26345865,26363247,17382
"747","ENSBTAG00000001166","19",9393890,9436547,42657
"748","ENSBTAG00000001168","17",55314762,55345115,30353
"749","ENSBTAG00000001171","18",24154462,24184693,30231
"750","ENSBTAG00000001173","16",75116092,75349323,233231
"751","ENSBTAG00000001174","14",22017167,22023197,6030
"752","ENSBTAG00000001176","22",22470522,22473916,3394
"753","ENSBTAG00000001178","12",30183487,30206285,22798
"754","ENSBTAG00000001179","10",26715137,26748582,33445
"755","ENSBTAG00000001181","16",70348824,70552926,204102
"756","ENSBTAG00000001182","4",61204174,61302729,98555
"757","ENSBTAG00000001183","10",26692917,26702595,9678
"758","ENSBTAG00000001185","29",45668456,45718688,50232
"759","ENSBTAG00000001186","27",38246299,38307830,61531
"760","ENSBTAG00000001187","17",68588587,68591488,2901
"761","ENSBTAG00000001188","29",40955641,40959667,4026
"762","ENSBTAG00000001189","17",68597309,68647088,49779
"763","ENSBTAG00000001191","18",25420716,25423723,3007
"764","ENSBTAG00000001192","2",125550304,125585869,35565
"765","ENSBTAG00000001193","29",45516976,45527213,10237
"766","ENSBTAG00000001195","19",42283857,42299780,15923
"767","ENSBTAG00000001197","3",8848948,8864962,16014
"768","ENSBTAG00000001198","4",112958076,112958969,893
"769","ENSBTAG00000001199","3",15051165,15090850,39685
"770","ENSBTAG00000001204","13",35028262,35105654,77392
"771","ENSBTAG00000001206","11",105873284,105875130,1846
"772","ENSBTAG00000001207","24",12393116,12415022,21906
"773","ENSBTAG00000001209","1",56486571,56727153,240582
"774","ENSBTAG00000001212","3",14754110,14760797,6687
"775","ENSBTAG00000001213","21",247253,256180,8927
"776","ENSBTAG00000001219","21",67102,78036,10934
"777","ENSBTAG00000001221","8",70787750,70791607,3857
"778","ENSBTAG00000001223","8",17332181,17403912,71731
"779","ENSBTAG00000001224","24",879074,1029386,150312
"780","ENSBTAG00000001225","29",44653764,44663023,9259
"781","ENSBTAG00000001228","29",50575224,50578174,2950
"782","ENSBTAG00000001229","29",50569809,50574869,5060
"783","ENSBTAG00000001231","28",39161231,39184091,22860
"784","ENSBTAG00000001233","15",28913768,28940892,27124
"785","ENSBTAG00000001235","1",57639751,57681112,41361
"786","ENSBTAG00000001241","20",27733036,27743771,10735
"787","ENSBTAG00000001242","26",34512776,34514320,1544
"788","ENSBTAG00000001243","27",37031655,37049363,17708
"789","ENSBTAG00000001244","27",37053715,37077724,24009
"790","ENSBTAG00000001246","3",26886560,26919931,33371
"791","ENSBTAG00000001247","7",47392302,47404408,12106
"792","ENSBTAG00000001249","6",85184653,85233341,48688
"793","ENSBTAG00000001250","23",45614708,45637787,23079
"794","ENSBTAG00000001252","23",44281855,44414520,132665
"795","ENSBTAG00000001254","14",63800447,63868200,67753
"796","ENSBTAG00000001255","17",65290954,65297599,6645
"797","ENSBTAG00000001257","8",78856517,79055459,198942
"798","ENSBTAG00000001258","1",2046733,2083566,36833
"799","ENSBTAG00000001260","18",51784174,51792784,8610
"800","ENSBTAG00000001265","1",80536976,80545514,8538
"801","ENSBTAG00000001269","6",70838726,70865828,27102
"802","ENSBTAG00000001271","9",96575183,96622803,47620
"803","ENSBTAG00000001273","7",40663606,40710647,47041
"804","ENSBTAG00000001274","1",106405113,106727070,321957
"805","ENSBTAG00000001279","19",43761909,43789395,27486
"806","ENSBTAG00000001280","15",51880779,52022991,142212
"807","ENSBTAG00000001282","21",45775690,45986337,210647
"808","ENSBTAG00000001283","8",38949554,39091202,141648
"809","ENSBTAG00000001286","18",34834852,34839375,4523
"810","ENSBTAG00000001287","18",34841795,34855415,13620
"811","ENSBTAG00000001288","X",99790477,99912393,121916
"812","ENSBTAG00000001289","9",96056505,96061780,5275
"813","ENSBTAG00000001290","19",10816976,10840892,23916
"814","ENSBTAG00000001291","15",79056621,79057631,1010
"815","ENSBTAG00000001292","22",52952571,52986619,34048
"816","ENSBTAG00000001293","1",64451181,64565304,114123
"817","ENSBTAG00000001294","18",55473997,55477628,3631
"818","ENSBTAG00000001295","17",70405060,70477892,72832
"819","ENSBTAG00000001296","2",127661915,127677708,15793
"820","ENSBTAG00000001297","2",127619034,127660308,41274
"821","ENSBTAG00000001298","26",10561355,10614599,53244
"822","ENSBTAG00000001299","14",29199622,29460150,260528
"823","ENSBTAG00000001301","15",56045705,56057707,12002
"824","ENSBTAG00000001302","14",43120078,43222183,102105
"825","ENSBTAG00000001303","17",56156718,56169968,13250
"826","ENSBTAG00000001305","22",54363223,54662992,299769
"827","ENSBTAG00000001306","8",45222654,45244974,22320
"828","ENSBTAG00000001308","21",19678771,19771221,92450
"829","ENSBTAG00000001310","22",56225120,56231448,6328
"830","ENSBTAG00000001311","X",52424387,52436523,12136
"831","ENSBTAG00000001314","13",48110221,48120755,10534
"832","ENSBTAG00000001315","8",21730255,21735209,4954
"833","ENSBTAG00000001320","13",52319463,52347540,28077
"834","ENSBTAG00000001321","11",46543394,46552101,8707
"835","ENSBTAG00000001322","8",25198565,25308606,110041
"836","ENSBTAG00000001323","6",83183416,83277500,94084
"837","ENSBTAG00000001324","1",135336540,135423996,87456
"838","ENSBTAG00000001325","17",71518122,71544778,26656
"839","ENSBTAG00000001326","3",69467291,69583186,115895
"840","ENSBTAG00000001328","6",116841592,116857408,15816
"841","ENSBTAG00000001329","20",71117460,71129901,12441
"842","ENSBTAG00000001331","1",117434619,117479150,44531
"843","ENSBTAG00000001332","19",22596199,22621272,25073
"844","ENSBTAG00000001333","22",56709248,56835386,126138
"845","ENSBTAG00000001335","20",31868624,32178311,309687
"846","ENSBTAG00000001338","22",53135114,53136190,1076
"847","ENSBTAG00000001342","10",55098884,55113416,14532
"848","ENSBTAG00000001343","3",76768174,76788676,20502
"849","ENSBTAG00000001344","12",79112891,79128997,16106
"850","ENSBTAG00000001346","4",98862169,98885072,22903
"851","ENSBTAG00000001348","6",66096689,66109857,13168
"852","ENSBTAG00000001349","19",26390112,26412206,22094
"853","ENSBTAG00000001350","18",50065898,50066449,551
"854","ENSBTAG00000001352","11",103858845,103865112,6267
"855","ENSBTAG00000001353","11",103865153,103875086,9933
"856","ENSBTAG00000001354","11",103876330,103886130,9800
"857","ENSBTAG00000001356","17",14683018,14716484,33466
"858","ENSBTAG00000001359","2",119174753,119179729,4976
"859","ENSBTAG00000001360","9",70976876,70989794,12918
"860","ENSBTAG00000001364","10",30837049,31026323,189274
"861","ENSBTAG00000001368","19",53416674,53427208,10534
"862","ENSBTAG00000001374","25",33472201,33476894,4693
"863","ENSBTAG00000001376","13",59870318,59906468,36150
"864","ENSBTAG00000001382","16",3642003,3662797,20794
"865","ENSBTAG00000001385","21",22275954,22289338,13384
"866","ENSBTAG00000001387","21",22303092,22319532,16440
"867","ENSBTAG00000001390","1",64019141,64049977,30836
"868","ENSBTAG00000001391","29",12412710,12472521,59811
"869","ENSBTAG00000001392","5",56531475,56537384,5909
"870","ENSBTAG00000001393","3",50331720,50402638,70918
"871","ENSBTAG00000001394","7",39117501,39121521,4020
"872","ENSBTAG00000001395","1",19227894,19256713,28819
"873","ENSBTAG00000001396","21",30312315,30373658,61343
"874","ENSBTAG00000001398","17",54211210,54267854,56644
"875","ENSBTAG00000001400","18",49628437,49658477,30040
"876","ENSBTAG00000001401","16",45035427,45057579,22152
"877","ENSBTAG00000001403","1",97094274,97163222,68948
"878","ENSBTAG00000001404","25",21922600,22023329,100729
"879","ENSBTAG00000001405","10",16029521,16138025,108504
"880","ENSBTAG00000001406","3",27164794,27208154,43360
"881","ENSBTAG00000001407","21",21254207,21295278,41071
"882","ENSBTAG00000001408","11",66705245,66729498,24253
"883","ENSBTAG00000001410","15",34027052,34225316,198264
"884","ENSBTAG00000001412","1",7259998,7280970,20972
"885","ENSBTAG00000001414","12",52003904,52004884,980
"886","ENSBTAG00000001415","25",2441636,2444374,2738
"887","ENSBTAG00000001417","25",18233577,18298233,64656
"888","ENSBTAG00000001419","7",14771591,14781064,9473
"889","ENSBTAG00000001420","13",42813204,42879226,66022
"890","ENSBTAG00000001424","11",30122026,30143448,21422
"891","ENSBTAG00000001425","11",30143409,30256247,112838
"892","ENSBTAG00000001429","20",4408001,4448471,40470
"893","ENSBTAG00000001432","15",82678941,82679660,719
"894","ENSBTAG00000001435","2",43427948,43469180,41232
"895","ENSBTAG00000001439","22",43884242,43906075,21833
"896","ENSBTAG00000001440","25",7652895,7683013,30118
"897","ENSBTAG00000001442","1",66438934,66441965,3031
"898","ENSBTAG00000001443","23",27365917,27368844,2927
"899","ENSBTAG00000001444","23",27279346,27326827,47481
"900","ENSBTAG00000001446","9",76758962,76773999,15037
"901","ENSBTAG00000001448","4",65603906,65608037,4131
"902","ENSBTAG00000001449","7",51724953,51730918,5965
"903","ENSBTAG00000001450","7",51731683,51737917,6234
"904","ENSBTAG00000001451","1",131003440,131008085,4645
"905","ENSBTAG00000001455","4",68885186,68887923,2737
"906","ENSBTAG00000001457","20",31333365,31353178,19813
"907","ENSBTAG00000001460","15",58214580,58224553,9973
"908","ENSBTAG00000001462","7",496572,537888,41316
"909","ENSBTAG00000001463","27",25497637,25654276,156639
"910","ENSBTAG00000001464","1",64938048,65020584,82536
"911","ENSBTAG00000001465","1",114908447,114910097,1650
"912","ENSBTAG00000001468","10",67062902,67289712,226810
"913","ENSBTAG00000001470","25",34464734,34501215,36481
"914","ENSBTAG00000001471","22",48705195,48805972,100777
"915","ENSBTAG00000001473","17",72915295,72932721,17426
"916","ENSBTAG00000001474","29",28218789,28225780,6991
"917","ENSBTAG00000001475","23",42868726,42888891,20165
"918","ENSBTAG00000001476","23",27896902,27905422,8520
"919","ENSBTAG00000001477","23",28492098,28492531,433
"920","ENSBTAG00000001478","16",32531069,32573204,42135
"921","ENSBTAG00000001481","3",9739774,9759677,19903
"922","ENSBTAG00000001483","16",4001470,4254165,252695
"923","ENSBTAG00000001484","22",53471326,53489385,18059
"924","ENSBTAG00000001485","7",102142230,102225206,82976
"925","ENSBTAG00000001488","X",104841981,104918525,76544
"926","ENSBTAG00000001489","5",30656035,30660484,4449
"927","ENSBTAG00000001491","6",56608259,56846294,238035
"928","ENSBTAG00000001492","20",35232726,35331223,98497
"929","ENSBTAG00000001497","1",130707102,130773432,66330
"930","ENSBTAG00000001498","18",55143867,55153371,9504
"931","ENSBTAG00000001499","3",28837852,28977392,139540
"932","ENSBTAG00000001500","4",5454469,5459002,4533
"933","ENSBTAG00000001503","25",27295750,27305411,9661
"934","ENSBTAG00000001504","6",115790395,115806223,15828
"935","ENSBTAG00000001505","6",115732951,115790351,57400
"936","ENSBTAG00000001506","6",115600973,115711270,110297
"937","ENSBTAG00000001507","X",87634765,87811435,176670
"938","ENSBTAG00000001508","8",1162186,1318002,155816
"939","ENSBTAG00000001509","5",60480235,60548556,68321
"940","ENSBTAG00000001510","5",60554135,60664570,110435
"941","ENSBTAG00000001511","1",79558314,79611183,52869
"942","ENSBTAG00000001512","13",79847778,79882148,34370
"943","ENSBTAG00000001513","2",126966876,126975053,8177
"944","ENSBTAG00000001514","X",128175688,128207836,32148
"945","ENSBTAG00000001516","15",37806125,37809438,3313
"946","ENSBTAG00000001517","5",26998530,27002595,4065
"947","ENSBTAG00000001518","3",14106347,14111649,5302
"948","ENSBTAG00000001519","3",14098949,14105919,6970
"949","ENSBTAG00000001520","3",14093466,14098646,5180
"950","ENSBTAG00000001521","14",67986645,67991355,4710
"951","ENSBTAG00000001522","14",67963955,67981692,17737
"952","ENSBTAG00000001523","24",35592011,35656660,64649
"953","ENSBTAG00000001527","4",102461080,102467306,6226
"954","ENSBTAG00000001528","4",80952446,81075991,123545
"955","ENSBTAG00000001529","27",33427742,33524431,96689
"956","ENSBTAG00000001530","26",22503903,22509709,5806
"957","ENSBTAG00000001533","9",45142839,45261156,118317
"958","ENSBTAG00000001535","1",81636267,81688516,52249
"959","ENSBTAG00000001537","15",56179611,56193003,13392
"960","ENSBTAG00000001538","3",116879870,116880307,437
"961","ENSBTAG00000001539","10",43523556,43555390,31834
"962","ENSBTAG00000001543","17",50813518,50834720,21202
"963","ENSBTAG00000001545","6",45178485,45205946,27461
"964","ENSBTAG00000001546","7",39979972,39997227,17255
"965","ENSBTAG00000001548","3",14713270,14728924,15654
"966","ENSBTAG00000001551","10",76837233,76885380,48147
"967","ENSBTAG00000001552","13",33129771,33226614,96843
"968","ENSBTAG00000001553","5",25779619,25785642,6023
"969","ENSBTAG00000001557","20",31371360,31400007,28647
"970","ENSBTAG00000001558","10",103060241,103065307,5066
"971","ENSBTAG00000001562","5",25770431,25777479,7048
"972","ENSBTAG00000001564","3",22756471,23031334,274863
"973","ENSBTAG00000001565","21",26815328,26823843,8515
"974","ENSBTAG00000001567","21",5492271,5620369,128098
"975","ENSBTAG00000001568","7",30779209,30793006,13797
"976","ENSBTAG00000001570","7",22398938,22401303,2365
"977","ENSBTAG00000001571","4",9488265,9504398,16133
"978","ENSBTAG00000001572","6",59664104,59709244,45140
"979","ENSBTAG00000001573","28",19314567,19583951,269384
"980","ENSBTAG00000001574","16",20931434,21125771,194337
"981","ENSBTAG00000001575","11",29581381,29594347,12966
"982","ENSBTAG00000001576","4",98798511,98812609,14098
"983","ENSBTAG00000001578","10",19545921,19578538,32617
"984","ENSBTAG00000001579","14",3055942,3138226,82284
"985","ENSBTAG00000001580","17",17272256,17317333,45077
"986","ENSBTAG00000001582","4",98217455,98239457,22002
"987","ENSBTAG00000001585","2",22130033,22259090,129057
"988","ENSBTAG00000001586","3",20611449,20666228,54779
"989","ENSBTAG00000001589","12",76343402,76394962,51560
"990","ENSBTAG00000001592","4",117125786,117138560,12774
"991","ENSBTAG00000001593","17",52558149,52561400,3251
"992","ENSBTAG00000001594","17",52554256,52556184,1928
"993","ENSBTAG00000001595","18",24034444,24035790,1346
"994","ENSBTAG00000001597","17",52428786,52553696,124910
"995","ENSBTAG00000001598","9",74359538,74536882,177344
"996","ENSBTAG00000001599","3",20696426,20710108,13682
"997","ENSBTAG00000001600","6",67707010,67787380,80370
"998","ENSBTAG00000001601","10",19137899,19165177,27278
"999","ENSBTAG00000001602","25",24872629,24922650,50021
"1000","ENSBTAG00000001603","6",63238860,63272379,33519
"1001","ENSBTAG00000001605","10",91495432,91504569,9137
"1002","ENSBTAG00000001607","15",43311264,43339025,27761
"1003","ENSBTAG00000001608","3",6944920,6945777,857
"1004","ENSBTAG00000001609","19",61130415,61236793,106378
"1005","ENSBTAG00000001610","19",44065112,44082448,17336
"1006","ENSBTAG00000001612","27",33338482,33348971,10489
"1007","ENSBTAG00000001614","25",2838636,2845622,6986
"1008","ENSBTAG00000001615","19",44116205,44125810,9605
"1009","ENSBTAG00000001616","21",22396538,22454554,58016
"1010","ENSBTAG00000001617","21",41190632,41262640,72008
"1011","ENSBTAG00000001618","21",22458575,22510554,51979
"1012","ENSBTAG00000001619","10",11111559,11216841,105282
"1013","ENSBTAG00000001626","3",105201098,105280146,79048
"1014","ENSBTAG00000001627","2",58906951,58908468,1517
"1015","ENSBTAG00000001628","3",105195223,105198693,3470
"1016","ENSBTAG00000001629","3",104965053,105188608,223555
"1017","ENSBTAG00000001631","23",7570491,7585450,14959
"1018","ENSBTAG00000001632","19",43140344,43169417,29073
"1019","ENSBTAG00000001634","23",7586499,7592765,6266
"1020","ENSBTAG00000001635","23",7590427,7593632,3205
"1021","ENSBTAG00000001637","X",99086562,99097626,11064
"1022","ENSBTAG00000001638","17",2859932,2868867,8935
"1023","ENSBTAG00000001639","21",27494667,27527019,32352
"1024","ENSBTAG00000001640","13",65221138,65353703,132565
"1025","ENSBTAG00000001642","16",50249882,50263472,13590
"1026","ENSBTAG00000001644","9",60410450,60550024,139574
"1027","ENSBTAG00000001645","13",65359888,65380072,20184
"1028","ENSBTAG00000001647","7",21389365,21391998,2633
"1029","ENSBTAG00000001648","12",32614865,32621581,6716
"1030","ENSBTAG00000001649","14",58819937,59239114,419177
"1031","ENSBTAG00000001651","2",127725940,127731258,5318
"1032","ENSBTAG00000001652","21",14842445,15219453,377008
"1033","ENSBTAG00000001654","18",36384396,36449365,64969
"1034","ENSBTAG00000001656","28",35225744,35234488,8744
"1035","ENSBTAG00000001657","29",9519111,9620607,101496
"1036","ENSBTAG00000001658","4",101778335,101828543,50208
"1037","ENSBTAG00000001659","18",36458178,36468905,10727
"1038","ENSBTAG00000001660","29",26103453,26119994,16541
"1039","ENSBTAG00000001662","11",68659832,68688786,28954
"1040","ENSBTAG00000001663","18",36472274,36474195,1921
"1041","ENSBTAG00000001665","18",36474044,36480940,6896
"1042","ENSBTAG00000001666","18",36481173,36483945,2772
"1043","ENSBTAG00000001668","22",58146712,58210942,64230
"1044","ENSBTAG00000001671","10",36864199,36909769,45570
"1045","ENSBTAG00000001673","5",87691740,87783526,91786
"1046","ENSBTAG00000001675","10",36918794,36927140,8346
"1047","ENSBTAG00000001686","3",3394156,3416012,21856
"1048","ENSBTAG00000001687","8",70977521,70990673,13152
"1049","ENSBTAG00000001692","7",61814759,61899464,84705
"1050","ENSBTAG00000001693","10",36938808,36955679,16871
"1051","ENSBTAG00000001694","10",36960794,36979416,18622
"1052","ENSBTAG00000001696","17",2540688,2585719,45031
"1053","ENSBTAG00000001697","1",81287578,81307980,20402
"1054","ENSBTAG00000001698","18",36332461,36343407,10946
"1055","ENSBTAG00000001700","2",130732620,130787969,55349
"1056","ENSBTAG00000001702","19",27821338,27823573,2235
"1057","ENSBTAG00000001703","15",75297582,75339698,42116
"1058","ENSBTAG00000001704","15",15416388,15419435,3047
"1059","ENSBTAG00000001706","11",7335538,7424633,89095
"1060","ENSBTAG00000001707","7",38357664,38496216,138552
"1061","ENSBTAG00000001708","5",113942509,113959663,17154
"1062","ENSBTAG00000001710","22",6716565,6812479,95914
"1063","ENSBTAG00000001711","19",27831617,27833445,1828
"1064","ENSBTAG00000001712","22",6821790,6869725,47935
"1065","ENSBTAG00000001714","11",7432259,7442878,10619
"1066","ENSBTAG00000001717","19",27835752,27840596,4844
"1067","ENSBTAG00000001721","1",119150402,119191206,40804
"1068","ENSBTAG00000001724","24",3485651,3493191,7540
"1069","ENSBTAG00000001725","6",90882124,90884526,2402
"1070","ENSBTAG00000001727","16",50307835,50310990,3155
"1071","ENSBTAG00000001728","1",116623017,116652023,29006
"1072","ENSBTAG00000001729","16",25186203,25227307,41104
"1073","ENSBTAG00000001730","11",82862822,82866369,3547
"1074","ENSBTAG00000001731","25",3882636,3914409,31773
"1075","ENSBTAG00000001734","29",37137409,37147081,9672
"1076","ENSBTAG00000001735","19",44482064,44507278,25214
"1077","ENSBTAG00000001736","25",3918601,3946384,27783
"1078","ENSBTAG00000001737","8",79466141,79523806,57665
"1079","ENSBTAG00000001739","24",59887828,60100758,212930
"1080","ENSBTAG00000001740","21",20449001,20463676,14675
"1081","ENSBTAG00000001741","13",65492788,65636252,143464
"1082","ENSBTAG00000001744","11",82867458,82871788,4330
"1083","ENSBTAG00000001745","5",20971289,20978528,7239
"1084","ENSBTAG00000001747","9",80913163,80945209,32046
"1085","ENSBTAG00000001748","3",26099795,26109125,9330
"1086","ENSBTAG00000001749","1",81586790,81621312,34522
"1087","ENSBTAG00000001751","6",20701427,20704793,3366
"1088","ENSBTAG00000001752","9",80952916,80972653,19737
"1089","ENSBTAG00000001753","1",764121,820845,56724
"1090","ENSBTAG00000001754","4",93142664,93333822,191158
"1091","ENSBTAG00000001755","2",14923735,14926095,2360
"1092","ENSBTAG00000001762","7",4059596,4064801,5205
"1093","ENSBTAG00000001763","7",4057893,4060107,2214
"1094","ENSBTAG00000001764","7",4021099,4051470,30371
"1095","ENSBTAG00000001765","7",4011049,4015600,4551
"1096","ENSBTAG00000001767","7",39124716,39133235,8519
"1097","ENSBTAG00000001768","X",126701561,126743336,41775
"1098","ENSBTAG00000001770","24",46418523,46485877,67354
"1099","ENSBTAG00000001771","1",149567810,149711585,143775
"1100","ENSBTAG00000001772","6",70988566,71024317,35751
"1101","ENSBTAG00000001773","4",98812496,98814946,2450
"1102","ENSBTAG00000001774","12",55341982,55343875,1893
"1103","ENSBTAG00000001775","18",48583453,48594129,10676
"1104","ENSBTAG00000001776","18",48593799,48614115,20316
"1105","ENSBTAG00000001777","29",50556688,50559203,2515
"1106","ENSBTAG00000001778","18",48614217,48624966,10749
"1107","ENSBTAG00000001780","18",48630043,48639088,9045
"1108","ENSBTAG00000001781","18",52618777,52630573,11796
"1109","ENSBTAG00000001782","18",48639276,48641169,1893
"1110","ENSBTAG00000001785","13",52793538,52836265,42727
"1111","ENSBTAG00000001786","21",30885776,30914495,28719
"1112","ENSBTAG00000001788","16",54008203,54043523,35320
"1113","ENSBTAG00000001790","7",18682927,18711822,28895
"1114","ENSBTAG00000001792","7",18617143,18618572,1429
"1115","ENSBTAG00000001793","7",18611628,18616460,4832
"1116","ENSBTAG00000001794","7",18608950,18610219,1269
"1117","ENSBTAG00000001795","7",18590319,18608816,18497
"1118","ENSBTAG00000001796","7",18552769,18589512,36743
"1119","ENSBTAG00000001801","24",12650269,12660064,9795
"1120","ENSBTAG00000001803","9",53186120,53239319,53199
"1121","ENSBTAG00000001804","19",38989588,39004881,15293
"1122","ENSBTAG00000001805","24",41545935,41567726,21791
"1123","ENSBTAG00000001806","17",61200521,61225586,25065
"1124","ENSBTAG00000001807","7",7750424,7783434,33010
"1125","ENSBTAG00000001808","14",34328194,34360711,32517
"1126","ENSBTAG00000001809","X",98836526,98837418,892
"1127","ENSBTAG00000001810","5",34210393,34303160,92767
"1128","ENSBTAG00000001812","22",56187762,56218695,30933
"1129","ENSBTAG00000001814","22",56134781,56182636,47855
"1130","ENSBTAG00000001815","4",107620189,107650884,30695
"1131","ENSBTAG00000001816","7",4123914,4135054,11140
"1132","ENSBTAG00000001817","7",4105828,4120006,14178
"1133","ENSBTAG00000001818","7",4095668,4099712,4044
"1134","ENSBTAG00000001819","12",32083603,32089291,5688
"1135","ENSBTAG00000001821","16",38985133,39080464,95331
"1136","ENSBTAG00000001822","4",69587812,69655430,67618
"1137","ENSBTAG00000001823","20",4999725,5011125,11400
"1138","ENSBTAG00000001824","11",104361551,104368899,7348
"1139","ENSBTAG00000001825","19",38615465,38616592,1127
"1140","ENSBTAG00000001826","9",85531682,85857444,325762
"1141","ENSBTAG00000001827","13",54464648,54470909,6261
"1142","ENSBTAG00000001828","19",38623127,38626863,3736
"1143","ENSBTAG00000001829","13",54445511,54460268,14757
"1144","ENSBTAG00000001830","19",38627367,38631794,4427
"1145","ENSBTAG00000001832","19",38631948,38638738,6790
"1146","ENSBTAG00000001834","18",56210681,56216339,5658
"1147","ENSBTAG00000001835","9",29748660,29761667,13007
"1148","ENSBTAG00000001836","NKLS02000657.1",49547,54320,4773
"1149","ENSBTAG00000001838","18",34936769,34997794,61025
"1150","ENSBTAG00000001839","6",67528050,67539862,11812
"1151","ENSBTAG00000001840","11",10170214,10173993,3779
"1152","ENSBTAG00000001842","3",33652466,33655778,3312
"1153","ENSBTAG00000001843","11",10168029,10170419,2390
"1154","ENSBTAG00000001844","11",10164061,10167845,3784
"1155","ENSBTAG00000001845","3",33634806,33649761,14955
"1156","ENSBTAG00000001847","8",26894319,27246452,352133
"1157","ENSBTAG00000001848","18",25703200,25722420,19220
"1158","ENSBTAG00000001851","18",23983413,24015657,32244
"1159","ENSBTAG00000001852","18",24745103,24771960,26857
"1160","ENSBTAG00000001854","18",25430935,25444806,13871
"1161","ENSBTAG00000001855","18",25444184,25456211,12027
"1162","ENSBTAG00000001856","18",25458202,25466516,8314
"1163","ENSBTAG00000001857","18",25466472,25479315,12843
"1164","ENSBTAG00000001858","5",70564582,70565501,919
"1165","ENSBTAG00000001861","2",17618997,17764631,145634
"1166","ENSBTAG00000001862","7",57796185,58305705,509520
"1167","ENSBTAG00000001864","8",64872311,64912348,40037
"1168","ENSBTAG00000001865","12",34674912,34705884,30972
"1169","ENSBTAG00000001866","11",11505904,11523111,17207
"1170","ENSBTAG00000001867","12",34588236,34668349,80113
"1171","ENSBTAG00000001868","19",50982926,50990089,7163
"1172","ENSBTAG00000001870","10",21062394,21069248,6854
"1173","ENSBTAG00000001872","18",15013053,15021378,8325
"1174","ENSBTAG00000001874","22",49387098,49668868,281770
"1175","ENSBTAG00000001877","X",71422740,71432688,9948
"1176","ENSBTAG00000001879","3",117558885,117599971,41086
"1177","ENSBTAG00000001880","NKLS02002208.1",8368346,8380429,12083
"1178","ENSBTAG00000001881","10",81503834,81526924,23090
"1179","ENSBTAG00000001882","18",51344675,51348682,4007
"1180","ENSBTAG00000001886","X",18464264,18487317,23053
"1181","ENSBTAG00000001887","2",44006701,44053721,47020
"1182","ENSBTAG00000001888","17",58611134,58888297,277163
"1183","ENSBTAG00000001889","22",38977280,38992722,15442
"1184","ENSBTAG00000001890","1",70372268,70433147,60879
"1185","ENSBTAG00000001892","4",81286079,81291402,5323
"1186","ENSBTAG00000001893","1",118662871,118691339,28468
"1187","ENSBTAG00000001894","5",61105019,61157165,52146
"1188","ENSBTAG00000001895","10",4050987,4104900,53913
"1189","ENSBTAG00000001898","10",4108967,4139252,30285
"1190","ENSBTAG00000001899","2",33901113,34058080,156967
"1191","ENSBTAG00000001900","X",37631652,37634256,2604
"1192","ENSBTAG00000001901","7",42249836,42250249,413
"1193","ENSBTAG00000001902","29",1091859,1138116,46257
"1194","ENSBTAG00000001903","11",86644113,86651190,7077
"1195","ENSBTAG00000001904","18",14593024,14607123,14099
"1196","ENSBTAG00000001906","18",14606881,14644928,38047
"1197","ENSBTAG00000001908","4",48953177,48979994,26817
"1198","ENSBTAG00000001911","X",39843052,40101409,258357
"1199","ENSBTAG00000001912","4",106214482,106246339,31857
"1200","ENSBTAG00000001915","19",62601237,62624974,23737
"1201","ENSBTAG00000001917","15",43659784,43669709,9925
"1202","ENSBTAG00000001918","1",65607598,65930952,323354
"1203","ENSBTAG00000001919","19",37239569,37299157,59588
"1204","ENSBTAG00000001920","1",65944699,66053204,108505
"1205","ENSBTAG00000001922","15",43669705,43677217,7512
"1206","ENSBTAG00000001925","6",83534118,83573690,39572
"1207","ENSBTAG00000001926","8",97012935,97057375,44440
"1208","ENSBTAG00000001927","11",86882894,86942882,59988
"1209","ENSBTAG00000001928","11",86859610,86882947,23337
"1210","ENSBTAG00000001931","5",119556874,119564149,7275
"1211","ENSBTAG00000001932","11",99559586,99572474,12888
"1212","ENSBTAG00000001933","11",99573134,99604787,31653
"1213","ENSBTAG00000001936","13",58609003,58650153,41150
"1214","ENSBTAG00000001937","19",50994951,51000136,5185
"1215","ENSBTAG00000001938","8",88791395,88796446,5051
"1216","ENSBTAG00000001939","8",88755737,88789416,33679
"1217","ENSBTAG00000001941","8",88627168,88753669,126501
"1218","ENSBTAG00000001942","3",19085294,19166836,81542
"1219","ENSBTAG00000001945","10",79498980,79534600,35620
"1220","ENSBTAG00000001947","11",1962361,1969817,7456
"1221","ENSBTAG00000001948","10",79534828,79553034,18206
"1222","ENSBTAG00000001950","10",79556432,79566949,10517
"1223","ENSBTAG00000001952","11",2018028,2033977,15949
"1224","ENSBTAG00000001956","9",25326358,25340095,13737
"1225","ENSBTAG00000001957","9",25253397,25317010,63613
"1226","ENSBTAG00000001959","3",110179926,110194927,15001
"1227","ENSBTAG00000001961","20",9401263,9494370,93107
"1228","ENSBTAG00000001962","20",9285735,9390606,104871
"1229","ENSBTAG00000001966","27",19636210,19709829,73619
"1230","ENSBTAG00000001968","1",86372984,86382674,9690
"1231","ENSBTAG00000001969","1",86318896,86371093,52197
"1232","ENSBTAG00000001975","X",50913541,50956043,42502
"1233","ENSBTAG00000001976","4",64759541,64779923,20382
"1234","ENSBTAG00000001977","X",81897272,81922657,25385
"1235","ENSBTAG00000001979","X",50887515,50906397,18882
"1236","ENSBTAG00000001981","3",33226163,33281966,55803
"1237","ENSBTAG00000001983","5",28521680,28547602,25922
"1238","ENSBTAG00000001985","13",54119668,54125427,5759
"1239","ENSBTAG00000001987","15",42918200,43062549,144349
"1240","ENSBTAG00000001988","5",74925192,74939376,14184
"1241","ENSBTAG00000001992","4",9459764,9476713,16949
"1242","ENSBTAG00000001994","18",45936350,45942074,5724
"1243","ENSBTAG00000001996","18",55614187,55618814,4627
"1244","ENSBTAG00000001997","20",33443255,33514932,71677
"1245","ENSBTAG00000001998","19",55121131,55140468,19337
"1246","ENSBTAG00000001999","15",22383021,22393491,10470
"1247","ENSBTAG00000002000","15",22395340,22397325,1985
"1248","ENSBTAG00000002002","14",16473279,16519326,46047
"1249","ENSBTAG00000002004","5",47669190,47673186,3996
"1250","ENSBTAG00000002006","10",35209595,35224867,15272
"1251","ENSBTAG00000002007","15",80616545,80651796,35251
"1252","ENSBTAG00000002009","2",20883349,20884329,980
"1253","ENSBTAG00000002010","26",18819244,18845948,26704
"1254","ENSBTAG00000002011","4",60855915,60915546,59631
"1255","ENSBTAG00000002012","10",45880414,45895812,15398
"1256","ENSBTAG00000002014","10",45843188,45880562,37374
"1257","ENSBTAG00000002015","X",68487958,68686374,198416
"1258","ENSBTAG00000002018","19",27014948,27020485,5537
"1259","ENSBTAG00000002019","24",61700675,61754106,53431
"1260","ENSBTAG00000002020","20",4776513,4831767,55254
"1261","ENSBTAG00000002021","20",4841533,4854725,13192
"1262","ENSBTAG00000002023","17",57763560,57876534,112974
"1263","ENSBTAG00000002024","3",115664205,115735916,71711
"1264","ENSBTAG00000002025","5",33169556,33172868,3312
"1265","ENSBTAG00000002026","3",50629956,50639054,9098
"1266","ENSBTAG00000002027","2",121285361,121286953,1592
"1267","ENSBTAG00000002028","3",50499733,50629771,130038
"1268","ENSBTAG00000002029","1",139827395,139881435,54040
"1269","ENSBTAG00000002030","3",113703201,113730900,27699
"1270","ENSBTAG00000002033","11",75052239,75081213,28974
"1271","ENSBTAG00000002034","11",75034973,75047562,12589
"1272","ENSBTAG00000002036","19",39672840,39691127,18287
"1273","ENSBTAG00000002037","4",46703819,46757682,53863
"1274","ENSBTAG00000002038","22",13292655,13296110,3455
"1275","ENSBTAG00000002039","29",43582047,43603325,21278
"1276","ENSBTAG00000002041","X",13811114,13826009,14895
"1277","ENSBTAG00000002042","11",82873450,82878792,5342
"1278","ENSBTAG00000002044","11",82879486,82902135,22649
"1279","ENSBTAG00000002045","11",82902339,82922670,20331
"1280","ENSBTAG00000002046","11",82921987,82924620,2633
"1281","ENSBTAG00000002048","17",61736442,61802172,65730
"1282","ENSBTAG00000002049","6",17208776,17252208,43432
"1283","ENSBTAG00000002050","3",93648200,93667733,19533
"1284","ENSBTAG00000002051","15",52239474,52300725,61251
"1285","ENSBTAG00000002052","16",41718717,41748319,29602
"1286","ENSBTAG00000002055","18",63880404,63907053,26649
"1287","ENSBTAG00000002056","2",86189671,86191905,2234
"1288","ENSBTAG00000002058","9",32129224,32142119,12895
"1289","ENSBTAG00000002059","9",32099905,32218601,118696
"1290","ENSBTAG00000002060","19",39693965,39697803,3838
"1291","ENSBTAG00000002062","14",35611321,35666918,55597
"1292","ENSBTAG00000002065","13",59366399,59375952,9553
"1293","ENSBTAG00000002066","4",77178578,77181080,2502
"1294","ENSBTAG00000002068","3",9761198,9769010,7812
"1295","ENSBTAG00000002069","23",28720501,28724399,3898
"1296","ENSBTAG00000002070","18",52974216,52982797,8581
"1297","ENSBTAG00000002072","18",52982422,53006219,23797
"1298","ENSBTAG00000002073","20",10341517,10375453,33936
"1299","ENSBTAG00000002075","1",112478989,112595507,116518
"1300","ENSBTAG00000002076","14",36760791,37064486,303695
"1301","ENSBTAG00000002078","3",102343085,102382969,39884
"1302","ENSBTAG00000002080","14",44848527,44856903,8376
"1303","ENSBTAG00000002081","6",29373117,29593444,220327
"1304","ENSBTAG00000002082","9",36554305,36560717,6412
"1305","ENSBTAG00000002083","25",29782669,29817161,34492
"1306","ENSBTAG00000002084","6",29166321,29361530,195209
"1307","ENSBTAG00000002086","23",50086930,50111296,24366
"1308","ENSBTAG00000002089","23",50064704,50081070,16366
"1309","ENSBTAG00000002090","25",36959456,36971725,12269
"1310","ENSBTAG00000002092","23",10860919,10873149,12230
"1311","ENSBTAG00000002094","25",36953321,36958643,5322
"1312","ENSBTAG00000002095","29",43041118,43047766,6648
"1313","ENSBTAG00000002096","3",8000299,8008181,7882
"1314","ENSBTAG00000002097","25",17029435,17093394,63959
"1315","ENSBTAG00000002098","7",43173660,43180341,6681
"1316","ENSBTAG00000002099","24",45329690,45399916,70226
"1317","ENSBTAG00000002100","7",43181976,43188286,6310
"1318","ENSBTAG00000002101","25",17101520,17127013,25493
"1319","ENSBTAG00000002103","18",8314287,8467665,153378
"1320","ENSBTAG00000002104","14",1262194,1269340,7146
"1321","ENSBTAG00000002105","11",13428958,13436886,7928
"1322","ENSBTAG00000002107","4",8665915,8670064,4149
"1323","ENSBTAG00000002108","11",87861882,87893172,31290
"1324","ENSBTAG00000002110","10",10026069,10142758,116689
"1325","ENSBTAG00000002112","2",69756864,69786933,30069
"1326","ENSBTAG00000002113","X",85770992,85773115,2123
"1327","ENSBTAG00000002115","13",60724269,60743835,19566
"1328","ENSBTAG00000002116","13",60712826,60715529,2703
"1329","ENSBTAG00000002117","15",58720346,58806311,85965
"1330","ENSBTAG00000002121","29",45388454,45390820,2366
"1331","ENSBTAG00000002123","13",26492604,26661536,168932
"1332","ENSBTAG00000002125","24",42652184,42723588,71404
"1333","ENSBTAG00000002126","16",4873072,4900640,27568
"1334","ENSBTAG00000002127","5",69672951,69713610,40659
"1335","ENSBTAG00000002128","24",42723600,42737607,14007
"1336","ENSBTAG00000002129","12",47799472,47818754,19282
"1337","ENSBTAG00000002130","17",72403730,72419364,15634
"1338","ENSBTAG00000002132","1",58791091,58837917,46826
"1339","ENSBTAG00000002134","20",1768224,1792301,24077
"1340","ENSBTAG00000002135","5",100297983,100305080,7097
"1341","ENSBTAG00000002136","7",5368410,5395426,27016
"1342","ENSBTAG00000002137","12",11102039,11142794,40755
"1343","ENSBTAG00000002138","2",135349139,135393383,44244
"1344","ENSBTAG00000002139","16",29232214,29234055,1841
"1345","ENSBTAG00000002143","7",34850843,34923992,73149
"1346","ENSBTAG00000002144","7",60232706,60234735,2029
"1347","ENSBTAG00000002145","17",45241554,45266444,24890
"1348","ENSBTAG00000002147","22",28654373,28705579,51206
"1349","ENSBTAG00000002148","7",15736270,15747432,11162
"1350","ENSBTAG00000002150","23",24605962,24609483,3521
"1351","ENSBTAG00000002151","4",87910057,87942478,32421
"1352","ENSBTAG00000002154","4",59642395,59643306,911
"1353","ENSBTAG00000002157","4",87959332,87968300,8968
"1354","ENSBTAG00000002163","10",11826416,11838823,12407
"1355","ENSBTAG00000002164","16",60702774,60782705,79931
"1356","ENSBTAG00000002166","23",22413744,22439206,25462
"1357","ENSBTAG00000002167","16",60789069,60808338,19269
"1358","ENSBTAG00000002169","7",1692144,1693181,1037
"1359","ENSBTAG00000002170","21",36714178,36879180,165002
"1360","ENSBTAG00000002171","9",9517906,9672872,154966
"1361","ENSBTAG00000002174","5",94669118,94824113,154995
"1362","ENSBTAG00000002175","4",46296970,46536298,239328
"1363","ENSBTAG00000002176","25",24801771,24839867,38096
"1364","ENSBTAG00000002177","2",96557844,96625577,67733
"1365","ENSBTAG00000002178","25",3948864,3996463,47599
"1366","ENSBTAG00000002179","10",32243797,32473979,230182
"1367","ENSBTAG00000002180","2",96639050,96641189,2139
"1368","ENSBTAG00000002181","14",6400724,6544685,143961
"1369","ENSBTAG00000002182","1",64425088,64432940,7852
"1370","ENSBTAG00000002185","1",127214846,127222120,7274
"1371","ENSBTAG00000002186","21",1252109,1253718,1609
"1372","ENSBTAG00000002187","13",72915534,72932004,16470
"1373","ENSBTAG00000002188","25",4069987,4084630,14643
"1374","ENSBTAG00000002189","25",4088137,4103061,14924
"1375","ENSBTAG00000002190","8",44032278,44271335,239057
"1376","ENSBTAG00000002191","26",18603839,18632724,28885
"1377","ENSBTAG00000002192","14",30748671,30774944,26273
"1378","ENSBTAG00000002194","10",52607700,52719411,111711
"1379","ENSBTAG00000002199","6",66274892,66581597,306705
"1380","ENSBTAG00000002201","6",66591304,66652182,60878
"1381","ENSBTAG00000002202","25",1246615,1285603,38988
"1382","ENSBTAG00000002203","3",8290744,8300810,10066
"1383","ENSBTAG00000002205","6",66669318,66684719,15401
"1384","ENSBTAG00000002206","X",94980266,95154879,174613
"1385","ENSBTAG00000002209","25",1289631,1302440,12809
"1386","ENSBTAG00000002210","X",94949495,94970026,20531
"1387","ENSBTAG00000002211","25",1305450,1349482,44032
"1388","ENSBTAG00000002214","18",39435299,39493837,58538
"1389","ENSBTAG00000002215","7",864922,910376,45454
"1390","ENSBTAG00000002216","15",34794122,34796767,2645
"1391","ENSBTAG00000002219","16",51085081,51101450,16369
"1392","ENSBTAG00000002220","8",85780390,85846082,65692
"1393","ENSBTAG00000002223","18",40232966,40243001,10035
"1394","ENSBTAG00000002224","7",19223877,19257053,33176
"1395","ENSBTAG00000002226","18",12929727,12964773,35046
"1396","ENSBTAG00000002227","5",54560835,54612806,51971
"1397","ENSBTAG00000002231","16",54950134,54976476,26342
"1398","ENSBTAG00000002232","1",126259412,126320424,61012
"1399","ENSBTAG00000002233","18",25134033,25166257,32224
"1400","ENSBTAG00000002236","13",64304949,64374165,69216
"1401","ENSBTAG00000002238","29",43227243,43235042,7799
"1402","ENSBTAG00000002240","12",76118033,76121780,3747
"1403","ENSBTAG00000002242","18",25171517,25212248,40731
"1404","ENSBTAG00000002243","29",43242325,43254073,11748
"1405","ENSBTAG00000002245","29",25901997,25909995,7998
"1406","ENSBTAG00000002247","6",117268448,117297851,29403
"1407","ENSBTAG00000002248","29",43254529,43256984,2455
"1408","ENSBTAG00000002249","29",43256742,43272965,16223
"1409","ENSBTAG00000002251","5",60753106,60789924,36818
"1410","ENSBTAG00000002252","8",74555230,74572682,17452
"1411","ENSBTAG00000002253","25",33778901,33800968,22067
"1412","ENSBTAG00000002255","10",10191139,10214743,23604
"1413","ENSBTAG00000002256","5",44086246,44110850,24604
"1414","ENSBTAG00000002257","18",56996838,57000619,3781
"1415","ENSBTAG00000002258","15",27490875,27505442,14567
"1416","ENSBTAG00000002260","15",83443176,83503594,60418
"1417","ENSBTAG00000002261","26",22026546,22029801,3255
"1418","ENSBTAG00000002266","16",63847538,63886366,38828
"1419","ENSBTAG00000002267","19",36026569,36046087,19518
"1420","ENSBTAG00000002271","12",18867334,18895163,27829
"1421","ENSBTAG00000002272","2",89035588,89056404,20816
"1422","ENSBTAG00000002275","9",448438,458072,9634
"1423","ENSBTAG00000002277","7",18141671,18210109,68438
"1424","ENSBTAG00000002278","10",61653913,61919176,265263
"1425","ENSBTAG00000002279","19",35993171,36018642,25471
"1426","ENSBTAG00000002280","13",33326434,33372964,46530
"1427","ENSBTAG00000002281","7",2280015,2284684,4669
"1428","ENSBTAG00000002282","19",41907220,41909777,2557
"1429","ENSBTAG00000002283","2",90571270,90573476,2206
"1430","ENSBTAG00000002286","7",50680729,50712129,31400
"1431","ENSBTAG00000002287","18",21555470,21782071,226601
"1432","ENSBTAG00000002290","18",60759305,60768024,8719
"1433","ENSBTAG00000002291","16",76102444,76135565,33121
"1434","ENSBTAG00000002292","X",13491040,13564555,73515
"1435","ENSBTAG00000002293","2",44355896,44378831,22935
"1436","ENSBTAG00000002294","9",49484923,49554234,69311
"1437","ENSBTAG00000002295","2",21736325,21792993,56668
"1438","ENSBTAG00000002296","7",50736654,50743097,6443
"1439","ENSBTAG00000002297","2",44073031,44344826,271795
"1440","ENSBTAG00000002298","11",46451747,46473972,22225
"1441","ENSBTAG00000002299","6",45244640,45352956,108316
"1442","ENSBTAG00000002300","12",68965800,69006513,40713
"1443","ENSBTAG00000002302","15",64346582,64368108,21526
"1444","ENSBTAG00000002303","18",1931769,2059508,127739
"1445","ENSBTAG00000002305","7",43888437,43894724,6287
"1446","ENSBTAG00000002306","3",107941137,107957939,16802
"1447","ENSBTAG00000002309","22",52089753,52102048,12295
"1448","ENSBTAG00000002311","7",43895971,43901427,5456
"1449","ENSBTAG00000002313","5",82983642,83572811,589169
"1450","ENSBTAG00000002315","17",53772931,53797175,24244
"1451","ENSBTAG00000002316","2",989536,1034413,44877
"1452","ENSBTAG00000002317","4",100885905,100995239,109334
"1453","ENSBTAG00000002319","11",100580768,100757175,176407
"1454","ENSBTAG00000002321","22",50693259,50697601,4342
"1455","ENSBTAG00000002323","15",24336893,24399979,63086
"1456","ENSBTAG00000002326","10",67611143,67629446,18303
"1457","ENSBTAG00000002327","18",34855548,34857710,2162
"1458","ENSBTAG00000002328","17",53650953,53768578,117625
"1459","ENSBTAG00000002329","11",88030765,88187321,156556
"1460","ENSBTAG00000002331","10",67631639,67677160,45521
"1461","ENSBTAG00000002332","4",64014862,64018569,3707
"1462","ENSBTAG00000002333","6",71973666,71983218,9552
"1463","ENSBTAG00000002335","7",65748838,65752153,3315
"1464","ENSBTAG00000002336","21",67320835,67434291,113456
"1465","ENSBTAG00000002340","4",72378038,72407341,29303
"1466","ENSBTAG00000002341","29",31813186,31949833,136647
"1467","ENSBTAG00000002344","25",27087303,27092751,5448
"1468","ENSBTAG00000002345","25",27095052,27122818,27766
"1469","ENSBTAG00000002346","25",27119323,27122802,3479
"1470","ENSBTAG00000002347","7",5074524,5102746,28222
"1471","ENSBTAG00000002348","6",86381836,86809131,427295
"1472","ENSBTAG00000002349","25",27125156,27141974,16818
"1473","ENSBTAG00000002350","7",5060769,5073385,12616
"1474","ENSBTAG00000002352","25",21152984,21182424,29440
"1475","ENSBTAG00000002355","5",28936847,28954650,17803
"1476","ENSBTAG00000002356","6",59387155,59663515,276360
"1477","ENSBTAG00000002357","10",4427217,4444604,17387
"1478","ENSBTAG00000002361","16",3006671,3044514,37843
"1479","ENSBTAG00000002362","5",97047947,97051826,3879
"1480","ENSBTAG00000002363","2",125113996,125132377,18381
"1481","ENSBTAG00000002367","25",2439925,2441270,1345
"1482","ENSBTAG00000002368","18",55478717,55486893,8176
"1483","ENSBTAG00000002369","23",11125128,11148488,23360
"1484","ENSBTAG00000002370","18",45697194,45702143,4949
"1485","ENSBTAG00000002374","25",27493317,27500855,7538
"1486","ENSBTAG00000002376","23",10771195,10791508,20313
"1487","ENSBTAG00000002377","3",110137178,110174112,36934
"1488","ENSBTAG00000002378","18",55487884,55503747,15863
"1489","ENSBTAG00000002381","15",80912886,80931167,18281
"1490","ENSBTAG00000002382","15",18358195,18664995,306800
"1491","ENSBTAG00000002385","17",69600757,69607790,7033
"1492","ENSBTAG00000002389","15",80932192,80940778,8586
"1493","ENSBTAG00000002390","5",32109728,32111603,1875
"1494","ENSBTAG00000002391","25",27503118,27510659,7541
"1495","ENSBTAG00000002392","6",12225305,12311458,86153
"1496","ENSBTAG00000002393","23",10795467,10831744,36277
"1497","ENSBTAG00000002394","1",72908919,72956817,47898
"1498","ENSBTAG00000002395","1",118969378,119046161,76783
"1499","ENSBTAG00000002398","18",46899991,46905809,5818
"1500","ENSBTAG00000002401","5",26517673,26518582,909
"1501","ENSBTAG00000002402","9",96197493,96300017,102524
"1502","ENSBTAG00000002404","15",80941209,80949881,8672
"1503","ENSBTAG00000002407","16",60817250,60896041,78791
"1504","ENSBTAG00000002408","16",52086460,52251893,165433
"1505","ENSBTAG00000002411","15",80967264,81012627,45363
"1506","ENSBTAG00000002412","18",36548065,36571837,23772
"1507","ENSBTAG00000002413","5",113908102,113919965,11863
"1508","ENSBTAG00000002414","3",9603030,9638172,35142
"1509","ENSBTAG00000002415","21",32177531,32204399,26868
"1510","ENSBTAG00000002416","3",54790812,54882110,91298
"1511","ENSBTAG00000002417","29",12583654,12678622,94968
"1512","ENSBTAG00000002418","21",21011537,21053211,41674
"1513","ENSBTAG00000002419","3",9644360,9647791,3431
"1514","ENSBTAG00000002422","3",22002398,22098251,95853
"1515","ENSBTAG00000002423","19",49494955,49515377,20422
"1516","ENSBTAG00000002425","2",29996676,30088178,91502
"1517","ENSBTAG00000002428","6",19708709,19805633,96924
"1518","ENSBTAG00000002430","26",24591192,24638064,46872
"1519","ENSBTAG00000002431","4",102170007,102282310,112303
"1520","ENSBTAG00000002432","12",83604977,83618953,13976
"1521","ENSBTAG00000002434","7",43504777,43512448,7671
"1522","ENSBTAG00000002435","26",47395179,47501339,106160
"1523","ENSBTAG00000002440","21",21057493,21074608,17115
"1524","ENSBTAG00000002444","26",47507654,47537887,30233
"1525","ENSBTAG00000002445","4",112350445,112354984,4539
"1526","ENSBTAG00000002446","13",70633140,70633343,203
"1527","ENSBTAG00000002447","7",6498766,6520939,22173
"1528","ENSBTAG00000002448","14",20398321,20699673,301352
"1529","ENSBTAG00000002451","3",94953364,95003162,49798
"1530","ENSBTAG00000002452","17",68906700,68942712,36012
"1531","ENSBTAG00000002454","8",64255877,64260241,4364
"1532","ENSBTAG00000002455","6",102066192,102119154,52962
"1533","ENSBTAG00000002457","8",64260374,64268675,8301
"1534","ENSBTAG00000002458","20",36974339,37025868,51529
"1535","ENSBTAG00000002460","1",87536382,87567798,31416
"1536","ENSBTAG00000002462","1",87518534,87536139,17605
"1537","ENSBTAG00000002463","1",87503557,87518661,15104
"1538","ENSBTAG00000002464","16",50361199,50426588,65389
"1539","ENSBTAG00000002468","7",16968061,16969193,1132
"1540","ENSBTAG00000002469","7",16969536,16980780,11244
"1541","ENSBTAG00000002470","25",621018,625700,4682
"1542","ENSBTAG00000002471","22",25984691,26207536,222845
"1543","ENSBTAG00000002472","16",52000725,52023460,22735
"1544","ENSBTAG00000002473","7",17005585,17012660,7075
"1545","ENSBTAG00000002474","25",40984697,41222673,237976
"1546","ENSBTAG00000002475","7",17018658,17029983,11325
"1547","ENSBTAG00000002476","16",51959038,51998821,39783
"1548","ENSBTAG00000002477","25",40977160,40983409,6249
"1549","ENSBTAG00000002478","16",51949575,51958274,8699
"1550","ENSBTAG00000002479","16",50343101,50358696,15595
"1551","ENSBTAG00000002480","25",40971643,40975697,4054
"1552","ENSBTAG00000002481","25",625848,628530,2682
"1553","ENSBTAG00000002483","16",50339379,50341218,1839
"1554","ENSBTAG00000002484","25",628093,635930,7837
"1555","ENSBTAG00000002485","2",105902088,106118422,216334
"1556","ENSBTAG00000002487","21",2303028,2366406,63378
"1557","ENSBTAG00000002488","29",26253411,26286384,32973
"1558","ENSBTAG00000002489","3",31952318,31958001,5683
"1559","ENSBTAG00000002490","5",65511775,65543424,31649
"1560","ENSBTAG00000002492","5",65541083,65548189,7106
"1561","ENSBTAG00000002493","18",14984970,15012555,27585
"1562","ENSBTAG00000002495","7",7854283,7884854,30571
"1563","ENSBTAG00000002497","23",45206988,45255969,48981
"1564","ENSBTAG00000002500","26",23043063,23046230,3167
"1565","ENSBTAG00000002501","26",23046322,23054141,7819
"1566","ENSBTAG00000002503","29",41015970,41028767,12797
"1567","ENSBTAG00000002504","21",30828476,30879177,50701
"1568","ENSBTAG00000002505","2",125893878,125894870,992
"1569","ENSBTAG00000002507","24",45842148,45851502,9354
"1570","ENSBTAG00000002508","29",41024955,41027570,2615
"1571","ENSBTAG00000002510","29",41032884,41042489,9605
"1572","ENSBTAG00000002512","24",45853705,45864846,11141
"1573","ENSBTAG00000002515","18",62260692,62273071,12379
"1574","ENSBTAG00000002516","7",11886460,11899535,13075
"1575","ENSBTAG00000002518","6",99306821,99312032,5211
"1576","ENSBTAG00000002520","15",77288832,77368002,79170
"1577","ENSBTAG00000002522","18",62252338,62259163,6825
"1578","ENSBTAG00000002524","7",11879051,11885546,6495
"1579","ENSBTAG00000002525","7",11871938,11877365,5427
"1580","ENSBTAG00000002526","6",21762234,21789601,27367
"1581","ENSBTAG00000002527","7",11840008,11864893,24885
"1582","ENSBTAG00000002528","26",39243366,39274462,31096
"1583","ENSBTAG00000002531","17",10027735,10405085,377350
"1584","ENSBTAG00000002534","23",47367326,47383134,15808
"1585","ENSBTAG00000002539","5",109532805,109591861,59056
"1586","ENSBTAG00000002542","11",47993772,48008161,14389
"1587","ENSBTAG00000002549","2",119414107,119419022,4915
"1588","ENSBTAG00000002550","6",60856459,60859886,3427
"1589","ENSBTAG00000002551","5",88434139,88442014,7875
"1590","ENSBTAG00000002554","4",107019305,107070624,51319
"1591","ENSBTAG00000002555","3",99025649,99050629,24980
"1592","ENSBTAG00000002557","11",44019398,44030213,10815
"1593","ENSBTAG00000002559","5",119793804,119796392,2588
"1594","ENSBTAG00000002561","X",87136473,87152941,16468
"1595","ENSBTAG00000002562","X",87153484,87157001,3517
"1596","ENSBTAG00000002563","X",87156551,87161774,5223
"1597","ENSBTAG00000002564","19",26909315,26932146,22831
"1598","ENSBTAG00000002565","X",87174997,87175641,644
"1599","ENSBTAG00000002566","7",4821776,4861321,39545
"1600","ENSBTAG00000002568","X",87178864,87205748,26884
"1601","ENSBTAG00000002570","11",30751958,30824312,72354
"1602","ENSBTAG00000002571","18",44817570,44835839,18269
"1603","ENSBTAG00000002573","18",44841845,44872496,30651
"1604","ENSBTAG00000002574","6",6097581,6135997,38416
"1605","ENSBTAG00000002575","16",51053560,51078042,24482
"1606","ENSBTAG00000002576","10",58951441,59006267,54826
"1607","ENSBTAG00000002578","13",46836953,46913156,76203
"1608","ENSBTAG00000002579","18",49388469,49400788,12319
"1609","ENSBTAG00000002580","18",56416654,56489716,73062
"1610","ENSBTAG00000002581","23",7072118,7078464,6346
"1611","ENSBTAG00000002583","3",108330553,108338022,7469
"1612","ENSBTAG00000002585","X",76549545,76681860,132315
"1613","ENSBTAG00000002586","10",53024862,53083831,58969
"1614","ENSBTAG00000002590","16",42522478,42544954,22476
"1615","ENSBTAG00000002591","17",63377041,63399500,22459
"1616","ENSBTAG00000002593","13",72715528,72740133,24605
"1617","ENSBTAG00000002594","2",129478393,129483457,5064
"1618","ENSBTAG00000002595","4",29354689,29474876,120187
"1619","ENSBTAG00000002596","18",61698117,61717831,19714
"1620","ENSBTAG00000002599","17",18399763,18411428,11665
"1621","ENSBTAG00000002600","3",81994568,82051985,57417
"1622","ENSBTAG00000002603","21",54809297,54844780,35483
"1623","ENSBTAG00000002604","4",29493047,29495564,2517
"1624","ENSBTAG00000002605","19",33033891,33049418,15527
"1625","ENSBTAG00000002606","15",58091974,58197387,105413
"1626","ENSBTAG00000002608","3",120482707,120511035,28328
"1627","ENSBTAG00000002609","19",21398194,21413013,14819
"1628","ENSBTAG00000002610","21",54845025,54855283,10258
"1629","ENSBTAG00000002612","21",54856691,54947082,90391
"1630","ENSBTAG00000002613","21",54868741,54965815,97074
"1631","ENSBTAG00000002614","28",24764873,24807564,42691
"1632","ENSBTAG00000002615","X",3392334,3446077,53743
"1633","ENSBTAG00000002620","28",24811860,24849160,37300
"1634","ENSBTAG00000002623","1",22617489,22675629,58140
"1635","ENSBTAG00000002624","24",45737786,45832060,94274
"1636","ENSBTAG00000002625","9",59679581,59744280,64699
"1637","ENSBTAG00000002626","NKLS02002210.1",216694,276092,59398
"1638","ENSBTAG00000002627","3",74146776,74163809,17033
"1639","ENSBTAG00000002628","7",15097948,15130761,32813
"1640","ENSBTAG00000002629","7",16368804,16373988,5184
"1641","ENSBTAG00000002630","5",111740795,111851021,110226
"1642","ENSBTAG00000002631","5",103993588,104018792,25204
"1643","ENSBTAG00000002632","6",85449164,85457744,8580
"1644","ENSBTAG00000002633","19",54497005,54676832,179827
"1645","ENSBTAG00000002635","18",53513706,53515925,2219
"1646","ENSBTAG00000002639","18",11109980,11118371,8391
"1647","ENSBTAG00000002640","1",68647206,68942661,295455
"1648","ENSBTAG00000002642","23",31959620,31977850,18230
"1649","ENSBTAG00000002643","23",7428093,7446296,18203
"1650","ENSBTAG00000002644","3",105375258,105433489,58231
"1651","ENSBTAG00000002645","7",42598262,42612110,13848
"1652","ENSBTAG00000002646","2",24765631,24819628,53997
"1653","ENSBTAG00000002647","26",39633276,39674155,40879
"1654","ENSBTAG00000002648","23",7446374,7451062,4688
"1655","ENSBTAG00000002650","15",27432686,27441859,9173
"1656","ENSBTAG00000002651","5",77001511,77154610,153099
"1657","ENSBTAG00000002654","19",42139364,42169593,30229
"1658","ENSBTAG00000002655","26",2809079,2813938,4859
"1659","ENSBTAG00000002657","19",42171684,42176531,4847
"1660","ENSBTAG00000002658","13",32099284,32155816,56532
"1661","ENSBTAG00000002661","21",34556000,34560183,4183
"1662","ENSBTAG00000002663","19",11982264,12286297,304033
"1663","ENSBTAG00000002664","19",45336095,45341333,5238
"1664","ENSBTAG00000002668","X",66972303,67003075,30772
"1665","ENSBTAG00000002669","28",44592405,44626362,33957
"1666","ENSBTAG00000002670","28",44606757,44608180,1423
"1667","ENSBTAG00000002673","5",28040793,28042763,1970
"1668","ENSBTAG00000002674","4",11210209,11235219,25010
"1669","ENSBTAG00000002675","13",20238095,20288065,49970
"1670","ENSBTAG00000002676","18",54170188,54232475,62287
"1671","ENSBTAG00000002678","2",125068641,125074216,5575
"1672","ENSBTAG00000002680","19",15463728,15480095,16367
"1673","ENSBTAG00000002682","18",52923089,52952700,29611
"1674","ENSBTAG00000002683","13",45107041,45161102,54061
"1675","ENSBTAG00000002685","13",45081151,45107887,26736
"1676","ENSBTAG00000002687","18",41847634,41916280,68646
"1677","ENSBTAG00000002688","16",36759212,36784818,25606
"1678","ENSBTAG00000002689","16",36784549,37029908,245359
"1679","ENSBTAG00000002690","16",37030114,37052446,22332
"1680","ENSBTAG00000002691","15",17111122,17196356,85234
"1681","ENSBTAG00000002693","5",31099793,31117905,18112
"1682","ENSBTAG00000002695","17",63725969,63733889,7920
"1683","ENSBTAG00000002697","17",63696948,63726368,29420
"1684","ENSBTAG00000002698","17",63650234,63696918,46684
"1685","ENSBTAG00000002699","6",70166692,70254044,87352
"1686","ENSBTAG00000002700","2",132688158,132690759,2601
"1687","ENSBTAG00000002701","20",38153885,38230788,76903
"1688","ENSBTAG00000002702","29",49265271,49282523,17252
"1689","ENSBTAG00000002703","1",58434456,58495220,60764
"1690","ENSBTAG00000002704","10",88474801,88521545,46744
"1691","ENSBTAG00000002705","10",20976598,20982410,5812
"1692","ENSBTAG00000002706","10",88528915,88537179,8264
"1693","ENSBTAG00000002707","10",20966510,20976590,10080
"1694","ENSBTAG00000002708","5",23269801,23300622,30821
"1695","ENSBTAG00000002709","10",20962178,20967158,4980
"1696","ENSBTAG00000002710","10",20949085,20955298,6213
"1697","ENSBTAG00000002712","10",20946293,20947792,1499
"1698","ENSBTAG00000002714","4",40956253,41062151,105898
"1699","ENSBTAG00000002715","10",20929689,20936187,6498
"1700","ENSBTAG00000002716","11",86971480,87061426,89946
"1701","ENSBTAG00000002717","26",23887978,23900120,12142
"1702","ENSBTAG00000002718","10",20926605,20932421,5816
"1703","ENSBTAG00000002719","3",93962136,93993700,31564
"1704","ENSBTAG00000002720","3",93934635,93956227,21592
"1705","ENSBTAG00000002721","3",93801866,93931333,129467
"1706","ENSBTAG00000002724","3",20016351,20036229,19878
"1707","ENSBTAG00000002725","9",61102065,61335342,233277
"1708","ENSBTAG00000002726","19",46204190,46261649,57459
"1709","ENSBTAG00000002727","2",124922940,125007155,84215
"1710","ENSBTAG00000002728","9",93406676,93842614,435938
"1711","ENSBTAG00000002730","8",10593713,10712508,118795
"1712","ENSBTAG00000002733","29",24757938,24762760,4822
"1713","ENSBTAG00000002734","7",14670931,14675554,4623
"1714","ENSBTAG00000002735","25",544098,546240,2142
"1715","ENSBTAG00000002736","7",14686995,14730720,43725
"1716","ENSBTAG00000002737","25",541147,543770,2623
"1717","ENSBTAG00000002738","7",14748494,14756256,7762
"1718","ENSBTAG00000002739","4",64554173,64715670,161497
"1719","ENSBTAG00000002742","11",29804956,29886276,81320
"1720","ENSBTAG00000002743","10",26673858,26680410,6552
"1721","ENSBTAG00000002744","8",100188591,100282649,94058
"1722","ENSBTAG00000002745","10",26670901,26673480,2579
"1723","ENSBTAG00000002746","8",51153923,51214968,61045
"1724","ENSBTAG00000002747","19",61281114,61342630,61516
"1725","ENSBTAG00000002748","10",26667296,26670811,3515
"1726","ENSBTAG00000002749","19",45791345,45843559,52214
"1727","ENSBTAG00000002750","4",9528416,9567814,39398
"1728","ENSBTAG00000002751","29",974953,1003566,28613
"1729","ENSBTAG00000002755","24",41438728,41534782,96054
"1730","ENSBTAG00000002756","8",72822379,72865583,43204
"1731","ENSBTAG00000002763","18",46433498,46453413,19915
"1732","ENSBTAG00000002764","18",46454243,46457233,2990
"1733","ENSBTAG00000002765","13",81592182,81610449,18267
"1734","ENSBTAG00000002767","1",87648347,87716734,68387
"1735","ENSBTAG00000002768","X",87019616,87026985,7369
"1736","ENSBTAG00000002769","18",39291352,39347633,56281
"1737","ENSBTAG00000002770","17",69579507,69597093,17586
"1738","ENSBTAG00000002772","29",44124187,44134874,10687
"1739","ENSBTAG00000002773","19",56700260,56719162,18902
"1740","ENSBTAG00000002774","22",52263501,52284441,20940
"1741","ENSBTAG00000002775","5",82248112,82251155,3043
"1742","ENSBTAG00000002778","29",44136952,44151425,14473
"1743","ENSBTAG00000002779","20",2680474,2707201,26727
"1744","ENSBTAG00000002782","5",112434864,112492002,57138
"1745","ENSBTAG00000002783","11",68588196,68599750,11554
"1746","ENSBTAG00000002784","14",31193319,31212995,19676
"1747","ENSBTAG00000002786","21",19763827,19771209,7382
"1748","ENSBTAG00000002788","24",54084316,54254593,170277
"1749","ENSBTAG00000002791","28",29639357,29662099,22742
"1750","ENSBTAG00000002792","28",29662120,29665188,3068
"1751","ENSBTAG00000002795","22",14740410,14792046,51636
"1752","ENSBTAG00000002796","7",49069108,49190970,121862
"1753","ENSBTAG00000002798","5",57097196,57103340,6144
"1754","ENSBTAG00000002799","5",57091706,57097226,5520
"1755","ENSBTAG00000002803","11",44906839,44921512,14673
"1756","ENSBTAG00000002804","7",61474501,61511284,36783
"1757","ENSBTAG00000002808","10",70551104,70576344,25240
"1758","ENSBTAG00000002809","3",119973442,119983832,10390
"1759","ENSBTAG00000002810","4",112434391,112462421,28030
"1760","ENSBTAG00000002813","17",14421800,14549193,127393
"1761","ENSBTAG00000002816","19",19861214,19881877,20663
"1762","ENSBTAG00000002817","19",19884289,19891906,7617
"1763","ENSBTAG00000002820","X",126676491,126698130,21639
"1764","ENSBTAG00000002822","13",65100388,65148653,48265
"1765","ENSBTAG00000002823","3",915375,997233,81858
"1766","ENSBTAG00000002824","18",35453707,35457746,4039
"1767","ENSBTAG00000002826","3",110021003,110047343,26340
"1768","ENSBTAG00000002827","9",96029107,96044723,15616
"1769","ENSBTAG00000002828","17",70019989,70032807,12818
"1770","ENSBTAG00000002829","9",96044639,96055563,10924
"1771","ENSBTAG00000002830","18",61879206,61892127,12921
"1772","ENSBTAG00000002833","21",31190820,31217122,26302
"1773","ENSBTAG00000002834","7",62434491,62469969,35478
"1774","ENSBTAG00000002835","17",12740787,12823604,82817
"1775","ENSBTAG00000002836","13",15965644,16086403,120759
"1776","ENSBTAG00000002837","11",100188040,100195167,7127
"1777","ENSBTAG00000002842","10",84922429,84971868,49439
"1778","ENSBTAG00000002843","10",84987893,84992172,4279
"1779","ENSBTAG00000002844","18",55631634,55653483,21849
"1780","ENSBTAG00000002845","20",48811787,48998130,186343
"1781","ENSBTAG00000002846","16",73524525,73550750,26225
"1782","ENSBTAG00000002847","3",120765583,120791784,26201
"1783","ENSBTAG00000002848","16",73522276,73524532,2256
"1784","ENSBTAG00000002849","16",73502081,73518531,16450
"1785","ENSBTAG00000002850","19",14519263,14535861,16598
"1786","ENSBTAG00000002853","18",55653320,55661187,7867
"1787","ENSBTAG00000002854","16",28871494,28904166,32672
"1788","ENSBTAG00000002856","13",29595687,29612617,16930
"1789","ENSBTAG00000002858","13",29654035,29660465,6430
"1790","ENSBTAG00000002859","4",82720173,82744666,24493
"1791","ENSBTAG00000002863","24",49442439,49478083,35644
"1792","ENSBTAG00000002865","20",2381094,2641564,260470
"1793","ENSBTAG00000002866","11",47351626,47386204,34578
"1794","ENSBTAG00000002868","9",40221514,40223897,2383
"1795","ENSBTAG00000002869","4",20764660,20766198,1538
"1796","ENSBTAG00000002871","25",36357122,36359887,2765
"1797","ENSBTAG00000002874","16",719778,735546,15768
"1798","ENSBTAG00000002878","1",82803353,82813103,9750
"1799","ENSBTAG00000002879","29",29649010,29691817,42807
"1800","ENSBTAG00000002880","26",16820342,17053812,233470
"1801","ENSBTAG00000002881","25",36343187,36349788,6601
"1802","ENSBTAG00000002882","7",27122942,27175858,52916
"1803","ENSBTAG00000002883","19",51687441,52010821,323380
"1804","ENSBTAG00000002885","27",20909874,20990586,80712
"1805","ENSBTAG00000002887","15",4390043,4392103,2060
"1806","ENSBTAG00000002888","5",12219074,12575593,356519
"1807","ENSBTAG00000002890","X",85531597,85557443,25846
"1808","ENSBTAG00000002891","4",116984176,117001715,17539
"1809","ENSBTAG00000002894","16",40818295,40838305,20010
"1810","ENSBTAG00000002895","6",30714651,30716815,2164
"1811","ENSBTAG00000002896","1",158238278,158293060,54782
"1812","ENSBTAG00000002898","19",14913862,14947268,33406
"1813","ENSBTAG00000002900","10",98287119,98288935,1816
"1814","ENSBTAG00000002902","5",34878194,35016323,138129
"1815","ENSBTAG00000002904","18",63496846,63512692,15846
"1816","ENSBTAG00000002907","15",53454345,53526389,72044
"1817","ENSBTAG00000002908","28",8295602,8364199,68597
"1818","ENSBTAG00000002910","3",93434006,93464715,30709
"1819","ENSBTAG00000002914","15",41064073,41420001,355928
"1820","ENSBTAG00000002915","9",53021359,53022618,1259
"1821","ENSBTAG00000002917","4",114086044,114415801,329757
"1822","ENSBTAG00000002918","10",36255232,36291194,35962
"1823","ENSBTAG00000002919","23",14951493,14963734,12241
"1824","ENSBTAG00000002920","28",30630524,30812165,181641
"1825","ENSBTAG00000002921","10",36291370,36306626,15256
"1826","ENSBTAG00000002922","29",17610531,17792365,181834
"1827","ENSBTAG00000002923","22",12569452,12583576,14124
"1828","ENSBTAG00000002924","28",30816846,30848848,32002
"1829","ENSBTAG00000002928","6",85903762,85917242,13480
"1830","ENSBTAG00000002929","23",52201686,52218895,17209
"1831","ENSBTAG00000002931","5",43762572,43817060,54488
"1832","ENSBTAG00000002934","23",20752000,20764795,12795
"1833","ENSBTAG00000002935","25",28293459,28319832,26373
"1834","ENSBTAG00000002936","11",100059513,100110784,51271
"1835","ENSBTAG00000002937","7",11127788,11181459,53671
"1836","ENSBTAG00000002938","4",85491227,85814161,322934
"1837","ENSBTAG00000002939","21",21780694,21793171,12477
"1838","ENSBTAG00000002940","4",85839505,85850836,11331
"1839","ENSBTAG00000002941","21",21768206,21780459,12253
"1840","ENSBTAG00000002942","13",75368025,75380832,12807
"1841","ENSBTAG00000002944","2",21688062,21691528,3466
"1842","ENSBTAG00000002947","3",8760842,8788290,27448
"1843","ENSBTAG00000002948","22",52450147,52509045,58898
"1844","ENSBTAG00000002949","19",38395615,38414767,19152
"1845","ENSBTAG00000002950","17",47426664,48084896,658232
"1846","ENSBTAG00000002951","3",8695315,8755426,60111
"1847","ENSBTAG00000002952","3",234607,260894,26287
"1848","ENSBTAG00000002953","8",99799187,99811602,12415
"1849","ENSBTAG00000002956","X",97435741,97465361,29620
"1850","ENSBTAG00000002959","12",16492597,16706784,214187
"1851","ENSBTAG00000002960","22",48629513,48648118,18605
"1852","ENSBTAG00000002962","22",48649439,48658495,9056
"1853","ENSBTAG00000002963","29",26470078,26482492,12414
"1854","ENSBTAG00000002964","9",76913942,76973629,59687
"1855","ENSBTAG00000002965","11",2518213,2526093,7880
"1856","ENSBTAG00000002966","1",137051554,137215251,163697
"1857","ENSBTAG00000002970","12",20817642,20903002,85360
"1858","ENSBTAG00000002971","26",20681351,20714718,33367
"1859","ENSBTAG00000002972","5",84818340,84887228,68888
"1860","ENSBTAG00000002973","26",12493145,12521099,27954
"1861","ENSBTAG00000002974","16",38756046,38800243,44197
"1862","ENSBTAG00000002976","18",51546288,51557282,10994
"1863","ENSBTAG00000002977","2",131324608,131449347,124739
"1864","ENSBTAG00000002978","6",95880840,96003620,122780
"1865","ENSBTAG00000002979","3",99963094,100063831,100737
"1866","ENSBTAG00000002980","18",15315872,15349193,33321
"1867","ENSBTAG00000002981","19",25412105,25416732,4627
"1868","ENSBTAG00000002982","19",25321703,25411010,89307
"1869","ENSBTAG00000002983","3",106403642,106419979,16337
"1870","ENSBTAG00000002985","20",2255766,2270188,14422
"1871","ENSBTAG00000002988","2",127542968,127609384,66416
"1872","ENSBTAG00000002993","9",101304152,101319276,15124
"1873","ENSBTAG00000002995","2",107429346,107436451,7105
"1874","ENSBTAG00000002996","X",88412754,88541873,129119
"1875","ENSBTAG00000002997","8",25327872,25821153,493281
"1876","ENSBTAG00000002998","1",71476619,71500652,24033
"1877","ENSBTAG00000002999","15",51742235,51745610,3375
"1878","ENSBTAG00000003000","15",51737390,51742158,4768
"1879","ENSBTAG00000003001","15",51729852,51736203,6351
"1880","ENSBTAG00000003002","2",6935086,6976756,41670
"1881","ENSBTAG00000003006","10",26541378,26542004,626
"1882","ENSBTAG00000003012","8",110293213,110317276,24063
"1883","ENSBTAG00000003014","19",33213076,33230717,17641
"1884","ENSBTAG00000003015","9",41069671,41183444,113773
"1885","ENSBTAG00000003016","16",80420337,80428748,8411
"1886","ENSBTAG00000003017","5",116584847,116609098,24251
"1887","ENSBTAG00000003018","7",43279471,43285849,6378
"1888","ENSBTAG00000003019","4",113974519,113980489,5970
"1889","ENSBTAG00000003020","25",34416156,34428404,12248
"1890","ENSBTAG00000003021","5",26607778,26642792,35014
"1891","ENSBTAG00000003022","22",51574749,51576697,1948
"1892","ENSBTAG00000003025","22",51557935,51564695,6760
"1893","ENSBTAG00000003027","26",37830786,37837033,6247
"1894","ENSBTAG00000003030","13",54187005,54214516,27511
"1895","ENSBTAG00000003033","8",88508004,88509798,1794
"1896","ENSBTAG00000003034","7",3816749,3913344,96595
"1897","ENSBTAG00000003035","24",32256373,32287095,30722
"1898","ENSBTAG00000003036","5",10849058,11349736,500678
"1899","ENSBTAG00000003038","23",7138546,7169274,30728
"1900","ENSBTAG00000003039","23",7173038,7176410,3372
"1901","ENSBTAG00000003040","13",67377908,67449822,71914
"1902","ENSBTAG00000003043","10",44659979,44794168,134189
"1903","ENSBTAG00000003044","8",89648862,89730513,81651
"1904","ENSBTAG00000003045","13",36021693,36028577,6884
"1905","ENSBTAG00000003047","7",34238240,34241776,3536
"1906","ENSBTAG00000003049","25",41461263,41480286,19023
"1907","ENSBTAG00000003051","7",107827212,108280766,453554
"1908","ENSBTAG00000003052","15",27895050,27922597,27547
"1909","ENSBTAG00000003054","3",13991619,14008734,17115
"1910","ENSBTAG00000003058","13",54939568,54945372,5804
"1911","ENSBTAG00000003059","1",2924656,2936276,11620
"1912","ENSBTAG00000003060","3",13971853,13989966,18113
"1913","ENSBTAG00000003061","13",54887682,54938873,51191
"1914","ENSBTAG00000003062","26",35277610,35312293,34683
"1915","ENSBTAG00000003063","1",2827691,2916599,88908
"1916","ENSBTAG00000003064","1",2786812,2819637,32825
"1917","ENSBTAG00000003066","20",6742915,6750047,7132
"1918","ENSBTAG00000003067","11",95402062,95459519,57457
"1919","ENSBTAG00000003068","17",517313,534143,16830
"1920","ENSBTAG00000003069","2",127292652,127444339,151687
"1921","ENSBTAG00000003072","19",26934465,26940043,5578
"1922","ENSBTAG00000003073","29",42281442,42295820,14378
"1923","ENSBTAG00000003074","19",61867803,61877805,10002
"1924","ENSBTAG00000003075","19",26940118,26948320,8202
"1925","ENSBTAG00000003076","9",34459444,34566772,107328
"1926","ENSBTAG00000003077","29",43538728,43551516,12788
"1927","ENSBTAG00000003078","9",34539776,34547373,7597
"1928","ENSBTAG00000003079","29",43555590,43557005,1415
"1929","ENSBTAG00000003081","27",14366891,14375065,8174
"1930","ENSBTAG00000003083","3",15463443,15465501,2058
"1931","ENSBTAG00000003084","10",87459365,87517588,58223
"1932","ENSBTAG00000003086","7",32314547,32314939,392
"1933","ENSBTAG00000003087","15",5477588,5506305,28717
"1934","ENSBTAG00000003088","X",105734791,105847786,112995
"1935","ENSBTAG00000003089","18",43404074,43474596,70522
"1936","ENSBTAG00000003090","10",72158409,72268307,109898
"1937","ENSBTAG00000003092","17",53827403,53862505,35102
"1938","ENSBTAG00000003093","29",44050324,44059798,9474
"1939","ENSBTAG00000003094","29",44060063,44075021,14958
"1940","ENSBTAG00000003097","8",24922544,25040129,117585
"1941","ENSBTAG00000003098","14",66507284,66561450,54166
"1942","ENSBTAG00000003100","17",69938495,69961375,22880
"1943","ENSBTAG00000003101","13",79567590,79583485,15895
"1944","ENSBTAG00000003102","4",91811881,91815933,4052
"1945","ENSBTAG00000003107","17",60981921,60991655,9734
"1946","ENSBTAG00000003108","11",14324110,14370453,46343
"1947","ENSBTAG00000003109","12",18036161,18061776,25615
"1948","ENSBTAG00000003110","22",32582496,32789965,207469
"1949","ENSBTAG00000003111","15",17853846,17996481,142635
"1950","ENSBTAG00000003112","22",17219839,17239593,19754
"1951","ENSBTAG00000003114","4",63956366,64010228,53862
"1952","ENSBTAG00000003115","4",63912710,63925721,13011
"1953","ENSBTAG00000003116","12",33932065,33952151,20086
"1954","ENSBTAG00000003120","2",17076721,17440980,364259
"1955","ENSBTAG00000003121","X",56135102,56220570,85468
"1956","ENSBTAG00000003124","8",244184,374863,130679
"1957","ENSBTAG00000003126","15",75941284,75946922,5638
"1958","ENSBTAG00000003128","3",97776435,97942867,166432
"1959","ENSBTAG00000003130","21",30972987,30991984,18997
"1960","ENSBTAG00000003131","6",10482289,10799267,316978
"1961","ENSBTAG00000003132","21",30995468,31015323,19855
"1962","ENSBTAG00000003134","1",143317096,143319925,2829
"1963","ENSBTAG00000003135","1",108226813,108249139,22326
"1964","ENSBTAG00000003137","8",90738106,91044783,306677
"1965","ENSBTAG00000003140","1",80690735,80696502,5767
"1966","ENSBTAG00000003143","1",80666383,80688899,22516
"1967","ENSBTAG00000003144","7",93522660,93911993,389333
"1968","ENSBTAG00000003147","3",80444566,80584006,139440
"1969","ENSBTAG00000003148","1",145931228,145971979,40751
"1970","ENSBTAG00000003151","1",80643739,80661936,18197
"1971","ENSBTAG00000003152","21",58735482,58744443,8961
"1972","ENSBTAG00000003155","21",58753793,58756455,2662
"1973","ENSBTAG00000003160","25",35968840,35982270,13430
"1974","ENSBTAG00000003161","1",145972840,145977560,4720
"1975","ENSBTAG00000003162","3",69989882,70019359,29477
"1976","ENSBTAG00000003163","13",54837647,54852333,14686
"1977","ENSBTAG00000003165","22",36760610,36922968,162358
"1978","ENSBTAG00000003166","18",50402713,50437704,34991
"1979","ENSBTAG00000003168","18",50440559,50474318,33759
"1980","ENSBTAG00000003169","25",35960544,35968828,8284
"1981","ENSBTAG00000003171","29",47561091,48119060,557969
"1982","ENSBTAG00000003172","10",32547550,32770681,223131
"1983","ENSBTAG00000003174","9",52882686,52891447,8761
"1984","ENSBTAG00000003176","29",32993975,33024632,30657
"1985","ENSBTAG00000003177","16",43916567,43946700,30133
"1986","ENSBTAG00000003178","26",41668494,41825813,157319
"1987","ENSBTAG00000003180","16",43890229,43911977,21748
"1988","ENSBTAG00000003183","5",60031676,60161682,130006
"1989","ENSBTAG00000003184","X",86899824,86906499,6675
"1990","ENSBTAG00000003185","14",10295954,10604312,308358
"1991","ENSBTAG00000003186","20",58493751,58560795,67044
"1992","ENSBTAG00000003189","28",15463074,15571693,108619
"1993","ENSBTAG00000003191","25",38748352,38757857,9505
"1994","ENSBTAG00000003192","19",52544478,52628757,84279
"1995","ENSBTAG00000003193","10",36167613,36174903,7290
"1996","ENSBTAG00000003196","26",9258640,9370521,111881
"1997","ENSBTAG00000003199","15",75852557,75860286,7729
"1998","ENSBTAG00000003200","20",24198618,24270349,71731
"1999","ENSBTAG00000003201","27",37703749,37727639,23890
"2000","ENSBTAG00000003202","2",124630567,124671398,40831
"2001","ENSBTAG00000003205","11",95849987,95854749,4762
"2002","ENSBTAG00000003207","2",25729317,25731210,1893
"2003","ENSBTAG00000003208","17",18245545,18266086,20541
"2004","ENSBTAG00000003209","13",66461377,66471861,10484
"2005","ENSBTAG00000003212","13",66465154,66467543,2389
"2006","ENSBTAG00000003215","13",61747316,61787770,40454
"2007","ENSBTAG00000003217","3",10531472,10562417,30945
"2008","ENSBTAG00000003218","6",108599906,108697973,98067
"2009","ENSBTAG00000003219","20",57228320,57239470,11150
"2010","ENSBTAG00000003220","3",10525788,10528190,2402
"2011","ENSBTAG00000003221","5",95367722,95479084,111362
"2012","ENSBTAG00000003222","4",15128694,15276513,147819
"2013","ENSBTAG00000003225","2",1318420,1323393,4973
"2014","ENSBTAG00000003228","5",110745805,110752075,6270
"2015","ENSBTAG00000003229","19",39438637,39443096,4459
"2016","ENSBTAG00000003231","18",57446835,57453988,7153
"2017","ENSBTAG00000003232","16",3509889,3517064,7175
"2018","ENSBTAG00000003234","18",8586361,8679888,93527
"2019","ENSBTAG00000003235","2",126666827,126704429,37602
"2020","ENSBTAG00000003236","29",41708650,41738156,29506
"2021","ENSBTAG00000003237","22",58736452,58878769,142317
"2022","ENSBTAG00000003238","4",23999242,24075104,75862
"2023","ENSBTAG00000003239","5",65183368,65269247,85879
"2024","ENSBTAG00000003240","8",99746343,99752613,6270
"2025","ENSBTAG00000003242","22",58892373,58944171,51798
"2026","ENSBTAG00000003244","22",58938929,58974160,35231
"2027","ENSBTAG00000003245","3",49691045,49912338,221293
"2028","ENSBTAG00000003250","23",29088449,29089402,953
"2029","ENSBTAG00000003253","2",119585852,119590637,4785
"2030","ENSBTAG00000003255","5",103631360,103654878,23518
"2031","ENSBTAG00000003256","13",73347049,73367104,20055
"2032","ENSBTAG00000003257","13",73371418,73458717,87299
"2033","ENSBTAG00000003258","7",88541683,88542355,672
"2034","ENSBTAG00000003259","7",57646493,57697609,51116
"2035","ENSBTAG00000003260","7",57701556,57702776,1220
"2036","ENSBTAG00000003261","18",64453980,64458059,4079
"2037","ENSBTAG00000003263","10",8804197,8885008,80811
"2038","ENSBTAG00000003264","18",56540703,56547718,7015
"2039","ENSBTAG00000003265","26",30579476,30711953,132477
"2040","ENSBTAG00000003267","18",65692531,65701693,9162
"2041","ENSBTAG00000003268","20",26268089,26270045,1956
"2042","ENSBTAG00000003272","18",50162372,50174987,12615
"2043","ENSBTAG00000003275","27",36635300,36661081,25781
"2044","ENSBTAG00000003276","10",73436729,73667888,231159
"2045","ENSBTAG00000003278","5",26042341,26047427,5086
"2046","ENSBTAG00000003279","3",118884975,118923959,38984
"2047","ENSBTAG00000003280","19",9625617,9626163,546
"2048","ENSBTAG00000003282","5",88834636,88889384,54748
"2049","ENSBTAG00000003288","25",37964318,37980263,15945
"2050","ENSBTAG00000003289","19",14387586,14389714,2128
"2051","ENSBTAG00000003290","X",84923136,85099957,176821
"2052","ENSBTAG00000003291","5",101125927,101163364,37437
"2053","ENSBTAG00000003294","26",21823624,21824790,1166
"2054","ENSBTAG00000003295","16",38087731,38110349,22618
"2055","ENSBTAG00000003296","26",21825438,21830839,5401
"2056","ENSBTAG00000003297","17",63195671,63211740,16069
"2057","ENSBTAG00000003298","26",21832097,21842880,10783
"2058","ENSBTAG00000003299","X",73576171,73587252,11081
"2059","ENSBTAG00000003300","21",20466203,20492331,26128
"2060","ENSBTAG00000003301","1",15324270,15556567,232297
"2061","ENSBTAG00000003303","19",56419751,56426828,7077
"2062","ENSBTAG00000003304","5",25977799,25980483,2684
"2063","ENSBTAG00000003305","25",32758258,32773118,14860
"2064","ENSBTAG00000003307","11",48673645,48716318,42673
"2065","ENSBTAG00000003308","25",38359038,38390756,31718
"2066","ENSBTAG00000003312","26",43714870,43792587,77717
"2067","ENSBTAG00000003313","16",45439406,45457866,18460
"2068","ENSBTAG00000003314","12",35583971,35597394,13423
"2069","ENSBTAG00000003315","12",35582808,35583891,1083
"2070","ENSBTAG00000003316","X",126782220,126798093,15873
"2071","ENSBTAG00000003319","13",7894630,7899756,5126
"2072","ENSBTAG00000003320","X",52465557,52478436,12879
"2073","ENSBTAG00000003321","X",55825134,55873080,47946
"2074","ENSBTAG00000003322","3",60110693,60257583,146890
"2075","ENSBTAG00000003323","8",75209908,75221988,12080
"2076","ENSBTAG00000003325","22",15232620,15298151,65531
"2077","ENSBTAG00000003326","20",10147256,10176131,28875
"2078","ENSBTAG00000003327","2",106154128,106175952,21824
"2079","ENSBTAG00000003328","22",55794950,55847377,52427
"2080","ENSBTAG00000003329","20",25580150,25586931,6781
"2081","ENSBTAG00000003330","29",42003025,42044529,41504
"2082","ENSBTAG00000003332","23",49546033,49555816,9783
"2083","ENSBTAG00000003334","19",18013982,18039921,25939
"2084","ENSBTAG00000003336","9",25985764,26078941,93177
"2085","ENSBTAG00000003338","14",77440753,77485090,44337
"2086","ENSBTAG00000003339","14",43668517,43696284,27767
"2087","ENSBTAG00000003340","9",25960234,25979946,19712
"2088","ENSBTAG00000003341","8",69221847,69227682,5835
"2089","ENSBTAG00000003342","9",39424555,39477476,52921
"2090","ENSBTAG00000003343","NKLS02002207.1",528626,531707,3081
"2091","ENSBTAG00000003345","17",32347951,32529264,181313
"2092","ENSBTAG00000003349","7",58816369,59006616,190247
"2093","ENSBTAG00000003353","18",23875374,23939382,64008
"2094","ENSBTAG00000003354","24",36929125,37054552,125427
"2095","ENSBTAG00000003357","6",112942655,112952422,9767
"2096","ENSBTAG00000003358","11",29359106,29406229,47123
"2097","ENSBTAG00000003359","23",25400733,25474020,73287
"2098","ENSBTAG00000003361","15",58806394,59021213,214819
"2099","ENSBTAG00000003362","5",67600075,67618814,18739
"2100","ENSBTAG00000003364","13",60979426,60990988,11562
"2101","ENSBTAG00000003365","19",10161453,10231394,69941
"2102","ENSBTAG00000003366","8",11559625,11604095,44470
"2103","ENSBTAG00000003367","5",114655422,114673112,17690
"2104","ENSBTAG00000003369","29",45010120,45033531,23411
"2105","ENSBTAG00000003370","10",71740722,71742215,1493
"2106","ENSBTAG00000003371","10",71759908,71782133,22225
"2107","ENSBTAG00000003372","4",97939642,97975400,35758
"2108","ENSBTAG00000003375","21",56489308,56531661,42353
"2109","ENSBTAG00000003376","3",117716651,117735517,18866
"2110","ENSBTAG00000003377","20",8447522,8448443,921
"2111","ENSBTAG00000003378","1",72150081,72264225,114144
"2112","ENSBTAG00000003380","13",73145045,73150464,5419
"2113","ENSBTAG00000003381","20",66450023,66491585,41562
"2114","ENSBTAG00000003382","13",73154937,73223830,68893
"2115","ENSBTAG00000003383","1",70085553,70086158,605
"2116","ENSBTAG00000003384","9",65172858,65263165,90307
"2117","ENSBTAG00000003387","11",98588918,98598087,9169
"2118","ENSBTAG00000003388","11",98600692,98603745,3053
"2119","ENSBTAG00000003389","3",120024989,120028930,3941
"2120","ENSBTAG00000003390","17",69345496,69364944,19448
"2121","ENSBTAG00000003392","21",4267204,4359559,92355
"2122","ENSBTAG00000003393","17",69364493,69376681,12188
"2123","ENSBTAG00000003394","17",69378978,69382634,3656
"2124","ENSBTAG00000003395","26",44470645,44543034,72389
"2125","ENSBTAG00000003396","13",69378600,69379571,971
"2126","ENSBTAG00000003397","26",44545730,44713829,168099
"2127","ENSBTAG00000003398","13",78918165,78934954,16789
"2128","ENSBTAG00000003399","17",14342769,14380566,37797
"2129","ENSBTAG00000003401","2",65522494,65569993,47499
"2130","ENSBTAG00000003403","2",135473410,135527194,53784
"2131","ENSBTAG00000003404","11",74974219,74978079,3860
"2132","ENSBTAG00000003405","11",74983559,74989607,6048
"2133","ENSBTAG00000003407","11",74990095,74998214,8119
"2134","ENSBTAG00000003408","11",47233511,47305610,72099
"2135","ENSBTAG00000003409","11",75002737,75016124,13387
"2136","ENSBTAG00000003410","21",23941195,24055053,113858
"2137","ENSBTAG00000003414","21",24055078,24073717,18639
"2138","ENSBTAG00000003415","12",16723868,16741586,17718
"2139","ENSBTAG00000003417","25",26869325,26878577,9252
"2140","ENSBTAG00000003418","X",94696646,94769333,72687
"2141","ENSBTAG00000003419","21",44934146,44951180,17034
"2142","ENSBTAG00000003421","25",26883214,26894901,11687
"2143","ENSBTAG00000003422","13",38215110,38239910,24800
"2144","ENSBTAG00000003423","21",58661562,58680016,18454
"2145","ENSBTAG00000003424","4",11330484,11345143,14659
"2146","ENSBTAG00000003425","13",38242214,38250800,8586
"2147","ENSBTAG00000003430","25",35873257,35875482,2225
"2148","ENSBTAG00000003432","25",35829891,35861931,32040
"2149","ENSBTAG00000003434","7",16897413,16933305,35892
"2150","ENSBTAG00000003435","21",28098966,28336655,237689
"2151","ENSBTAG00000003436","19",55249957,55274837,24880
"2152","ENSBTAG00000003438","11",97584412,97610512,26100
"2153","ENSBTAG00000003439","19",33740771,33784070,43299
"2154","ENSBTAG00000003440","3",43472653,43525462,52809
"2155","ENSBTAG00000003442","28",39201718,39213131,11413
"2156","ENSBTAG00000003443","6",68303938,68378475,74537
"2157","ENSBTAG00000003444","3",58890026,58928166,38140
"2158","ENSBTAG00000003445","14",61844561,61854021,9460
"2159","ENSBTAG00000003446","25",35810463,35827441,16978
"2160","ENSBTAG00000003447","18",65142027,65143289,1262
"2161","ENSBTAG00000003449","4",92843936,92873142,29206
"2162","ENSBTAG00000003450","14",21853750,21901839,48089
"2163","ENSBTAG00000003454","14",21903677,21955373,51696
"2164","ENSBTAG00000003455","9",60560040,60742901,182861
"2165","ENSBTAG00000003456","18",65466424,65468871,2447
"2166","ENSBTAG00000003457","18",56269038,56273691,4653
"2167","ENSBTAG00000003458","2",23340522,23353696,13174
"2168","ENSBTAG00000003460","14",21961033,21989950,28917
"2169","ENSBTAG00000003462","18",65499669,65508164,8495
"2170","ENSBTAG00000003465","18",65485031,65528663,43632
"2171","ENSBTAG00000003467","25",22514215,22571278,57063
"2172","ENSBTAG00000003469","10",77048025,77066487,18462
"2173","ENSBTAG00000003470","18",62862296,62875689,13393
"2174","ENSBTAG00000003472","2",103002440,103202440,200000
"2175","ENSBTAG00000003474","10",77076095,77096617,20522
"2176","ENSBTAG00000003476","7",19353553,19357132,3579
"2177","ENSBTAG00000003479","2",122848955,122858265,9310
"2178","ENSBTAG00000003481","14",73283493,73338173,54680
"2179","ENSBTAG00000003483","8",69421125,69423840,2715
"2180","ENSBTAG00000003484","3",93014104,93021970,7866
"2181","ENSBTAG00000003485","3",93003032,93012322,9290
"2182","ENSBTAG00000003489","9",90897823,91060026,162203
"2183","ENSBTAG00000003490","4",59867412,60450510,583098
"2184","ENSBTAG00000003491","7",18011743,18026173,14430
"2185","ENSBTAG00000003494","13",51791839,51961386,169547
"2186","ENSBTAG00000003495","4",103532104,103604495,72391
"2187","ENSBTAG00000003496","9",80508314,80778018,269704
"2188","ENSBTAG00000003498","7",62700927,62775320,74393
"2189","ENSBTAG00000003499","23",19386682,19401592,14910
"2190","ENSBTAG00000003500","19",47867635,47898831,31196
"2191","ENSBTAG00000003501","22",53572967,53626046,53079
"2192","ENSBTAG00000003502","7",48367043,48947295,580252
"2193","ENSBTAG00000003503","18",15130698,15162952,32254
"2194","ENSBTAG00000003504","13",64234188,64259465,25277
"2195","ENSBTAG00000003505","5",21014376,21053400,39024
"2196","ENSBTAG00000003506","4",74405139,74430946,25807
"2197","ENSBTAG00000003508","4",74443217,74502981,59764
"2198","ENSBTAG00000003509","27",34063676,34126284,62608
"2199","ENSBTAG00000003510","28",41554852,41570271,15419
"2200","ENSBTAG00000003511","12",52840663,52892666,52003
"2201","ENSBTAG00000003512","13",64280737,64309631,28894
"2202","ENSBTAG00000003514","18",34803086,34807857,4771
"2203","ENSBTAG00000003515","28",41570798,41575650,4852
"2204","ENSBTAG00000003516","27",34145693,34152126,6433
"2205","ENSBTAG00000003519","18",34807714,34812057,4343
"2206","ENSBTAG00000003521","18",34813277,34820215,6938
"2207","ENSBTAG00000003523","6",84526796,84627239,100443
"2208","ENSBTAG00000003525","11",98313634,98381906,68272
"2209","ENSBTAG00000003526","21",60271216,60379854,108638
"2210","ENSBTAG00000003527","17",52703453,52724998,21545
"2211","ENSBTAG00000003528","7",10762312,10776244,13932
"2212","ENSBTAG00000003529","26",8598293,8659761,61468
"2213","ENSBTAG00000003530","11",102659360,102733192,73832
"2214","ENSBTAG00000003531","4",7205760,7598351,392591
"2215","ENSBTAG00000003532","8",55576283,55729912,153629
"2216","ENSBTAG00000003535","3",15462231,15462806,575
"2217","ENSBTAG00000003536","20",62822982,62899935,76953
"2218","ENSBTAG00000003539","20",62783281,62814323,31042
"2219","ENSBTAG00000003540","8",111921667,112087408,165741
"2220","ENSBTAG00000003541","18",57852499,57858521,6022
"2221","ENSBTAG00000003543","7",15009384,15017614,8230
"2222","ENSBTAG00000003544","7",15021733,15025832,4099
"2223","ENSBTAG00000003545","29",1080813,1086765,5952
"2224","ENSBTAG00000003546","28",45677709,45689736,12027
"2225","ENSBTAG00000003547","X",51346938,51382240,35302
"2226","ENSBTAG00000003548","29",45409334,45412139,2805
"2227","ENSBTAG00000003550","29",1056371,1080650,24279
"2228","ENSBTAG00000003552","29",1014403,1043535,29132
"2229","ENSBTAG00000003553","11",25506546,25510785,4239
"2230","ENSBTAG00000003555","11",25515109,25845945,330836
"2231","ENSBTAG00000003556","21",68318275,68328683,10408
"2232","ENSBTAG00000003557","17",68029981,68049495,19514
"2233","ENSBTAG00000003559","21",68329806,68412242,82436
"2234","ENSBTAG00000003560","12",18095424,18096263,839
"2235","ENSBTAG00000003561","13",52981969,53025264,43295
"2236","ENSBTAG00000003564","15",46605826,46638913,33087
"2237","ENSBTAG00000003565","15",46574037,46599884,25847
"2238","ENSBTAG00000003566","15",46566770,46571931,5161
"2239","ENSBTAG00000003567","15",46565858,46566703,845
"2240","ENSBTAG00000003568","12",72904593,73009466,104873
"2241","ENSBTAG00000003569","12",73010630,73060581,49951
"2242","ENSBTAG00000003570","18",1734913,1753496,18583
"2243","ENSBTAG00000003572","27",16293899,16313546,19647
"2244","ENSBTAG00000003574","5",114937916,115015482,77566
"2245","ENSBTAG00000003575","23",30441464,30450225,8761
"2246","ENSBTAG00000003576","26",22326344,22335507,9163
"2247","ENSBTAG00000003577","25",10560415,10590303,29888
"2248","ENSBTAG00000003578","26",22334789,22356875,22086
"2249","ENSBTAG00000003579","26",22357362,22440852,83490
"2250","ENSBTAG00000003580","26",23026186,23041793,15607
"2251","ENSBTAG00000003581","17",18155442,18207948,52506
"2252","ENSBTAG00000003585","1",52712128,52777176,65048
"2253","ENSBTAG00000003586","3",25709064,25856341,147277
"2254","ENSBTAG00000003587","7",4654732,4732378,77646
"2255","ENSBTAG00000003588","14",80864110,80888123,24013
"2256","ENSBTAG00000003589","13",23425839,23429696,3857
"2257","ENSBTAG00000003592","22",24943531,25264487,320956
"2258","ENSBTAG00000003593","3",119936790,119944346,7556
"2259","ENSBTAG00000003594","5",115818297,115830013,11716
"2260","ENSBTAG00000003595","12",12923398,12933168,9770
"2261","ENSBTAG00000003598","5",103610117,103623450,13333
"2262","ENSBTAG00000003600","16",26949786,27046178,96392
"2263","ENSBTAG00000003601","X",50345620,50387724,42104
"2264","ENSBTAG00000003602","6",45773063,45883952,110889
"2265","ENSBTAG00000003604","3",20143733,20155185,11452
"2266","ENSBTAG00000003606","14",1323954,1335463,11509
"2267","ENSBTAG00000003607","25",42135192,42169725,34533
"2268","ENSBTAG00000003608","13",56624611,56685728,61117
"2269","ENSBTAG00000003609","X",75540847,75545297,4450
"2270","ENSBTAG00000003610","11",94528363,95058808,530445
"2271","ENSBTAG00000003614","3",29479664,29489949,10285
"2272","ENSBTAG00000003616","3",29473236,29479991,6755
"2273","ENSBTAG00000003617","25",34587543,34595099,7556
"2274","ENSBTAG00000003619","6",6491225,6606147,114922
"2275","ENSBTAG00000003621","4",105477822,105485610,7788
"2276","ENSBTAG00000003622","22",16387907,16400710,12803
"2277","ENSBTAG00000003624","15",81931958,81933780,1822
"2278","ENSBTAG00000003625","4",582623,607055,24432
"2279","ENSBTAG00000003626","2",25753839,26211202,457363
"2280","ENSBTAG00000003629","19",24214152,24235481,21329
"2281","ENSBTAG00000003632","23",19743358,19878413,135055
"2282","ENSBTAG00000003634","26",745915,764085,18170
"2283","ENSBTAG00000003635","13",75079067,75089137,10070
"2284","ENSBTAG00000003636","26",10952398,11082198,129800
"2285","ENSBTAG00000003638","15",45755364,45773134,17770
"2286","ENSBTAG00000003639","13",75092070,75130281,38211
"2287","ENSBTAG00000003640","13",26756928,26764493,7565
"2288","ENSBTAG00000003642","3",100550576,100565166,14590
"2289","ENSBTAG00000003644","18",62195226,62205672,10446
"2290","ENSBTAG00000003649","27",37734906,37749415,14509
"2291","ENSBTAG00000003650","2",39887966,39905341,17375
"2292","ENSBTAG00000003651","6",104881314,104932641,51327
"2293","ENSBTAG00000003652","6",104853328,104868645,15317
"2294","ENSBTAG00000003653","6",104819025,104839735,20710
"2295","ENSBTAG00000003658","4",44653832,45211015,557183
"2296","ENSBTAG00000003661","15",17376530,17393726,17196
"2297","ENSBTAG00000003665","22",58481421,58572816,91395
"2298","ENSBTAG00000003667","10",47248374,47742906,494532
"2299","ENSBTAG00000003668","X",55109466,55215085,105619
"2300","ENSBTAG00000003669","8",27468468,27944404,475936
"2301","ENSBTAG00000003671","7",44402106,44403797,1691
"2302","ENSBTAG00000003675","7",11509948,11560792,50844
"2303","ENSBTAG00000003676","2",125015868,125016296,428
"2304","ENSBTAG00000003679","15",53344671,53393878,49207
"2305","ENSBTAG00000003682","15",53393791,53406519,12728
"2306","ENSBTAG00000003684","21",51329040,51648277,319237
"2307","ENSBTAG00000003687","19",50030249,50079424,49175
"2308","ENSBTAG00000003690","26",34306815,34362842,56027
"2309","ENSBTAG00000003691","11",86217391,86225065,7674
"2310","ENSBTAG00000003692","15",53409782,53416245,6463
"2311","ENSBTAG00000003693","5",110358967,110377270,18303
"2312","ENSBTAG00000003695","19",49991652,50015614,23962
"2313","ENSBTAG00000003696","17",62392061,62470991,78930
"2314","ENSBTAG00000003697","16",42593901,42605389,11488
"2315","ENSBTAG00000003699","19",26344237,26351333,7096
"2316","ENSBTAG00000003700","19",34214709,34270099,55390
"2317","ENSBTAG00000003701","16",70601757,70639797,38040
"2318","ENSBTAG00000003702","16",70580072,70598523,18451
"2319","ENSBTAG00000003705","19",34230241,34260820,30579
"2320","ENSBTAG00000003707","19",34193450,34214693,21243
"2321","ENSBTAG00000003708","21",49038721,49103406,64685
"2322","ENSBTAG00000003709","4",29024090,29115760,91670
"2323","ENSBTAG00000003710","12",35700277,35789390,89113
"2324","ENSBTAG00000003711","11",28734999,28828070,93071
"2325","ENSBTAG00000003712","29",43754201,43756591,2390
"2326","ENSBTAG00000003713","29",43752073,43754193,2120
"2327","ENSBTAG00000003715","10",82154116,82156081,1965
"2328","ENSBTAG00000003718","1",152599803,152638556,38753
"2329","ENSBTAG00000003719","8",62612938,62715815,102877
"2330","ENSBTAG00000003721","15",75702165,75705849,3684
"2331","ENSBTAG00000003724","3",51387228,51406793,19565
"2332","ENSBTAG00000003726","8",7995561,8064000,68439
"2333","ENSBTAG00000003727","X",123270221,123601790,331569
"2334","ENSBTAG00000003728","20",25400418,25516036,115618
"2335","ENSBTAG00000003733","19",26575856,26583222,7366
"2336","ENSBTAG00000003737","10",11983354,11993942,10588
"2337","ENSBTAG00000003740","X",98634552,98814092,179540
"2338","ENSBTAG00000003741","26",24085526,24160165,74639
"2339","ENSBTAG00000003743","9",56643939,56645654,1715
"2340","ENSBTAG00000003745","22",12377233,12429953,52720
"2341","ENSBTAG00000003746","3",93275045,93393567,118522
"2342","ENSBTAG00000003747","10",85254086,85275390,21304
"2343","ENSBTAG00000003748","5",43134292,43266434,132142
"2344","ENSBTAG00000003749","5",43038800,43120159,81359
"2345","ENSBTAG00000003751","4",28790424,28886703,96279
"2346","ENSBTAG00000003752","3",35038387,35096479,58092
"2347","ENSBTAG00000003757","18",15375166,15386724,11558
"2348","ENSBTAG00000003758","22",47707405,47731710,24305
"2349","ENSBTAG00000003759","29",43796881,43816203,19322
"2350","ENSBTAG00000003760","13",77185752,77186279,527
"2351","ENSBTAG00000003762","10",58191905,58224910,33005
"2352","ENSBTAG00000003763","10",58061475,58179382,117907
"2353","ENSBTAG00000003764","9",62239189,62262030,22841
"2354","ENSBTAG00000003766","6",113216655,113218143,1488
"2355","ENSBTAG00000003769","10",26300260,26302086,1826
"2356","ENSBTAG00000003771","2",70918684,70920915,2231
"2357","ENSBTAG00000003773","4",13462646,13692192,229546
"2358","ENSBTAG00000003774","3",89219877,89291700,71823
"2359","ENSBTAG00000003775","3",89165719,89209186,43467
"2360","ENSBTAG00000003776","6",115584916,115591282,6366
"2361","ENSBTAG00000003777","3",102694863,102714614,19751
"2362","ENSBTAG00000003779","X",95636726,95712638,75912
"2363","ENSBTAG00000003781","3",102663876,102678104,14228
"2364","ENSBTAG00000003784","4",44531524,44565511,33987
"2365","ENSBTAG00000003786","19",51063960,51072587,8627
"2366","ENSBTAG00000003788","2",124883384,124903231,19847
"2367","ENSBTAG00000003789","14",69781691,69846027,64336
"2368","ENSBTAG00000003791","3",59185581,59269352,83771
"2369","ENSBTAG00000003793","27",40020331,40078439,58108
"2370","ENSBTAG00000003794","18",24255762,24437386,181624
"2371","ENSBTAG00000003797","23",31999597,32017253,17656
"2372","ENSBTAG00000003798","18",24207779,24253288,45509
"2373","ENSBTAG00000003799","3",20190884,20202510,11626
"2374","ENSBTAG00000003800","26",51937591,51962276,24685
"2375","ENSBTAG00000003801","24",49855041,49916289,61248
"2376","ENSBTAG00000003802","19",32815735,32849990,34255
"2377","ENSBTAG00000003804","16",30588004,30618003,29999
"2378","ENSBTAG00000003806","3",20183480,20191176,7696
"2379","ENSBTAG00000003807","2",106532969,106566527,33558
"2380","ENSBTAG00000003808","4",27093041,27667961,574920
"2381","ENSBTAG00000003809","2",106575924,106598631,22707
"2382","ENSBTAG00000003810","4",9877592,9895506,17914
"2383","ENSBTAG00000003813","2",106619142,106623100,3958
"2384","ENSBTAG00000003815","13",64392791,64420836,28045
"2385","ENSBTAG00000003817","2",106623552,106632884,9332
"2386","ENSBTAG00000003818","23",15548833,15559909,11076
"2387","ENSBTAG00000003819","2",106633221,106659569,26348
"2388","ENSBTAG00000003820","18",45743703,45767909,24206
"2389","ENSBTAG00000003822","2",135617021,135668617,51596
"2390","ENSBTAG00000003825","4",43598679,43690863,92184
"2391","ENSBTAG00000003826","18",45771238,45781395,10157
"2392","ENSBTAG00000003827","14",60359146,60390081,30935
"2393","ENSBTAG00000003829","18",45782388,45802719,20331
"2394","ENSBTAG00000003830","19",39343958,39353533,9575
"2395","ENSBTAG00000003832","2",135611507,135616267,4760
"2396","ENSBTAG00000003833","1",132298308,132334597,36289
"2397","ENSBTAG00000003835","10",66518527,66525667,7140
"2398","ENSBTAG00000003836","7",69121471,69210620,89149
"2399","ENSBTAG00000003837","3",108267191,108288596,21405
"2400","ENSBTAG00000003840","17",43514978,43577750,62772
"2401","ENSBTAG00000003842","25",28224570,28275671,51101
"2402","ENSBTAG00000003843","2",104423001,104474279,51278
"2403","ENSBTAG00000003845","22",12478903,12492412,13509
"2404","ENSBTAG00000003848","13",51545361,51731772,186411
"2405","ENSBTAG00000003849","3",108305087,108331447,26360
"2406","ENSBTAG00000003850","3",78520247,78523226,2979
"2407","ENSBTAG00000003851","1",110447554,110461439,13885
"2408","ENSBTAG00000003855","X",91540004,91658010,118006
"2409","ENSBTAG00000003856","18",42597926,42599478,1552
"2410","ENSBTAG00000003857","10",81344780,81439922,95142
"2411","ENSBTAG00000003861","11",19542599,19557191,14592
"2412","ENSBTAG00000003863","13",52347705,52352814,5109
"2413","ENSBTAG00000003864","4",99483644,99526129,42485
"2414","ENSBTAG00000003865","1",66655046,66744722,89676
"2415","ENSBTAG00000003866","2",125526927,125545896,18969
"2416","ENSBTAG00000003871","18",50290687,50308138,17451
"2417","ENSBTAG00000003872","13",57697575,57720075,22500
"2418","ENSBTAG00000003876","28",28709027,28902834,193807
"2419","ENSBTAG00000003877","28",34988423,35050547,62124
"2420","ENSBTAG00000003878","9",33924603,33949379,24776
"2421","ENSBTAG00000003880","24",37076794,37135870,59076
"2422","ENSBTAG00000003882","22",16789209,16803771,14562
"2423","ENSBTAG00000003884","9",103945578,104013269,67691
"2424","ENSBTAG00000003885","14",40176054,40191397,15343
"2425","ENSBTAG00000003886","18",51586356,51589682,3326
"2426","ENSBTAG00000003887","9",23947563,24000910,53347
"2427","ENSBTAG00000003889","19",27778418,27788197,9779
"2428","ENSBTAG00000003892","23",32672258,32731972,59714
"2429","ENSBTAG00000003894","18",26255289,26298424,43135
"2430","ENSBTAG00000003897","6",45403482,45416234,12752
"2431","ENSBTAG00000003898","3",23536511,23560620,24109
"2432","ENSBTAG00000003901","13",62142537,62176363,33826
"2433","ENSBTAG00000003902","11",72076374,72106794,30420
"2434","ENSBTAG00000003904","11",72043664,72067357,23693
"2435","ENSBTAG00000003906","11",72030387,72043098,12711
"2436","ENSBTAG00000003907","28",35848163,35904370,56207
"2437","ENSBTAG00000003908","13",62182219,62210102,27883
"2438","ENSBTAG00000003910","28",35923918,36007613,83695
"2439","ENSBTAG00000003914","7",5683952,5688015,4063
"2440","ENSBTAG00000003915","10",17679370,17701804,22434
"2441","ENSBTAG00000003916","1",153260324,153266600,6276
"2442","ENSBTAG00000003919","9",23829766,23859383,29617
"2443","ENSBTAG00000003920","10",20902051,20916712,14661
"2444","ENSBTAG00000003921","9",23783735,23829745,46010
"2445","ENSBTAG00000003922","12",36350339,36395281,44942
"2446","ENSBTAG00000003923","2",106290033,106293245,3212
"2447","ENSBTAG00000003925","9",103492823,103495427,2604
"2448","ENSBTAG00000003927","2",106293589,106298509,4920
"2449","ENSBTAG00000003928","3",112967754,113012711,44957
"2450","ENSBTAG00000003929","9",103494501,103514664,20163
"2451","ENSBTAG00000003934","12",36270996,36321788,50792
"2452","ENSBTAG00000003935","2",106302074,106319619,17545
"2453","ENSBTAG00000003936","2",106348916,106371789,22873
"2454","ENSBTAG00000003937","13",22531135,22531659,524
"2455","ENSBTAG00000003938","9",95479831,95591689,111858
"2456","ENSBTAG00000003941","6",13243676,13272540,28864
"2457","ENSBTAG00000003942","5",55886481,55898381,11900
"2458","ENSBTAG00000003943","8",28971824,29120097,148273
"2459","ENSBTAG00000003944","2",106378600,106384257,5657
"2460","ENSBTAG00000003946","13",63108923,63127630,18707
"2461","ENSBTAG00000003947","7",4741028,4756830,15802
"2462","ENSBTAG00000003948","3",15311058,15320377,9319
"2463","ENSBTAG00000003949","13",64908243,64934850,26607
"2464","ENSBTAG00000003950","2",5102165,5112861,10696
"2465","ENSBTAG00000003952","22",7572111,7647124,75013
"2466","ENSBTAG00000003953","25",38453661,38470158,16497
"2467","ENSBTAG00000003954","3",15121790,15298435,176645
"2468","ENSBTAG00000003955","15",56532192,56637170,104978
"2469","ENSBTAG00000003956","19",36482931,36491920,8989
"2470","ENSBTAG00000003957","21",29231423,29236481,5058
"2471","ENSBTAG00000003958","19",29676159,29693442,17283
"2472","ENSBTAG00000003959","6",100718857,100887281,168424
"2473","ENSBTAG00000003960","25",17132655,17154455,21800
"2474","ENSBTAG00000003961","18",19065512,19074769,9257
"2475","ENSBTAG00000003962","13",63115589,63117032,1443
"2476","ENSBTAG00000003963","11",2630338,2684017,53679
"2477","ENSBTAG00000003965","11",4311242,4314128,2886
"2478","ENSBTAG00000003966","19",43658550,43671863,13313
"2479","ENSBTAG00000003967","29",42315719,42323775,8056
"2480","ENSBTAG00000003968","22",7649885,7712124,62239
"2481","ENSBTAG00000003970","11",4320918,4336873,15955
"2482","ENSBTAG00000003971","13",63129139,63138330,9191
"2483","ENSBTAG00000003975","11",2683641,2704083,20442
"2484","ENSBTAG00000003977","13",60290408,60306877,16469
"2485","ENSBTAG00000003981","1",143851101,143874772,23671
"2486","ENSBTAG00000003983","19",34556866,34625228,68362
"2487","ENSBTAG00000003985","29",28419057,28467714,48657
"2488","ENSBTAG00000003986","7",50878379,50886363,7984
"2489","ENSBTAG00000003989","26",24827343,24837104,9761
"2490","ENSBTAG00000003990","26",24869417,24893385,23968
"2491","ENSBTAG00000003992","16",61427758,61473954,46196
"2492","ENSBTAG00000003994","4",76116349,76124835,8486
"2493","ENSBTAG00000003997","22",341357,362047,20690
"2494","ENSBTAG00000004000","7",65722185,65730845,8660
"2495","ENSBTAG00000004003","NKLS02002208.1",5525886,5558268,32382
"2496","ENSBTAG00000004004","5",112640001,112654494,14493
"2497","ENSBTAG00000004005","24",56001377,56351749,350372
"2498","ENSBTAG00000004007","X",23002249,23087043,84794
"2499","ENSBTAG00000004008","X",52869224,52893759,24535
"2500","ENSBTAG00000004009","5",112654669,112670817,16148
"2501","ENSBTAG00000004010","8",105351900,105612449,260549
"2502","ENSBTAG00000004011","10",60924617,61080535,155918
"2503","ENSBTAG00000004014","22",58328984,58398286,69302
"2504","ENSBTAG00000004015","27",36846611,36952779,106168
"2505","ENSBTAG00000004017","18",49109364,49119473,10109
"2506","ENSBTAG00000004018","5",57353452,57376105,22653
"2507","ENSBTAG00000004019","5",57343063,57353330,10267
"2508","ENSBTAG00000004021","5",57339030,57344446,5416
"2509","ENSBTAG00000004022","14",23330541,23375751,45210
"2510","ENSBTAG00000004023","4",33398732,33619877,221145
"2511","ENSBTAG00000004024","21",31126645,31188035,61390
"2512","ENSBTAG00000004028","10",6925321,7006062,80741
"2513","ENSBTAG00000004034","15",15192650,15264115,71465
"2514","ENSBTAG00000004035","25",39452546,40061787,609241
"2515","ENSBTAG00000004036","19",44526681,44554914,28233
"2516","ENSBTAG00000004037","3",87265962,87268007,2045
"2517","ENSBTAG00000004038","25",7551536,7641455,89919
"2518","ENSBTAG00000004039","13",67738519,67807849,69330
"2519","ENSBTAG00000004040","6",85083386,85137347,53961
"2520","ENSBTAG00000004041","12",85327078,85359000,31922
"2521","ENSBTAG00000004043","18",62945785,62948849,3064
"2522","ENSBTAG00000004046","15",82296009,82339632,43623
"2523","ENSBTAG00000004048","5",111989018,111993080,4062
"2524","ENSBTAG00000004050","28",32180149,32180550,401
"2525","ENSBTAG00000004051","25",28371598,28377073,5475
"2526","ENSBTAG00000004052","6",89244964,89251433,6469
"2527","ENSBTAG00000004054","21",61358353,61409967,51614
"2528","ENSBTAG00000004059","16",60633331,60693186,59855
"2529","ENSBTAG00000004061","1",157232248,157249033,16785
"2530","ENSBTAG00000004063","21",59460078,59465438,5360
"2531","ENSBTAG00000004064","16",23556998,23584580,27582
"2532","ENSBTAG00000004066","20",28302955,28495429,192474
"2533","ENSBTAG00000004072","4",51491712,51546693,54981
"2534","ENSBTAG00000004073","11",24886922,25096963,210041
"2535","ENSBTAG00000004075","13",46325275,46328399,3124
"2536","ENSBTAG00000004076","11",25106734,25107870,1136
"2537","ENSBTAG00000004077","25",34367974,34392972,24998
"2538","ENSBTAG00000004078","4",113526181,113561800,35619
"2539","ENSBTAG00000004079","10",37769390,37821807,52417
"2540","ENSBTAG00000004080","26",39698402,39718014,19612
"2541","ENSBTAG00000004081","29",1996704,2635494,638790
"2542","ENSBTAG00000004082","6",69404268,69404524,256
"2543","ENSBTAG00000004085","7",11577424,11589850,12426
"2544","ENSBTAG00000004086","10",36377742,36391629,13887
"2545","ENSBTAG00000004088","17",65295023,65318605,23582
"2546","ENSBTAG00000004091","11",102733925,102751664,17739
"2547","ENSBTAG00000004092","11",102774910,102911331,136421
"2548","ENSBTAG00000004094","6",102370630,102423199,52569
"2549","ENSBTAG00000004095","11",106257250,106260851,3601
"2550","ENSBTAG00000004097","5",101041433,101090609,49176
"2551","ENSBTAG00000004098","9",88485231,88498999,13768
"2552","ENSBTAG00000004099","9",88552142,88616854,64712
"2553","ENSBTAG00000004100","13",66868177,66910251,42074
"2554","ENSBTAG00000004104","23",18594098,18945527,351429
"2555","ENSBTAG00000004106","25",34632687,34659008,26321
"2556","ENSBTAG00000004108","19",50887829,50891455,3626
"2557","ENSBTAG00000004109","5",86538796,86540267,1471
"2558","ENSBTAG00000004110","X",79296161,79296783,622
"2559","ENSBTAG00000004111","19",50879326,50887717,8391
"2560","ENSBTAG00000004112","7",43814700,43817778,3078
"2561","ENSBTAG00000004114","29",43778592,43795152,16560
"2562","ENSBTAG00000004115","23",40992084,41012741,20657
"2563","ENSBTAG00000004117","22",2757707,2798686,40979
"2564","ENSBTAG00000004118","22",48689674,48704126,14452
"2565","ENSBTAG00000004119","19",39984692,39988816,4124
"2566","ENSBTAG00000004120","22",49767036,49789516,22480
"2567","ENSBTAG00000004124","1",42888156,42901415,13259
"2568","ENSBTAG00000004126","1",108908179,108938862,30683
"2569","ENSBTAG00000004129","19",15867084,15869981,2897
"2570","ENSBTAG00000004131","X",16074475,16089487,15012
"2571","ENSBTAG00000004135","25",37799299,37874887,75588
"2572","ENSBTAG00000004136","4",69748359,69782790,34431
"2573","ENSBTAG00000004138","18",54601126,54622191,21065
"2574","ENSBTAG00000004139","1",6815185,6858058,42873
"2575","ENSBTAG00000004140","11",104285624,104303152,17528
"2576","ENSBTAG00000004145","5",64586995,65019424,432429
"2577","ENSBTAG00000004147","13",17565238,17604498,39260
"2578","ENSBTAG00000004148","13",73616060,73618353,2293
"2579","ENSBTAG00000004150","27",28529266,28651519,122253
"2580","ENSBTAG00000004153","7",59111440,59114995,3555
"2581","ENSBTAG00000004154","1",97035501,97055587,20086
"2582","ENSBTAG00000004155","19",36171006,36179075,8069
"2583","ENSBTAG00000004159","11",27425619,27429295,3676
"2584","ENSBTAG00000004161","7",50789407,50831986,42579
"2585","ENSBTAG00000004165","12",76430686,76660289,229603
"2586","ENSBTAG00000004167","17",11330442,11605484,275042
"2587","ENSBTAG00000004168","11",30836473,30892686,56213
"2588","ENSBTAG00000004170","8",67617494,67617733,239
"2589","ENSBTAG00000004171","10",78563456,79097795,534339
"2590","ENSBTAG00000004172","17",53482843,53498434,15591
"2591","ENSBTAG00000004173","27",26866819,26885748,18929
"2592","ENSBTAG00000004175","17",53458874,53470660,11786
"2593","ENSBTAG00000004176","16",67521135,67525396,4261
"2594","ENSBTAG00000004177","2",37135008,37386059,251051
"2595","ENSBTAG00000004178","22",42836607,42867384,30777
"2596","ENSBTAG00000004179","17",53423935,53439245,15310
"2597","ENSBTAG00000004184","2",37061967,37131114,69147
"2598","ENSBTAG00000004187","17",53347984,53421121,73137
"2599","ENSBTAG00000004188","7",3403573,3469381,65808
"2600","ENSBTAG00000004189","17",53223788,53284407,60619
"2601","ENSBTAG00000004190","3",49238269,49319832,81563
"2602","ENSBTAG00000004191","7",3468962,3474671,5709
"2603","ENSBTAG00000004192","17",53184647,53194577,9930
"2604","ENSBTAG00000004193","19",8775705,8787368,11663
"2605","ENSBTAG00000004194","11",103082834,103132073,49239
"2606","ENSBTAG00000004196","19",44863248,44892548,29300
"2607","ENSBTAG00000004197","17",53174272,53175345,1073
"2608","ENSBTAG00000004199","17",53155700,53173948,18248
"2609","ENSBTAG00000004200","7",5787153,5791859,4706
"2610","ENSBTAG00000004203","17",53120968,53150578,29610
"2611","ENSBTAG00000004204","11",100410491,100463233,52742
"2612","ENSBTAG00000004206","15",80381626,80388802,7176
"2613","ENSBTAG00000004207","13",41878359,41882281,3922
"2614","ENSBTAG00000004208","5",104037216,104055041,17825
"2615","ENSBTAG00000004211","5",104024027,104036846,12819
"2616","ENSBTAG00000004212","29",48208005,48246550,38545
"2617","ENSBTAG00000004215","4",112749675,112753172,3497
"2618","ENSBTAG00000004216","2",5199357,5234002,34645
"2619","ENSBTAG00000004221","20",24108178,24117011,8833
"2620","ENSBTAG00000004222","19",27344313,27345970,1657
"2621","ENSBTAG00000004223","19",23279266,23297617,18351
"2622","ENSBTAG00000004224","7",15308803,15319511,10708
"2623","ENSBTAG00000004225","19",23296346,23307681,11335
"2624","ENSBTAG00000004226","19",27346147,27350672,4525
"2625","ENSBTAG00000004227","6",18864621,19072435,207814
"2626","ENSBTAG00000004230","6",18836660,18865624,28964
"2627","ENSBTAG00000004231","27",7349169,7491747,142578
"2628","ENSBTAG00000004237","6",89681975,89731873,49898
"2629","ENSBTAG00000004238","27",33879871,34006043,126172
"2630","ENSBTAG00000004240","5",62686936,62712545,25609
"2631","ENSBTAG00000004242","25",37022843,37046234,23391
"2632","ENSBTAG00000004243","14",21994932,22011297,16365
"2633","ENSBTAG00000004246","16",44209992,44234164,24172
"2634","ENSBTAG00000004247","17",61409306,61473245,63939
"2635","ENSBTAG00000004248","18",10240324,10254080,13756
"2636","ENSBTAG00000004249","19",47441495,47758825,317330
"2637","ENSBTAG00000004256","11",87197374,87204771,7397
"2638","ENSBTAG00000004257","24",30501605,30607271,105666
"2639","ENSBTAG00000004258","7",20027762,20036651,8889
"2640","ENSBTAG00000004259","11",87213288,87330722,117434
"2641","ENSBTAG00000004261","6",117253087,117256856,3769
"2642","ENSBTAG00000004262","7",2442461,2462424,19963
"2643","ENSBTAG00000004263","4",102389791,102436384,46593
"2644","ENSBTAG00000004266","29",29259451,29279562,20111
"2645","ENSBTAG00000004267","2",37990451,38200517,210066
"2646","ENSBTAG00000004268","7",16526036,16528271,2235
"2647","ENSBTAG00000004269","9",72305979,72418535,112556
"2648","ENSBTAG00000004270","7",16531763,16544273,12510
"2649","ENSBTAG00000004271","3",16260349,16300420,40071
"2650","ENSBTAG00000004272","21",58715675,58727005,11330
"2651","ENSBTAG00000004273","13",42573807,42584178,10371
"2652","ENSBTAG00000004275","15",40685311,40735279,49968
"2653","ENSBTAG00000004277","6",103500611,103662790,162179
"2654","ENSBTAG00000004278","13",42586269,42615935,29666
"2655","ENSBTAG00000004279","22",50701226,50751132,49906
"2656","ENSBTAG00000004280","X",105052662,105194351,141689
"2657","ENSBTAG00000004281","13",42622174,42666487,44313
"2658","ENSBTAG00000004282","15",76389709,76562282,172573
"2659","ENSBTAG00000004283","5",82135506,82342855,207349
"2660","ENSBTAG00000004284","17",72702974,72716296,13322
"2661","ENSBTAG00000004286","17",72716770,72732379,15609
"2662","ENSBTAG00000004287","6",103394278,103497766,103488
"2663","ENSBTAG00000004288","23",25209814,25224154,14340
"2664","ENSBTAG00000004290","18",35478077,35479909,1832
"2665","ENSBTAG00000004291","X",3968970,4042579,73609
"2666","ENSBTAG00000004292","6",103327385,103388983,61598
"2667","ENSBTAG00000004294","7",16608165,16640661,32496
"2668","ENSBTAG00000004295","11",93028887,93046862,17975
"2669","ENSBTAG00000004296","11",93046923,93081450,34527
"2670","ENSBTAG00000004297","11",1237943,1576166,338223
"2671","ENSBTAG00000004300","7",16653091,16660988,7897
"2672","ENSBTAG00000004302","13",7387520,7413038,25518
"2673","ENSBTAG00000004303","10",60012457,60071272,58815
"2674","ENSBTAG00000004305","16",63646670,63652245,5575
"2675","ENSBTAG00000004307","12",21615450,21646981,31531
"2676","ENSBTAG00000004310","21",57831036,57847913,16877
"2677","ENSBTAG00000004315","3",120423895,120482640,58745
"2678","ENSBTAG00000004316","6",108778999,108831026,52027
"2679","ENSBTAG00000004318","26",23292989,23317114,24125
"2680","ENSBTAG00000004321","26",23323218,23341592,18374
"2681","ENSBTAG00000004322","10",86488645,86492108,3463
"2682","ENSBTAG00000004328","11",5501359,5522717,21358
"2683","ENSBTAG00000004329","6",56945688,57025931,80243
"2684","ENSBTAG00000004330","26",37240310,37268612,28302
"2685","ENSBTAG00000004333","3",9350633,9394688,44055
"2686","ENSBTAG00000004334","3",9324285,9350657,26372
"2687","ENSBTAG00000004337","5",25515716,25542997,27281
"2688","ENSBTAG00000004339","21",19998520,20005965,7445
"2689","ENSBTAG00000004342","29",44625952,44628525,2573
"2690","ENSBTAG00000004343","29",44628778,44643562,14784
"2691","ENSBTAG00000004344","27",15078089,15243974,165885
"2692","ENSBTAG00000004347","23",20061552,20136992,75440
"2693","ENSBTAG00000004348","29",46258414,46269659,11245
"2694","ENSBTAG00000004349","5",28547803,28552009,4206
"2695","ENSBTAG00000004351","20",23285000,23352421,67421
"2696","ENSBTAG00000004352","11",45013217,45034289,21072
"2697","ENSBTAG00000004355","29",28330721,28353409,22688
"2698","ENSBTAG00000004356","29",28351069,28365789,14720
"2699","ENSBTAG00000004358","16",55204247,55232009,27762
"2700","ENSBTAG00000004361","16",55238448,55250178,11730
"2701","ENSBTAG00000004362","16",55267223,55277874,10651
"2702","ENSBTAG00000004364","11",47866198,47884245,18047
"2703","ENSBTAG00000004367","5",57065720,57069211,3491
"2704","ENSBTAG00000004368","18",35517797,35609581,91784
"2705","ENSBTAG00000004371","5",57042171,57065001,22830
"2706","ENSBTAG00000004374","5",57031093,57034101,3008
"2707","ENSBTAG00000004375","18",35612392,35618416,6024
"2708","ENSBTAG00000004376","5",57015019,57028863,13844
"2709","ENSBTAG00000004377","18",51684205,51710421,26216
"2710","ENSBTAG00000004378","5",57009388,57011422,2034
"2711","ENSBTAG00000004379","18",51712248,51729614,17366
"2712","ENSBTAG00000004380","5",56997911,57009477,11566
"2713","ENSBTAG00000004381","3",87457691,87458650,959
"2714","ENSBTAG00000004383","3",49925230,50044652,119422
"2715","ENSBTAG00000004384","5",56979557,56994574,15017
"2716","ENSBTAG00000004386","25",9913007,9913678,671
"2717","ENSBTAG00000004387","13",35229884,35260074,30190
"2718","ENSBTAG00000004388","12",60696709,60699237,2528
"2719","ENSBTAG00000004392","29",45759885,45769622,9737
"2720","ENSBTAG00000004394","9",28522081,28642574,120493
"2721","ENSBTAG00000004398","4",56808963,57722182,913219
"2722","ENSBTAG00000004399","4",57220961,57223087,2126
"2723","ENSBTAG00000004400","11",101536817,101618215,81398
"2724","ENSBTAG00000004401","12",73169073,73313726,144653
"2725","ENSBTAG00000004402","13",57347419,57356139,8720
"2726","ENSBTAG00000004403","7",16951668,16957071,5403
"2727","ENSBTAG00000004405","4",87783954,87862973,79019
"2728","ENSBTAG00000004406","19",8092267,8492726,400459
"2729","ENSBTAG00000004407","16",68370670,68640645,269975
"2730","ENSBTAG00000004409","10",36022720,36034673,11953
"2731","ENSBTAG00000004411","14",38295064,38345541,50477
"2732","ENSBTAG00000004413","7",95035646,95120697,85051
"2733","ENSBTAG00000004414","16",23426971,23439750,12779
"2734","ENSBTAG00000004415","7",50070571,50075962,5391
"2735","ENSBTAG00000004416","2",126273255,126286771,13516
"2736","ENSBTAG00000004418","2",132788953,132793411,4458
"2737","ENSBTAG00000004420","10",36050714,36074743,24029
"2738","ENSBTAG00000004421","10",36077444,36079398,1954
"2739","ENSBTAG00000004422","3",48405843,48504005,98162
"2740","ENSBTAG00000004423","15",8008850,8351636,342786
"2741","ENSBTAG00000004426","6",24740451,24778339,37888
"2742","ENSBTAG00000004427","5",5839779,6001503,161724
"2743","ENSBTAG00000004428","6",24736918,24739414,2496
"2744","ENSBTAG00000004429","13",64681475,64685560,4085
"2745","ENSBTAG00000004430","10",75936963,75968043,31080
"2746","ENSBTAG00000004432","X",59037880,59172293,134413
"2747","ENSBTAG00000004436","23",27225234,27233488,8254
"2748","ENSBTAG00000004438","26",30430380,30482338,51958
"2749","ENSBTAG00000004440","12",75634639,75662955,28316
"2750","ENSBTAG00000004442","23",27214132,27221612,7480
"2751","ENSBTAG00000004448","15",76674259,76779196,104937
"2752","ENSBTAG00000004449","19",7651698,7676942,25244
"2753","ENSBTAG00000004452","16",80589408,80629377,39969
"2754","ENSBTAG00000004456","15",31725892,31807945,82053
"2755","ENSBTAG00000004457","17",53610136,53626039,15903
"2756","ENSBTAG00000004458","17",53594452,53605589,11137
"2757","ENSBTAG00000004459","1",44948235,45061338,113103
"2758","ENSBTAG00000004460","18",2081391,2114246,32855
"2759","ENSBTAG00000004461","X",129734317,129795926,61609
"2760","ENSBTAG00000004462","21",44020190,44285742,265552
"2761","ENSBTAG00000004463","18",55078241,55086739,8498
"2762","ENSBTAG00000004464","19",43971820,43985354,13534
"2763","ENSBTAG00000004468","8",85252060,85255684,3624
"2764","ENSBTAG00000004471","1",43047976,43111603,63627
"2765","ENSBTAG00000004472","9",95047811,95055302,7491
"2766","ENSBTAG00000004474","13",38054188,38080191,26003
"2767","ENSBTAG00000004475","19",17694779,17696848,2069
"2768","ENSBTAG00000004476","14",30690619,30723593,32974
"2769","ENSBTAG00000004484","5",24070404,24345243,274839
"2770","ENSBTAG00000004488","5",112755748,112811605,55857
"2771","ENSBTAG00000004489","19",12448418,12504606,56188
"2772","ENSBTAG00000004490","23",28868629,28879147,10518
"2773","ENSBTAG00000004492","16",66173944,66212958,39014
"2774","ENSBTAG00000004494","5",55856907,55863814,6907
"2775","ENSBTAG00000004495","1",136872755,136905496,32741
"2776","ENSBTAG00000004497","11",2557280,2630187,72907
"2777","ENSBTAG00000004498","10",76395356,76445041,49685
"2778","ENSBTAG00000004499","8",102734527,102832523,97996
"2779","ENSBTAG00000004502","25",2898064,2928536,30472
"2780","ENSBTAG00000004503","4",71616842,71623983,7141
"2781","ENSBTAG00000004505","25",2932365,2948268,15903
"2782","ENSBTAG00000004508","11",104498693,104518490,19797
"2783","ENSBTAG00000004509","25",2962335,2979321,16986
"2784","ENSBTAG00000004510","11",104521668,104582043,60375
"2785","ENSBTAG00000004511","11",104592021,104777976,185955
"2786","ENSBTAG00000004512","22",56543425,56581017,37592
"2787","ENSBTAG00000004515","28",6451737,6519065,67328
"2788","ENSBTAG00000004517","28",7196026,7269320,73294
"2789","ENSBTAG00000004518","14",62721044,62888891,167847
"2790","ENSBTAG00000004519","2",120096973,120100228,3255
"2791","ENSBTAG00000004521","7",21239214,21243937,4723
"2792","ENSBTAG00000004524","7",21225361,21239159,13798
"2793","ENSBTAG00000004531","11",60465179,60478339,13160
"2794","ENSBTAG00000004532","5",82845307,82866184,20877
"2795","ENSBTAG00000004538","1",157545780,157559387,13607
"2796","ENSBTAG00000004540","4",113890451,113925971,35520
"2797","ENSBTAG00000004541","5",103796256,103806242,9986
"2798","ENSBTAG00000004542","11",101450754,101465047,14293
"2799","ENSBTAG00000004544","11",4443235,4454741,11506
"2800","ENSBTAG00000004547","5",99803497,99815138,11641
"2801","ENSBTAG00000004549","X",75909884,75941925,32041
"2802","ENSBTAG00000004551","25",573401,578970,5569
"2803","ENSBTAG00000004552","3",15627232,15643667,16435
"2804","ENSBTAG00000004553","7",6898966,6924156,25190
"2805","ENSBTAG00000004554","2",133201115,133340081,138966
"2806","ENSBTAG00000004555","2",26888630,27029783,141153
"2807","ENSBTAG00000004556","5",101438341,101451219,12878
"2808","ENSBTAG00000004557","2",27067552,27092118,24566
"2809","ENSBTAG00000004558","10",64962587,65019546,56959
"2810","ENSBTAG00000004560","11",13572359,13584327,11968
"2811","ENSBTAG00000004561","15",62560118,62588024,27906
"2812","ENSBTAG00000004562","11",13559661,13564560,4899
"2813","ENSBTAG00000004564","1",115303718,115524968,221250
"2814","ENSBTAG00000004565","11",77426654,77427329,675
"2815","ENSBTAG00000004568","18",14016352,14032348,15996
"2816","ENSBTAG00000004569","5",4839406,4881606,42200
"2817","ENSBTAG00000004570","16",38201016,38286243,85227
"2818","ENSBTAG00000004571","8",102517331,102538052,20721
"2819","ENSBTAG00000004572","8",102543323,102551138,7815
"2820","ENSBTAG00000004574","6",10925712,11037983,112271
"2821","ENSBTAG00000004575","4",31618071,31751438,133367
"2822","ENSBTAG00000004578","8",69462493,69468447,5954
"2823","ENSBTAG00000004580","15",83282746,83298109,15363
"2824","ENSBTAG00000004581","15",83214109,83241883,27774
"2825","ENSBTAG00000004582","13",54262435,54283294,20859
"2826","ENSBTAG00000004583","15",83251879,83278952,27073
"2827","ENSBTAG00000004585","3",103567783,103700789,133006
"2828","ENSBTAG00000004586","X",59872141,59877713,5572
"2829","ENSBTAG00000004587","5",19213683,19217415,3732
"2830","ENSBTAG00000004588","18",51965948,51979728,13780
"2831","ENSBTAG00000004590","3",103540446,103565396,24950
"2832","ENSBTAG00000004591","3",44218427,44349718,131291
"2833","ENSBTAG00000004592","8",28835713,28874310,38597
"2834","ENSBTAG00000004593","27",40151096,40196738,45642
"2835","ENSBTAG00000004594","15",6143194,6153615,10421
"2836","ENSBTAG00000004595","14",1513837,1542041,28204
"2837","ENSBTAG00000004596","14",1503538,1508569,5031
"2838","ENSBTAG00000004597","X",87028786,87034387,5601
"2839","ENSBTAG00000004598","21",57478772,57507655,28883
"2840","ENSBTAG00000004599","1",56759915,56773309,13394
"2841","ENSBTAG00000004600","X",87037310,87064562,27252
"2842","ENSBTAG00000004601","1",56737576,56750712,13136
"2843","ENSBTAG00000004602","7",46474432,46481011,6579
"2844","ENSBTAG00000004603","2",120344483,120393885,49402
"2845","ENSBTAG00000004604","7",5230990,5241638,10648
"2846","ENSBTAG00000004607","25",25339151,25591807,252656
"2847","ENSBTAG00000004608","18",57101773,57132189,30416
"2848","ENSBTAG00000004611","18",57077371,57083950,6579
"2849","ENSBTAG00000004612","26",25203123,26181296,978173
"2850","ENSBTAG00000004613","27",37958250,38233860,275610
"2851","ENSBTAG00000004617","19",57052694,57110943,58249
"2852","ENSBTAG00000004620","13",38404270,38419061,14791
"2853","ENSBTAG00000004622","13",38428211,38533119,104908
"2854","ENSBTAG00000004625","13",42775506,42811085,35579
"2855","ENSBTAG00000004629","20",71607452,71645487,38035
"2856","ENSBTAG00000004630","7",4422721,4430541,7820
"2857","ENSBTAG00000004631","10",70698684,70832429,133745
"2858","ENSBTAG00000004632","19",50892622,50920822,28200
"2859","ENSBTAG00000004633","17",6526967,6534197,7230
"2860","ENSBTAG00000004635","19",34398896,34413732,14836
"2861","ENSBTAG00000004636","26",42206907,42261348,54441
"2862","ENSBTAG00000004637","19",47110902,47203442,92540
"2863","ENSBTAG00000004639","15",76568896,76576776,7880
"2864","ENSBTAG00000004640","4",88202846,88222320,19474
"2865","ENSBTAG00000004641","16",1986639,2125248,138609
"2866","ENSBTAG00000004643","4",87988365,88069929,81564
"2867","ENSBTAG00000004645","21",24144715,24509041,364326
"2868","ENSBTAG00000004647","17",17164837,17171147,6310
"2869","ENSBTAG00000004650","24",2551345,2649888,98543
"2870","ENSBTAG00000004651","19",35594173,35605444,11271
"2871","ENSBTAG00000004652","7",3704311,3708931,4620
"2872","ENSBTAG00000004653","6",41984735,42116814,132079
"2873","ENSBTAG00000004654","5",70931732,70950944,19212
"2874","ENSBTAG00000004657","7",80545528,80546895,1367
"2875","ENSBTAG00000004658","4",104972275,104999289,27014
"2876","ENSBTAG00000004659","2",86007358,86024344,16986
"2877","ENSBTAG00000004660","5",30304006,30378369,74363
"2878","ENSBTAG00000004662","26",11104543,11177185,72642
"2879","ENSBTAG00000004663","11",98906989,98918673,11684
"2880","ENSBTAG00000004664","11",98919110,98933125,14015
"2881","ENSBTAG00000004672","15",20275874,20359908,84034
"2882","ENSBTAG00000004674","11",25110252,25125594,15342
"2883","ENSBTAG00000004675","19",30616167,30640005,23838
"2884","ENSBTAG00000004676","25",41391488,41402061,10573
"2885","ENSBTAG00000004679","21",65238068,65267367,29299
"2886","ENSBTAG00000004680","19",25181428,25204840,23412
"2887","ENSBTAG00000004685","22",17328399,17573739,245340
"2888","ENSBTAG00000004688","3",91411766,91445037,33271
"2889","ENSBTAG00000004692","10",38833674,38834018,344
"2890","ENSBTAG00000004693","17",55876002,56046137,170135
"2891","ENSBTAG00000004694","10",25807460,25857008,49548
"2892","ENSBTAG00000004695","11",98461647,98466335,4688
"2893","ENSBTAG00000004705","1",66482692,66608853,126161
"2894","ENSBTAG00000004706","X",86777328,86790232,12904
"2895","ENSBTAG00000004709","7",919314,984704,65390
"2896","ENSBTAG00000004710","19",13971352,14036151,64799
"2897","ENSBTAG00000004712","13",59647340,59648311,971
"2898","ENSBTAG00000004714","7",16521617,16525532,3915
"2899","ENSBTAG00000004715","3",106986685,106998848,12163
"2900","ENSBTAG00000004716","7",16513147,16514562,1415
"2901","ENSBTAG00000004718","5",36712229,36730075,17846
"2902","ENSBTAG00000004720","14",33382025,33475206,93181
"2903","ENSBTAG00000004721","5",96766338,96785806,19468
"2904","ENSBTAG00000004722","11",22040726,22080803,40077
"2905","ENSBTAG00000004723","19",48368410,48482779,114369
"2906","ENSBTAG00000004727","25",2376855,2380341,3486
"2907","ENSBTAG00000004729","25",2380374,2391571,11197
"2908","ENSBTAG00000004732","10",76890176,77019425,129249
"2909","ENSBTAG00000004735","18",40424330,40434833,10503
"2910","ENSBTAG00000004736","19",56117146,56181857,64711
"2911","ENSBTAG00000004738","16",49273661,49284772,11111
"2912","ENSBTAG00000004739","26",37562768,37602774,40006
"2913","ENSBTAG00000004741","7",70893041,70912103,19062
"2914","ENSBTAG00000004742","1",146975141,147244722,269581
"2915","ENSBTAG00000004745","17",18305040,18377855,72815
"2916","ENSBTAG00000004746","19",63147954,63292314,144360
"2917","ENSBTAG00000004749","22",48124642,48152515,27873
"2918","ENSBTAG00000004750","13",66799390,66838313,38923
"2919","ENSBTAG00000004751","18",49799380,49880032,80652
"2920","ENSBTAG00000004753","5",49919291,49945730,26439
"2921","ENSBTAG00000004754","1",140132680,140470932,338252
"2922","ENSBTAG00000004755","18",49880406,49892720,12314
"2923","ENSBTAG00000004757","18",49897503,49924389,26886
"2924","ENSBTAG00000004760","28",41909763,41915538,5775
"2925","ENSBTAG00000004761","14",469132,470687,1555
"2926","ENSBTAG00000004765","15",49505112,49506068,956
"2927","ENSBTAG00000004766","18",1832754,1844905,12151
"2928","ENSBTAG00000004767","8",86977449,87083681,106232
"2929","ENSBTAG00000004768","19",34650992,34752887,101895
"2930","ENSBTAG00000004769","8",7625912,7636935,11023
"2931","ENSBTAG00000004770","19",48140003,48192876,52873
"2932","ENSBTAG00000004771","15",43646969,43647729,760
"2933","ENSBTAG00000004772","3",18844273,18892924,48651
"2934","ENSBTAG00000004775","17",41785259,41971774,186515
"2935","ENSBTAG00000004776","3",9912927,9914349,1422
"2936","ENSBTAG00000004777","1",146272607,146280008,7401
"2937","ENSBTAG00000004778","8",85663749,85716393,52644
"2938","ENSBTAG00000004780","10",43233495,43284821,51326
"2939","ENSBTAG00000004781","5",69721989,69837859,115870
"2940","ENSBTAG00000004782","29",45327237,45330137,2900
"2941","ENSBTAG00000004783","29",45329800,45335332,5532
"2942","ENSBTAG00000004785","29",45343481,45346973,3492
"2943","ENSBTAG00000004786","29",45352399,45357252,4853
"2944","ENSBTAG00000004787","19",49624451,49639773,15322
"2945","ENSBTAG00000004788","10",20731298,20734731,3433
"2946","ENSBTAG00000004789","16",80312915,80399065,86150
"2947","ENSBTAG00000004790","16",80305103,80309745,4642
"2948","ENSBTAG00000004791","1",149461702,149496009,34307
"2949","ENSBTAG00000004792","14",80824602,80853922,29320
"2950","ENSBTAG00000004793","6",85968067,85979382,11315
"2951","ENSBTAG00000004795","9",65546265,65550567,4302
"2952","ENSBTAG00000004796","24",58203516,58216348,12832
"2953","ENSBTAG00000004797","6",114718709,114744471,25762
"2954","ENSBTAG00000004799","4",103877533,103947944,70411
"2955","ENSBTAG00000004801","25",13731833,13786815,54982
"2956","ENSBTAG00000004802","21",69312292,69336738,24446
"2957","ENSBTAG00000004803","25",13716797,13731513,14716
"2958","ENSBTAG00000004804","25",13686276,13714338,28062
"2959","ENSBTAG00000004805","18",15565244,15865233,299989
"2960","ENSBTAG00000004806","18",15865422,16091810,226388
"2961","ENSBTAG00000004813","8",101464304,101594549,130245
"2962","ENSBTAG00000004814","11",3650777,3769745,118968
"2963","ENSBTAG00000004815","7",40400620,40439818,39198
"2964","ENSBTAG00000004817","18",15442537,15443092,555
"2965","ENSBTAG00000004820","5",109745905,109755102,9197
"2966","ENSBTAG00000004822","5",109757715,109768623,10908
"2967","ENSBTAG00000004823","11",48659309,48665790,6481
"2968","ENSBTAG00000004824","11",48518871,48654804,135933
"2969","ENSBTAG00000004826","7",15911386,15915021,3635
"2970","ENSBTAG00000004829","29",44337761,44342824,5063
"2971","ENSBTAG00000004832","5",41732670,41918813,186143
"2972","ENSBTAG00000004833","1",44617553,44637448,19895
"2973","ENSBTAG00000004834","22",7113428,7171778,58350
"2974","ENSBTAG00000004835","2",20740712,20760616,19904
"2975","ENSBTAG00000004836","X",54618411,54767142,148731
"2976","ENSBTAG00000004838","18",23234761,23240750,5989
"2977","ENSBTAG00000004840","5",103407687,103419088,11401
"2978","ENSBTAG00000004842","18",25212511,25249920,37409
"2979","ENSBTAG00000004844","18",25251821,25257892,6071
"2980","ENSBTAG00000004848","11",95786174,95805310,19136
"2981","ENSBTAG00000004849","3",26574398,26704608,130210
"2982","ENSBTAG00000004850","12",19243142,19339516,96374
"2983","ENSBTAG00000004851","5",30062441,30093874,31433
"2984","ENSBTAG00000004852","3",20475129,20485097,9968
"2985","ENSBTAG00000004854","10",62242641,62264605,21964
"2986","ENSBTAG00000004855","16",54932618,54942555,9937
"2987","ENSBTAG00000004856","7",1184720,1362136,177416
"2988","ENSBTAG00000004860","7",25037025,25117897,80872
"2989","ENSBTAG00000004861","15",44532808,44541048,8240
"2990","ENSBTAG00000004862","15",44436182,44522347,86165
"2991","ENSBTAG00000004863","15",44368149,44429697,61548
"2992","ENSBTAG00000004864","18",43316097,43398266,82169
"2993","ENSBTAG00000004869","1",19437777,19502580,64803
"2994","ENSBTAG00000004870","28",2098139,2284314,186175
"2995","ENSBTAG00000004871","24",41415091,41433991,18900
"2996","ENSBTAG00000004872","16",51132210,51135384,3174
"2997","ENSBTAG00000004873","16",51136847,51145545,8698
"2998","ENSBTAG00000004874","16",51147301,51151891,4590
"2999","ENSBTAG00000004875","25",2859806,2888334,28528
"3000","ENSBTAG00000004876","5",120037421,120056199,18778
"3001","ENSBTAG00000004877","22",50399202,50417063,17861
"3002","ENSBTAG00000004878","22",50386354,50397870,11516
"3003","ENSBTAG00000004879","X",79528190,79535525,7335
"3004","ENSBTAG00000004881","11",10424409,10446337,21928
"3005","ENSBTAG00000004884","11",10337166,10421482,84316
"3006","ENSBTAG00000004885","3",6677596,6853843,176247
"3007","ENSBTAG00000004886","6",67172309,67176434,4125
"3008","ENSBTAG00000004887","11",10238630,10269100,30470
"3009","ENSBTAG00000004888","6",67165376,67171369,5993
"3010","ENSBTAG00000004891","1",153274404,153318611,44207
"3011","ENSBTAG00000004893","6",114648001,114697373,49372
"3012","ENSBTAG00000004894","4",113328043,113338736,10693
"3013","ENSBTAG00000004895","26",34756223,34799268,43045
"3014","ENSBTAG00000004896","7",60505700,60641090,135390
"3015","ENSBTAG00000004899","26",34909133,35229900,320767
"3016","ENSBTAG00000004901","15",35295398,35400621,105223
"3017","ENSBTAG00000004902","14",69460845,69505807,44962
"3018","ENSBTAG00000004903","19",41721536,41726328,4792
"3019","ENSBTAG00000004905","19",41731625,41735635,4010
"3020","ENSBTAG00000004906","14",69448183,69460811,12628
"3021","ENSBTAG00000004907","19",26489830,26537129,47299
"3022","ENSBTAG00000004908","19",26484296,26489324,5028
"3023","ENSBTAG00000004909","19",26460494,26462445,1951
"3024","ENSBTAG00000004910","19",26455453,26458255,2802
"3025","ENSBTAG00000004911","13",54318945,54322245,3300
"3026","ENSBTAG00000004912","6",88187894,88354991,167097
"3027","ENSBTAG00000004913","19",26450718,26455554,4836
"3028","ENSBTAG00000004915","19",26447390,26450242,2852
"3029","ENSBTAG00000004916","13",54287348,54297677,10329
"3030","ENSBTAG00000004917","5",99603137,99613790,10653
"3031","ENSBTAG00000004920","20",24418261,24418708,447
"3032","ENSBTAG00000004921","6",91186036,91199159,13123
"3033","ENSBTAG00000004922","27",5810038,5856711,46673
"3034","ENSBTAG00000004924","14",23542370,23546868,4498
"3035","ENSBTAG00000004925","18",60018479,60019726,1247
"3036","ENSBTAG00000004926","10",42644327,42655193,10866
"3037","ENSBTAG00000004929","20",32612381,32634378,21997
"3038","ENSBTAG00000004930","10",42664104,42671425,7321
"3039","ENSBTAG00000004931","10",42673879,42705616,31737
"3040","ENSBTAG00000004933","10",42749128,42764722,15594
"3041","ENSBTAG00000004934","10",42750285,42819594,69309
"3042","ENSBTAG00000004936","7",19775155,19782514,7359
"3043","ENSBTAG00000004937","22",59545658,59559392,13734
"3044","ENSBTAG00000004939","18",47417825,47435704,17879
"3045","ENSBTAG00000004940","24",19505280,19818204,312924
"3046","ENSBTAG00000004941","16",59915002,59925320,10318
"3047","ENSBTAG00000004942","6",3432039,3444791,12752
"3048","ENSBTAG00000004943","6",3425574,3431686,6112
"3049","ENSBTAG00000004944","8",495871,571472,75601
"3050","ENSBTAG00000004945","6",3385320,3423390,38070
"3051","ENSBTAG00000004948","11",83673039,83676241,3202
"3052","ENSBTAG00000004949","15",22223059,22228068,5009
"3053","ENSBTAG00000004950","10",26256262,26257893,1631
"3054","ENSBTAG00000004951","15",22228101,22232777,4676
"3055","ENSBTAG00000004952","16",3334950,3362754,27804
"3056","ENSBTAG00000004953","16",3360475,3386704,26229
"3057","ENSBTAG00000004954","14",24946881,25258596,311715
"3058","ENSBTAG00000004955","X",105235090,105341728,106638
"3059","ENSBTAG00000004956","17",67975024,68013366,38342
"3060","ENSBTAG00000004958","4",118732679,119258101,525422
"3061","ENSBTAG00000004961","19",21541950,21577471,35521
"3062","ENSBTAG00000004962","X",13977520,14037004,59484
"3063","ENSBTAG00000004964","26",12777507,12896019,118512
"3064","ENSBTAG00000004965","28",1410148,1464793,54645
"3065","ENSBTAG00000004969","14",424798,428272,3474
"3066","ENSBTAG00000004970","14",417616,424777,7161
"3067","ENSBTAG00000004971","1",58518934,58618308,99374
"3068","ENSBTAG00000004974","1",58619102,58629385,10283
"3069","ENSBTAG00000004975","1",58637237,58735117,97880
"3070","ENSBTAG00000004976","4",30692956,30904166,211210
"3071","ENSBTAG00000004977","1",58735307,58761901,26594
"3072","ENSBTAG00000004979","23",33271110,33309747,38637
"3073","ENSBTAG00000004982","23",33209824,33268580,58756
"3074","ENSBTAG00000004987","3",16347123,16447546,100423
"3075","ENSBTAG00000004988","6",45920952,45940972,20020
"3076","ENSBTAG00000004989","4",92892127,92905297,13170
"3077","ENSBTAG00000004990","10",19888399,20126828,238429
"3078","ENSBTAG00000004991","8",98474958,98536474,61516
"3079","ENSBTAG00000004992","4",92909747,92987982,78235
"3080","ENSBTAG00000004993","13",42019553,42022430,2877
"3081","ENSBTAG00000004995","4",15276632,15320627,43995
"3082","ENSBTAG00000004996","8",98536710,98543210,6500
"3083","ENSBTAG00000004997","8",98544960,98601628,56668
"3084","ENSBTAG00000004999","5",77923734,77950862,27128
"3085","ENSBTAG00000005002","2",129111017,129115576,4559
"3086","ENSBTAG00000005004","28",42262749,42267306,4557
"3087","ENSBTAG00000005005","6",85529905,85548556,18651
"3088","ENSBTAG00000005008","19",18989423,19004078,14655
"3089","ENSBTAG00000005009","7",38775913,38779466,3553
"3090","ENSBTAG00000005010","7",38779127,38784017,4890
"3091","ENSBTAG00000005012","12",29796159,29819628,23469
"3092","ENSBTAG00000005015","26",21863615,21872923,9308
"3093","ENSBTAG00000005016","10",9099553,9335422,235869
"3094","ENSBTAG00000005017","8",85538948,85540420,1472
"3095","ENSBTAG00000005018","5",113310514,113347845,37331
"3096","ENSBTAG00000005019","22",52773679,52778844,5165
"3097","ENSBTAG00000005021","20",63654369,64216207,561838
"3098","ENSBTAG00000005025","14",16074868,16112829,37961
"3099","ENSBTAG00000005026","9",54296791,54379111,82320
"3100","ENSBTAG00000005027","26",49392763,49424030,31267
"3101","ENSBTAG00000005028","25",26267918,26271508,3590
"3102","ENSBTAG00000005029","3",99005834,99022661,16827
"3103","ENSBTAG00000005030","25",26260151,26268621,8470
"3104","ENSBTAG00000005031","25",26253986,26260480,6494
"3105","ENSBTAG00000005033","25",26240206,26247628,7422
"3106","ENSBTAG00000005034","15",56472805,56530219,57414
"3107","ENSBTAG00000005038","21",69255818,69256846,1028
"3108","ENSBTAG00000005039","X",85918875,85943558,24683
"3109","ENSBTAG00000005040","21",56210637,56245304,34667
"3110","ENSBTAG00000005041","11",72930044,72983048,53004
"3111","ENSBTAG00000005042","X",85929321,85992826,63505
"3112","ENSBTAG00000005045","19",37567760,37573005,5245
"3113","ENSBTAG00000005048","19",28955374,28968734,13360
"3114","ENSBTAG00000005049","8",7822291,7874394,52103
"3115","ENSBTAG00000005052","19",28982918,29024862,41944
"3116","ENSBTAG00000005055","6",66757241,66815481,58240
"3117","ENSBTAG00000005057","26",38583166,38611943,28777
"3118","ENSBTAG00000005058","18",34758682,34788087,29405
"3119","ENSBTAG00000005062","6",66819064,66856803,37739
"3120","ENSBTAG00000005063","14",1694331,1697806,3475
"3121","ENSBTAG00000005064","3",23999239,24101046,101807
"3122","ENSBTAG00000005066","1",67055375,67120252,64877
"3123","ENSBTAG00000005067","19",44022180,44035259,13079
"3124","ENSBTAG00000005068","1",118403615,118414343,10728
"3125","ENSBTAG00000005069","29",43316442,43323367,6925
"3126","ENSBTAG00000005071","1",67121600,67210214,88614
"3127","ENSBTAG00000005072","13",31274942,31535596,260654
"3128","ENSBTAG00000005073","29",43322776,43324014,1238
"3129","ENSBTAG00000005075","29",43328457,43332374,3917
"3130","ENSBTAG00000005076","29",43332275,43339711,7436
"3131","ENSBTAG00000005077","28",45022356,45051627,29271
"3132","ENSBTAG00000005078","6",60147025,60159287,12262
"3133","ENSBTAG00000005082","5",82772595,82782365,9770
"3134","ENSBTAG00000005083","9",94820216,94960850,140634
"3135","ENSBTAG00000005085","2",127020869,127035929,15060
"3136","ENSBTAG00000005086","13",66909212,66967486,58274
"3137","ENSBTAG00000005089","25",34121205,34129920,8715
"3138","ENSBTAG00000005090","8",47923884,48006056,82172
"3139","ENSBTAG00000005091","1",80873608,81097089,223481
"3140","ENSBTAG00000005092","8",85905346,86141520,236174
"3141","ENSBTAG00000005093","18",34638138,34650196,12058
"3142","ENSBTAG00000005094","27",15622186,15644508,22322
"3143","ENSBTAG00000005096","9",14833551,14838734,5183
"3144","ENSBTAG00000005098","X",91144490,91145083,593
"3145","ENSBTAG00000005099","3",72964374,72965265,891
"3146","ENSBTAG00000005100","9",14849783,14893385,43602
"3147","ENSBTAG00000005102","4",43312172,43449891,137719
"3148","ENSBTAG00000005103","4",86715415,86718421,3006
"3149","ENSBTAG00000005104","19",54906180,54972843,66663
"3150","ENSBTAG00000005105","2",127089778,127125126,35348
"3151","ENSBTAG00000005106","26",15237569,15277896,40327
"3152","ENSBTAG00000005108","6",39779895,40182890,402995
"3153","ENSBTAG00000005110","4",86734600,87314496,579896
"3154","ENSBTAG00000005111","13",49151441,49185579,34138
"3155","ENSBTAG00000005115","8",102402632,102411013,8381
"3156","ENSBTAG00000005116","8",102413489,102470040,56551
"3157","ENSBTAG00000005119","2",118865174,118946608,81434
"3158","ENSBTAG00000005120","5",59925024,59961156,36132
"3159","ENSBTAG00000005122","1",80506965,80530772,23807
"3160","ENSBTAG00000005124","X",85297817,85436598,138781
"3161","ENSBTAG00000005127","13",55054323,55059934,5611
"3162","ENSBTAG00000005129","26",14823940,14845414,21474
"3163","ENSBTAG00000005133","8",63787511,63836341,48830
"3164","ENSBTAG00000005136","13",17828449,17914912,86463
"3165","ENSBTAG00000005137","16",71591831,71713585,121754
"3166","ENSBTAG00000005138","15",29495311,29521540,26229
"3167","ENSBTAG00000005140","2",133045370,133056409,11039
"3168","ENSBTAG00000005141","10",68531860,68727049,195189
"3169","ENSBTAG00000005142","20",33653738,33656338,2600
"3170","ENSBTAG00000005144","29",50548324,50553197,4873
"3171","ENSBTAG00000005145","21",32245129,32554682,309553
"3172","ENSBTAG00000005146","23",28525598,28527983,2385
"3173","ENSBTAG00000005147","29",26355459,26398708,43249
"3174","ENSBTAG00000005148","25",1162390,1165731,3341
"3175","ENSBTAG00000005149","3",16234047,16236867,2820
"3176","ENSBTAG00000005150","X",33603508,33611381,7873
"3177","ENSBTAG00000005151","11",61723956,62023241,299285
"3178","ENSBTAG00000005152","18",34227970,34273715,45745
"3179","ENSBTAG00000005154","24",42127687,42159372,31685
"3180","ENSBTAG00000005155","1",38275588,38352554,76966
"3181","ENSBTAG00000005156","15",22376632,22382689,6057
"3182","ENSBTAG00000005158","24",42177753,42190058,12305
"3183","ENSBTAG00000005160","29",26326212,26355709,29497
"3184","ENSBTAG00000005161","3",16210799,16232969,22170
"3185","ENSBTAG00000005162","1",38315772,38331093,15321
"3186","ENSBTAG00000005163","3",16751302,16755589,4287
"3187","ENSBTAG00000005164","20",24073111,24083959,10848
"3188","ENSBTAG00000005165","28",13532555,13584917,52362
"3189","ENSBTAG00000005166","3",16739580,16750665,11085
"3190","ENSBTAG00000005168","3",120194352,120234324,39972
"3191","ENSBTAG00000005169","20",14840060,14973475,133415
"3192","ENSBTAG00000005170","18",25526925,25553754,26829
"3193","ENSBTAG00000005174","21",21622233,21631473,9240
"3194","ENSBTAG00000005176","20",36614256,36639869,25613
"3195","ENSBTAG00000005178","17",63628770,63639339,10569
"3196","ENSBTAG00000005180","2",35855477,36075061,219584
"3197","ENSBTAG00000005181","13",73707706,73711211,3505
"3198","ENSBTAG00000005182","23",27829737,27836725,6988
"3199","ENSBTAG00000005183","17",63607270,63628642,21372
"3200","ENSBTAG00000005184","13",73717980,73720596,2616
"3201","ENSBTAG00000005186","13",73736862,73741808,4946
"3202","ENSBTAG00000005189","11",102911371,102922553,11182
"3203","ENSBTAG00000005190","11",102926937,102960628,33691
"3204","ENSBTAG00000005191","22",59282274,59296089,13815
"3205","ENSBTAG00000005193","15",33457223,33485670,28447
"3206","ENSBTAG00000005195","25",2678891,2690118,11227
"3207","ENSBTAG00000005196","3",69968102,69990582,22480
"3208","ENSBTAG00000005197","25",33673612,33729479,55867
"3209","ENSBTAG00000005198","7",53622273,53729308,107035
"3210","ENSBTAG00000005202","13",38706055,38706764,709
"3211","ENSBTAG00000005203","1",111876350,111901894,25544
"3212","ENSBTAG00000005205","9",34276663,34353054,76391
"3213","ENSBTAG00000005206","23",25056028,25066519,10491
"3214","ENSBTAG00000005207","2",119504023,119527187,23164
"3215","ENSBTAG00000005208","25",9621279,9853824,232545
"3216","ENSBTAG00000005209","1",82116216,82377026,260810
"3217","ENSBTAG00000005210","10",13352814,13356161,3347
"3218","ENSBTAG00000005211","10",13357473,13362297,4824
"3219","ENSBTAG00000005212","1",81984064,82104798,120734
"3220","ENSBTAG00000005213","10",13362441,13404844,42403
"3221","ENSBTAG00000005214","10",13404231,13420411,16180
"3222","ENSBTAG00000005215","15",28659560,28672319,12759
"3223","ENSBTAG00000005217","10",61336614,61337249,635
"3224","ENSBTAG00000005218","15",37935445,38095528,160083
"3225","ENSBTAG00000005219","X",24492,127593,103101
"3226","ENSBTAG00000005221","5",107577726,107706571,128845
"3227","ENSBTAG00000005222","8",59988842,59998097,9255
"3228","ENSBTAG00000005225","5",107708193,107734428,26235
"3229","ENSBTAG00000005227","3",7599092,7846132,247040
"3230","ENSBTAG00000005228","15",46791967,46796810,4843
"3231","ENSBTAG00000005230","1",109417834,109426592,8758
"3232","ENSBTAG00000005231","16",50775398,50830785,55387
"3233","ENSBTAG00000005234","2",64874976,64937074,62098
"3234","ENSBTAG00000005235","2",67391409,67756692,365283
"3235","ENSBTAG00000005236","15",46765294,46776272,10978
"3236","ENSBTAG00000005238","2",64157472,64872456,714984
"3237","ENSBTAG00000005239","2",99840653,99841243,590
"3238","ENSBTAG00000005240","17",43972110,43977394,5284
"3239","ENSBTAG00000005243","5",100679985,100732005,52020
"3240","ENSBTAG00000005244","12",32604390,32606967,2577
"3241","ENSBTAG00000005246","5",29182879,29412313,229434
"3242","ENSBTAG00000005247","8",76429785,76773898,344113
"3243","ENSBTAG00000005248","23",45996663,46011021,14358
"3244","ENSBTAG00000005249","7",53035569,53054126,18557
"3245","ENSBTAG00000005250","X",36728398,36742298,13900
"3246","ENSBTAG00000005251","15",47865341,47880349,15008
"3247","ENSBTAG00000005252","X",89049928,89055743,5815
"3248","ENSBTAG00000005257","11",43760329,43791822,31493
"3249","ENSBTAG00000005259","15",53440626,53451256,10630
"3250","ENSBTAG00000005260","6",36693193,36730559,37366
"3251","ENSBTAG00000005261","18",49408225,49450004,41779
"3252","ENSBTAG00000005263","17",339603,511267,171664
"3253","ENSBTAG00000005265","7",81294847,81304041,9194
"3254","ENSBTAG00000005268","10",37485317,37507804,22487
"3255","ENSBTAG00000005269","10",51184626,51209368,24742
"3256","ENSBTAG00000005272","7",20418396,20426869,8473
"3257","ENSBTAG00000005273","11",6876050,6915249,39199
"3258","ENSBTAG00000005275","13",72948009,73028130,80121
"3259","ENSBTAG00000005278","15",43077354,43091213,13859
"3260","ENSBTAG00000005280","13",73028616,73052210,23594
"3261","ENSBTAG00000005284","12",20784319,20816359,32040
"3262","ENSBTAG00000005285","4",104264742,104273391,8649
"3263","ENSBTAG00000005287","14",24664833,24675169,10336
"3264","ENSBTAG00000005288","7",49676538,49695901,19363
"3265","ENSBTAG00000005289","7",6479012,6498287,19275
"3266","ENSBTAG00000005293","7",49701226,49731890,30664
"3267","ENSBTAG00000005294","X",55464519,55507905,43386
"3268","ENSBTAG00000005295","7",6455407,6471362,15955
"3269","ENSBTAG00000005296","18",55940456,55944163,3707
"3270","ENSBTAG00000005299","12",53037256,53068390,31134
"3271","ENSBTAG00000005300","16",52283707,52343027,59320
"3272","ENSBTAG00000005301","9",52625780,52797848,172068
"3273","ENSBTAG00000005304","16",42564305,42568355,4050
"3274","ENSBTAG00000005305","5",15532029,15543699,11670
"3275","ENSBTAG00000005306","22",55886672,55889873,3201
"3276","ENSBTAG00000005308","15",6889168,6906278,17110
"3277","ENSBTAG00000005309","12",69073166,69096804,23638
"3278","ENSBTAG00000005310","12",69099073,69124754,25681
"3279","ENSBTAG00000005311","5",112617058,112629599,12541
"3280","ENSBTAG00000005312","7",6412462,6453156,40694
"3281","ENSBTAG00000005313","1",82610922,82631983,21061
"3282","ENSBTAG00000005314","16",41684079,41711310,27231
"3283","ENSBTAG00000005315","2",111044032,111044777,745
"3284","ENSBTAG00000005316","13",42926081,42955333,29252
"3285","ENSBTAG00000005318","12",33169752,33179038,9286
"3286","ENSBTAG00000005321","22",38430995,38900735,469740
"3287","ENSBTAG00000005324","24",61969586,61973814,4228
"3288","ENSBTAG00000005326","7",60859330,60906196,46866
"3289","ENSBTAG00000005327","22",7499864,7541920,42056
"3290","ENSBTAG00000005328","10",49707745,49771123,63378
"3291","ENSBTAG00000005333","5",73814162,73829888,15726
"3292","ENSBTAG00000005337","3",94334017,94401951,67934
"3293","ENSBTAG00000005338","15",63298794,63316294,17500
"3294","ENSBTAG00000005339","23",17281915,17297193,15278
"3295","ENSBTAG00000005340","15",34481846,34730051,248205
"3296","ENSBTAG00000005343","15",34443695,34473486,29791
"3297","ENSBTAG00000005344","10",11392564,11404461,11897
"3298","ENSBTAG00000005345","17",54326081,54337078,10997
"3299","ENSBTAG00000005347","17",54340390,54359773,19383
"3300","ENSBTAG00000005349","15",43878304,43882620,4316
"3301","ENSBTAG00000005351","12",24807037,24815859,8822
"3302","ENSBTAG00000005352","19",20576451,20591495,15044
"3303","ENSBTAG00000005353","2",107351796,107358964,7168
"3304","ENSBTAG00000005354","3",117074081,117235735,161654
"3305","ENSBTAG00000005355","23",3040820,3050862,10042
"3306","ENSBTAG00000005356","15",43744114,43870868,126754
"3307","ENSBTAG00000005357","15",29653348,29663611,10263
"3308","ENSBTAG00000005359","16",21808003,21900539,92536
"3309","ENSBTAG00000005362","23",3019707,3038485,18778
"3310","ENSBTAG00000005363","18",48192636,48195524,2888
"3311","ENSBTAG00000005364","15",29666771,29674064,7293
"3312","ENSBTAG00000005365","5",80123807,80185224,61417
"3313","ENSBTAG00000005367","18",56291592,56327148,35556
"3314","ENSBTAG00000005370","5",79807657,80114645,306988
"3315","ENSBTAG00000005371","15",29676203,29682311,6108
"3316","ENSBTAG00000005372","24",37577864,37876652,298788
"3317","ENSBTAG00000005373","10",46993261,47022836,29575
"3318","ENSBTAG00000005376","9",83070230,83085504,15274
"3319","ENSBTAG00000005377","4",24961801,24966045,4244
"3320","ENSBTAG00000005378","X",51241608,51254455,12847
"3321","ENSBTAG00000005379","16",3531266,3551208,19942
"3322","ENSBTAG00000005380","20",25956799,25967149,10350
"3323","ENSBTAG00000005384","5",25722716,25742083,19367
"3324","ENSBTAG00000005385","17",62851819,62854683,2864
"3325","ENSBTAG00000005386","1",96452471,96483056,30585
"3326","ENSBTAG00000005390","18",49038391,49043335,4944
"3327","ENSBTAG00000005392","15",1658125,1664400,6275
"3328","ENSBTAG00000005393","3",386406,455451,69045
"3329","ENSBTAG00000005394","6",88173958,88184784,10826
"3330","ENSBTAG00000005395","X",45684507,45688637,4130
"3331","ENSBTAG00000005396","8",8147972,8164211,16239
"3332","ENSBTAG00000005397","16",75582021,75621057,39036
"3333","ENSBTAG00000005400","9",43655210,43768691,113481
"3334","ENSBTAG00000005403","8",111039144,111046449,7305
"3335","ENSBTAG00000005404","14",35439046,35441608,2562
"3336","ENSBTAG00000005408","2",89504933,89512321,7388
"3337","ENSBTAG00000005410","16",35397169,35882504,485335
"3338","ENSBTAG00000005412","24",57348965,57546293,197328
"3339","ENSBTAG00000005413","18",25044850,25102326,57476
"3340","ENSBTAG00000005416","2",89519710,89530269,10559
"3341","ENSBTAG00000005419","4",113450547,113463258,12711
"3342","ENSBTAG00000005424","15",34734865,34779954,45089
"3343","ENSBTAG00000005425","8",7642403,7695092,52689
"3344","ENSBTAG00000005426","10",101862077,101874842,12765
"3345","ENSBTAG00000005427","10",101875399,101923805,48406
"3346","ENSBTAG00000005429","10",58230692,58235389,4697
"3347","ENSBTAG00000005430","1",74489024,74609955,120931
"3348","ENSBTAG00000005431","22",17919376,17976405,57029
"3349","ENSBTAG00000005432","11",49587704,49605849,18145
"3350","ENSBTAG00000005433","22",17852252,17874641,22389
"3351","ENSBTAG00000005434","7",5762752,5781737,18985
"3352","ENSBTAG00000005436","22",28835679,28939485,103806
"3353","ENSBTAG00000005439","3",34726393,34805116,78723
"3354","ENSBTAG00000005441","7",51825588,51830683,5095
"3355","ENSBTAG00000005442","3",78408935,78508278,99343
"3356","ENSBTAG00000005443","3",78338108,78408732,70624
"3357","ENSBTAG00000005444","2",4300416,4399011,98595
"3358","ENSBTAG00000005445","3",78274131,78317314,43183
"3359","ENSBTAG00000005446","25",34576779,34581163,4384
"3360","ENSBTAG00000005448","25",34549739,34572255,22516
"3361","ENSBTAG00000005453","5",77234501,77463105,228604
"3362","ENSBTAG00000005454","27",29120091,29188786,68695
"3363","ENSBTAG00000005455","25",7721211,7774425,53214
"3364","ENSBTAG00000005456","9",19702310,19748999,46689
"3365","ENSBTAG00000005458","25",1978231,2006139,27908
"3366","ENSBTAG00000005461","19",27319235,27321042,1807
"3367","ENSBTAG00000005462","19",27322295,27335891,13596
"3368","ENSBTAG00000005464","5",30987932,31009399,21467
"3369","ENSBTAG00000005465","5",105474032,105495946,21914
"3370","ENSBTAG00000005466","8",69902137,69905977,3840
"3371","ENSBTAG00000005469","8",69908360,69923010,14650
"3372","ENSBTAG00000005470","8",69923304,69973864,50560
"3373","ENSBTAG00000005471","21",20933485,20958904,25419
"3374","ENSBTAG00000005474","2",95846071,95897815,51744
"3375","ENSBTAG00000005475","4",106966075,107001714,35639
"3376","ENSBTAG00000005477","2",122807359,122833480,26121
"3377","ENSBTAG00000005478","17",70125940,70144379,18439
"3378","ENSBTAG00000005479","10",51696914,51859296,162382
"3379","ENSBTAG00000005481","10",51535794,51679258,143464
"3380","ENSBTAG00000005482","29",8236863,8540319,303456
"3381","ENSBTAG00000005483","4",119432686,119508052,75366
"3382","ENSBTAG00000005488","22",51000461,51038025,37564
"3383","ENSBTAG00000005489","10",93774543,93813580,39037
"3384","ENSBTAG00000005490","22",50983772,50997485,13713
"3385","ENSBTAG00000005492","13",18091181,18127217,36036
"3386","ENSBTAG00000005493","6",113395848,113504809,108961
"3387","ENSBTAG00000005495","8",75860475,75861510,1035
"3388","ENSBTAG00000005496","X",85226521,85273689,47168
"3389","ENSBTAG00000005497","24",21051655,21117141,65486
"3390","ENSBTAG00000005498","14",15144664,15167777,23113
"3391","ENSBTAG00000005499","4",5809814,5961428,151614
"3392","ENSBTAG00000005501","2",31429997,31587069,157072
"3393","ENSBTAG00000005503","1",146320299,146345063,24764
"3394","ENSBTAG00000005504","13",64041297,64048878,7581
"3395","ENSBTAG00000005514","20",58644763,58864848,220085
"3396","ENSBTAG00000005517","2",90787057,90810889,23832
"3397","ENSBTAG00000005519","8",60593718,60713864,120146
"3398","ENSBTAG00000005522","1",121852796,121878087,25291
"3399","ENSBTAG00000005523","25",15541403,15887474,346071
"3400","ENSBTAG00000005524","4",48265379,48296503,31124
"3401","ENSBTAG00000005525","11",93083908,93109821,25913
"3402","ENSBTAG00000005526","4",48291963,48507532,215569
"3403","ENSBTAG00000005527","18",53241345,53249607,8262
"3404","ENSBTAG00000005532","23",16610717,16625004,14287
"3405","ENSBTAG00000005533","23",16629759,16653065,23306
"3406","ENSBTAG00000005534","19",26437553,26447840,10287
"3407","ENSBTAG00000005536","23",16652951,16657240,4289
"3408","ENSBTAG00000005540","1",904168,904713,545
"3409","ENSBTAG00000005542","3",94802846,94942191,139345
"3410","ENSBTAG00000005546","19",37882057,37885440,3383
"3411","ENSBTAG00000005547","10",43046520,43051985,5465
"3412","ENSBTAG00000005548","4",88178402,88190862,12460
"3413","ENSBTAG00000005550","10",43053808,43157640,103832
"3414","ENSBTAG00000005556","19",55217714,55227282,9568
"3415","ENSBTAG00000005557","9",102278808,102392284,113476
"3416","ENSBTAG00000005559","27",19002363,19004406,2043
"3417","ENSBTAG00000005560","14",21160085,21250282,90197
"3418","ENSBTAG00000005562","2",41676135,42259624,583489
"3419","ENSBTAG00000005564","10",14905205,15030499,125294
"3420","ENSBTAG00000005565","10",15051437,15067688,16251
"3421","ENSBTAG00000005567","6",60982593,61011444,28851
"3422","ENSBTAG00000005568","28",42588737,42653298,64561
"3423","ENSBTAG00000005570","7",49525958,49530902,4944
"3424","ENSBTAG00000005571","13",64976219,65081867,105648
"3425","ENSBTAG00000005572","25",2561192,2572656,11464
"3426","ENSBTAG00000005573","13",65085556,65086387,831
"3427","ENSBTAG00000005574","8",11176838,11194518,17680
"3428","ENSBTAG00000005576","18",56802302,56804604,2302
"3429","ENSBTAG00000005577","29",43886441,43887760,1319
"3430","ENSBTAG00000005578","29",43878865,43886391,7526
"3431","ENSBTAG00000005580","3",102576579,102603276,26697
"3432","ENSBTAG00000005581","7",16776216,16779697,3481
"3433","ENSBTAG00000005583","3",102573104,102575815,2711
"3434","ENSBTAG00000005584","2",118178703,118179368,665
"3435","ENSBTAG00000005585","14",16165840,16200097,34257
"3436","ENSBTAG00000005586","10",65098687,65114697,16010
"3437","ENSBTAG00000005587","23",27399292,27409242,9950
"3438","ENSBTAG00000005588","23",27396902,27402108,5206
"3439","ENSBTAG00000005589","23",27387692,27396606,8914
"3440","ENSBTAG00000005592","7",16390698,16399664,8966
"3441","ENSBTAG00000005595","5",116635061,116651306,16245
"3442","ENSBTAG00000005596","2",104619851,104649017,29166
"3443","ENSBTAG00000005603","6",90902720,90904851,2131
"3444","ENSBTAG00000005604","1",64397770,64415902,18132
"3445","ENSBTAG00000005606","5",26029920,26032423,2503
"3446","ENSBTAG00000005607","X",78440506,78470166,29660
"3447","ENSBTAG00000005609","15",47812242,47819532,7290
"3448","ENSBTAG00000005614","11",45721302,45778536,57234
"3449","ENSBTAG00000005615","18",50817523,50837100,19577
"3450","ENSBTAG00000005616","X",20090334,20094597,4263
"3451","ENSBTAG00000005617","22",60519605,60539566,19961
"3452","ENSBTAG00000005620","15",54593621,54598584,4963
"3453","ENSBTAG00000005622","25",10226637,10273178,46541
"3454","ENSBTAG00000005623","5",26867427,26877858,10431
"3455","ENSBTAG00000005626","5",59885089,59886081,992
"3456","ENSBTAG00000005627","15",27831366,27858164,26798
"3457","ENSBTAG00000005628","2",126804336,126806114,1778
"3458","ENSBTAG00000005629","2",126775472,126806913,31441
"3459","ENSBTAG00000005630","23",27546267,27555831,9564
"3460","ENSBTAG00000005631","23",27533912,27546157,12245
"3461","ENSBTAG00000005633","20",7683041,7967728,284687
"3462","ENSBTAG00000005634","23",27528402,27533357,4955
"3463","ENSBTAG00000005635","24",32560390,32575991,15601
"3464","ENSBTAG00000005638","24",32536815,32553953,17138
"3465","ENSBTAG00000005639","27",30820059,30820820,761
"3466","ENSBTAG00000005644","17",44853887,44968139,114252
"3467","ENSBTAG00000005647","21",69438528,69448221,9693
"3468","ENSBTAG00000005648","17",11675939,11677612,1673
"3469","ENSBTAG00000005650","4",69125496,69297030,171534
"3470","ENSBTAG00000005652","1",82927910,82933513,5603
"3471","ENSBTAG00000005653","4",33006669,33080056,73387
"3472","ENSBTAG00000005654","11",50094264,50095274,1010
"3473","ENSBTAG00000005657","1",82918317,82920472,2155
"3474","ENSBTAG00000005658","1",82894597,82909029,14432
"3475","ENSBTAG00000005660","1",82878892,82888239,9347
"3476","ENSBTAG00000005661","10",37826017,37866625,40608
"3477","ENSBTAG00000005663","10",37875148,37888393,13245
"3478","ENSBTAG00000005664","19",22514070,22548856,34786
"3479","ENSBTAG00000005665","19",22566859,22586884,20025
"3480","ENSBTAG00000005666","28",26507231,26577692,70461
"3481","ENSBTAG00000005667","8",57835669,57838652,2983
"3482","ENSBTAG00000005668","6",22459117,22542658,83541
"3483","ENSBTAG00000005670","2",135893247,135911229,17982
"3484","ENSBTAG00000005671","15",48052811,48054616,1805
"3485","ENSBTAG00000005672","13",74896588,74980777,84189
"3486","ENSBTAG00000005674","23",27494530,27498491,3961
"3487","ENSBTAG00000005675","23",27480743,27494225,13482
"3488","ENSBTAG00000005676","23",27467178,27480388,13210
"3489","ENSBTAG00000005678","17",50718350,50773650,55300
"3490","ENSBTAG00000005679","25",37360828,37377623,16795
"3491","ENSBTAG00000005681","9",23131908,23352169,220261
"3492","ENSBTAG00000005682","12",76079653,76300630,220977
"3493","ENSBTAG00000005683","24",50478561,50487376,8815
"3494","ENSBTAG00000005685","18",35040304,35051023,10719
"3495","ENSBTAG00000005688","11",105822041,105825257,3216
"3496","ENSBTAG00000005691","17",34801330,34860849,59519
"3497","ENSBTAG00000005693","19",44427063,44436404,9341
"3498","ENSBTAG00000005694","10",86374541,86407514,32973
"3499","ENSBTAG00000005695","17",34747124,34807159,60035
"3500","ENSBTAG00000005696","19",44448991,44478957,29966
"3501","ENSBTAG00000005697","10",40090850,40143903,53053
"3502","ENSBTAG00000005699","9",42257477,42358090,100613
"3503","ENSBTAG00000005700","10",82375960,82454849,78889
"3504","ENSBTAG00000005702","18",25813885,25882542,68657
"3505","ENSBTAG00000005704","11",7031920,7057285,25365
"3506","ENSBTAG00000005708","26",11351677,11435642,83965
"3507","ENSBTAG00000005709","24",34541295,34591097,49802
"3508","ENSBTAG00000005710","15",23712341,23832796,120455
"3509","ENSBTAG00000005711","6",104705029,104738615,33586
"3510","ENSBTAG00000005712","6",104587343,104705746,118403
"3511","ENSBTAG00000005714","10",30288637,30294046,5409
"3512","ENSBTAG00000005715","26",25645862,25648860,2998
"3513","ENSBTAG00000005716","3",14124443,14130828,6385
"3514","ENSBTAG00000005717","3",110930986,110934249,3263
"3515","ENSBTAG00000005718","8",25117062,25131177,14115
"3516","ENSBTAG00000005719","3",110927018,110929691,2673
"3517","ENSBTAG00000005723","1",57725471,57740983,15512
"3518","ENSBTAG00000005724","X",51443291,51477597,34306
"3519","ENSBTAG00000005725","27",35048477,35114325,65848
"3520","ENSBTAG00000005726","4",69735135,69744610,9475
"3521","ENSBTAG00000005728","22",50434292,50441745,7453
"3522","ENSBTAG00000005729","9",50809427,50885025,75598
"3523","ENSBTAG00000005730","27",36522605,36539773,17168
"3524","ENSBTAG00000005732","3",109676148,109691945,15797
"3525","ENSBTAG00000005733","13",70030863,70232300,201437
"3526","ENSBTAG00000005734","24",34163203,34192624,29421
"3527","ENSBTAG00000005735","5",26370053,26378227,8174
"3528","ENSBTAG00000005736","11",73210558,73220120,9562
"3529","ENSBTAG00000005738","24",56868850,56976543,107693
"3530","ENSBTAG00000005741","2",24448619,24451184,2565
"3531","ENSBTAG00000005743","20",10105978,10137931,31953
"3532","ENSBTAG00000005744","6",98037930,98065079,27149
"3533","ENSBTAG00000005745","6",98072170,98118656,46486
"3534","ENSBTAG00000005748","14",22229596,22232109,2513
"3535","ENSBTAG00000005750","13",60450874,60457087,6213
"3536","ENSBTAG00000005751","10",38020205,38032350,12145
"3537","ENSBTAG00000005753","10",19170936,19196490,25554
"3538","ENSBTAG00000005754","6",36449102,36471153,22051
"3539","ENSBTAG00000005756","29",44577773,44584122,6349
"3540","ENSBTAG00000005757","25",27267596,27277781,10185
"3541","ENSBTAG00000005759","2",132710095,132713984,3889
"3542","ENSBTAG00000005760","12",50330163,50540017,209854
"3543","ENSBTAG00000005761","18",51051123,51066367,15244
"3544","ENSBTAG00000005762","14",1669738,1672645,2907
"3545","ENSBTAG00000005763","18",56216856,56224488,7632
"3546","ENSBTAG00000005765","5",110777318,110804983,27665
"3547","ENSBTAG00000005766","18",56235067,56239827,4760
"3548","ENSBTAG00000005769","1",136814837,136869560,54723
"3549","ENSBTAG00000005772","29",43386613,43388631,2018
"3550","ENSBTAG00000005773","6",57145040,57182331,37291
"3551","ENSBTAG00000005776","X",35186592,35242092,55500
"3552","ENSBTAG00000005780","26",22778536,22791499,12963
"3553","ENSBTAG00000005782","3",59509795,59524072,14277
"3554","ENSBTAG00000005784","3",111603940,112289188,685248
"3555","ENSBTAG00000005785","4",61976304,62068881,92577
"3556","ENSBTAG00000005786","21",56774464,56794358,19894
"3557","ENSBTAG00000005787","1",52879903,52953508,73605
"3558","ENSBTAG00000005788","3",27624363,27677204,52841
"3559","ENSBTAG00000005791","26",45300494,45324610,24116
"3560","ENSBTAG00000005792","26",45324631,45341336,16705
"3561","ENSBTAG00000005793","3",9460717,9471684,10967
"3562","ENSBTAG00000005795","26",45341113,45394948,53835
"3563","ENSBTAG00000005796","3",9420056,9462754,42698
"3564","ENSBTAG00000005797","3",120153536,120164464,10928
"3565","ENSBTAG00000005798","25",33808726,33816136,7410
"3566","ENSBTAG00000005799","3",12272293,12372265,99972
"3567","ENSBTAG00000005800","7",64771807,65118334,346527
"3568","ENSBTAG00000005803","8",85312677,85383567,70890
"3569","ENSBTAG00000005805","3",51334931,51372381,37450
"3570","ENSBTAG00000005807","28",28402858,28619073,216215
"3571","ENSBTAG00000005808","23",45406618,45413390,6772
"3572","ENSBTAG00000005809","3",21695356,21742236,46880
"3573","ENSBTAG00000005810","3",21684181,21695746,11565
"3574","ENSBTAG00000005812","16",49329176,49404364,75188
"3575","ENSBTAG00000005814","10",20993568,21007790,14222
"3576","ENSBTAG00000005815","10",20992517,21003538,11021
"3577","ENSBTAG00000005816","10",20986934,20992851,5917
"3578","ENSBTAG00000005819","18",53492950,53513160,20210
"3579","ENSBTAG00000005824","19",36937900,37020386,82486
"3580","ENSBTAG00000005825","27",8413462,8621182,207720
"3581","ENSBTAG00000005826","8",45852527,45894473,41946
"3582","ENSBTAG00000005827","9",40387289,40559531,172242
"3583","ENSBTAG00000005828","11",380816,516486,135670
"3584","ENSBTAG00000005830","18",53825011,53849753,24742
"3585","ENSBTAG00000005832","29",45190089,45208600,18511
"3586","ENSBTAG00000005833","5",87560456,87610028,49572
"3587","ENSBTAG00000005835","16",28945398,28949586,4188
"3588","ENSBTAG00000005838","21",33840386,33847405,7019
"3589","ENSBTAG00000005842","23",16988512,17008684,20172
"3590","ENSBTAG00000005843","15",24957690,24968465,10775
"3591","ENSBTAG00000005844","21",33814296,33839750,25454
"3592","ENSBTAG00000005845","21",33797784,33805071,7287
"3593","ENSBTAG00000005846","21",33790109,33801826,11717
"3594","ENSBTAG00000005847","11",86489509,86615280,125771
"3595","ENSBTAG00000005848","10",54636043,54780229,144186
"3596","ENSBTAG00000005850","23",17008895,17013149,4254
"3597","ENSBTAG00000005851","9",79629539,79700323,70784
"3598","ENSBTAG00000005852","X",93319321,93445155,125834
"3599","ENSBTAG00000005854","3",116552174,116565322,13148
"3600","ENSBTAG00000005857","22",55057076,55075939,18863
"3601","ENSBTAG00000005858","3",112513879,112521623,7744
"3602","ENSBTAG00000005859","5",31183432,31213145,29713
"3603","ENSBTAG00000005861","5",31054293,31090446,36153
"3604","ENSBTAG00000005862","1",107045175,107078624,33449
"3605","ENSBTAG00000005863","5",26419016,26509448,90432
"3606","ENSBTAG00000005865","10",58334675,58366916,32241
"3607","ENSBTAG00000005866","X",86216968,86340606,123638
"3608","ENSBTAG00000005868","5",96875314,96912825,37511
"3609","ENSBTAG00000005869","9",15242718,15373861,131143
"3610","ENSBTAG00000005870","11",40797526,40886322,88796
"3611","ENSBTAG00000005871","1",98280869,98347503,66634
"3612","ENSBTAG00000005877","14",16588055,16609466,21411
"3613","ENSBTAG00000005884","8",102571581,102595151,23570
"3614","ENSBTAG00000005888","23",11546127,11611239,65112
"3615","ENSBTAG00000005891","3",12577541,12610184,32643
"3616","ENSBTAG00000005892","11",3047488,3087280,39792
"3617","ENSBTAG00000005893","14",23034280,23070124,35844
"3618","ENSBTAG00000005895","11",47341507,47342176,669
"3619","ENSBTAG00000005897","10",77109412,77189928,80516
"3620","ENSBTAG00000005898","14",23070145,23095949,25804
"3621","ENSBTAG00000005903","29",45807108,45927821,120713
"3622","ENSBTAG00000005904","2",120969745,120986234,16489
"3623","ENSBTAG00000005905","8",11522164,11532925,10761
"3624","ENSBTAG00000005907","8",11504625,11521008,16383
"3625","ENSBTAG00000005908","25",37980915,38005641,24726
"3626","ENSBTAG00000005909","3",79914162,79925489,11327
"3627","ENSBTAG00000005910","3",79741920,79838382,96462
"3628","ENSBTAG00000005912","3",101832496,101841691,9195
"3629","ENSBTAG00000005913","15",82831299,82859455,28156
"3630","ENSBTAG00000005915","13",16387218,16564334,177116
"3631","ENSBTAG00000005916","24",438848,470317,31469
"3632","ENSBTAG00000005917","24",341633,418744,77111
"3633","ENSBTAG00000005922","22",58979972,59009178,29206
"3634","ENSBTAG00000005923","15",64746521,64932891,186370
"3635","ENSBTAG00000005925","12",79269215,79290951,21736
"3636","ENSBTAG00000005928","26",9137086,9201162,64076
"3637","ENSBTAG00000005929","29",44713352,44746745,33393
"3638","ENSBTAG00000005932","6",37181075,37301540,120465
"3639","ENSBTAG00000005933","16",43628175,43675419,47244
"3640","ENSBTAG00000005934","25",40725959,40751351,25392
"3641","ENSBTAG00000005936","5",110197351,110230629,33278
"3642","ENSBTAG00000005937","13",61413129,61463663,50534
"3643","ENSBTAG00000005938","3",52530347,52537415,7068
"3644","ENSBTAG00000005940","17",55750475,55759908,9433
"3645","ENSBTAG00000005945","15",25080841,25098492,17651
"3646","ENSBTAG00000005946","1",87355950,87482259,126309
"3647","ENSBTAG00000005947","28",29791112,29799836,8724
"3648","ENSBTAG00000005950","X",33715329,33720020,4691
"3649","ENSBTAG00000005951","17",72191445,72195702,4257
"3650","ENSBTAG00000005952","10",21743260,21745419,2159
"3651","ENSBTAG00000005953","X",52955361,52961688,6327
"3652","ENSBTAG00000005955","9",95298134,95338541,40407
"3653","ENSBTAG00000005957","13",77193956,77229841,35885
"3654","ENSBTAG00000005958","8",74490929,74555716,64787
"3655","ENSBTAG00000005960","9",68939450,69149312,209862
"3656","ENSBTAG00000005961","7",23073268,23192277,119009
"3657","ENSBTAG00000005963","28",35665736,35682716,16980
"3658","ENSBTAG00000005964","6",117743309,117771804,28495
"3659","ENSBTAG00000005965","26",50687923,50723720,35797
"3660","ENSBTAG00000005967","23",16255756,16363361,107605
"3661","ENSBTAG00000005968","17",1510259,1846345,336086
"3662","ENSBTAG00000005969","13",63461769,63490553,28784
"3663","ENSBTAG00000005970","17",68052596,68056965,4369
"3664","ENSBTAG00000005971","23",16367966,16382111,14145
"3665","ENSBTAG00000005972","8",38152375,38152857,482
"3666","ENSBTAG00000005973","3",31890059,31901999,11940
"3667","ENSBTAG00000005974","23",14967227,14990620,23393
"3668","ENSBTAG00000005975","23",14992681,14998169,5488
"3669","ENSBTAG00000005976","3",6634642,6664654,30012
"3670","ENSBTAG00000005978","19",28354288,28428847,74559
"3671","ENSBTAG00000005979","26",16021677,16041531,19854
"3672","ENSBTAG00000005980","23",48048576,48110128,61552
"3673","ENSBTAG00000005984","10",71479280,71670966,191686
"3674","ENSBTAG00000005985","24",5330904,5339295,8391
"3675","ENSBTAG00000005986","2",4790398,4791060,662
"3676","ENSBTAG00000005987","2",4676998,4785534,108536
"3677","ENSBTAG00000005989","6",37140752,37166191,25439
"3678","ENSBTAG00000005990","3",42027458,42039822,12364
"3679","ENSBTAG00000005994","10",15763555,15791716,28161
"3680","ENSBTAG00000005996","28",43214484,43231590,17106
"3681","ENSBTAG00000005997","4",32880212,32982260,102048
"3682","ENSBTAG00000005998","17",18582256,18600421,18165
"3683","ENSBTAG00000005999","7",19761502,19774023,12521
"3684","ENSBTAG00000006001","7",19749298,19761854,12556
"3685","ENSBTAG00000006002","13",54471197,54521148,49951
"3686","ENSBTAG00000006003","2",4454874,4530094,75220
"3687","ENSBTAG00000006005","7",19734266,19744478,10212
"3688","ENSBTAG00000006007","7",19706831,19734112,27281
"3689","ENSBTAG00000006008","11",103394881,103437809,42928
"3690","ENSBTAG00000006010","5",67273124,67445234,172110
"3691","ENSBTAG00000006013","5",67451740,67511409,59669
"3692","ENSBTAG00000006014","26",22889324,23012954,123630
"3693","ENSBTAG00000006015","23",17114387,17143658,29271
"3694","ENSBTAG00000006016","23",17144373,17153545,9172
"3695","ENSBTAG00000006017","26",23019572,23026090,6518
"3696","ENSBTAG00000006019","11",2871450,2933372,61922
"3697","ENSBTAG00000006021","13",64699831,64746870,47039
"3698","ENSBTAG00000006022","4",112715024,112720180,5156
"3699","ENSBTAG00000006024","21",34509672,34512801,3129
"3700","ENSBTAG00000006025","11",59837506,59859806,22300
"3701","ENSBTAG00000006026","X",51927910,51929405,1495
"3702","ENSBTAG00000006027","11",59860971,60057096,196125
"3703","ENSBTAG00000006029","4",76758582,76844759,86177
"3704","ENSBTAG00000006030","16",797547,800444,2897
"3705","ENSBTAG00000006031","7",90154320,90667809,513489
"3706","ENSBTAG00000006033","X",4220533,4223698,3165
"3707","ENSBTAG00000006034","X",4219166,4220445,1279
"3708","ENSBTAG00000006035","19",40006305,40015041,8736
"3709","ENSBTAG00000006036","5",94967133,94991578,24445
"3710","ENSBTAG00000006037","13",73111319,73125821,14502
"3711","ENSBTAG00000006039","5",94945968,94965348,19380
"3712","ENSBTAG00000006040","5",64074489,64165062,90573
"3713","ENSBTAG00000006042","28",43421335,43445677,24342
"3714","ENSBTAG00000006043","13",37756664,37789222,32558
"3715","ENSBTAG00000006044","6",58266641,58336226,69585
"3716","ENSBTAG00000006045","19",51034066,51044560,10494
"3717","ENSBTAG00000006048","19",44717121,44737363,20242
"3718","ENSBTAG00000006049","2",89470523,89485958,15435
"3719","ENSBTAG00000006050","3",20713195,20714518,1323
"3720","ENSBTAG00000006051","19",44745276,44776088,30812
"3721","ENSBTAG00000006052","19",44781286,44802191,20905
"3722","ENSBTAG00000006054","19",44803416,44810326,6910
"3723","ENSBTAG00000006056","19",44814089,44816001,1912
"3724","ENSBTAG00000006059","2",73398067,73416298,18231
"3725","ENSBTAG00000006060","15",61692631,62145149,452518
"3726","ENSBTAG00000006063","13",47421389,47429786,8397
"3727","ENSBTAG00000006064","7",11783948,11805417,21469
"3728","ENSBTAG00000006065","13",47430406,47436478,6072
"3729","ENSBTAG00000006066","13",47441800,47498715,56915
"3730","ENSBTAG00000006067","7",18469286,18472439,3153
"3731","ENSBTAG00000006068","7",11766152,11784471,18319
"3732","ENSBTAG00000006069","7",18466099,18467633,1534
"3733","ENSBTAG00000006070","7",18414908,18464857,49949
"3734","ENSBTAG00000006071","29",47511216,47538255,27039
"3735","ENSBTAG00000006072","19",36285469,36297388,11919
"3736","ENSBTAG00000006073","7",11759483,11765568,6085
"3737","ENSBTAG00000006075","11",50516577,50551425,34848
"3738","ENSBTAG00000006078","13",17518539,17555784,37245
"3739","ENSBTAG00000006080","7",12679399,12704101,24702
"3740","ENSBTAG00000006081","3",30609356,30615182,5826
"3741","ENSBTAG00000006082","7",12676733,12679144,2411
"3742","ENSBTAG00000006083","7",12671237,12675537,4300
"3743","ENSBTAG00000006084","2",131986298,132006686,20388
"3744","ENSBTAG00000006085","2",131971819,131985982,14163
"3745","ENSBTAG00000006086","19",14587761,14613432,25671
"3746","ENSBTAG00000006087","19",58115492,58127648,12156
"3747","ENSBTAG00000006088","19",58095733,58114837,19104
"3748","ENSBTAG00000006089","19",58084841,58095624,10783
"3749","ENSBTAG00000006099","3",19572074,19611272,39198
"3750","ENSBTAG00000006101","3",19555183,19565649,10466
"3751","ENSBTAG00000006103","5",112706895,112730021,23126
"3752","ENSBTAG00000006104","5",112734335,112743206,8871
"3753","ENSBTAG00000006107","7",93950265,94018468,68203
"3754","ENSBTAG00000006108","17",71231375,71239854,8479
"3755","ENSBTAG00000006111","28",4062692,4065152,2460
"3756","ENSBTAG00000006112","28",4065261,4076916,11655
"3757","ENSBTAG00000006114","17",52946671,52968059,21388
"3758","ENSBTAG00000006116","7",3965453,3998161,32708
"3759","ENSBTAG00000006117","25",2321450,2364796,43346
"3760","ENSBTAG00000006118","17",52924879,52940209,15330
"3761","ENSBTAG00000006121","18",61982147,61990216,8069
"3762","ENSBTAG00000006122","X",90965898,91123238,157340
"3763","ENSBTAG00000006124","7",3930008,3965897,35889
"3764","ENSBTAG00000006125","3",101208672,101213711,5039
"3765","ENSBTAG00000006126","25",25009630,25089814,80184
"3766","ENSBTAG00000006128","3",101207678,101208337,659
"3767","ENSBTAG00000006129","25",25087968,25327424,239456
"3768","ENSBTAG00000006130","21",48394033,48395926,1893
"3769","ENSBTAG00000006132","14",2711735,2775154,63419
"3770","ENSBTAG00000006134","13",63888186,63905671,17485
"3771","ENSBTAG00000006135","13",63918996,63920656,1660
"3772","ENSBTAG00000006138","4",39939436,40145312,205876
"3773","ENSBTAG00000006139","18",55660346,55703316,42970
"3774","ENSBTAG00000006140","21",21098837,21105918,7081
"3775","ENSBTAG00000006141","21",21115571,21133179,17608
"3776","ENSBTAG00000006142","1",113326569,113371550,44981
"3777","ENSBTAG00000006143","15",76282608,76319986,37378
"3778","ENSBTAG00000006147","1",113234818,113319984,85166
"3779","ENSBTAG00000006150","11",9113958,9158980,45022
"3780","ENSBTAG00000006152","4",83911360,83911797,437
"3781","ENSBTAG00000006155","22",52998333,53000232,1899
"3782","ENSBTAG00000006156","6",110872406,110901795,29389
"3783","ENSBTAG00000006158","1",53353203,53467047,113844
"3784","ENSBTAG00000006159","2",41183416,41378419,195003
"3785","ENSBTAG00000006160","5",57314953,57319225,4272
"3786","ENSBTAG00000006161","4",51622340,51735652,113312
"3787","ENSBTAG00000006162","11",11326325,11369731,43406
"3788","ENSBTAG00000006165","X",119515820,119532069,16249
"3789","ENSBTAG00000006166","23",50850791,50862194,11403
"3790","ENSBTAG00000006167","3",51223913,51316954,93041
"3791","ENSBTAG00000006168","2",18758172,18779396,21224
"3792","ENSBTAG00000006170","23",9254929,9267702,12773
"3793","ENSBTAG00000006173","17",72117340,72121854,4514
"3794","ENSBTAG00000006174","1",95639747,95650387,10640
"3795","ENSBTAG00000006175","16",79949862,80022792,72930
"3796","ENSBTAG00000006176","15",1889884,2497441,607557
"3797","ENSBTAG00000006177","12",35523662,35582364,58702
"3798","ENSBTAG00000006179","22",59370198,59370893,695
"3799","ENSBTAG00000006185","7",15587514,15594237,6723
"3800","ENSBTAG00000006186","16",18818847,18890932,72085
"3801","ENSBTAG00000006187","19",34082571,34085106,2535
"3802","ENSBTAG00000006188","16",18892333,19815906,923573
"3803","ENSBTAG00000006189","19",51259300,51262303,3003
"3804","ENSBTAG00000006191","21",59205291,59220746,15455
"3805","ENSBTAG00000006193","22",16649490,16705519,56029
"3806","ENSBTAG00000006194","29",44006997,44013529,6532
"3807","ENSBTAG00000006195","29",44025896,44029041,3145
"3808","ENSBTAG00000006197","8",29490420,29559002,68582
"3809","ENSBTAG00000006199","29",44028101,44030509,2408
"3810","ENSBTAG00000006200","5",112006046,112086674,80628
"3811","ENSBTAG00000006201","10",60695198,60712381,17183
"3812","ENSBTAG00000006202","5",112092012,112115729,23717
"3813","ENSBTAG00000006204","5",112115956,112159105,43149
"3814","ENSBTAG00000006205","5",112121010,112122070,1060
"3815","ENSBTAG00000006208","18",18655907,18720625,64718
"3816","ENSBTAG00000006209","14",46164456,46477513,313057
"3817","ENSBTAG00000006212","25",32905098,33023011,117913
"3818","ENSBTAG00000006213","14",56697846,56698406,560
"3819","ENSBTAG00000006214","8",70414275,70527527,113252
"3820","ENSBTAG00000006221","18",25644891,25674917,30026
"3821","ENSBTAG00000006222","1",126884717,127026615,141898
"3822","ENSBTAG00000006223","2",125473679,125486124,12445
"3823","ENSBTAG00000006225","2",125448288,125470852,22564
"3824","ENSBTAG00000006227","21",30538294,30554581,16287
"3825","ENSBTAG00000006231","21",30555711,30614979,59268
"3826","ENSBTAG00000006232","4",113931167,113956890,25723
"3827","ENSBTAG00000006233","20",31464792,31542859,78067
"3828","ENSBTAG00000006234","3",16686148,16700685,14537
"3829","ENSBTAG00000006235","3",16625276,16664624,39348
"3830","ENSBTAG00000006239","25",42246841,42262415,15574
"3831","ENSBTAG00000006240","8",107057826,107068836,11010
"3832","ENSBTAG00000006241","7",12838368,12854497,16129
"3833","ENSBTAG00000006242","X",102323656,102437200,113544
"3834","ENSBTAG00000006243","13",59456875,59465525,8650
"3835","ENSBTAG00000006244","7",12824061,12837556,13495
"3836","ENSBTAG00000006245","7",12820087,12824499,4412
"3837","ENSBTAG00000006246","5",25786249,25812785,26536
"3838","ENSBTAG00000006247","7",12816113,12820042,3929
"3839","ENSBTAG00000006250","19",40432365,40455099,22734
"3840","ENSBTAG00000006251","7",12812758,12813064,306
"3841","ENSBTAG00000006252","X",4481267,4489392,8125
"3842","ENSBTAG00000006253","4",92797675,92825735,28060
"3843","ENSBTAG00000006255","16",2255641,2292885,37244
"3844","ENSBTAG00000006256","5",94342435,94455619,113184
"3845","ENSBTAG00000006259","11",10475427,10496960,21533
"3846","ENSBTAG00000006260","16",62043278,62080970,37692
"3847","ENSBTAG00000006261","2",4872953,4878988,6035
"3848","ENSBTAG00000006262","2",4842239,4887427,45188
"3849","ENSBTAG00000006263","25",17988332,18004842,16510
"3850","ENSBTAG00000006264","25",18009950,18028531,18581
"3851","ENSBTAG00000006268","X",37587308,37604668,17360
"3852","ENSBTAG00000006270","21",66936747,66945064,8317
"3853","ENSBTAG00000006272","25",1589481,1595175,5694
"3854","ENSBTAG00000006273","5",114521296,114554743,33447
"3855","ENSBTAG00000006276","19",53358290,53366382,8092
"3856","ENSBTAG00000006277","19",53335620,53347068,11448
"3857","ENSBTAG00000006278","13",64554623,64561144,6521
"3858","ENSBTAG00000006280","19",53005648,53334641,328993
"3859","ENSBTAG00000006282","15",21635824,21660814,24990
"3860","ENSBTAG00000006287","23",44941916,45131898,189982
"3861","ENSBTAG00000006288","28",43285950,43376863,90913
"3862","ENSBTAG00000006291","18",19131365,19199820,68455
"3863","ENSBTAG00000006293","X",18258976,18295598,36622
"3864","ENSBTAG00000006295","3",28308795,28314030,5235
"3865","ENSBTAG00000006296","X",33911757,33922135,10378
"3866","ENSBTAG00000006305","11",98538932,98549627,10695
"3867","ENSBTAG00000006307","6",102227496,102276940,49444
"3868","ENSBTAG00000006320","3",43039359,43079725,40366
"3869","ENSBTAG00000006321","3",43006658,43034731,28073
"3870","ENSBTAG00000006322","15",43374690,43468654,93964
"3871","ENSBTAG00000006323","9",94425091,94514466,89375
"3872","ENSBTAG00000006324","5",56340377,56346527,6150
"3873","ENSBTAG00000006325","4",76917098,76988105,71007
"3874","ENSBTAG00000006326","5",68542281,68603070,60789
"3875","ENSBTAG00000006328","22",50246619,50336220,89601
"3876","ENSBTAG00000006330","22",50218344,50242674,24330
"3877","ENSBTAG00000006335","5",56325609,56339539,13930
"3878","ENSBTAG00000006341","10",69899955,69931987,32032
"3879","ENSBTAG00000006342","2",125145420,125147786,2366
"3880","ENSBTAG00000006343","11",6689610,6728985,39375
"3881","ENSBTAG00000006345","15",51352000,51376520,24520
"3882","ENSBTAG00000006346","20",62513771,62580674,66903
"3883","ENSBTAG00000006347","18",36343222,36373620,30398
"3884","ENSBTAG00000006349","2",127052889,127070881,17992
"3885","ENSBTAG00000006350","23",16893160,16899654,6494
"3886","ENSBTAG00000006352","13",53682431,53743786,61355
"3887","ENSBTAG00000006353","18",39027225,39035340,8115
"3888","ENSBTAG00000006354","18",39037402,39043531,6129
"3889","ENSBTAG00000006355","2",127042911,127050544,7633
"3890","ENSBTAG00000006357","23",16899607,16902449,2842
"3891","ENSBTAG00000006359","4",106788865,106804335,15470
"3892","ENSBTAG00000006360","20",12417798,12432414,14616
"3893","ENSBTAG00000006363","21",52283866,52287484,3618
"3894","ENSBTAG00000006364","3",14506327,14509256,2929
"3895","ENSBTAG00000006366","10",20800020,20809340,9320
"3896","ENSBTAG00000006367","9",69887189,69890613,3424
"3897","ENSBTAG00000006368","7",39216407,39219191,2784
"3898","ENSBTAG00000006369","5",82081715,82125299,43584
"3899","ENSBTAG00000006370","3",14486486,14501164,14678
"3900","ENSBTAG00000006371","7",39225401,39243186,17785
"3901","ENSBTAG00000006372","5",82047183,82063595,16412
"3902","ENSBTAG00000006374","7",39244051,39247998,3947
"3903","ENSBTAG00000006377","4",76617184,76633185,16001
"3904","ENSBTAG00000006378","23",50555148,50581180,26032
"3905","ENSBTAG00000006379","23",50529746,50551585,21839
"3906","ENSBTAG00000006380","X",119016521,119020244,3723
"3907","ENSBTAG00000006383","X",119014567,119015361,794
"3908","ENSBTAG00000006384","X",118973583,118979594,6011
"3909","ENSBTAG00000006385","14",1797368,1862330,64962
"3910","ENSBTAG00000006386","9",64058498,64059455,957
"3911","ENSBTAG00000006387","18",35326864,35338625,11761
"3912","ENSBTAG00000006388","1",71101138,71112719,11581
"3913","ENSBTAG00000006391","25",21250396,21261282,10886
"3914","ENSBTAG00000006392","10",102131716,102435752,304036
"3915","ENSBTAG00000006393","24",56786355,56822198,35843
"3916","ENSBTAG00000006395","26",25714368,25732401,18033
"3917","ENSBTAG00000006396","18",44782828,44812532,29704
"3918","ENSBTAG00000006397","19",28728646,28730292,1646
"3919","ENSBTAG00000006398","9",88528925,88529104,179
"3920","ENSBTAG00000006404","18",35338638,35344538,5900
"3921","ENSBTAG00000006405","25",21268379,21293162,24783
"3922","ENSBTAG00000006408","16",38526584,38602120,75536
"3923","ENSBTAG00000006409","1",97562712,97580517,17805
"3924","ENSBTAG00000006410","25",21293320,21322278,28958
"3925","ENSBTAG00000006411","18",35349992,35353414,3422
"3926","ENSBTAG00000006413","10",28406090,28458754,52664
"3927","ENSBTAG00000006414","18",35353692,35368781,15089
"3928","ENSBTAG00000006415","1",97543291,97557519,14228
"3929","ENSBTAG00000006416","10",28388336,28391846,3510
"3930","ENSBTAG00000006417","18",35370766,35381914,11148
"3931","ENSBTAG00000006419","18",62274658,62285833,11175
"3932","ENSBTAG00000006420","2",90864689,91017391,152702
"3933","ENSBTAG00000006422","18",65769086,65775447,6361
"3934","ENSBTAG00000006423","5",112558716,112567981,9265
"3935","ENSBTAG00000006428","7",39797175,39816270,19095
"3936","ENSBTAG00000006429","5",112568047,112617811,49764
"3937","ENSBTAG00000006431","28",25906029,25906824,795
"3938","ENSBTAG00000006432","2",111212142,111215329,3187
"3939","ENSBTAG00000006434","6",6233764,6435034,201270
"3940","ENSBTAG00000006438","2",134843160,134846603,3443
"3941","ENSBTAG00000006439","X",2680554,3007250,326696
"3942","ENSBTAG00000006440","10",12315689,12354764,39075
"3943","ENSBTAG00000006441","3",31846429,31863330,16901
"3944","ENSBTAG00000006443","15",75202012,75285991,83979
"3945","ENSBTAG00000006445","26",10341908,10355935,14027
"3946","ENSBTAG00000006446","8",65903973,66088484,184511
"3947","ENSBTAG00000006447","25",18491967,18539999,48032
"3948","ENSBTAG00000006448","25",18541026,18565241,24215
"3949","ENSBTAG00000006449","25",18556283,18617087,60804
"3950","ENSBTAG00000006451","1",60306484,60407701,101217
"3951","ENSBTAG00000006452","15",29019465,29023621,4156
"3952","ENSBTAG00000006453","15",29025582,29032726,7144
"3953","ENSBTAG00000006457","25",27543234,27544133,899
"3954","ENSBTAG00000006463","10",86137703,86156692,18989
"3955","ENSBTAG00000006464","5",109458483,109477483,19000
"3956","ENSBTAG00000006466","3",32494132,32533031,38899
"3957","ENSBTAG00000006468","17",46727461,46762107,34646
"3958","ENSBTAG00000006470","10",38039980,38129334,89354
"3959","ENSBTAG00000006471","1",69962379,70053523,91144
"3960","ENSBTAG00000006472","X",133303369,133333184,29815
"3961","ENSBTAG00000006474","11",29782764,29793436,10672
"3962","ENSBTAG00000006478","8",77189030,77200820,11790
"3963","ENSBTAG00000006479","1",152232655,152284372,51717
"3964","ENSBTAG00000006481","11",48759421,48843648,84227
"3965","ENSBTAG00000006482","11",48727826,48759022,31196
"3966","ENSBTAG00000006484","17",53609590,53614703,5113
"3967","ENSBTAG00000006485","23",15074058,15078758,4700
"3968","ENSBTAG00000006486","18",63209077,63213014,3937
"3969","ENSBTAG00000006487","18",63196980,63204349,7369
"3970","ENSBTAG00000006489","10",57848520,58048891,200371
"3971","ENSBTAG00000006490","23",7315559,7323441,7882
"3972","ENSBTAG00000006491","3",43353479,43432848,79369
"3973","ENSBTAG00000006492","6",44805517,44841655,36138
"3974","ENSBTAG00000006493","15",80900685,80903789,3104
"3975","ENSBTAG00000006494","1",76847361,76869738,22377
"3976","ENSBTAG00000006495","25",35909237,35915046,5809
"3977","ENSBTAG00000006497","11",68302507,68304476,1969
"3978","ENSBTAG00000006499","19",39357841,39381273,23432
"3979","ENSBTAG00000006500","22",49374567,49377717,3150
"3980","ENSBTAG00000006501","22",49282339,49370178,87839
"3981","ENSBTAG00000006504","17",63350533,63365001,14468
"3982","ENSBTAG00000006505","3",17115128,17117984,2856
"3983","ENSBTAG00000006506","17",63304658,63345190,40532
"3984","ENSBTAG00000006507","6",87427184,87706738,279554
"3985","ENSBTAG00000006510","3",108109004,108114061,5057
"3986","ENSBTAG00000006511","3",108063039,108103478,40439
"3987","ENSBTAG00000006514","10",25434856,25435325,469
"3988","ENSBTAG00000006515","16",46910358,46943809,33451
"3989","ENSBTAG00000006517","19",34497627,34506489,8862
"3990","ENSBTAG00000006519","16",46905090,46909417,4327
"3991","ENSBTAG00000006523","9",95955338,95966127,10789
"3992","ENSBTAG00000006525","19",56542648,56554189,11541
"3993","ENSBTAG00000006526","13",61220111,61271367,51256
"3994","ENSBTAG00000006528","4",63255358,63708251,452893
"3995","ENSBTAG00000006529","13",17916359,17956810,40451
"3996","ENSBTAG00000006530","5",81860450,81860701,251
"3997","ENSBTAG00000006531","13",46527612,46818194,290582
"3998","ENSBTAG00000006532","8",109828789,110013031,184242
"3999","ENSBTAG00000006533","13",59707107,59727653,20546
"4000","ENSBTAG00000006534","1",57707956,57727875,19919
"4001","ENSBTAG00000006535","X",57410330,57424578,14248
"4002","ENSBTAG00000006536","28",35466971,35476802,9831
"4003","ENSBTAG00000006538","5",81846047,81858436,12389
"4004","ENSBTAG00000006539","13",59688327,59695502,7175
"4005","ENSBTAG00000006541","25",25929240,25946430,17190
"4006","ENSBTAG00000006542","25",25917049,25929296,12247
"4007","ENSBTAG00000006543","25",26008727,26028899,20172
"4008","ENSBTAG00000006546","23",25074938,25088616,13678
"4009","ENSBTAG00000006547","8",11022949,11053125,30176
"4010","ENSBTAG00000006548","1",83960686,84019357,58671
"4011","ENSBTAG00000006549","9",34245855,34248411,2556
"4012","ENSBTAG00000006550","18",2868273,2878363,10090
"4013","ENSBTAG00000006551","8",10992674,11019066,26392
"4014","ENSBTAG00000006552","1",83922240,83951783,29543
"4015","ENSBTAG00000006555","3",110581767,110623103,41336
"4016","ENSBTAG00000006556","15",38233156,38267714,34558
"4017","ENSBTAG00000006557","5",30752743,30755981,3238
"4018","ENSBTAG00000006560","3",9265691,9294212,28521
"4019","ENSBTAG00000006561","6",96214372,96252603,38231
"4020","ENSBTAG00000006562","27",25662613,25669028,6415
"4021","ENSBTAG00000006563","22",14817159,14824510,7351
"4022","ENSBTAG00000006564","15",38213868,38226753,12885
"4023","ENSBTAG00000006566","18",46122175,46124338,2163
"4024","ENSBTAG00000006567","22",14658102,14689960,31858
"4025","ENSBTAG00000006569","17",65872051,66063271,191220
"4026","ENSBTAG00000006570","22",14704398,14722644,18246
"4027","ENSBTAG00000006572","11",103824220,103831359,7139
"4028","ENSBTAG00000006573","22",52310680,52361884,51204
"4029","ENSBTAG00000006574","16",80429842,80436465,6623
"4030","ENSBTAG00000006578","13",51422410,51425980,3570
"4031","ENSBTAG00000006579","15",53640849,53681795,40946
"4032","ENSBTAG00000006581","15",13851990,13883572,31582
"4033","ENSBTAG00000006582","21",48348493,48351072,2579
"4034","ENSBTAG00000006586","19",38773099,38794976,21877
"4035","ENSBTAG00000006587","8",83091018,83115232,24214
"4036","ENSBTAG00000006588","5",110294844,110304271,9427
"4037","ENSBTAG00000006589","4",50743789,50957593,213804
"4038","ENSBTAG00000006590","25",3802893,3810585,7692
"4039","ENSBTAG00000006592","17",65010788,65083923,73135
"4040","ENSBTAG00000006593","25",3805608,3820247,14639
"4041","ENSBTAG00000006594","17",65089357,65098969,9612
"4042","ENSBTAG00000006595","25",3821072,3831143,10071
"4043","ENSBTAG00000006599","5",56005014,56006928,1914
"4044","ENSBTAG00000006600","3",72180622,72181690,1068
"4045","ENSBTAG00000006601","19",19088871,19247444,158573
"4046","ENSBTAG00000006606","19",22265770,22271125,5355
"4047","ENSBTAG00000006607","7",75115945,75123209,7264
"4048","ENSBTAG00000006608","17",71443740,71453369,9629
"4049","ENSBTAG00000006609","16",45352249,45366511,14262
"4050","ENSBTAG00000006610","15",54155681,54223146,67465
"4051","ENSBTAG00000006611","18",24796100,24898992,102892
"4052","ENSBTAG00000006612","18",56050468,56060969,10501
"4053","ENSBTAG00000006613","10",26119686,26125451,5765
"4054","ENSBTAG00000006614","22",55948231,56101053,152822
"4055","ENSBTAG00000006615","26",34153506,34187199,33693
"4056","ENSBTAG00000006616","13",78534152,78594854,60702
"4057","ENSBTAG00000006618","19",5491500,5544055,52555
"4058","ENSBTAG00000006619","7",20195053,20203174,8121
"4059","ENSBTAG00000006620","21",57008449,57197392,188943
"4060","ENSBTAG00000006624","7",62521906,62543906,22000
"4061","ENSBTAG00000006625","3",92391225,92452345,61120
"4062","ENSBTAG00000006626","17",50309613,50687263,377650
"4063","ENSBTAG00000006630","18",24914409,24953834,39425
"4064","ENSBTAG00000006631","5",55992686,56003064,10378
"4065","ENSBTAG00000006633","18",56062452,56068031,5579
"4066","ENSBTAG00000006635","5",35292254,35329974,37720
"4067","ENSBTAG00000006638","18",56068168,56075228,7060
"4068","ENSBTAG00000006639","13",59540733,59555034,14301
"4069","ENSBTAG00000006640","12",18118566,18238934,120368
"4070","ENSBTAG00000006642","7",11592331,11610330,17999
"4071","ENSBTAG00000006643","6",56850591,56929149,78558
"4072","ENSBTAG00000006644","15",54223258,54247190,23932
"4073","ENSBTAG00000006645","12",18204042,18205891,1849
"4074","ENSBTAG00000006646","18",56079592,56089648,10056
"4075","ENSBTAG00000006647","12",18241680,18284265,42585
"4076","ENSBTAG00000006648","1",339070,350389,11319
"4077","ENSBTAG00000006649","7",3810680,3811501,821
"4078","ENSBTAG00000006650","25",27175346,27184380,9034
"4079","ENSBTAG00000006651","8",39351712,39362934,11222
"4080","ENSBTAG00000006654","2",35143374,35239417,96043
"4081","ENSBTAG00000006656","17",72995406,73000114,4708
"4082","ENSBTAG00000006657","17",73001852,73015951,14099
"4083","ENSBTAG00000006659","17",62142208,62178958,36750
"4084","ENSBTAG00000006661","4",81187581,81244481,56900
"4085","ENSBTAG00000006663","19",53565765,53643768,78003
"4086","ENSBTAG00000006665","17",62134583,62142059,7476
"4087","ENSBTAG00000006666","17",62067802,62129018,61216
"4088","ENSBTAG00000006667","2",124431682,124610867,179185
"4089","ENSBTAG00000006670","13",64776869,64791647,14778
"4090","ENSBTAG00000006671","13",77328694,77345950,17256
"4091","ENSBTAG00000006672","9",63819985,63842196,22211
"4092","ENSBTAG00000006673","21",69070299,69079841,9542
"4093","ENSBTAG00000006674","4",87464059,87568389,104330
"4094","ENSBTAG00000006675","21",28971505,29143668,172163
"4095","ENSBTAG00000006676","15",57703872,57707587,3715
"4096","ENSBTAG00000006678","3",16574943,16586974,12031
"4097","ENSBTAG00000006679","22",31617620,31843533,225913
"4098","ENSBTAG00000006680","27",42055492,42075340,19848
"4099","ENSBTAG00000006683","6",116265797,116364222,98425
"4100","ENSBTAG00000006685","16",4550836,4555318,4482
"4101","ENSBTAG00000006686","6",19173926,19254856,80930
"4102","ENSBTAG00000006688","10",86158264,86174332,16068
"4103","ENSBTAG00000006689","26",32815958,32835691,19733
"4104","ENSBTAG00000006690","15",29227702,29256278,28576
"4105","ENSBTAG00000006691","X",34602113,34842545,240432
"4106","ENSBTAG00000006692","16",4627787,4633191,5404
"4107","ENSBTAG00000006693","2",20568451,20644147,75696
"4108","ENSBTAG00000006694","7",47070286,47078939,8653
"4109","ENSBTAG00000006695","14",30874819,30899394,24575
"4110","ENSBTAG00000006697","20",35360857,35498717,137860
"4111","ENSBTAG00000006702","14",56245887,56293897,48010
"4112","ENSBTAG00000006703","10",45157991,45165480,7489
"4113","ENSBTAG00000006704","16",26845496,26847572,2076
"4114","ENSBTAG00000006707","26",32906517,32957882,51365
"4115","ENSBTAG00000006708","10",19367325,19469353,102028
"4116","ENSBTAG00000006709","16",41834215,41835960,1745
"4117","ENSBTAG00000006712","8",100805164,100912356,107192
"4118","ENSBTAG00000006713","26",32961732,32976664,14932
"4119","ENSBTAG00000006715","8",6554603,6595352,40749
"4120","ENSBTAG00000006716","11",93236273,93262107,25834
"4121","ENSBTAG00000006718","16",27418492,27502631,84139
"4122","ENSBTAG00000006719","28",44160950,44213073,52123
"4123","ENSBTAG00000006720","3",21877817,21894417,16600
"4124","ENSBTAG00000006721","4",28399526,28410479,10953
"4125","ENSBTAG00000006722","X",74908945,74918250,9305
"4126","ENSBTAG00000006724","1",72100094,72118577,18483
"4127","ENSBTAG00000006726","24",8121426,8402158,280732
"4128","ENSBTAG00000006730","17",71426379,71433950,7571
"4129","ENSBTAG00000006731","18",13298147,13327247,29100
"4130","ENSBTAG00000006732","4",49248702,49563305,314603
"4131","ENSBTAG00000006733","4",54551942,54592009,40067
"4132","ENSBTAG00000006734","5",77487500,77732164,244664
"4133","ENSBTAG00000006735","22",10127665,10240558,112893
"4134","ENSBTAG00000006738","21",55998495,56001659,3164
"4135","ENSBTAG00000006739","5",27600962,27607091,6129
"4136","ENSBTAG00000006740","29",43704515,43715580,11065
"4137","ENSBTAG00000006742","13",40899868,40910159,10291
"4138","ENSBTAG00000006743","24",33499444,33582080,82636
"4139","ENSBTAG00000006744","11",3113419,3298177,184758
"4140","ENSBTAG00000006745","17",2840842,2848781,7939
"4141","ENSBTAG00000006747","29",43714477,43735238,20761
"4142","ENSBTAG00000006748","7",34638516,34761975,123459
"4143","ENSBTAG00000006751","10",10611782,10671411,59629
"4144","ENSBTAG00000006752","22",51322004,51363442,41438
"4145","ENSBTAG00000006754","18",55272313,55278976,6663
"4146","ENSBTAG00000006755","15",35689576,35716099,26523
"4147","ENSBTAG00000006756","7",50593615,50620401,26786
"4148","ENSBTAG00000006757","18",55278608,55285152,6544
"4149","ENSBTAG00000006758","17",44271152,44272435,1283
"4150","ENSBTAG00000006759","12",17809328,17853938,44610
"4151","ENSBTAG00000006760","11",61543663,61551630,7967
"4152","ENSBTAG00000006761","23",35287369,35299843,12474
"4153","ENSBTAG00000006762","7",57146803,57275413,128610
"4154","ENSBTAG00000006765","7",57327431,57397980,70549
"4155","ENSBTAG00000006767","14",81745762,81824127,78365
"4156","ENSBTAG00000006768","8",70549553,70586248,36695
"4157","ENSBTAG00000006769","3",23706733,23717051,10318
"4158","ENSBTAG00000006770","14",81787034,81863369,76335
"4159","ENSBTAG00000006771","12",28747721,28997274,249553
"4160","ENSBTAG00000006775","20",71281294,71301030,19736
"4161","ENSBTAG00000006776","5",115617569,115654855,37286
"4162","ENSBTAG00000006777","19",20148802,20151236,2434
"4163","ENSBTAG00000006779","18",2453442,2458665,5223
"4164","ENSBTAG00000006780","18",56509840,56516939,7099
"4165","ENSBTAG00000006784","10",37229548,37241029,11481
"4166","ENSBTAG00000006785","19",45605688,45624227,18539
"4167","ENSBTAG00000006786","10",82158246,82227072,68826
"4168","ENSBTAG00000006789","22",57383017,57505284,122267
"4169","ENSBTAG00000006790","10",37243193,37288411,45218
"4170","ENSBTAG00000006792","10",37292701,37379567,86866
"4171","ENSBTAG00000006795","18",7759553,7771600,12047
"4172","ENSBTAG00000006797","7",26947768,27104258,156490
"4173","ENSBTAG00000006800","5",105667368,105679381,12013
"4174","ENSBTAG00000006801","19",43169555,43176493,6938
"4175","ENSBTAG00000006802","13",62707631,62719178,11547
"4176","ENSBTAG00000006804","29",29748689,29881807,133118
"4177","ENSBTAG00000006805","18",52296386,52315637,19251
"4178","ENSBTAG00000006806","19",41834618,41840426,5808
"4179","ENSBTAG00000006807","19",41678480,41683431,4951
"4180","ENSBTAG00000006811","1",37110684,37519280,408596
"4181","ENSBTAG00000006812","29",12925471,12927320,1849
"4182","ENSBTAG00000006813","1",76472929,76473141,212
"4183","ENSBTAG00000006815","15",47661933,47663266,1333
"4184","ENSBTAG00000006816","8",48108615,48157205,48590
"4185","ENSBTAG00000006817","15",29787170,29878434,91264
"4186","ENSBTAG00000006818","X",32099885,32142013,42128
"4187","ENSBTAG00000006819","21",49184308,49281283,96975
"4188","ENSBTAG00000006820","X",34197027,34203510,6483
"4189","ENSBTAG00000006821","2",104068554,104116082,47528
"4190","ENSBTAG00000006823","10",10675335,10773419,98084
"4191","ENSBTAG00000006824","22",43851906,43882728,30822
"4192","ENSBTAG00000006828","5",32528576,32550135,21559
"4193","ENSBTAG00000006831","8",48157841,48230524,72683
"4194","ENSBTAG00000006832","11",72420089,72430694,10605
"4195","ENSBTAG00000006833","24",58292452,58311500,19048
"4196","ENSBTAG00000006835","15",29886714,29894602,7888
"4197","ENSBTAG00000006836","21",49289714,49310143,20429
"4198","ENSBTAG00000006837","6",83328886,83415785,86899
"4199","ENSBTAG00000006838","X",14095101,14125897,30796
"4200","ENSBTAG00000006839","18",56634001,56639676,5675
"4201","ENSBTAG00000006841","18",56644863,56669238,24375
"4202","ENSBTAG00000006843","20",8051889,8070652,18763
"4203","ENSBTAG00000006844","6",17083864,17200183,116319
"4204","ENSBTAG00000006846","19",19368210,19387215,19005
"4205","ENSBTAG00000006848","18",54344182,54371183,27001
"4206","ENSBTAG00000006851","5",100099708,100111353,11645
"4207","ENSBTAG00000006852","11",36831220,37010446,179226
"4208","ENSBTAG00000006853","8",16761251,16763347,2096
"4209","ENSBTAG00000006855","26",34653339,34692090,38751
"4210","ENSBTAG00000006859","18",51400717,51406445,5728
"4211","ENSBTAG00000006860","26",34706685,34753535,46850
"4212","ENSBTAG00000006861","11",37035251,37061596,26345
"4213","ENSBTAG00000006862","18",54379821,54397189,17368
"4214","ENSBTAG00000006864","23",27333830,27348134,14304
"4215","ENSBTAG00000006868","21",30065785,30227350,161565
"4216","ENSBTAG00000006869","14",8470928,8543137,72209
"4217","ENSBTAG00000006870","28",13593571,13683222,89651
"4218","ENSBTAG00000006872","1",80349375,80351782,2407
"4219","ENSBTAG00000006876","4",44516585,44531440,14855
"4220","ENSBTAG00000006877","14",74381958,74776968,395010
"4221","ENSBTAG00000006878","X",79206804,79280122,73318
"4222","ENSBTAG00000006879","5",26057080,26059552,2472
"4223","ENSBTAG00000006881","19",36913633,36921556,7923
"4224","ENSBTAG00000006882","3",14259699,14299013,39314
"4225","ENSBTAG00000006883","5",26925465,26949409,23944
"4226","ENSBTAG00000006884","10",21590451,21597349,6898
"4227","ENSBTAG00000006886","19",36869256,36911648,42392
"4228","ENSBTAG00000006893","1",52133128,52430797,297669
"4229","ENSBTAG00000006894","19",19388579,19429569,40990
"4230","ENSBTAG00000006896","19",61493353,61539725,46372
"4231","ENSBTAG00000006898","16",23472901,23537555,64654
"4232","ENSBTAG00000006899","18",13142992,13218221,75229
"4233","ENSBTAG00000006901","8",94568397,94581931,13534
"4234","ENSBTAG00000006902","29",32262390,32290687,28297
"4235","ENSBTAG00000006904","5",26903397,26921895,18498
"4236","ENSBTAG00000006905","18",13225247,13256630,31383
"4237","ENSBTAG00000006907","2",44434401,44651653,217252
"4238","ENSBTAG00000006909","1",130293099,130471254,178155
"4239","ENSBTAG00000006910","29",40756509,40776202,19693
"4240","ENSBTAG00000006911","5",45077381,45125506,48125
"4241","ENSBTAG00000006912","21",34401527,34440515,38988
"4242","ENSBTAG00000006914","23",28415008,28420086,5078
"4243","ENSBTAG00000006916","19",14543295,14573019,29724
"4244","ENSBTAG00000006918","2",25392971,25450609,57638
"4245","ENSBTAG00000006919","24",50524995,50577277,52282
"4246","ENSBTAG00000006920","1",82960351,82968194,7843
"4247","ENSBTAG00000006921","19",61421551,61482846,61295
"4248","ENSBTAG00000006924","4",16889144,16890150,1006
"4249","ENSBTAG00000006925","16",55179506,55203940,24434
"4250","ENSBTAG00000006927","23",28394981,28408133,13152
"4251","ENSBTAG00000006928","26",44044921,44064391,19470
"4252","ENSBTAG00000006933","23",28373727,28389370,15643
"4253","ENSBTAG00000006934","21",34328403,34342900,14497
"4254","ENSBTAG00000006936","23",28366299,28373216,6917
"4255","ENSBTAG00000006937","19",61389714,61409179,19465
"4256","ENSBTAG00000006938","17",71967760,71987213,19453
"4257","ENSBTAG00000006939","8",84388645,84420636,31991
"4258","ENSBTAG00000006940","2",131012510,131085750,73240
"4259","ENSBTAG00000006941","23",28353038,28366874,13836
"4260","ENSBTAG00000006943","19",46829680,46862871,33191
"4261","ENSBTAG00000006945","1",75926837,76006093,79256
"4262","ENSBTAG00000006947","1",68349806,68384919,35113
"4263","ENSBTAG00000006948","11",98027457,98137332,109875
"4264","ENSBTAG00000006949","13",64841049,64845754,4705
"4265","ENSBTAG00000006950","6",97836116,97875459,39343
"4266","ENSBTAG00000006951","15",64472394,64485114,12720
"4267","ENSBTAG00000006954","18",57825465,57831752,6287
"4268","ENSBTAG00000006955","13",64848971,64884882,35911
"4269","ENSBTAG00000006957","11",98149418,98158448,9030
"4270","ENSBTAG00000006958","23",28349045,28353973,4928
"4271","ENSBTAG00000006960","23",28336294,28348888,12594
"4272","ENSBTAG00000006961","18",63423255,63449560,26305
"4273","ENSBTAG00000006962","13",64887674,64904921,17247
"4274","ENSBTAG00000006963","11",98179658,98183783,4125
"4275","ENSBTAG00000006966","23",28319981,28323011,3030
"4276","ENSBTAG00000006969","23",28298359,28302018,3659
"4277","ENSBTAG00000006970","2",22528224,22693132,164908
"4278","ENSBTAG00000006971","20",71390369,71408924,18555
"4279","ENSBTAG00000006972","20",71375341,71390362,15021
"4280","ENSBTAG00000006973","5",115395022,115482327,87305
"4281","ENSBTAG00000006974","15",35447942,35675946,228004
"4282","ENSBTAG00000006975","1",102272282,102388043,115761
"4283","ENSBTAG00000006977","X",52543967,52560839,16872
"4284","ENSBTAG00000006978","7",34325642,34425552,99910
"4285","ENSBTAG00000006982","19",42256788,42280743,23955
"4286","ENSBTAG00000006984","16",5250021,5279400,29379
"4287","ENSBTAG00000006985","5",82791610,82832235,40625
"4288","ENSBTAG00000006986","6",25325318,25342586,17268
"4289","ENSBTAG00000006987","21",6079335,6238773,159438
"4290","ENSBTAG00000006988","11",9989574,10084934,95360
"4291","ENSBTAG00000006989","11",9961628,9986344,24716
"4292","ENSBTAG00000006990","29",40197141,40232303,35162
"4293","ENSBTAG00000006991","6",25413497,25429844,16347
"4294","ENSBTAG00000006995","11",37177107,37389119,212012
"4295","ENSBTAG00000006998","18",48215443,48229106,13663
"4296","ENSBTAG00000006999","18",48237459,48365215,127756
"4297","ENSBTAG00000007000","24",35564899,35587720,22821
"4298","ENSBTAG00000007001","6",117379932,117386917,6985
"4299","ENSBTAG00000007002","6",117374270,117388382,14112
"4300","ENSBTAG00000007003","24",35553464,35564144,10680
"4301","ENSBTAG00000007007","21",66983300,67047746,64446
"4302","ENSBTAG00000007008","21",67050636,67092949,42313
"4303","ENSBTAG00000007011","26",45208051,45215977,7926
"4304","ENSBTAG00000007012","25",36368810,36376716,7906
"4305","ENSBTAG00000007013","19",5021192,5083084,61892
"4306","ENSBTAG00000007014","1",134765523,134838769,73246
"4307","ENSBTAG00000007015","19",5083534,5090035,6501
"4308","ENSBTAG00000007016","25",36333374,36337700,4326
"4309","ENSBTAG00000007019","6",15551780,15569552,17772
"4310","ENSBTAG00000007020","22",16468574,16478227,9653
"4311","ENSBTAG00000007024","5",103710501,103711055,554
"4312","ENSBTAG00000007031","27",40005539,40010324,4785
"4313","ENSBTAG00000007035","5",20831998,20833802,1804
"4314","ENSBTAG00000007036","18",55889117,55900355,11238
"4315","ENSBTAG00000007039","1",146528127,146556177,28050
"4316","ENSBTAG00000007041","21",59309994,59326531,16537
"4317","ENSBTAG00000007043","NKLS02001854.1",247,5744,5497
"4318","ENSBTAG00000007044","26",24039332,24042806,3474
"4319","ENSBTAG00000007047","17",46932749,46934705,1956
"4320","ENSBTAG00000007049","26",6331906,6337225,5319
"4321","ENSBTAG00000007051","27",24740438,24741319,881
"4322","ENSBTAG00000007052","21",61149334,61149924,590
"4323","ENSBTAG00000007053","10",21395335,21423831,28496
"4324","ENSBTAG00000007058","29",43117321,43138368,21047
"4325","ENSBTAG00000007061","29",43147030,43155894,8864
"4326","ENSBTAG00000007063","29",43156087,43156747,660
"4327","ENSBTAG00000007065","18",52816717,52826341,9624
"4328","ENSBTAG00000007066","12",77235998,77292275,56277
"4329","ENSBTAG00000007067","12",16035557,16055518,19961
"4330","ENSBTAG00000007068","1",139528818,139600025,71207
"4331","ENSBTAG00000007070","18",52827195,52827797,602
"4332","ENSBTAG00000007071","20",39314838,39473962,159124
"4333","ENSBTAG00000007073","12",16138033,16196068,58035
"4334","ENSBTAG00000007074","23",30534992,30550488,15496
"4335","ENSBTAG00000007075","23",27943564,28059869,116305
"4336","ENSBTAG00000007077","11",72504307,72515568,11261
"4337","ENSBTAG00000007079","12",16207287,16313140,105853
"4338","ENSBTAG00000007080","11",72504307,72508662,4355
"4339","ENSBTAG00000007084","19",44908849,44952435,43586
"4340","ENSBTAG00000007089","27",19178239,19192324,14085
"4341","ENSBTAG00000007090","19",29510066,29536488,26422
"4342","ENSBTAG00000007092","X",127346207,127383580,37373
"4343","ENSBTAG00000007093","5",106982821,106999621,16800
"4344","ENSBTAG00000007094","21",25613353,25624430,11077
"4345","ENSBTAG00000007096","18",14772666,14793387,20721
"4346","ENSBTAG00000007097","10",21388435,21431236,42801
"4347","ENSBTAG00000007099","10",21380886,21389479,8593
"4348","ENSBTAG00000007100","1",144056126,144132832,76706
"4349","ENSBTAG00000007101","3",48954585,48965477,10892
"4350","ENSBTAG00000007102","5",116612064,116631552,19488
"4351","ENSBTAG00000007103","25",26654119,26703485,49366
"4352","ENSBTAG00000007104","10",21371662,21380865,9203
"4353","ENSBTAG00000007105","1",144134113,144147949,13836
"4354","ENSBTAG00000007106","1",144148919,144158060,9141
"4355","ENSBTAG00000007107","18",55044414,55064944,20530
"4356","ENSBTAG00000007108","29",41783243,41792648,9405
"4357","ENSBTAG00000007109","21",58530348,58579232,48884
"4358","ENSBTAG00000007110","16",72056794,72108849,52055
"4359","ENSBTAG00000007111","2",71009555,71061343,51788
"4360","ENSBTAG00000007112","3",92263079,92296401,33322
"4361","ENSBTAG00000007113","25",37265876,37353871,87995
"4362","ENSBTAG00000007114","10",7084931,7115694,30763
"4363","ENSBTAG00000007115","27",26801919,26846927,45008
"4364","ENSBTAG00000007116","7",90839565,90853620,14055
"4365","ENSBTAG00000007117","19",27852911,27873656,20745
"4366","ENSBTAG00000007118","25",37170680,37259882,89202
"4367","ENSBTAG00000007120","13",77097708,77181348,83640
"4368","ENSBTAG00000007121","19",53977498,53991174,13676
"4369","ENSBTAG00000007122","7",2467013,2468407,1394
"4370","ENSBTAG00000007123","3",20098776,20104404,5628
"4371","ENSBTAG00000007125","19",53954985,53977477,22492
"4372","ENSBTAG00000007127","2",115838391,115840022,1631
"4373","ENSBTAG00000007128","7",3672337,3688090,15753
"4374","ENSBTAG00000007129","15",41959236,42098627,139391
"4375","ENSBTAG00000007130","13",7321092,7387380,66288
"4376","ENSBTAG00000007131","22",5209250,5403422,194172
"4377","ENSBTAG00000007133","13",18321888,18393476,71588
"4378","ENSBTAG00000007135","11",56606755,56609713,2958
"4379","ENSBTAG00000007136","4",72076430,72308387,231957
"4380","ENSBTAG00000007137","17",57183198,57231988,48790
"4381","ENSBTAG00000007139","17",57116197,57183504,67307
"4382","ENSBTAG00000007141","2",7839124,7933339,94215
"4383","ENSBTAG00000007142","25",11393983,11531543,137560
"4384","ENSBTAG00000007144","5",27570607,27577406,6799
"4385","ENSBTAG00000007146","4",67029848,67157458,127610
"4386","ENSBTAG00000007147","19",8670138,8760139,90001
"4387","ENSBTAG00000007148","15",76656867,76671235,14368
"4388","ENSBTAG00000007149","10",20755325,20776134,20809
"4389","ENSBTAG00000007152","5",55731741,55779980,48239
"4390","ENSBTAG00000007153","2",130189849,130193588,3739
"4391","ENSBTAG00000007156","5",55721786,55736914,15128
"4392","ENSBTAG00000007158","5",55716601,55719301,2700
"4393","ENSBTAG00000007159","9",88802742,89097095,294353
"4394","ENSBTAG00000007160","5",55713433,55717031,3598
"4395","ENSBTAG00000007163","8",95034378,95265375,230997
"4396","ENSBTAG00000007164","6",116766295,116780691,14396
"4397","ENSBTAG00000007166","19",24494098,24523107,29009
"4398","ENSBTAG00000007167","12",36235527,36261519,25992
"4399","ENSBTAG00000007169","19",24528313,24545951,17638
"4400","ENSBTAG00000007170","18",26429234,26440641,11407
"4401","ENSBTAG00000007172","18",26447740,26471387,23647
"4402","ENSBTAG00000007173","6",69723655,69771549,47894
"4403","ENSBTAG00000007175","5",50362882,50366965,4083
"4404","ENSBTAG00000007177","25",9268789,9311099,42310
"4405","ENSBTAG00000007181","18",25722016,25756803,34787
"4406","ENSBTAG00000007184","18",4950347,4962900,12553
"4407","ENSBTAG00000007186","14",359395,414811,55416
"4408","ENSBTAG00000007187","21",69183853,69195007,11154
"4409","ENSBTAG00000007189","6",90325049,90340510,15461
"4410","ENSBTAG00000007190","6",90340298,90367894,27596
"4411","ENSBTAG00000007192","15",27871494,27887203,15709
"4412","ENSBTAG00000007194","3",104021061,104024316,3255
"4413","ENSBTAG00000007195","3",104015403,104017508,2105
"4414","ENSBTAG00000007196","15",27888817,27894507,5690
"4415","ENSBTAG00000007200","18",62124767,62126264,1497
"4416","ENSBTAG00000007201","9",93924829,93966600,41771
"4417","ENSBTAG00000007202","29",28982785,28997544,14759
"4418","ENSBTAG00000007203","29",29005937,29027281,21344
"4419","ENSBTAG00000007204","5",27732717,27757234,24517
"4420","ENSBTAG00000007206","4",93338888,93401401,62513
"4421","ENSBTAG00000007208","22",58427520,58440755,13235
"4422","ENSBTAG00000007210","25",6424841,6638491,213650
"4423","ENSBTAG00000007211","X",96102890,96104560,1670
"4424","ENSBTAG00000007213","13",53196957,53240508,43551
"4425","ENSBTAG00000007214","7",95212712,95286507,73795
"4426","ENSBTAG00000007215","3",119958670,119967450,8780
"4427","ENSBTAG00000007216","18",48026992,48039998,13006
"4428","ENSBTAG00000007217","19",56044033,56058416,14383
"4429","ENSBTAG00000007220","19",56028993,56043211,14218
"4430","ENSBTAG00000007223","16",42027797,42034327,6530
"4431","ENSBTAG00000007228","5",110592240,110609167,16927
"4432","ENSBTAG00000007230","29",22224775,22225974,1199
"4433","ENSBTAG00000007231","7",94976501,95003346,26845
"4434","ENSBTAG00000007233","21",65267468,65416865,149397
"4435","ENSBTAG00000007234","17",2912667,2932205,19538
"4436","ENSBTAG00000007235","11",102251087,102324089,73002
"4437","ENSBTAG00000007236","27",19263170,19339603,76433
"4438","ENSBTAG00000007237","10",35786200,35841256,55056
"4439","ENSBTAG00000007238","NKLS02001566.1",13980,15624,1644
"4440","ENSBTAG00000007239","2",44747145,44764214,17069
"4441","ENSBTAG00000007240","6",44864668,44915083,50415
"4442","ENSBTAG00000007241","3",9730538,9733707,3169
"4443","ENSBTAG00000007243","26",24916176,25021513,105337
"4444","ENSBTAG00000007244","28",8687268,8784180,96912
"4445","ENSBTAG00000007245","25",1184871,1241910,57039
"4446","ENSBTAG00000007246","25",1197395,1209836,12441
"4447","ENSBTAG00000007247","3",5960360,5998691,38331
"4448","ENSBTAG00000007253","4",93068851,93088762,19911
"4449","ENSBTAG00000007256","5",46121140,46131988,10848
"4450","ENSBTAG00000007258","2",25604286,25643331,39045
"4451","ENSBTAG00000007259","5",75796037,75798511,2474
"4452","ENSBTAG00000007262","18",40827492,41221033,393541
"4453","ENSBTAG00000007266","17",52061347,52079100,17753
"4454","ENSBTAG00000007268","23",48770091,48913854,143763
"4455","ENSBTAG00000007269","17",52050315,52061227,10912
"4456","ENSBTAG00000007270","17",52029878,52050145,20267
"4457","ENSBTAG00000007271","17",51998677,52027811,29134
"4458","ENSBTAG00000007272","17",51954039,51993763,39724
"4459","ENSBTAG00000007273","1",135579069,135618070,39001
"4460","ENSBTAG00000007275","23",15082501,15105534,23033
"4461","ENSBTAG00000007280","2",118153657,118162736,9079
"4462","ENSBTAG00000007281","3",19673523,19687033,13510
"4463","ENSBTAG00000007284","12",25107258,25118080,10822
"4464","ENSBTAG00000007286","23",31884099,31884488,389
"4465","ENSBTAG00000007288","9",39477920,39644633,166713
"4466","ENSBTAG00000007296","1",81956536,81960076,3540
"4467","ENSBTAG00000007298","12",85542292,85552388,10096
"4468","ENSBTAG00000007299","3",107971020,107997728,26708
"4469","ENSBTAG00000007300","3",107959452,107967135,7683
"4470","ENSBTAG00000007302","14",82359771,82387445,27674
"4471","ENSBTAG00000007303","14",47398425,47427803,29378
"4472","ENSBTAG00000007304","21",34047580,34062167,14587
"4473","ENSBTAG00000007305","4",81966837,82156974,190137
"4474","ENSBTAG00000007306","20",20440181,20735999,295818
"4475","ENSBTAG00000007307","16",37372237,37384911,12674
"4476","ENSBTAG00000007308","21",33991423,34046913,55490
"4477","ENSBTAG00000007309","3",67605888,67814273,208385
"4478","ENSBTAG00000007312","7",16586871,16589914,3043
"4479","ENSBTAG00000007315","22",53741196,53886985,145789
"4480","ENSBTAG00000007316","6",6962626,7077344,114718
"4481","ENSBTAG00000007318","3",19509778,19518770,8992
"4482","ENSBTAG00000007319","21",69505932,69519541,13609
"4483","ENSBTAG00000007320","3",19481062,19509852,28790
"4484","ENSBTAG00000007321","20",13439033,13484492,45459
"4485","ENSBTAG00000007323","5",44560547,44588478,27931
"4486","ENSBTAG00000007324","15",70398888,70400810,1922
"4487","ENSBTAG00000007325","25",996893,1000217,3324
"4488","ENSBTAG00000007329","12",19015845,19053524,37679
"4489","ENSBTAG00000007330","3",34568247,34622399,54152
"4490","ENSBTAG00000007331","1",122349984,122471157,121173
"4491","ENSBTAG00000007332","15",29084998,29093127,8129
"4492","ENSBTAG00000007333","3",34517748,34521119,3371
"4493","ENSBTAG00000007334","18",46580116,46588405,8289
"4494","ENSBTAG00000007335","14",43230911,43359853,128942
"4495","ENSBTAG00000007336","18",46589699,46591226,1527
"4496","ENSBTAG00000007338","18",46576253,46605718,29465
"4497","ENSBTAG00000007344","X",15981034,16038866,57832
"4498","ENSBTAG00000007346","21",33481851,33487374,5523
"4499","ENSBTAG00000007347","24",56614426,56622816,8390
"4500","ENSBTAG00000007348","21",34477952,34507708,29756
"4501","ENSBTAG00000007352","3",33193740,33216772,23032
"4502","ENSBTAG00000007353","19",36682225,36688039,5814
"4503","ENSBTAG00000007354","19",49390433,49390912,479
"4504","ENSBTAG00000007356","12",11154001,11239928,85927
"4505","ENSBTAG00000007357","21",5285464,5375159,89695
"4506","ENSBTAG00000007359","7",39848312,39852340,4028
"4507","ENSBTAG00000007360","22",58064573,58095559,30986
"4508","ENSBTAG00000007362","22",58040295,58063254,22959
"4509","ENSBTAG00000007363","22",58031643,58038810,7167
"4510","ENSBTAG00000007364","25",38006823,38030446,23623
"4511","ENSBTAG00000007365","21",33464548,33471171,6623
"4512","ENSBTAG00000007366","7",5991339,6016463,25124
"4513","ENSBTAG00000007367","25",38030392,38038514,8122
"4514","ENSBTAG00000007368","21",33452950,33464335,11385
"4515","ENSBTAG00000007369","8",69882167,69895316,13149
"4516","ENSBTAG00000007370","25",38038515,38065419,26904
"4517","ENSBTAG00000007371","10",9403959,9554754,150795
"4518","ENSBTAG00000007372","25",38044044,38047838,3794
"4519","ENSBTAG00000007374","10",9534467,9626567,92100
"4520","ENSBTAG00000007375","17",71292117,71293211,1094
"4521","ENSBTAG00000007378","11",70671210,70747621,76411
"4522","ENSBTAG00000007379","11",70153921,70661150,507229
"4523","ENSBTAG00000007382","21",31842786,31956814,114028
"4524","ENSBTAG00000007383","24",31380664,31692928,312264
"4525","ENSBTAG00000007384","25",38133004,38199238,66234
"4526","ENSBTAG00000007385","10",28490709,28506271,15562
"4527","ENSBTAG00000007386","14",55087717,55181181,93464
"4528","ENSBTAG00000007387","14",55078156,55087610,9454
"4529","ENSBTAG00000007388","9",86692238,86726552,34314
"4530","ENSBTAG00000007389","19",43030226,43044830,14604
"4531","ENSBTAG00000007390","19",43044124,43051001,6877
"4532","ENSBTAG00000007392","21",59164221,59174909,10688
"4533","ENSBTAG00000007393","19",43051798,43056172,4374
"4534","ENSBTAG00000007394","1",96572443,96576821,4378
"4535","ENSBTAG00000007395","2",90248645,90296359,47714
"4536","ENSBTAG00000007397","29",5885258,5958145,72887
"4537","ENSBTAG00000007398","22",207311,229794,22483
"4538","ENSBTAG00000007399","X",4940703,5023623,82920
"4539","ENSBTAG00000007402","25",41664183,41672223,8040
"4540","ENSBTAG00000007403","X",79712812,79718270,5458
"4541","ENSBTAG00000007409","19",48618991,48639790,20799
"4542","ENSBTAG00000007411","12",86491628,86497941,6313
"4543","ENSBTAG00000007413","4",94144405,94192546,48141
"4544","ENSBTAG00000007414","11",43514061,43544017,29956
"4545","ENSBTAG00000007415","10",21683779,21737239,53460
"4546","ENSBTAG00000007417","5",57506100,57512983,6883
"4547","ENSBTAG00000007421","18",34122601,34160211,37610
"4548","ENSBTAG00000007422","27",14375306,14414602,39296
"4549","ENSBTAG00000007423","14",45276997,45305176,28179
"4550","ENSBTAG00000007424","17",69262954,69269513,6559
"4551","ENSBTAG00000007427","26",22794880,22818924,24044
"4552","ENSBTAG00000007428","X",124822388,125001039,178651
"4553","ENSBTAG00000007429","19",24986777,25023355,36578
"4554","ENSBTAG00000007430","19",25024913,25039465,14552
"4555","ENSBTAG00000007431","21",26725040,26791142,66102
"4556","ENSBTAG00000007433","10",18677351,19002748,325397
"4557","ENSBTAG00000007434","19",43733650,43745515,11865
"4558","ENSBTAG00000007435","26",22820386,22829196,8810
"4559","ENSBTAG00000007436","19",25040641,25043546,2905
"4560","ENSBTAG00000007437","19",25055643,25071385,15742
"4561","ENSBTAG00000007438","22",6035587,6138659,103072
"4562","ENSBTAG00000007439","29",16813276,17402612,589336
"4563","ENSBTAG00000007440","8",38803157,38815530,12373
"4564","ENSBTAG00000007441","26",40001731,40039892,38161
"4565","ENSBTAG00000007442","4",9333128,9455572,122444
"4566","ENSBTAG00000007443","19",5441137,5446286,5149
"4567","ENSBTAG00000007444","1",7005502,7053831,48329
"4568","ENSBTAG00000007445","2",91906146,91939649,33503
"4569","ENSBTAG00000007446","3",27948940,28007027,58087
"4570","ENSBTAG00000007447","5",23191702,23208104,16402
"4571","ENSBTAG00000007449","6",106504062,106540229,36167
"4572","ENSBTAG00000007450","23",27421810,27433479,11669
"4573","ENSBTAG00000007453","23",27409462,27415203,5741
"4574","ENSBTAG00000007454","X",37450195,37453599,3404
"4575","ENSBTAG00000007455","X",37454318,37462057,7739
"4576","ENSBTAG00000007456","X",37465726,37473701,7975
"4577","ENSBTAG00000007457","12",20441414,20498087,56673
"4578","ENSBTAG00000007460","26",38279319,38320494,41175
"4579","ENSBTAG00000007461","20",31304242,31331077,26835
"4580","ENSBTAG00000007462","1",138839426,138853788,14362
"4581","ENSBTAG00000007467","24",34423837,34514245,90408
"4582","ENSBTAG00000007470","7",41228075,41242020,13945
"4583","ENSBTAG00000007473","27",5896149,5913660,17511
"4584","ENSBTAG00000007474","25",40885875,40904851,18976
"4585","ENSBTAG00000007476","26",22130152,22301533,171381
"4586","ENSBTAG00000007479","29",12384676,12411725,27049
"4587","ENSBTAG00000007480","7",43707339,43712131,4792
"4588","ENSBTAG00000007483","17",62955311,62964687,9376
"4589","ENSBTAG00000007484","17",62969284,62985770,16486
"4590","ENSBTAG00000007485","11",87587451,87637666,50215
"4591","ENSBTAG00000007486","11",103058904,103067774,8870
"4592","ENSBTAG00000007488","18",35898241,35903829,5588
"4593","ENSBTAG00000007489","13",76036719,76152407,115688
"4594","ENSBTAG00000007490","13",76156611,76282301,125690
"4595","ENSBTAG00000007492","11",104418528,104449657,31129
"4596","ENSBTAG00000007493","X",90627221,90630486,3265
"4597","ENSBTAG00000007494","8",42369825,42549632,179807
"4598","ENSBTAG00000007496","17",44585357,44588957,3600
"4599","ENSBTAG00000007497","13",54047439,54053613,6174
"4600","ENSBTAG00000007498","13",54034397,54047311,12914
"4601","ENSBTAG00000007499","X",50797768,50803571,5803
"4602","ENSBTAG00000007501","13",54034397,54036045,1648
"4603","ENSBTAG00000007502","21",55322423,55328813,6390
"4604","ENSBTAG00000007503","21",55328662,55345907,17245
"4605","ENSBTAG00000007506","18",61607183,61622688,15505
"4606","ENSBTAG00000007507","3",99716645,99737813,21168
"4607","ENSBTAG00000007508","11",27806024,28050575,244551
"4608","ENSBTAG00000007509","18",61637425,61651931,14506
"4609","ENSBTAG00000007510","17",44512664,44522964,10300
"4610","ENSBTAG00000007512","18",35623806,35638385,14579
"4611","ENSBTAG00000007513","17",44502890,44510533,7643
"4612","ENSBTAG00000007514","23",10653672,10757196,103524
"4613","ENSBTAG00000007515","3",16022438,16032162,9724
"4614","ENSBTAG00000007516","10",103153153,103154157,1004
"4615","ENSBTAG00000007517","3",16000297,16010188,9891
"4616","ENSBTAG00000007519","3",15968147,15994363,26216
"4617","ENSBTAG00000007520","24",21874960,21991645,116685
"4618","ENSBTAG00000007522","6",26124919,26275541,150622
"4619","ENSBTAG00000007523","25",27156826,27163281,6455
"4620","ENSBTAG00000007530","23",28816417,28825181,8764
"4621","ENSBTAG00000007531","5",75265852,75284401,18549
"4622","ENSBTAG00000007532","23",28803215,28813526,10311
"4623","ENSBTAG00000007534","14",28047727,28070375,22648
"4624","ENSBTAG00000007537","3",9399899,9405346,5447
"4625","ENSBTAG00000007540","28",41609015,41649016,40001
"4626","ENSBTAG00000007543","11",87654106,87710164,56058
"4627","ENSBTAG00000007544","18",39421095,39435777,14682
"4628","ENSBTAG00000007545","18",39354161,39416025,61864
"4629","ENSBTAG00000007547","19",63125471,63133138,7667
"4630","ENSBTAG00000007550","7",14446719,14524247,77528
"4631","ENSBTAG00000007553","5",105143974,105146171,2197
"4632","ENSBTAG00000007554","2",125662055,125665793,3738
"4633","ENSBTAG00000007556","5",105528525,105552494,23969
"4634","ENSBTAG00000007558","25",102448,107161,4713
"4635","ENSBTAG00000007559","18",40542798,40605024,62226
"4636","ENSBTAG00000007562","14",34273501,34307287,33786
"4637","ENSBTAG00000007564","17",34936426,34938688,2262
"4638","ENSBTAG00000007566","16",33885095,34015860,130765
"4639","ENSBTAG00000007567","24",8456521,8493333,36812
"4640","ENSBTAG00000007568","6",36850100,36864170,14070
"4641","ENSBTAG00000007569","24",60733395,60790306,56911
"4642","ENSBTAG00000007570","14",69265371,69301594,36223
"4643","ENSBTAG00000007572","4",92828149,92831704,3555
"4644","ENSBTAG00000007577","1",70935047,70987415,52368
"4645","ENSBTAG00000007578","26",37270901,37380827,109926
"4646","ENSBTAG00000007580","2",9491627,9512730,21103
"4647","ENSBTAG00000007581","19",33482107,33502631,20524
"4648","ENSBTAG00000007583","19",41792382,41796909,4527
"4649","ENSBTAG00000007584","2",5934748,5970809,36061
"4650","ENSBTAG00000007586","10",81981151,82020581,39430
"4651","ENSBTAG00000007588","26",21052721,21094527,41806
"4652","ENSBTAG00000007589","12",24731844,24795963,64119
"4653","ENSBTAG00000007591","26",21096934,21139264,42330
"4654","ENSBTAG00000007592","5",26774193,26794835,20642
"4655","ENSBTAG00000007593","16",26158797,26205139,46342
"4656","ENSBTAG00000007594","26",21141544,21165957,24413
"4657","ENSBTAG00000007595","16",26208022,26226551,18529
"4658","ENSBTAG00000007596","14",70066731,70080523,13792
"4659","ENSBTAG00000007599","27",37127811,37180362,52551
"4660","ENSBTAG00000007601","19",37974853,37976071,1218
"4661","ENSBTAG00000007602","13",30056080,30242437,186357
"4662","ENSBTAG00000007603","19",37957909,37959268,1359
"4663","ENSBTAG00000007605","5",106946944,106955086,8142
"4664","ENSBTAG00000007606","16",32404381,32420440,16059
"4665","ENSBTAG00000007608","4",55467396,55544715,77319
"4666","ENSBTAG00000007609","5",106928836,106938181,9345
"4667","ENSBTAG00000007611","5",106920227,106927024,6797
"4668","ENSBTAG00000007614","10",19486143,19532111,45968
"4669","ENSBTAG00000007615","22",27019069,27417544,398475
"4670","ENSBTAG00000007616","18",36484583,36489822,5239
"4671","ENSBTAG00000007617","18",36491411,36514012,22601
"4672","ENSBTAG00000007618","23",25899578,25907363,7785
"4673","ENSBTAG00000007619","16",51211860,51214693,2833
"4674","ENSBTAG00000007620","16",51201649,51211966,10317
"4675","ENSBTAG00000007622","29",49712700,49722179,9479
"4676","ENSBTAG00000007623","16",51197668,51201525,3857
"4677","ENSBTAG00000007624","22",32022449,32381786,359337
"4678","ENSBTAG00000007626","X",79521612,79525287,3675
"4679","ENSBTAG00000007629","27",37547355,37553519,6164
"4680","ENSBTAG00000007630","27",37559802,37590963,31161
"4681","ENSBTAG00000007632","7",80632983,80667079,34096
"4682","ENSBTAG00000007633","7",80676426,80694011,17585
"4683","ENSBTAG00000007634","27",37591154,37670670,79516
"4684","ENSBTAG00000007635","2",86319697,86686609,366912
"4685","ENSBTAG00000007636","5",47564309,47624668,60359
"4686","ENSBTAG00000007638","10",45270353,45277456,7103
"4687","ENSBTAG00000007639","6",90809716,90841174,31458
"4688","ENSBTAG00000007643","23",28456600,28465409,8809
"4689","ENSBTAG00000007644","7",20959393,21097631,138238
"4690","ENSBTAG00000007646","X",128161127,128177660,16533
"4691","ENSBTAG00000007648","13",43160605,43186863,26258
"4692","ENSBTAG00000007649","21",28805848,28844007,38159
"4693","ENSBTAG00000007650","2",31290313,31348516,58203
"4694","ENSBTAG00000007651","21",28759374,28803585,44211
"4695","ENSBTAG00000007652","2",86102214,86178287,76073
"4696","ENSBTAG00000007654","X",84890297,84968930,78633
"4697","ENSBTAG00000007657","8",11125659,11159325,33666
"4698","ENSBTAG00000007658","13",66604147,66771100,166953
"4699","ENSBTAG00000007659","8",63246399,63310282,63883
"4700","ENSBTAG00000007660","7",17112595,17116261,3666
"4701","ENSBTAG00000007661","7",17119429,17157724,38295
"4702","ENSBTAG00000007662","11",96115141,96119503,4362
"4703","ENSBTAG00000007665","20",40918778,40995857,77079
"4704","ENSBTAG00000007666","1",81402025,81572413,170388
"4705","ENSBTAG00000007668","9",96785815,96922398,136583
"4706","ENSBTAG00000007674","5",73357105,73374540,17435
"4707","ENSBTAG00000007675","11",1697163,1762645,65482
"4708","ENSBTAG00000007678","13",36823187,36893338,70151
"4709","ENSBTAG00000007680","4",19514202,19990379,476177
"4710","ENSBTAG00000007681","7",80733293,80748878,15585
"4711","ENSBTAG00000007683","2",25003233,25029169,25936
"4712","ENSBTAG00000007684","7",80748981,80931592,182611
"4713","ENSBTAG00000007685","9",104070553,104088278,17725
"4714","ENSBTAG00000007686","9",104096728,104106442,9714
"4715","ENSBTAG00000007689","11",86083907,86175202,91295
"4716","ENSBTAG00000007690","20",39119608,39162311,42703
"4717","ENSBTAG00000007693","16",3410078,3416912,6834
"4718","ENSBTAG00000007694","9",102410506,102444599,34093
"4719","ENSBTAG00000007695","6",85411118,85429268,18150
"4720","ENSBTAG00000007696","24",25259960,25343059,83099
"4721","ENSBTAG00000007698","7",4576425,4582526,6101
"4722","ENSBTAG00000007700","13",27975607,27996366,20759
"4723","ENSBTAG00000007702","13",29674380,29680260,5880
"4724","ENSBTAG00000007703","13",29681997,29742318,60321
"4725","ENSBTAG00000007704","20",18454411,18531445,77034
"4726","ENSBTAG00000007705","24",35248809,35434069,185260
"4727","ENSBTAG00000007706","5",31354912,31355844,932
"4728","ENSBTAG00000007708","X",79470658,79493193,22535
"4729","ENSBTAG00000007709","26",31481196,31568116,86920
"4730","ENSBTAG00000007712","3",23075087,23100499,25412
"4731","ENSBTAG00000007714","18",52211530,52225621,14091
"4732","ENSBTAG00000007718","24",37527297,37535143,7846
"4733","ENSBTAG00000007719","2",5820563,5881926,61363
"4734","ENSBTAG00000007721","13",78852506,78869898,17392
"4735","ENSBTAG00000007723","24",61599658,61638727,39069
"4736","ENSBTAG00000007724","3",59768028,59773058,5030
"4737","ENSBTAG00000007725","7",3001505,3019569,18064
"4738","ENSBTAG00000007728","17",69555254,69569017,13763
"4739","ENSBTAG00000007730","X",119111685,119149285,37600
"4740","ENSBTAG00000007732","22",9640621,9758464,117843
"4741","ENSBTAG00000007734","11",14545698,14655844,110146
"4742","ENSBTAG00000007736","14",9074043,9111806,37763
"4743","ENSBTAG00000007737","7",4603746,4606130,2384
"4744","ENSBTAG00000007739","7",4599480,4602233,2753
"4745","ENSBTAG00000007740","15",76374118,76377898,3780
"4746","ENSBTAG00000007741","7",4593528,4598872,5344
"4747","ENSBTAG00000007743","4",46586617,46640231,53614
"4748","ENSBTAG00000007746","4",25805796,25855901,50105
"4749","ENSBTAG00000007749","14",496271,507275,11004
"4750","ENSBTAG00000007753","14",470777,478486,7709
"4751","ENSBTAG00000007754","18",63279554,63282901,3347
"4752","ENSBTAG00000007755","5",110559226,110574354,15128
"4753","ENSBTAG00000007756","18",63271873,63279516,7643
"4754","ENSBTAG00000007757","18",63260500,63271920,11420
"4755","ENSBTAG00000007758","9",100469651,100729770,260119
"4756","ENSBTAG00000007759","4",113605321,113623176,17855
"4757","ENSBTAG00000007761","8",61567467,61594251,26784
"4758","ENSBTAG00000007762","4",113624753,113628970,4217
"4759","ENSBTAG00000007763","11",63379682,63409616,29934
"4760","ENSBTAG00000007765","2",72963706,73025484,61778
"4761","ENSBTAG00000007766","4",113630176,113634606,4430
"4762","ENSBTAG00000007767","3",24129991,24254368,124377
"4763","ENSBTAG00000007768","14",65828236,65829669,1433
"4764","ENSBTAG00000007772","25",38971637,38983187,11550
"4765","ENSBTAG00000007773","3",42553488,42576599,23111
"4766","ENSBTAG00000007776","22",16964586,16980496,15910
"4767","ENSBTAG00000007777","22",16957264,16962873,5609
"4768","ENSBTAG00000007778","8",46715833,46817682,101849
"4769","ENSBTAG00000007779","2",85361038,85393083,32045
"4770","ENSBTAG00000007780","22",16946297,16957323,11026
"4771","ENSBTAG00000007782","7",49334671,49357200,22529
"4772","ENSBTAG00000007783","13",72231694,72258247,26553
"4773","ENSBTAG00000007784","1",58402278,58433748,31470
"4774","ENSBTAG00000007785","7",49358740,49403930,45190
"4775","ENSBTAG00000007787","2",5980697,6129150,148453
"4776","ENSBTAG00000007788","X",87078387,87100538,22151
"4777","ENSBTAG00000007791","9",12429180,12648301,219121
"4778","ENSBTAG00000007794","19",41065643,41075614,9971
"4779","ENSBTAG00000007796","4",77228350,77236566,8216
"4780","ENSBTAG00000007797","X",80289621,80336629,47008
"4781","ENSBTAG00000007798","X",80257127,80278443,21316
"4782","ENSBTAG00000007799","9",74232905,74250570,17665
"4783","ENSBTAG00000007800","10",20690589,20704207,13618
"4784","ENSBTAG00000007802","9",74258878,74287498,28620
"4785","ENSBTAG00000007804","17",52178861,52205415,26554
"4786","ENSBTAG00000007806","4",99750823,99827165,76342
"4787","ENSBTAG00000007807","10",76679838,76682342,2504
"4788","ENSBTAG00000007808","11",67359790,67615063,255273
"4789","ENSBTAG00000007809","10",76687169,76710452,23283
"4790","ENSBTAG00000007812","7",3801697,3810659,8962
"4791","ENSBTAG00000007813","X",35964513,35976127,11614
"4792","ENSBTAG00000007814","1",118469263,118642804,173541
"4793","ENSBTAG00000007816","6",85829541,85830410,869
"4794","ENSBTAG00000007817","X",35888645,35964229,75584
"4795","ENSBTAG00000007818","1",145089416,145103157,13741
"4796","ENSBTAG00000007820","7",2653256,2653810,554
"4797","ENSBTAG00000007821","18",46533688,46553042,19354
"4798","ENSBTAG00000007823","14",8217490,8453614,236124
"4799","ENSBTAG00000007825","29",42197785,42253634,55849
"4800","ENSBTAG00000007826","18",46556490,46565668,9178
"4801","ENSBTAG00000007827","29",42254022,42259113,5091
"4802","ENSBTAG00000007828","14",8250306,8315788,65482
"4803","ENSBTAG00000007829","5",26821653,26847931,26278
"4804","ENSBTAG00000007830","2",96101252,96318495,217243
"4805","ENSBTAG00000007833","24",46532526,46645291,112765
"4806","ENSBTAG00000007834","14",443246,448420,5174
"4807","ENSBTAG00000007835","14",438530,442163,3633
"4808","ENSBTAG00000007836","28",26418194,26456501,38307
"4809","ENSBTAG00000007837","11",73145020,73184405,39385
"4810","ENSBTAG00000007838","14",435003,437076,2073
"4811","ENSBTAG00000007840","10",6763962,6784639,20677
"4812","ENSBTAG00000007841","18",44881373,44907012,25639
"4813","ENSBTAG00000007842","3",49581839,49599562,17723
"4814","ENSBTAG00000007843","22",48099219,48113488,14269
"4815","ENSBTAG00000007844","X",35129242,35133447,4205
"4816","ENSBTAG00000007846","22",48078023,48091969,13946
"4817","ENSBTAG00000007847","29",9265425,9295980,30555
"4818","ENSBTAG00000007850","22",48059508,48079899,20391
"4819","ENSBTAG00000007851","16",4681160,4687617,6457
"4820","ENSBTAG00000007859","X",56674451,56707742,33291
"4821","ENSBTAG00000007860","16",76021939,76082066,60127
"4822","ENSBTAG00000007863","2",79427772,79481911,54139
"4823","ENSBTAG00000007865","7",53066435,53077719,11284
"4824","ENSBTAG00000007866","19",32224904,32266041,41137
"4825","ENSBTAG00000007867","2",79518741,79560102,41361
"4826","ENSBTAG00000007870","4",66328677,66340716,12039
"4827","ENSBTAG00000007871","X",79555739,79603340,47601
"4828","ENSBTAG00000007872","8",28792830,28833726,40896
"4829","ENSBTAG00000007875","7",18621612,18651390,29778
"4830","ENSBTAG00000007876","28",42712776,42813456,100680
"4831","ENSBTAG00000007878","28",42821393,43000626,179233
"4832","ENSBTAG00000007879","25",34284143,34325779,41636
"4833","ENSBTAG00000007880","25",517353,539807,22454
"4834","ENSBTAG00000007881","26",11068424,11074395,5971
"4835","ENSBTAG00000007882","11",106722392,106933600,211208
"4836","ENSBTAG00000007884","19",34633133,34649213,16080
"4837","ENSBTAG00000007887","25",8496962,8687352,190390
"4838","ENSBTAG00000007888","11",74126883,74224519,97636
"4839","ENSBTAG00000007890","25",4015563,4054421,38858
"4840","ENSBTAG00000007893","19",7813172,7847068,33896
"4841","ENSBTAG00000007895","11",46352478,46366279,13801
"4842","ENSBTAG00000007896","25",4050938,4068402,17464
"4843","ENSBTAG00000007897","11",74117511,74124989,7478
"4844","ENSBTAG00000007898","2",24912893,24945933,33040
"4845","ENSBTAG00000007900","25",35447764,35461476,13712
"4846","ENSBTAG00000007901","7",17557794,17633496,75702
"4847","ENSBTAG00000007904","5",27289799,27302328,12529
"4848","ENSBTAG00000007906","19",55578491,55582703,4212
"4849","ENSBTAG00000007909","3",23163504,23368572,205068
"4850","ENSBTAG00000007910","19",55560758,55581189,20431
"4851","ENSBTAG00000007913","15",15447722,15456214,8492
"4852","ENSBTAG00000007916","19",55541080,55545858,4778
"4853","ENSBTAG00000007917","13",80866302,81066805,200503
"4854","ENSBTAG00000007920","13",51276263,51306156,29893
"4855","ENSBTAG00000007921","6",24802758,24859480,56722
"4856","ENSBTAG00000007922","13",51228908,51267554,38646
"4857","ENSBTAG00000007923","6",24787040,24798440,11400
"4858","ENSBTAG00000007927","3",8969591,9008636,39045
"4859","ENSBTAG00000007930","13",64051984,64148363,96379
"4860","ENSBTAG00000007931","10",73121780,73210131,88351
"4861","ENSBTAG00000007932","13",61563070,61608503,45433
"4862","ENSBTAG00000007933","1",124866092,124888751,22659
"4863","ENSBTAG00000007934","25",27653220,27658120,4900
"4864","ENSBTAG00000007935","19",37678783,37702465,23682
"4865","ENSBTAG00000007937","23",2560548,2894440,333892
"4866","ENSBTAG00000007939","1",35381297,35415198,33901
"4867","ENSBTAG00000007942","18",18573010,18645765,72755
"4868","ENSBTAG00000007943","14",61585944,61617025,31081
"4869","ENSBTAG00000007946","19",20406351,20419985,13634
"4870","ENSBTAG00000007948","26",27553353,27912060,358707
"4871","ENSBTAG00000007952","25",26403797,26423373,19576
"4872","ENSBTAG00000007953","17",5256463,5351434,94971
"4873","ENSBTAG00000007954","25",26388343,26391768,3425
"4874","ENSBTAG00000007955","25",26362158,26382375,20217
"4875","ENSBTAG00000007956","26",18565464,18566291,827
"4876","ENSBTAG00000007958","19",40696965,40720517,23552
"4877","ENSBTAG00000007960","13",69721975,69779394,57419
"4878","ENSBTAG00000007961","22",16922281,16933837,11556
"4879","ENSBTAG00000007962","13",79436295,79557537,121242
"4880","ENSBTAG00000007963","11",88488031,88581016,92985
"4881","ENSBTAG00000007964","22",16912813,16923222,10409
"4882","ENSBTAG00000007966","22",16888782,16910868,22086
"4883","ENSBTAG00000007968","22",16878874,16886849,7975
"4884","ENSBTAG00000007969","22",16864534,16873831,9297
"4885","ENSBTAG00000007970","1",36156437,36162573,6136
"4886","ENSBTAG00000007971","15",81198021,81198974,953
"4887","ENSBTAG00000007974","9",95997044,96023437,26393
"4888","ENSBTAG00000007975","9",72977327,73001905,24578
"4889","ENSBTAG00000007976","4",85865619,85918137,52518
"4890","ENSBTAG00000007977","13",2540227,2553000,12773
"4891","ENSBTAG00000007979","20",8728071,8816598,88527
"4892","ENSBTAG00000007981","26",39360203,39592150,231947
"4893","ENSBTAG00000007983","4",112791822,112813266,21444
"4894","ENSBTAG00000007986","6",116642228,116685495,43267
"4895","ENSBTAG00000007988","17",46316500,46383190,66690
"4896","ENSBTAG00000007989","9",53645198,53646339,1141
"4897","ENSBTAG00000007990","5",20843517,20884065,40548
"4898","ENSBTAG00000007993","17",64209162,64284057,74895
"4899","ENSBTAG00000007994","3",109442372,109471653,29281
"4900","ENSBTAG00000007996","2",133022950,133035378,12428
"4901","ENSBTAG00000007998","2",132915932,133020007,104075
"4902","ENSBTAG00000008001","16",3467645,3495038,27393
"4903","ENSBTAG00000008003","16",64518478,64604657,86179
"4904","ENSBTAG00000008004","16",64606142,64652347,46205
"4905","ENSBTAG00000008005","18",25679294,25700260,20966
"4906","ENSBTAG00000008006","11",16067572,16114724,47152
"4907","ENSBTAG00000008008","17",3954019,3967242,13223
"4908","ENSBTAG00000008009","19",34939346,34942156,2810
"4909","ENSBTAG00000008010","19",34915672,34932182,16510
"4910","ENSBTAG00000008013","22",52863612,52921087,57475
"4911","ENSBTAG00000008014","18",53592617,53613177,20560
"4912","ENSBTAG00000008016","8",64953185,65022721,69536
"4913","ENSBTAG00000008017","21",58086363,58328508,242145
"4914","ENSBTAG00000008020","5",65308669,65308998,329
"4915","ENSBTAG00000008021","7",5735682,5737511,1829
"4916","ENSBTAG00000008022","3",26252748,26331248,78500
"4917","ENSBTAG00000008023","3",107046910,107104902,57992
"4918","ENSBTAG00000008024","12",50598782,50648820,50038
"4919","ENSBTAG00000008025","4",118465389,118580636,115247
"4920","ENSBTAG00000008026","13",52113970,52114880,910
"4921","ENSBTAG00000008027","13",52102351,52104369,2018
"4922","ENSBTAG00000008028","2",21843101,22045348,202247
"4923","ENSBTAG00000008032","4",115112614,115184356,71742
"4924","ENSBTAG00000008033","11",96044191,96085238,41047
"4925","ENSBTAG00000008034","7",38829326,38849952,20626
"4926","ENSBTAG00000008035","11",11295693,11296169,476
"4927","ENSBTAG00000008036","5",116657456,116800031,142575
"4928","ENSBTAG00000008039","2",62363597,62424558,60961
"4929","ENSBTAG00000008040","12",25176134,25208192,32058
"4930","ENSBTAG00000008047","X",75746325,75811386,65061
"4931","ENSBTAG00000008048","11",43921124,43998529,77405
"4932","ENSBTAG00000008053","12",21011836,21198062,186226
"4933","ENSBTAG00000008054","14",63150498,63158673,8175
"4934","ENSBTAG00000008056","13",26665423,26728690,63267
"4935","ENSBTAG00000008057","5",114877721,114904689,26968
"4936","ENSBTAG00000008059","28",12684411,12718907,34496
"4937","ENSBTAG00000008060","17",52157896,52161635,3739
"4938","ENSBTAG00000008061","17",52111245,52153382,42137
"4939","ENSBTAG00000008062","8",43506897,43513871,6974
"4940","ENSBTAG00000008063","5",116438987,116507065,68078
"4941","ENSBTAG00000008064","29",37451299,37481231,29932
"4942","ENSBTAG00000008065","5",116513986,116522344,8358
"4943","ENSBTAG00000008066","5",116574927,116584877,9950
"4944","ENSBTAG00000008068","11",36519763,36544362,24599
"4945","ENSBTAG00000008072","2",128924106,128936367,12261
"4946","ENSBTAG00000008074","5",75616456,75629565,13109
"4947","ENSBTAG00000008075","15",29590521,29594196,3675
"4948","ENSBTAG00000008076","23",17759581,17763259,3678
"4949","ENSBTAG00000008077","15",29592789,29599909,7120
"4950","ENSBTAG00000008078","1",107030008,107042373,12365
"4951","ENSBTAG00000008079","14",961099,968482,7383
"4952","ENSBTAG00000008082","16",61203358,61333436,130078
"4953","ENSBTAG00000008083","10",92758415,92823117,64702
"4954","ENSBTAG00000008084","18",46957460,46988177,30717
"4955","ENSBTAG00000008088","19",44629534,44650895,21361
"4956","ENSBTAG00000008089","2",4601012,4621042,20030
"4957","ENSBTAG00000008090","4",76550183,76603468,53285
"4958","ENSBTAG00000008091","3",19442661,19451510,8849
"4959","ENSBTAG00000008092","19",56672776,56740010,67234
"4960","ENSBTAG00000008095","7",18105651,18128839,23188
"4961","ENSBTAG00000008096","23",44156426,44163955,7529
"4962","ENSBTAG00000008097","4",51105613,51149684,44071
"4963","ENSBTAG00000008098","17",7567228,7755085,187857
"4964","ENSBTAG00000008099","22",53029379,53032543,3164
"4965","ENSBTAG00000008100","26",18993544,19006545,13001
"4966","ENSBTAG00000008101","8",51911490,52419336,507846
"4967","ENSBTAG00000008102","26",19019143,19170819,151676
"4968","ENSBTAG00000008103","8",49053228,49106706,53478
"4969","ENSBTAG00000008105","13",58757856,58773523,15667
"4970","ENSBTAG00000008109","19",19806850,19814864,8014
"4971","ENSBTAG00000008110","19",19814952,19821909,6957
"4972","ENSBTAG00000008111","1",130610161,130664345,54184
"4973","ENSBTAG00000008112","9",83146375,83227904,81529
"4974","ENSBTAG00000008113","11",79405644,79413111,7467
"4975","ENSBTAG00000008114","X",138754709,138785187,30478
"4976","ENSBTAG00000008115","19",19822153,19830834,8681
"4977","ENSBTAG00000008116","19",19826425,19841200,14775
"4978","ENSBTAG00000008117","17",70627688,70655990,28302
"4979","ENSBTAG00000008118","3",59600699,59617167,16468
"4980","ENSBTAG00000008120","19",19841240,19846107,4867
"4981","ENSBTAG00000008121","9",24092377,24187122,94745
"4982","ENSBTAG00000008122","3",59591885,59600029,8144
"4983","ENSBTAG00000008124","X",112861218,112935556,74338
"4984","ENSBTAG00000008125","16",47231521,47298388,66867
"4985","ENSBTAG00000008126","16",47331774,47463903,132129
"4986","ENSBTAG00000008127","5",103251544,103258418,6874
"4987","ENSBTAG00000008129","5",103220647,103250646,29999
"4988","ENSBTAG00000008130","20",66817755,66826001,8246
"4989","ENSBTAG00000008131","3",21532899,21598565,65666
"4990","ENSBTAG00000008132","16",1899514,1911011,11497
"4991","ENSBTAG00000008133","10",88823935,88846698,22763
"4992","ENSBTAG00000008134","15",58385523,58422131,36608
"4993","ENSBTAG00000008135","10",88846597,88853571,6974
"4994","ENSBTAG00000008136","10",88853700,88888853,35153
"4995","ENSBTAG00000008137","5",75145365,75145619,254
"4996","ENSBTAG00000008138","4",68939317,68941279,1962
"4997","ENSBTAG00000008139","4",68902556,68934981,32425
"4998","ENSBTAG00000008140","2",34192288,34271400,79112
"4999","ENSBTAG00000008142","2",34111730,34166890,55160
"5000","ENSBTAG00000008143","4",77478669,77515252,36583
"5001","ENSBTAG00000008144","9",40714260,40749877,35617
"5002","ENSBTAG00000008145","9",40710828,40714565,3737
"5003","ENSBTAG00000008147","9",40698480,40710698,12218
"5004","ENSBTAG00000008148","23",25311634,25332932,21298
"5005","ENSBTAG00000008150","14",41721020,41820938,99918
"5006","ENSBTAG00000008151","19",47912961,47973784,60823
"5007","ENSBTAG00000008153","16",79375975,79473155,97180
"5008","ENSBTAG00000008154","19",47975191,47977056,1865
"5009","ENSBTAG00000008155","4",7704656,7744159,39503
"5010","ENSBTAG00000008158","24",54267957,54325899,57942
"5011","ENSBTAG00000008159","9",81316749,81361312,44563
"5012","ENSBTAG00000008160","11",88363056,88464714,101658
"5013","ENSBTAG00000008161","3",57558897,57592968,34071
"5014","ENSBTAG00000008165","19",44172212,44185276,13064
"5015","ENSBTAG00000008167","1",149318018,149436586,118568
"5016","ENSBTAG00000008168","24",53723313,53741049,17736
"5017","ENSBTAG00000008169","24",53744053,53791986,47933
"5018","ENSBTAG00000008170","X",118341050,118636885,295835
"5019","ENSBTAG00000008172","21",44387137,44416154,29017
"5020","ENSBTAG00000008173","12",19448143,19461103,12960
"5021","ENSBTAG00000008175","25",27624063,27637076,13013
"5022","ENSBTAG00000008176","12",19462731,19468197,5466
"5023","ENSBTAG00000008180","20",1477149,1510229,33080
"5024","ENSBTAG00000008181","7",19676722,19701793,25071
"5025","ENSBTAG00000008182","18",53074888,53081288,6400
"5026","ENSBTAG00000008183","X",121426231,121470766,44535
"5027","ENSBTAG00000008184","25",27727918,27738084,10166
"5028","ENSBTAG00000008185","18",53087288,53096006,8718
"5029","ENSBTAG00000008186","7",19663055,19674553,11498
"5030","ENSBTAG00000008188","25",19694092,19769282,75190
"5031","ENSBTAG00000008190","25",27738682,27754221,15539
"5032","ENSBTAG00000008191","23",7386228,7391458,5230
"5033","ENSBTAG00000008192","7",15759391,15768139,8748
"5034","ENSBTAG00000008195","25",27749099,27763437,14338
"5035","ENSBTAG00000008196","7",15772589,15774930,2341
"5036","ENSBTAG00000008197","7",15775449,15781166,5717
"5037","ENSBTAG00000008198","7",15785486,15800362,14876
"5038","ENSBTAG00000008201","7",15800804,15811483,10679
"5039","ENSBTAG00000008202","7",15811857,15825182,13325
"5040","ENSBTAG00000008204","8",51058247,51098110,39863
"5041","ENSBTAG00000008213","18",7721648,7736768,15120
"5042","ENSBTAG00000008216","11",87488674,87495961,7287
"5043","ENSBTAG00000008218","10",20373350,20437776,64426
"5044","ENSBTAG00000008219","15",24920578,24927867,7289
"5045","ENSBTAG00000008220","15",24919805,24920623,818
"5046","ENSBTAG00000008222","25",4101448,4112329,10881
"5047","ENSBTAG00000008223","11",14815806,14865722,49916
"5048","ENSBTAG00000008224","7",50628259,50645911,17652
"5049","ENSBTAG00000008227","15",53838026,53839967,1941
"5050","ENSBTAG00000008228","23",3189366,3252666,63300
"5051","ENSBTAG00000008232","11",92474356,92686144,211788
"5052","ENSBTAG00000008236","15",50318301,50319263,962
"5053","ENSBTAG00000008237","29",50169950,50185623,15673
"5054","ENSBTAG00000008238","3",16905298,16909160,3862
"5055","ENSBTAG00000008240","1",153179306,153226107,46801
"5056","ENSBTAG00000008241","11",1922410,1945833,23423
"5057","ENSBTAG00000008243","3",74977580,75017652,40072
"5058","ENSBTAG00000008248","X",111610500,112306889,696389
"5059","ENSBTAG00000008250","7",53339584,53351162,11578
"5060","ENSBTAG00000008251","21",1937647,1961037,23390
"5061","ENSBTAG00000008253","15",18190683,18291205,100522
"5062","ENSBTAG00000008255","6",4138065,4200076,62011
"5063","ENSBTAG00000008257","14",56948115,56949709,1594
"5064","ENSBTAG00000008259","12",52068462,52075849,7387
"5065","ENSBTAG00000008267","11",6164467,6177875,13408
"5066","ENSBTAG00000008269","11",6191651,6208758,17107
"5067","ENSBTAG00000008271","12",29997123,30014621,17498
"5068","ENSBTAG00000008272","26",49155222,49271953,116731
"5069","ENSBTAG00000008274","29",50212292,50227932,15640
"5070","ENSBTAG00000008275","24",34676930,34784853,107923
"5071","ENSBTAG00000008278","X",37184098,37188612,4514
"5072","ENSBTAG00000008279","13",28351256,28679615,328359
"5073","ENSBTAG00000008280","14",38801752,38831315,29563
"5074","ENSBTAG00000008283","29",32051549,32184256,132707
"5075","ENSBTAG00000008285","14",57844325,58141613,297288
"5076","ENSBTAG00000008287","10",86019850,86083721,63871
"5077","ENSBTAG00000008288","13",17640546,17708610,68064
"5078","ENSBTAG00000008289","19",27131781,27147274,15493
"5079","ENSBTAG00000008291","13",64444427,64449124,4697
"5080","ENSBTAG00000008292","24",34606945,34614665,7720
"5081","ENSBTAG00000008293","13",47720768,47778950,58182
"5082","ENSBTAG00000008294","19",60608545,60618841,10296
"5083","ENSBTAG00000008295","25",35923271,35934218,10947
"5084","ENSBTAG00000008296","12",35796991,35817783,20792
"5085","ENSBTAG00000008299","1",132167385,132207262,39877
"5086","ENSBTAG00000008300","2",103361566,103431472,69906
"5087","ENSBTAG00000008301","8",84552273,84699098,146825
"5088","ENSBTAG00000008302","4",46646922,46670543,23621
"5089","ENSBTAG00000008303","13",59737061,59766123,29062
"5090","ENSBTAG00000008306","4",103825066,103842924,17858
"5091","ENSBTAG00000008307","1",111945804,112167879,222075
"5092","ENSBTAG00000008309","2",135586322,135606413,20091
"5093","ENSBTAG00000008310","15",43625137,43643807,18670
"5094","ENSBTAG00000008313","22",60612131,60624486,12355
"5095","ENSBTAG00000008314","2",135548907,135578120,29213
"5096","ENSBTAG00000008318","19",25422472,25431855,9383
"5097","ENSBTAG00000008319","X",36871649,36874437,2788
"5098","ENSBTAG00000008320","17",72790364,72799264,8900
"5099","ENSBTAG00000008321","23",11244735,11282020,37285
"5100","ENSBTAG00000008323","13",3478001,3561819,83818
"5101","ENSBTAG00000008325","27",28986648,28986965,317
"5102","ENSBTAG00000008328","19",56883894,56894884,10990
"5103","ENSBTAG00000008329","2",38913867,38942113,28246
"5104","ENSBTAG00000008330","2",120719524,120743308,23784
"5105","ENSBTAG00000008331","2",120773181,120780411,7230
"5106","ENSBTAG00000008332","6",14912679,14992464,79785
"5107","ENSBTAG00000008333","19",43447918,43462772,14854
"5108","ENSBTAG00000008336","2",120779969,120788339,8370
"5109","ENSBTAG00000008338","13",933264,1794219,860955
"5110","ENSBTAG00000008339","19",43415313,43443775,28462
"5111","ENSBTAG00000008340","7",62942179,62957525,15346
"5112","ENSBTAG00000008341","10",9823217,10003931,180714
"5113","ENSBTAG00000008342","15",28569542,28601482,31940
"5114","ENSBTAG00000008343","1",82703621,82705452,1831
"5115","ENSBTAG00000008347","15",53278739,53333980,55241
"5116","ENSBTAG00000008348","13",61874277,61955381,81104
"5117","ENSBTAG00000008349","23",29996426,30007987,11561
"5118","ENSBTAG00000008350","16",46800207,46813319,13112
"5119","ENSBTAG00000008351","5",95085927,95086643,716
"5120","ENSBTAG00000008352","5",95068426,95082135,13709
"5121","ENSBTAG00000008353","23",10582308,10590589,8281
"5122","ENSBTAG00000008355","14",542386,556837,14451
"5123","ENSBTAG00000008361","4",12645430,12673193,27763
"5124","ENSBTAG00000008362","2",106408440,106413567,5127
"5125","ENSBTAG00000008363","10",36677942,36704017,26075
"5126","ENSBTAG00000008365","3",21413252,21415922,2670
"5127","ENSBTAG00000008366","19",39703116,39716321,13205
"5128","ENSBTAG00000008368","19",39727417,39735809,8392
"5129","ENSBTAG00000008369","3",21418275,21448521,30246
"5130","ENSBTAG00000008370","3",21449848,21453480,3632
"5131","ENSBTAG00000008371","19",39742501,39842783,100282
"5132","ENSBTAG00000008372","3",21454070,21459694,5624
"5133","ENSBTAG00000008373","3",21460548,21477566,17018
"5134","ENSBTAG00000008374","5",29926245,29931719,5474
"5135","ENSBTAG00000008376","8",75727314,75764780,37466
"5136","ENSBTAG00000008378","10",15105565,15119491,13926
"5137","ENSBTAG00000008380","10",15129322,15262276,132954
"5138","ENSBTAG00000008382","5",11908969,12015429,106460
"5139","ENSBTAG00000008384","21",65227939,65234057,6118
"5140","ENSBTAG00000008385","18",10837455,10851268,13813
"5141","ENSBTAG00000008386","10",12092543,12157468,64925
"5142","ENSBTAG00000008388","X",7973369,8083076,109707
"5143","ENSBTAG00000008389","26",42285479,42343309,57830
"5144","ENSBTAG00000008390","2",13794248,13842369,48121
"5145","ENSBTAG00000008394","22",52638016,52644842,6826
"5146","ENSBTAG00000008395","7",20214159,20223118,8959
"5147","ENSBTAG00000008396","7",20209218,20212341,3123
"5148","ENSBTAG00000008397","7",20847764,20853001,5237
"5149","ENSBTAG00000008399","22",51401422,51419086,17664
"5150","ENSBTAG00000008401","13",17205507,17372393,166886
"5151","ENSBTAG00000008403","24",35016400,35139433,123033
"5152","ENSBTAG00000008406","22",51399388,51401262,1874
"5153","ENSBTAG00000008409","14",12653173,12658366,5193
"5154","ENSBTAG00000008410","13",38271785,38300529,28744
"5155","ENSBTAG00000008411","10",45233901,45256216,22315
"5156","ENSBTAG00000008412","25",26938951,26969724,30773
"5157","ENSBTAG00000008414","20",41213852,41297142,83290
"5158","ENSBTAG00000008416","22",15584972,15626415,41443
"5159","ENSBTAG00000008417","17",54370245,54377438,7193
"5160","ENSBTAG00000008419","15",52090857,52228534,137677
"5161","ENSBTAG00000008420","16",15166537,15630781,464244
"5162","ENSBTAG00000008421","14",987039,1006477,19438
"5163","ENSBTAG00000008423","19",21863372,21870716,7344
"5164","ENSBTAG00000008424","19",21674362,21862869,188507
"5165","ENSBTAG00000008426","8",113173097,113173255,158
"5166","ENSBTAG00000008428","4",7619639,7648114,28475
"5167","ENSBTAG00000008429","15",76789248,76840637,51389
"5168","ENSBTAG00000008430","20",37936883,37991125,54242
"5169","ENSBTAG00000008431","2",110843395,110873230,29835
"5170","ENSBTAG00000008432","15",51264707,51350656,85949
"5171","ENSBTAG00000008433","15",51243181,51264664,21483
"5172","ENSBTAG00000008434","5",109621889,109634246,12357
"5173","ENSBTAG00000008435","7",52987584,53004020,16436
"5174","ENSBTAG00000008436","13",51395118,51404718,9600
"5175","ENSBTAG00000008437","7",53009272,53021867,12595
"5176","ENSBTAG00000008438","17",4727646,4887492,159846
"5177","ENSBTAG00000008439","13",51378950,51383204,4254
"5178","ENSBTAG00000008441","19",53840159,53840858,699
"5179","ENSBTAG00000008442","19",45443488,45591669,148181
"5180","ENSBTAG00000008443","7",65952521,66013847,61326
"5181","ENSBTAG00000008446","25",28378765,28522373,143608
"5182","ENSBTAG00000008448","11",64808522,64951995,143473
"5183","ENSBTAG00000008452","2",107001051,107007228,6177
"5184","ENSBTAG00000008453","16",28446036,28472860,26824
"5185","ENSBTAG00000008457","7",71985922,72000969,15047
"5186","ENSBTAG00000008461","1",72877165,72901758,24593
"5187","ENSBTAG00000008462","1",72861563,72862834,1271
"5188","ENSBTAG00000008463","22",11752094,11763779,11685
"5189","ENSBTAG00000008464","17",52574035,52603860,29825
"5190","ENSBTAG00000008465","15",74175866,74199580,23714
"5191","ENSBTAG00000008466","10",26794963,26802885,7922
"5192","ENSBTAG00000008467","3",34702129,34714161,12032
"5193","ENSBTAG00000008468","4",113698770,113717852,19082
"5194","ENSBTAG00000008470","17",52333197,52385417,52220
"5195","ENSBTAG00000008471","1",141621165,141658223,37058
"5196","ENSBTAG00000008472","13",39604529,39628940,24411
"5197","ENSBTAG00000008479","6",92284631,92291191,6560
"5198","ENSBTAG00000008480","6",117202374,117225838,23464
"5199","ENSBTAG00000008482","1",1954230,1985068,30838
"5200","ENSBTAG00000008483","2",8891734,9020442,128708
"5201","ENSBTAG00000008484","7",87739194,87817552,78358
"5202","ENSBTAG00000008487","25",33581566,33585569,4003
"5203","ENSBTAG00000008490","1",1909498,1943914,34416
"5204","ENSBTAG00000008491","23",32615138,32622371,7233
"5205","ENSBTAG00000008492","X",79395484,79409855,14371
"5206","ENSBTAG00000008493","8",75194687,75200704,6017
"5207","ENSBTAG00000008494","20",8497858,8508646,10788
"5208","ENSBTAG00000008495","21",22966143,23003119,36976
"5209","ENSBTAG00000008497","7",38857589,38872628,15039
"5210","ENSBTAG00000008498","19",50999623,51004298,4675
"5211","ENSBTAG00000008499","5",30487010,30495995,8985
"5212","ENSBTAG00000008500","18",2551228,2555890,4662
"5213","ENSBTAG00000008501","3",82243978,82245566,1588
"5214","ENSBTAG00000008504","25",1544721,1549053,4332
"5215","ENSBTAG00000008505","11",77885935,77927967,42032
"5216","ENSBTAG00000008507","19",55350377,55354150,3773
"5217","ENSBTAG00000008509","22",50131869,50146728,14859
"5218","ENSBTAG00000008510","2",135783522,135863766,80244
"5219","ENSBTAG00000008512","14",54487445,54495242,7797
"5220","ENSBTAG00000008513","16",3826242,3851218,24976
"5221","ENSBTAG00000008518","18",56177154,56191179,14025
"5222","ENSBTAG00000008520","7",20448283,20516117,67834
"5223","ENSBTAG00000008523","X",87111180,87122824,11644
"5224","ENSBTAG00000008525","3",30209587,30272272,62685
"5225","ENSBTAG00000008527","13",72096560,72102389,5829
"5226","ENSBTAG00000008528","17",72617237,72620215,2978
"5227","ENSBTAG00000008530","29",1701573,1743386,41813
"5228","ENSBTAG00000008533","4",16051521,16156180,104659
"5229","ENSBTAG00000008535","19",39011186,39036089,24903
"5230","ENSBTAG00000008537","8",75767849,75827099,59250
"5231","ENSBTAG00000008538","8",75826096,75895209,69113
"5232","ENSBTAG00000008539","8",75895253,75897375,2122
"5233","ENSBTAG00000008540","9",96308485,96346187,37702
"5234","ENSBTAG00000008541","5",93497064,93521047,23983
"5235","ENSBTAG00000008542","4",112625941,112677619,51678
"5236","ENSBTAG00000008543","9",94714760,94729301,14541
"5237","ENSBTAG00000008544","18",19546249,19560362,14113
"5238","ENSBTAG00000008545","16",70924511,70937490,12979
"5239","ENSBTAG00000008546","18",55065034,55075090,10056
"5240","ENSBTAG00000008548","11",16138037,16154045,16008
"5241","ENSBTAG00000008550","4",113276469,113287212,10743
"5242","ENSBTAG00000008551","8",18576404,18577033,629
"5243","ENSBTAG00000008552","X",37517384,37533715,16331
"5244","ENSBTAG00000008553","5",107337753,107434583,96830
"5245","ENSBTAG00000008554","5",107436492,107509112,72620
"5246","ENSBTAG00000008555","X",73327068,73345776,18708
"5247","ENSBTAG00000008556","18",51132250,51162438,30188
"5248","ENSBTAG00000008557","15",56338774,56340810,2036
"5249","ENSBTAG00000008562","1",64246626,64269696,23070
"5250","ENSBTAG00000008564","15",24807815,24813266,5451
"5251","ENSBTAG00000008567","22",11491792,11582286,90494
"5252","ENSBTAG00000008568","29",43569209,43574834,5625
"5253","ENSBTAG00000008570","7",61760781,61778862,18081
"5254","ENSBTAG00000008571","17",54818687,55096432,277745
"5255","ENSBTAG00000008573","18",49101057,49104540,3483
"5256","ENSBTAG00000008575","10",52768945,52889275,120330
"5257","ENSBTAG00000008576","10",81245510,81276266,30756
"5258","ENSBTAG00000008577","6",86196005,86214840,18835
"5259","ENSBTAG00000008578","7",4882773,4893672,10899
"5260","ENSBTAG00000008579","2",135211439,135237283,25844
"5261","ENSBTAG00000008583","28",26677156,26762598,85442
"5262","ENSBTAG00000008584","27",1195589,1252035,56446
"5263","ENSBTAG00000008585","27",1347269,1407799,60530
"5264","ENSBTAG00000008587","17",71328580,71334085,5505
"5265","ENSBTAG00000008590","19",26434654,26438799,4145
"5266","ENSBTAG00000008591","19",26418173,26434463,16290
"5267","ENSBTAG00000008592","3",20802181,20811180,8999
"5268","ENSBTAG00000008593","19",26414113,26419319,5206
"5269","ENSBTAG00000008595","5",38179856,38354903,175047
"5270","ENSBTAG00000008596","5",38058247,38171657,113410
"5271","ENSBTAG00000008597","14",2652445,2715564,63119
"5272","ENSBTAG00000008600","9",38820071,38864690,44619
"5273","ENSBTAG00000008603","X",113007471,113020230,12759
"5274","ENSBTAG00000008605","19",27416681,27523393,106712
"5275","ENSBTAG00000008606","20",71649687,71674393,24706
"5276","ENSBTAG00000008607","7",43469763,43498705,28942
"5277","ENSBTAG00000008609","7",21565591,21590781,25190
"5278","ENSBTAG00000008611","19",40672669,40684245,11576
"5279","ENSBTAG00000008612","5",103358822,103387417,28595
"5280","ENSBTAG00000008613","15",63686064,63716137,30073
"5281","ENSBTAG00000008614","18",55855244,55879473,24229
"5282","ENSBTAG00000008617","15",63722373,63789775,67402
"5283","ENSBTAG00000008619","28",30882776,30936255,53479
"5284","ENSBTAG00000008621","19",61704501,61718579,14078
"5285","ENSBTAG00000008625","18",40287571,40296599,9028
"5286","ENSBTAG00000008626","7",5185086,5214413,29327
"5287","ENSBTAG00000008629","14",30039506,30098890,59384
"5288","ENSBTAG00000008631","25",26134784,26140301,5517
"5289","ENSBTAG00000008632","25",26131819,26132468,649
"5290","ENSBTAG00000008633","25",26126027,26131638,5611
"5291","ENSBTAG00000008634","19",55760647,55769045,8398
"5292","ENSBTAG00000008635","25",26123609,26127457,3848
"5293","ENSBTAG00000008636","3",78957184,79406648,449464
"5294","ENSBTAG00000008638","13",60259697,60273426,13729
"5295","ENSBTAG00000008641","4",40574285,40629320,55035
"5296","ENSBTAG00000008642","12",32319707,32321401,1694
"5297","ENSBTAG00000008644","29",42592282,42599230,6948
"5298","ENSBTAG00000008645","29",42603429,42612003,8574
"5299","ENSBTAG00000008646","29",42611757,42613078,1321
"5300","ENSBTAG00000008647","12",43998992,44525321,526329
"5301","ENSBTAG00000008648","29",42613257,42616366,3109
"5302","ENSBTAG00000008649","3",13730370,13744313,13943
"5303","ENSBTAG00000008650","13",11673965,12062665,388700
"5304","ENSBTAG00000008652","3",1605719,1673362,67643
"5305","ENSBTAG00000008654","7",12747648,12759585,11937
"5306","ENSBTAG00000008656","12",11333975,11336092,2117
"5307","ENSBTAG00000008661","15",22251270,22258191,6921
"5308","ENSBTAG00000008664","10",86259479,86266555,7076
"5309","ENSBTAG00000008665","15",22301569,22335080,33511
"5310","ENSBTAG00000008672","16",50708331,50725360,17029
"5311","ENSBTAG00000008673","2",91143446,91177884,34438
"5312","ENSBTAG00000008674","11",14150135,14154627,4492
"5313","ENSBTAG00000008676","17",56189388,56355937,166549
"5314","ENSBTAG00000008682","27",16085880,16187248,101368
"5315","ENSBTAG00000008683","29",26290893,26301350,10457
"5316","ENSBTAG00000008684","29",24589163,24590218,1055
"5317","ENSBTAG00000008685","8",111053754,111089492,35738
"5318","ENSBTAG00000008687","13",37505784,37745694,239910
"5319","ENSBTAG00000008688","3",106442589,106458224,15635
"5320","ENSBTAG00000008690","3",102033426,102065123,31697
"5321","ENSBTAG00000008692","7",43976251,43979203,2952
"5322","ENSBTAG00000008693","14",19817531,19828829,11298
"5323","ENSBTAG00000008695","7",43981884,44015020,33136
"5324","ENSBTAG00000008696","8",84768223,84884516,116293
"5325","ENSBTAG00000008699","10",4358418,4386867,28449
"5326","ENSBTAG00000008700","3",18184104,18185905,1801
"5327","ENSBTAG00000008703","11",19556770,19597286,40516
"5328","ENSBTAG00000008704","2",32625453,32751507,126054
"5329","ENSBTAG00000008705","24",33306982,33408139,101157
"5330","ENSBTAG00000008707","11",19605859,19621401,15542
"5331","ENSBTAG00000008708","12",65755349,66788079,1032730
"5332","ENSBTAG00000008709","15",18149364,18181340,31976
"5333","ENSBTAG00000008710","16",72205829,72642416,436587
"5334","ENSBTAG00000008711","3",120646406,120658685,12279
"5335","ENSBTAG00000008713","10",84446506,84481648,35142
"5336","ENSBTAG00000008714","1",128385395,128561717,176322
"5337","ENSBTAG00000008716","2",26545255,26554248,8993
"5338","ENSBTAG00000008717","2",112087760,112158159,70399
"5339","ENSBTAG00000008718","25",29133705,29563785,430080
"5340","ENSBTAG00000008719","22",47749990,47780548,30558
"5341","ENSBTAG00000008721","5",97454273,97478531,24258
"5342","ENSBTAG00000008723","24",58381338,58609120,227782
"5343","ENSBTAG00000008726","11",100490472,100534966,44494
"5344","ENSBTAG00000008728","25",12982380,13192989,210609
"5345","ENSBTAG00000008729","26",39291968,39309566,17598
"5346","ENSBTAG00000008730","26",39311749,39328281,16532
"5347","ENSBTAG00000008731","26",39330323,39339704,9381
"5348","ENSBTAG00000008732","15",20173026,20239566,66540
"5349","ENSBTAG00000008733","X",89426617,89433441,6824
"5350","ENSBTAG00000008734","16",3602521,3627653,25132
"5351","ENSBTAG00000008735","10",88017741,88039634,21893
"5352","ENSBTAG00000008736","4",111931201,112019196,87995
"5353","ENSBTAG00000008737","3",50084785,50106905,22120
"5354","ENSBTAG00000008739","16",51526682,51544095,17413
"5355","ENSBTAG00000008743","17",62300435,62326158,25723
"5356","ENSBTAG00000008744","19",36544867,36561186,16319
"5357","ENSBTAG00000008747","19",50873199,50876290,3091
"5358","ENSBTAG00000008752","7",49553095,49581666,28571
"5359","ENSBTAG00000008753","7",49592340,49612744,20404
"5360","ENSBTAG00000008755","2",36579472,36627161,47689
"5361","ENSBTAG00000008756","16",80502933,80507964,5031
"5362","ENSBTAG00000008758","7",49613257,49621657,8400
"5363","ENSBTAG00000008759","7",49612809,49642263,29454
"5364","ENSBTAG00000008761","17",62027374,62046790,19416
"5365","ENSBTAG00000008762","17",61854475,62022631,168156
"5366","ENSBTAG00000008763","X",11131719,11133673,1954
"5367","ENSBTAG00000008764","11",11220289,11232163,11874
"5368","ENSBTAG00000008765","11",11215589,11219819,4230
"5369","ENSBTAG00000008766","2",126090279,126142300,52021
"5370","ENSBTAG00000008771","10",62211057,62242057,31000
"5371","ENSBTAG00000008772","8",93707084,93754793,47709
"5372","ENSBTAG00000008773","19",27662514,27676988,14474
"5373","ENSBTAG00000008774","22",60462678,60490194,27516
"5374","ENSBTAG00000008777","18",46209080,46222026,12946
"5375","ENSBTAG00000008778","22",60452539,60459537,6998
"5376","ENSBTAG00000008779","19",27695196,27704006,8810
"5377","ENSBTAG00000008783","26",12388407,12476123,87716
"5378","ENSBTAG00000008787","13",29781616,29913709,132093
"5379","ENSBTAG00000008788","19",19943529,19967651,24122
"5380","ENSBTAG00000008789","7",20353044,20358586,5542
"5381","ENSBTAG00000008792","10",26370334,26371828,1494
"5382","ENSBTAG00000008793","10",26351238,26385111,33873
"5383","ENSBTAG00000008794","23",27254964,27264842,9878
"5384","ENSBTAG00000008797","6",19485468,19636025,150557
"5385","ENSBTAG00000008798","19",34536462,34556509,20047
"5386","ENSBTAG00000008800","2",125392642,125400258,7616
"5387","ENSBTAG00000008801","19",34524223,34536057,11834
"5388","ENSBTAG00000008802","19",34509785,34524187,14402
"5389","ENSBTAG00000008804","15",34402511,34426197,23686
"5390","ENSBTAG00000008805","10",46413154,46513245,100091
"5391","ENSBTAG00000008807","10",46401956,46408047,6091
"5392","ENSBTAG00000008808","3",100455525,100459138,3613
"5393","ENSBTAG00000008809","3",46655713,46739928,84215
"5394","ENSBTAG00000008810","3",100418895,100453755,34860
"5395","ENSBTAG00000008812","13",81632576,81644895,12319
"5396","ENSBTAG00000008814","27",33069925,33105995,36070
"5397","ENSBTAG00000008815","10",75839093,75886203,47110
"5398","ENSBTAG00000008816","17",4309174,4436986,127812
"5399","ENSBTAG00000008817","9",38176518,38331079,154561
"5400","ENSBTAG00000008819","26",42120732,42173400,52668
"5401","ENSBTAG00000008821","13",28007772,28034343,26571
"5402","ENSBTAG00000008825","13",38533190,38546652,13462
"5403","ENSBTAG00000008826","13",38548013,38555741,7728
"5404","ENSBTAG00000008827","28",28145189,28170447,25258
"5405","ENSBTAG00000008828","10",12270524,12311903,41379
"5406","ENSBTAG00000008832","19",15782652,15786668,4016
"5407","ENSBTAG00000008833","23",27641580,27643685,2105
"5408","ENSBTAG00000008835","23",27634037,27637429,3392
"5409","ENSBTAG00000008836","8",83428998,83435694,6696
"5410","ENSBTAG00000008837","23",27629798,27633927,4129
"5411","ENSBTAG00000008839","X",96120226,96146246,26020
"5412","ENSBTAG00000008840","13",61107684,61147486,39802
"5413","ENSBTAG00000008841","7",11726058,11735293,9235
"5414","ENSBTAG00000008842","14",37502881,37595533,92652
"5415","ENSBTAG00000008844","8",9980042,10017423,37381
"5416","ENSBTAG00000008845","8",9840507,9967280,126773
"5417","ENSBTAG00000008849","3",34036271,34100367,64096
"5418","ENSBTAG00000008851","18",57488548,57494764,6216
"5419","ENSBTAG00000008852","18",57462227,57469952,7725
"5420","ENSBTAG00000008853","28",13803801,13822395,18594
"5421","ENSBTAG00000008854","7",11690479,11725963,35484
"5422","ENSBTAG00000008857","5",109630804,109639001,8197
"5423","ENSBTAG00000008858","5",115343632,115382618,38986
"5424","ENSBTAG00000008860","18",35115259,35131417,16158
"5425","ENSBTAG00000008862","1",66151427,66215030,63603
"5426","ENSBTAG00000008863","10",37598861,37637423,38562
"5427","ENSBTAG00000008864","14",37240839,37273887,33048
"5428","ENSBTAG00000008866","10",37638467,37700215,61748
"5429","ENSBTAG00000008868","10",37711578,37766813,55235
"5430","ENSBTAG00000008869","25",36234803,36273129,38326
"5431","ENSBTAG00000008870","13",73470239,73476819,6580
"5432","ENSBTAG00000008871","20",23358630,23424574,65944
"5433","ENSBTAG00000008873","1",71404768,71410588,5820
"5434","ENSBTAG00000008876","20",3986718,3992285,5567
"5435","ENSBTAG00000008877","8",45576614,45814041,237427
"5436","ENSBTAG00000008880","12",79016634,79029810,13176
"5437","ENSBTAG00000008881","7",51298957,51302491,3534
"5438","ENSBTAG00000008883","19",17784942,17802679,17737
"5439","ENSBTAG00000008884","11",72609654,72665036,55382
"5440","ENSBTAG00000008886","27",14458809,14650043,191234
"5441","ENSBTAG00000008887","6",93645075,93677820,32745
"5442","ENSBTAG00000008888","12",34305327,34390737,85410
"5443","ENSBTAG00000008892","15",46837272,46838657,1385
"5444","ENSBTAG00000008893","22",15307495,15535485,227990
"5445","ENSBTAG00000008895","4",98321779,98353157,31378
"5446","ENSBTAG00000008896","6",44133877,44187907,54030
"5447","ENSBTAG00000008897","5",28477745,28515837,38092
"5448","ENSBTAG00000008898","3",115642951,115645047,2096
"5449","ENSBTAG00000008900","5",28460087,28474991,14904
"5450","ENSBTAG00000008902","18",47568721,47583658,14937
"5451","ENSBTAG00000008906","7",16476406,16477872,1466
"5452","ENSBTAG00000008908","13",42029073,42035720,6647
"5453","ENSBTAG00000008909","11",38307014,38347120,40106
"5454","ENSBTAG00000008910","5",75635774,75637042,1268
"5455","ENSBTAG00000008911","X",97041482,97180135,138653
"5456","ENSBTAG00000008913","19",17287825,17300526,12701
"5457","ENSBTAG00000008915","2",85946152,85984071,37919
"5458","ENSBTAG00000008916","7",68943176,69076275,133099
"5459","ENSBTAG00000008920","X",4930434,4951512,21078
"5460","ENSBTAG00000008921","3",66742753,66798302,55549
"5461","ENSBTAG00000008923","15",1393141,1407039,13898
"5462","ENSBTAG00000008924","12",12700984,12742850,41866
"5463","ENSBTAG00000008925","15",1437975,1508799,70824
"5464","ENSBTAG00000008926","3",66707375,66737434,30059
"5465","ENSBTAG00000008931","3",1148816,1160249,11433
"5466","ENSBTAG00000008932","18",62066756,62073582,6826
"5467","ENSBTAG00000008933","5",26757885,26760156,2271
"5468","ENSBTAG00000008934","5",26730162,26752001,21839
"5469","ENSBTAG00000008935","5",26724888,26729058,4170
"5470","ENSBTAG00000008936","26",20744151,20815377,71226
"5471","ENSBTAG00000008937","13",12875332,13197450,322118
"5472","ENSBTAG00000008938","13",66295099,66349583,54484
"5473","ENSBTAG00000008939","26",20825047,20942446,117399
"5474","ENSBTAG00000008940","19",52059956,52066350,6394
"5475","ENSBTAG00000008942","3",112609162,112657496,48334
"5476","ENSBTAG00000008943","23",30316678,30347409,30731
"5477","ENSBTAG00000008944","16",76188124,76401805,213681
"5478","ENSBTAG00000008945","17",61005835,61018993,13158
"5479","ENSBTAG00000008946","11",69068510,69144508,75998
"5480","ENSBTAG00000008947","6",2168490,2171062,2572
"5481","ENSBTAG00000008948","17",53970346,54027496,57150
"5482","ENSBTAG00000008950","27",23989210,24058110,68900
"5483","ENSBTAG00000008951","2",131181416,131245100,63684
"5484","ENSBTAG00000008952","2",131095681,131165889,70208
"5485","ENSBTAG00000008953","23",7177583,7186556,8973
"5486","ENSBTAG00000008954","23",7186813,7193342,6529
"5487","ENSBTAG00000008956","11",48044725,48064460,19735
"5488","ENSBTAG00000008958","14",24765312,24830983,65671
"5489","ENSBTAG00000008962","8",91113175,91120279,7104
"5490","ENSBTAG00000008963","17",55569766,55740689,170923
"5491","ENSBTAG00000008964","13",38600324,38679626,79302
"5492","ENSBTAG00000008966","X",104581073,104712744,131671
"5493","ENSBTAG00000008967","5",45157005,45200873,43868
"5494","ENSBTAG00000008969","13",77899042,77969755,70713
"5495","ENSBTAG00000008973","11",100031083,100036799,5716
"5496","ENSBTAG00000008977","23",15600547,15601893,1346
"5497","ENSBTAG00000008978","19",35124073,35142894,18821
"5498","ENSBTAG00000008981","23",15607998,15669922,61924
"5499","ENSBTAG00000008985","11",68411350,68430059,18709
"5500","ENSBTAG00000008987","11",29142823,29210949,68126
"5501","ENSBTAG00000008989","5",97342528,97440530,98002
"5502","ENSBTAG00000008990","17",70169984,70184876,14892
"5503","ENSBTAG00000008991","17",70189737,70228816,39079
"5504","ENSBTAG00000008993","NKLS02002208.1",9030869,9090163,59294
"5505","ENSBTAG00000008994","11",98472429,98497457,25028
"5506","ENSBTAG00000008996","17",70236410,70322746,86336
"5507","ENSBTAG00000008997","11",98497640,98529734,32094
"5508","ENSBTAG00000009002","4",115468572,115468919,347
"5509","ENSBTAG00000009006","17",70322367,70401301,78934
"5510","ENSBTAG00000009012","1",110158198,110164262,6064
"5511","ENSBTAG00000009014","1",63981593,64010650,29057
"5512","ENSBTAG00000009019","20",4104991,4223391,118400
"5513","ENSBTAG00000009020","11",18812764,19022665,209901
"5514","ENSBTAG00000009021","11",19023725,19068890,45165
"5515","ENSBTAG00000009022","25",33573623,33575091,1468
"5516","ENSBTAG00000009023","5",17943910,17981541,37631
"5517","ENSBTAG00000009024","X",87068162,87075215,7053
"5518","ENSBTAG00000009026","29",44153098,44302701,149603
"5519","ENSBTAG00000009029","19",53918897,53924904,6007
"5520","ENSBTAG00000009030","10",15849508,15888340,38832
"5521","ENSBTAG00000009032","29",50634390,50638626,4236
"5522","ENSBTAG00000009033","11",47540445,47545141,4696
"5523","ENSBTAG00000009034","7",21413767,21447278,33511
"5524","ENSBTAG00000009035","6",21674019,21756964,82945
"5525","ENSBTAG00000009036","19",20098012,20129719,31707
"5526","ENSBTAG00000009037","8",63854829,63887891,33062
"5527","ENSBTAG00000009042","3",33956341,33965040,8699
"5528","ENSBTAG00000009046","25",26197449,26201774,4325
"5529","ENSBTAG00000009047","25",26193135,26196515,3380
"5530","ENSBTAG00000009048","16",52057202,52075315,18113
"5531","ENSBTAG00000009049","5",57433437,57437847,4410
"5532","ENSBTAG00000009050","5",108180786,108225416,44630
"5533","ENSBTAG00000009051","5",57426768,57433048,6280
"5534","ENSBTAG00000009055","23",39178911,39266796,87885
"5535","ENSBTAG00000009057","2",71437172,71470213,33041
"5536","ENSBTAG00000009058","2",71480988,71482235,1247
"5537","ENSBTAG00000009059","6",14831302,14851254,19952
"5538","ENSBTAG00000009061","15",38992000,39068406,76406
"5539","ENSBTAG00000009062","3",92781366,92786271,4905
"5540","ENSBTAG00000009064","5",75349088,75370432,21344
"5541","ENSBTAG00000009065","9",74542301,74770948,228647
"5542","ENSBTAG00000009067","15",29361063,29392143,31080
"5543","ENSBTAG00000009070","6",87248937,87325253,76316
"5544","ENSBTAG00000009072","14",15178243,15192599,14356
"5545","ENSBTAG00000009075","16",47120164,47137199,17035
"5546","ENSBTAG00000009076","11",13623423,13744471,121048
"5547","ENSBTAG00000009077","18",50021789,50032620,10831
"5548","ENSBTAG00000009078","18",50035035,50036466,1431
"5549","ENSBTAG00000009079","18",50036378,50046767,10389
"5550","ENSBTAG00000009080","2",36097616,36247251,149635
"5551","ENSBTAG00000009084","1",57309120,57343709,34589
"5552","ENSBTAG00000009085","1",57343853,57364455,20602
"5553","ENSBTAG00000009086","21",34663151,34687592,24441
"5554","ENSBTAG00000009087","8",101081276,101087370,6094
"5555","ENSBTAG00000009091","16",63614243,63633749,19506
"5556","ENSBTAG00000009093","3",120816487,120819462,2975
"5557","ENSBTAG00000009097","21",20722980,20787646,64666
"5558","ENSBTAG00000009098","21",20787329,20803591,16262
"5559","ENSBTAG00000009099","25",26776309,26781350,5041
"5560","ENSBTAG00000009101","17",55140724,55175813,35089
"5561","ENSBTAG00000009103","7",70851229,70871248,20019
"5562","ENSBTAG00000009104","1",117598268,117600549,2281
"5563","ENSBTAG00000009105","7",18256064,18269611,13547
"5564","ENSBTAG00000009106","1",117556623,117597952,41329
"5565","ENSBTAG00000009107","19",52742477,52745844,3367
"5566","ENSBTAG00000009109","4",11886419,11939978,53559
"5567","ENSBTAG00000009110","17",18424476,18425159,683
"5568","ENSBTAG00000009111","16",2358407,2419458,61051
"5569","ENSBTAG00000009112","23",24893081,24957939,64858
"5570","ENSBTAG00000009115","1",127831477,127918128,86651
"5571","ENSBTAG00000009117","13",25851589,25853835,2246
"5572","ENSBTAG00000009121","X",8278461,8408287,129826
"5573","ENSBTAG00000009123","3",120743885,120760644,16759
"5574","ENSBTAG00000009124","29",28906683,28949563,42880
"5575","ENSBTAG00000009125","21",5629152,5670937,41785
"5576","ENSBTAG00000009126","19",26988948,26996169,7221
"5577","ENSBTAG00000009127","9",34447805,34451897,4092
"5578","ENSBTAG00000009128","1",35417574,35435629,18055
"5579","ENSBTAG00000009129","24",53691858,53715916,24058
"5580","ENSBTAG00000009131","7",94765526,94860268,94742
"5581","ENSBTAG00000009132","1",141713171,141747814,34643
"5582","ENSBTAG00000009137","18",57439866,57442638,2772
"5583","ENSBTAG00000009138","14",24587138,24624435,37297
"5584","ENSBTAG00000009139","24",43310126,43477563,167437
"5585","ENSBTAG00000009141","24",43485957,43500220,14263
"5586","ENSBTAG00000009142","24",43500371,43525419,25048
"5587","ENSBTAG00000009143","24",43542193,43543170,977
"5588","ENSBTAG00000009144","13",62503682,62514220,10538
"5589","ENSBTAG00000009145","17",72369764,72376047,6283
"5590","ENSBTAG00000009148","3",1675900,1728605,52705
"5591","ENSBTAG00000009150","15",38457984,38773001,315017
"5592","ENSBTAG00000009151","10",54810099,54830804,20705
"5593","ENSBTAG00000009152","23",31199273,31208024,8751
"5594","ENSBTAG00000009153","25",33613971,33632441,18470
"5595","ENSBTAG00000009154","1",125961513,125987011,25498
"5596","ENSBTAG00000009155","22",11975410,12063392,87982
"5597","ENSBTAG00000009156","2",132136807,132139923,3116
"5598","ENSBTAG00000009157","23",47158325,47179853,21528
"5599","ENSBTAG00000009159","22",60240226,60280068,39842
"5600","ENSBTAG00000009163","2",121306084,121311470,5386
"5601","ENSBTAG00000009165","13",69973201,69990650,17449
"5602","ENSBTAG00000009166","12",32211463,32212710,1247
"5603","ENSBTAG00000009167","17",48308901,48338170,29269
"5604","ENSBTAG00000009169","16",61818973,62021433,202460
"5605","ENSBTAG00000009171","18",61180951,61189526,8575
"5606","ENSBTAG00000009172","18",55411775,55425141,13366
"5607","ENSBTAG00000009174","18",55427042,55447503,20461
"5608","ENSBTAG00000009175","29",45320952,45327925,6973
"5609","ENSBTAG00000009176","15",1508947,1526908,17961
"5610","ENSBTAG00000009177","18",55447604,55471328,23724
"5611","ENSBTAG00000009178","7",16482854,16491641,8787
"5612","ENSBTAG00000009180","23",33501350,33521750,20400
"5613","ENSBTAG00000009181","26",50937626,51083088,145462
"5614","ENSBTAG00000009182","4",106700966,106738430,37464
"5615","ENSBTAG00000009183","22",51371186,51399168,27982
"5616","ENSBTAG00000009186","21",46860164,46877480,17316
"5617","ENSBTAG00000009187","1",2028900,2030042,1142
"5618","ENSBTAG00000009188","1",1985522,2012383,26861
"5619","ENSBTAG00000009190","19",26983928,26990339,6411
"5620","ENSBTAG00000009191","27",21352772,21570464,217692
"5621","ENSBTAG00000009192","3",98066623,98090010,23387
"5622","ENSBTAG00000009194","22",6157369,6498868,341499
"5623","ENSBTAG00000009198","X",128217622,128246226,28604
"5624","ENSBTAG00000009199","25",3497842,3504227,6385
"5625","ENSBTAG00000009200","25",3504908,3508444,3536
"5626","ENSBTAG00000009201","25",3512064,3566042,53978
"5627","ENSBTAG00000009206","13",61378626,61379933,1307
"5628","ENSBTAG00000009207","4",46202241,46292635,90394
"5629","ENSBTAG00000009208","17",54477625,54505524,27899
"5630","ENSBTAG00000009209","3",97468115,97518125,50010
"5631","ENSBTAG00000009210","29",36408247,36429241,20994
"5632","ENSBTAG00000009211","18",62089250,62093134,3884
"5633","ENSBTAG00000009212","3",8282869,8284122,1253
"5634","ENSBTAG00000009213","3",8275799,8280141,4342
"5635","ENSBTAG00000009214","1",151161814,151181631,19817
"5636","ENSBTAG00000009215","3",8271660,8276977,5317
"5637","ENSBTAG00000009216","17",54505222,54531025,25803
"5638","ENSBTAG00000009217","2",106842324,106855593,13269
"5639","ENSBTAG00000009218","4",60772368,60825953,53585
"5640","ENSBTAG00000009219","1",33714841,34095244,380403
"5641","ENSBTAG00000009220","22",31499577,31502975,3398
"5642","ENSBTAG00000009223","2",126340193,126341536,1343
"5643","ENSBTAG00000009226","23",9192525,9224847,32322
"5644","ENSBTAG00000009228","19",55592401,55617440,25039
"5645","ENSBTAG00000009230","11",245530,303203,57673
"5646","ENSBTAG00000009231","X",35133537,35159670,26133
"5647","ENSBTAG00000009232","1",87879574,87964195,84621
"5648","ENSBTAG00000009235","1",87793359,87870663,77304
"5649","ENSBTAG00000009236","25",38297751,38321662,23911
"5650","ENSBTAG00000009237","25",38325866,38342141,16275
"5651","ENSBTAG00000009238","5",26002104,26016051,13947
"5652","ENSBTAG00000009239","9",39168422,39281019,112597
"5653","ENSBTAG00000009242","11",13156084,13246782,90698
"5654","ENSBTAG00000009243","9",39141791,39148316,6525
"5655","ENSBTAG00000009245","27",26900099,26924571,24472
"5656","ENSBTAG00000009246","11",14665931,14678497,12566
"5657","ENSBTAG00000009249","10",8755491,8765137,9646
"5658","ENSBTAG00000009251","2",135738977,135759581,20604
"5659","ENSBTAG00000009252","5",98969137,98984165,15028
"5660","ENSBTAG00000009254","4",64817186,64906352,89166
"5661","ENSBTAG00000009256","2",15083908,15176065,92157
"5662","ENSBTAG00000009257","2",14945329,15081254,135925
"5663","ENSBTAG00000009258","1",138565353,138835292,269939
"5664","ENSBTAG00000009260","X",129564690,129724677,159987
"5665","ENSBTAG00000009263","1",108706429,108732991,26562
"5666","ENSBTAG00000009265","16",78828931,78957232,128301
"5667","ENSBTAG00000009266","24",7301497,7359786,58289
"5668","ENSBTAG00000009267","23",8810255,8882363,72108
"5669","ENSBTAG00000009269","3",108832486,109076297,243811
"5670","ENSBTAG00000009271","10",85120765,85123417,2652
"5671","ENSBTAG00000009272","10",85127443,85158072,30629
"5672","ENSBTAG00000009273","7",42821634,42822967,1333
"5673","ENSBTAG00000009275","9",89904124,89918662,14538
"5674","ENSBTAG00000009277","9",89926480,90024105,97625
"5675","ENSBTAG00000009278","X",131750626,131766122,15496
"5676","ENSBTAG00000009279","26",13347972,13411176,63204
"5677","ENSBTAG00000009281","5",56893433,56925355,31922
"5678","ENSBTAG00000009282","X",86646281,86656868,10587
"5679","ENSBTAG00000009284","5",56910794,56923321,12527
"5680","ENSBTAG00000009286","18",54113875,54149783,35908
"5681","ENSBTAG00000009287","X",86657890,86662101,4211
"5682","ENSBTAG00000009288","X",86664669,86678020,13351
"5683","ENSBTAG00000009289","29",37057599,37073704,16105
"5684","ENSBTAG00000009290","11",60430455,60435346,4891
"5685","ENSBTAG00000009291","13",39635309,39875499,240190
"5686","ENSBTAG00000009292","19",6030318,6033208,2890
"5687","ENSBTAG00000009293","21",64912163,65089676,177513
"5688","ENSBTAG00000009294","21",65091255,65110055,18800
"5689","ENSBTAG00000009296","4",44588731,44624862,36131
"5690","ENSBTAG00000009297","5",119546564,119553230,6666
"5691","ENSBTAG00000009298","19",36309593,36329783,20190
"5692","ENSBTAG00000009299","11",62957397,62996669,39272
"5693","ENSBTAG00000009302","23",19452882,19685336,232454
"5694","ENSBTAG00000009304","18",43083766,43090571,6805
"5695","ENSBTAG00000009305","18",43093120,43153635,60515
"5696","ENSBTAG00000009306","16",50453092,50502162,49070
"5697","ENSBTAG00000009307","16",50442765,50452928,10163
"5698","ENSBTAG00000009308","12",1586960,1813642,226682
"5699","ENSBTAG00000009309","16",50437154,50442749,5595
"5700","ENSBTAG00000009310","6",86071697,86073121,1424
"5701","ENSBTAG00000009314","3",89336374,89464197,127823
"5702","ENSBTAG00000009315","29",29322677,29419487,96810
"5703","ENSBTAG00000009327","25",27581047,27611278,30231
"5704","ENSBTAG00000009328","7",6235790,6318228,82438
"5705","ENSBTAG00000009330","7",6181303,6224656,43353
"5706","ENSBTAG00000009331","7",6073318,6174087,100769
"5707","ENSBTAG00000009332","19",37730040,37765778,35738
"5708","ENSBTAG00000009334","4",87871092,87887305,16213
"5709","ENSBTAG00000009336","1",108867031,108874756,7725
"5710","ENSBTAG00000009337","18",53647296,53651181,3885
"5711","ENSBTAG00000009338","3",75039363,75644478,605115
"5712","ENSBTAG00000009340","12",30478919,30533274,54355
"5713","ENSBTAG00000009341","4",43916446,44057818,141372
"5714","ENSBTAG00000009343","11",67828491,67990881,162390
"5715","ENSBTAG00000009345","19",61889073,61897305,8232
"5716","ENSBTAG00000009346","17",62254596,62288021,33425
"5717","ENSBTAG00000009348","28",28915123,28942806,27683
"5718","ENSBTAG00000009349","16",50271751,50306501,34750
"5719","ENSBTAG00000009350","28",28944315,28963077,18762
"5720","ENSBTAG00000009351","5",116028707,116169393,140686
"5721","ENSBTAG00000009353","19",18674661,18683264,8603
"5722","ENSBTAG00000009354","19",18667321,18671399,4078
"5723","ENSBTAG00000009355","9",23477795,23642456,164661
"5724","ENSBTAG00000009357","18",1510170,1570878,60708
"5725","ENSBTAG00000009358","18",1488986,1508027,19041
"5726","ENSBTAG00000009359","15",38342903,38343841,938
"5727","ENSBTAG00000009362","9",89115405,89174252,58847
"5728","ENSBTAG00000009363","18",26198116,26204583,6467
"5729","ENSBTAG00000009364","18",61300943,61306285,5342
"5730","ENSBTAG00000009366","4",91819098,91822148,3050
"5731","ENSBTAG00000009368","3",107121920,107136338,14418
"5732","ENSBTAG00000009371","22",50812881,50840894,28013
"5733","ENSBTAG00000009372","10",26806108,26822454,16346
"5734","ENSBTAG00000009374","10",26764162,26778356,14194
"5735","ENSBTAG00000009376","19",23055699,23065906,10207
"5736","ENSBTAG00000009378","14",77397439,77402800,5361
"5737","ENSBTAG00000009381","20",2132959,2179242,46283
"5738","ENSBTAG00000009382","18",57016373,57026711,10338
"5739","ENSBTAG00000009383","26",14004835,14050631,45796
"5740","ENSBTAG00000009384","16",41927836,41947957,20121
"5741","ENSBTAG00000009387","27",1452466,1516585,64119
"5742","ENSBTAG00000009389","7",1694637,1703639,9002
"5743","ENSBTAG00000009390","4",65467521,65585947,118426
"5744","ENSBTAG00000009391","1",64334745,64377235,42490
"5745","ENSBTAG00000009393","29",46104267,46110100,5833
"5746","ENSBTAG00000009394","14",14849669,15081008,231339
"5747","ENSBTAG00000009396","16",34954133,35000907,46774
"5748","ENSBTAG00000009400","20",65343172,65354775,11603
"5749","ENSBTAG00000009401","20",65311530,65343117,31587
"5750","ENSBTAG00000009405","12",23965261,24172034,206773
"5751","ENSBTAG00000009407","19",35512988,35577544,64556
"5752","ENSBTAG00000009410","29",28100116,28111910,11794
"5753","ENSBTAG00000009412","29",28116611,28154372,37761
"5754","ENSBTAG00000009414","18",49488651,49500160,11509
"5755","ENSBTAG00000009415","12",15118007,15157140,39133
"5756","ENSBTAG00000009416","12",15157211,15188941,31730
"5757","ENSBTAG00000009417","8",48589473,48599969,10496
"5758","ENSBTAG00000009418","4",106740881,106749085,8204
"5759","ENSBTAG00000009419","15",30684847,30712927,28080
"5760","ENSBTAG00000009420","X",125069882,125191027,121145
"5761","ENSBTAG00000009421","3",11606607,11610099,3492
"5762","ENSBTAG00000009423","6",66702049,66744153,42104
"5763","ENSBTAG00000009426","4",112024328,112069782,45454
"5764","ENSBTAG00000009427","19",12299125,12359979,60854
"5765","ENSBTAG00000009428","18",7948139,7992806,44667
"5766","ENSBTAG00000009430","22",12922611,13149096,226485
"5767","ENSBTAG00000009431","3",14575798,14592765,16967
"5768","ENSBTAG00000009432","3",14553830,14575605,21775
"5769","ENSBTAG00000009433","3",14551207,14552260,1053
"5770","ENSBTAG00000009434","3",14546206,14551083,4877
"5771","ENSBTAG00000009435","3",14517240,14544995,27755
"5772","ENSBTAG00000009436","3",14509511,14515615,6104
"5773","ENSBTAG00000009438","6",80837085,81239941,402856
"5774","ENSBTAG00000009439","26",45252613,45286513,33900
"5775","ENSBTAG00000009441","25",22201433,22235455,34022
"5776","ENSBTAG00000009443","10",50634343,50639462,5119
"5777","ENSBTAG00000009444","5",93602194,93699192,96998
"5778","ENSBTAG00000009446","18",10870728,10933879,63151
"5779","ENSBTAG00000009447","5",106319032,106389988,70956
"5780","ENSBTAG00000009449","18",50566982,50572796,5814
"5781","ENSBTAG00000009451","10",86610233,86655611,45378
"5782","ENSBTAG00000009453","22",237365,268228,30863
"5783","ENSBTAG00000009455","3",77948658,78035575,86917
"5784","ENSBTAG00000009457","X",54017227,54018538,1311
"5785","ENSBTAG00000009458","19",46867505,46878724,11219
"5786","ENSBTAG00000009459","24",41135878,41248489,112611
"5787","ENSBTAG00000009460","18",64754096,64764864,10768
"5788","ENSBTAG00000009461","25",34222298,34254742,32444
"5789","ENSBTAG00000009462","25",34254236,34266939,12703
"5790","ENSBTAG00000009468","20",14767974,14790737,22763
"5791","ENSBTAG00000009469","20",14726021,14761956,35935
"5792","ENSBTAG00000009470","2",128114762,128188876,74114
"5793","ENSBTAG00000009471","6",71357447,71431834,74387
"5794","ENSBTAG00000009472","4",78136885,78147222,10337
"5795","ENSBTAG00000009475","13",21312388,21747796,435408
"5796","ENSBTAG00000009476","X",128109102,128155599,46497
"5797","ENSBTAG00000009477","X",128010530,128108753,98223
"5798","ENSBTAG00000009478","7",44442457,44445396,2939
"5799","ENSBTAG00000009479","7",44447301,44448594,1293
"5800","ENSBTAG00000009481","3",85704934,85786712,81778
"5801","ENSBTAG00000009482","7",44460187,44540470,80283
"5802","ENSBTAG00000009483","29",41079651,41082911,3260
"5803","ENSBTAG00000009484","29",41086051,41095958,9907
"5804","ENSBTAG00000009486","29",41095872,41098075,2203
"5805","ENSBTAG00000009487","29",41098173,41099727,1554
"5806","ENSBTAG00000009488","29",41099002,41111085,12083
"5807","ENSBTAG00000009489","22",49872343,49986489,114146
"5808","ENSBTAG00000009490","29",41111844,41140757,28913
"5809","ENSBTAG00000009491","29",41141424,41149376,7952
"5810","ENSBTAG00000009493","18",52519991,52529588,9597
"5811","ENSBTAG00000009494","18",52541136,52556926,15790
"5812","ENSBTAG00000009495","18",52562406,52574348,11942
"5813","ENSBTAG00000009496","19",42395221,42416545,21324
"5814","ENSBTAG00000009498","26",9466271,9564180,97909
"5815","ENSBTAG00000009500","2",129770258,129836290,66032
"5816","ENSBTAG00000009501","27",16269302,16290089,20787
"5817","ENSBTAG00000009502","2",129672631,129764693,92062
"5818","ENSBTAG00000009504","8",69452228,69456335,4107
"5819","ENSBTAG00000009506","5",113024569,113032754,8185
"5820","ENSBTAG00000009507","5",113035565,113040617,5052
"5821","ENSBTAG00000009508","5",113040978,113044677,3699
"5822","ENSBTAG00000009509","5",113045844,113056944,11100
"5823","ENSBTAG00000009510","11",2253295,2254638,1343
"5824","ENSBTAG00000009512","18",62310784,62323676,12892
"5825","ENSBTAG00000009513","7",47430704,47501496,70792
"5826","ENSBTAG00000009514","20",13977037,13999640,22603
"5827","ENSBTAG00000009515","16",44440378,44472484,32106
"5828","ENSBTAG00000009516","8",91277019,91302491,25472
"5829","ENSBTAG00000009517","2",71192388,71197568,5180
"5830","ENSBTAG00000009518","15",73974959,74018861,43902
"5831","ENSBTAG00000009519","20",13938790,13972833,34043
"5832","ENSBTAG00000009520","4",76174089,76273756,99667
"5833","ENSBTAG00000009521","18",46829855,46855871,26016
"5834","ENSBTAG00000009522","6",25667167,25705748,38581
"5835","ENSBTAG00000009523","NKLS02002208.1",8850651,8902731,52080
"5836","ENSBTAG00000009526","3",92177759,92203031,25272
"5837","ENSBTAG00000009527","3",92133467,92177725,44258
"5838","ENSBTAG00000009533","25",1507603,1517204,9601
"5839","ENSBTAG00000009534","25",1516192,1519337,3145
"5840","ENSBTAG00000009535","25",1519510,1522512,3002
"5841","ENSBTAG00000009537","5",99887314,99899431,12117
"5842","ENSBTAG00000009539","14",41618101,41623935,5834
"5843","ENSBTAG00000009541","22",33859633,34134874,275241
"5844","ENSBTAG00000009542","5",57197914,57205232,7318
"5845","ENSBTAG00000009543","5",57179946,57194004,14058
"5846","ENSBTAG00000009545","X",124612332,124741081,128749
"5847","ENSBTAG00000009547","25",38409174,38417978,8804
"5848","ENSBTAG00000009548","23",17158204,17162867,4663
"5849","ENSBTAG00000009549","23",17164825,17177978,13153
"5850","ENSBTAG00000009552","5",19476824,19607517,130693
"5851","ENSBTAG00000009554","29",43758719,43774081,15362
"5852","ENSBTAG00000009558","4",106120040,106121757,1717
"5853","ENSBTAG00000009560","25",9439671,9457900,18229
"5854","ENSBTAG00000009562","2",126929533,126930613,1080
"5855","ENSBTAG00000009565","7",86925623,87036828,111205
"5856","ENSBTAG00000009566","7",87037413,87067897,30484
"5857","ENSBTAG00000009568","7",15601585,15628102,26517
"5858","ENSBTAG00000009569","7",15628759,15676178,47419
"5859","ENSBTAG00000009570","7",15656227,15660222,3995
"5860","ENSBTAG00000009573","15",76852552,77063224,210672
"5861","ENSBTAG00000009574","15",77063167,77075217,12050
"5862","ENSBTAG00000009575","9",29816336,30021574,205238
"5863","ENSBTAG00000009576","15",77074376,77083628,9252
"5864","ENSBTAG00000009578","14",2844134,3037063,192929
"5865","ENSBTAG00000009579","2",126841741,126876537,34796
"5866","ENSBTAG00000009580","2",126837552,126839005,1453
"5867","ENSBTAG00000009581","2",126814237,126836894,22657
"5868","ENSBTAG00000009583","9",96368072,96400188,32116
"5869","ENSBTAG00000009584","29",45936791,46061309,124518
"5870","ENSBTAG00000009585","18",34613338,34623316,9978
"5871","ENSBTAG00000009586","22",51693533,51717133,23600
"5872","ENSBTAG00000009587","28",36896430,38132186,1235756
"5873","ENSBTAG00000009595","10",21461584,21468818,7234
"5874","ENSBTAG00000009596","8",102659520,102676450,16930
"5875","ENSBTAG00000009598","X",66151879,66401668,249789
"5876","ENSBTAG00000009599","11",105841421,105854755,13334
"5877","ENSBTAG00000009600","11",10793276,10817432,24156
"5878","ENSBTAG00000009602","17",53521439,53567583,46144
"5879","ENSBTAG00000009603","3",99790133,99799010,8877
"5880","ENSBTAG00000009607","15",75950774,75956775,6001
"5881","ENSBTAG00000009611","15",75955555,76148892,193337
"5882","ENSBTAG00000009614","1",71155752,71182955,27203
"5883","ENSBTAG00000009615","10",49800140,49844615,44475
"5884","ENSBTAG00000009617","3",103309039,103337423,28384
"5885","ENSBTAG00000009618","16",71773296,71785719,12423
"5886","ENSBTAG00000009620","9",103347250,103470312,123062
"5887","ENSBTAG00000009624","5",111705767,111739844,34077
"5888","ENSBTAG00000009625","3",99618092,99623713,5621
"5889","ENSBTAG00000009631","2",126764040,126771731,7691
"5890","ENSBTAG00000009632","6",12971034,12982948,11914
"5891","ENSBTAG00000009634","5",25997501,26000142,2641
"5892","ENSBTAG00000009635","19",14132719,14165335,32616
"5893","ENSBTAG00000009636","18",35672589,35680832,8243
"5894","ENSBTAG00000009637","7",25761272,25853058,91786
"5895","ENSBTAG00000009638","18",35680939,35721145,40206
"5896","ENSBTAG00000009639","18",35723889,35805738,81849
"5897","ENSBTAG00000009641","10",76546544,76607077,60533
"5898","ENSBTAG00000009642","10",76615143,76616429,1286
"5899","ENSBTAG00000009643","10",76614722,76648488,33766
"5900","ENSBTAG00000009646","7",27282164,27326576,44412
"5901","ENSBTAG00000009647","7",27265901,27278334,12433
"5902","ENSBTAG00000009649","11",73094992,73133466,38474
"5903","ENSBTAG00000009650","11",73006439,73094548,88109
"5904","ENSBTAG00000009653","21",60515459,60519098,3639
"5905","ENSBTAG00000009654","8",100355969,100518129,162160
"5906","ENSBTAG00000009655","4",74779686,74996283,216597
"5907","ENSBTAG00000009656","23",25583083,25589209,6126
"5908","ENSBTAG00000009657","X",33366140,33426037,59897
"5909","ENSBTAG00000009658","11",66786975,66814889,27914
"5910","ENSBTAG00000009661","7",12722227,12730155,7928
"5911","ENSBTAG00000009663","5",98853392,98878560,25168
"5912","ENSBTAG00000009664","2",118237531,118282557,45026
"5913","ENSBTAG00000009665","9",81658039,82206913,548874
"5914","ENSBTAG00000009667","7",109738260,109760966,22706
"5915","ENSBTAG00000009668","5",109974528,110024787,50259
"5916","ENSBTAG00000009673","6",21861338,21928497,67159
"5917","ENSBTAG00000009674","3",95140835,95186049,45214
"5918","ENSBTAG00000009676","3",120612526,120622330,9804
"5919","ENSBTAG00000009677","14",832766,839743,6977
"5920","ENSBTAG00000009679","9",87781650,87966376,184726
"5921","ENSBTAG00000009680","21",45352820,45368962,16142
"5922","ENSBTAG00000009681","21",45369633,45395367,25734
"5923","ENSBTAG00000009682","21",45395271,45527537,132266
"5924","ENSBTAG00000009683","21",45548878,45572660,23782
"5925","ENSBTAG00000009685","27",25061504,25078428,16924
"5926","ENSBTAG00000009686","24",4244211,4281871,37660
"5927","ENSBTAG00000009687","24",4237235,4243236,6001
"5928","ENSBTAG00000009689","9",34136380,34154113,17733
"5929","ENSBTAG00000009691","25",34677729,34702221,24492
"5930","ENSBTAG00000009693","26",15899097,15996458,97361
"5931","ENSBTAG00000009694","11",43674599,43760004,85405
"5932","ENSBTAG00000009696","28",9321730,9403358,81628
"5933","ENSBTAG00000009698","3",48980774,49070167,89393
"5934","ENSBTAG00000009701","10",21548273,21550846,2573
"5935","ENSBTAG00000009702","19",29403330,29433093,29763
"5936","ENSBTAG00000009703","10",21490410,21510517,20107
"5937","ENSBTAG00000009704","5",108937842,109051118,113276
"5938","ENSBTAG00000009705","19",22848049,22859852,11803
"5939","ENSBTAG00000009707","2",98099886,98125989,26103
"5940","ENSBTAG00000009708","19",22860572,22898946,38374
"5941","ENSBTAG00000009709","26",23967689,23982420,14731
"5942","ENSBTAG00000009711","19",22899633,22946071,46438
"5943","ENSBTAG00000009713","26",23982416,23987702,5286
"5944","ENSBTAG00000009714","18",46487531,46500286,12755
"5945","ENSBTAG00000009715","26",23987873,24030564,42691
"5946","ENSBTAG00000009717","4",44000211,44004848,4637
"5947","ENSBTAG00000009719","26",24030504,24035854,5350
"5948","ENSBTAG00000009725","2",89102213,89173911,71698
"5949","ENSBTAG00000009726","16",79889001,79911514,22513
"5950","ENSBTAG00000009727","16",79870488,79883989,13501
"5951","ENSBTAG00000009732","8",62840870,62878151,37281
"5952","ENSBTAG00000009733","8",81068225,81099411,31186
"5953","ENSBTAG00000009734","8",62878687,62908594,29907
"5954","ENSBTAG00000009735","18",65641089,65646101,5012
"5955","ENSBTAG00000009736","29",43058767,43077323,18556
"5956","ENSBTAG00000009737","7",1519314,1522229,2915
"5957","ENSBTAG00000009738","7",1507472,1518038,10566
"5958","ENSBTAG00000009739","27",2152161,2922753,770592
"5959","ENSBTAG00000009742","6",115390539,115424342,33803
"5960","ENSBTAG00000009743","13",61464644,61471874,7230
"5961","ENSBTAG00000009744","6",116021091,116168611,147520
"5962","ENSBTAG00000009746","18",8717274,8729011,11737
"5963","ENSBTAG00000009747","19",10882985,10893524,10539
"5964","ENSBTAG00000009748","15",29922657,29927990,5333
"5965","ENSBTAG00000009749","15",29936983,29958822,21839
"5966","ENSBTAG00000009750","7",20206334,20209157,2823
"5967","ENSBTAG00000009752","7",17903865,17908687,4822
"5968","ENSBTAG00000009755","17",44423383,44470280,46897
"5969","ENSBTAG00000009757","22",12684159,12710177,26018
"5970","ENSBTAG00000009760","22",12663090,12681670,18580
"5971","ENSBTAG00000009761","11",63594845,63632511,37666
"5972","ENSBTAG00000009762","18",34194553,34232732,38179
"5973","ENSBTAG00000009765","22",17007959,17052505,44546
"5974","ENSBTAG00000009768","26",11043454,11054461,11007
"5975","ENSBTAG00000009770","2",39653910,39803015,149105
"5976","ENSBTAG00000009772","7",96536559,96592167,55608
"5977","ENSBTAG00000009773","17",68432890,68476866,43976
"5978","ENSBTAG00000009774","22",12723390,12756307,32917
"5979","ENSBTAG00000009775","X",34175338,34181029,5691
"5980","ENSBTAG00000009777","2",13426631,13458918,32287
"5981","ENSBTAG00000009778","5",84749225,84789041,39816
"5982","ENSBTAG00000009780","25",32782209,32863447,81238
"5983","ENSBTAG00000009783","10",85070695,85074051,3356
"5984","ENSBTAG00000009784","9",83832388,83864091,31703
"5985","ENSBTAG00000009785","18",49050030,49085221,35191
"5986","ENSBTAG00000009786","4",20624426,20703669,79243
"5987","ENSBTAG00000009788","10",85013824,85030876,17052
"5988","ENSBTAG00000009789","8",53685832,53996400,310568
"5989","ENSBTAG00000009795","9",81491291,81491963,672
"5990","ENSBTAG00000009796","2",126392028,126402241,10213
"5991","ENSBTAG00000009797","17",46406767,46715519,308752
"5992","ENSBTAG00000009798","23",33335556,33479705,144149
"5993","ENSBTAG00000009800","17",62661593,62686348,24755
"5994","ENSBTAG00000009803","7",38091557,38100473,8916
"5995","ENSBTAG00000009804","8",65039577,65136740,97163
"5996","ENSBTAG00000009805","18",2734037,2753088,19051
"5997","ENSBTAG00000009806","8",65135948,65273530,137582
"5998","ENSBTAG00000009811","14",634453,652447,17994
"5999","ENSBTAG00000009812","6",88897012,88899124,2112
"6000","ENSBTAG00000009816","14",646600,648020,1420
"6001","ENSBTAG00000009819","3",102655232,102659704,4472
"6002","ENSBTAG00000009822","24",41652235,41701148,48913
"6003","ENSBTAG00000009823","4",86627249,86627801,552
"6004","ENSBTAG00000009824","17",29365401,29365658,257
"6005","ENSBTAG00000009826","22",6593877,6690914,97037
"6006","ENSBTAG00000009828","15",28480087,28485276,5189
"6007","ENSBTAG00000009830","15",53117190,53136353,19163
"6008","ENSBTAG00000009831","2",442135,705205,263070
"6009","ENSBTAG00000009832","4",107667095,107672444,5349
"6010","ENSBTAG00000009833","6",55680843,55762662,81819
"6011","ENSBTAG00000009835","19",36102387,36164028,61641
"6012","ENSBTAG00000009836","21",57571704,57585058,13354
"6013","ENSBTAG00000009837","25",19058918,19070775,11857
"6014","ENSBTAG00000009838","16",21737328,21791045,53717
"6015","ENSBTAG00000009839","4",106651014,106656121,5107
"6016","ENSBTAG00000009840","25",36502754,36503777,1023
"6017","ENSBTAG00000009841","24",4001720,4015956,14236
"6018","ENSBTAG00000009842","25",19074616,19098173,23557
"6019","ENSBTAG00000009844","3",58488378,58491302,2924
"6020","ENSBTAG00000009845","21",57589349,57752955,163606
"6021","ENSBTAG00000009846","9",87978427,88160303,181876
"6022","ENSBTAG00000009848","1",116891760,116898285,6525
"6023","ENSBTAG00000009849","6",97946767,97980661,33894
"6024","ENSBTAG00000009850","4",112898193,112907030,8837
"6025","ENSBTAG00000009851","1",26116520,26265576,149056
"6026","ENSBTAG00000009852","5",7300922,7681263,380341
"6027","ENSBTAG00000009854","21",27396948,27409258,12310
"6028","ENSBTAG00000009855","21",27412384,27435334,22950
"6029","ENSBTAG00000009856","16",51215231,51229547,14316
"6030","ENSBTAG00000009861","23",15583411,15599481,16070
"6031","ENSBTAG00000009862","10",69824307,69853174,28867
"6032","ENSBTAG00000009863","22",21400624,21406265,5641
"6033","ENSBTAG00000009864","19",37392145,37431777,39632
"6034","ENSBTAG00000009867","4",92695804,92711399,15595
"6035","ENSBTAG00000009868","25",35574908,35576764,1856
"6036","ENSBTAG00000009871","13",36998687,37026824,28137
"6037","ENSBTAG00000009872","18",55265305,55272144,6839
"6038","ENSBTAG00000009873","23",48986030,48994863,8833
"6039","ENSBTAG00000009874","22",60496359,60517368,21009
"6040","ENSBTAG00000009876","16",4932453,4979207,46754
"6041","ENSBTAG00000009877","26",39948291,39986119,37828
"6042","ENSBTAG00000009879","26",23907893,23939589,31696
"6043","ENSBTAG00000009881","13",42738786,42757351,18565
"6044","ENSBTAG00000009885","19",47901885,47908689,6804
"6045","ENSBTAG00000009886","5",110148627,110161850,13223
"6046","ENSBTAG00000009887","5",110161867,110180391,18524
"6047","ENSBTAG00000009888","3",32272397,32300821,28424
"6048","ENSBTAG00000009889","18",45508663,45573584,64921
"6049","ENSBTAG00000009894","21",58912813,58923393,10580
"6050","ENSBTAG00000009895","18",45515132,45556175,41043
"6051","ENSBTAG00000009897","2",19341272,19468765,127493
"6052","ENSBTAG00000009899","29",50492678,50515464,22786
"6053","ENSBTAG00000009902","4",98115288,98132148,16860
"6054","ENSBTAG00000009903","8",82098120,82161357,63237
"6055","ENSBTAG00000009904","5",65323700,65337081,13381
"6056","ENSBTAG00000009905","23",14998801,15022870,24069
"6057","ENSBTAG00000009906","11",82677576,82717290,39714
"6058","ENSBTAG00000009907","24",50107770,50281083,173313
"6059","ENSBTAG00000009908","17",6717402,6722090,4688
"6060","ENSBTAG00000009911","10",59982866,60004776,21910
"6061","ENSBTAG00000009912","12",31834570,31957265,122695
"6062","ENSBTAG00000009913","5",115685923,115694504,8581
"6063","ENSBTAG00000009914","20",70839103,70844383,5280
"6064","ENSBTAG00000009915","29",50416807,50488031,71224
"6065","ENSBTAG00000009916","14",16424755,16442926,18171
"6066","ENSBTAG00000009917","8",44808121,45153937,345816
"6067","ENSBTAG00000009918","18",11409193,11645115,235922
"6068","ENSBTAG00000009923","10",88298760,88314446,15686
"6069","ENSBTAG00000009924","16",62161304,62187092,25788
"6070","ENSBTAG00000009928","25",1736264,1740142,3878
"6071","ENSBTAG00000009933","1",66988057,66996322,8265
"6072","ENSBTAG00000009938","16",36163970,36167373,3403
"6073","ENSBTAG00000009939","5",46494871,46529168,34297
"6074","ENSBTAG00000009941","21",46488245,46507168,18923
"6075","ENSBTAG00000009942","1",153882096,154095595,213499
"6076","ENSBTAG00000009943","16",36150525,36154203,3678
"6077","ENSBTAG00000009945","25",1739999,1741537,1538
"6078","ENSBTAG00000009948","19",7676446,7737220,60774
"6079","ENSBTAG00000009949","2",61390060,61455629,65569
"6080","ENSBTAG00000009950","2",110369553,110471285,101732
"6081","ENSBTAG00000009951","25",1742546,1745400,2854
"6082","ENSBTAG00000009952","2",88480800,88492586,11786
"6083","ENSBTAG00000009956","5",112916658,112928741,12083
"6084","ENSBTAG00000009958","8",74386004,74401852,15848
"6085","ENSBTAG00000009959","X",36914289,36921866,7577
"6086","ENSBTAG00000009960","23",28286486,28296570,10084
"6087","ENSBTAG00000009961","25",1751354,1761043,9689
"6088","ENSBTAG00000009962","11",5581311,5592467,11156
"6089","ENSBTAG00000009963","17",69819467,69860089,40622
"6090","ENSBTAG00000009964","25",1761808,1764862,3054
"6091","ENSBTAG00000009965","25",1765090,1778389,13299
"6092","ENSBTAG00000009966","21",68308102,68317607,9505
"6093","ENSBTAG00000009968","19",11607447,11633858,26411
"6094","ENSBTAG00000009969","25",1778570,1787687,9117
"6095","ENSBTAG00000009972","2",107501784,107504801,3017
"6096","ENSBTAG00000009974","14",1902552,2019963,117411
"6097","ENSBTAG00000009975","7",3711139,3768733,57594
"6098","ENSBTAG00000009976","2",84018938,84020154,1216
"6099","ENSBTAG00000009978","23",19910664,19922053,11389
"6100","ENSBTAG00000009979","19",37946400,37948673,2273
"6101","ENSBTAG00000009982","3",9577152,9584516,7364
"6102","ENSBTAG00000009983","10",16268432,16328199,59767
"6103","ENSBTAG00000009984","28",26964983,27026784,61801
"6104","ENSBTAG00000009985","21",33383914,33450894,66980
"6105","ENSBTAG00000009987","19",46329945,46392416,62471
"6106","ENSBTAG00000009988","17",71241945,71259042,17097
"6107","ENSBTAG00000009990","7",6553352,6659290,105938
"6108","ENSBTAG00000009991","19",53391266,53406328,15062
"6109","ENSBTAG00000009994","10",100303249,100460074,156825
"6110","ENSBTAG00000009995","20",5606065,5678507,72442
"6111","ENSBTAG00000009996","7",21334365,21386441,52076
"6112","ENSBTAG00000009997","29",47168667,47358095,189428
"6113","ENSBTAG00000009998","10",81046037,81147943,101906
"6114","ENSBTAG00000010001","19",17908914,17977497,68583
"6115","ENSBTAG00000010002","27",14872061,14955802,83741
"6116","ENSBTAG00000010003","20",3158996,3161648,2652
"6117","ENSBTAG00000010006","14",55973618,56023743,50125
"6118","ENSBTAG00000010007","23",10058481,10067089,8608
"6119","ENSBTAG00000010008","15",23874011,23920712,46701
"6120","ENSBTAG00000010009","3",3105832,3191071,85239
"6121","ENSBTAG00000010012","20",8116743,8123751,7008
"6122","ENSBTAG00000010013","25",3574508,3605787,31279
"6123","ENSBTAG00000010015","25",3608348,3614300,5952
"6124","ENSBTAG00000010016","16",70729199,70741623,12424
"6125","ENSBTAG00000010018","X",74363513,74490948,127435
"6126","ENSBTAG00000010020","7",38514899,38515840,941
"6127","ENSBTAG00000010023","13",29216135,29292558,76423
"6128","ENSBTAG00000010024","13",64512071,64543097,31026
"6129","ENSBTAG00000010026","22",47162857,47508559,345702
"6130","ENSBTAG00000010027","22",47133914,47158681,24767
"6131","ENSBTAG00000010029","22",44539154,45518463,979309
"6132","ENSBTAG00000010030","2",109525497,109678039,152542
"6133","ENSBTAG00000010032","29",34576918,34994005,417087
"6134","ENSBTAG00000010036","8",69558179,69564548,6369
"6135","ENSBTAG00000010037","24",33168820,33227343,58523
"6136","ENSBTAG00000010042","24",33143190,33165434,22244
"6137","ENSBTAG00000010046","18",57875071,57894839,19768
"6138","ENSBTAG00000010047","9",91723944,91866359,142415
"6139","ENSBTAG00000010048","2",27248579,27260964,12385
"6140","ENSBTAG00000010050","2",122014154,122068417,54263
"6141","ENSBTAG00000010051","2",315119,382536,67417
"6142","ENSBTAG00000010052","10",80994863,81025335,30472
"6143","ENSBTAG00000010057","21",34876603,34880233,3630
"6144","ENSBTAG00000010059","8",16700235,16727059,26824
"6145","ENSBTAG00000010060","15",80673388,80692495,19107
"6146","ENSBTAG00000010062","4",48677577,48736265,58688
"6147","ENSBTAG00000010063","7",49749644,49805938,56294
"6148","ENSBTAG00000010065","X",59975310,60322067,346757
"6149","ENSBTAG00000010068","7",49808753,49814912,6159
"6150","ENSBTAG00000010069","7",49825961,49830306,4345
"6151","ENSBTAG00000010070","19",40292881,40304832,11951
"6152","ENSBTAG00000010071","15",64374161,64408465,34304
"6153","ENSBTAG00000010072","11",10306886,10307580,694
"6154","ENSBTAG00000010073","19",20250827,20269068,18241
"6155","ENSBTAG00000010077","22",16737949,16789121,51172
"6156","ENSBTAG00000010082","8",63974402,64077938,103536
"6157","ENSBTAG00000010083","11",73226234,73256305,30071
"6158","ENSBTAG00000010085","27",19719908,19745898,25990
"6159","ENSBTAG00000010089","15",37629706,37635212,5506
"6160","ENSBTAG00000010091","1",42010599,42049950,39351
"6161","ENSBTAG00000010094","22",16734140,16737399,3259
"6162","ENSBTAG00000010096","25",27513955,27523749,9794
"6163","ENSBTAG00000010100","23",15642765,15687902,45137
"6164","ENSBTAG00000010101","23",15687963,15698295,10332
"6165","ENSBTAG00000010103","10",43826973,43944784,117811
"6166","ENSBTAG00000010105","26",15374939,15399424,24485
"6167","ENSBTAG00000010106","23",15698661,15705476,6815
"6168","ENSBTAG00000010107","8",103620999,103713017,92018
"6169","ENSBTAG00000010109","28",16488142,16582565,94423
"6170","ENSBTAG00000010111","11",49674139,49876828,202689
"6171","ENSBTAG00000010113","9",40680702,40691320,10618
"6172","ENSBTAG00000010114","X",49988725,49990203,1478
"6173","ENSBTAG00000010116","9",40567444,40620337,52893
"6174","ENSBTAG00000010118","2",24564087,24604728,40641
"6175","ENSBTAG00000010119","10",52214465,52340304,125839
"6176","ENSBTAG00000010120","6",36052150,36198478,146328
"6177","ENSBTAG00000010123","18",52637233,52640572,3339
"6178","ENSBTAG00000010124","3",82756143,82852335,96192
"6179","ENSBTAG00000010125","19",42319170,42357910,38740
"6180","ENSBTAG00000010126","13",74686117,74698084,11967
"6181","ENSBTAG00000010127","5",56934066,56938031,3965
"6182","ENSBTAG00000010128","6",36082759,36084685,1926
"6183","ENSBTAG00000010129","12",62295920,62298808,2888
"6184","ENSBTAG00000010130","13",74698317,74716421,18104
"6185","ENSBTAG00000010131","13",62957651,63094973,137322
"6186","ENSBTAG00000010132","18",34516460,34540770,24310
"6187","ENSBTAG00000010134","9",42052263,42095170,42907
"6188","ENSBTAG00000010135","13",78152923,78178452,25529
"6189","ENSBTAG00000010136","5",88154132,88170546,16414
"6190","ENSBTAG00000010138","22",50084781,50093377,8596
"6191","ENSBTAG00000010144","5",70252258,70257832,5574
"6192","ENSBTAG00000010145","10",62094457,62180991,86534
"6193","ENSBTAG00000010146","X",36980019,36996610,16591
"6194","ENSBTAG00000010149","5",70260351,70355222,94871
"6195","ENSBTAG00000010151","18",13345873,13368386,22513
"6196","ENSBTAG00000010152","X",132157304,132305813,148509
"6197","ENSBTAG00000010153","6",93300736,93373380,72644
"6198","ENSBTAG00000010155","19",14421208,14427667,6459
"6199","ENSBTAG00000010156","12",15472287,15475922,3635
"6200","ENSBTAG00000010157","5",110314071,110316041,1970
"6201","ENSBTAG00000010158","3",7135834,7264277,128443
"6202","ENSBTAG00000010161","8",76080584,76081928,1344
"6203","ENSBTAG00000010163","25",20853279,20884516,31237
"6204","ENSBTAG00000010164","3",117441783,117464352,22569
"6205","ENSBTAG00000010165","22",49790596,49799038,8442
"6206","ENSBTAG00000010166","23",27842117,27849003,6886
"6207","ENSBTAG00000010167","19",9512391,9662512,150121
"6208","ENSBTAG00000010169","16",40017928,40108187,90259
"6209","ENSBTAG00000010170","18",10389617,10434506,44889
"6210","ENSBTAG00000010174","3",7117209,7119975,2766
"6211","ENSBTAG00000010175","3",109696709,109721078,24369
"6212","ENSBTAG00000010176","3",117501464,117526261,24797
"6213","ENSBTAG00000010177","16",1964115,1978208,14093
"6214","ENSBTAG00000010178","8",36145265,36600302,455037
"6215","ENSBTAG00000010179","7",14542635,14587292,44657
"6216","ENSBTAG00000010180","28",1577597,1603804,26207
"6217","ENSBTAG00000010181","6",113520832,113543245,22413
"6218","ENSBTAG00000010182","5",120013292,120020697,7405
"6219","ENSBTAG00000010184","19",42949691,42960484,10793
"6220","ENSBTAG00000010185","6",113511976,113524514,12538
"6221","ENSBTAG00000010188","7",14589608,14596077,6469
"6222","ENSBTAG00000010191","29",18521064,18682812,161748
"6223","ENSBTAG00000010192","21",6821223,6827752,6529
"6224","ENSBTAG00000010193","22",59192424,59207552,15128
"6225","ENSBTAG00000010195","11",99210796,99226586,15790
"6226","ENSBTAG00000010196","9",86902280,86917596,15316
"6227","ENSBTAG00000010198","25",9153217,9228756,75539
"6228","ENSBTAG00000010204","9",86919468,86962347,42879
"6229","ENSBTAG00000010206","3",6906319,6938634,32315
"6230","ENSBTAG00000010207","18",24184906,24199512,14606
"6231","ENSBTAG00000010208","11",99234095,99262779,28684
"6232","ENSBTAG00000010210","13",29527156,29549270,22114
"6233","ENSBTAG00000010215","7",19866004,19877349,11345
"6234","ENSBTAG00000010217","23",16929147,16955126,25979
"6235","ENSBTAG00000010219","4",112569850,112584312,14462
"6236","ENSBTAG00000010220","13",29554370,29588401,34031
"6237","ENSBTAG00000010221","2",69565219,69664403,99184
"6238","ENSBTAG00000010223","5",104745602,104823230,77628
"6239","ENSBTAG00000010227","21",56809062,56842217,33155
"6240","ENSBTAG00000010229","9",67153459,67556512,403053
"6241","ENSBTAG00000010230","29",43400333,43427397,27064
"6242","ENSBTAG00000010232","3",106970587,106976098,5511
"6243","ENSBTAG00000010234","10",20871434,20880388,8954
"6244","ENSBTAG00000010235","10",20865162,20871269,6107
"6245","ENSBTAG00000010236","10",20862517,20865361,2844
"6246","ENSBTAG00000010238","10",20853778,20855801,2023
"6247","ENSBTAG00000010239","10",79106812,79142207,35395
"6248","ENSBTAG00000010241","27",30732560,31370431,637871
"6249","ENSBTAG00000010242","12",86593182,86605278,12096
"6250","ENSBTAG00000010243","4",117366283,117462802,96519
"6251","ENSBTAG00000010244","23",19185150,19351221,166071
"6252","ENSBTAG00000010245","X",35446398,35447264,866
"6253","ENSBTAG00000010246","12",86605075,86623712,18637
"6254","ENSBTAG00000010247","8",95364547,95400156,35609
"6255","ENSBTAG00000010249","2",125946146,125956940,10794
"6256","ENSBTAG00000010251","7",73772453,73899292,126839
"6257","ENSBTAG00000010252","24",21736928,21785331,48403
"6258","ENSBTAG00000010253","2",125934205,125940846,6641
"6259","ENSBTAG00000010254","2",125921162,125934238,13076
"6260","ENSBTAG00000010255","24",21710349,21716048,5699
"6261","ENSBTAG00000010256","23",44802116,44835671,33555
"6262","ENSBTAG00000010264","25",38809820,38840353,30533
"6263","ENSBTAG00000010265","3",3264993,3288716,23723
"6264","ENSBTAG00000010270","10",85042309,85046178,3869
"6265","ENSBTAG00000010271","11",96283674,96516604,232930
"6266","ENSBTAG00000010273","6",89306902,89325899,18997
"6267","ENSBTAG00000010275","14",15092454,15141282,48828
"6268","ENSBTAG00000010276","14",428460,434942,6482
"6269","ENSBTAG00000010277","13",40757715,40760695,2980
"6270","ENSBTAG00000010278","2",128500788,128561411,60623
"6271","ENSBTAG00000010279","19",13783243,13808854,25611
"6272","ENSBTAG00000010284","6",16554037,16573066,19029
"6273","ENSBTAG00000010285","6",34655101,34767415,112314
"6274","ENSBTAG00000010286","15",17790814,17843006,52192
"6275","ENSBTAG00000010289","X",129489714,129507469,17755
"6276","ENSBTAG00000010290","19",12895739,12928293,32554
"6277","ENSBTAG00000010291","25",38535601,38545789,10188
"6278","ENSBTAG00000010292","19",13812484,13895891,83407
"6279","ENSBTAG00000010293","2",93255171,93626123,370952
"6280","ENSBTAG00000010297","19",12930324,12940525,10201
"6281","ENSBTAG00000010298","10",50582585,50614948,32363
"6282","ENSBTAG00000010299","24",22850105,23337742,487637
"6283","ENSBTAG00000010303","7",14813729,14824411,10682
"6284","ENSBTAG00000010304","29",45579775,45640374,60599
"6285","ENSBTAG00000010306","17",40348027,40475237,127210
"6286","ENSBTAG00000010309","25",25620580,25727702,107122
"6287","ENSBTAG00000010311","19",12941110,12950393,9283
"6288","ENSBTAG00000010312","17",71998213,72053367,55154
"6289","ENSBTAG00000010313","19",13899961,13922590,22629
"6290","ENSBTAG00000010314","7",14824808,14825864,1056
"6291","ENSBTAG00000010316","7",14826795,14834231,7436
"6292","ENSBTAG00000010318","7",14841524,14846130,4606
"6293","ENSBTAG00000010321","7",71598514,71647531,49017
"6294","ENSBTAG00000010322","15",29631206,29653505,22299
"6295","ENSBTAG00000010324","5",110334791,110358382,23591
"6296","ENSBTAG00000010326","8",1963622,2000436,36814
"6297","ENSBTAG00000010328","23",13166550,13179213,12663
"6298","ENSBTAG00000010330","13",35474947,35490959,16012
"6299","ENSBTAG00000010334","9",95072282,95155471,83189
"6300","ENSBTAG00000010336","29",50591285,50598649,7364
"6301","ENSBTAG00000010337","12",21415368,21424942,9574
"6302","ENSBTAG00000010338","2",117962254,118069148,106894
"6303","ENSBTAG00000010339","25",33530965,33533374,2409
"6304","ENSBTAG00000010341","7",71658159,71688040,29881
"6305","ENSBTAG00000010343","6",110457785,110586506,128721
"6306","ENSBTAG00000010344","2",118076301,118099221,22920
"6307","ENSBTAG00000010345","X",13775714,13805036,29322
"6308","ENSBTAG00000010346","6",86004178,86021548,17370
"6309","ENSBTAG00000010347","9",95156270,95201305,45035
"6310","ENSBTAG00000010348","29",50584569,50589862,5293
"6311","ENSBTAG00000010349","11",46482543,46493673,11130
"6312","ENSBTAG00000010350","6",6014820,6054142,39322
"6313","ENSBTAG00000010351","27",15530048,15621603,91555
"6314","ENSBTAG00000010352","23",13180877,13187815,6938
"6315","ENSBTAG00000010353","12",21342921,21390489,47568
"6316","ENSBTAG00000010355","27",19952764,19986425,33661
"6317","ENSBTAG00000010356","24",41081076,41101417,20341
"6318","ENSBTAG00000010357","1",80194829,80267738,72909
"6319","ENSBTAG00000010359","7",69320218,69327120,6902
"6320","ENSBTAG00000010360","22",34953094,35066971,113877
"6321","ENSBTAG00000010361","10",36464520,36473693,9173
"6322","ENSBTAG00000010362","2",27269454,27332687,63233
"6323","ENSBTAG00000010363","7",69328868,69337119,8251
"6324","ENSBTAG00000010365","10",64811087,64864928,53841
"6325","ENSBTAG00000010366","2",122097791,122108116,10325
"6326","ENSBTAG00000010367","28",3633670,3714384,80714
"6327","ENSBTAG00000010368","17",66190152,66244471,54319
"6328","ENSBTAG00000010370","21",69403926,69411216,7290
"6329","ENSBTAG00000010371","10",36485672,36488431,2759
"6330","ENSBTAG00000010372","27",19848025,19948594,100569
"6331","ENSBTAG00000010373","7",20313628,20324899,11271
"6332","ENSBTAG00000010375","19",40417962,40428347,10385
"6333","ENSBTAG00000010376","17",10488576,10517061,28485
"6334","ENSBTAG00000010378","2",122077521,122095612,18091
"6335","ENSBTAG00000010379","7",4423279,4516043,92764
"6336","ENSBTAG00000010380","10",36505672,36628891,123219
"6337","ENSBTAG00000010381","17",10454873,10487503,32630
"6338","ENSBTAG00000010382","1",69332534,69349823,17289
"6339","ENSBTAG00000010383","13",54332554,54344491,11937
"6340","ENSBTAG00000010384","19",40524612,40546357,21745
"6341","ENSBTAG00000010386","2",106256621,106284396,27775
"6342","ENSBTAG00000010387","13",30319498,30399996,80498
"6343","ENSBTAG00000010388","11",3840888,3956079,115191
"6344","ENSBTAG00000010389","6",91219218,91223003,3785
"6345","ENSBTAG00000010390","4",72319442,72342353,22911
"6346","ENSBTAG00000010392","16",19907145,20149352,242207
"6347","ENSBTAG00000010393","2",124855242,124878660,23418
"6348","ENSBTAG00000010394","1",83653154,83911446,258292
"6349","ENSBTAG00000010395","12",75720835,75894298,173463
"6350","ENSBTAG00000010397","1",83752076,83827942,75866
"6351","ENSBTAG00000010399","10",11623049,11719602,96553
"6352","ENSBTAG00000010401","16",43379657,43501600,121943
"6353","ENSBTAG00000010402","5",74719956,74805905,85949
"6354","ENSBTAG00000010403","18",43398418,43401991,3573
"6355","ENSBTAG00000010407","21",59627729,59629562,1833
"6356","ENSBTAG00000010408","16",4259232,4284591,25359
"6357","ENSBTAG00000010411","29",36515554,36534251,18697
"6358","ENSBTAG00000010413","2",104067181,104128350,61169
"6359","ENSBTAG00000010414","3",95865909,95870988,5079
"6360","ENSBTAG00000010416","21",57231578,57367471,135893
"6361","ENSBTAG00000010419","15",37889793,37958129,68336
"6362","ENSBTAG00000010420","12",5106603,5221533,114930
"6363","ENSBTAG00000010422","5",44979892,45005325,25433
"6364","ENSBTAG00000010423","20",35840757,35949859,109102
"6365","ENSBTAG00000010426","2",104134456,104223320,88864
"6366","ENSBTAG00000010427","16",4293882,4367194,73312
"6367","ENSBTAG00000010428","5",51147112,51276079,128967
"6368","ENSBTAG00000010431","8",31503232,31557952,54720
"6369","ENSBTAG00000010432","16",4369646,4391398,21752
"6370","ENSBTAG00000010437","4",95025992,95232557,206565
"6371","ENSBTAG00000010439","7",7737722,7765967,28245
"6372","ENSBTAG00000010442","26",11248533,11303502,54969
"6373","ENSBTAG00000010444","5",57215784,57236737,20953
"6374","ENSBTAG00000010445","3",59681727,59699694,17967
"6375","ENSBTAG00000010447","29",49598330,49637383,39053
"6376","ENSBTAG00000010448","1",138181418,138320203,138785
"6377","ENSBTAG00000010449","23",13836254,13889103,52849
"6378","ENSBTAG00000010450","7",7706769,7730338,23569
"6379","ENSBTAG00000010451","5",57208094,57214801,6707
"6380","ENSBTAG00000010452","4",95248660,95294639,45979
"6381","ENSBTAG00000010455","29",40982507,40987197,4690
"6382","ENSBTAG00000010456","3",2034404,2050406,16002
"6383","ENSBTAG00000010457","5",69476203,69552137,75934
"6384","ENSBTAG00000010458","3",8802581,8816310,13729
"6385","ENSBTAG00000010460","16",24017131,24156596,139465
"6386","ENSBTAG00000010462","1",24870588,25065331,194743
"6387","ENSBTAG00000010464","17",67173546,67221633,48087
"6388","ENSBTAG00000010465","29",40993414,40998547,5133
"6389","ENSBTAG00000010467","18",49132458,49159095,26637
"6390","ENSBTAG00000010470","29",41001416,41002146,730
"6391","ENSBTAG00000010472","10",59314012,59360054,46042
"6392","ENSBTAG00000010475","12",18857662,18859717,2055
"6393","ENSBTAG00000010477","22",12455223,12477183,21960
"6394","ENSBTAG00000010478","29",45366761,45375402,8641
"6395","ENSBTAG00000010480","18",49160920,49168043,7123
"6396","ENSBTAG00000010481","29",41003954,41006643,2689
"6397","ENSBTAG00000010482","29",45373821,45388348,14527
"6398","ENSBTAG00000010483","18",49172884,49180410,7526
"6399","ENSBTAG00000010484","29",41013304,41015955,2651
"6400","ENSBTAG00000010485","1",87721169,87765315,44146
"6401","ENSBTAG00000010487","7",62132825,62152726,19901
"6402","ENSBTAG00000010490","5",103177675,103195053,17378
"6403","ENSBTAG00000010492","24",61648831,61686320,37489
"6404","ENSBTAG00000010493","18",49764725,49767618,2893
"6405","ENSBTAG00000010496","25",36205145,36235822,30677
"6406","ENSBTAG00000010497","11",105961068,105977038,15970
"6407","ENSBTAG00000010498","2",6776416,6800154,23738
"6408","ENSBTAG00000010501","18",49184744,49190099,5355
"6409","ENSBTAG00000010502","18",49774642,49778162,3520
"6410","ENSBTAG00000010503","10",70683476,70699660,16184
"6411","ENSBTAG00000010504","4",76522744,76531904,9160
"6412","ENSBTAG00000010505","29",18041194,18149447,108253
"6413","ENSBTAG00000010506","3",108368074,108392514,24440
"6414","ENSBTAG00000010507","9",39753078,39788314,35236
"6415","ENSBTAG00000010508","18",49781065,49798244,17179
"6416","ENSBTAG00000010509","19",55644953,55657739,12786
"6417","ENSBTAG00000010510","20",23830149,23877461,47312
"6418","ENSBTAG00000010511","25",27217760,27228735,10975
"6419","ENSBTAG00000010513","19",27020759,27024021,3262
"6420","ENSBTAG00000010514","21",5970734,6023292,52558
"6421","ENSBTAG00000010515","11",105981080,105984424,3344
"6422","ENSBTAG00000010517","19",55626318,55644114,17796
"6423","ENSBTAG00000010518","20",23738862,23830250,91388
"6424","ENSBTAG00000010519","19",27023548,27035375,11827
"6425","ENSBTAG00000010521","25",36191068,36193369,2301
"6426","ENSBTAG00000010522","26",25511783,25521653,9870
"6427","ENSBTAG00000010524","25",27212130,27216927,4797
"6428","ENSBTAG00000010526","20",23636355,23738916,102561
"6429","ENSBTAG00000010529","14",61176627,61212948,36321
"6430","ENSBTAG00000010530","5",88796314,88801862,5548
"6431","ENSBTAG00000010531","11",20470965,20476592,5627
"6432","ENSBTAG00000010532","19",27038891,27055354,16463
"6433","ENSBTAG00000010533","5",73508916,73543335,34419
"6434","ENSBTAG00000010534","19",34949651,35042578,92927
"6435","ENSBTAG00000010535","8",99835331,99867723,32392
"6436","ENSBTAG00000010536","21",41985008,41986030,1022
"6437","ENSBTAG00000010541","7",38534033,38559286,25253
"6438","ENSBTAG00000010542","24",42881073,43046731,165658
"6439","ENSBTAG00000010543","7",38575410,38586456,11046
"6440","ENSBTAG00000010545","7",4607347,4614828,7481
"6441","ENSBTAG00000010546","6",97753005,97815165,62160
"6442","ENSBTAG00000010547","24",43057463,43072701,15238
"6443","ENSBTAG00000010548","14",8601623,8672683,71060
"6444","ENSBTAG00000010549","4",55863961,55887646,23685
"6445","ENSBTAG00000010550","1",96540992,96557978,16986
"6446","ENSBTAG00000010551","3",9528257,9552859,24602
"6447","ENSBTAG00000010552","24",43073010,43082953,9943
"6448","ENSBTAG00000010555","4",55849056,55859542,10486
"6449","ENSBTAG00000010559","19",35165031,35212185,47154
"6450","ENSBTAG00000010560","3",32969972,32974969,4997
"6451","ENSBTAG00000010562","16",75466075,75489259,23184
"6452","ENSBTAG00000010563","24",43097074,43165140,68066
"6453","ENSBTAG00000010564","6",15199666,15360477,160811
"6454","ENSBTAG00000010565","3",32944105,32954911,10806
"6455","ENSBTAG00000010566","19",35212505,35235654,23149
"6456","ENSBTAG00000010568","15",41816381,41821678,5297
"6457","ENSBTAG00000010571","6",71782614,71821764,39150
"6458","ENSBTAG00000010573","5",110270350,110287563,17213
"6459","ENSBTAG00000010576","19",35255751,35273731,17980
"6460","ENSBTAG00000010577","6",71796672,71841416,44744
"6461","ENSBTAG00000010578","7",60772778,60777637,4859
"6462","ENSBTAG00000010579","2",97989116,98029245,40129
"6463","ENSBTAG00000010581","22",35758131,36020214,262083
"6464","ENSBTAG00000010582","11",104804414,104838104,33690
"6465","ENSBTAG00000010584","18",53925647,53935418,9771
"6466","ENSBTAG00000010587","X",71202116,71330055,127939
"6467","ENSBTAG00000010590","5",115707024,115732866,25842
"6468","ENSBTAG00000010591","28",18471094,18495472,24378
"6469","ENSBTAG00000010593","6",71846136,71871800,25664
"6470","ENSBTAG00000010595","11",66560111,66589114,29003
"6471","ENSBTAG00000010597","4",65806682,65816128,9446
"6472","ENSBTAG00000010598","2",120187397,120218347,30950
"6473","ENSBTAG00000010599","2",71107880,71192356,84476
"6474","ENSBTAG00000010601","11",99443621,99445710,2089
"6475","ENSBTAG00000010602","4",76865589,76874946,9357
"6476","ENSBTAG00000010604","11",66589551,66598955,9404
"6477","ENSBTAG00000010605","11",13482524,13508824,26300
"6478","ENSBTAG00000010606","27",25180847,25190311,9464
"6479","ENSBTAG00000010609","4",71959160,72031056,71896
"6480","ENSBTAG00000010610","6",24526441,24531397,4956
"6481","ENSBTAG00000010611","6",67496284,67519221,22937
"6482","ENSBTAG00000010612","4",76859613,76862453,2840
"6483","ENSBTAG00000010613","11",99445824,99489060,43236
"6484","ENSBTAG00000010615","6",71874725,71889296,14571
"6485","ENSBTAG00000010616","5",55947935,55953054,5119
"6486","ENSBTAG00000010617","3",15444041,15446577,2536
"6487","ENSBTAG00000010619","11",66604007,66667996,63989
"6488","ENSBTAG00000010620","11",13454348,13480401,26053
"6489","ENSBTAG00000010622","3",15433668,15443429,9761
"6490","ENSBTAG00000010623","11",13434822,13442574,7752
"6491","ENSBTAG00000010624","5",55932944,55946889,13945
"6492","ENSBTAG00000010626","11",99489805,99506890,17085
"6493","ENSBTAG00000010627","18",1578539,1618405,39866
"6494","ENSBTAG00000010630","17",29695955,29733214,37259
"6495","ENSBTAG00000010632","7",71800104,71806269,6165
"6496","ENSBTAG00000010634","6",4403331,4414617,11286
"6497","ENSBTAG00000010635","7",5017271,5023792,6521
"6498","ENSBTAG00000010637","19",61782347,61886528,104181
"6499","ENSBTAG00000010639","7",16662127,16672289,10162
"6500","ENSBTAG00000010641","10",46654444,46772271,117827
"6501","ENSBTAG00000010642","15",16933741,17065156,131415
"6502","ENSBTAG00000010644","5",68044447,68306547,262100
"6503","ENSBTAG00000010645","23",25837353,25843155,5802
"6504","ENSBTAG00000010647","8",77952718,78360358,407640
"6505","ENSBTAG00000010649","21",6860316,7041397,181081
"6506","ENSBTAG00000010652","7",5001615,5013738,12123
"6507","ENSBTAG00000010653","11",99510597,99535599,25002
"6508","ENSBTAG00000010655","3",15548874,15564300,15426
"6509","ENSBTAG00000010657","2",121953227,121990032,36805
"6510","ENSBTAG00000010658","1",144308711,144335975,27264
"6511","ENSBTAG00000010659","25",34703181,35062913,359732
"6512","ENSBTAG00000010660","5",108446722,108792612,345890
"6513","ENSBTAG00000010661","7",58595964,58710806,114842
"6514","ENSBTAG00000010662","17",70033759,70093314,59555
"6515","ENSBTAG00000010663","3",15538260,15548475,10215
"6516","ENSBTAG00000010664","13",17008653,17100097,91444
"6517","ENSBTAG00000010665","10",20744959,20748108,3149
"6518","ENSBTAG00000010666","10",20736077,20744735,8658
"6519","ENSBTAG00000010667","17",70094432,70105136,10704
"6520","ENSBTAG00000010668","18",52756055,52762915,6860
"6521","ENSBTAG00000010670","3",9825348,9833376,8028
"6522","ENSBTAG00000010671","4",78761983,79063150,301167
"6523","ENSBTAG00000010672","12",76812919,77174969,362050
"6524","ENSBTAG00000010673","3",15532649,15536764,4115
"6525","ENSBTAG00000010676","3",117246496,117266624,20128
"6526","ENSBTAG00000010677","6",60224068,60573254,349186
"6527","ENSBTAG00000010681","15",77125341,77139490,14149
"6528","ENSBTAG00000010682","23",28172747,28219346,46599
"6529","ENSBTAG00000010686","8",100789221,100790171,950
"6530","ENSBTAG00000010688","1",66772681,66783747,11066
"6531","ENSBTAG00000010689","7",51031920,51226063,194143
"6532","ENSBTAG00000010690","12",32118971,32123944,4973
"6533","ENSBTAG00000010691","11",49357672,49394318,36646
"6534","ENSBTAG00000010692","4",91873756,92296106,422350
"6535","ENSBTAG00000010693","12",50677082,50897222,220140
"6536","ENSBTAG00000010694","28",13971512,14316512,345000
"6537","ENSBTAG00000010696","16",51179889,51192095,12206
"6538","ENSBTAG00000010698","23",28146081,28159087,13006
"6539","ENSBTAG00000010701","5",56711826,56743636,31810
"6540","ENSBTAG00000010704","4",92143302,92233611,90309
"6541","ENSBTAG00000010709","15",22340056,22374925,34869
"6542","ENSBTAG00000010711","5",25143973,25144497,524
"6543","ENSBTAG00000010715","3",92016377,92033861,17484
"6544","ENSBTAG00000010716","6",92951310,93291875,340565
"6545","ENSBTAG00000010717","3",91841230,92006821,165591
"6546","ENSBTAG00000010718","16",60124735,60284409,159674
"6547","ENSBTAG00000010719","16",60222330,60246517,24187
"6548","ENSBTAG00000010720","16",51007644,51020416,12772
"6549","ENSBTAG00000010721","23",24694544,24712140,17596
"6550","ENSBTAG00000010722","2",98069915,98070370,455
"6551","ENSBTAG00000010723","23",7463125,7464805,1680
"6552","ENSBTAG00000010726","X",36013567,36155731,142164
"6553","ENSBTAG00000010727","7",15053007,15061657,8650
"6554","ENSBTAG00000010729","7",15061317,15070938,9621
"6555","ENSBTAG00000010731","7",15071126,15073864,2738
"6556","ENSBTAG00000010732","16",51003903,51006594,2691
"6557","ENSBTAG00000010734","7",37851533,37856390,4857
"6558","ENSBTAG00000010735","7",37856220,37857202,982
"6559","ENSBTAG00000010736","2",26753551,26774873,21322
"6560","ENSBTAG00000010737","16",50983615,51003930,20315
"6561","ENSBTAG00000010738","19",14460812,14465640,4828
"6562","ENSBTAG00000010739","26",21174604,21184517,9913
"6563","ENSBTAG00000010740","7",37857326,37879421,22095
"6564","ENSBTAG00000010741","2",26734655,26750934,16279
"6565","ENSBTAG00000010742","26",21186852,21261965,75113
"6566","ENSBTAG00000010743","2",26694016,26730287,36271
"6567","ENSBTAG00000010745","19",40366052,40391256,25204
"6568","ENSBTAG00000010756","4",51165809,51456320,290511
"6569","ENSBTAG00000010758","19",55932583,55939531,6948
"6570","ENSBTAG00000010760","9",38930441,39108208,177767
"6571","ENSBTAG00000010763","5",97282682,97334536,51854
"6572","ENSBTAG00000010765","28",3972493,4005098,32605
"6573","ENSBTAG00000010766","10",36780762,36789336,8574
"6574","ENSBTAG00000010769","12",32872542,32875852,3310
"6575","ENSBTAG00000010772","7",43164988,43168955,3967
"6576","ENSBTAG00000010773","28",4004934,4045603,40669
"6577","ENSBTAG00000010774","10",36788934,36819852,30918
"6578","ENSBTAG00000010775","3",2051963,2069922,17959
"6579","ENSBTAG00000010777","29",48561752,48614531,52779
"6580","ENSBTAG00000010778","10",36820290,36837237,16947
"6581","ENSBTAG00000010784","23",31520971,31523923,2952
"6582","ENSBTAG00000010785","26",10678580,10712480,33900
"6583","ENSBTAG00000010786","26",41877231,42112620,235389
"6584","ENSBTAG00000010787","12",27378900,27396278,17378
"6585","ENSBTAG00000010788","19",9720415,9936721,216306
"6586","ENSBTAG00000010789","5",109643325,109653939,10614
"6587","ENSBTAG00000010790","5",109662810,109683993,21183
"6588","ENSBTAG00000010791","15",24505232,24518059,12827
"6589","ENSBTAG00000010792","24",43196058,43216524,20466
"6590","ENSBTAG00000010793","1",57364375,57478155,113780
"6591","ENSBTAG00000010795","10",67833062,67879072,46010
"6592","ENSBTAG00000010796","26",42549883,42558677,8794
"6593","ENSBTAG00000010797","26",42561495,42564493,2998
"6594","ENSBTAG00000010798","7",50647652,50660051,12399
"6595","ENSBTAG00000010799","5",57161869,57164985,3116
"6596","ENSBTAG00000010801","20",62947915,62973176,25261
"6597","ENSBTAG00000010802","29",43774318,43777103,2785
"6598","ENSBTAG00000010803","16",35143253,35145208,1955
"6599","ENSBTAG00000010805","11",101622925,101642291,19366
"6600","ENSBTAG00000010809","19",56455015,56475733,20718
"6601","ENSBTAG00000010810","11",101639654,101645280,5626
"6602","ENSBTAG00000010812","17",53925451,53941599,16148
"6603","ENSBTAG00000010813","14",15649311,15649697,386
"6604","ENSBTAG00000010815","17",53870785,53920434,49649
"6605","ENSBTAG00000010818","5",90468635,90530352,61717
"6606","ENSBTAG00000010819","8",9647783,9843899,196116
"6607","ENSBTAG00000010820","15",55605299,55624948,19649
"6608","ENSBTAG00000010821","8",24864803,24891849,27046
"6609","ENSBTAG00000010822","20",33016045,33218726,202681
"6610","ENSBTAG00000010826","15",55854695,55933677,78982
"6611","ENSBTAG00000010828","21",34811403,34814493,3090
"6612","ENSBTAG00000010830","5",56230519,56310118,79599
"6613","ENSBTAG00000010832","22",16857169,16859982,2813
"6614","ENSBTAG00000010833","22",16841733,16851718,9985
"6615","ENSBTAG00000010835","22",16820562,16828799,8237
"6616","ENSBTAG00000010836","22",16817598,16819415,1817
"6617","ENSBTAG00000010837","7",59874121,60068120,193999
"6618","ENSBTAG00000010838","9",95033934,95042817,8883
"6619","ENSBTAG00000010841","3",22466919,22510019,43100
"6620","ENSBTAG00000010843","17",29460086,29478965,18879
"6621","ENSBTAG00000010846","11",2763444,2794689,31245
"6622","ENSBTAG00000010847","17",63818770,63841781,23011
"6623","ENSBTAG00000010849","11",2801347,2807103,5756
"6624","ENSBTAG00000010850","16",73094210,73105682,11472
"6625","ENSBTAG00000010852","23",31608469,31615067,6598
"6626","ENSBTAG00000010856","18",54413384,54446250,32866
"6627","ENSBTAG00000010858","18",16590653,16667410,76757
"6628","ENSBTAG00000010859","29",29244169,29258470,14301
"6629","ENSBTAG00000010860","15",23969723,23982733,13010
"6630","ENSBTAG00000010863","22",47646509,47690569,44060
"6631","ENSBTAG00000010865","5",74969135,75090284,121149
"6632","ENSBTAG00000010866","4",62664288,62917005,252717
"6633","ENSBTAG00000010867","18",16674438,16759589,85151
"6634","ENSBTAG00000010868","18",16771820,16794725,22905
"6635","ENSBTAG00000010871","7",51705072,51715786,10714
"6636","ENSBTAG00000010873","13",54422583,54423251,668
"6637","ENSBTAG00000010874","1",95029121,95032760,3639
"6638","ENSBTAG00000010875","6",104281506,104285802,4296
"6639","ENSBTAG00000010877","23",9716949,9728648,11699
"6640","ENSBTAG00000010880","29",49645728,49648440,2712
"6641","ENSBTAG00000010881","X",4235958,4245145,9187
"6642","ENSBTAG00000010882","21",67251762,67254853,3091
"6643","ENSBTAG00000010884","X",4248531,4264366,15835
"6644","ENSBTAG00000010885","9",34430224,34433482,3258
"6645","ENSBTAG00000010888","28",27894350,27920827,26477
"6646","ENSBTAG00000010889","15",60976952,60980910,3958
"6647","ENSBTAG00000010890","10",21915369,21923670,8301
"6648","ENSBTAG00000010896","6",108753570,108757070,3500
"6649","ENSBTAG00000010897","2",107270817,107276428,5611
"6650","ENSBTAG00000010898","11",14763571,14809754,46183
"6651","ENSBTAG00000010899","19",53460671,53514937,54266
"6652","ENSBTAG00000010904","25",26423976,26431502,7526
"6653","ENSBTAG00000010906","10",102478630,102673838,195208
"6654","ENSBTAG00000010907","5",25506716,25515565,8849
"6655","ENSBTAG00000010909","16",71867070,71871370,4300
"6656","ENSBTAG00000010910","3",119662082,119666681,4599
"6657","ENSBTAG00000010913","13",60402762,60408261,5499
"6658","ENSBTAG00000010915","21",21993225,22086826,93601
"6659","ENSBTAG00000010916","22",17087253,17118687,31434
"6660","ENSBTAG00000010919","15",40740642,40846207,105565
"6661","ENSBTAG00000010922","X",129795992,129808647,12655
"6662","ENSBTAG00000010923","X",129812666,129832128,19462
"6663","ENSBTAG00000010924","5",28687647,28695321,7674
"6664","ENSBTAG00000010927","18",14051588,14127897,76309
"6665","ENSBTAG00000010928","5",28671342,28684721,13379
"6666","ENSBTAG00000010930","28",26468932,26476794,7862
"6667","ENSBTAG00000010931","4",105003768,105014759,10991
"6668","ENSBTAG00000010932","28",24248418,24296594,48176
"6669","ENSBTAG00000010934","13",58788120,58806295,18175
"6670","ENSBTAG00000010935","11",24585989,24739169,153180
"6671","ENSBTAG00000010937","X",119337922,119408077,70155
"6672","ENSBTAG00000010938","2",136066725,136069993,3268
"6673","ENSBTAG00000010939","X",119315256,119337877,22621
"6674","ENSBTAG00000010943","23",50326768,50458184,131416
"6675","ENSBTAG00000010944","10",17737186,17895044,157858
"6676","ENSBTAG00000010945","6",15825962,15906195,80233
"6677","ENSBTAG00000010947","28",14786778,14882678,95900
"6678","ENSBTAG00000010948","X",35677939,35703033,25094
"6679","ENSBTAG00000010949","12",23219451,23251116,31665
"6680","ENSBTAG00000010951","12",23178045,23219416,41371
"6681","ENSBTAG00000010952","10",48017835,48034891,17056
"6682","ENSBTAG00000010954","6",90865633,91007790,142157
"6683","ENSBTAG00000010955","6",91010248,91043062,32814
"6684","ENSBTAG00000010956","6",91048377,91130984,82607
"6685","ENSBTAG00000010957","26",44097496,44224863,127367
"6686","ENSBTAG00000010959","7",23271324,23278556,7232
"6687","ENSBTAG00000010961","7",23244080,23265677,21597
"6688","ENSBTAG00000010963","21",27049337,27099793,50456
"6689","ENSBTAG00000010964","21",27101691,27110334,8643
"6690","ENSBTAG00000010967","28",17588160,17758677,170517
"6691","ENSBTAG00000010968","7",15298592,15301886,3294
"6692","ENSBTAG00000010970","29",13380041,13380523,482
"6693","ENSBTAG00000010971","11",44715399,44796640,81241
"6694","ENSBTAG00000010976","8",43770176,43988755,218579
"6695","ENSBTAG00000010977","2",13693338,13730072,36734
"6696","ENSBTAG00000010978","16",69536053,69590809,54756
"6697","ENSBTAG00000010979","7",45909928,45941170,31242
"6698","ENSBTAG00000010980","4",25090913,25130458,39545
"6699","ENSBTAG00000010981","21",30485336,30508394,23058
"6700","ENSBTAG00000010982","7",45944974,45957591,12617
"6701","ENSBTAG00000010984","7",45966236,45972424,6188
"6702","ENSBTAG00000010986","29",48759236,49139386,380150
"6703","ENSBTAG00000010987","1",46190242,46201247,11005
"6704","ENSBTAG00000010988","21",25176571,25194048,17477
"6705","ENSBTAG00000010989","20",11397628,11480087,82459
"6706","ENSBTAG00000010990","11",95125097,95144837,19740
"6707","ENSBTAG00000010991","24",25544097,25553148,9051
"6708","ENSBTAG00000010992","21",25201460,25222224,20764
"6709","ENSBTAG00000010993","21",67119969,67129491,9522
"6710","ENSBTAG00000010994","29",44596854,44602466,5612
"6711","ENSBTAG00000010995","21",67132861,67147264,14403
"6712","ENSBTAG00000010998","2",89703845,89757452,53607
"6713","ENSBTAG00000010999","22",43940324,44002737,62413
"6714","ENSBTAG00000011000","5",119611412,119616810,5398
"6715","ENSBTAG00000011001","1",150668926,150803833,134907
"6716","ENSBTAG00000011002","4",92763331,92792188,28857
"6717","ENSBTAG00000011003","19",40128960,40213794,84834
"6718","ENSBTAG00000011007","19",57151008,57186696,35688
"6719","ENSBTAG00000011010","13",47086007,47091045,5038
"6720","ENSBTAG00000011011","19",20882415,21124185,241770
"6721","ENSBTAG00000011014","28",28073465,28097452,23987
"6722","ENSBTAG00000011017","2",91544953,91642576,97623
"6723","ENSBTAG00000011019","29",41863567,41932878,69311
"6724","ENSBTAG00000011021","18",23948128,23975139,27011
"6725","ENSBTAG00000011022","10",57819020,57834446,15426
"6726","ENSBTAG00000011023","5",99782216,99792430,10214
"6727","ENSBTAG00000011024","3",94278884,94312525,33641
"6728","ENSBTAG00000011025","3",94255802,94278300,22498
"6729","ENSBTAG00000011027","8",100963670,100994111,30441
"6730","ENSBTAG00000011028","X",75979982,76138382,158400
"6731","ENSBTAG00000011032","27",5446148,5686242,240094
"6732","ENSBTAG00000011034","27",5552298,5612326,60028
"6733","ENSBTAG00000011037","10",45313259,45339402,26143
"6734","ENSBTAG00000011038","24",43564576,43583046,18470
"6735","ENSBTAG00000011041","10",84487291,84531337,44046
"6736","ENSBTAG00000011042","6",116835513,116840085,4572
"6737","ENSBTAG00000011043","5",75656456,75673313,16857
"6738","ENSBTAG00000011044","6",116825809,116835029,9220
"6739","ENSBTAG00000011045","20",10467519,10475679,8160
"6740","ENSBTAG00000011046","20",10432556,10460715,28159
"6741","ENSBTAG00000011048","8",39841411,39915201,73790
"6742","ENSBTAG00000011050","8",39863787,39864933,1146
"6743","ENSBTAG00000011052","18",58474268,58533857,59589
"6744","ENSBTAG00000011056","X",31991465,32006656,15191
"6745","ENSBTAG00000011057","23",7720354,7725488,5134
"6746","ENSBTAG00000011059","3",95337691,95342769,5078
"6747","ENSBTAG00000011062","17",43386894,43403747,16853
"6748","ENSBTAG00000011063","17",43364999,43381605,16606
"6749","ENSBTAG00000011064","14",556020,570498,14478
"6750","ENSBTAG00000011067","5",108808131,108823757,15626
"6751","ENSBTAG00000011068","5",50995056,51105717,110661
"6752","ENSBTAG00000011070","5",71017594,71038972,21378
"6753","ENSBTAG00000011071","5",71042373,71086800,44427
"6754","ENSBTAG00000011072","28",30012693,30556374,543681
"6755","ENSBTAG00000011074","23",7286988,7294770,7782
"6756","ENSBTAG00000011075","27",33042477,33052036,9559
"6757","ENSBTAG00000011076","10",3260025,3428630,168605
"6758","ENSBTAG00000011079","18",56859896,56866365,6469
"6759","ENSBTAG00000011080","26",21955756,21962008,6252
"6760","ENSBTAG00000011081","22",34462620,34474389,11769
"6761","ENSBTAG00000011082","5",66191602,66264083,72481
"6762","ENSBTAG00000011083","18",56550376,56572361,21985
"6763","ENSBTAG00000011087","5",34310775,34518431,207656
"6764","ENSBTAG00000011088","22",57784828,57868863,84035
"6765","ENSBTAG00000011091","3",78580351,78701895,121544
"6766","ENSBTAG00000011092","26",50605237,50671512,66275
"6767","ENSBTAG00000011094","24",17841991,17843559,1568
"6768","ENSBTAG00000011095","5",80281585,80337660,56075
"6769","ENSBTAG00000011096","5",80232322,80275610,43288
"6770","ENSBTAG00000011097","3",78522563,78571153,48590
"6771","ENSBTAG00000011098","5",119392379,119450153,57774
"6772","ENSBTAG00000011100","29",7375472,7417234,41762
"6773","ENSBTAG00000011101","11",37435497,37719952,284455
"6774","ENSBTAG00000011102","17",61225406,61284097,58691
"6775","ENSBTAG00000011103","17",61287674,61316764,29090
"6776","ENSBTAG00000011104","11",37722029,37796520,74491
"6777","ENSBTAG00000011105","5",33850777,33865222,14445
"6778","ENSBTAG00000011106","9",98192795,98722419,529624
"6779","ENSBTAG00000011108","28",29476577,29538572,61995
"6780","ENSBTAG00000011110","7",81313802,81354584,40782
"6781","ENSBTAG00000011111","5",103713684,103719840,6156
"6782","ENSBTAG00000011112","23",13060754,13101280,40526
"6783","ENSBTAG00000011113","21",39241174,39242646,1472
"6784","ENSBTAG00000011116","1",126040064,126042144,2080
"6785","ENSBTAG00000011120","4",113721311,113742660,21349
"6786","ENSBTAG00000011121","X",132548507,132617488,68981
"6787","ENSBTAG00000011124","11",103681199,103687920,6721
"6788","ENSBTAG00000011125","7",5883221,5969910,86689
"6789","ENSBTAG00000011126","23",10417325,10458886,41561
"6790","ENSBTAG00000011127","4",99335497,99461007,125510
"6791","ENSBTAG00000011129","11",103691455,103716231,24776
"6792","ENSBTAG00000011131","7",63636150,63653855,17705
"6793","ENSBTAG00000011132","29",9645537,9697688,52151
"6794","ENSBTAG00000011133","2",111898333,111965169,66836
"6795","ENSBTAG00000011134","7",5878528,5882165,3637
"6796","ENSBTAG00000011135","7",5872496,5874573,2077
"6797","ENSBTAG00000011136","7",5859425,5870048,10623
"6798","ENSBTAG00000011137","26",18795089,18808252,13163
"6799","ENSBTAG00000011139","1",101522744,101601660,78916
"6800","ENSBTAG00000011140","1",66820312,66861495,41183
"6801","ENSBTAG00000011143","1",66875768,66944339,68571
"6802","ENSBTAG00000011144","X",35846840,35851741,4901
"6803","ENSBTAG00000011145","4",19041321,19049196,7875
"6804","ENSBTAG00000011146","10",46780500,46850532,70032
"6805","ENSBTAG00000011147","1",118223007,118350034,127027
"6806","ENSBTAG00000011149","29",50871631,50877584,5953
"6807","ENSBTAG00000011150","1",118213388,118220074,6686
"6808","ENSBTAG00000011153","5",15662678,15743168,80490
"6809","ENSBTAG00000011154","11",78628994,78653573,24579
"6810","ENSBTAG00000011155","11",78486240,78601472,115232
"6811","ENSBTAG00000011156","6",61243794,61478178,234384
"6812","ENSBTAG00000011160","8",38437521,38440175,2654
"6813","ENSBTAG00000011161","8",38431578,38431961,383
"6814","ENSBTAG00000011162","25",22823163,22836634,13471
"6815","ENSBTAG00000011163","6",104144869,104151818,6949
"6816","ENSBTAG00000011164","18",24682781,24710853,28072
"6817","ENSBTAG00000011170","6",103013174,103169423,156249
"6818","ENSBTAG00000011171","24",42247107,42451865,204758
"6819","ENSBTAG00000011172","11",10889460,11079798,190338
"6820","ENSBTAG00000011173","8",45469516,45532469,62953
"6821","ENSBTAG00000011176","11",10874115,10880817,6702
"6822","ENSBTAG00000011178","22",47051292,47066805,15513
"6823","ENSBTAG00000011179","9",104110949,104116975,6026
"6824","ENSBTAG00000011180","22",47032971,47056658,23687
"6825","ENSBTAG00000011182","26",16743883,16784813,40930
"6826","ENSBTAG00000011184","29",40477517,40480266,2749
"6827","ENSBTAG00000011185","21",7418429,7576775,158346
"6828","ENSBTAG00000011186","29",40467592,40477419,9827
"6829","ENSBTAG00000011187","6",35721146,36031040,309894
"6830","ENSBTAG00000011189","23",17028383,17052411,24028
"6831","ENSBTAG00000011190","X",37397604,37422791,25187
"6832","ENSBTAG00000011192","1",116756155,116798069,41914
"6833","ENSBTAG00000011193","2",130181311,130185682,4371
"6834","ENSBTAG00000011195","2",130178487,130179596,1109
"6835","ENSBTAG00000011196","2",130166509,130173608,7099
"6836","ENSBTAG00000011197","26",765303,816547,51244
"6837","ENSBTAG00000011198","17",54567784,54586904,19120
"6838","ENSBTAG00000011200","3",52252198,52348486,96288
"6839","ENSBTAG00000011202","8",84481296,84497538,16242
"6840","ENSBTAG00000011203","14",22335447,22344612,9165
"6841","ENSBTAG00000011204","8",84504860,84516124,11264
"6842","ENSBTAG00000011205","14",31135385,31180312,44927
"6843","ENSBTAG00000011206","24",21374863,21455432,80569
"6844","ENSBTAG00000011207","7",15883405,15891295,7890
"6845","ENSBTAG00000011209","3",14871960,14949656,77696
"6846","ENSBTAG00000011212","18",48383247,48396141,12894
"6847","ENSBTAG00000011214","16",46777968,46783678,5710
"6848","ENSBTAG00000011215","18",48402709,48476443,73734
"6849","ENSBTAG00000011217","16",46707282,46777605,70323
"6850","ENSBTAG00000011224","9",77046182,77048572,2390
"6851","ENSBTAG00000011225","10",44057645,44070733,13088
"6852","ENSBTAG00000011226","4",113636352,113654163,17811
"6853","ENSBTAG00000011227","15",7313385,7472045,158660
"6854","ENSBTAG00000011228","4",113651548,113656055,4507
"6855","ENSBTAG00000011229","4",113656380,113658879,2499
"6856","ENSBTAG00000011234","9",41522588,41620269,97681
"6857","ENSBTAG00000011236","9",81523929,81574347,50418
"6858","ENSBTAG00000011237","23",24075070,24509308,434238
"6859","ENSBTAG00000011238","3",8901877,8932543,30666
"6860","ENSBTAG00000011239","21",22328984,22362069,33085
"6861","ENSBTAG00000011240","4",113192316,113193196,880
"6862","ENSBTAG00000011241","3",100731586,100733237,1651
"6863","ENSBTAG00000011242","3",100722449,100731011,8562
"6864","ENSBTAG00000011243","3",100717214,100731168,13954
"6865","ENSBTAG00000011244","3",100579652,100718934,139282
"6866","ENSBTAG00000011245","5",23915775,24071389,155614
"6867","ENSBTAG00000011246","4",53771530,54076899,305369
"6868","ENSBTAG00000011247","4",93819542,93835784,16242
"6869","ENSBTAG00000011248","29",28246104,28276051,29947
"6870","ENSBTAG00000011249","29",49990564,50043414,52850
"6871","ENSBTAG00000011250","24",42810257,42829665,19408
"6872","ENSBTAG00000011252","7",21765855,21873259,107404
"6873","ENSBTAG00000011256","2",79795528,79994785,199257
"6874","ENSBTAG00000011257","27",19211654,19243281,31627
"6875","ENSBTAG00000011258","X",119474570,119503789,29219
"6876","ENSBTAG00000011263","13",64544773,64553147,8374
"6877","ENSBTAG00000011266","15",24583310,24781391,198081
"6878","ENSBTAG00000011267","1",117161151,117204819,43668
"6879","ENSBTAG00000011268","14",73535796,73569953,34157
"6880","ENSBTAG00000011271","14",63707070,63789288,82218
"6881","ENSBTAG00000011273","5",103546873,103554354,7481
"6882","ENSBTAG00000011274","5",103538156,103547189,9033
"6883","ENSBTAG00000011275","5",113976803,114102640,125837
"6884","ENSBTAG00000011277","X",42168528,42169311,783
"6885","ENSBTAG00000011278","22",11776966,11816612,39646
"6886","ENSBTAG00000011279","13",73636222,73651078,14856
"6887","ENSBTAG00000011280","19",38748410,38764622,16212
"6888","ENSBTAG00000011283","13",73649289,73659384,10095
"6889","ENSBTAG00000011284","3",16473115,16477147,4032
"6890","ENSBTAG00000011285","16",66131785,66166490,34705
"6891","ENSBTAG00000011287","22",37470887,37559158,88271
"6892","ENSBTAG00000011290","14",66694629,66695102,473
"6893","ENSBTAG00000011291","X",79947017,80000894,53877
"6894","ENSBTAG00000011292","17",72327212,72339983,12771
"6895","ENSBTAG00000011298","14",34786252,35146514,360262
"6896","ENSBTAG00000011304","13",40615497,40678291,62794
"6897","ENSBTAG00000011305","1",81254282,81273853,19571
"6898","ENSBTAG00000011307","11",98822624,98866066,43442
"6899","ENSBTAG00000011310","X",80931538,80960201,28663
"6900","ENSBTAG00000011311","22",52548484,52585071,36587
"6901","ENSBTAG00000011313","9",60369226,60403669,34443
"6902","ENSBTAG00000011315","9",60351728,60360012,8284
"6903","ENSBTAG00000011316","3",108403027,108412520,9493
"6904","ENSBTAG00000011317","11",98866668,98883294,16626
"6905","ENSBTAG00000011319","10",51347928,51390892,42964
"6906","ENSBTAG00000011321","8",10720463,10767022,46559
"6907","ENSBTAG00000011322","3",29399811,29449947,50136
"6908","ENSBTAG00000011324","11",72551220,72559504,8284
"6909","ENSBTAG00000011325","11",72537265,72549970,12705
"6910","ENSBTAG00000011327","3",29390850,29394608,3758
"6911","ENSBTAG00000011332","15",50412931,50427053,14122
"6912","ENSBTAG00000011333","22",7736043,7908960,172917
"6913","ENSBTAG00000011334","20",37998818,38044180,45362
"6914","ENSBTAG00000011336","5",9754283,9927119,172836
"6915","ENSBTAG00000011337","20",62607952,62702998,95046
"6916","ENSBTAG00000011338","10",2213062,2245525,32463
"6917","ENSBTAG00000011339","23",15794648,15814397,19749
"6918","ENSBTAG00000011340","16",70771022,70806428,35406
"6919","ENSBTAG00000011343","19",25148636,25166951,18315
"6920","ENSBTAG00000011344","22",47999883,48051428,51545
"6921","ENSBTAG00000011345","22",47877481,47992605,115124
"6922","ENSBTAG00000011349","10",21801644,21812292,10648
"6923","ENSBTAG00000011350","X",36813509,36823266,9757
"6924","ENSBTAG00000011351","7",43523685,43530420,6735
"6925","ENSBTAG00000011352","5",48952181,49035846,83665
"6926","ENSBTAG00000011354","6",102320394,102357766,37372
"6927","ENSBTAG00000011356","7",16447830,16464459,16629
"6928","ENSBTAG00000011358","23",28284912,28286183,1271
"6929","ENSBTAG00000011359","19",50542282,50545928,3646
"6930","ENSBTAG00000011360","7",16450200,16474545,24345
"6931","ENSBTAG00000011363","3",50677521,50918603,241082
"6932","ENSBTAG00000011366","13",31734865,31896009,161144
"6933","ENSBTAG00000011367","5",10351190,10506727,155537
"6934","ENSBTAG00000011368","26",15851397,15877096,25699
"6935","ENSBTAG00000011370","29",44174048,44174260,212
"6936","ENSBTAG00000011373","17",17836577,18018432,181855
"6937","ENSBTAG00000011374","8",89122679,89135893,13214
"6938","ENSBTAG00000011375","8",88931759,89113202,181443
"6939","ENSBTAG00000011377","1",88158304,88194815,36511
"6940","ENSBTAG00000011379","10",74940464,75324906,384442
"6941","ENSBTAG00000011381","11",72374144,72382875,8731
"6942","ENSBTAG00000011382","19",56653907,56671068,17161
"6943","ENSBTAG00000011383","1",69887221,69946638,59417
"6944","ENSBTAG00000011384","17",60228521,60317552,89031
"6945","ENSBTAG00000011388","8",59358080,59361681,3601
"6946","ENSBTAG00000011389","19",56577202,56647063,69861
"6947","ENSBTAG00000011390","2",120166846,120174104,7258
"6948","ENSBTAG00000011392","5",65398362,65500279,101917
"6949","ENSBTAG00000011394","8",59362241,59373813,11572
"6950","ENSBTAG00000011395","5",77144456,77205083,60627
"6951","ENSBTAG00000011396","10",25880971,25925727,44756
"6952","ENSBTAG00000011397","8",59373966,59599764,225798
"6953","ENSBTAG00000011398","7",38952342,38953698,1356
"6954","ENSBTAG00000011399","5",77131742,77158404,26662
"6955","ENSBTAG00000011400","7",38954347,38995645,41298
"6956","ENSBTAG00000011401","26",37606719,37687376,80657
"6957","ENSBTAG00000011402","8",59637289,59710590,73301
"6958","ENSBTAG00000011403","8",59723669,59785504,61835
"6959","ENSBTAG00000011405","20",71491866,71529187,37321
"6960","ENSBTAG00000011406","8",59795969,59801419,5450
"6961","ENSBTAG00000011409","8",59799960,59808752,8792
"6962","ENSBTAG00000011411","8",59827546,59829096,1550
"6963","ENSBTAG00000011412","4",48985684,49062759,77075
"6964","ENSBTAG00000011413","8",59833726,59836253,2527
"6965","ENSBTAG00000011414","1",83002134,83012323,10189
"6966","ENSBTAG00000011415","7",49858047,49886144,28097
"6967","ENSBTAG00000011416","8",59836548,59840144,3596
"6968","ENSBTAG00000011417","8",110506203,110535129,28926
"6969","ENSBTAG00000011419","7",49894161,49909804,15643
"6970","ENSBTAG00000011420","8",59849175,59855369,6194
"6971","ENSBTAG00000011421","18",55821902,55827357,5455
"6972","ENSBTAG00000011423","1",99995832,100031888,36056
"6973","ENSBTAG00000011424","8",59856503,59864645,8142
"6974","ENSBTAG00000011425","13",52139610,52310545,170935
"6975","ENSBTAG00000011429","8",59901572,59905938,4366
"6976","ENSBTAG00000011431","8",59901585,59921540,19955
"6977","ENSBTAG00000011433","8",59917058,59922869,5811
"6978","ENSBTAG00000011434","8",59956219,59974722,18503
"6979","ENSBTAG00000011435","19",38823897,38928029,104132
"6980","ENSBTAG00000011437","1",143512564,143523992,11428
"6981","ENSBTAG00000011439","10",38404680,38424273,19593
"6982","ENSBTAG00000011441","18",60655738,60656231,493
"6983","ENSBTAG00000011442","8",59974305,59977270,2965
"6984","ENSBTAG00000011444","8",59979689,59981974,2285
"6985","ENSBTAG00000011445","8",60003644,60027284,23640
"6986","ENSBTAG00000011446","21",34234871,34258160,23289
"6987","ENSBTAG00000011447","19",44156311,44167029,10718
"6988","ENSBTAG00000011451","10",71781858,72109539,327681
"6989","ENSBTAG00000011454","19",42006042,42014027,7985
"6990","ENSBTAG00000011455","29",43477495,43504482,26987
"6991","ENSBTAG00000011456","19",42015614,42041251,25637
"6992","ENSBTAG00000011458","13",52381587,52390072,8485
"6993","ENSBTAG00000011459","19",42024526,42037110,12584
"6994","ENSBTAG00000011461","16",915106,956850,41744
"6995","ENSBTAG00000011463","X",104474452,104476230,1778
"6996","ENSBTAG00000011465","16",957169,965458,8289
"6997","ENSBTAG00000011466","12",85224846,85238032,13186
"6998","ENSBTAG00000011467","29",43205606,43212737,7131
"6999","ENSBTAG00000011470","25",36276522,36283249,6727
"7000","ENSBTAG00000011471","12",85238266,85258334,20068
"7001","ENSBTAG00000011473","13",65646954,65655870,8916
"7002","ENSBTAG00000011478","22",52133185,52149780,16595
"7003","ENSBTAG00000011479","19",22622695,22641597,18902
"7004","ENSBTAG00000011480","19",22646310,22678320,32010
"7005","ENSBTAG00000011481","7",5124965,5142553,17588
"7006","ENSBTAG00000011482","19",22690663,22730143,39480
"7007","ENSBTAG00000011483","19",22738997,22749219,10222
"7008","ENSBTAG00000011484","22",54204473,54261834,57361
"7009","ENSBTAG00000011487","26",34217848,34240431,22583
"7010","ENSBTAG00000011488","19",22753897,22786458,32561
"7011","ENSBTAG00000011489","26",21892282,21895537,3255
"7012","ENSBTAG00000011490","19",22805337,22807839,2502
"7013","ENSBTAG00000011491","19",22820015,22831944,11929
"7014","ENSBTAG00000011494","10",43742881,43797321,54440
"7015","ENSBTAG00000011495","1",146121832,146241261,119429
"7016","ENSBTAG00000011496","7",8056664,8057662,998
"7017","ENSBTAG00000011498","23",31172787,31184917,12130
"7018","ENSBTAG00000011500","3",27540536,27611173,70637
"7019","ENSBTAG00000011504","25",19019168,19030962,11794
"7020","ENSBTAG00000011505","19",26149862,26246571,96709
"7021","ENSBTAG00000011507","19",26128009,26149670,21661
"7022","ENSBTAG00000011509","9",94662572,94714692,52120
"7023","ENSBTAG00000011511","3",10700383,10745178,44795
"7024","ENSBTAG00000011514","2",112068965,112076912,7947
"7025","ENSBTAG00000011515","16",37340131,37366443,26312
"7026","ENSBTAG00000011516","14",60035526,60126246,90720
"7027","ENSBTAG00000011517","18",61893703,61897283,3580
"7028","ENSBTAG00000011518","27",40197883,40381619,183736
"7029","ENSBTAG00000011524","1",126593243,126700958,107715
"7030","ENSBTAG00000011525","5",65045132,65111413,66281
"7031","ENSBTAG00000011527","19",56318393,56320652,2259
"7032","ENSBTAG00000011528","1",1102887,1118312,15425
"7033","ENSBTAG00000011529","1",126471505,126591861,120356
"7034","ENSBTAG00000011530","18",14257853,14277025,19172
"7035","ENSBTAG00000011531","24",30670051,30746241,76190
"7036","ENSBTAG00000011532","19",39301906,39322135,20229
"7037","ENSBTAG00000011533","18",14277507,14282248,4741
"7038","ENSBTAG00000011534","3",117279522,117320622,41100
"7039","ENSBTAG00000011538","3",120040007,120127795,87788
"7040","ENSBTAG00000011539","19",39328390,39340373,11983
"7041","ENSBTAG00000011540","10",11906117,11926485,20368
"7042","ENSBTAG00000011541","13",66015527,66074535,59008
"7043","ENSBTAG00000011543","3",120837823,120848740,10917
"7044","ENSBTAG00000011544","11",96142850,96214312,71462
"7045","ENSBTAG00000011545","8",48359127,48483138,124011
"7046","ENSBTAG00000011547","22",59577454,59628363,50909
"7047","ENSBTAG00000011548","3",28641073,28658760,17687
"7048","ENSBTAG00000011549","15",51515409,51553384,37975
"7049","ENSBTAG00000011551","22",16985219,17006258,21039
"7050","ENSBTAG00000011553","11",2153786,2164529,10743
"7051","ENSBTAG00000011554","11",104240172,104246931,6759
"7052","ENSBTAG00000011556","11",104249112,104255687,6575
"7053","ENSBTAG00000011558","11",2164621,2174030,9409
"7054","ENSBTAG00000011559","11",104255845,104259161,3316
"7055","ENSBTAG00000011562","26",51855015,51927423,72408
"7056","ENSBTAG00000011563","12",83641466,83672595,31129
"7057","ENSBTAG00000011567","10",36433611,36442758,9147
"7058","ENSBTAG00000011569","1",116033356,116050220,16864
"7059","ENSBTAG00000011571","10",21762262,21800719,38457
"7060","ENSBTAG00000011572","14",66852944,66854263,1319
"7061","ENSBTAG00000011573","27",14707896,14785230,77334
"7062","ENSBTAG00000011575","19",50821475,50826744,5269
"7063","ENSBTAG00000011578","15",65649433,65737462,88029
"7064","ENSBTAG00000011579","29",41222284,41232735,10451
"7065","ENSBTAG00000011580","22",50616593,50663265,46672
"7066","ENSBTAG00000011581","22",50533323,50568056,34733
"7067","ENSBTAG00000011583","22",50515197,50525786,10589
"7068","ENSBTAG00000011584","1",125870591,125874332,3741
"7069","ENSBTAG00000011585","22",50509885,50514786,4901
"7070","ENSBTAG00000011586","8",83156981,83193125,36144
"7071","ENSBTAG00000011587","26",45938326,46185629,247303
"7072","ENSBTAG00000011588","22",50484030,50507304,23274
"7073","ENSBTAG00000011589","8",83197226,83326847,129621
"7074","ENSBTAG00000011590","5",4987628,5034033,46405
"7075","ENSBTAG00000011591","5",5033423,5047918,14495
"7076","ENSBTAG00000011593","9",98820539,98975050,154511
"7077","ENSBTAG00000011595","22",50443820,50481306,37486
"7078","ENSBTAG00000011596","10",81495740,81501121,5381
"7079","ENSBTAG00000011597","12",28312936,28495424,182488
"7080","ENSBTAG00000011600","13",35293958,35321804,27846
"7081","ENSBTAG00000011601","11",48977897,49034683,56786
"7082","ENSBTAG00000011602","7",7691747,7703977,12230
"7083","ENSBTAG00000011608","10",5012186,5025730,13544
"7084","ENSBTAG00000011611","6",16632776,16644454,11678
"7085","ENSBTAG00000011613","X",64140186,64236961,96775
"7086","ENSBTAG00000011614","14",30111614,30127822,16208
"7087","ENSBTAG00000011616","19",9247562,9259279,11717
"7088","ENSBTAG00000011617","18",55352451,55358245,5794
"7089","ENSBTAG00000011619","18",55359116,55372769,13653
"7090","ENSBTAG00000011620","13",63920854,64011921,91067
"7091","ENSBTAG00000011621","18",55373388,55376353,2965
"7092","ENSBTAG00000011622","24",21138256,21146253,7997
"7093","ENSBTAG00000011623","19",10674179,10802801,128622
"7094","ENSBTAG00000011624","18",55382972,55384709,1737
"7095","ENSBTAG00000011625","2",129115781,129121108,5327
"7096","ENSBTAG00000011626","1",138872223,139026120,153897
"7097","ENSBTAG00000011628","22",905960,1121554,215594
"7098","ENSBTAG00000011632","18",12973616,12986923,13307
"7099","ENSBTAG00000011634","1",137242683,137294481,51798
"7100","ENSBTAG00000011635","18",7700533,7719809,19276
"7101","ENSBTAG00000011636","29",12723282,12728390,5108
"7102","ENSBTAG00000011638","13",53538138,53538619,481
"7103","ENSBTAG00000011639","7",43656058,43670433,14375
"7104","ENSBTAG00000011640","3",89608083,89696904,88821
"7105","ENSBTAG00000011642","7",57417458,57475501,58043
"7106","ENSBTAG00000011643","11",21308259,21434854,126595
"7107","ENSBTAG00000011644","10",18399009,18628833,229824
"7108","ENSBTAG00000011645","1",143261977,143274941,12964
"7109","ENSBTAG00000011646","13",53879286,53887495,8209
"7110","ENSBTAG00000011647","12",21783841,21814435,30594
"7111","ENSBTAG00000011648","X",35551796,35602890,51094
"7112","ENSBTAG00000011649","2",110746220,110820175,73955
"7113","ENSBTAG00000011651","26",13028066,13101803,73737
"7114","ENSBTAG00000011654","12",21738590,21779227,40637
"7115","ENSBTAG00000011655","13",53872334,53877893,5559
"7116","ENSBTAG00000011656","13",53832190,53871572,39382
"7117","ENSBTAG00000011657","20",30363489,30367934,4445
"7118","ENSBTAG00000011658","2",1322993,1352673,29680
"7119","ENSBTAG00000011659","1",71415019,71440654,25635
"7120","ENSBTAG00000011660","28",44061316,44071826,10510
"7121","ENSBTAG00000011661","10",61437230,61529573,92343
"7122","ENSBTAG00000011662","13",53823431,53825284,1853
"7123","ENSBTAG00000011666","29",17989041,17994955,5914
"7124","ENSBTAG00000011667","9",60958094,60971066,12972
"7125","ENSBTAG00000011668","29",18019943,18026164,6221
"7126","ENSBTAG00000011671","23",31844641,31849982,5341
"7127","ENSBTAG00000011672","9",60845210,60946360,101150
"7128","ENSBTAG00000011677","23",31876303,31878150,1847
"7129","ENSBTAG00000011680","10",84702266,84737572,35306
"7130","ENSBTAG00000011682","2",72712261,72753189,40928
"7131","ENSBTAG00000011683","10",84739671,84901657,161986
"7132","ENSBTAG00000011684","27",33119234,33151979,32745
"7133","ENSBTAG00000011689","18",62878755,62888679,9924
"7134","ENSBTAG00000011692","25",13881225,14026239,145014
"7135","ENSBTAG00000011693","18",62888724,62890331,1607
"7136","ENSBTAG00000011694","28",44014883,44035987,21104
"7137","ENSBTAG00000011698","7",14876119,14905841,29722
"7138","ENSBTAG00000011699","7",14926944,14938212,11268
"7139","ENSBTAG00000011700","18",25260164,25290238,30074
"7140","ENSBTAG00000011702","22",13227438,13261914,34476
"7141","ENSBTAG00000011704","13",62630366,62630795,429
"7142","ENSBTAG00000011706","16",56545152,56764975,219823
"7143","ENSBTAG00000011709","14",80902821,80922354,19533
"7144","ENSBTAG00000011713","19",55946579,55960796,14217
"7145","ENSBTAG00000011715","19",55916749,55945997,29248
"7146","ENSBTAG00000011717","19",55881837,55915877,34040
"7147","ENSBTAG00000011719","23",5119756,5251967,132211
"7148","ENSBTAG00000011720","5",56674172,56696104,21932
"7149","ENSBTAG00000011721","19",11057705,11151673,93968
"7150","ENSBTAG00000011723","18",51195286,51245902,50616
"7151","ENSBTAG00000011726","12",35929014,35985473,56459
"7152","ENSBTAG00000011727","11",65838846,65852520,13674
"7153","ENSBTAG00000011729","19",40015508,40043108,27600
"7154","ENSBTAG00000011730","19",40041901,40043107,1206
"7155","ENSBTAG00000011731","19",40044371,40046543,2172
"7156","ENSBTAG00000011732","19",40047113,40061042,13929
"7157","ENSBTAG00000011733","3",66535129,66637864,102735
"7158","ENSBTAG00000011734","26",12533095,12542796,9701
"7159","ENSBTAG00000011736","19",37503490,37543759,40269
"7160","ENSBTAG00000011738","25",35934903,35946171,11268
"7161","ENSBTAG00000011740","26",17684303,17698885,14582
"7162","ENSBTAG00000011741","28",26096194,26246128,149934
"7163","ENSBTAG00000011742","1",96395573,96426824,31251
"7164","ENSBTAG00000011743","26",17703169,17846407,143238
"7165","ENSBTAG00000011744","25",20741670,20818673,77003
"7166","ENSBTAG00000011748","26",8700589,9024462,323873
"7167","ENSBTAG00000011752","21",7581549,7606637,25088
"7168","ENSBTAG00000011753","25",32669753,32693617,23864
"7169","ENSBTAG00000011754","3",14709191,14713057,3866
"7170","ENSBTAG00000011757","10",84619690,84686874,67184
"7171","ENSBTAG00000011758","5",104357908,104359452,1544
"7172","ENSBTAG00000011759","19",44658033,44665380,7347
"7173","ENSBTAG00000011761","5",97526603,97700083,173480
"7174","ENSBTAG00000011762","5",57074995,57086731,11736
"7175","ENSBTAG00000011763","7",96602708,96624452,21744
"7176","ENSBTAG00000011765","5",99764511,99773990,9479
"7177","ENSBTAG00000011766","20",33535937,33593157,57220
"7178","ENSBTAG00000011767","10",79127657,79238619,110962
"7179","ENSBTAG00000011770","8",45284977,45412774,127797
"7180","ENSBTAG00000011771","17",64408095,64412616,4521
"7181","ENSBTAG00000011772","16",80138744,80301780,163036
"7182","ENSBTAG00000011779","14",44987026,45020255,33229
"7183","ENSBTAG00000011780","X",26759608,26762121,2513
"7184","ENSBTAG00000011782","13",48069187,48084157,14970
"7185","ENSBTAG00000011783","X",102871366,102872059,693
"7186","ENSBTAG00000011784","2",125688547,125709381,20834
"7187","ENSBTAG00000011785","16",27556059,27591825,35766
"7188","ENSBTAG00000011786","19",23586772,23608018,21246
"7189","ENSBTAG00000011787","17",64357119,64363222,6103
"7190","ENSBTAG00000011788","X",102845418,102865145,19727
"7191","ENSBTAG00000011789","6",72173295,72331847,158552
"7192","ENSBTAG00000011790","X",102781099,102841483,60384
"7193","ENSBTAG00000011793","15",20445067,20494938,49871
"7194","ENSBTAG00000011795","22",60417817,60442172,24355
"7195","ENSBTAG00000011796","10",73110976,73121588,10612
"7196","ENSBTAG00000011798","5",82567378,82646675,79297
"7197","ENSBTAG00000011800","15",29730979,29745435,14456
"7198","ENSBTAG00000011802","1",145668949,145687210,18261
"7199","ENSBTAG00000011803","19",29601526,29622481,20955
"7200","ENSBTAG00000011804","5",82469958,82557915,87957
"7201","ENSBTAG00000011805","7",19291174,19311897,20723
"7202","ENSBTAG00000011808","2",6278630,6285486,6856
"7203","ENSBTAG00000011810","11",97835687,97858358,22671
"7204","ENSBTAG00000011811","7",12788981,12806281,17300
"7205","ENSBTAG00000011812","20",17003461,17018595,15134
"7206","ENSBTAG00000011814","8",83951574,84187164,235590
"7207","ENSBTAG00000011815","18",51935729,51956086,20357
"7208","ENSBTAG00000011816","29",45482026,45485782,3756
"7209","ENSBTAG00000011817","6",64820535,64960787,140252
"7210","ENSBTAG00000011818","25",35220789,35383571,162782
"7211","ENSBTAG00000011819","4",19065677,19077110,11433
"7212","ENSBTAG00000011820","10",45948472,46088593,140121
"7213","ENSBTAG00000011822","3",101292352,101355267,62915
"7214","ENSBTAG00000011823","16",43747735,43786671,38936
"7215","ENSBTAG00000011824","8",84019514,84035380,15866
"7216","ENSBTAG00000011825","7",12780995,12784168,3173
"7217","ENSBTAG00000011826","5",109353912,109361691,7779
"7218","ENSBTAG00000011828","21",34083678,34131883,48205
"7219","ENSBTAG00000011829","19",18763113,18873847,110734
"7220","ENSBTAG00000011830","29",45808029,45808477,448
"7221","ENSBTAG00000011831","10",59575781,59628437,52656
"7222","ENSBTAG00000011832","26",17088627,17129756,41129
"7223","ENSBTAG00000011833","X",7567436,7876396,308960
"7224","ENSBTAG00000011834","19",48011800,48032907,21107
"7225","ENSBTAG00000011836","8",84044974,84052939,7965
"7226","ENSBTAG00000011837","7",12771105,12819792,48687
"7227","ENSBTAG00000011838","5",33019566,33169810,150244
"7228","ENSBTAG00000011839","20",31431008,31456871,25863
"7229","ENSBTAG00000011841","26",17135122,17156089,20967
"7230","ENSBTAG00000011842","7",18541354,18546361,5007
"7231","ENSBTAG00000011843","29",40915995,40927583,11588
"7232","ENSBTAG00000011844","18",59375765,59378104,2339
"7233","ENSBTAG00000011846","29",40927672,40937085,9413
"7234","ENSBTAG00000011847","8",84067290,84092633,25343
"7235","ENSBTAG00000011849","9",36449731,36485327,35596
"7236","ENSBTAG00000011850","12",24694524,24722674,28150
"7237","ENSBTAG00000011851","9",38628871,38780948,152077
"7238","ENSBTAG00000011854","X",86584143,86593327,9184
"7239","ENSBTAG00000011855","12",24685659,24694910,9251
"7240","ENSBTAG00000011857","5",50634073,50938091,304018
"7241","ENSBTAG00000011859","8",84187019,84246783,59764
"7242","ENSBTAG00000011860","12",24646355,24685566,39211
"7243","ENSBTAG00000011861","21",26838739,26963009,124270
"7244","ENSBTAG00000011862","12",477004,480875,3871
"7245","ENSBTAG00000011864","7",98014274,98032844,18570
"7246","ENSBTAG00000011865","29",40939621,40948257,8636
"7247","ENSBTAG00000011866","28",27067751,27072908,5157
"7248","ENSBTAG00000011869","29",25744105,25764911,20806
"7249","ENSBTAG00000011871","1",57228945,57261728,32783
"7250","ENSBTAG00000011872","29",40948278,40957330,9052
"7251","ENSBTAG00000011873","15",53809296,53809595,299
"7252","ENSBTAG00000011874","8",44618781,44622489,3708
"7253","ENSBTAG00000011875","25",33057243,33109136,51893
"7254","ENSBTAG00000011876","1",148604900,148639711,34811
"7255","ENSBTAG00000011879","3",102069299,102079762,10463
"7256","ENSBTAG00000011880","1",148657613,148683915,26302
"7257","ENSBTAG00000011881","3",16032551,16081469,48918
"7258","ENSBTAG00000011882","13",38891310,39323725,432415
"7259","ENSBTAG00000011883","5",65275298,65284728,9430
"7260","ENSBTAG00000011885","20",31154175,31245748,91573
"7261","ENSBTAG00000011887","18",46035958,46049444,13486
"7262","ENSBTAG00000011888","3",102065404,102069070,3666
"7263","ENSBTAG00000011889","17",45015310,45021074,5764
"7264","ENSBTAG00000011890","9",33951758,33965043,13285
"7265","ENSBTAG00000011892","5",49582752,49890496,307744
"7266","ENSBTAG00000011893","24",46800380,46847451,47071
"7267","ENSBTAG00000011894","22",50803150,50809723,6573
"7268","ENSBTAG00000011895","20",305642,327561,21919
"7269","ENSBTAG00000011896","22",57706518,57766842,60324
"7270","ENSBTAG00000011898","29",46849877,46917259,67382
"7271","ENSBTAG00000011899","22",50762625,50803467,40842
"7272","ENSBTAG00000011902","5",106998953,107014573,15620
"7273","ENSBTAG00000011904","X",37161313,37182132,20819
"7274","ENSBTAG00000011905","15",38367194,38444339,77145
"7275","ENSBTAG00000011908","14",66989157,67551536,562379
"7276","ENSBTAG00000011909","2",38466454,38597910,131456
"7277","ENSBTAG00000011910","15",43963328,44152165,188837
"7278","ENSBTAG00000011912","11",98712579,98748930,36351
"7279","ENSBTAG00000011913","5",69631578,69639265,7687
"7280","ENSBTAG00000011914","15",39680167,39681702,1535
"7281","ENSBTAG00000011916","10",59758633,59849849,91216
"7282","ENSBTAG00000011917","26",32687779,32753080,65301
"7283","ENSBTAG00000011918","5",57538198,57541849,3651
"7284","ENSBTAG00000011921","1",58926907,58945271,18364
"7285","ENSBTAG00000011922","14",839972,896647,56675
"7286","ENSBTAG00000011924","17",61167481,61176138,8657
"7287","ENSBTAG00000011925","10",25534347,25535294,947
"7288","ENSBTAG00000011927","5",57533663,57537461,3798
"7289","ENSBTAG00000011928","1",58975735,59030035,54300
"7290","ENSBTAG00000011929","10",59775598,59796120,20522
"7291","ENSBTAG00000011930","17",61176579,61194317,17738
"7292","ENSBTAG00000011931","5",57528943,57532768,3825
"7293","ENSBTAG00000011932","16",67381599,67398481,16882
"7294","ENSBTAG00000011934","10",21036261,21044548,8287
"7295","ENSBTAG00000011935","6",88625427,88682025,56598
"7296","ENSBTAG00000011936","10",60137819,60430447,292628
"7297","ENSBTAG00000011937","17",61195558,61199902,4344
"7298","ENSBTAG00000011938","7",52392586,52393491,905
"7299","ENSBTAG00000011939","14",1359669,1363525,3856
"7300","ENSBTAG00000011940","13",57147352,57251774,104422
"7301","ENSBTAG00000011941","5",44119611,44125565,5954
"7302","ENSBTAG00000011944","6",25005876,25062589,56713
"7303","ENSBTAG00000011946","16",67461867,67498396,36529
"7304","ENSBTAG00000011950","2",133406871,133434408,27537
"7305","ENSBTAG00000011951","2",133405836,133411304,5468
"7306","ENSBTAG00000011952","6",85309030,85365114,56084
"7307","ENSBTAG00000011953","3",59884333,60026329,141996
"7308","ENSBTAG00000011954","24",58152176,58163481,11305
"7309","ENSBTAG00000011956","26",20337662,20409706,72044
"7310","ENSBTAG00000011957","5",97173598,97203053,29455
"7311","ENSBTAG00000011959","5",97139728,97163152,23424
"7312","ENSBTAG00000011960","26",20416120,20440477,24357
"7313","ENSBTAG00000011961","6",88915320,88925227,9907
"7314","ENSBTAG00000011962","17",69982739,69988677,5938
"7315","ENSBTAG00000011963","18",51355174,51363304,8130
"7316","ENSBTAG00000011964","2",119630438,119987217,356779
"7317","ENSBTAG00000011966","16",64062643,64183738,121095
"7318","ENSBTAG00000011969","25",34345339,34347009,1670
"7319","ENSBTAG00000011970","17",40112134,40236065,123931
"7320","ENSBTAG00000011971","2",94028625,94145404,116779
"7321","ENSBTAG00000011973","6",37315442,37320955,5513
"7322","ENSBTAG00000011975","23",50820672,50829829,9157
"7323","ENSBTAG00000011976","3",99337603,99358612,21009
"7324","ENSBTAG00000011981","14",30827578,30862362,34784
"7325","ENSBTAG00000011982","16",70845328,70859124,13796
"7326","ENSBTAG00000011984","19",20056746,20060305,3559
"7327","ENSBTAG00000011985","10",86881618,86895721,14103
"7328","ENSBTAG00000011986","1",122257891,122300144,42253
"7329","ENSBTAG00000011987","10",86908115,86916703,8588
"7330","ENSBTAG00000011988","19",20060814,20088152,27338
"7331","ENSBTAG00000011990","19",26697231,26705809,8578
"7332","ENSBTAG00000011991","28",43579136,43610753,31617
"7333","ENSBTAG00000011992","2",96667717,96752328,84611
"7334","ENSBTAG00000011994","19",28004031,28087154,83123
"7335","ENSBTAG00000011995","18",2564597,2567928,3331
"7336","ENSBTAG00000011997","4",76730454,76748161,17707
"7337","ENSBTAG00000011998","10",62059579,62071091,11512
"7338","ENSBTAG00000012002","18",2573410,2610924,37514
"7339","ENSBTAG00000012003","4",76709520,76713230,3710
"7340","ENSBTAG00000012004","10",87237844,87271480,33636
"7341","ENSBTAG00000012005","10",87263348,87371765,108417
"7342","ENSBTAG00000012007","5",23367712,23380477,12765
"7343","ENSBTAG00000012010","29",614967,671409,56442
"7344","ENSBTAG00000012012","24",4141580,4175476,33896
"7345","ENSBTAG00000012014","7",61521982,61539126,17144
"7346","ENSBTAG00000012015","10",35227930,35436219,208289
"7347","ENSBTAG00000012016","18",55157328,55178870,21542
"7348","ENSBTAG00000012019","12",84650925,84655079,4154
"7349","ENSBTAG00000012020","16",71996522,72041299,44777
"7350","ENSBTAG00000012022","21",30372068,30461318,89250
"7351","ENSBTAG00000012023","1",157996922,158004891,7969
"7352","ENSBTAG00000012024","29",44408904,44418017,9113
"7353","ENSBTAG00000012025","3",3653710,3828022,174312
"7354","ENSBTAG00000012026","5",100181622,100199602,17980
"7355","ENSBTAG00000012029","5",100504892,100630214,125322
"7356","ENSBTAG00000012030","5",113827081,113862433,35352
"7357","ENSBTAG00000012031","4",113596444,113603315,6871
"7358","ENSBTAG00000012032","7",14946947,14990520,43573
"7359","ENSBTAG00000012034","5",27117923,27124833,6910
"7360","ENSBTAG00000012035","18",34820643,34826221,5578
"7361","ENSBTAG00000012036","8",69428721,69445389,16668
"7362","ENSBTAG00000012037","11",10696134,10730414,34280
"7363","ENSBTAG00000012038","25",35632045,35634312,2267
"7364","ENSBTAG00000012039","23",43276359,43794630,518271
"7365","ENSBTAG00000012040","19",20829405,20843830,14425
"7366","ENSBTAG00000012041","18",14463306,14484611,21305
"7367","ENSBTAG00000012044","18",14490263,14492655,2392
"7368","ENSBTAG00000012046","7",12736091,12737893,1802
"7369","ENSBTAG00000012047","8",39381277,39499024,117747
"7370","ENSBTAG00000012048","7",15319706,15362293,42587
"7371","ENSBTAG00000012049","25",39021133,39045383,24250
"7372","ENSBTAG00000012050","25",34599598,34611518,11920
"7373","ENSBTAG00000012052","2",135262232,135290548,28316
"7374","ENSBTAG00000012053","15",74160726,74173076,12350
"7375","ENSBTAG00000012054","29",45495728,45504514,8786
"7376","ENSBTAG00000012057","15",83029815,83048887,19072
"7377","ENSBTAG00000012058","23",51168216,51604000,435784
"7378","ENSBTAG00000012059","18",13893902,13900564,6662
"7379","ENSBTAG00000012060","24",37140992,37214261,73269
"7380","ENSBTAG00000012061","3",107920730,107922862,2132
"7381","ENSBTAG00000012062","7",12730803,12733440,2637
"7382","ENSBTAG00000012063","18",34827984,34834624,6640
"7383","ENSBTAG00000012064","18",56331952,56338812,6860
"7384","ENSBTAG00000012065","12",73095336,73160534,65198
"7385","ENSBTAG00000012066","19",48541625,48619840,78215
"7386","ENSBTAG00000012067","24",45588443,45716228,127785
"7387","ENSBTAG00000012068","19",11232242,11410164,177922
"7388","ENSBTAG00000012069","23",11373453,11389074,15621
"7389","ENSBTAG00000012070","19",11169421,11225797,56376
"7390","ENSBTAG00000012071","19",26893934,26899708,5774
"7391","ENSBTAG00000012072","29",45559236,45563283,4047
"7392","ENSBTAG00000012073","22",514202,693676,179474
"7393","ENSBTAG00000012074","9",73221494,73257783,36289
"7394","ENSBTAG00000012077","26",21762673,21802182,39509
"7395","ENSBTAG00000012078","4",113407642,113413255,5613
"7396","ENSBTAG00000012079","23",50879055,50953182,74127
"7397","ENSBTAG00000012082","25",2435936,2439695,3759
"7398","ENSBTAG00000012083","18",22615235,22618354,3119
"7399","ENSBTAG00000012084","8",112982692,113000760,18068
"7400","ENSBTAG00000012086","7",66041908,66060222,18314
"7401","ENSBTAG00000012087","23",39461718,39465516,3798
"7402","ENSBTAG00000012088","5",115888383,115968965,80582
"7403","ENSBTAG00000012089","NKLS02002210.1",129596,137470,7874
"7404","ENSBTAG00000012090","11",92317777,92395185,77408
"7405","ENSBTAG00000012094","3",15376265,15381469,5204
"7406","ENSBTAG00000012095","7",66065436,66104566,39130
"7407","ENSBTAG00000012096","9",19804029,20074759,270730
"7408","ENSBTAG00000012097","18",53330303,53350461,20158
"7409","ENSBTAG00000012099","11",319215,361708,42493
"7410","ENSBTAG00000012100","2",14056093,14453673,397580
"7411","ENSBTAG00000012101","18",53350775,53380309,29534
"7412","ENSBTAG00000012102","18",14681557,14704281,22724
"7413","ENSBTAG00000012103","19",30648997,30726936,77939
"7414","ENSBTAG00000012104","18",53384988,53391814,6826
"7415","ENSBTAG00000012106","10",88931675,89062788,131113
"7416","ENSBTAG00000012107","26",20596417,20607094,10677
"7417","ENSBTAG00000012109","13",57061094,57088977,27883
"7418","ENSBTAG00000012111","6",4526911,4777589,250678
"7419","ENSBTAG00000012112","18",35641249,35670751,29502
"7420","ENSBTAG00000012113","NKLS02002210.1",287303,296075,8772
"7421","ENSBTAG00000012116","13",72825552,72853312,27760
"7422","ENSBTAG00000012117","X",37488851,37496788,7937
"7423","ENSBTAG00000012119","4",86301179,86510240,209061
"7424","ENSBTAG00000012120","1",110928202,110955891,27689
"7425","ENSBTAG00000012121","11",106405333,106414269,8936
"7426","ENSBTAG00000012124","20",22017006,22080506,63500
"7427","ENSBTAG00000012125","X",37497182,37503260,6078
"7428","ENSBTAG00000012126","11",106440020,106519303,79283
"7429","ENSBTAG00000012128","4",86516905,86594679,77774
"7430","ENSBTAG00000012132","28",4236177,4236836,659
"7431","ENSBTAG00000012135","17",29525417,29663774,138357
"7432","ENSBTAG00000012137","19",28447224,28649129,201905
"7433","ENSBTAG00000012139","10",72817881,72821235,3354
"7434","ENSBTAG00000012140","1",45082065,45145326,63261
"7435","ENSBTAG00000012141","29",45286731,45292816,6085
"7436","ENSBTAG00000012142","22",17583266,17694050,110784
"7437","ENSBTAG00000012143","21",67161388,67245032,83644
"7438","ENSBTAG00000012144","11",106544913,106554343,9430
"7439","ENSBTAG00000012146","29",45292432,45295929,3497
"7440","ENSBTAG00000012147","11",106565894,106575162,9268
"7441","ENSBTAG00000012148","11",106578900,106687654,108754
"7442","ENSBTAG00000012149","5",26020286,26023408,3122
"7443","ENSBTAG00000012150","7",43930508,43937290,6782
"7444","ENSBTAG00000012152","X",79368092,79381166,13074
"7445","ENSBTAG00000012156","11",98706627,98711496,4869
"7446","ENSBTAG00000012157","6",91226891,91294472,67581
"7447","ENSBTAG00000012158","16",54730528,54762653,32125
"7448","ENSBTAG00000012159","22",59070589,59080201,9612
"7449","ENSBTAG00000012163","X",79330685,79367501,36816
"7450","ENSBTAG00000012164","1",118901381,119012034,110653
"7451","ENSBTAG00000012168","8",38675449,38678766,3317
"7452","ENSBTAG00000012169","29",29562032,29610872,48840
"7453","ENSBTAG00000012170","12",30806229,30854060,47831
"7454","ENSBTAG00000012171","2",85937557,85938651,1094
"7455","ENSBTAG00000012172","7",43688529,43698292,9763
"7456","ENSBTAG00000012176","18",53257192,53263878,6686
"7457","ENSBTAG00000012177","18",53253415,53257036,3621
"7458","ENSBTAG00000012178","19",40389125,40397513,8388
"7459","ENSBTAG00000012180","10",35737731,35757288,19557
"7460","ENSBTAG00000012181","7",20694784,20713444,18660
"7461","ENSBTAG00000012182","3",77246899,77249257,2358
"7462","ENSBTAG00000012184","7",72005667,72013595,7928
"7463","ENSBTAG00000012185","5",101675072,101710556,35484
"7464","ENSBTAG00000012186","18",55842663,55847427,4764
"7465","ENSBTAG00000012191","27",14019529,14170149,150620
"7466","ENSBTAG00000012192","5",74623518,74628935,5417
"7467","ENSBTAG00000012193","17",67395806,67801228,405422
"7468","ENSBTAG00000012194","3",28661323,28753483,92160
"7469","ENSBTAG00000012197","25",39192114,39207833,15719
"7470","ENSBTAG00000012200","29",45212106,45223268,11162
"7471","ENSBTAG00000012205","18",56093245,56114971,21726
"7472","ENSBTAG00000012206","21",33233415,33241926,8511
"7473","ENSBTAG00000012208","23",27871206,27875056,3850
"7474","ENSBTAG00000012210","8",110338434,110435907,97473
"7475","ENSBTAG00000012211","4",68898726,68901681,2955
"7476","ENSBTAG00000012212","11",12376837,12396521,19684
"7477","ENSBTAG00000012213","28",41162567,41235092,72525
"7478","ENSBTAG00000012215","18",14500473,14512698,12225
"7479","ENSBTAG00000012216","18",2123144,2146610,23466
"7480","ENSBTAG00000012219","21",33182725,33218500,35775
"7481","ENSBTAG00000012222","18",2151216,2205687,54471
"7482","ENSBTAG00000012223","7",17839032,17843838,4806
"7483","ENSBTAG00000012225","19",48950358,48960311,9953
"7484","ENSBTAG00000012228","3",14606839,14627449,20610
"7485","ENSBTAG00000012229","15",83556733,83588368,31635
"7486","ENSBTAG00000012232","14",738124,740518,2394
"7487","ENSBTAG00000012234","3",14441107,14453937,12830
"7488","ENSBTAG00000012235","14",732964,737292,4328
"7489","ENSBTAG00000012237","4",77200840,77209981,9141
"7490","ENSBTAG00000012239","4",103727360,103796965,69605
"7491","ENSBTAG00000012241","4",77190290,77200482,10192
"7492","ENSBTAG00000012242","14",728324,732756,4432
"7493","ENSBTAG00000012243","8",61610188,61626165,15977
"7494","ENSBTAG00000012244","5",30699220,30703581,4361
"7495","ENSBTAG00000012246","5",104359792,104696724,336932
"7496","ENSBTAG00000012247","16",51172933,51177376,4443
"7497","ENSBTAG00000012249","19",38510736,38516493,5757
"7498","ENSBTAG00000012250","10",64883550,64898805,15255
"7499","ENSBTAG00000012251","28",9420371,9547987,127616
"7500","ENSBTAG00000012252","24",20888057,20946894,58837
"7501","ENSBTAG00000012253","3",109877713,109914109,36396
"7502","ENSBTAG00000012259","19",38520754,38527313,6559
"7503","ENSBTAG00000012260","12",11266778,11463803,197025
"7504","ENSBTAG00000012261","4",103792986,103806850,13864
"7505","ENSBTAG00000012262","8",61633982,61673542,39560
"7506","ENSBTAG00000012263","2",129367152,129417868,50716
"7507","ENSBTAG00000012265","5",104221024,104345680,124656
"7508","ENSBTAG00000012266","8",67827937,67829776,1839
"7509","ENSBTAG00000012267","5",1243675,1293905,50230
"7510","ENSBTAG00000012272","5",1319437,1337429,17992
"7511","ENSBTAG00000012273","1",82845021,82851428,6407
"7512","ENSBTAG00000012274","11",98794261,98811474,17213
"7513","ENSBTAG00000012275","5",32563233,32580351,17118
"7514","ENSBTAG00000012276","13",38669956,38670985,1029
"7515","ENSBTAG00000012277","17",66140620,66166478,25858
"7516","ENSBTAG00000012278","20",41323015,41391311,68296
"7517","ENSBTAG00000012279","15",1567371,1595200,27829
"7518","ENSBTAG00000012280","7",7683489,7688864,5375
"7519","ENSBTAG00000012284","1",82830348,82844401,14053
"7520","ENSBTAG00000012285","10",87626557,87812758,186201
"7521","ENSBTAG00000012288","17",66164554,66181277,16723
"7522","ENSBTAG00000012289","2",133363649,133369985,6336
"7523","ENSBTAG00000012290","25",20970085,21042943,72858
"7524","ENSBTAG00000012291","5",116973678,117230659,256981
"7525","ENSBTAG00000012293","19",35645114,35794345,149231
"7526","ENSBTAG00000012295","18",18940443,19034788,94345
"7527","ENSBTAG00000012296","6",64584452,64674550,90098
"7528","ENSBTAG00000012297","13",78599932,78674899,74967
"7529","ENSBTAG00000012299","9",76639351,76729531,90180
"7530","ENSBTAG00000012302","19",22977112,23051959,74847
"7531","ENSBTAG00000012305","3",62436807,63147752,710945
"7532","ENSBTAG00000012307","24",22130833,22449938,319105
"7533","ENSBTAG00000012311","19",62987856,63014502,26646
"7534","ENSBTAG00000012312","3",81332951,81538324,205373
"7535","ENSBTAG00000012314","7",15545282,15579093,33811
"7536","ENSBTAG00000012317","10",26632023,26638353,6330
"7537","ENSBTAG00000012319","X",58014297,58015693,1396
"7538","ENSBTAG00000012320","24",35488684,35489569,885
"7539","ENSBTAG00000012321","21",26043872,26098833,54961
"7540","ENSBTAG00000012322","22",50430296,50432582,2286
"7541","ENSBTAG00000012328","22",54313125,54317595,4470
"7542","ENSBTAG00000012330","10",103116503,103123174,6671
"7543","ENSBTAG00000012332","11",9256368,9266802,10434
"7544","ENSBTAG00000012333","18",61915345,61960163,44818
"7545","ENSBTAG00000012334","2",89903607,89924382,20775
"7546","ENSBTAG00000012335","22",50420590,50430092,9502
"7547","ENSBTAG00000012338","21",26110012,26142398,32386
"7548","ENSBTAG00000012341","13",60506986,60565498,58512
"7549","ENSBTAG00000012342","5",29637176,29729199,92023
"7550","ENSBTAG00000012343","6",25923695,26102484,178789
"7551","ENSBTAG00000012344","19",27974414,27979325,4911
"7552","ENSBTAG00000012347","1",70809680,70827658,17978
"7553","ENSBTAG00000012348","3",13925709,13938001,12292
"7554","ENSBTAG00000012349","16",1510252,1518304,8052
"7555","ENSBTAG00000012350","7",75187453,75202949,15496
"7556","ENSBTAG00000012351","21",26266857,26459510,192653
"7557","ENSBTAG00000012352","10",12187382,12228909,41527
"7558","ENSBTAG00000012353","14",309282,313478,4196
"7559","ENSBTAG00000012355","3",101373593,101645892,272299
"7560","ENSBTAG00000012357","14",64454510,65258852,804342
"7561","ENSBTAG00000012361","3",13871481,13922860,51379
"7562","ENSBTAG00000012363","2",120102431,120106292,3861
"7563","ENSBTAG00000012365","10",15613398,15652308,38910
"7564","ENSBTAG00000012366","19",8655164,8661689,6525
"7565","ENSBTAG00000012368","17",35062970,35070765,7795
"7566","ENSBTAG00000012370","5",95024682,95028653,3971
"7567","ENSBTAG00000012371","19",21464506,21533374,68868
"7568","ENSBTAG00000012372","3",101354615,101378938,24323
"7569","ENSBTAG00000012374","3",120166730,120174871,8141
"7570","ENSBTAG00000012375","8",22874270,22876774,2504
"7571","ENSBTAG00000012376","2",49631454,49631858,404
"7572","ENSBTAG00000012377","13",12517107,12533297,16190
"7573","ENSBTAG00000012380","28",25694146,25769790,75644
"7574","ENSBTAG00000012382","8",72741940,72821366,79426
"7575","ENSBTAG00000012383","8",75033192,75047111,13919
"7576","ENSBTAG00000012384","23",15499140,15547643,48503
"7577","ENSBTAG00000012385","8",75057600,75125297,67697
"7578","ENSBTAG00000012387","7",101896775,102084454,187679
"7579","ENSBTAG00000012390","8",100933078,100936451,3373
"7580","ENSBTAG00000012391","10",51438301,51509014,70713
"7581","ENSBTAG00000012393","28",45757443,45768564,11121
"7582","ENSBTAG00000012394","11",38849940,39075742,225802
"7583","ENSBTAG00000012397","6",86319005,86345274,26269
"7584","ENSBTAG00000012398","15",27486034,27488618,2584
"7585","ENSBTAG00000012401","1",93681319,93683506,2187
"7586","ENSBTAG00000012403","9",69522090,69539079,16989
"7587","ENSBTAG00000012405","3",13938873,13959672,20799
"7588","ENSBTAG00000012406","13",58563618,58574289,10671
"7589","ENSBTAG00000012407","13",41542504,41546955,4451
"7590","ENSBTAG00000012408","10",55014868,55094843,79975
"7591","ENSBTAG00000012409","12",24218976,24254116,35140
"7592","ENSBTAG00000012411","7",83538717,83617117,78400
"7593","ENSBTAG00000012412","1",3103263,3180340,77077
"7594","ENSBTAG00000012413","1",74876548,75283017,406469
"7595","ENSBTAG00000012414","3",103124857,103130522,5665
"7596","ENSBTAG00000012416","26",25709778,25714347,4569
"7597","ENSBTAG00000012417","15",61047198,61061504,14306
"7598","ENSBTAG00000012418","9",69540273,69583721,43448
"7599","ENSBTAG00000012419","3",29498121,29502961,4840
"7600","ENSBTAG00000012421","17",72935432,72967481,32049
"7601","ENSBTAG00000012423","5",32190514,32240416,49902
"7602","ENSBTAG00000012425","5",115132411,115133130,719
"7603","ENSBTAG00000012426","24",21582817,21608156,25339
"7604","ENSBTAG00000012432","8",7591014,7617546,26532
"7605","ENSBTAG00000012433","16",76482363,76747186,264823
"7606","ENSBTAG00000012434","12",13339367,13682749,343382
"7607","ENSBTAG00000012436","19",27763456,27765929,2473
"7608","ENSBTAG00000012439","23",15900394,15911894,11500
"7609","ENSBTAG00000012441","24",48598830,48627410,28580
"7610","ENSBTAG00000012442","8",7566095,7586862,20767
"7611","ENSBTAG00000012443","12",2180988,2743479,562491
"7612","ENSBTAG00000012444","26",45513531,45903613,390082
"7613","ENSBTAG00000012446","18",12356262,12373932,17670
"7614","ENSBTAG00000012447","11",70976071,71012355,36284
"7615","ENSBTAG00000012448","5",81198215,81592476,394261
"7616","ENSBTAG00000012449","11",4665771,5289303,623532
"7617","ENSBTAG00000012450","17",39633239,39902881,269642
"7618","ENSBTAG00000012451","23",7246582,7253835,7253
"7619","ENSBTAG00000012454","3",43249864,43294691,44827
"7620","ENSBTAG00000012456","4",10541020,10595196,54176
"7621","ENSBTAG00000012458","6",113842039,113844510,2471
"7622","ENSBTAG00000012460","15",65019976,65067265,47289
"7623","ENSBTAG00000012461","23",31308822,31315668,6846
"7624","ENSBTAG00000012462","16",34937151,34944966,7815
"7625","ENSBTAG00000012463","1",88005930,88038010,32080
"7626","ENSBTAG00000012464","6",114134147,114283820,149673
"7627","ENSBTAG00000012465","18",12381319,12382827,1508
"7628","ENSBTAG00000012467","1",80006310,80074215,67905
"7629","ENSBTAG00000012470","3",16722663,16724347,1684
"7630","ENSBTAG00000012471","3",16711945,16723007,11062
"7631","ENSBTAG00000012475","19",27718183,27730008,11825
"7632","ENSBTAG00000012476","28",19273626,19302758,29132
"7633","ENSBTAG00000012478","19",27739350,27760708,21358
"7634","ENSBTAG00000012480","11",99276468,99292311,15843
"7635","ENSBTAG00000012481","5",112396231,112425046,28815
"7636","ENSBTAG00000012482","22",54085588,54138907,53319
"7637","ENSBTAG00000012484","11",99293313,99303903,10590
"7638","ENSBTAG00000012485","11",99296474,99305631,9157
"7639","ENSBTAG00000012489","21",31336996,31461070,124074
"7640","ENSBTAG00000012490","21",31471294,31541249,69955
"7641","ENSBTAG00000012491","X",137255225,137260579,5354
"7642","ENSBTAG00000012495","3",20681758,20685817,4059
"7643","ENSBTAG00000012496","3",20672618,20680889,8271
"7644","ENSBTAG00000012497","1",158336214,158359816,23602
"7645","ENSBTAG00000012498","8",60998035,61178197,180162
"7646","ENSBTAG00000012499","18",21941771,22040220,98449
"7647","ENSBTAG00000012500","19",40559946,40595285,35339
"7648","ENSBTAG00000012501","18",22040310,22464466,424156
"7649","ENSBTAG00000012503","5",110880567,110910262,29695
"7650","ENSBTAG00000012504","17",68582675,68588419,5744
"7651","ENSBTAG00000012505","15",52798117,52856744,58627
"7652","ENSBTAG00000012507","15",29770007,29775411,5404
"7653","ENSBTAG00000012508","18",10285040,10339375,54335
"7654","ENSBTAG00000012509","18",49368217,49388224,20007
"7655","ENSBTAG00000012511","29",42573709,42585490,11781
"7656","ENSBTAG00000012512","29",42587096,42590173,3077
"7657","ENSBTAG00000012514","3",93157902,93175464,17562
"7658","ENSBTAG00000012516","3",93105905,93156932,51027
"7659","ENSBTAG00000012518","7",52931937,52958465,26528
"7660","ENSBTAG00000012519","11",14164544,14269931,105387
"7661","ENSBTAG00000012522","18",52044659,52053065,8406
"7662","ENSBTAG00000012525","11",104176840,104214809,37969
"7663","ENSBTAG00000012526","13",17991761,18066070,74309
"7664","ENSBTAG00000012529","5",45624462,45629336,4874
"7665","ENSBTAG00000012534","9",42895611,42926505,30894
"7666","ENSBTAG00000012535","8",5783455,5795853,12398
"7667","ENSBTAG00000012537","6",15694143,15715905,21762
"7668","ENSBTAG00000012538","18",57036062,57042603,6541
"7669","ENSBTAG00000012540","15",82145541,82160656,15115
"7670","ENSBTAG00000012541","25",21401701,21406270,4569
"7671","ENSBTAG00000012543","X",80409518,80523338,113820
"7672","ENSBTAG00000012544","9",75081985,75106375,24390
"7673","ENSBTAG00000012545","10",102772590,102861254,88664
"7674","ENSBTAG00000012549","15",78066065,78066991,926
"7675","ENSBTAG00000012550","17",56979400,57072044,92644
"7676","ENSBTAG00000012552","X",30625271,30664682,39411
"7677","ENSBTAG00000012554","2",6605784,6657432,51648
"7678","ENSBTAG00000012555","3",33088523,33095448,6925
"7679","ENSBTAG00000012557","2",6592659,6603565,10906
"7680","ENSBTAG00000012558","20",39873127,40265889,392762
"7681","ENSBTAG00000012559","20",71165516,71181851,16335
"7682","ENSBTAG00000012560","8",69474988,69478735,3747
"7683","ENSBTAG00000012561","2",6572135,6584583,12448
"7684","ENSBTAG00000012562","15",29916407,29917708,1301
"7685","ENSBTAG00000012564","19",46008699,46179281,170582
"7686","ENSBTAG00000012565","10",82525805,82704991,179186
"7687","ENSBTAG00000012566","28",5675771,5678556,2785
"7688","ENSBTAG00000012567","20",71145309,71162695,17386
"7689","ENSBTAG00000012575","6",117125135,117152643,27508
"7690","ENSBTAG00000012577","6",117096413,117118752,22339
"7691","ENSBTAG00000012581","1",64275417,64295231,19814
"7692","ENSBTAG00000012582","16",23586935,23631281,44346
"7693","ENSBTAG00000012584","3",110900183,110905849,5666
"7694","ENSBTAG00000012585","16",23632616,23735677,103061
"7695","ENSBTAG00000012586","2",86035475,86045870,10395
"7696","ENSBTAG00000012587","7",5837516,5843414,5898
"7697","ENSBTAG00000012589","2",86044912,86048062,3150
"7698","ENSBTAG00000012592","7",5830530,5836468,5938
"7699","ENSBTAG00000012594","1",1390803,1455219,64416
"7700","ENSBTAG00000012595","14",66121455,66129652,8197
"7701","ENSBTAG00000012596","14",66086238,66115081,28843
"7702","ENSBTAG00000012599","10",13895783,14018262,122479
"7703","ENSBTAG00000012600","12",32485688,32495663,9975
"7704","ENSBTAG00000012601","25",872390,878381,5991
"7705","ENSBTAG00000012604","2",128320578,128334929,14351
"7706","ENSBTAG00000012605","16",44330572,44353081,22509
"7707","ENSBTAG00000012606","18",54494035,54508720,14685
"7708","ENSBTAG00000012607","5",119812249,119822276,10027
"7709","ENSBTAG00000012608","14",37626644,37645604,18960
"7710","ENSBTAG00000012609","5",119822433,119824250,1817
"7711","ENSBTAG00000012615","2",52268261,52305498,37237
"7712","ENSBTAG00000012618","2",107113751,107120309,6558
"7713","ENSBTAG00000012619","2",107122933,107126587,3654
"7714","ENSBTAG00000012620","2",107128001,107133526,5525
"7715","ENSBTAG00000012621","15",80727171,80737692,10521
"7716","ENSBTAG00000012622","4",32116515,32135318,18803
"7717","ENSBTAG00000012623","X",99678423,99705345,26922
"7718","ENSBTAG00000012624","5",39200973,39632049,431076
"7719","ENSBTAG00000012626","13",77734050,77810241,76191
"7720","ENSBTAG00000012628","15",65776406,65935522,159116
"7721","ENSBTAG00000012629","2",120410028,120436409,26381
"7722","ENSBTAG00000012630","15",65950563,66028384,77821
"7723","ENSBTAG00000012632","7",11232359,11260179,27820
"7724","ENSBTAG00000012634","7",11227835,11232299,4464
"7725","ENSBTAG00000012636","5",57292528,57302803,10275
"7726","ENSBTAG00000012637","11",45829019,45838416,9397
"7727","ENSBTAG00000012638","3",17102722,17104173,1451
"7728","ENSBTAG00000012640","3",17085577,17086827,1250
"7729","ENSBTAG00000012642","18",34792854,34798800,5946
"7730","ENSBTAG00000012644","3",101012745,101037592,24847
"7731","ENSBTAG00000012646","1",56425478,56476144,50666
"7732","ENSBTAG00000012647","2",99223775,99801312,577537
"7733","ENSBTAG00000012648","3",100852666,101009999,157333
"7734","ENSBTAG00000012649","4",82786342,82793813,7471
"7735","ENSBTAG00000012652","23",6029292,6135369,106077
"7736","ENSBTAG00000012653","4",77025265,77117686,92421
"7737","ENSBTAG00000012654","28",29679227,29680517,1290
"7738","ENSBTAG00000012656","29",43908693,43919733,11040
"7739","ENSBTAG00000012657","28",29682252,29697213,14961
"7740","ENSBTAG00000012658","6",2111636,2141474,29838
"7741","ENSBTAG00000012659","3",32408226,32428000,19774
"7742","ENSBTAG00000012664","28",29696608,29705236,8628
"7743","ENSBTAG00000012667","28",29705563,29761013,55450
"7744","ENSBTAG00000012668","25",36317416,36319388,1972
"7745","ENSBTAG00000012671","7",62293510,62337815,44305
"7746","ENSBTAG00000012672","19",12843752,12850362,6610
"7747","ENSBTAG00000012673","16",3248618,3275153,26535
"7748","ENSBTAG00000012674","9",91103523,91214302,110779
"7749","ENSBTAG00000012675","19",12850548,12884004,33456
"7750","ENSBTAG00000012676","5",27098480,27108554,10074
"7751","ENSBTAG00000012677","13",33421066,33538437,117371
"7752","ENSBTAG00000012678","7",5543272,5566733,23461
"7753","ENSBTAG00000012681","10",15419306,15567397,148091
"7754","ENSBTAG00000012682","7",5459776,5525065,65289
"7755","ENSBTAG00000012683","25",2285225,2302870,17645
"7756","ENSBTAG00000012684","8",76054024,76055932,1908
"7757","ENSBTAG00000012687","7",16058828,16183062,124234
"7758","ENSBTAG00000012688","20",38238510,38275199,36689
"7759","ENSBTAG00000012691","27",26703213,26783526,80313
"7760","ENSBTAG00000012692","3",33690892,33731268,40376
"7761","ENSBTAG00000012693","18",7775728,7882996,107268
"7762","ENSBTAG00000012694","3",6980659,7000320,19661
"7763","ENSBTAG00000012695","2",121262594,121283528,20934
"7764","ENSBTAG00000012697","26",18649023,18655665,6642
"7765","ENSBTAG00000012698","2",121225584,121257548,31964
"7766","ENSBTAG00000012699","26",18657377,18664009,6632
"7767","ENSBTAG00000012700","3",1182748,1266862,84114
"7768","ENSBTAG00000012702","26",18664215,18673470,9255
"7769","ENSBTAG00000012703","23",12494154,12519916,25762
"7770","ENSBTAG00000012704","26",18674042,18709360,35318
"7771","ENSBTAG00000012705","16",27363456,27373727,10271
"7772","ENSBTAG00000012706","1",80082559,80085391,2832
"7773","ENSBTAG00000012708","1",99660456,99743550,83094
"7774","ENSBTAG00000012710","13",66207181,66216486,9305
"7775","ENSBTAG00000012712","10",30359033,30440494,81461
"7776","ENSBTAG00000012715","16",31626657,31942949,316292
"7777","ENSBTAG00000012719","26",18709528,18760668,51140
"7778","ENSBTAG00000012720","26",18762488,18771573,9085
"7779","ENSBTAG00000012721","26",18771707,18793256,21549
"7780","ENSBTAG00000012722","3",97586687,97733398,146711
"7781","ENSBTAG00000012723","10",21886704,21896202,9498
"7782","ENSBTAG00000012724","10",21862619,21871325,8706
"7783","ENSBTAG00000012725","10",21839185,21859297,20112
"7784","ENSBTAG00000012726","10",21821525,21827804,6279
"7785","ENSBTAG00000012729","X",96256712,96675377,418665
"7786","ENSBTAG00000012735","11",98387399,98394479,7080
"7787","ENSBTAG00000012736","11",98393584,98395443,1859
"7788","ENSBTAG00000012737","10",99742350,99751572,9222
"7789","ENSBTAG00000012738","17",12387472,12579784,192312
"7790","ENSBTAG00000012739","19",26114946,26120375,5429
"7791","ENSBTAG00000012740","10",54973408,54998890,25482
"7792","ENSBTAG00000012741","10",54951054,54973424,22370
"7793","ENSBTAG00000012742","29",48692593,48712661,20068
"7794","ENSBTAG00000012744","18",65779277,65782460,3183
"7795","ENSBTAG00000012745","7",14663969,14667985,4016
"7796","ENSBTAG00000012747","X",37555427,37563766,8339
"7797","ENSBTAG00000012748","X",34548452,34552995,4543
"7798","ENSBTAG00000012749","23",16668580,16684135,15555
"7799","ENSBTAG00000012750","15",29545903,29548145,2242
"7800","ENSBTAG00000012751","21",69573709,69577210,3501
"7801","ENSBTAG00000012752","23",16683878,16688088,4210
"7802","ENSBTAG00000012753","21",69555656,69607534,51878
"7803","ENSBTAG00000012755","23",16689176,16702483,13307
"7804","ENSBTAG00000012756","11",11197280,11214567,17287
"7805","ENSBTAG00000012757","8",52522641,52568603,45962
"7806","ENSBTAG00000012758","7",55259539,55275266,15727
"7807","ENSBTAG00000012759","11",11168103,11195919,27816
"7808","ENSBTAG00000012760","2",89662427,89672935,10508
"7809","ENSBTAG00000012761","23",16703732,16767981,64249
"7810","ENSBTAG00000012762","7",46322048,46329335,7287
"7811","ENSBTAG00000012765","16",11923585,11929299,5714
"7812","ENSBTAG00000012768","7",61322505,61379912,57407
"7813","ENSBTAG00000012771","7",61380054,61411558,31504
"7814","ENSBTAG00000012772","11",103007273,103012074,4801
"7815","ENSBTAG00000012774","16",3728988,3757499,28511
"7816","ENSBTAG00000012777","23",16775130,16783881,8751
"7817","ENSBTAG00000012778","16",27079890,27138327,58437
"7818","ENSBTAG00000012779","11",81786078,81885694,99616
"7819","ENSBTAG00000012780","19",9202920,9247946,45026
"7820","ENSBTAG00000012781","16",27139848,27207478,67630
"7821","ENSBTAG00000012784","5",29851713,29890966,39253
"7822","ENSBTAG00000012785","18",25888368,25895551,7183
"7823","ENSBTAG00000012787","16",29005214,29020714,15500
"7824","ENSBTAG00000012788","17",62732323,62746023,13700
"7825","ENSBTAG00000012789","21",40114486,40460921,346435
"7826","ENSBTAG00000012790","17",62747154,62749467,2313
"7827","ENSBTAG00000012791","17",62749284,62755938,6654
"7828","ENSBTAG00000012792","17",62757004,62763283,6279
"7829","ENSBTAG00000012793","5",65786921,65789646,2725
"7830","ENSBTAG00000012794","5",66613984,66732963,118979
"7831","ENSBTAG00000012796","18",51829180,51838230,9050
"7832","ENSBTAG00000012797","1",84042262,84074786,32524
"7833","ENSBTAG00000012798","1",156340497,156841779,501282
"7834","ENSBTAG00000012800","17",12653032,12681867,28835
"7835","ENSBTAG00000012801","2",38225057,38262544,37487
"7836","ENSBTAG00000012803","10",1153328,1161671,8343
"7837","ENSBTAG00000012804","10",1094651,1145330,50679
"7838","ENSBTAG00000012805","4",25245149,25283286,38137
"7839","ENSBTAG00000012808","16",42581910,42597203,15293
"7840","ENSBTAG00000012809","8",59245071,59267220,22149
"7841","ENSBTAG00000012815","5",99947296,99960045,12749
"7842","ENSBTAG00000012816","2",43268213,43269180,967
"7843","ENSBTAG00000012817","13",3939809,3984202,44393
"7844","ENSBTAG00000012818","6",29911322,30142653,231331
"7845","ENSBTAG00000012820","15",82963910,83044497,80587
"7846","ENSBTAG00000012822","23",15865137,15884246,19109
"7847","ENSBTAG00000012824","17",29913837,29993696,79859
"7848","ENSBTAG00000012826","17",29880313,29908490,28177
"7849","ENSBTAG00000012827","11",92715936,92922596,206660
"7850","ENSBTAG00000012828","5",1450098,1524167,74069
"7851","ENSBTAG00000012829","7",19814211,19819636,5425
"7852","ENSBTAG00000012830","7",19797987,19812101,14114
"7853","ENSBTAG00000012833","21",61171215,61248583,77368
"7854","ENSBTAG00000012834","7",61647116,61653431,6315
"7855","ENSBTAG00000012835","NKLS02001111.1",113391,117065,3674
"7856","ENSBTAG00000012837","1",151565699,151680026,114327
"7857","ENSBTAG00000012838","10",79579851,79589018,9167
"7858","ENSBTAG00000012844","11",98183693,98217754,34061
"7859","ENSBTAG00000012845","19",20090371,20098195,7824
"7860","ENSBTAG00000012846","15",63989009,64306981,317972
"7861","ENSBTAG00000012847","11",98220651,98272276,51625
"7862","ENSBTAG00000012848","2",124237184,124325673,88489
"7863","ENSBTAG00000012849","12",84863917,84995777,131860
"7864","ENSBTAG00000012850","1",130793239,130816718,23479
"7865","ENSBTAG00000012851","17",70570574,70620771,50197
"7866","ENSBTAG00000012852","21",59956298,60027328,71030
"7867","ENSBTAG00000012854","19",40243358,40254120,10762
"7868","ENSBTAG00000012855","8",66989665,67016690,27025
"7869","ENSBTAG00000012856","X",80162351,80173912,11561
"7870","ENSBTAG00000012857","26",23551416,23728870,177454
"7871","ENSBTAG00000012858","26",23739169,23813190,74021
"7872","ENSBTAG00000012860","X",80153461,80156420,2959
"7873","ENSBTAG00000012861","X",80023333,80153340,130007
"7874","ENSBTAG00000012863","X",80011281,80021117,9836
"7875","ENSBTAG00000012865","23",39355962,39387656,31694
"7876","ENSBTAG00000012866","10",11005591,11060139,54548
"7877","ENSBTAG00000012867","1",158215919,158228038,12119
"7878","ENSBTAG00000012868","7",20810640,20811788,1148
"7879","ENSBTAG00000012870","23",4470532,4614742,144210
"7880","ENSBTAG00000012873","21",44998853,45046871,48018
"7881","ENSBTAG00000012878","28",13197801,13229985,32184
"7882","ENSBTAG00000012880","11",103822110,103824821,2711
"7883","ENSBTAG00000012881","1",82854035,82872768,18733
"7884","ENSBTAG00000012882","15",17611240,17718341,107101
"7885","ENSBTAG00000012884","3",10458782,10462141,3359
"7886","ENSBTAG00000012885","15",17734330,17763541,29211
"7887","ENSBTAG00000012887","3",10419633,10425891,6258
"7888","ENSBTAG00000012888","2",96437069,96460618,23549
"7889","ENSBTAG00000012889","24",5079442,5181880,102438
"7890","ENSBTAG00000012890","5",62746005,62752373,6368
"7891","ENSBTAG00000012892","17",68404806,68407909,3103
"7892","ENSBTAG00000012896","5",57572503,57575448,2945
"7893","ENSBTAG00000012897","5",57548839,57572012,23173
"7894","ENSBTAG00000012898","10",46889250,46892617,3367
"7895","ENSBTAG00000012899","1",2098968,2124278,25310
"7896","ENSBTAG00000012900","10",79345988,79359617,13629
"7897","ENSBTAG00000012902","22",21234916,21281338,46422
"7898","ENSBTAG00000012904","22",21198504,21225184,26680
"7899","ENSBTAG00000012907","3",57674210,57713603,39393
"7900","ENSBTAG00000012908","1",22783876,22794051,10175
"7901","ENSBTAG00000012909","21",30733397,30740592,7195
"7902","ENSBTAG00000012912","2",39011020,39016794,5774
"7903","ENSBTAG00000012914","26",21372167,21376119,3952
"7904","ENSBTAG00000012915","18",52062598,52082934,20336
"7905","ENSBTAG00000012918","23",22446157,22484653,38496
"7906","ENSBTAG00000012919","18",25939947,25960720,20773
"7907","ENSBTAG00000012920","14",37225602,37233937,8335
"7908","ENSBTAG00000012921","8",75651802,75724181,72379
"7909","ENSBTAG00000012922","8",84899107,84990833,91726
"7910","ENSBTAG00000012925","11",2433855,2467290,33435
"7911","ENSBTAG00000012926","21",24921877,24951743,29866
"7912","ENSBTAG00000012927","25",26212553,26218476,5923
"7913","ENSBTAG00000012928","25",26202157,26210403,8246
"7914","ENSBTAG00000012929","9",32336625,32479899,143274
"7915","ENSBTAG00000012931","9",32402831,32413602,10771
"7916","ENSBTAG00000012936","15",83520804,83525320,4516
"7917","ENSBTAG00000012937","15",83525512,83539320,13808
"7918","ENSBTAG00000012938","23",41486442,41715140,228698
"7919","ENSBTAG00000012939","23",41382797,41484256,101459
"7920","ENSBTAG00000012940","15",29194107,29203081,8974
"7921","ENSBTAG00000012941","15",29205690,29219880,14190
"7922","ENSBTAG00000012943","7",61073587,61186881,113294
"7923","ENSBTAG00000012944","29",17795927,17853459,57532
"7924","ENSBTAG00000012945","7",61195051,61269840,74789
"7925","ENSBTAG00000012946","9",28763138,28803014,39876
"7926","ENSBTAG00000012949","11",67308836,67314682,5846
"7927","ENSBTAG00000012953","16",58058897,58410271,351374
"7928","ENSBTAG00000012954","X",86934934,86938684,3750
"7929","ENSBTAG00000012955","26",35387480,35418682,31202
"7930","ENSBTAG00000012957","3",77922744,77937176,14432
"7931","ENSBTAG00000012961","6",17489062,17601500,112438
"7932","ENSBTAG00000012962","3",34170143,34190011,19868
"7933","ENSBTAG00000012963","22",11439398,11459404,20006
"7934","ENSBTAG00000012966","2",22365327,22397420,32093
"7935","ENSBTAG00000012968","4",77371216,77465906,94690
"7936","ENSBTAG00000012969","6",18125623,18254810,129187
"7937","ENSBTAG00000012970","26",44230932,44360485,129553
"7938","ENSBTAG00000012971","20",55592320,55593381,1061
"7939","ENSBTAG00000012972","6",17261763,17282966,21203
"7940","ENSBTAG00000012975","28",30970120,30984667,14547
"7941","ENSBTAG00000012976","3",77070780,77186963,116183
"7942","ENSBTAG00000012977","28",30986811,30988887,2076
"7943","ENSBTAG00000012979","3",103720970,103756764,35794
"7944","ENSBTAG00000012980","X",93035620,93077042,41422
"7945","ENSBTAG00000012981","10",19264662,19296240,31578
"7946","ENSBTAG00000012982","3",103717321,103720404,3083
"7947","ENSBTAG00000012984","11",21111071,21112837,1766
"7948","ENSBTAG00000012985","18",1643524,1656631,13107
"7949","ENSBTAG00000012987","17",45176713,45199686,22973
"7950","ENSBTAG00000012988","18",1618164,1643268,25104
"7951","ENSBTAG00000012989","15",80815599,80829794,14195
"7952","ENSBTAG00000012990","17",45161930,45173082,11152
"7953","ENSBTAG00000012991","8",52760745,52887222,126477
"7954","ENSBTAG00000012992","20",42209780,42354761,144981
"7955","ENSBTAG00000012994","7",31754829,31767397,12568
"7956","ENSBTAG00000012995","6",15717981,15813728,95747
"7957","ENSBTAG00000012997","2",125401099,125432986,31887
"7958","ENSBTAG00000012998","10",69768687,69789526,20839
"7959","ENSBTAG00000012999","5",70974100,70998583,24483
"7960","ENSBTAG00000013001","17",44044076,44068639,24563
"7961","ENSBTAG00000013002","X",35046213,35060775,14562
"7962","ENSBTAG00000013003","29",49392878,49394536,1658
"7963","ENSBTAG00000013004","13",16200781,16281657,80876
"7964","ENSBTAG00000013007","13",59572279,59582949,10670
"7965","ENSBTAG00000013008","5",66019470,66021457,1987
"7966","ENSBTAG00000013009","13",59555286,59570430,15144
"7967","ENSBTAG00000013010","4",32217367,32259874,42507
"7968","ENSBTAG00000013011","8",17280446,17320525,40079
"7969","ENSBTAG00000013013","1",111732900,111804777,71877
"7970","ENSBTAG00000013014","3",33901936,33905313,3377
"7971","ENSBTAG00000013015","22",14837847,14872151,34304
"7972","ENSBTAG00000013016","3",33854858,33899237,44379
"7973","ENSBTAG00000013017","3",33837406,33846790,9384
"7974","ENSBTAG00000013018","3",33818280,33830235,11955
"7975","ENSBTAG00000013023","11",6577660,6628589,50929
"7976","ENSBTAG00000013025","3",16250174,16252803,2629
"7977","ENSBTAG00000013026","22",37750448,37764990,14542
"7978","ENSBTAG00000013027","22",14567356,14573955,6599
"7979","ENSBTAG00000013029","15",39286444,39394387,107943
"7980","ENSBTAG00000013030","11",99394202,99421595,27393
"7981","ENSBTAG00000013031","10",38358798,38393156,34358
"7982","ENSBTAG00000013032","10",38393529,38403862,10333
"7983","ENSBTAG00000013033","15",39210342,39285703,75361
"7984","ENSBTAG00000013035","10",72694498,72697071,2573
"7985","ENSBTAG00000013036","17",72124049,72126076,2027
"7986","ENSBTAG00000013038","17",72129021,72153652,24631
"7987","ENSBTAG00000013039","2",132738657,132741687,3030
"7988","ENSBTAG00000013042","10",69619265,69671092,51827
"7989","ENSBTAG00000013043","10",69671251,69691278,20027
"7990","ENSBTAG00000013044","X",36237532,36321169,83637
"7991","ENSBTAG00000013045","X",36210775,36223011,12236
"7992","ENSBTAG00000013046","X",36176367,36209890,33523
"7993","ENSBTAG00000013047","22",18673820,19567204,893384
"7994","ENSBTAG00000013048","2",128445501,128496459,50958
"7995","ENSBTAG00000013050","4",55985141,56120652,135511
"7996","ENSBTAG00000013052","25",19845794,19864999,19205
"7997","ENSBTAG00000013054","3",106122567,106136408,13841
"7998","ENSBTAG00000013055","21",34816886,34818847,1961
"7999","ENSBTAG00000013056","13",62276784,62297291,20507
"8000","ENSBTAG00000013057","1",50258002,50481552,223550
"8001","ENSBTAG00000013060","21",22109271,22190576,81305
"8002","ENSBTAG00000013063","11",88013833,88030303,16470
"8003","ENSBTAG00000013064","16",13120960,13151798,30838
"8004","ENSBTAG00000013065","23",31855234,31864562,9328
"8005","ENSBTAG00000013066","29",49394907,49422468,27561
"8006","ENSBTAG00000013068","28",8066744,8078752,12008
"8007","ENSBTAG00000013069","1",66248439,66293959,45520
"8008","ENSBTAG00000013070","1",66294136,66349798,55662
"8009","ENSBTAG00000013071","16",47090061,47101848,11787
"8010","ENSBTAG00000013072","11",100882266,100931850,49584
"8011","ENSBTAG00000013074","16",2151478,2156646,5168
"8012","ENSBTAG00000013076","29",36942605,36975284,32679
"8013","ENSBTAG00000013077","X",67149850,67151589,1739
"8014","ENSBTAG00000013078","4",30324683,30693265,368582
"8015","ENSBTAG00000013079","13",58657726,58682600,24874
"8016","ENSBTAG00000013081","25",27697184,27719287,22103
"8017","ENSBTAG00000013084","18",54459647,54487500,27853
"8018","ENSBTAG00000013085","2",130816944,130824150,7206
"8019","ENSBTAG00000013090","28",26636791,26643883,7092
"8020","ENSBTAG00000013093","29",45537447,45557692,20245
"8021","ENSBTAG00000013095","19",19977270,20005151,27881
"8022","ENSBTAG00000013096","19",20009504,20015204,5700
"8023","ENSBTAG00000013098","19",20016185,20027945,11760
"8024","ENSBTAG00000013099","19",20030282,20034197,3915
"8025","ENSBTAG00000013100","19",20034503,20053455,18952
"8026","ENSBTAG00000013103","19",36457658,36474513,16855
"8027","ENSBTAG00000013105","18",56713476,56727569,14093
"8028","ENSBTAG00000013106","18",56744210,56747139,2929
"8029","ENSBTAG00000013107","18",56749847,56795834,45987
"8030","ENSBTAG00000013108","11",9743172,9810098,66926
"8031","ENSBTAG00000013109","15",51012407,51216927,204520
"8032","ENSBTAG00000013110","3",120512441,120612106,99665
"8033","ENSBTAG00000013111","15",50969950,51010523,40573
"8034","ENSBTAG00000013112","7",45648094,45661066,12972
"8035","ENSBTAG00000013113","7",45663905,45696087,32182
"8036","ENSBTAG00000013114","13",75774888,75899044,124156
"8037","ENSBTAG00000013116","13",2304288,2503503,199215
"8038","ENSBTAG00000013117","22",45924535,46818511,893976
"8039","ENSBTAG00000013118","1",66543642,66610926,67284
"8040","ENSBTAG00000013120","26",22572314,22746820,174506
"8041","ENSBTAG00000013123","5",103493143,103497684,4541
"8042","ENSBTAG00000013124","22",46051998,46062657,10659
"8043","ENSBTAG00000013125","18",51865091,51878472,13381
"8044","ENSBTAG00000013126","5",103486417,103493327,6910
"8045","ENSBTAG00000013127","5",103451002,103487994,36992
"8046","ENSBTAG00000013128","16",29157748,29196233,38485
"8047","ENSBTAG00000013131","2",126936277,126939832,3555
"8048","ENSBTAG00000013132","10",10952454,10961762,9308
"8049","ENSBTAG00000013133","29",45296017,45302692,6675
"8050","ENSBTAG00000013136","10",101466634,101634822,168188
"8051","ENSBTAG00000013138","10",101640018,101708726,68708
"8052","ENSBTAG00000013141","1",97604626,97610506,5880
"8053","ENSBTAG00000013142","1",97587928,97604139,16211
"8054","ENSBTAG00000013143","27",33349063,33374595,25532
"8055","ENSBTAG00000013145","27",33387283,33416172,28889
"8056","ENSBTAG00000013147","17",68684707,68692551,7844
"8057","ENSBTAG00000013148","1",76973808,76989396,15588
"8058","ENSBTAG00000013150","17",68700997,68731933,30936
"8059","ENSBTAG00000013152","17",68731177,68748582,17405
"8060","ENSBTAG00000013153","17",68758653,68833313,74660
"8061","ENSBTAG00000013155","5",32283180,32313172,29992
"8062","ENSBTAG00000013157","18",53442851,53469024,26173
"8063","ENSBTAG00000013159","12",19055623,19089521,33898
"8064","ENSBTAG00000013160","13",51526771,51531465,4694
"8065","ENSBTAG00000013162","15",33679009,33683436,4427
"8066","ENSBTAG00000013163","13",51512829,51523330,10501
"8067","ENSBTAG00000013165","14",80982673,81117148,134475
"8068","ENSBTAG00000013166","16",69234217,69287670,53453
"8069","ENSBTAG00000013167","13",51487257,51505680,18423
"8070","ENSBTAG00000013168","4",15692488,15695690,3202
"8071","ENSBTAG00000013169","25",22696952,22766564,69612
"8072","ENSBTAG00000013170","2",92070614,92077168,6554
"8073","ENSBTAG00000013173","5",112960110,112979720,19610
"8074","ENSBTAG00000013174","5",112982148,113011836,29688
"8075","ENSBTAG00000013175","18",44691411,44776252,84841
"8076","ENSBTAG00000013176","9",102645195,102803012,157817
"8077","ENSBTAG00000013177","X",92476249,92484051,7802
"8078","ENSBTAG00000013178","X",92485200,92512358,27158
"8079","ENSBTAG00000013180","4",89093139,89183193,90054
"8080","ENSBTAG00000013183","7",39318556,39336543,17987
"8081","ENSBTAG00000013184","7",30358003,30441533,83530
"8082","ENSBTAG00000013185","7",68286089,68314227,28138
"8083","ENSBTAG00000013187","28",33518711,33642717,124006
"8084","ENSBTAG00000013191","16",51422628,51461967,39339
"8085","ENSBTAG00000013192","1",71223038,71228675,5637
"8086","ENSBTAG00000013196","2",84682093,84723198,41105
"8087","ENSBTAG00000013197","16",29851509,29872546,21037
"8088","ENSBTAG00000013201","12",30108987,30138259,29272
"8089","ENSBTAG00000013203","1",73132670,73134289,1619
"8090","ENSBTAG00000013204","1",73048103,73125832,77729
"8091","ENSBTAG00000013205","1",76577593,76723526,145933
"8092","ENSBTAG00000013207","5",91334674,91335759,1085
"8093","ENSBTAG00000013208","27",15489470,15493487,4017
"8094","ENSBTAG00000013210","3",8303389,8311838,8449
"8095","ENSBTAG00000013211","27",15497436,15516152,18716
"8096","ENSBTAG00000013212","22",59131697,59149421,17724
"8097","ENSBTAG00000013213","14",65332265,65339913,7648
"8098","ENSBTAG00000013215","2",103970393,104038722,68329
"8099","ENSBTAG00000013218","2",25523852,25556898,33046
"8100","ENSBTAG00000013219","1",87028551,87382268,353717
"8101","ENSBTAG00000013220","13",72771226,72780372,9146
"8102","ENSBTAG00000013221","24",7121098,7239471,118373
"8103","ENSBTAG00000013222","9",13201927,13341118,139191
"8104","ENSBTAG00000013224","9",88449225,88485099,35874
"8105","ENSBTAG00000013225","14",73748382,73804245,55863
"8106","ENSBTAG00000013226","4",74573944,74587244,13300
"8107","ENSBTAG00000013227","14",19941415,19945016,3601
"8108","ENSBTAG00000013231","8",51044476,51050554,6078
"8109","ENSBTAG00000013235","2",122142699,122178659,35960
"8110","ENSBTAG00000013236","19",39843840,39867840,24000
"8111","ENSBTAG00000013238","19",39878982,39929778,50796
"8112","ENSBTAG00000013239","18",48477099,48489316,12217
"8113","ENSBTAG00000013240","29",41158413,41199503,41090
"8114","ENSBTAG00000013241","3",91312841,91324220,11379
"8115","ENSBTAG00000013242","11",104400006,104408077,8071
"8116","ENSBTAG00000013244","X",86914646,86934091,19445
"8117","ENSBTAG00000013245","23",7745549,7813182,67633
"8118","ENSBTAG00000013247","18",63478435,63493232,14797
"8119","ENSBTAG00000013249","10",25641552,25655398,13846
"8120","ENSBTAG00000013250","X",86939604,86944224,4620
"8121","ENSBTAG00000013251","7",19627416,19645495,18079
"8122","ENSBTAG00000013253","3",120665994,120709495,43501
"8123","ENSBTAG00000013254","11",60136683,60178374,41691
"8124","ENSBTAG00000013256","5",1094237,1220337,126100
"8125","ENSBTAG00000013259","28",33674813,33723963,49150
"8126","ENSBTAG00000013260","X",94030462,94032343,1881
"8127","ENSBTAG00000013262","7",73400770,73417558,16788
"8128","ENSBTAG00000013263","4",68945977,68948264,2287
"8129","ENSBTAG00000013264","28",33725340,33742925,17585
"8130","ENSBTAG00000013265","18",39009906,39027609,17703
"8131","ENSBTAG00000013266","18",38964401,39006969,42568
"8132","ENSBTAG00000013270","19",33444096,33470553,26457
"8133","ENSBTAG00000013271","19",33326801,33442361,115560
"8134","ENSBTAG00000013273","19",33284684,33326707,42023
"8135","ENSBTAG00000013274","19",33274633,33282679,8046
"8136","ENSBTAG00000013275","16",41990741,42003150,12409
"8137","ENSBTAG00000013277","X",87274462,87289622,15160
"8138","ENSBTAG00000013278","X",87209267,87213287,4020
"8139","ENSBTAG00000013279","X",87290349,87305008,14659
"8140","ENSBTAG00000013281","2",135698556,135736414,37858
"8141","ENSBTAG00000013282","2",135674410,135688455,14045
"8142","ENSBTAG00000013283","18",50974851,50978007,3156
"8143","ENSBTAG00000013284","14",30994346,31055075,60729
"8144","ENSBTAG00000013287","4",93108630,93132945,24315
"8145","ENSBTAG00000013288","7",4184237,4213271,29034
"8146","ENSBTAG00000013289","X",91405559,91501300,95741
"8147","ENSBTAG00000013290","11",12899573,13123869,224296
"8148","ENSBTAG00000013291","7",4167879,4183780,15901
"8149","ENSBTAG00000013292","1",58218879,58326309,107430
"8150","ENSBTAG00000013294","16",4423580,4433770,10190
"8151","ENSBTAG00000013298","16",67906979,68081283,174304
"8152","ENSBTAG00000013300","28",32616314,33387186,770872
"8153","ENSBTAG00000013301","13",64158906,64183221,24315
"8154","ENSBTAG00000013302","2",61636892,61799766,162874
"8155","ENSBTAG00000013303","13",64186743,64233568,46825
"8156","ENSBTAG00000013305","25",10116901,10147359,30458
"8157","ENSBTAG00000013306","24",47693446,47994499,301053
"8158","ENSBTAG00000013308","NKLS02002208.1",8049264,8054472,5208
"8159","ENSBTAG00000013309","2",124374950,124400699,25749
"8160","ENSBTAG00000013311","X",89276444,89278960,2516
"8161","ENSBTAG00000013314","11",96551860,96776539,224679
"8162","ENSBTAG00000013315","5",56789495,56795018,5523
"8163","ENSBTAG00000013316","23",10118401,10154265,35864
"8164","ENSBTAG00000013317","1",71020360,71048691,28331
"8165","ENSBTAG00000013319","1",71044905,71052495,7590
"8166","ENSBTAG00000013320","3",99895907,99901044,5137
"8167","ENSBTAG00000013322","3",99869871,99894001,24130
"8168","ENSBTAG00000013326","17",13187215,13268352,81137
"8169","ENSBTAG00000013329","7",6796879,6826495,29616
"8170","ENSBTAG00000013330","13",60581480,60600669,19189
"8171","ENSBTAG00000013333","5",88602173,88658602,56429
"8172","ENSBTAG00000013334","3",109418279,109429587,11308
"8173","ENSBTAG00000013336","13",75584898,75761781,176883
"8174","ENSBTAG00000013337","18",55510391,55521354,10963
"8175","ENSBTAG00000013338","18",43263397,43296804,33407
"8176","ENSBTAG00000013339","13",22100371,22214013,113642
"8177","ENSBTAG00000013340","18",55530826,55535003,4177
"8178","ENSBTAG00000013341","X",138696888,138714389,17501
"8179","ENSBTAG00000013343","18",55538469,55540364,1895
"8180","ENSBTAG00000013345","18",61284316,61290145,5829
"8181","ENSBTAG00000013346","18",53305376,53309473,4097
"8182","ENSBTAG00000013347","18",53309385,53319942,10557
"8183","ENSBTAG00000013352","21",46767484,46769486,2002
"8184","ENSBTAG00000013353","18",65546714,65568827,22113
"8185","ENSBTAG00000013356","22",51579579,51621314,41735
"8186","ENSBTAG00000013357","8",41655032,41696334,41302
"8187","ENSBTAG00000013358","7",82217490,82219272,1782
"8188","ENSBTAG00000013362","7",15209049,15297760,88711
"8189","ENSBTAG00000013363","3",106037116,106066200,29084
"8190","ENSBTAG00000013364","26",10469273,10505106,35833
"8191","ENSBTAG00000013366","15",43584066,43612623,28557
"8192","ENSBTAG00000013367","3",106020188,106037050,16862
"8193","ENSBTAG00000013368","26",10506966,10534508,27542
"8194","ENSBTAG00000013369","14",81512830,81729606,216776
"8195","ENSBTAG00000013371","12",16369992,16408879,38887
"8196","ENSBTAG00000013378","1",116201550,116227639,26089
"8197","ENSBTAG00000013380","24",43219452,43293516,74064
"8198","ENSBTAG00000013384","23",30605335,30606276,941
"8199","ENSBTAG00000013387","13",63226304,63271073,44769
"8200","ENSBTAG00000013390","19",26564847,26567068,2221
"8201","ENSBTAG00000013391","20",58307527,58477497,169970
"8202","ENSBTAG00000013392","19",26543144,26556510,13366
"8203","ENSBTAG00000013393","19",22088342,22096721,8379
"8204","ENSBTAG00000013395","19",22088603,22089801,1198
"8205","ENSBTAG00000013400","9",89713051,89721607,8556
"8206","ENSBTAG00000013401","10",26001808,26023736,21928
"8207","ENSBTAG00000013403","11",72566960,72585095,18135
"8208","ENSBTAG00000013405","14",70563223,70588594,25371
"8209","ENSBTAG00000013406","5",6281008,6300975,19967
"8210","ENSBTAG00000013407","22",51439234,51463440,24206
"8211","ENSBTAG00000013408","14",70555362,70558316,2954
"8212","ENSBTAG00000013410","21",68022901,68140517,117616
"8213","ENSBTAG00000013411","16",44553028,44566771,13743
"8214","ENSBTAG00000013412","18",36732492,36772080,39588
"8215","ENSBTAG00000013413","22",51422933,51433253,10320
"8216","ENSBTAG00000013414","4",77284046,77335575,51529
"8217","ENSBTAG00000013416","13",42104889,42108976,4087
"8218","ENSBTAG00000013417","5",25478787,25482857,4070
"8219","ENSBTAG00000013419","29",24565819,24579990,14171
"8220","ENSBTAG00000013420","8",95277042,95335727,58685
"8221","ENSBTAG00000013421","29",24440296,24562058,121762
"8222","ENSBTAG00000013422","21",3866347,4146441,280094
"8223","ENSBTAG00000013423","21",60402134,60412055,9921
"8224","ENSBTAG00000013425","10",61080768,61113961,33193
"8225","ENSBTAG00000013426","20",22314474,22323346,8872
"8226","ENSBTAG00000013429","7",16561209,16564690,3481
"8227","ENSBTAG00000013436","18",46339517,46349797,10280
"8228","ENSBTAG00000013439","1",113382720,113519848,137128
"8229","ENSBTAG00000013440","18",46355865,46363445,7580
"8230","ENSBTAG00000013442","22",48976816,48978925,2109
"8231","ENSBTAG00000013443","5",56545369,56554855,9486
"8232","ENSBTAG00000013444","18",46367274,46369616,2342
"8233","ENSBTAG00000013449","2",62127818,62238789,110971
"8234","ENSBTAG00000013451","6",59202154,59250253,48099
"8235","ENSBTAG00000013452","10",52087944,52135881,47937
"8236","ENSBTAG00000013454","9",86593316,86652158,58842
"8237","ENSBTAG00000013455","2",58563828,58612726,48898
"8238","ENSBTAG00000013456","1",76794862,76815721,20859
"8239","ENSBTAG00000013460","1",46028911,46058876,29965
"8240","ENSBTAG00000013461","1",46061453,46066949,5496
"8241","ENSBTAG00000013462","X",37076248,37090660,14412
"8242","ENSBTAG00000013464","1",46077322,46098614,21292
"8243","ENSBTAG00000013465","1",46114976,46166455,51479
"8244","ENSBTAG00000013468","29",40815654,40907522,91868
"8245","ENSBTAG00000013469","19",39146536,39217469,70933
"8246","ENSBTAG00000013472","4",11776554,11812997,36443
"8247","ENSBTAG00000013473","4",93985493,93995180,9687
"8248","ENSBTAG00000013475","21",67549224,67603033,53809
"8249","ENSBTAG00000013476","4",94063807,94118110,54303
"8250","ENSBTAG00000013477","10",36312775,36316540,3765
"8251","ENSBTAG00000013478","26",18867898,18872334,4436
"8252","ENSBTAG00000013479","25",1576743,1588861,12118
"8253","ENSBTAG00000013480","10",36316703,36347349,30646
"8254","ENSBTAG00000013481","3",99319612,99334690,15078
"8255","ENSBTAG00000013483","16",26044153,26076530,32377
"8256","ENSBTAG00000013485","10",36346936,36354616,7680
"8257","ENSBTAG00000013486","5",49488842,49511314,22472
"8258","ENSBTAG00000013488","10",36354678,36378044,23366
"8259","ENSBTAG00000013489","2",106739389,106782307,42918
"8260","ENSBTAG00000013491","21",64706925,64908212,201287
"8261","ENSBTAG00000013492","2",106786779,106794751,7972
"8262","ENSBTAG00000013493","10",50557150,50607672,50522
"8263","ENSBTAG00000013495","6",99508632,99723220,214588
"8264","ENSBTAG00000013496","5",44876588,44960458,83870
"8265","ENSBTAG00000013498","12",16775264,16842147,66883
"8266","ENSBTAG00000013499","16",76858671,76878665,19994
"8267","ENSBTAG00000013501","19",20269612,20274600,4988
"8268","ENSBTAG00000013502","7",8179440,8205483,26043
"8269","ENSBTAG00000013505","3",115779091,115862207,83116
"8270","ENSBTAG00000013509","11",98396191,98411787,15596
"8271","ENSBTAG00000013510","11",98411722,98415785,4063
"8272","ENSBTAG00000013511","2",132262279,132314628,52349
"8273","ENSBTAG00000013513","14",61410572,61450792,40220
"8274","ENSBTAG00000013515","5",82866000,82896085,30085
"8275","ENSBTAG00000013523","19",38639481,38651271,11790
"8276","ENSBTAG00000013524","18",8044687,8257246,212559
"8277","ENSBTAG00000013525","23",27585431,27588663,3232
"8278","ENSBTAG00000013526","19",44566296,44603604,37308
"8279","ENSBTAG00000013527","16",43158594,43173975,15381
"8280","ENSBTAG00000013528","8",70374034,70387480,13446
"8281","ENSBTAG00000013530","23",27581609,27585128,3519
"8282","ENSBTAG00000013531","16",43134178,43148824,14646
"8283","ENSBTAG00000013532","19",44609317,44610582,1265
"8284","ENSBTAG00000013533","23",27575514,27581255,5741
"8285","ENSBTAG00000013534","19",44611313,44621130,9817
"8286","ENSBTAG00000013535","16",43110546,43120943,10397
"8287","ENSBTAG00000013536","7",14668284,14670849,2565
"8288","ENSBTAG00000013537","14",15865228,15995482,130254
"8289","ENSBTAG00000013538","16",42966075,43110580,144505
"8290","ENSBTAG00000013541","5",93264607,93328292,63685
"8291","ENSBTAG00000013544","28",9161993,9192514,30521
"8292","ENSBTAG00000013545","13",51338286,51351094,12808
"8293","ENSBTAG00000013548","X",34441838,34460179,18341
"8294","ENSBTAG00000013550","18",61583328,61602873,19545
"8295","ENSBTAG00000013555","5",27884739,27915481,30742
"8296","ENSBTAG00000013556","19",55770279,55785637,15358
"8297","ENSBTAG00000013557","7",96168529,96204132,35603
"8298","ENSBTAG00000013560","16",79913789,79917702,3913
"8299","ENSBTAG00000013562","20",38040008,38088539,48531
"8300","ENSBTAG00000013563","29",26197623,26239206,41583
"8301","ENSBTAG00000013568","29",26137688,26192124,54436
"8302","ENSBTAG00000013569","6",110986237,111044215,57978
"8303","ENSBTAG00000013573","19",53940667,53947960,7293
"8304","ENSBTAG00000013577","18",53864327,53893245,28918
"8305","ENSBTAG00000013578","3",32155439,32192735,37296
"8306","ENSBTAG00000013579","27",26248680,26273822,25142
"8307","ENSBTAG00000013580","11",48378513,48434868,56355
"8308","ENSBTAG00000013581","27",26280336,26290168,9832
"8309","ENSBTAG00000013585","28",31060271,31061655,1384
"8310","ENSBTAG00000013586","22",53043751,53046271,2520
"8311","ENSBTAG00000013587","24",538851,549831,10980
"8312","ENSBTAG00000013588","24",57933911,58044908,110997
"8313","ENSBTAG00000013589","11",48325513,48368467,42954
"8314","ENSBTAG00000013591","9",65426509,65543729,117220
"8315","ENSBTAG00000013592","28",13128462,13151181,22719
"8316","ENSBTAG00000013593","21",29153369,29166386,13017
"8317","ENSBTAG00000013596","5",64396366,64475743,79377
"8318","ENSBTAG00000013598","14",56385156,56556667,171511
"8319","ENSBTAG00000013600","1",139225714,139238322,12608
"8320","ENSBTAG00000013602","1",139238832,139362519,123687
"8321","ENSBTAG00000013606","29",42544629,42547701,3072
"8322","ENSBTAG00000013607","6",105290863,105332843,41980
"8323","ENSBTAG00000013611","17",28724059,28932798,208739
"8324","ENSBTAG00000013612","7",90012728,90037230,24502
"8325","ENSBTAG00000013613","7",6384274,6396721,12447
"8326","ENSBTAG00000013614","7",6356455,6383026,26571
"8327","ENSBTAG00000013615","29",5050449,5072434,21985
"8328","ENSBTAG00000013616","10",59393839,59460079,66240
"8329","ENSBTAG00000013619","2",71244652,71319376,74724
"8330","ENSBTAG00000013620","16",12190421,12232355,41934
"8331","ENSBTAG00000013621","14",69526133,69588076,61943
"8332","ENSBTAG00000013623","7",21154979,21156156,1177
"8333","ENSBTAG00000013624","7",21133347,21154526,21179
"8334","ENSBTAG00000013627","7",39280575,39286714,6139
"8335","ENSBTAG00000013628","7",39286373,39312475,26102
"8336","ENSBTAG00000013629","1",139443100,139458044,14944
"8337","ENSBTAG00000013631","16",63468038,63478788,10750
"8338","ENSBTAG00000013632","23",8140143,8255826,115683
"8339","ENSBTAG00000013635","5",94923693,94933948,10255
"8340","ENSBTAG00000013636","15",76341430,76374697,33267
"8341","ENSBTAG00000013638","10",14103229,14332391,229162
"8342","ENSBTAG00000013640","5",100946808,100964339,17531
"8343","ENSBTAG00000013641","26",39775458,39798891,23433
"8344","ENSBTAG00000013642","29",41285605,41293751,8146
"8345","ENSBTAG00000013644","29",41302545,41323004,20459
"8346","ENSBTAG00000013645","19",14997717,15072713,74996
"8347","ENSBTAG00000013648","4",81370877,81759991,389114
"8348","ENSBTAG00000013650","2",133346903,133363429,16526
"8349","ENSBTAG00000013651","28",28368606,28385093,16487
"8350","ENSBTAG00000013652","10",92473239,92511524,38285
"8351","ENSBTAG00000013653","19",38420711,38433852,13141
"8352","ENSBTAG00000013657","21",30945440,30973322,27882
"8353","ENSBTAG00000013658","5",107784433,108049841,265408
"8354","ENSBTAG00000013660","20",52703148,52703516,368
"8355","ENSBTAG00000013662","1",43902264,44073696,171432
"8356","ENSBTAG00000013663","1",44086074,44481342,395268
"8357","ENSBTAG00000013664","1",44096867,44402309,305442
"8358","ENSBTAG00000013665","24",614234,636393,22159
"8359","ENSBTAG00000013666","21",65203062,65216307,13245
"8360","ENSBTAG00000013667","1",44483988,44511474,27486
"8361","ENSBTAG00000013669","25",26438296,26453320,15024
"8362","ENSBTAG00000013670","8",102117909,102129395,11486
"8363","ENSBTAG00000013671","X",13920836,13937434,16598
"8364","ENSBTAG00000013674","17",10596771,10669858,73087
"8365","ENSBTAG00000013675","11",46612787,46619812,7025
"8366","ENSBTAG00000013676","11",25999952,26038209,38257
"8367","ENSBTAG00000013677","19",54705353,54755623,50270
"8368","ENSBTAG00000013678","14",73814998,73843583,28585
"8369","ENSBTAG00000013680","19",27364091,27369121,5030
"8370","ENSBTAG00000013686","17",64605375,64658202,52827
"8371","ENSBTAG00000013688","10",86200949,86214110,13161
"8372","ENSBTAG00000013689","21",12595813,12855267,259454
"8373","ENSBTAG00000013697","18",52724338,52749212,24874
"8374","ENSBTAG00000013698","19",42107008,42130544,23536
"8375","ENSBTAG00000013699","6",57213813,57429961,216148
"8376","ENSBTAG00000013700","16",34908876,34913559,4683
"8377","ENSBTAG00000013702","18",52749691,52753533,3842
"8378","ENSBTAG00000013705","23",17764635,17771918,7283
"8379","ENSBTAG00000013706","8",110032801,110110151,77350
"8380","ENSBTAG00000013708","25",40930356,40969236,38880
"8381","ENSBTAG00000013715","16",58500206,58558936,58730
"8382","ENSBTAG00000013716","22",57260252,57369366,109114
"8383","ENSBTAG00000013717","26",25654916,25658688,3772
"8384","ENSBTAG00000013718","6",86953984,87007062,53078
"8385","ENSBTAG00000013720","5",27585437,27592399,6962
"8386","ENSBTAG00000013721","X",56715369,56723016,7647
"8387","ENSBTAG00000013722","23",17801845,17813188,11343
"8388","ENSBTAG00000013723","22",57208568,57253578,45010
"8389","ENSBTAG00000013724","X",56720113,56799908,79795
"8390","ENSBTAG00000013725","22",57180178,57200607,20429
"8391","ENSBTAG00000013726","16",80509611,80522913,13302
"8392","ENSBTAG00000013727","1",69127863,69178521,50658
"8393","ENSBTAG00000013730","29",37422743,37445044,22301
"8394","ENSBTAG00000013732","4",89019866,89037983,18117
"8395","ENSBTAG00000013734","11",28966166,28974105,7939
"8396","ENSBTAG00000013735","28",8099451,8188434,88983
"8397","ENSBTAG00000013736","6",111165322,111279541,114219
"8398","ENSBTAG00000013737","13",66086809,66143601,56792
"8399","ENSBTAG00000013740","19",38533720,38565114,31394
"8400","ENSBTAG00000013744","7",61971868,62026834,54966
"8401","ENSBTAG00000013745","5",25662272,25683364,21092
"8402","ENSBTAG00000013749","11",28991537,29029383,37846
"8403","ENSBTAG00000013750","28",8187545,8253106,65561
"8404","ENSBTAG00000013753","13",52004036,52014649,10613
"8405","ENSBTAG00000013755","1",69196881,69312128,115247
"8406","ENSBTAG00000013757","18",35149908,35189850,39942
"8407","ENSBTAG00000013760","X",56803357,57140369,337012
"8408","ENSBTAG00000013761","2",127152813,127183806,30993
"8409","ENSBTAG00000013763","26",37058422,37066152,7730
"8410","ENSBTAG00000013764","16",1257070,1266500,9430
"8411","ENSBTAG00000013766","18",51923715,51927617,3902
"8412","ENSBTAG00000013768","4",62120709,62274639,153930
"8413","ENSBTAG00000013769","1",55893616,56089185,195569
"8414","ENSBTAG00000013772","2",128253260,128282672,29412
"8415","ENSBTAG00000013773","2",37644721,37901601,256880
"8416","ENSBTAG00000013774","10",35947853,35956754,8901
"8417","ENSBTAG00000013776","13",51988372,52001677,13305
"8418","ENSBTAG00000013778","3",58957671,59043012,85341
"8419","ENSBTAG00000013779","26",37069912,37241123,171211
"8420","ENSBTAG00000013781","4",15634972,15672063,37091
"8421","ENSBTAG00000013782","2",107227555,107234943,7388
"8422","ENSBTAG00000013784","18",26016093,26051043,34950
"8423","ENSBTAG00000013790","20",22340163,22417428,77265
"8424","ENSBTAG00000013791","18",46054918,46059770,4852
"8425","ENSBTAG00000013792","19",55443082,55449253,6171
"8426","ENSBTAG00000013793","10",54425968,54570727,144759
"8427","ENSBTAG00000013798","2",107236824,107256280,19456
"8428","ENSBTAG00000013799","2",107259185,107259703,518
"8429","ENSBTAG00000013801","3",4147294,4246502,99208
"8430","ENSBTAG00000013802","3",88677121,89136086,458965
"8431","ENSBTAG00000013806","1",157125001,157190548,65547
"8432","ENSBTAG00000013810","8",63383029,63749799,366770
"8433","ENSBTAG00000013812","16",12164240,12190959,26719
"8434","ENSBTAG00000013813","16",51499247,51512948,13701
"8435","ENSBTAG00000013819","12",32066532,32076509,9977
"8436","ENSBTAG00000013821","23",47942974,47960131,17157
"8437","ENSBTAG00000013824","X",132631819,132741312,109493
"8438","ENSBTAG00000013825","5",85057073,85174596,117523
"8439","ENSBTAG00000013830","10",58404147,58440198,36051
"8440","ENSBTAG00000013831","24",25777696,25821610,43914
"8441","ENSBTAG00000013832","3",106204847,106248823,43976
"8442","ENSBTAG00000013836","10",76507877,76538495,30618
"8443","ENSBTAG00000013837","9",38345563,38366634,21071
"8444","ENSBTAG00000013838","8",110928191,110951725,23534
"8445","ENSBTAG00000013841","1",1099127,1100145,1018
"8446","ENSBTAG00000013842","5",64170245,64189511,19266
"8447","ENSBTAG00000013843","5",27943530,27957768,14238
"8448","ENSBTAG00000013848","17",46030140,46206056,175916
"8449","ENSBTAG00000013849","16",12596362,12623734,27372
"8450","ENSBTAG00000013851","3",58819705,58829797,10092
"8451","ENSBTAG00000013854","13",43143556,43144390,834
"8452","ENSBTAG00000013855","19",40256170,40262469,6299
"8453","ENSBTAG00000013856","7",81401606,81711503,309897
"8454","ENSBTAG00000013857","7",17732309,17747008,14699
"8455","ENSBTAG00000013858","25",7883250,7907314,24064
"8456","ENSBTAG00000013859","5",64220436,64277577,57141
"8457","ENSBTAG00000013860","3",77648760,77651872,3112
"8458","ENSBTAG00000013861","11",22410362,22764982,354620
"8459","ENSBTAG00000013863","20",4540518,4543611,3093
"8460","ENSBTAG00000013866","3",16447956,16449471,1515
"8461","ENSBTAG00000013867","3",110769753,110827938,58185
"8462","ENSBTAG00000013869","3",114535147,114633955,98808
"8463","ENSBTAG00000013873","20",6444184,6449312,5128
"8464","ENSBTAG00000013874","18",25994990,26008531,13541
"8465","ENSBTAG00000013875","26",37467830,37472057,4227
"8466","ENSBTAG00000013877","17",69132614,69203058,70444
"8467","ENSBTAG00000013879","12",12301388,12339175,37787
"8468","ENSBTAG00000013880","7",80336697,80493580,156883
"8469","ENSBTAG00000013881","3",110888198,110890904,2706
"8470","ENSBTAG00000013882","18",65775983,65778680,2697
"8471","ENSBTAG00000013884","29",43816352,43829063,12711
"8472","ENSBTAG00000013885","16",32767321,32799776,32455
"8473","ENSBTAG00000013888","21",47777670,47782907,5237
"8474","ENSBTAG00000013889","11",105895673,105897519,1846
"8475","ENSBTAG00000013895","29",43830884,43840041,9157
"8476","ENSBTAG00000013898","19",50992167,50992784,617
"8477","ENSBTAG00000013899","13",46389229,46478656,89427
"8478","ENSBTAG00000013900","15",50637416,50648514,11098
"8479","ENSBTAG00000013901","14",67893306,67960782,67476
"8480","ENSBTAG00000013905","26",31124223,31163013,38790
"8481","ENSBTAG00000013906","19",26325242,26337507,12265
"8482","ENSBTAG00000013907","3",9983501,9987619,4118
"8483","ENSBTAG00000013909","1",57945013,58023212,78199
"8484","ENSBTAG00000013910","3",21398790,21402032,3242
"8485","ENSBTAG00000013912","5",67898938,67961973,63035
"8486","ENSBTAG00000013914","17",5993019,6093988,100969
"8487","ENSBTAG00000013915","13",65811649,65827589,15940
"8488","ENSBTAG00000013916","2",719767,951758,231991
"8489","ENSBTAG00000013917","25",26832768,26844133,11365
"8490","ENSBTAG00000013918","6",77075369,77651502,576133
"8491","ENSBTAG00000013919","23",25723715,25735337,11622
"8492","ENSBTAG00000013920","1",58075022,58113303,38281
"8493","ENSBTAG00000013921","18",52956472,52966223,9751
"8494","ENSBTAG00000013922","X",18574679,18598914,24235
"8495","ENSBTAG00000013923","11",19792170,19822758,30588
"8496","ENSBTAG00000013924","18",55950306,55952940,2634
"8497","ENSBTAG00000013925","13",16109664,16134182,24518
"8498","ENSBTAG00000013926","18",55961445,55968132,6687
"8499","ENSBTAG00000013927","6",19301432,19453018,151586
"8500","ENSBTAG00000013928","13",74360635,74367977,7342
"8501","ENSBTAG00000013929","18",34626237,34629485,3248
"8502","ENSBTAG00000013930","13",16093405,16110168,16763
"8503","ENSBTAG00000013931","18",34635125,34637400,2275
"8504","ENSBTAG00000013932","22",50863214,50866898,3684
"8505","ENSBTAG00000013935","28",5833249,5871529,38280
"8506","ENSBTAG00000013937","1",58141829,58199879,58050
"8507","ENSBTAG00000013938","1",97196214,97271658,75444
"8508","ENSBTAG00000013941","18",36121354,36305835,184481
"8509","ENSBTAG00000013942","29",40162375,40188645,26270
"8510","ENSBTAG00000013943","27",32978496,32981525,3029
"8511","ENSBTAG00000013946","3",20311487,20330731,19244
"8512","ENSBTAG00000013947","8",74749188,74764924,15736
"8513","ENSBTAG00000013949","16",30410191,30514782,104591
"8514","ENSBTAG00000013951","17",44386512,44411465,24953
"8515","ENSBTAG00000013952","6",97143335,97160733,17398
"8516","ENSBTAG00000013953","4",98573632,98679000,105368
"8517","ENSBTAG00000013955","14",3200372,3587738,387366
"8518","ENSBTAG00000013956","5",109082265,109133396,51131
"8519","ENSBTAG00000013957","2",30545764,30569913,24149
"8520","ENSBTAG00000013958","18",48852699,48900413,47714
"8521","ENSBTAG00000013960","8",54216465,54245158,28693
"8522","ENSBTAG00000013961","3",87349595,87391325,41730
"8523","ENSBTAG00000013971","17",72208853,72268526,59673
"8524","ENSBTAG00000013973","17",72232163,72238762,6599
"8525","ENSBTAG00000013974","8",11330165,11335552,5387
"8526","ENSBTAG00000013976","4",98689853,98789432,99579
"8527","ENSBTAG00000013977","7",3253358,3285153,31795
"8528","ENSBTAG00000013979","5",63864751,63899114,34363
"8529","ENSBTAG00000013980","6",44387091,44393158,6067
"8530","ENSBTAG00000013981","21",44882558,44901774,19216
"8531","ENSBTAG00000013982","10",17533608,17619279,85671
"8532","ENSBTAG00000013983","10",86319206,86327460,8254
"8533","ENSBTAG00000013984","12",28051025,28088332,37307
"8534","ENSBTAG00000013988","5",109136740,109154244,17504
"8535","ENSBTAG00000013989","15",33502740,33584763,82023
"8536","ENSBTAG00000013990","2",106822087,106835094,13007
"8537","ENSBTAG00000013991","9",41936619,41957320,20701
"8538","ENSBTAG00000013992","10",86307298,86313688,6390
"8539","ENSBTAG00000013995","X",113428153,113430601,2448
"8540","ENSBTAG00000013996","6",115911950,115946978,35028
"8541","ENSBTAG00000013997","15",51399833,51403671,3838
"8542","ENSBTAG00000013999","16",60375301,60417812,42511
"8543","ENSBTAG00000014001","21",55255841,55276709,20868
"8544","ENSBTAG00000014002","19",48686458,48723349,36891
"8545","ENSBTAG00000014003","5",10275115,10277301,2186
"8546","ENSBTAG00000014005","21",55277905,55318422,40517
"8547","ENSBTAG00000014006","16",60422988,60450960,27972
"8548","ENSBTAG00000014007","17",17174575,17203917,29342
"8549","ENSBTAG00000014011","10",58560371,58610111,49740
"8550","ENSBTAG00000014012","24",35518976,35545065,26089
"8551","ENSBTAG00000014014","16",42376909,42387230,10321
"8552","ENSBTAG00000014015","5",109891806,109938952,47146
"8553","ENSBTAG00000014016","4",5505954,5599101,93147
"8554","ENSBTAG00000014017","6",117551688,117594229,42541
"8555","ENSBTAG00000014020","28",18283704,18400082,116378
"8556","ENSBTAG00000014021","4",102782997,102852321,69324
"8557","ENSBTAG00000014023","28",24405508,24432036,26528
"8558","ENSBTAG00000014024","12",31471716,31482858,11142
"8559","ENSBTAG00000014026","14",44178038,44329953,151915
"8560","ENSBTAG00000014027","10",3972433,4015816,43383
"8561","ENSBTAG00000014028","26",42767646,42780839,13193
"8562","ENSBTAG00000014029","28",24437054,24564497,127443
"8563","ENSBTAG00000014030","5",24766344,24868854,102510
"8564","ENSBTAG00000014031","6",58051143,58070580,19437
"8565","ENSBTAG00000014032","14",47572111,47669435,97324
"8566","ENSBTAG00000014038","6",90413362,90454715,41353
"8567","ENSBTAG00000014041","6",90469442,90561190,91748
"8568","ENSBTAG00000014042","6",58034093,58059082,24989
"8569","ENSBTAG00000014043","12",79079749,79107518,27769
"8570","ENSBTAG00000014044","5",24868908,24939568,70660
"8571","ENSBTAG00000014046","13",67172370,67201998,29628
"8572","ENSBTAG00000014048","13",47916971,48028742,111771
"8573","ENSBTAG00000014050","27",37469274,37496681,27407
"8574","ENSBTAG00000014051","14",56984054,57285247,301193
"8575","ENSBTAG00000014053","23",45349611,45399368,49757
"8576","ENSBTAG00000014054","9",62457382,62493333,35951
"8577","ENSBTAG00000014056","27",37508456,37521577,13121
"8578","ENSBTAG00000014057","9",62413961,62445501,31540
"8579","ENSBTAG00000014058","6",111699769,112153362,453593
"8580","ENSBTAG00000014059","16",1400155,1497069,96914
"8581","ENSBTAG00000014060","17",12162216,12177198,14982
"8582","ENSBTAG00000014062","9",102450455,102463266,12811
"8583","ENSBTAG00000014063","23",12560570,12888737,328167
"8584","ENSBTAG00000014064","26",41450745,41558092,107347
"8585","ENSBTAG00000014068","27",37235271,37246636,11365
"8586","ENSBTAG00000014069","4",12881889,12895362,13473
"8587","ENSBTAG00000014074","4",26324012,26469689,145677
"8588","ENSBTAG00000014075","13",16140331,16172586,32255
"8589","ENSBTAG00000014076","6",98233356,98250555,17199
"8590","ENSBTAG00000014078","8",62441823,62458755,16932
"8591","ENSBTAG00000014079","3",112454968,112584264,129296
"8592","ENSBTAG00000014080","6",6640184,6679178,38994
"8593","ENSBTAG00000014081","11",82736891,83207199,470308
"8594","ENSBTAG00000014082","24",29688812,29966256,277444
"8595","ENSBTAG00000014083","3",33940232,33945726,5494
"8596","ENSBTAG00000014087","18",62131439,62138720,7281
"8597","ENSBTAG00000014088","X",16211737,16325665,113928
"8598","ENSBTAG00000014089","21",33650514,33697085,46571
"8599","ENSBTAG00000014090","11",2557613,2569332,11719
"8600","ENSBTAG00000014091","22",44017422,44330646,313224
"8601","ENSBTAG00000014092","10",19210000,19240414,30414
"8602","ENSBTAG00000014093","21",21478221,21494539,16318
"8603","ENSBTAG00000014095","X",36686215,36703223,17008
"8604","ENSBTAG00000014096","10",72321920,72374502,52582
"8605","ENSBTAG00000014099","10",2413343,2486039,72696
"8606","ENSBTAG00000014100","25",1056554,1070398,13844
"8607","ENSBTAG00000014101","25",1070341,1072788,2447
"8608","ENSBTAG00000014102","3",31863581,31873115,9534
"8609","ENSBTAG00000014103","8",26598842,26826372,227530
"8610","ENSBTAG00000014105","29",29610847,29617171,6324
"8611","ENSBTAG00000014106","5",78855488,78922350,66862
"8612","ENSBTAG00000014111","17",15374564,15824212,449648
"8613","ENSBTAG00000014112","4",96940092,97744748,804656
"8614","ENSBTAG00000014113","19",15807710,15809743,2033
"8615","ENSBTAG00000014114","7",4528389,4555291,26902
"8616","ENSBTAG00000014117","18",54269145,54282523,13378
"8617","ENSBTAG00000014118","25",1072873,1083886,11013
"8618","ENSBTAG00000014119","16",50600040,50699718,99678
"8619","ENSBTAG00000014122","29",29617419,29625087,7668
"8620","ENSBTAG00000014123","18",42860282,42903275,42993
"8621","ENSBTAG00000014124","8",23784601,24069145,284544
"8622","ENSBTAG00000014126","25",1084235,1115788,31553
"8623","ENSBTAG00000014127","16",67728006,67735629,7623
"8624","ENSBTAG00000014129","5",57321765,57337350,15585
"8625","ENSBTAG00000014130","14",64442651,64452623,9972
"8626","ENSBTAG00000014132","3",120284114,120324147,40033
"8627","ENSBTAG00000014135","27",7631348,7701071,69723
"8628","ENSBTAG00000014136","16",50593827,50598411,4584
"8629","ENSBTAG00000014137","15",28011130,28073376,62246
"8630","ENSBTAG00000014138","X",33267806,33360219,92413
"8631","ENSBTAG00000014140","1",127050091,127086255,36164
"8632","ENSBTAG00000014141","27",7702924,7711887,8963
"8633","ENSBTAG00000014143","27",7720264,7761066,40802
"8634","ENSBTAG00000014144","18",26085843,26119863,34020
"8635","ENSBTAG00000014146","27",7777104,7782843,5739
"8636","ENSBTAG00000014147","18",26119132,26132035,12903
"8637","ENSBTAG00000014149","11",98781893,98785927,4034
"8638","ENSBTAG00000014150","11",98789901,98793297,3396
"8639","ENSBTAG00000014151","3",1011191,1083046,71855
"8640","ENSBTAG00000014153","1",143182017,143202288,20271
"8641","ENSBTAG00000014156","5",78176178,78261615,85437
"8642","ENSBTAG00000014157","1",63957312,63961902,4590
"8643","ENSBTAG00000014158","2",62319905,62352405,32500
"8644","ENSBTAG00000014159","11",46209195,46242645,33450
"8645","ENSBTAG00000014161","4",44363508,44428499,64991
"8646","ENSBTAG00000014162","22",14872158,14933266,61108
"8647","ENSBTAG00000014166","11",46252625,46274597,21972
"8648","ENSBTAG00000014167","15",51553511,51637874,84363
"8649","ENSBTAG00000014169","X",49303935,49430984,127049
"8650","ENSBTAG00000014170","X",19832647,19860095,27448
"8651","ENSBTAG00000014171","4",44427825,44517650,89825
"8652","ENSBTAG00000014172","23",10916507,10942796,26289
"8653","ENSBTAG00000014175","5",94018317,94039904,21587
"8654","ENSBTAG00000014176","13",61074110,61083228,9118
"8655","ENSBTAG00000014177","20",33315988,33442085,126097
"8656","ENSBTAG00000014178","13",39901567,40188462,286895
"8657","ENSBTAG00000014179","13",74766798,74795844,29046
"8658","ENSBTAG00000014181","10",51225052,51318938,93886
"8659","ENSBTAG00000014182","7",49921360,50255751,334391
"8660","ENSBTAG00000014186","13",74797673,74824936,27263
"8661","ENSBTAG00000014187","18",53096254,53101788,5534
"8662","ENSBTAG00000014189","10",83871181,84062445,191264
"8663","ENSBTAG00000014191","16",61362225,61403864,41639
"8664","ENSBTAG00000014192","7",50189492,50193541,4049
"8665","ENSBTAG00000014194","13",46039122,46276680,237558
"8666","ENSBTAG00000014197","5",33400460,33483891,83431
"8667","ENSBTAG00000014199","19",38715293,38727078,11785
"8668","ENSBTAG00000014202","19",38489984,38499387,9403
"8669","ENSBTAG00000014204","3",16769716,16776627,6911
"8670","ENSBTAG00000014205","22",51085591,51155609,70018
"8671","ENSBTAG00000014207","7",17159713,17179480,19767
"8672","ENSBTAG00000014208","1",70176689,70180132,3443
"8673","ENSBTAG00000014211","23",15366276,15417429,51153
"8674","ENSBTAG00000014215","29",37169742,37178905,9163
"8675","ENSBTAG00000014217","26",14075882,14081682,5800
"8676","ENSBTAG00000014218","26",6846290,6849518,3228
"8677","ENSBTAG00000014220","4",40319707,40360899,41192
"8678","ENSBTAG00000014221","2",135877622,135881588,3966
"8679","ENSBTAG00000014223","X",52203745,52205702,1957
"8680","ENSBTAG00000014224","29",33104035,33160157,56122
"8681","ENSBTAG00000014225","3",97963204,98001735,38531
"8682","ENSBTAG00000014226","6",16671257,16675901,4644
"8683","ENSBTAG00000014227","12",54578637,54649183,70546
"8684","ENSBTAG00000014228","4",52282339,52499410,217071
"8685","ENSBTAG00000014229","25",16711129,16799832,88703
"8686","ENSBTAG00000014230","21",61642000,61722292,80292
"8687","ENSBTAG00000014232","17",69494398,69553439,59041
"8688","ENSBTAG00000014233","1",7114205,7127950,13745
"8689","ENSBTAG00000014235","3",110835276,110839536,4260
"8690","ENSBTAG00000014236","10",18653771,18659405,5634
"8691","ENSBTAG00000014237","5",75703658,75734563,30905
"8692","ENSBTAG00000014238","5",109061445,109082272,20827
"8693","ENSBTAG00000014239","20",10507979,10517702,9723
"8694","ENSBTAG00000014246","20",10483634,10502446,18812
"8695","ENSBTAG00000014247","5",111356401,111392015,35614
"8696","ENSBTAG00000014248","20",22279228,22305654,26426
"8697","ENSBTAG00000014249","16",66278361,66299316,20955
"8698","ENSBTAG00000014250","4",102641445,102653875,12430
"8699","ENSBTAG00000014251","15",6031820,6089843,58023
"8700","ENSBTAG00000014252","13",6598913,6750081,151168
"8701","ENSBTAG00000014253","23",11148615,11223026,74411
"8702","ENSBTAG00000014255","4",10600800,10732873,132073
"8703","ENSBTAG00000014261","20",40309676,40332876,23200
"8704","ENSBTAG00000014262","4",25130690,25193513,62823
"8705","ENSBTAG00000014265","5",112832407,112890177,57770
"8706","ENSBTAG00000014267","18",12991196,13036196,45000
"8707","ENSBTAG00000014269","17",50929375,51022457,93082
"8708","ENSBTAG00000014270","28",27352171,27443527,91356
"8709","ENSBTAG00000014272","23",22196643,22263733,67090
"8710","ENSBTAG00000014273","4",93449966,93576616,126650
"8711","ENSBTAG00000014278","19",11683158,11692577,9419
"8712","ENSBTAG00000014284","24",57611636,57740561,128925
"8713","ENSBTAG00000014286","12",35853109,35914424,61315
"8714","ENSBTAG00000014288","5",96929922,96937085,7163
"8715","ENSBTAG00000014289","3",94018750,94201518,182768
"8716","ENSBTAG00000014291","3",30790883,30805442,14559
"8717","ENSBTAG00000014294","3",30702703,30844632,141929
"8718","ENSBTAG00000014295","3",30657802,30701981,44179
"8719","ENSBTAG00000014296","18",48915266,48919376,4110
"8720","ENSBTAG00000014297","3",30624734,30652245,27511
"8721","ENSBTAG00000014299","3",30617923,30624465,6542
"8722","ENSBTAG00000014300","29",24321077,24376246,55169
"8723","ENSBTAG00000014302","1",44650783,44687949,37166
"8724","ENSBTAG00000014304","X",108635859,108663641,27782
"8725","ENSBTAG00000014306","1",148516597,148594523,77926
"8726","ENSBTAG00000014310","11",19440552,19541520,100968
"8727","ENSBTAG00000014312","10",43448785,43524337,75552
"8728","ENSBTAG00000014313","26",19468898,19494715,25817
"8729","ENSBTAG00000014314","26",19496140,19521528,25388
"8730","ENSBTAG00000014315","28",24716180,24739190,23010
"8731","ENSBTAG00000014316","28",24751331,24762283,10952
"8732","ENSBTAG00000014318","1",111829274,111850038,20764
"8733","ENSBTAG00000014319","16",39259084,39909380,650296
"8734","ENSBTAG00000014320","7",31794298,31854776,60478
"8735","ENSBTAG00000014322","5",96786665,96862648,75983
"8736","ENSBTAG00000014324","6",94579877,94757659,177782
"8737","ENSBTAG00000014325","3",108213369,108220804,7435
"8738","ENSBTAG00000014326","3",108198136,108213207,15071
"8739","ENSBTAG00000014328","18",61238819,61255678,16859
"8740","ENSBTAG00000014329","13",73593275,73596222,2947
"8741","ENSBTAG00000014331","X",37544098,37547550,3452
"8742","ENSBTAG00000014333","X",37547328,37550770,3442
"8743","ENSBTAG00000014334","10",79599600,79667575,67975
"8744","ENSBTAG00000014335","26",23450403,23456668,6265
"8745","ENSBTAG00000014336","26",23347562,23403774,56212
"8746","ENSBTAG00000014337","X",119205686,119220743,15057
"8747","ENSBTAG00000014339","29",29246639,29250458,3819
"8748","ENSBTAG00000014340","5",20929215,20936827,7612
"8749","ENSBTAG00000014343","25",35409967,35415333,5366
"8750","ENSBTAG00000014349","7",43262900,43270904,8004
"8751","ENSBTAG00000014351","10",35590812,35687969,97157
"8752","ENSBTAG00000014353","10",35688239,35691505,3266
"8753","ENSBTAG00000014354","15",28497534,28534109,36575
"8754","ENSBTAG00000014355","19",36193752,36216596,22844
"8755","ENSBTAG00000014357","14",67588233,67708225,119992
"8756","ENSBTAG00000014358","3",109535132,109537474,2342
"8757","ENSBTAG00000014359","16",41962331,41990486,28155
"8758","ENSBTAG00000014361","8",69401490,69417369,15879
"8759","ENSBTAG00000014365","7",10998204,11027956,29752
"8760","ENSBTAG00000014366","29",37223625,37233385,9760
"8761","ENSBTAG00000014367","X",138349121,138384937,35816
"8762","ENSBTAG00000014368","3",9152844,9174085,21241
"8763","ENSBTAG00000014370","18",15485075,15548896,63821
"8764","ENSBTAG00000014371","4",113811847,113816294,4447
"8765","ENSBTAG00000014372","4",113816436,113848095,31659
"8766","ENSBTAG00000014373","7",89936049,89953630,17581
"8767","ENSBTAG00000014374","20",33625018,33639878,14860
"8768","ENSBTAG00000014375","5",24306913,24595494,288581
"8769","ENSBTAG00000014376","17",63266238,63301078,34840
"8770","ENSBTAG00000014377","19",27570592,27594543,23951
"8771","ENSBTAG00000014380","22",59896021,59912780,16759
"8772","ENSBTAG00000014381","4",65647996,65705053,57057
"8773","ENSBTAG00000014382","3",83258392,83334028,75636
"8774","ENSBTAG00000014384","10",88330013,88338164,8151
"8775","ENSBTAG00000014387","3",22528348,22542857,14509
"8776","ENSBTAG00000014388","2",121298262,121306107,7845
"8777","ENSBTAG00000014389","4",30225647,30305513,79866
"8778","ENSBTAG00000014390","2",121291040,121298203,7163
"8779","ENSBTAG00000014391","11",94503778,94525383,21605
"8780","ENSBTAG00000014392","10",70515394,70541963,26569
"8781","ENSBTAG00000014393","3",15367523,15376512,8989
"8782","ENSBTAG00000014395","7",63021619,63108191,86572
"8783","ENSBTAG00000014396","14",61770129,61776507,6378
"8784","ENSBTAG00000014397","NKLS02002208.1",4780880,4781713,833
"8785","ENSBTAG00000014399","15",63556795,63634185,77390
"8786","ENSBTAG00000014400","2",129326862,129343702,16840
"8787","ENSBTAG00000014401","8",69848988,69878635,29647
"8788","ENSBTAG00000014402","4",112850270,112874233,23963
"8789","ENSBTAG00000014405","2",18481775,18696841,215066
"8790","ENSBTAG00000014406","12",35662146,35684640,22494
"8791","ENSBTAG00000014407","2",94363694,94404651,40957
"8792","ENSBTAG00000014409","2",62271904,62313297,41393
"8793","ENSBTAG00000014412","7",15828841,15844379,15538
"8794","ENSBTAG00000014415","7",15846201,15863557,17356
"8795","ENSBTAG00000014417","25",32610385,32659631,49246
"8796","ENSBTAG00000014418","22",40819274,41605063,785789
"8797","ENSBTAG00000014420","23",27206155,27209354,3199
"8798","ENSBTAG00000014421","23",27199606,27203174,3568
"8799","ENSBTAG00000014422","21",27438000,27475154,37154
"8800","ENSBTAG00000014423","16",47144460,47152159,7699
"8801","ENSBTAG00000014424","5",30816500,30821420,4920
"8802","ENSBTAG00000014426","5",30799602,30814717,15115
"8803","ENSBTAG00000014429","5",30764350,30796550,32200
"8804","ENSBTAG00000014430","8",102506038,102517195,11157
"8805","ENSBTAG00000014432","2",59138783,59180569,41786
"8806","ENSBTAG00000014433","19",24797195,24884781,87586
"8807","ENSBTAG00000014434","23",27992754,28004146,11392
"8808","ENSBTAG00000014435","23",27988581,27992408,3827
"8809","ENSBTAG00000014438","13",55025849,55054212,28363
"8810","ENSBTAG00000014439","16",35178266,35246743,68477
"8811","ENSBTAG00000014440","21",30920003,30927850,7847
"8812","ENSBTAG00000014441","1",56306180,56403972,97792
"8813","ENSBTAG00000014442","13",55018299,55025069,6770
"8814","ENSBTAG00000014443","19",27949539,27954573,5034
"8815","ENSBTAG00000014447","2",126574904,126612862,37958
"8816","ENSBTAG00000014448","25",27845210,27901668,56458
"8817","ENSBTAG00000014449","1",83419537,83420366,829
"8818","ENSBTAG00000014450","18",55990005,56002003,11998
"8819","ENSBTAG00000014451","1",83313948,83416551,102603
"8820","ENSBTAG00000014453","25",21334598,21345432,10834
"8821","ENSBTAG00000014454","18",56009113,56018665,9552
"8822","ENSBTAG00000014455","20",41504814,41907383,402569
"8823","ENSBTAG00000014456","25",21345154,21368273,23119
"8824","ENSBTAG00000014458","14",652785,702430,49645
"8825","ENSBTAG00000014459","1",83304567,83311791,7224
"8826","ENSBTAG00000014460","1",83246423,83301299,54876
"8827","ENSBTAG00000014461","1",134839356,134845010,5654
"8828","ENSBTAG00000014463","6",11800357,12107600,307243
"8829","ENSBTAG00000014464","17",69431412,69441202,9790
"8830","ENSBTAG00000014465","25",35596139,35617193,21054
"8831","ENSBTAG00000014466","3",26012214,26074278,62064
"8832","ENSBTAG00000014467","8",40574216,40693751,119535
"8833","ENSBTAG00000014468","25",35578151,35585220,7069
"8834","ENSBTAG00000014469","2",91317091,91471377,154286
"8835","ENSBTAG00000014470","22",60550594,60578426,27832
"8836","ENSBTAG00000014471","8",99312764,99721951,409187
"8837","ENSBTAG00000014472","21",55083401,55085458,2057
"8838","ENSBTAG00000014474","15",73423823,73450600,26777
"8839","ENSBTAG00000014476","21",55085724,55109133,23409
"8840","ENSBTAG00000014478","21",55112823,55121590,8767
"8841","ENSBTAG00000014479","21",55122674,55164325,41651
"8842","ENSBTAG00000014482","3",95351469,95849104,497635
"8843","ENSBTAG00000014484","28",17262964,17324416,61452
"8844","ENSBTAG00000014485","X",66868308,66966819,98511
"8845","ENSBTAG00000014486","12",36641397,36664200,22803
"8846","ENSBTAG00000014488","24",10779992,10928376,148384
"8847","ENSBTAG00000014490","23",27748035,27761676,13641
"8848","ENSBTAG00000014491","23",27743849,27746134,2285
"8849","ENSBTAG00000014492","23",27732075,27742916,10841
"8850","ENSBTAG00000014493","10",45556247,45639746,83499
"8851","ENSBTAG00000014494","9",101760237,101777925,17688
"8852","ENSBTAG00000014495","9",101818057,101845437,27380
"8853","ENSBTAG00000014496","9",101910811,101926256,15445
"8854","ENSBTAG00000014497","9",101940497,101941435,938
"8855","ENSBTAG00000014498","9",102000999,102029738,28739
"8856","ENSBTAG00000014501","10",65537750,65613540,75790
"8857","ENSBTAG00000014502","25",40660506,40671058,10552
"8858","ENSBTAG00000014503","25",40672716,40712775,40059
"8859","ENSBTAG00000014505","21",21635601,21641668,6067
"8860","ENSBTAG00000014506","28",31133122,31135786,2664
"8861","ENSBTAG00000014508","1",66095751,66108659,12908
"8862","ENSBTAG00000014511","16",51375151,51400873,25722
"8863","ENSBTAG00000014512","6",58350006,58428640,78634
"8864","ENSBTAG00000014513","15",78970795,78971743,948
"8865","ENSBTAG00000014514","18",55296103,55313202,17099
"8866","ENSBTAG00000014515","6",58431359,58492858,61499
"8867","ENSBTAG00000014517","6",58528467,58563083,34616
"8868","ENSBTAG00000014518","6",58564663,58569422,4759
"8869","ENSBTAG00000014520","6",58569574,58581438,11864
"8870","ENSBTAG00000014521","6",58585317,58620122,34805
"8871","ENSBTAG00000014522","6",58632233,58690833,58600
"8872","ENSBTAG00000014523","8",87226523,87261139,34616
"8873","ENSBTAG00000014525","5",107170136,107208656,38520
"8874","ENSBTAG00000014526","7",21451865,21470865,19000
"8875","ENSBTAG00000014529","3",54451265,54507578,56313
"8876","ENSBTAG00000014530","3",35852447,36220155,367708
"8877","ENSBTAG00000014533","4",106252812,106278917,26105
"8878","ENSBTAG00000014534","9",13011231,13020524,9293
"8879","ENSBTAG00000014536","10",5613866,5674977,61111
"8880","ENSBTAG00000014538","3",106386092,106398512,12420
"8881","ENSBTAG00000014540","16",51493180,51498783,5603
"8882","ENSBTAG00000014541","25",42013602,42030396,16794
"8883","ENSBTAG00000014543","4",95795104,95958170,163066
"8884","ENSBTAG00000014546","5",99833307,99860241,26934
"8885","ENSBTAG00000014547","22",390221,392579,2358
"8886","ENSBTAG00000014548","16",65831839,66012562,180723
"8887","ENSBTAG00000014549","22",48169659,48175878,6219
"8888","ENSBTAG00000014550","22",48157167,48169414,12247
"8889","ENSBTAG00000014551","7",34474474,34609385,134911
"8890","ENSBTAG00000014553","18",35046554,35085645,39091
"8891","ENSBTAG00000014554","13",78036327,78042585,6258
"8892","ENSBTAG00000014555","13",59498598,59535140,36542
"8893","ENSBTAG00000014556","18",35086439,35087189,750
"8894","ENSBTAG00000014558","28",25219711,25243112,23401
"8895","ENSBTAG00000014560","16",24350883,24356601,5718
"8896","ENSBTAG00000014561","28",25247950,25302700,54750
"8897","ENSBTAG00000014564","1",72326705,72499174,172469
"8898","ENSBTAG00000014567","1",67982278,68068472,86194
"8899","ENSBTAG00000014574","26",24695460,24826062,130602
"8900","ENSBTAG00000014575","X",57288214,57391723,103509
"8901","ENSBTAG00000014576","17",43601257,43673434,72177
"8902","ENSBTAG00000014579","7",5819753,5821004,1251
"8903","ENSBTAG00000014580","3",7884632,7889585,4953
"8904","ENSBTAG00000014581","23",6197413,6480455,283042
"8905","ENSBTAG00000014583","18",53736653,53746134,9481
"8906","ENSBTAG00000014584","29",41581967,41608502,26535
"8907","ENSBTAG00000014585","18",53750873,53755896,5023
"8908","ENSBTAG00000014588","25",10535397,10547590,12193
"8909","ENSBTAG00000014589","1",131114604,131131817,17213
"8910","ENSBTAG00000014592","9",41655110,41851120,196010
"8911","ENSBTAG00000014593","18",57752745,57762930,10185
"8912","ENSBTAG00000014595","18",54865681,54893345,27664
"8913","ENSBTAG00000014596","3",112396168,112440870,44702
"8914","ENSBTAG00000014597","18",54894408,54916962,22554
"8915","ENSBTAG00000014598","19",48997281,49127850,130569
"8916","ENSBTAG00000014599","6",67852541,67875658,23117
"8917","ENSBTAG00000014600","14",9754216,9979380,225164
"8918","ENSBTAG00000014601","6",67878832,67905884,27052
"8919","ENSBTAG00000014602","16",45620320,45673776,53456
"8920","ENSBTAG00000014603","5",103914981,103924356,9375
"8921","ENSBTAG00000014605","5",97936658,98225335,288677
"8922","ENSBTAG00000014607","14",755134,757010,1876
"8923","ENSBTAG00000014608","23",39389854,39432004,42150
"8924","ENSBTAG00000014609","5",9311402,9477553,166151
"8925","ENSBTAG00000014610","14",750608,753850,3242
"8926","ENSBTAG00000014611","15",32050384,32220026,169642
"8927","ENSBTAG00000014612","20",1562432,2001666,439234
"8928","ENSBTAG00000014614","26",10626803,10679430,52627
"8929","ENSBTAG00000014615","7",61294681,61300835,6154
"8930","ENSBTAG00000014616","6",44701325,44737391,36066
"8931","ENSBTAG00000014619","12",32913740,32961755,48015
"8932","ENSBTAG00000014620","20",2012271,2016056,3785
"8933","ENSBTAG00000014623","13",48123958,48166976,43018
"8934","ENSBTAG00000014626","7",80503644,80533316,29672
"8935","ENSBTAG00000014628","17",61338202,61357849,19647
"8936","ENSBTAG00000014632","10",85599605,85618776,19171
"8937","ENSBTAG00000014633","10",85631547,85647111,15564
"8938","ENSBTAG00000014636","18",38120563,38362036,241473
"8939","ENSBTAG00000014638","7",47651292,47806171,154879
"8940","ENSBTAG00000014642","14",1127518,1131606,4088
"8941","ENSBTAG00000014643","14",1113551,1126356,12805
"8942","ENSBTAG00000014644","18",35479960,35512004,32044
"8943","ENSBTAG00000014645","16",2825767,2858770,33003
"8944","ENSBTAG00000014646","17",72399346,72403587,4241
"8945","ENSBTAG00000014648","13",66126440,66197742,71302
"8946","ENSBTAG00000014649","3",93032987,93057118,24131
"8947","ENSBTAG00000014650","25",25885086,25897161,12075
"8948","ENSBTAG00000014652","3",113586057,113672155,86098
"8949","ENSBTAG00000014653","25",25867538,25876113,8575
"8950","ENSBTAG00000014655","5",56378741,56406111,27370
"8951","ENSBTAG00000014659","5",56356649,56375772,19123
"8952","ENSBTAG00000014660","1",71087882,71101117,13235
"8953","ENSBTAG00000014661","7",23976246,24263996,287750
"8954","ENSBTAG00000014662","10",22033232,22033713,481
"8955","ENSBTAG00000014665","7",2015432,2260856,245424
"8956","ENSBTAG00000014666","22",59021081,59021623,542
"8957","ENSBTAG00000014668","11",13396657,13405830,9173
"8958","ENSBTAG00000014669","5",24684273,24711486,27213
"8959","ENSBTAG00000014670","X",50182852,50185139,2287
"8960","ENSBTAG00000014674","4",100752928,100754401,1473
"8961","ENSBTAG00000014675","20",9254757,9286916,32159
"8962","ENSBTAG00000014676","7",44413310,44421245,7935
"8963","ENSBTAG00000014677","19",13726527,13772700,46173
"8964","ENSBTAG00000014678","11",103255824,103264276,8452
"8965","ENSBTAG00000014679","11",21145287,21198813,53526
"8966","ENSBTAG00000014680","6",104792359,104819002,26643
"8967","ENSBTAG00000014683","5",101268561,101274410,5849
"8968","ENSBTAG00000014685","X",18176948,18208578,31630
"8969","ENSBTAG00000014687","19",20823068,20828587,5519
"8970","ENSBTAG00000014689","14",31215536,31326500,110964
"8971","ENSBTAG00000014691","14",31303246,31456543,153297
"8972","ENSBTAG00000014692","3",16464193,16472933,8740
"8973","ENSBTAG00000014693","19",27545899,27546951,1052
"8974","ENSBTAG00000014694","3",16461551,16465986,4435
"8975","ENSBTAG00000014695","19",27546606,27548927,2321
"8976","ENSBTAG00000014697","5",57140987,57161786,20799
"8977","ENSBTAG00000014698","25",40416268,40522996,106728
"8978","ENSBTAG00000014699","10",50806869,50869445,62576
"8979","ENSBTAG00000014700","22",6973311,7026356,53045
"8980","ENSBTAG00000014704","27",15389178,15390968,1790
"8981","ENSBTAG00000014705","16",51474167,51475191,1024
"8982","ENSBTAG00000014707","16",51464069,51465107,1038
"8983","ENSBTAG00000014711","4",32287899,32315089,27190
"8984","ENSBTAG00000014712","7",18077043,18084803,7760
"8985","ENSBTAG00000014713","1",108807496,108849597,42101
"8986","ENSBTAG00000014714","2",1232958,1284056,51098
"8987","ENSBTAG00000014719","8",62722964,62812715,89751
"8988","ENSBTAG00000014721","1",70484258,70515363,31105
"8989","ENSBTAG00000014722","8",62813437,62841230,27793
"8990","ENSBTAG00000014724","1",80467443,80473754,6311
"8991","ENSBTAG00000014725","5",103931998,103937571,5573
"8992","ENSBTAG00000014727","1",80452885,80467441,14556
"8993","ENSBTAG00000014728","5",103922269,103929825,7556
"8994","ENSBTAG00000014729","5",103902391,103906162,3771
"8995","ENSBTAG00000014730","5",103877217,103901222,24005
"8996","ENSBTAG00000014731","5",103870384,103874824,4440
"8997","ENSBTAG00000014733","5",103848170,103856938,8768
"8998","ENSBTAG00000014734","5",103817796,103847333,29537
"8999","ENSBTAG00000014735","4",68842500,68844385,1885
"9000","ENSBTAG00000014737","27",8017950,8103703,85753
"9001","ENSBTAG00000014738","4",68857431,68861055,3624
"9002","ENSBTAG00000014741","10",69215730,69224687,8957
"9003","ENSBTAG00000014742","25",34581490,34588017,6527
"9004","ENSBTAG00000014744","7",46354701,46370643,15942
"9005","ENSBTAG00000014746","7",46424173,46455511,31338
"9006","ENSBTAG00000014749","1",120907816,120916227,8411
"9007","ENSBTAG00000014750","10",1518392,1814761,296369
"9008","ENSBTAG00000014751","1",120897288,120900384,3096
"9009","ENSBTAG00000014752","12",12410713,12461551,50838
"9010","ENSBTAG00000014758","5",48687578,48779884,92306
"9011","ENSBTAG00000014759","5",95103224,95118867,15643
"9012","ENSBTAG00000014761","29",39760936,39771367,10431
"9013","ENSBTAG00000014762","21",19607426,19625071,17645
"9014","ENSBTAG00000014764","5",104123609,104159392,35783
"9015","ENSBTAG00000014765","5",13679065,13681783,2718
"9016","ENSBTAG00000014766","19",8806081,8809808,3727
"9017","ENSBTAG00000014768","4",112230995,112243363,12368
"9018","ENSBTAG00000014769","13",54101587,54112865,11278
"9019","ENSBTAG00000014770","X",14348502,14349509,1007
"9020","ENSBTAG00000014771","X",14358111,14371745,13634
"9021","ENSBTAG00000014772","7",75130784,75137127,6343
"9022","ENSBTAG00000014773","7",75137017,75170625,33608
"9023","ENSBTAG00000014775","7",2983133,2993613,10480
"9024","ENSBTAG00000014777","16",42003474,42018178,14704
"9025","ENSBTAG00000014779","22",48370379,48432781,62402
"9026","ENSBTAG00000014782","22",48343002,48368328,25326
"9027","ENSBTAG00000014784","22",48291599,48343007,51408
"9028","ENSBTAG00000014786","22",48176132,48283003,106871
"9029","ENSBTAG00000014788","9",88290613,88401329,110716
"9030","ENSBTAG00000014790","9",88411591,88420605,9014
"9031","ENSBTAG00000014791","3",74766636,74793722,27086
"9032","ENSBTAG00000014792","10",43312765,43438638,125873
"9033","ENSBTAG00000014793","16",37442916,37493120,50204
"9034","ENSBTAG00000014794","16",37492622,37534240,41618
"9035","ENSBTAG00000014795","4",49666022,49666903,881
"9036","ENSBTAG00000014797","1",67555432,67637451,82019
"9037","ENSBTAG00000014798","X",79058193,79063342,5149
"9038","ENSBTAG00000014799","19",56320659,56335696,15037
"9039","ENSBTAG00000014803","6",114791954,114816294,24340
"9040","ENSBTAG00000014804","6",97209613,97216516,6903
"9041","ENSBTAG00000014805","6",97217195,97255729,38534
"9042","ENSBTAG00000014806","19",24551813,24586083,34270
"9043","ENSBTAG00000014807","10",12373709,12424564,50855
"9044","ENSBTAG00000014809","7",62357582,62404880,47298
"9045","ENSBTAG00000014810","25",33446069,33447713,1644
"9046","ENSBTAG00000014814","23",16428773,16506078,77305
"9047","ENSBTAG00000014818","18",15033527,15078213,44686
"9048","ENSBTAG00000014819","2",106933695,106936940,3245
"9049","ENSBTAG00000014820","10",22026651,22042635,15984
"9050","ENSBTAG00000014821","10",21990496,22026915,36419
"9051","ENSBTAG00000014822","10",21979443,21984547,5104
"9052","ENSBTAG00000014823","25",10365652,10425944,60292
"9053","ENSBTAG00000014824","10",21967557,21978162,10605
"9054","ENSBTAG00000014825","19",19651228,19780827,129599
"9055","ENSBTAG00000014826","25",10434094,10460647,26553
"9056","ENSBTAG00000014827","8",76869555,76925625,56070
"9057","ENSBTAG00000014828","7",12144237,12396421,252184
"9058","ENSBTAG00000014829","5",43516703,43642194,125491
"9059","ENSBTAG00000014830","29",39953334,39962267,8933
"9060","ENSBTAG00000014831","26",13208458,13213362,4904
"9061","ENSBTAG00000014832","2",80621362,80899591,278229
"9062","ENSBTAG00000014833","3",120822794,120828287,5493
"9063","ENSBTAG00000014834","25",34446126,34453893,7767
"9064","ENSBTAG00000014835","7",62874446,62897221,22775
"9065","ENSBTAG00000014838","15",83503677,83522019,18342
"9066","ENSBTAG00000014840","3",15409490,15414531,5041
"9067","ENSBTAG00000014841","3",15390177,15409004,18827
"9068","ENSBTAG00000014843","1",129706887,129741285,34398
"9069","ENSBTAG00000014847","15",57758972,57839046,80074
"9070","ENSBTAG00000014848","2",126303160,126305471,2311
"9071","ENSBTAG00000014849","2",126314664,126321490,6826
"9072","ENSBTAG00000014850","2",126320997,126333342,12345
"9073","ENSBTAG00000014855","15",40374952,40604561,229609
"9074","ENSBTAG00000014857","3",54009526,54035069,25543
"9075","ENSBTAG00000014858","19",34274658,34296563,21905
"9076","ENSBTAG00000014859","5",4783613,4796635,13022
"9077","ENSBTAG00000014861","27",37252190,37363184,110994
"9078","ENSBTAG00000014862","16",10453902,10454549,647
"9079","ENSBTAG00000014863","2",78885394,78934052,48658
"9080","ENSBTAG00000014871","4",114862025,114863629,1604
"9081","ENSBTAG00000014872","18",46798751,46805845,7094
"9082","ENSBTAG00000014873","11",3790084,3824582,34498
"9083","ENSBTAG00000014874","1",70342777,70373184,30407
"9084","ENSBTAG00000014877","11",3824075,3834738,10663
"9085","ENSBTAG00000014878","18",46806391,46808127,1736
"9086","ENSBTAG00000014879","4",44057955,44133423,75468
"9087","ENSBTAG00000014880","1",144225436,144234833,9397
"9088","ENSBTAG00000014881","19",26948820,26953274,4454
"9089","ENSBTAG00000014882","1",144242585,144256996,14411
"9090","ENSBTAG00000014883","19",26954142,26956071,1929
"9091","ENSBTAG00000014884","15",63908514,63962613,54099
"9092","ENSBTAG00000014885","2",128788187,128839063,50876
"9093","ENSBTAG00000014886","24",50647147,50667734,20587
"9094","ENSBTAG00000014889","1",43112237,43195312,83075
"9095","ENSBTAG00000014890","10",59102240,59156607,54367
"9096","ENSBTAG00000014891","11",21086083,21091537,5454
"9097","ENSBTAG00000014897","7",38268362,38331961,63599
"9098","ENSBTAG00000014898","7",38332119,38352118,19999
"9099","ENSBTAG00000014900","18",63241718,63257591,15873
"9100","ENSBTAG00000014903","25",1794637,1828602,33965
"9101","ENSBTAG00000014904","23",43027528,43050452,22924
"9102","ENSBTAG00000014906","7",83356440,83476139,119699
"9103","ENSBTAG00000014907","8",76017695,76027363,9668
"9104","ENSBTAG00000014908","8",76027403,76028140,737
"9105","ENSBTAG00000014910","15",15850059,15905090,55031
"9106","ENSBTAG00000014911","4",92436922,92453653,16731
"9107","ENSBTAG00000014912","16",1122157,1132658,10501
"9108","ENSBTAG00000014913","6",70803119,70819349,16230
"9109","ENSBTAG00000014915","1",81135305,81194599,59294
"9110","ENSBTAG00000014916","7",2972742,2982335,9593
"9111","ENSBTAG00000014917","13",46331627,46346321,14694
"9112","ENSBTAG00000014918","7",2956083,2966802,10719
"9113","ENSBTAG00000014920","4",36966817,37237011,270194
"9114","ENSBTAG00000014921","4",31454749,31459131,4382
"9115","ENSBTAG00000014922","8",62008686,62144584,135898
"9116","ENSBTAG00000014923","18",24122099,24148233,26134
"9117","ENSBTAG00000014925","29",44464264,44469355,5091
"9118","ENSBTAG00000014926","7",16674793,16679420,4627
"9119","ENSBTAG00000014927","22",11636912,11721061,84149
"9120","ENSBTAG00000014930","13",61355025,61369702,14677
"9121","ENSBTAG00000014931","5",103691194,103696645,5451
"9122","ENSBTAG00000014932","X",138650965,138665834,14869
"9123","ENSBTAG00000014933","2",89938529,90008545,70016
"9124","ENSBTAG00000014934","8",61910844,61961976,51132
"9125","ENSBTAG00000014936","8",61976292,61994835,18543
"9126","ENSBTAG00000014940","19",27603100,27609768,6668
"9127","ENSBTAG00000014943","X",90644022,90675643,31621
"9128","ENSBTAG00000014944","7",20334826,20343537,8711
"9129","ENSBTAG00000014945","X",90684699,90726856,42157
"9130","ENSBTAG00000014947","6",101531746,101735421,203675
"9131","ENSBTAG00000014948","10",28287799,28298647,10848
"9132","ENSBTAG00000014949","2",22449123,22451704,2581
"9133","ENSBTAG00000014953","18",61067997,61083999,16002
"9134","ENSBTAG00000014955","7",21401483,21404348,2865
"9135","ENSBTAG00000014956","7",21404529,21408418,3889
"9136","ENSBTAG00000014958","4",48154065,48255759,101694
"9137","ENSBTAG00000014960","1",107552681,107731909,179228
"9138","ENSBTAG00000014964","19",55833248,55840035,6787
"9139","ENSBTAG00000014966","5",119638532,119666475,27943
"9140","ENSBTAG00000014967","2",133926471,134029644,103173
"9141","ENSBTAG00000014968","7",3791943,3802077,10134
"9142","ENSBTAG00000014969","7",3782380,3791397,9017
"9143","ENSBTAG00000014970","3",33026800,33031126,4326
"9144","ENSBTAG00000014971","22",1459780,1466666,6886
"9145","ENSBTAG00000014972","20",33747133,33759226,12093
"9146","ENSBTAG00000014974","7",27358948,27477507,118559
"9147","ENSBTAG00000014975","2",107548385,107563336,14951
"9148","ENSBTAG00000014977","5",14916906,14939215,22309
"9149","ENSBTAG00000014979","7",20369007,20378072,9065
"9150","ENSBTAG00000014981","21",58636677,58659061,22384
"9151","ENSBTAG00000014982","7",20379062,20382521,3459
"9152","ENSBTAG00000014983","3",78077155,78150856,73701
"9153","ENSBTAG00000014984","3",20203827,20302019,98192
"9154","ENSBTAG00000014988","2",119471574,119471963,389
"9155","ENSBTAG00000014990","28",43741136,43742710,1574
"9156","ENSBTAG00000014991","13",18484975,19062784,577809
"9157","ENSBTAG00000014992","16",80440023,80444291,4268
"9158","ENSBTAG00000014995","18",46703036,46718010,14974
"9159","ENSBTAG00000015000","8",59321791,59336523,14732
"9160","ENSBTAG00000015001","18",46771434,46773377,1943
"9161","ENSBTAG00000015002","18",46773367,46775387,2020
"9162","ENSBTAG00000015004","18",46774392,46783766,9374
"9163","ENSBTAG00000015005","8",59337760,59343676,5916
"9164","ENSBTAG00000015007","11",74447679,74612645,164966
"9165","ENSBTAG00000015008","1",119297388,119329547,32159
"9166","ENSBTAG00000015009","25",36252207,36255522,3315
"9167","ENSBTAG00000015010","1",44554751,44611092,56341
"9168","ENSBTAG00000015011","25",36247789,36251357,3568
"9169","ENSBTAG00000015012","11",74432443,74436977,4534
"9170","ENSBTAG00000015013","15",29685465,29695831,10366
"9171","ENSBTAG00000015014","11",74418119,74433150,15031
"9172","ENSBTAG00000015015","15",29699811,29709237,9426
"9173","ENSBTAG00000015016","5",26328331,26342538,14207
"9174","ENSBTAG00000015017","25",36241636,36247375,5739
"9175","ENSBTAG00000015018","21",23037004,23073729,36725
"9176","ENSBTAG00000015019","26",24441901,24481229,39328
"9177","ENSBTAG00000015022","20",17021529,17087796,66267
"9178","ENSBTAG00000015023","21",49145029,49156067,11038
"9179","ENSBTAG00000015024","5",38545505,38591629,46124
"9180","ENSBTAG00000015025","5",38456114,38535924,79810
"9181","ENSBTAG00000015026","16",60462909,60558239,95330
"9182","ENSBTAG00000015027","8",74707747,74718631,10884
"9183","ENSBTAG00000015032","7",51762895,51765768,2873
"9184","ENSBTAG00000015034","7",51780969,51793195,12226
"9185","ENSBTAG00000015036","19",9662183,9693917,31734
"9186","ENSBTAG00000015037","11",73302138,73317846,15708
"9187","ENSBTAG00000015038","11",73256623,73298910,42287
"9188","ENSBTAG00000015040","14",774643,776724,2081
"9189","ENSBTAG00000015041","7",51778423,51780743,2320
"9190","ENSBTAG00000015042","7",51795499,51800408,4909
"9191","ENSBTAG00000015043","5",75887878,75903492,15614
"9192","ENSBTAG00000015044","5",75907210,75940103,32893
"9193","ENSBTAG00000015045","25",2241515,2245766,4251
"9194","ENSBTAG00000015046","22",50357168,50370270,13102
"9195","ENSBTAG00000015047","6",84949480,84986700,37220
"9196","ENSBTAG00000015049","7",15862527,15874429,11902
"9197","ENSBTAG00000015050","7",43213783,43234084,20301
"9198","ENSBTAG00000015051","7",43234029,43247499,13470
"9199","ENSBTAG00000015052","10",86108354,86116785,8431
"9200","ENSBTAG00000015053","21",45099213,45101864,2651
"9201","ENSBTAG00000015056","1",129620306,129651650,31344
"9202","ENSBTAG00000015058","13",55175303,55306529,131226
"9203","ENSBTAG00000015059","15",5670942,5681601,10659
"9204","ENSBTAG00000015060","3",54094947,54111586,16639
"9205","ENSBTAG00000015061","18",61209482,61224598,15116
"9206","ENSBTAG00000015065","1",56831560,56872261,40701
"9207","ENSBTAG00000015066","2",98188212,98237653,49441
"9208","ENSBTAG00000015067","3",27474900,27478019,3119
"9209","ENSBTAG00000015069","1",46001965,46016856,14891
"9210","ENSBTAG00000015073","4",24500692,24921062,420370
"9211","ENSBTAG00000015074","11",106021670,106024967,3297
"9212","ENSBTAG00000015075","17",68012848,68023699,10851
"9213","ENSBTAG00000015076","9",86860562,86897588,37026
"9214","ENSBTAG00000015077","2",69496365,69511380,15015
"9215","ENSBTAG00000015080","13",56695468,56901813,206345
"9216","ENSBTAG00000015083","23",25275775,25297277,21502
"9217","ENSBTAG00000015085","11",106039204,106043647,4443
"9218","ENSBTAG00000015086","16",73564739,73634329,69590
"9219","ENSBTAG00000015087","15",54604155,54610635,6480
"9220","ENSBTAG00000015089","5",109512489,109515793,3304
"9221","ENSBTAG00000015090","7",20903069,20917593,14524
"9222","ENSBTAG00000015091","15",55030396,55048724,18328
"9223","ENSBTAG00000015093","11",104321394,104343538,22144
"9224","ENSBTAG00000015094","9",70835488,70854194,18706
"9225","ENSBTAG00000015095","21",47810137,47998810,188673
"9226","ENSBTAG00000015097","11",104352204,104361244,9040
"9227","ENSBTAG00000015098","11",96085018,96114101,29083
"9228","ENSBTAG00000015099","20",4716985,4723653,6668
"9229","ENSBTAG00000015100","20",4732524,4762537,30013
"9230","ENSBTAG00000015101","8",5735151,5737485,2334
"9231","ENSBTAG00000015103","2",121316668,121320573,3905
"9232","ENSBTAG00000015104","2",121319922,121324082,4160
"9233","ENSBTAG00000015105","4",61402841,61438886,36045
"9234","ENSBTAG00000015106","23",47824435,47868337,43902
"9235","ENSBTAG00000015107","3",30382285,30411742,29457
"9236","ENSBTAG00000015108","7",5846576,5855842,9266
"9237","ENSBTAG00000015109","5",112539939,112549987,10048
"9238","ENSBTAG00000015112","22",37420628,37439307,18679
"9239","ENSBTAG00000015113","3",105348797,105350137,1340
"9240","ENSBTAG00000015114","7",12618113,12621944,3831
"9241","ENSBTAG00000015115","18",56852919,56858029,5110
"9242","ENSBTAG00000015116","7",12610348,12616382,6034
"9243","ENSBTAG00000015117","7",12607307,12609853,2546
"9244","ENSBTAG00000015118","23",10187681,10245704,58023
"9245","ENSBTAG00000015119","15",27514715,27778263,263548
"9246","ENSBTAG00000015124","12",82296498,82322844,26346
"9247","ENSBTAG00000015125","18",56932744,56942537,9793
"9248","ENSBTAG00000015126","6",115983795,116011719,27924
"9249","ENSBTAG00000015127","13",73670727,73691288,20561
"9250","ENSBTAG00000015128","18",56972309,56977491,5182
"9251","ENSBTAG00000015129","18",56989036,56995008,5972
"9252","ENSBTAG00000015130","23",35662148,35664136,1988
"9253","ENSBTAG00000015131","23",17730856,17741105,10249
"9254","ENSBTAG00000015132","12",29212314,29274747,62433
"9255","ENSBTAG00000015133","19",40775267,40786420,11153
"9256","ENSBTAG00000015136","19",42993675,43002885,9210
"9257","ENSBTAG00000015138","10",37075885,37166996,91111
"9258","ENSBTAG00000015139","18",61501761,61507130,5369
"9259","ENSBTAG00000015140","19",43012010,43020122,8112
"9260","ENSBTAG00000015142","10",37171212,37219738,48526
"9261","ENSBTAG00000015144","7",3693625,3703484,9859
"9262","ENSBTAG00000015145","3",18727498,18733580,6082
"9263","ENSBTAG00000015146","10",25677580,25692928,15348
"9264","ENSBTAG00000015147","3",18762472,18773422,10950
"9265","ENSBTAG00000015148","10",25661794,25677142,15348
"9266","ENSBTAG00000015149","22",46919070,46920844,1774
"9267","ENSBTAG00000015150","1",107432967,107440547,7580
"9268","ENSBTAG00000015151","11",30657152,30713233,56081
"9269","ENSBTAG00000015154","3",20129373,20134008,4635
"9270","ENSBTAG00000015155","10",12436032,12464228,28196
"9271","ENSBTAG00000015156","21",56801789,56808775,6986
"9272","ENSBTAG00000015157","5",111263287,111329131,65844
"9273","ENSBTAG00000015158","10",12466732,12500862,34130
"9274","ENSBTAG00000015160","21",69348993,69356401,7408
"9275","ENSBTAG00000015163","1",118809503,118817968,8465
"9276","ENSBTAG00000015164","18",65732865,65741718,8853
"9277","ENSBTAG00000015165","18",42918483,42989287,70804
"9278","ENSBTAG00000015166","9",96065261,96090966,25705
"9279","ENSBTAG00000015169","2",61588164,61617901,29737
"9280","ENSBTAG00000015170","2",61535026,61583839,48813
"9281","ENSBTAG00000015171","8",90058550,90067819,9269
"9282","ENSBTAG00000015172","2",61489617,61524285,34668
"9283","ENSBTAG00000015175","23",29895604,29896566,962
"9284","ENSBTAG00000015176","23",50052410,50064249,11839
"9285","ENSBTAG00000015177","29",8736369,8744974,8605
"9286","ENSBTAG00000015178","23",50039718,50057712,17994
"9287","ENSBTAG00000015180","3",38980463,38982152,1689
"9288","ENSBTAG00000015181","9",82921421,83030362,108941
"9289","ENSBTAG00000015182","15",52302299,52329988,27689
"9290","ENSBTAG00000015183","29",46378071,46413304,35233
"9291","ENSBTAG00000015184","7",8011972,8019178,7206
"9292","ENSBTAG00000015185","29",46354537,46364270,9733
"9293","ENSBTAG00000015186","7",7999294,8010976,11682
"9294","ENSBTAG00000015187","7",39010919,39017080,6161
"9295","ENSBTAG00000015188","13",44597240,44605699,8459
"9296","ENSBTAG00000015190","24",33105396,33127532,22136
"9297","ENSBTAG00000015191","25",14473657,14553925,80268
"9298","ENSBTAG00000015192","7",39019826,39051259,31433
"9299","ENSBTAG00000015194","18",17738418,17741055,2637
"9300","ENSBTAG00000015195","24",33058613,33105720,47107
"9301","ENSBTAG00000015196","X",18106846,18153425,46579
"9302","ENSBTAG00000015197","16",3099330,3106454,7124
"9303","ENSBTAG00000015198","1",131015352,131071635,56283
"9304","ENSBTAG00000015200","10",43166419,43219854,53435
"9305","ENSBTAG00000015202","10",43219972,43235333,15361
"9306","ENSBTAG00000015204","X",121527929,121581314,53385
"9307","ENSBTAG00000015205","11",45919450,46034499,115049
"9308","ENSBTAG00000015208","10",21070899,21087370,16471
"9309","ENSBTAG00000015209","6",116371256,116383571,12315
"9310","ENSBTAG00000015210","24",46187807,46396098,208291
"9311","ENSBTAG00000015212","1",2315596,2350090,34494
"9312","ENSBTAG00000015214","14",77028978,77038971,9993
"9313","ENSBTAG00000015217","2",24462482,24466496,4014
"9314","ENSBTAG00000015220","3",109947115,109977492,30377
"9315","ENSBTAG00000015221","1",132920382,133024359,103977
"9316","ENSBTAG00000015222","2",127708588,127712696,4108
"9317","ENSBTAG00000015224","7",61708261,61746787,38526
"9318","ENSBTAG00000015225","12",33897705,33926079,28374
"9319","ENSBTAG00000015226","18",62167350,62190012,22662
"9320","ENSBTAG00000015228","7",61747923,61755685,7762
"9321","ENSBTAG00000015230","6",15675549,15690031,14482
"9322","ENSBTAG00000015232","19",40458896,40472295,13399
"9323","ENSBTAG00000015235","16",66706032,67245075,539043
"9324","ENSBTAG00000015238","24",26083078,26134653,51575
"9325","ENSBTAG00000015240","2",133452143,133589435,137292
"9326","ENSBTAG00000015241","8",74591008,74662149,71141
"9327","ENSBTAG00000015242","9",70929915,70965392,35477
"9328","ENSBTAG00000015246","2",133800882,133813306,12424
"9329","ENSBTAG00000015248","29",41963966,41994238,30272
"9330","ENSBTAG00000015249","8",74858830,74914405,55575
"9331","ENSBTAG00000015251","X",59897844,59951347,53503
"9332","ENSBTAG00000015252","6",59324388,59337767,13379
"9333","ENSBTAG00000015253","25",41758511,41764100,5589
"9334","ENSBTAG00000015254","22",7340652,7444669,104017
"9335","ENSBTAG00000015255","19",55174502,55193764,19262
"9336","ENSBTAG00000015258","19",24368861,24384507,15646
"9337","ENSBTAG00000015259","6",13066827,13068319,1492
"9338","ENSBTAG00000015260","18",49307702,49309900,2198
"9339","ENSBTAG00000015261","19",52431399,52468644,37245
"9340","ENSBTAG00000015263","29",39903929,39921782,17853
"9341","ENSBTAG00000015264","19",24392539,24437306,44767
"9342","ENSBTAG00000015265","6",35692061,35693638,1577
"9343","ENSBTAG00000015266","29",39921806,39931368,9562
"9344","ENSBTAG00000015267","19",52424174,52431354,7180
"9345","ENSBTAG00000015268","5",109834675,109851541,16866
"9346","ENSBTAG00000015271","14",73895603,73936735,41132
"9347","ENSBTAG00000015272","25",36077727,36087711,9984
"9348","ENSBTAG00000015273","22",56349726,56377505,27779
"9349","ENSBTAG00000015274","23",35332705,35341607,8902
"9350","ENSBTAG00000015275","5",109853974,109858626,4652
"9351","ENSBTAG00000015276","19",52406402,52424135,17733
"9352","ENSBTAG00000015277","29",12481299,12505037,23738
"9353","ENSBTAG00000015278","11",95859752,95866961,7209
"9354","ENSBTAG00000015280","3",101248621,101266875,18254
"9355","ENSBTAG00000015283","22",56344620,56348415,3795
"9356","ENSBTAG00000015285","3",101232560,101235265,2705
"9357","ENSBTAG00000015286","11",95868596,95911867,43271
"9358","ENSBTAG00000015288","3",101225985,101229638,3653
"9359","ENSBTAG00000015290","5",109861367,109891295,29928
"9360","ENSBTAG00000015291","2",48181494,48275918,94424
"9361","ENSBTAG00000015293","19",37037444,37042103,4659
"9362","ENSBTAG00000015294","19",32090857,32199802,108945
"9363","ENSBTAG00000015296","5",42885405,43010556,125151
"9364","ENSBTAG00000015297","6",22695492,23016141,320649
"9365","ENSBTAG00000015298","19",35095243,35118131,22888
"9366","ENSBTAG00000015301","23",15920024,15932613,12589
"9367","ENSBTAG00000015303","4",71173805,71303589,129784
"9368","ENSBTAG00000015304","3",19777160,19786734,9574
"9369","ENSBTAG00000015307","7",25484714,25706699,221985
"9370","ENSBTAG00000015308","19",40833643,40856220,22577
"9371","ENSBTAG00000015309","15",6664998,6692997,27999
"9372","ENSBTAG00000015310","1",128008638,128042419,33781
"9373","ENSBTAG00000015311","5",42611538,42884729,273191
"9374","ENSBTAG00000015312","5",103976074,103992749,16675
"9375","ENSBTAG00000015313","18",52446740,52465524,18784
"9376","ENSBTAG00000015314","25",27989110,27998697,9587
"9377","ENSBTAG00000015316","20",3205593,3215788,10195
"9378","ENSBTAG00000015317","2",34473422,34723194,249772
"9379","ENSBTAG00000015318","18",52582085,52615556,33471
"9380","ENSBTAG00000015319","14",16566090,16583706,17616
"9381","ENSBTAG00000015321","23",15939656,16145761,206105
"9382","ENSBTAG00000015325","16",42392180,42514910,122730
"9383","ENSBTAG00000015326","4",71088326,71192446,104120
"9384","ENSBTAG00000015327","11",99104054,99159309,55255
"9385","ENSBTAG00000015329","3",19766326,19775894,9568
"9386","ENSBTAG00000015333","14",81173271,81261605,88334
"9387","ENSBTAG00000015334","14",16534435,16557231,22796
"9388","ENSBTAG00000015335","9",7702860,8247107,544247
"9389","ENSBTAG00000015336","3",19744729,19764785,20056
"9390","ENSBTAG00000015337","4",85288736,85355349,66613
"9391","ENSBTAG00000015338","14",81263986,81276602,12616
"9392","ENSBTAG00000015339","19",52036079,52115032,78953
"9393","ENSBTAG00000015340","16",42447039,42453123,6084
"9394","ENSBTAG00000015341","14",81286703,81439669,152966
"9395","ENSBTAG00000015343","11",99159372,99179482,20110
"9396","ENSBTAG00000015345","3",19737600,19745849,8249
"9397","ENSBTAG00000015346","3",100461046,100505190,44144
"9398","ENSBTAG00000015347","5",30841487,30847512,6025
"9399","ENSBTAG00000015348","8",91125259,91131042,5783
"9400","ENSBTAG00000015349","3",19735220,19737363,2143
"9401","ENSBTAG00000015350","21",21078035,21091895,13860
"9402","ENSBTAG00000015351","5",98891931,98945941,54010
"9403","ENSBTAG00000015352","19",9445435,9470249,24814
"9404","ENSBTAG00000015353","4",49680896,49717933,37037
"9405","ENSBTAG00000015354","X",13834974,13864923,29949
"9406","ENSBTAG00000015355","X",124468937,124560357,91420
"9407","ENSBTAG00000015356","4",15014498,15023433,8935
"9408","ENSBTAG00000015358","8",91142800,91232552,89752
"9409","ENSBTAG00000015361","8",75920507,75958549,38042
"9410","ENSBTAG00000015362","13",58889622,58975046,85424
"9411","ENSBTAG00000015363","3",19726452,19734555,8103
"9412","ENSBTAG00000015364","5",30832513,30835596,3083
"9413","ENSBTAG00000015366","4",49731840,49742113,10273
"9414","ENSBTAG00000015368","19",9471938,9483948,12010
"9415","ENSBTAG00000015369","3",19721037,19726107,5070
"9416","ENSBTAG00000015371","3",19698284,19715704,17420
"9417","ENSBTAG00000015373","16",54777644,54856765,79121
"9418","ENSBTAG00000015375","11",98421824,98454917,33093
"9419","ENSBTAG00000015376","20",3678207,3809572,131365
"9420","ENSBTAG00000015377","1",134087026,134553600,466574
"9421","ENSBTAG00000015378","8",62537300,62593188,55888
"9422","ENSBTAG00000015379","13",52039801,52087687,47886
"9423","ENSBTAG00000015380","3",33044290,33074902,30612
"9424","ENSBTAG00000015381","9",67735746,67939537,203791
"9425","ENSBTAG00000015384","16",46785881,46792583,6702
"9426","ENSBTAG00000015385","10",102869154,102941464,72310
"9427","ENSBTAG00000015386","11",43625180,43662860,37680
"9428","ENSBTAG00000015387","19",49958836,49984090,25254
"9429","ENSBTAG00000015388","18",55260023,55263921,3898
"9430","ENSBTAG00000015390","19",49934833,49943162,8329
"9431","ENSBTAG00000015392","3",26126025,26179583,53558
"9432","ENSBTAG00000015395","5",45526671,45531263,4592
"9433","ENSBTAG00000015396","23",40056293,40067746,11453
"9434","ENSBTAG00000015398","21",28399040,28430307,31267
"9435","ENSBTAG00000015401","3",120710007,120725948,15941
"9436","ENSBTAG00000015402","11",86232489,86365887,133398
"9437","ENSBTAG00000015403","15",46444901,46452583,7682
"9438","ENSBTAG00000015405","15",46407409,46444149,36740
"9439","ENSBTAG00000015406","19",49854334,49863765,9431
"9440","ENSBTAG00000015408","3",120728099,120736657,8558
"9441","ENSBTAG00000015409","6",103708310,104113056,404746
"9442","ENSBTAG00000015412","21",55035899,55062339,26440
"9443","ENSBTAG00000015413","1",127345515,127469070,123555
"9444","ENSBTAG00000015414","19",49768681,49927209,158528
"9445","ENSBTAG00000015415","2",97594986,97821531,226545
"9446","ENSBTAG00000015416","8",70019049,70244688,225639
"9447","ENSBTAG00000015419","7",60928103,60982278,54175
"9448","ENSBTAG00000015424","2",91206414,91230173,23759
"9449","ENSBTAG00000015426","7",22148143,22162595,14452
"9450","ENSBTAG00000015427","18",2623342,2727856,104514
"9451","ENSBTAG00000015428","18",2806374,2819530,13156
"9452","ENSBTAG00000015432","18",2843007,2863808,20801
"9453","ENSBTAG00000015433","7",43851930,43875954,24024
"9454","ENSBTAG00000015434","13",37954688,37980471,25783
"9455","ENSBTAG00000015436","11",98945593,98959912,14319
"9456","ENSBTAG00000015437","11",100021354,100029200,7846
"9457","ENSBTAG00000015438","13",37984719,38011411,26692
"9458","ENSBTAG00000015439","7",51920612,51933005,12393
"9459","ENSBTAG00000015441","11",10736902,10761462,24560
"9460","ENSBTAG00000015444","27",33528788,33544151,15363
"9461","ENSBTAG00000015449","6",90714356,90757072,42716
"9462","ENSBTAG00000015450","26",13528540,13779279,250739
"9463","ENSBTAG00000015457","27",33549267,33599083,49816
"9464","ENSBTAG00000015459","3",32830656,32834145,3489
"9465","ENSBTAG00000015460","1",77389337,77689118,299781
"9466","ENSBTAG00000015461","4",43758669,43758983,314
"9467","ENSBTAG00000015462","21",24771884,24784761,12877
"9468","ENSBTAG00000015463","27",29212081,29225350,13269
"9469","ENSBTAG00000015466","20",66599168,66632055,32887
"9470","ENSBTAG00000015467","9",31952874,32076695,123821
"9471","ENSBTAG00000015470","3",33968205,33981459,13254
"9472","ENSBTAG00000015473","11",37970354,37972652,2298
"9473","ENSBTAG00000015474","3",74928249,74964017,35768
"9474","ENSBTAG00000015478","20",66561436,66598483,37047
"9475","ENSBTAG00000015479","29",43297386,43301446,4060
"9476","ENSBTAG00000015481","11",37973502,37996104,22602
"9477","ENSBTAG00000015482","3",74830012,74922861,92849
"9478","ENSBTAG00000015483","22",12634614,12635672,1058
"9479","ENSBTAG00000015485","9",100423967,100448228,24261
"9480","ENSBTAG00000015486","25",26540572,26542953,2381
"9481","ENSBTAG00000015487","7",19096391,19175953,79562
"9482","ENSBTAG00000015490","11",78208891,78257439,48548
"9483","ENSBTAG00000015493","22",12637814,12643092,5278
"9484","ENSBTAG00000015498","9",19602129,19641142,39013
"9485","ENSBTAG00000015499","29",43305490,43317745,12255
"9486","ENSBTAG00000015504","20",31552937,31580831,27894
"9487","ENSBTAG00000015505","29",40350389,40387558,37169
"9488","ENSBTAG00000015509","4",47321231,47361906,40675
"9489","ENSBTAG00000015510","4",106164367,106180774,16407
"9490","ENSBTAG00000015511","29",40392841,40407757,14916
"9491","ENSBTAG00000015512","20",6801767,6834107,32340
"9492","ENSBTAG00000015513","8",72443786,72724312,280526
"9493","ENSBTAG00000015516","9",76538594,76553785,15191
"9494","ENSBTAG00000015517","16",560059,560997,938
"9495","ENSBTAG00000015518","19",41053613,41059170,5557
"9496","ENSBTAG00000015519","20",6750176,6801800,51624
"9497","ENSBTAG00000015520","2",106392590,106403650,11060
"9498","ENSBTAG00000015521","11",21128704,21132566,3862
"9499","ENSBTAG00000015522","12",21839887,21865301,25414
"9500","ENSBTAG00000015525","13",32374570,32459142,84572
"9501","ENSBTAG00000015526","17",64971207,64996531,25324
"9502","ENSBTAG00000015527","19",17330801,17691005,360204
"9503","ENSBTAG00000015529","22",58085681,58092399,6718
"9504","ENSBTAG00000015532","X",113283185,113289019,5834
"9505","ENSBTAG00000015533","16",42146013,42204254,58241
"9506","ENSBTAG00000015534","16",22658588,22690679,32091
"9507","ENSBTAG00000015535","19",20153121,20164116,10995
"9508","ENSBTAG00000015536","14",76118257,76165972,47715
"9509","ENSBTAG00000015537","16",59629859,59878925,249066
"9510","ENSBTAG00000015538","23",7898387,7914749,16362
"9511","ENSBTAG00000015539","4",30909069,31143356,234287
"9512","ENSBTAG00000015541","27",23395827,23916949,521122
"9513","ENSBTAG00000015543","18",53947301,54062545,115244
"9514","ENSBTAG00000015546","1",42194819,42230806,35987
"9515","ENSBTAG00000015547","4",48780316,48813887,33571
"9516","ENSBTAG00000015549","17",20288045,20302085,14040
"9517","ENSBTAG00000015550","23",7921502,7928988,7486
"9518","ENSBTAG00000015551","4",99482020,99482705,685
"9519","ENSBTAG00000015553","11",95924987,96038852,113865
"9520","ENSBTAG00000015554","22",32494168,32525378,31210
"9521","ENSBTAG00000015556","22",32457271,32491697,34426
"9522","ENSBTAG00000015557","7",14609150,14639088,29938
"9523","ENSBTAG00000015558","7",59050296,59057347,7051
"9524","ENSBTAG00000015559","3",101700924,101832084,131160
"9525","ENSBTAG00000015562","5",95273952,95362982,89030
"9526","ENSBTAG00000015563","22",43636012,43639721,3709
"9527","ENSBTAG00000015565","23",25825528,25828791,3263
"9528","ENSBTAG00000015566","15",41898894,41923881,24987
"9529","ENSBTAG00000015567","7",16680584,16695716,15132
"9530","ENSBTAG00000015569","13",25808009,25844085,36076
"9531","ENSBTAG00000015571","23",6982172,7026855,44683
"9532","ENSBTAG00000015572","6",84101528,84139895,38367
"9533","ENSBTAG00000015574","16",43542548,43563401,20853
"9534","ENSBTAG00000015575","11",9482775,9669064,186289
"9535","ENSBTAG00000015576","18",54078441,54094359,15918
"9536","ENSBTAG00000015578","8",5761207,5766834,5627
"9537","ENSBTAG00000015579","18",54094492,54097330,2838
"9538","ENSBTAG00000015580","10",16923512,16970803,47291
"9539","ENSBTAG00000015581","13",54546013,54550357,4344
"9540","ENSBTAG00000015582","5",73623293,73630548,7255
"9541","ENSBTAG00000015584","13",23430468,23440823,10355
"9542","ENSBTAG00000015587","11",78904244,78910954,6710
"9543","ENSBTAG00000015588","4",93952779,93983043,30264
"9544","ENSBTAG00000015590","23",25229377,25272669,43292
"9545","ENSBTAG00000015591","7",1433632,1508188,74556
"9546","ENSBTAG00000015592","5",25709927,25711851,1924
"9547","ENSBTAG00000015593","19",25244080,25297667,53587
"9548","ENSBTAG00000015595","5",73633313,73651860,18547
"9549","ENSBTAG00000015596","15",54375514,54427957,52443
"9550","ENSBTAG00000015598","23",8488475,8495421,6946
"9551","ENSBTAG00000015599","18",53786704,53822352,35648
"9552","ENSBTAG00000015602","7",1417994,1435525,17531
"9553","ENSBTAG00000015604","5",25686990,25707964,20974
"9554","ENSBTAG00000015606","16",52389243,52403213,13970
"9555","ENSBTAG00000015607","8",38886868,38948728,61860
"9556","ENSBTAG00000015609","13",76841312,77021815,180503
"9557","ENSBTAG00000015611","7",1374503,1414803,40300
"9558","ENSBTAG00000015612","19",18221902,18249177,27275
"9559","ENSBTAG00000015614","12",32322916,32412534,89618
"9560","ENSBTAG00000015615","9",65724492,65923926,199434
"9561","ENSBTAG00000015618","7",4778258,4780515,2257
"9562","ENSBTAG00000015625","7",62073639,62106751,33112
"9563","ENSBTAG00000015628","15",46648923,46653387,4464
"9564","ENSBTAG00000015630","X",76498440,76517923,19483
"9565","ENSBTAG00000015632","16",51293430,51296461,3031
"9566","ENSBTAG00000015635","16",51282437,51288691,6254
"9567","ENSBTAG00000015636","7",14649561,14654345,4784
"9568","ENSBTAG00000015637","14",23867153,23883121,15968
"9569","ENSBTAG00000015638","9",74969097,75002580,33483
"9570","ENSBTAG00000015639","19",20232099,20238395,6296
"9571","ENSBTAG00000015642","16",51270270,51282975,12705
"9572","ENSBTAG00000015644","18",49208888,49210381,1493
"9573","ENSBTAG00000015647","3",99069008,99097597,28589
"9574","ENSBTAG00000015648","20",39183189,39214779,31590
"9575","ENSBTAG00000015649","6",58180729,58223872,43143
"9576","ENSBTAG00000015650","16",56325447,56386531,61084
"9577","ENSBTAG00000015651","26",50904505,50918043,13538
"9578","ENSBTAG00000015654","4",12542354,12576328,33974
"9579","ENSBTAG00000015655","15",46625995,46648787,22792
"9580","ENSBTAG00000015656","19",25642885,25687060,44175
"9581","ENSBTAG00000015659","11",2367548,2374474,6926
"9582","ENSBTAG00000015662","1",45743519,45816098,72579
"9583","ENSBTAG00000015663","29",42496143,42508869,12726
"9584","ENSBTAG00000015666","4",32435032,32536675,101643
"9585","ENSBTAG00000015667","11",2355706,2367369,11663
"9586","ENSBTAG00000015669","18",2870001,2921632,51631
"9587","ENSBTAG00000015670","X",59266325,59390168,123843
"9588","ENSBTAG00000015677","18",2923427,2937944,14517
"9589","ENSBTAG00000015678","2",5786098,5810777,24679
"9590","ENSBTAG00000015681","28",39216724,39229082,12358
"9591","ENSBTAG00000015683","7",44607161,44661126,53965
"9592","ENSBTAG00000015685","8",103296384,103331354,34970
"9593","ENSBTAG00000015686","18",2937398,2943918,6520
"9594","ENSBTAG00000015690","7",19614545,19626137,11592
"9595","ENSBTAG00000015692","17",29817687,29876207,58520
"9596","ENSBTAG00000015698","22",53336390,53403928,67538
"9597","ENSBTAG00000015700","26",22870228,22873569,3341
"9598","ENSBTAG00000015702","26",22873667,22885585,11918
"9599","ENSBTAG00000015704","12",86682932,86704824,21892
"9600","ENSBTAG00000015707","23",15118374,15125755,7381
"9601","ENSBTAG00000015708","22",53373617,53378958,5341
"9602","ENSBTAG00000015710","15",29004371,29015210,10839
"9603","ENSBTAG00000015711","16",1087323,1089347,2024
"9604","ENSBTAG00000015712","X",69352152,69353243,1091
"9605","ENSBTAG00000015713","19",46911925,47034030,122105
"9606","ENSBTAG00000015715","2",121894026,121924935,30909
"9607","ENSBTAG00000015716","10",11498442,11548825,50383
"9608","ENSBTAG00000015717","14",42969172,42972066,2894
"9609","ENSBTAG00000015718","2",89861141,89885545,24404
"9610","ENSBTAG00000015719","11",29028864,29060370,31506
"9611","ENSBTAG00000015720","14",76218264,76322858,104594
"9612","ENSBTAG00000015721","7",14846394,14861001,14607
"9613","ENSBTAG00000015723","11",29060557,29071522,10965
"9614","ENSBTAG00000015724","13",62762330,62785964,23634
"9615","ENSBTAG00000015727","7",40459455,40475731,16276
"9616","ENSBTAG00000015728","1",38360629,38420853,60224
"9617","ENSBTAG00000015729","6",25176418,25191445,15027
"9618","ENSBTAG00000015730","23",7263678,7269167,5489
"9619","ENSBTAG00000015731","24",55937973,55981193,43220
"9620","ENSBTAG00000015732","10",11462175,11486288,24113
"9621","ENSBTAG00000015734","14",76178740,76212523,33783
"9622","ENSBTAG00000015737","25",37123013,37150162,27149
"9623","ENSBTAG00000015738","25",35900360,35909574,9214
"9624","ENSBTAG00000015739","19",47043679,47102832,59153
"9625","ENSBTAG00000015741","3",9251873,9253856,1983
"9626","ENSBTAG00000015742","7",14860022,14867280,7258
"9627","ENSBTAG00000015743","23",40838499,40899445,60946
"9628","ENSBTAG00000015744","9",50244002,50269733,25731
"9629","ENSBTAG00000015745","29",40417000,40438948,21948
"9630","ENSBTAG00000015749","4",74355342,74368429,13087
"9631","ENSBTAG00000015750","21",67610926,67621574,10648
"9632","ENSBTAG00000015751","19",43548089,43566761,18672
"9633","ENSBTAG00000015752","2",118183281,118232898,49617
"9634","ENSBTAG00000015753","4",43464283,43548241,83958
"9635","ENSBTAG00000015757","8",69531535,69544331,12796
"9636","ENSBTAG00000015758","18",25907856,25923157,15301
"9637","ENSBTAG00000015759","3",42986580,42987080,500
"9638","ENSBTAG00000015761","17",62796288,62813384,17096
"9639","ENSBTAG00000015763","19",24190707,24212643,21936
"9640","ENSBTAG00000015764","18",53207149,53232479,25330
"9641","ENSBTAG00000015766","18",13720107,13781533,61426
"9642","ENSBTAG00000015767","17",62816689,62850319,33630
"9643","ENSBTAG00000015769","X",94489440,94560163,70723
"9644","ENSBTAG00000015771","2",124710421,124740398,29977
"9645","ENSBTAG00000015772","21",34633182,34641526,8344
"9646","ENSBTAG00000015773","4",97789937,97890975,101038
"9647","ENSBTAG00000015775","21",29515102,29650761,135659
"9648","ENSBTAG00000015776","3",43182189,43236013,53824
"9649","ENSBTAG00000015778","3",43140706,43181017,40311
"9650","ENSBTAG00000015779","21",34575149,34630988,55839
"9651","ENSBTAG00000015780","21",32049173,32067324,18151
"9652","ENSBTAG00000015781","3",43120392,43140707,20315
"9653","ENSBTAG00000015782","22",52163455,52264116,100661
"9654","ENSBTAG00000015784","3",14207776,14213176,5400
"9655","ENSBTAG00000015786","3",43100401,43122021,21620
"9656","ENSBTAG00000015788","8",28433124,28755648,322524
"9657","ENSBTAG00000015789","3",14176880,14194996,18116
"9658","ENSBTAG00000015792","5",60796779,61065110,268331
"9659","ENSBTAG00000015793","29",7501290,7566916,65626
"9660","ENSBTAG00000015794","3",14159893,14168905,9012
"9661","ENSBTAG00000015796","13",53907615,53936817,29202
"9662","ENSBTAG00000015798","13",53890853,53902116,11263
"9663","ENSBTAG00000015801","X",81627753,81648094,20341
"9664","ENSBTAG00000015802","4",101603470,101729511,126041
"9665","ENSBTAG00000015804","8",76005558,76008280,2722
"9666","ENSBTAG00000015805","10",82976926,83274389,297463
"9667","ENSBTAG00000015806","10",45366522,45379381,12859
"9668","ENSBTAG00000015807","8",76012246,76016123,3877
"9669","ENSBTAG00000015808","10",45385273,45582446,197173
"9670","ENSBTAG00000015810","15",22642103,22654247,12144
"9671","ENSBTAG00000015815","X",85997314,86003576,6262
"9672","ENSBTAG00000015817","X",86007731,86022472,14741
"9673","ENSBTAG00000015818","15",5868388,5877633,9245
"9674","ENSBTAG00000015820","X",86023688,86030097,6409
"9675","ENSBTAG00000015821","15",42183570,42201212,17642
"9676","ENSBTAG00000015824","15",42143138,42177749,34611
"9677","ENSBTAG00000015825","5",30885533,30893751,8218
"9678","ENSBTAG00000015828","5",30881465,30913799,32334
"9679","ENSBTAG00000015829","23",19405349,19415720,10371
"9680","ENSBTAG00000015830","7",5262909,5273072,10163
"9681","ENSBTAG00000015831","7",5279449,5283023,3574
"9682","ENSBTAG00000015833","22",51910393,51929087,18694
"9683","ENSBTAG00000015834","2",1679994,1864849,184855
"9684","ENSBTAG00000015835","8",69591401,69669500,78099
"9685","ENSBTAG00000015836","18",52865366,52918727,53361
"9686","ENSBTAG00000015837","1",116694941,116747192,52251
"9687","ENSBTAG00000015839","22",51814681,51907742,93061
"9688","ENSBTAG00000015840","2",20724272,20726509,2237
"9689","ENSBTAG00000015841","2",1314158,1318235,4077
"9690","ENSBTAG00000015843","20",71063361,71096031,32670
"9691","ENSBTAG00000015844","4",11204075,11208760,4685
"9692","ENSBTAG00000015848","X",77948612,78095274,146662
"9693","ENSBTAG00000015849","X",134903988,134949145,45157
"9694","ENSBTAG00000015853","3",8177617,8208058,30441
"9695","ENSBTAG00000015854","3",18643149,18648444,5295
"9696","ENSBTAG00000015856","3",8143059,8175606,32547
"9697","ENSBTAG00000015857","16",49419764,49422765,3001
"9698","ENSBTAG00000015858","X",91960664,91965617,4953
"9699","ENSBTAG00000015859","16",49406150,49418212,12062
"9700","ENSBTAG00000015860","X",91965590,92003575,37985
"9701","ENSBTAG00000015865","11",68715819,68742726,26907
"9702","ENSBTAG00000015866","18",65047407,65050896,3489
"9703","ENSBTAG00000015868","12",83594754,83602827,8073
"9704","ENSBTAG00000015872","13",47550275,47558426,8151
"9705","ENSBTAG00000015874","27",15047754,15072825,25071
"9706","ENSBTAG00000015875","5",106886687,106900663,13976
"9707","ENSBTAG00000015878","5",106876984,106886490,9506
"9708","ENSBTAG00000015879","5",106845510,106875967,30457
"9709","ENSBTAG00000015880","21",58353457,58412116,58659
"9710","ENSBTAG00000015882","16",51239385,51252236,12851
"9711","ENSBTAG00000015885","16",738761,790141,51380
"9712","ENSBTAG00000015887","3",103880098,104004083,123985
"9713","ENSBTAG00000015888","9",73847489,74193822,346333
"9714","ENSBTAG00000015889","25",1138152,1158761,20609
"9715","ENSBTAG00000015891","3",99750594,99773411,22817
"9716","ENSBTAG00000015892","1",65318371,65324506,6135
"9717","ENSBTAG00000015893","19",36182898,36192550,9652
"9718","ENSBTAG00000015894","18",5240349,6170333,929984
"9719","ENSBTAG00000015895","1",65337969,65380604,42635
"9720","ENSBTAG00000015896","3",93998822,94011885,13063
"9721","ENSBTAG00000015898","1",65387679,65433970,46291
"9722","ENSBTAG00000015899","18",58952492,58955722,3230
"9723","ENSBTAG00000015900","23",16555474,16563856,8382
"9724","ENSBTAG00000015901","14",30000050,30024834,24784
"9725","ENSBTAG00000015902","3",66128213,66193803,65590
"9726","ENSBTAG00000015904","10",48892525,49702163,809638
"9727","ENSBTAG00000015905","29",32330486,32459266,128780
"9728","ENSBTAG00000015907","20",70777557,70786491,8934
"9729","ENSBTAG00000015908","18",63213542,63227739,14197
"9730","ENSBTAG00000015909","21",22656735,22799519,142784
"9731","ENSBTAG00000015910","13",19971622,20014497,42875
"9732","ENSBTAG00000015911","9",23115913,23120795,4882
"9733","ENSBTAG00000015912","18",46166501,46178470,11969
"9734","ENSBTAG00000015913","27",24865164,24975150,109986
"9735","ENSBTAG00000015915","18",46186098,46190745,4647
"9736","ENSBTAG00000015917","18",46195549,46204429,8880
"9737","ENSBTAG00000015919","6",89847732,89973563,125831
"9738","ENSBTAG00000015920","18",46204641,46207450,2809
"9739","ENSBTAG00000015924","14",73654320,73676317,21997
"9740","ENSBTAG00000015925","4",14476805,14567618,90813
"9741","ENSBTAG00000015926","6",114318700,114465544,146844
"9742","ENSBTAG00000015929","11",106968158,106969088,930
"9743","ENSBTAG00000015930","10",85054840,85113986,59146
"9744","ENSBTAG00000015931","3",91536057,91564769,28712
"9745","ENSBTAG00000015935","9",87457227,87509744,52517
"9746","ENSBTAG00000015936","8",108636487,108834428,197941
"9747","ENSBTAG00000015938","7",52747335,52773654,26319
"9748","ENSBTAG00000015939","15",30211169,30282341,71172
"9749","ENSBTAG00000015940","29",40699673,40703153,3480
"9750","ENSBTAG00000015942","21",30652951,30669870,16919
"9751","ENSBTAG00000015943","12",35458595,35512370,53775
"9752","ENSBTAG00000015944","21",30671671,30690758,19087
"9753","ENSBTAG00000015945","16",2861873,2864026,2153
"9754","ENSBTAG00000015946","16",2866469,2905597,39128
"9755","ENSBTAG00000015949","13",42144361,42152225,7864
"9756","ENSBTAG00000015950","18",62053844,62060249,6405
"9757","ENSBTAG00000015951","19",49175977,49194768,18791
"9758","ENSBTAG00000015952","25",41771181,41804810,33629
"9759","ENSBTAG00000015953","7",21720737,21723568,2831
"9760","ENSBTAG00000015955","20",4596395,4709455,113060
"9761","ENSBTAG00000015957","7",21696248,21704136,7888
"9762","ENSBTAG00000015958","19",45277559,45298155,20596
"9763","ENSBTAG00000015961","3",28254062,28339667,85605
"9764","ENSBTAG00000015962","2",46549089,46565933,16844
"9765","ENSBTAG00000015963","8",37095276,37096906,1630
"9766","ENSBTAG00000015965","11",203490,230821,27331
"9767","ENSBTAG00000015968","18",14203972,14248441,44469
"9768","ENSBTAG00000015969","3",109490894,109528385,37491
"9769","ENSBTAG00000015972","16",12146640,12167350,20710
"9770","ENSBTAG00000015973","3",117639171,117699247,60076
"9771","ENSBTAG00000015974","16",70675517,70703889,28372
"9772","ENSBTAG00000015976","19",20277136,20317115,39979
"9773","ENSBTAG00000015977","3",28556518,28562488,5970
"9774","ENSBTAG00000015978","8",49321220,49339587,18367
"9775","ENSBTAG00000015979","19",20320602,20368883,48281
"9776","ENSBTAG00000015980","19",50775674,50796012,20338
"9777","ENSBTAG00000015981","4",22099728,22195687,95959
"9778","ENSBTAG00000015982","25",26343322,26356561,13239
"9779","ENSBTAG00000015983","10",26866721,26867689,968
"9780","ENSBTAG00000015984","18",51841341,51855772,14431
"9781","ENSBTAG00000015985","14",2615166,2616251,1085
"9782","ENSBTAG00000015986","25",14084540,14144211,59671
"9783","ENSBTAG00000015987","18",61322356,61333880,11524
"9784","ENSBTAG00000015988","25",14124964,14252413,127449
"9785","ENSBTAG00000015989","18",65660240,65665846,5606
"9786","ENSBTAG00000015991","18",36046665,36119368,72703
"9787","ENSBTAG00000015994","12",16313355,16346904,33549
"9788","ENSBTAG00000015996","3",119863649,119891441,27792
"9789","ENSBTAG00000016000","2",91242784,91310808,68024
"9790","ENSBTAG00000016002","20",6676797,6738543,61746
"9791","ENSBTAG00000016004","6",25546350,25603993,57643
"9792","ENSBTAG00000016005","6",23444708,23767842,323134
"9793","ENSBTAG00000016006","18",14327315,14446553,119238
"9794","ENSBTAG00000016007","6",25528829,25543695,14866
"9795","ENSBTAG00000016010","4",31768332,31824070,55738
"9796","ENSBTAG00000016012","19",45384549,45434296,49747
"9797","ENSBTAG00000016013","22",43831391,43848345,16954
"9798","ENSBTAG00000016014","4",31829701,31843769,14068
"9799","ENSBTAG00000016017","19",52500266,52544223,43957
"9800","ENSBTAG00000016021","19",52483395,52499075,15680
"9801","ENSBTAG00000016023","19",52468335,52480600,12265
"9802","ENSBTAG00000016024","24",37407892,37413272,5380
"9803","ENSBTAG00000016026","1",126132067,126231903,99836
"9804","ENSBTAG00000016028","3",103390078,103395435,5357
"9805","ENSBTAG00000016030","2",20793704,20796809,3105
"9806","ENSBTAG00000016033","2",20789261,20790650,1389
"9807","ENSBTAG00000016034","18",50532030,50541209,9179
"9808","ENSBTAG00000016037","18",50541224,50560679,19455
"9809","ENSBTAG00000016038","11",44805532,44840401,34869
"9810","ENSBTAG00000016041","18",50561044,50562841,1797
"9811","ENSBTAG00000016042","7",4000994,4007880,6886
"9812","ENSBTAG00000016043","5",103602565,103609014,6449
"9813","ENSBTAG00000016045","11",85237104,85266681,29577
"9814","ENSBTAG00000016046","9",33189352,33226856,37504
"9815","ENSBTAG00000016048","5",119888929,119897788,8859
"9816","ENSBTAG00000016050","5",119897492,119901095,3603
"9817","ENSBTAG00000016052","12",29841921,29877617,35696
"9818","ENSBTAG00000016053","5",119942566,119945935,3369
"9819","ENSBTAG00000016057","16",80847188,80867559,20371
"9820","ENSBTAG00000016058","23",5456524,5552818,96294
"9821","ENSBTAG00000016060","13",18226732,18280982,54250
"9822","ENSBTAG00000016061","11",90038994,90056291,17297
"9823","ENSBTAG00000016062","21",54673204,54682460,9256
"9824","ENSBTAG00000016063","2",117379818,117771065,391247
"9825","ENSBTAG00000016069","22",43606541,43625327,18786
"9826","ENSBTAG00000016070","8",16299032,16300852,1820
"9827","ENSBTAG00000016071","17",13448752,13558329,109577
"9828","ENSBTAG00000016072","7",43109357,43137776,28419
"9829","ENSBTAG00000016073","8",101283120,101320186,37066
"9830","ENSBTAG00000016074","15",43112434,43179214,66780
"9831","ENSBTAG00000016075","18",11747957,11759716,11759
"9832","ENSBTAG00000016076","22",14455792,14556630,100838
"9833","ENSBTAG00000016077","7",13617639,13621930,4291
"9834","ENSBTAG00000016078","19",5115956,5315869,199913
"9835","ENSBTAG00000016079","18",11758912,11767078,8166
"9836","ENSBTAG00000016080","16",41205338,41473842,268504
"9837","ENSBTAG00000016085","X",37212625,37220146,7521
"9838","ENSBTAG00000016091","21",16566497,16600659,34162
"9839","ENSBTAG00000016092","2",88832854,89024878,192024
"9840","ENSBTAG00000016093","X",87216017,87219386,3369
"9841","ENSBTAG00000016094","7",62635851,62681653,45802
"9842","ENSBTAG00000016095","X",87218648,87228549,9901
"9843","ENSBTAG00000016096","X",87230205,87242062,11857
"9844","ENSBTAG00000016097","X",87245521,87272781,27260
"9845","ENSBTAG00000016098","22",16724649,16732199,7550
"9846","ENSBTAG00000016101","22",16714931,16719806,4875
"9847","ENSBTAG00000016103","18",34704611,34751330,46719
"9848","ENSBTAG00000016104","26",13489681,13540913,51232
"9849","ENSBTAG00000016105","7",46799693,46882561,82868
"9850","ENSBTAG00000016107","X",118649772,118793523,143751
"9851","ENSBTAG00000016108","7",44280997,44302294,21297
"9852","ENSBTAG00000016109","12",21205715,21246209,40494
"9853","ENSBTAG00000016112","21",58604221,58617282,13061
"9854","ENSBTAG00000016113","18",54837596,54846628,9032
"9855","ENSBTAG00000016116","12",33407779,33408369,590
"9856","ENSBTAG00000016121","5",27456255,27467771,11516
"9857","ENSBTAG00000016122","13",73747849,73759591,11742
"9858","ENSBTAG00000016124","23",8520787,8588638,67851
"9859","ENSBTAG00000016125","18",55584700,55587399,2699
"9860","ENSBTAG00000016126","19",56241099,56269017,27918
"9861","ENSBTAG00000016127","13",73763287,73766219,2932
"9862","ENSBTAG00000016128","19",56226171,56240464,14293
"9863","ENSBTAG00000016131","4",119334801,119408828,74027
"9864","ENSBTAG00000016133","19",56222482,56226605,4123
"9865","ENSBTAG00000016137","7",29020202,29124809,104607
"9866","ENSBTAG00000016138","9",62780916,62797821,16905
"9867","ENSBTAG00000016139","25",34213516,34218982,5466
"9868","ENSBTAG00000016140","15",45063034,45217437,154403
"9869","ENSBTAG00000016142","15",45046540,45056681,10141
"9870","ENSBTAG00000016145","7",24410759,24678664,267905
"9871","ENSBTAG00000016147","17",34949127,34953270,4143
"9872","ENSBTAG00000016148","11",105861436,105862442,1006
"9873","ENSBTAG00000016149","20",35077205,35144035,66830
"9874","ENSBTAG00000016151","19",19855894,19858909,3015
"9875","ENSBTAG00000016152","20",35003821,35062931,59110
"9876","ENSBTAG00000016155","25",26186549,26191906,5357
"9877","ENSBTAG00000016156","25",26178468,26186174,7706
"9878","ENSBTAG00000016158","21",20377694,20446373,68679
"9879","ENSBTAG00000016159","14",21608255,21609250,995
"9880","ENSBTAG00000016161","19",34386823,34398726,11903
"9881","ENSBTAG00000016163","17",69282366,69286795,4429
"9882","ENSBTAG00000016164","9",8607136,8739663,132527
"9883","ENSBTAG00000016165","5",27674854,27689030,14176
"9884","ENSBTAG00000016166","5",27660828,27673135,12307
"9885","ENSBTAG00000016167","11",20672449,20740864,68415
"9886","ENSBTAG00000016168","29",36262912,36325816,62904
"9887","ENSBTAG00000016169","13",61179938,61182003,2065
"9888","ENSBTAG00000016170","15",35113703,35116350,2647
"9889","ENSBTAG00000016171","13",61199609,61205430,5821
"9890","ENSBTAG00000016174","2",119226977,119236929,9952
"9891","ENSBTAG00000016175","19",24936774,24976487,39713
"9892","ENSBTAG00000016177","27",19387846,19406133,18287
"9893","ENSBTAG00000016179","7",6849012,6859468,10456
"9894","ENSBTAG00000016185","16",28535630,28690127,154497
"9895","ENSBTAG00000016186","X",97356117,97357613,1496
"9896","ENSBTAG00000016189","16",79938517,79940606,2089
"9897","ENSBTAG00000016190","25",36910745,36923698,12953
"9898","ENSBTAG00000016191","28",45636052,45640704,4652
"9899","ENSBTAG00000016192","2",95031780,95064408,32628
"9900","ENSBTAG00000016193","2",95064720,95085010,20290
"9901","ENSBTAG00000016194","14",16328949,16361047,32098
"9902","ENSBTAG00000016197","15",29261921,29310613,48692
"9903","ENSBTAG00000016198","5",112282183,112344853,62670
"9904","ENSBTAG00000016199","7",69380503,69437827,57324
"9905","ENSBTAG00000016202","15",29310821,29323620,12799
"9906","ENSBTAG00000016203","14",261621,275771,14150
"9907","ENSBTAG00000016204","5",103273388,103298036,24648
"9908","ENSBTAG00000016206","X",99933437,100014113,80676
"9909","ENSBTAG00000016208","13",67002552,67037111,34559
"9910","ENSBTAG00000016209","14",1689941,1691031,1090
"9911","ENSBTAG00000016210","14",1683800,1686606,2806
"9912","ENSBTAG00000016211","7",12657301,12664100,6799
"9913","ENSBTAG00000016213","7",12641076,12658137,17061
"9914","ENSBTAG00000016217","2",44857602,44869106,11504
"9915","ENSBTAG00000016218","11",98758509,98765006,6497
"9916","ENSBTAG00000016220","4",66423128,66443623,20495
"9917","ENSBTAG00000016221","X",61246282,61304946,58664
"9918","ENSBTAG00000016223","4",66355254,66421169,65915
"9919","ENSBTAG00000016224","8",110987196,110992673,5477
"9920","ENSBTAG00000016225","8",110960677,110983738,23061
"9921","ENSBTAG00000016227","5",66733093,66733752,659
"9922","ENSBTAG00000016228","1",106150166,106186579,36413
"9923","ENSBTAG00000016229","8",46586710,46611498,24788
"9924","ENSBTAG00000016230","X",71710584,71853446,142862
"9925","ENSBTAG00000016231","13",61694343,61745905,51562
"9926","ENSBTAG00000016234","10",65313524,65331190,17666
"9927","ENSBTAG00000016235","8",111002463,111011706,9243
"9928","ENSBTAG00000016236","10",28304735,28385879,81144
"9929","ENSBTAG00000016239","10",65309321,65313503,4182
"9930","ENSBTAG00000016240","19",55464958,55539900,74942
"9931","ENSBTAG00000016242","10",65297977,65308806,10829
"9932","ENSBTAG00000016243","18",21801909,21848069,46160
"9933","ENSBTAG00000016244","25",19784819,19837787,52968
"9934","ENSBTAG00000016246","10",65265033,65295343,30310
"9935","ENSBTAG00000016247","6",21354118,21442491,88373
"9936","ENSBTAG00000016249","19",43861632,43866825,5193
"9937","ENSBTAG00000016250","18",21847728,21860197,12469
"9938","ENSBTAG00000016251","19",43868247,43871745,3498
"9939","ENSBTAG00000016252","19",43884990,43904700,19710
"9940","ENSBTAG00000016253","19",43907173,43912005,4832
"9941","ENSBTAG00000016254","19",43912352,43951162,38810
"9942","ENSBTAG00000016255","10",79279034,79299893,20859
"9943","ENSBTAG00000016257","17",72544934,72553115,8181
"9944","ENSBTAG00000016259","8",101814684,101938599,123915
"9945","ENSBTAG00000016260","5",40461232,40666425,205193
"9946","ENSBTAG00000016263","X",14291706,14332456,40750
"9947","ENSBTAG00000016264","7",4632929,4643275,10346
"9948","ENSBTAG00000016265","8",74790616,74800322,9706
"9949","ENSBTAG00000016266","15",22397453,22409057,11604
"9950","ENSBTAG00000016267","15",80850690,80863385,12695
"9951","ENSBTAG00000016268","18",51744820,51782790,37970
"9952","ENSBTAG00000016269","24",50403005,50461032,58027
"9953","ENSBTAG00000016270","11",78448092,78448878,786
"9954","ENSBTAG00000016271","5",60214476,60222722,8246
"9955","ENSBTAG00000016272","X",79752631,79930935,178304
"9956","ENSBTAG00000016274","5",60222922,60248210,25288
"9957","ENSBTAG00000016275","5",60255971,60270687,14716
"9958","ENSBTAG00000016276","5",60276265,60299590,23325
"9959","ENSBTAG00000016277","16",24225168,24268400,43232
"9960","ENSBTAG00000016278","14",66175850,66194695,18845
"9961","ENSBTAG00000016279","13",69992148,69997169,5021
"9962","ENSBTAG00000016281","9",44576094,44708594,132500
"9963","ENSBTAG00000016282","21",67987965,67997279,9314
"9964","ENSBTAG00000016283","10",88380797,88459271,78474
"9965","ENSBTAG00000016284","14",41937221,41996546,59325
"9966","ENSBTAG00000016285","10",88465282,88470538,5256
"9967","ENSBTAG00000016287","19",55785615,55817832,32217
"9968","ENSBTAG00000016290","6",86250301,86308361,58060
"9969","ENSBTAG00000016293","29",5190831,5211255,20424
"9970","ENSBTAG00000016294","13",34231654,34439280,207626
"9971","ENSBTAG00000016295","8",75977936,75980129,2193
"9972","ENSBTAG00000016296","5",29788762,29795178,6416
"9973","ENSBTAG00000016297","2",95992566,96027482,34916
"9974","ENSBTAG00000016298","26",17851539,17912665,61126
"9975","ENSBTAG00000016299","18",61921781,61924820,3039
"9976","ENSBTAG00000016302","23",19878544,19900772,22228
"9977","ENSBTAG00000016305","1",73893640,74020388,126748
"9978","ENSBTAG00000016306","1",132547744,132548300,556
"9979","ENSBTAG00000016307","3",51855684,51880799,25115
"9980","ENSBTAG00000016309","10",79239423,79255817,16394
"9981","ENSBTAG00000016311","10",79255021,79275823,20802
"9982","ENSBTAG00000016312","18",48537130,48543918,6788
"9983","ENSBTAG00000016313","18",48544351,48554508,10157
"9984","ENSBTAG00000016315","18",10775784,10820124,44340
"9985","ENSBTAG00000016316","19",24617657,24710635,92978
"9986","ENSBTAG00000016319","19",24711205,24716946,5741
"9987","ENSBTAG00000016320","15",44281256,44323130,41874
"9988","ENSBTAG00000016323","1",96865068,96974741,109673
"9989","ENSBTAG00000016324","4",44146960,44363428,216468
"9990","ENSBTAG00000016326","3",58835524,58843022,7498
"9991","ENSBTAG00000016327","10",65166732,65202056,35324
"9992","ENSBTAG00000016328","3",110557888,110571478,13590
"9993","ENSBTAG00000016330","25",3856459,3868939,12480
"9994","ENSBTAG00000016331","25",3872510,3882364,9854
"9995","ENSBTAG00000016332","4",85453414,85480394,26980
"9996","ENSBTAG00000016334","2",87843246,88046645,203399
"9997","ENSBTAG00000016335","26",22514804,22517004,2200
"9998","ENSBTAG00000016336","26",22519644,22546646,27002
"9999","ENSBTAG00000016337","23",33069547,33082602,13055
"10000","ENSBTAG00000016338","17",63028441,63121549,93108
"10001","ENSBTAG00000016341","3",6159079,6212125,53046
"10002","ENSBTAG00000016343","26",22552428,22569873,17445
"10003","ENSBTAG00000016344","19",28294817,28342739,47922
"10004","ENSBTAG00000016345","5",75550213,75591439,41226
"10005","ENSBTAG00000016347","16",40269953,40271230,1277
"10006","ENSBTAG00000016348","13",61487256,61512327,25071
"10007","ENSBTAG00000016349","18",55815647,55841503,25856
"10008","ENSBTAG00000016350","7",12444337,12461920,17583
"10009","ENSBTAG00000016352","7",12438436,12441902,3466
"10010","ENSBTAG00000016354","7",12433859,12435630,1771
"10011","ENSBTAG00000016355","15",55160620,55539167,378547
"10012","ENSBTAG00000016357","9",70885902,70916052,30150
"10013","ENSBTAG00000016359","7",101269347,101354602,85255
"10014","ENSBTAG00000016362","5",28570674,28590702,20028
"10015","ENSBTAG00000016363","1",45155599,45188354,32755
"10016","ENSBTAG00000016365","11",26047011,26079187,32176
"10017","ENSBTAG00000016366","11",26078726,26097141,18415
"10018","ENSBTAG00000016367","11",93120914,93141347,20433
"10019","ENSBTAG00000016368","11",26107978,26207684,99706
"10020","ENSBTAG00000016369","16",65100661,65130514,29853
"10021","ENSBTAG00000016370","19",27148724,27150319,1595
"10022","ENSBTAG00000016373","4",102730668,102771532,40864
"10023","ENSBTAG00000016374","9",10397908,10413050,15142
"10024","ENSBTAG00000016377","3",100332768,100369992,37224
"10025","ENSBTAG00000016378","10",21950052,21955730,5678
"10026","ENSBTAG00000016381","10",21942073,21946377,4304
"10027","ENSBTAG00000016385","12",86499761,86514706,14945
"10028","ENSBTAG00000016387","3",25299568,25353595,54027
"10029","ENSBTAG00000016388","13",54671725,54695783,24058
"10030","ENSBTAG00000016389","3",33316136,33317748,1612
"10031","ENSBTAG00000016391","9",16121663,16122025,362
"10032","ENSBTAG00000016396","2",18826605,19250049,423444
"10033","ENSBTAG00000016397","23",49586802,49745081,158279
"10034","ENSBTAG00000016398","5",30470981,30474172,3191
"10035","ENSBTAG00000016399","X",87916593,87934363,17770
"10036","ENSBTAG00000016401","13",27800706,27840043,39337
"10037","ENSBTAG00000016406","13",27854518,27891168,36650
"10038","ENSBTAG00000016407","18",23606056,23612021,5965
"10039","ENSBTAG00000016411","27",29247829,29266018,18189
"10040","ENSBTAG00000016413","27",29281841,29288445,6604
"10041","ENSBTAG00000016414","5",32376365,32440330,63965
"10042","ENSBTAG00000016415","5",60305573,60336225,30652
"10043","ENSBTAG00000016420","22",13798884,13845848,46964
"10044","ENSBTAG00000016424","25",2477200,2486529,9329
"10045","ENSBTAG00000016427","13",62102412,62131186,28774
"10046","ENSBTAG00000016429","7",15749276,15751958,2682
"10047","ENSBTAG00000016430","2",25029282,25113419,84137
"10048","ENSBTAG00000016432","19",34780764,34816442,35678
"10049","ENSBTAG00000016433","X",128633411,128661957,28546
"10050","ENSBTAG00000016434","25",18032878,18077429,44551
"10051","ENSBTAG00000016435","4",118348694,118361445,12751
"10052","ENSBTAG00000016438","18",34483310,34510830,27520
"10053","ENSBTAG00000016441","20",56692045,56705788,13743
"10054","ENSBTAG00000016442","11",21552945,21736237,183292
"10055","ENSBTAG00000016444","20",56526791,56683260,156469
"10056","ENSBTAG00000016445","13",17720460,17749247,28787
"10057","ENSBTAG00000016446","27",33181305,33186909,5604
"10058","ENSBTAG00000016448","2",130297461,130333090,35629
"10059","ENSBTAG00000016450","13",29470661,29492325,21664
"10060","ENSBTAG00000016451","13",29491860,29517411,25551
"10061","ENSBTAG00000016455","3",80788175,81022967,234792
"10062","ENSBTAG00000016456","21",67623262,67721124,97862
"10063","ENSBTAG00000016457","1",86047794,86121242,73448
"10064","ENSBTAG00000016462","24",54594983,54976864,381881
"10065","ENSBTAG00000016465","29",48285096,48304702,19606
"10066","ENSBTAG00000016467","10",21572220,21578551,6331
"10067","ENSBTAG00000016469","15",80501949,80526194,24245
"10068","ENSBTAG00000016470","29",48309501,48338158,28657
"10069","ENSBTAG00000016471","18",1880341,1920828,40487
"10070","ENSBTAG00000016473","27",39013913,39020598,6685
"10071","ENSBTAG00000016477","7",21274513,21280458,5945
"10072","ENSBTAG00000016478","7",21265619,21267397,1778
"10073","ENSBTAG00000016481","4",92719265,92744873,25608
"10074","ENSBTAG00000016484","X",23164132,23265292,101160
"10075","ENSBTAG00000016486","27",15790398,16001017,210619
"10076","ENSBTAG00000016494","15",52862870,52879965,17095
"10077","ENSBTAG00000016495","21",6023636,6056491,32855
"10078","ENSBTAG00000016496","5",31932949,31938044,5095
"10079","ENSBTAG00000016497","15",52890052,53086176,196124
"10080","ENSBTAG00000016498","9",81071948,81286688,214740
"10081","ENSBTAG00000016501","15",76622892,76639557,16665
"10082","ENSBTAG00000016502","29",36224832,36227640,2808
"10083","ENSBTAG00000016504","3",115044731,115604936,560205
"10084","ENSBTAG00000016505","25",16931193,16989972,58779
"10085","ENSBTAG00000016506","29",29698724,29750191,51467
"10086","ENSBTAG00000016507","5",113417141,113436911,19770
"10087","ENSBTAG00000016508","5",55634355,55656768,22413
"10088","ENSBTAG00000016510","5",113436160,113444152,7992
"10089","ENSBTAG00000016511","5",113447522,113470655,23133
"10090","ENSBTAG00000016512","2",30336543,30434725,98182
"10091","ENSBTAG00000016513","18",60741854,60749312,7458
"10092","ENSBTAG00000016514","17",573369,721435,148066
"10093","ENSBTAG00000016515","7",106497219,106784981,287762
"10094","ENSBTAG00000016516","5",113473711,113498670,24959
"10095","ENSBTAG00000016519","23",37723596,37834307,110711
"10096","ENSBTAG00000016520","25",990596,992595,1999
"10097","ENSBTAG00000016522","21",23257796,23264107,6311
"10098","ENSBTAG00000016523","17",51794311,51952067,157756
"10099","ENSBTAG00000016524","13",63374875,63464846,89971
"10100","ENSBTAG00000016525","20",26108411,26283573,175162
"10101","ENSBTAG00000016526","18",55903404,55910398,6994
"10102","ENSBTAG00000016527","28",25944288,25947538,3250
"10103","ENSBTAG00000016528","16",51514474,51527133,12659
"10104","ENSBTAG00000016529","12",15541390,15565519,24129
"10105","ENSBTAG00000016532","22",49711610,49740232,28622
"10106","ENSBTAG00000016533","22",30294351,30686756,392405
"10107","ENSBTAG00000016534","11",43208567,43311324,102757
"10108","ENSBTAG00000016541","16",73713243,73744243,31000
"10109","ENSBTAG00000016542","16",73668603,73712367,43764
"10110","ENSBTAG00000016546","4",103472247,103519158,46911
"10111","ENSBTAG00000016547","15",14448588,14488828,40240
"10112","ENSBTAG00000016548","15",22504072,22509205,5133
"10113","ENSBTAG00000016549","23",32267215,32573502,306287
"10114","ENSBTAG00000016550","3",1829693,1886128,56435
"10115","ENSBTAG00000016552","25",1349764,1351265,1501
"10116","ENSBTAG00000016553","25",1352321,1355120,2799
"10117","ENSBTAG00000016554","1",56882970,56918320,35350
"10118","ENSBTAG00000016555","29",42529011,42532064,3053
"10119","ENSBTAG00000016557","15",14329140,14447600,118460
"10120","ENSBTAG00000016558","25",1355612,1361181,5569
"10121","ENSBTAG00000016559","29",42531635,42534804,3169
"10122","ENSBTAG00000016560","29",42534249,42539123,4874
"10123","ENSBTAG00000016561","25",1361638,1366860,5222
"10124","ENSBTAG00000016562","9",42151796,42219435,67639
"10125","ENSBTAG00000016563","22",10776195,10886175,109980
"10126","ENSBTAG00000016564","25",152493,185694,33201
"10127","ENSBTAG00000016566","22",10908546,11272063,363517
"10128","ENSBTAG00000016567","25",222415,223194,779
"10129","ENSBTAG00000016568","25",231277,263800,32523
"10130","ENSBTAG00000016571","25",276353,299484,23131
"10131","ENSBTAG00000016572","2",106447346,106532901,85555
"10132","ENSBTAG00000016573","11",30977114,31040358,63244
"10133","ENSBTAG00000016574","25",299628,304824,5196
"10134","ENSBTAG00000016577","25",313101,347292,34191
"10135","ENSBTAG00000016578","2",129500051,129531646,31595
"10136","ENSBTAG00000016580","5",112495969,112519575,23606
"10137","ENSBTAG00000016581","25",361870,364453,2583
"10138","ENSBTAG00000016584","9",39325007,39373157,48150
"10139","ENSBTAG00000016588","25",365762,375066,9304
"10140","ENSBTAG00000016589","5",30202309,30240990,38681
"10141","ENSBTAG00000016590","25",383715,386873,3158
"10142","ENSBTAG00000016591","25",404523,464177,59654
"10143","ENSBTAG00000016592","25",474248,485664,11416
"10144","ENSBTAG00000016593","5",30151294,30202352,51058
"10145","ENSBTAG00000016594","25",499022,512246,13224
"10146","ENSBTAG00000016595","7",51364569,51435249,70680
"10147","ENSBTAG00000016598","21",66850740,66911778,61038
"10148","ENSBTAG00000016599","11",10159213,10162298,3085
"10149","ENSBTAG00000016600","11",10151984,10158175,6191
"10150","ENSBTAG00000016602","11",10138281,10140220,1939
"10151","ENSBTAG00000016603","21",66912801,66928743,15942
"10152","ENSBTAG00000016606","11",10130551,10132842,2291
"10153","ENSBTAG00000016609","11",10114072,10120751,6679
"10154","ENSBTAG00000016612","10",86332450,86367622,35172
"10155","ENSBTAG00000016613","19",47841787,47864567,22780
"10156","ENSBTAG00000016615","22",43026804,43075099,48295
"10157","ENSBTAG00000016618","16",2935604,2985029,49425
"10158","ENSBTAG00000016619","1",3209824,3222938,13114
"10159","ENSBTAG00000016620","24",45560584,45575909,15325
"10160","ENSBTAG00000016621","19",24462679,24488625,25946
"10161","ENSBTAG00000016622","22",16271889,16309668,37779
"10162","ENSBTAG00000016624","1",83064169,83070990,6821
"10163","ENSBTAG00000016625","17",3995816,4171087,175271
"10164","ENSBTAG00000016627","9",40037421,40109999,72578
"10165","ENSBTAG00000016629","25",3246956,3349173,102217
"10166","ENSBTAG00000016633","17",2088797,2093009,4212
"10167","ENSBTAG00000016635","12",22698525,22753083,54558
"10168","ENSBTAG00000016637","12",11277083,11299445,22362
"10169","ENSBTAG00000016640","18",18480139,18519650,39511
"10170","ENSBTAG00000016643","3",33946014,33954930,8916
"10171","ENSBTAG00000016644","10",4850840,4929057,78217
"10172","ENSBTAG00000016645","6",65496510,65573542,77032
"10173","ENSBTAG00000016646","5",105269006,105270493,1487
"10174","ENSBTAG00000016648","7",43201562,43208656,7094
"10175","ENSBTAG00000016649","5",105763459,105787132,23673
"10176","ENSBTAG00000016650","5",105732531,105747498,14967
"10177","ENSBTAG00000016651","21",31584548,31590222,5674
"10178","ENSBTAG00000016656","1",67012287,67058498,46211
"10179","ENSBTAG00000016658","10",22200351,22212618,12267
"10180","ENSBTAG00000016661","5",75988786,76019180,30394
"10181","ENSBTAG00000016662","2",98327892,98467680,139788
"10182","ENSBTAG00000016663","24",60492609,60601514,108905
"10183","ENSBTAG00000016664","13",54030667,54033391,2724
"10184","ENSBTAG00000016666","24",60601662,60714860,113198
"10185","ENSBTAG00000016667","13",53979453,54027412,47959
"10186","ENSBTAG00000016675","17",54291474,54312144,20670
"10187","ENSBTAG00000016676","13",30918706,30994962,76256
"10188","ENSBTAG00000016677","13",30996656,31004164,7508
"10189","ENSBTAG00000016679","17",40285083,40337562,52479
"10190","ENSBTAG00000016680","17",40279436,40292370,12934
"10191","ENSBTAG00000016683","21",45639133,45643131,3998
"10192","ENSBTAG00000016684","15",34308406,34315987,7581
"10193","ENSBTAG00000016685","16",38865097,38902141,37044
"10194","ENSBTAG00000016688","X",61885294,61886292,998
"10195","ENSBTAG00000016691","12",14093233,14103845,10612
"10196","ENSBTAG00000016692","15",28095216,28194601,99385
"10197","ENSBTAG00000016694","3",110214078,110307266,93188
"10198","ENSBTAG00000016695","18",10497903,10510536,12633
"10199","ENSBTAG00000016696","3",110202070,110210854,8784
"10200","ENSBTAG00000016698","3",9850404,9860647,10243
"10201","ENSBTAG00000016703","16",12027018,12117531,90513
"10202","ENSBTAG00000016704","29",28495549,28524597,29048
"10203","ENSBTAG00000016705","3",28755534,28769812,14278
"10204","ENSBTAG00000016707","4",63812248,63854573,42325
"10205","ENSBTAG00000016708","19",10595786,10660521,64735
"10206","ENSBTAG00000016709","4",63788270,63807500,19230
"10207","ENSBTAG00000016710","19",10665274,10674104,8830
"10208","ENSBTAG00000016711","28",34966650,34973573,6923
"10209","ENSBTAG00000016712","3",57408592,57444768,36176
"10210","ENSBTAG00000016713","10",73390550,73391611,1061
"10211","ENSBTAG00000016714","6",115460363,115466921,6558
"10212","ENSBTAG00000016716","14",30687060,30688821,1761
"10213","ENSBTAG00000016717","11",63443972,63468974,25002
"10214","ENSBTAG00000016720","11",63471793,63500632,28839
"10215","ENSBTAG00000016721","7",12895974,12897485,1511
"10216","ENSBTAG00000016722","11",82956390,82976683,20293
"10217","ENSBTAG00000016723","3",50945369,50956131,10762
"10218","ENSBTAG00000016724","13",57665835,57682867,17032
"10219","ENSBTAG00000016725","22",16499122,16508096,8974
"10220","ENSBTAG00000016726","22",16507963,16564652,56689
"10221","ENSBTAG00000016728","16",46873183,46904877,31694
"10222","ENSBTAG00000016729","16",6388192,6826502,438310
"10223","ENSBTAG00000016730","3",20409567,20423408,13841
"10224","ENSBTAG00000016731","22",54270977,54274825,3848
"10225","ENSBTAG00000016732","19",57115962,57146541,30579
"10226","ENSBTAG00000016733","16",46832476,46851187,18711
"10227","ENSBTAG00000016734","16",46823946,46831825,7879
"10228","ENSBTAG00000016735","16",46815369,46823480,8111
"10229","ENSBTAG00000016736","19",44564294,44566917,2623
"10230","ENSBTAG00000016737","12",33082022,33153677,71655
"10231","ENSBTAG00000016738","17",61085710,61123902,38192
"10232","ENSBTAG00000016739","17",61125494,61163613,38119
"10233","ENSBTAG00000016740","19",42049435,42093855,44420
"10234","ENSBTAG00000016741","13",72414396,72567739,153343
"10235","ENSBTAG00000016742","13",74551350,74564779,13429
"10236","ENSBTAG00000016743","13",74564888,74587020,22132
"10237","ENSBTAG00000016744","15",64661600,64697021,35421
"10238","ENSBTAG00000016746","13",74586517,74593327,6810
"10239","ENSBTAG00000016747","15",64702013,64740844,38831
"10240","ENSBTAG00000016748","2",120038513,120041495,2982
"10241","ENSBTAG00000016750","8",101635405,101722064,86659
"10242","ENSBTAG00000016751","9",15461668,15554235,92567
"10243","ENSBTAG00000016752","4",113719034,113761445,42411
"10244","ENSBTAG00000016754","14",16228870,16241271,12401
"10245","ENSBTAG00000016757","25",36405295,36418869,13574
"10246","ENSBTAG00000016758","22",10457825,10551357,93532
"10247","ENSBTAG00000016760","22",10347060,10455986,108926
"10248","ENSBTAG00000016761","X",51310497,51346521,36024
"10249","ENSBTAG00000016762","2",24637412,24736032,98620
"10250","ENSBTAG00000016763","25",36108387,36112557,4170
"10251","ENSBTAG00000016764","X",85564805,85586823,22018
"10252","ENSBTAG00000016765","25",36087990,36091646,3656
"10253","ENSBTAG00000016766","4",113400403,113408319,7916
"10254","ENSBTAG00000016768","15",34227876,34254186,26310
"10255","ENSBTAG00000016769","X",85590421,85601821,11400
"10256","ENSBTAG00000016770","20",20805729,20810823,5094
"10257","ENSBTAG00000016771","20",20847409,20853378,5969
"10258","ENSBTAG00000016772","X",85604710,85619691,14981
"10259","ENSBTAG00000016773","7",5658324,5663017,4693
"10260","ENSBTAG00000016775","7",5605375,5646428,41053
"10261","ENSBTAG00000016776","19",51302716,51357264,54548
"10262","ENSBTAG00000016777","18",51566522,51569656,3134
"10263","ENSBTAG00000016779","17",52998851,53115871,117020
"10264","ENSBTAG00000016782","2",84253392,84389538,136146
"10265","ENSBTAG00000016783","7",5590439,5599169,8730
"10266","ENSBTAG00000016784","2",84377037,84632137,255100
"10267","ENSBTAG00000016785","2",69535964,69553834,17870
"10268","ENSBTAG00000016791","9",74805000,74883599,78599
"10269","ENSBTAG00000016793","9",74889556,74892763,3207
"10270","ENSBTAG00000016794","11",26441298,26474363,33065
"10271","ENSBTAG00000016795","6",86092957,86171203,78246
"10272","ENSBTAG00000016797","7",44243734,44268032,24298
"10273","ENSBTAG00000016799","19",48273414,48350809,77395
"10274","ENSBTAG00000016800","10",62638620,62697268,58648
"10275","ENSBTAG00000016801","3",3538896,3599116,60220
"10276","ENSBTAG00000016804","28",8379173,8523114,143941
"10277","ENSBTAG00000016805","6",17297001,17391885,94884
"10278","ENSBTAG00000016806","19",23512801,23581162,68361
"10279","ENSBTAG00000016810","14",1101602,1108734,7132
"10280","ENSBTAG00000016813","17",6490585,6698879,208294
"10281","ENSBTAG00000016814","28",43760392,43804579,44187
"10282","ENSBTAG00000016817","2",122347180,122372981,25801
"10283","ENSBTAG00000016818","2",122295337,122347439,52102
"10284","ENSBTAG00000016819","2",122285620,122294666,9046
"10285","ENSBTAG00000016820","X",137182426,137232036,49610
"10286","ENSBTAG00000016821","10",45824595,45830579,5984
"10287","ENSBTAG00000016822","10",45818677,45824619,5942
"10288","ENSBTAG00000016823","10",45660900,45811429,150529
"10289","ENSBTAG00000016824","23",7453264,7463155,9891
"10290","ENSBTAG00000016826","10",35455221,35579809,124588
"10291","ENSBTAG00000016827","23",7465583,7472693,7110
"10292","ENSBTAG00000016828","23",7473580,7484202,10622
"10293","ENSBTAG00000016829","23",7484223,7486127,1904
"10294","ENSBTAG00000016830","23",7487546,7491922,4376
"10295","ENSBTAG00000016834","23",9767607,9783035,15428
"10296","ENSBTAG00000016835","23",24645643,24653192,7549
"10297","ENSBTAG00000016836","2",24026650,24069014,42364
"10298","ENSBTAG00000016838","23",9787871,9824986,37115
"10299","ENSBTAG00000016839","9",12969537,12990379,20842
"10300","ENSBTAG00000016841","7",72220261,72358789,138528
"10301","ENSBTAG00000016844","9",83905971,84100518,194547
"10302","ENSBTAG00000016845","8",5591834,5726979,135145
"10303","ENSBTAG00000016846","13",73297664,73319931,22267
"10304","ENSBTAG00000016847","19",43342402,43344318,1916
"10305","ENSBTAG00000016848","1",65433369,65474553,41184
"10306","ENSBTAG00000016849","13",73331681,73344136,12455
"10307","ENSBTAG00000016851","19",10841303,10878409,37106
"10308","ENSBTAG00000016852","3",108338106,108355571,17465
"10309","ENSBTAG00000016854","21",61274471,61343081,68610
"10310","ENSBTAG00000016855","15",27406269,27430976,24707
"10311","ENSBTAG00000016857","29",36560407,36584912,24505
"10312","ENSBTAG00000016858","28",26384597,26396614,12017
"10313","ENSBTAG00000016864","13",67214873,67247273,32400
"10314","ENSBTAG00000016867","8",82961057,83014357,53300
"10315","ENSBTAG00000016869","15",53909173,53953518,44345
"10316","ENSBTAG00000016873","13",72669119,72679177,10058
"10317","ENSBTAG00000016874","7",11269404,11273083,3679
"10318","ENSBTAG00000016876","5",100277062,100277637,575
"10319","ENSBTAG00000016877","2",132470520,132486289,15769
"10320","ENSBTAG00000016878","18",2259179,2339568,80389
"10321","ENSBTAG00000016879","4",104914558,104960261,45703
"10322","ENSBTAG00000016881","21",21195680,21213021,17341
"10323","ENSBTAG00000016882","28",25526476,25551758,25282
"10324","ENSBTAG00000016883","25",26092599,26123366,30767
"10325","ENSBTAG00000016885","28",23365381,23574789,209408
"10326","ENSBTAG00000016886","18",24051082,24052904,1822
"10327","ENSBTAG00000016887","23",8887254,8894899,7645
"10328","ENSBTAG00000016890","23",8896219,9063638,167419
"10329","ENSBTAG00000016891","23",9078654,9110714,32060
"10330","ENSBTAG00000016894","2",1066691,1175326,108635
"10331","ENSBTAG00000016895","2",1044598,1064844,20246
"10332","ENSBTAG00000016896","18",24965857,24977798,11941
"10333","ENSBTAG00000016899","3",102629291,102654464,25173
"10334","ENSBTAG00000016900","20",13903927,13938339,34412
"10335","ENSBTAG00000016902","20",13853750,13899292,45542
"10336","ENSBTAG00000016903","20",13752971,13853634,100663
"10337","ENSBTAG00000016904","5",55705886,55710394,4508
"10338","ENSBTAG00000016906","5",55698030,55704141,6111
"10339","ENSBTAG00000016908","5",55693579,55697768,4189
"10340","ENSBTAG00000016910","5",55685470,55699636,14166
"10341","ENSBTAG00000016911","19",39088363,39136166,47803
"10342","ENSBTAG00000016912","5",55677211,55685370,8159
"10343","ENSBTAG00000016913","5",55657654,55676222,18568
"10344","ENSBTAG00000016915","12",31624125,31829369,205244
"10345","ENSBTAG00000016918","26",14623780,14803157,179377
"10346","ENSBTAG00000016920","22",2109641,2116204,6563
"10347","ENSBTAG00000016924","23",39867875,40003014,135139
"10348","ENSBTAG00000016926","13",58171229,58187773,16544
"10349","ENSBTAG00000016928","26",21845153,21862381,17228
"10350","ENSBTAG00000016929","7",49214888,49218365,3477
"10351","ENSBTAG00000016931","5",6443192,6482529,39337
"10352","ENSBTAG00000016932","1",45816823,45988234,171411
"10353","ENSBTAG00000016933","7",11641168,11665060,23892
"10354","ENSBTAG00000016936","7",11623511,11626222,2711
"10355","ENSBTAG00000016937","7",11611606,11618492,6886
"10356","ENSBTAG00000016939","11",68474083,68513151,39068
"10357","ENSBTAG00000016943","16",77074385,77212053,137668
"10358","ENSBTAG00000016944","17",71592531,71608102,15571
"10359","ENSBTAG00000016948","22",52597375,52624332,26957
"10360","ENSBTAG00000016950","29",40959781,40964618,4837
"10361","ENSBTAG00000016951","2",112010456,112064142,53686
"10362","ENSBTAG00000016952","8",110195834,110217114,21280
"10363","ENSBTAG00000016954","1",158296611,158315972,19361
"10364","ENSBTAG00000016956","29",40966901,40982284,15383
"10365","ENSBTAG00000016958","8",110242266,110260664,18398
"10366","ENSBTAG00000016959","14",66373395,66438425,65030
"10367","ENSBTAG00000016963","20",14047359,14332388,285029
"10368","ENSBTAG00000016967","9",62336702,62417666,80964
"10369","ENSBTAG00000016968","18",39529465,39536278,6813
"10370","ENSBTAG00000016969","9",62267857,62337163,69306
"10371","ENSBTAG00000016972","19",18501132,18574408,73276
"10372","ENSBTAG00000016973","25",27228651,27233122,4471
"10373","ENSBTAG00000016975","4",76689344,76701169,11825
"10374","ENSBTAG00000016977","X",35991255,36013728,22473
"10375","ENSBTAG00000016979","1",70824603,70878013,53410
"10376","ENSBTAG00000016980","9",86741578,86782301,40723
"10377","ENSBTAG00000016981","20",32589453,32602498,13045
"10378","ENSBTAG00000016982","3",59055510,59090386,34876
"10379","ENSBTAG00000016984","21",33305768,33375889,70121
"10380","ENSBTAG00000016987","11",75008630,75029311,20681
"10381","ENSBTAG00000016988","7",14429856,14442110,12254
"10382","ENSBTAG00000016989","X",137559911,137563950,4039
"10383","ENSBTAG00000016990","3",91131528,91284630,153102
"10384","ENSBTAG00000016991","12",82241704,82289618,47914
"10385","ENSBTAG00000016995","5",108838763,108849972,11209
"10386","ENSBTAG00000016997","18",56282528,56288926,6398
"10387","ENSBTAG00000016998","12",19179821,19181672,1851
"10388","ENSBTAG00000016999","1",135082834,135191082,108248
"10389","ENSBTAG00000017000","9",75054085,75074492,20407
"10390","ENSBTAG00000017001","4",92499373,92531680,32307
"10391","ENSBTAG00000017002","13",60605469,60622626,17157
"10392","ENSBTAG00000017005","11",105879001,105881812,2811
"10393","ENSBTAG00000017007","13",60634440,60645432,10992
"10394","ENSBTAG00000017009","18",7686031,7700190,14159
"10395","ENSBTAG00000017010","1",144809574,144833722,24148
"10396","ENSBTAG00000017011","20",10404727,10427800,23073
"10397","ENSBTAG00000017012","13",10822457,10835395,12938
"10398","ENSBTAG00000017015","25",9365013,9414544,49531
"10399","ENSBTAG00000017016","14",19419742,19420794,1052
"10400","ENSBTAG00000017017","X",126802958,126911606,108648
"10401","ENSBTAG00000017019","14",19424288,19551028,126740
"10402","ENSBTAG00000017020","X",126857761,126861849,4088
"10403","ENSBTAG00000017021","14",19551601,19563221,11620
"10404","ENSBTAG00000017023","17",69972392,69984070,11678
"10405","ENSBTAG00000017024","6",43380463,43501184,120721
"10406","ENSBTAG00000017026","20",18560198,18649542,89344
"10407","ENSBTAG00000017027","3",100566182,100571190,5008
"10408","ENSBTAG00000017028","6",90560691,90641879,81188
"10409","ENSBTAG00000017029","3",100571785,100574558,2773
"10410","ENSBTAG00000017031","3",70108633,70160145,51512
"10411","ENSBTAG00000017032","12",23297835,23449177,151342
"10412","ENSBTAG00000017033","18",45966140,45981351,15211
"10413","ENSBTAG00000017035","18",45982575,45992237,9662
"10414","ENSBTAG00000017037","7",11303312,11333515,30203
"10415","ENSBTAG00000017038","17",66113220,66140520,27300
"10416","ENSBTAG00000017039","11",21250827,21295045,44218
"10417","ENSBTAG00000017040","14",1422652,1426356,3704
"10418","ENSBTAG00000017041","7",11300366,11304191,3825
"10419","ENSBTAG00000017042","18",45994746,45996356,1610
"10420","ENSBTAG00000017043","2",94507200,94552835,45635
"10421","ENSBTAG00000017044","18",46002123,46018891,16768
"10422","ENSBTAG00000017045","6",5970114,5973346,3232
"10423","ENSBTAG00000017048","12",36486712,36521339,34627
"10424","ENSBTAG00000017051","3",21960526,21981430,20904
"10425","ENSBTAG00000017053","28",1471776,1494454,22678
"10426","ENSBTAG00000017055","3",15354861,15363825,8964
"10427","ENSBTAG00000017056","3",15344675,15354053,9378
"10428","ENSBTAG00000017060","1",144759527,144789479,29952
"10429","ENSBTAG00000017061","6",30308257,30398980,90723
"10430","ENSBTAG00000017063","8",98732990,98868703,135713
"10431","ENSBTAG00000017064","5",103778087,103785354,7267
"10432","ENSBTAG00000017067","25",33562095,33573445,11350
"10433","ENSBTAG00000017068","7",5807201,5817259,10058
"10434","ENSBTAG00000017069","17",40795189,40871776,76587
"10435","ENSBTAG00000017071","20",39720311,39752581,32270
"10436","ENSBTAG00000017072","5",103756234,103775871,19637
"10437","ENSBTAG00000017073","6",30269614,30303214,33600
"10438","ENSBTAG00000017074","7",5794556,5803719,9163
"10439","ENSBTAG00000017075","25",33543190,33561036,17846
"10440","ENSBTAG00000017077","8",83553382,83558696,5314
"10441","ENSBTAG00000017078","7",65295989,65330574,34585
"10442","ENSBTAG00000017079","7",65340082,65347501,7419
"10443","ENSBTAG00000017081","19",34382621,34386321,3700
"10444","ENSBTAG00000017082","25",34146939,34213388,66449
"10445","ENSBTAG00000017083","27",26937647,27003539,65892
"10446","ENSBTAG00000017085","27",8686865,8698220,11355
"10447","ENSBTAG00000017086","4",5106065,5327013,220948
"10448","ENSBTAG00000017087","19",34359100,34379578,20478
"10449","ENSBTAG00000017090","19",34353294,34358390,5096
"10450","ENSBTAG00000017091","23",11318736,11372125,53389
"10451","ENSBTAG00000017094","19",34334364,34350038,15674
"10452","ENSBTAG00000017095","10",12556380,12638806,82426
"10453","ENSBTAG00000017096","27",498301,531821,33520
"10454","ENSBTAG00000017097","23",16547283,16552636,5353
"10455","ENSBTAG00000017098","13",62727682,62734810,7128
"10456","ENSBTAG00000017103","1",81711839,81868201,156362
"10457","ENSBTAG00000017104","3",15427371,15432019,4648
"10458","ENSBTAG00000017105","7",44827999,45259343,431344
"10459","ENSBTAG00000017108","2",132802975,132831792,28817
"10460","ENSBTAG00000017112","18",7389327,7553534,164207
"10461","ENSBTAG00000017113","5",27974153,27976040,1887
"10462","ENSBTAG00000017115","1",81696499,81706039,9540
"10463","ENSBTAG00000017116","5",73749045,73760542,11497
"10464","ENSBTAG00000017118","23",39831961,39840596,8635
"10465","ENSBTAG00000017120","19",37195914,37206574,10660
"10466","ENSBTAG00000017121","6",88484915,88503341,18426
"10467","ENSBTAG00000017122","2",130906818,130976365,69547
"10468","ENSBTAG00000017123","7",3508101,3531656,23555
"10469","ENSBTAG00000017124","3",34431970,34485343,53373
"10470","ENSBTAG00000017125","3",106494310,106507737,13427
"10471","ENSBTAG00000017128","23",39755907,39826783,70876
"10472","ENSBTAG00000017129","3",34397588,34430982,33394
"10473","ENSBTAG00000017131","6",88511182,88532729,21547
"10474","ENSBTAG00000017132","3",91489658,91514087,24429
"10475","ENSBTAG00000017133","27",36454819,36470324,15505
"10476","ENSBTAG00000017135","3",19981529,20004455,22926
"10477","ENSBTAG00000017136","19",58153872,58154978,1106
"10478","ENSBTAG00000017137","8",39822427,39841618,19191
"10479","ENSBTAG00000017138","14",8558256,8587613,29357
"10480","ENSBTAG00000017139","9",70392486,70449183,56697
"10481","ENSBTAG00000017140","1",53314658,53338782,24124
"10482","ENSBTAG00000017141","10",67014577,67042304,27727
"10483","ENSBTAG00000017143","4",112198601,112215554,16953
"10484","ENSBTAG00000017145","3",91464951,91485080,20129
"10485","ENSBTAG00000017146","15",31274172,31606902,332730
"10486","ENSBTAG00000017147","8",39797196,39819493,22297
"10487","ENSBTAG00000017150","15",65186293,65227768,41475
"10488","ENSBTAG00000017151","7",60396062,60449985,53923
"10489","ENSBTAG00000017155","8",105876120,105887774,11654
"10490","ENSBTAG00000017157","27",15691913,15705241,13328
"10491","ENSBTAG00000017158","11",80940114,81060900,120786
"10492","ENSBTAG00000017160","23",43223724,43247454,23730
"10493","ENSBTAG00000017161","3",83947667,83996285,48618
"10494","ENSBTAG00000017162","2",27870256,28191872,321616
"10495","ENSBTAG00000017164","5",29433902,29503457,69555
"10496","ENSBTAG00000017165","14",66186820,66359721,172901
"10497","ENSBTAG00000017166","9",23751837,23764663,12826
"10498","ENSBTAG00000017167","17",2668435,2675467,7032
"10499","ENSBTAG00000017169","14",41547135,41547515,380
"10500","ENSBTAG00000017173","22",58119606,58120919,1313
"10501","ENSBTAG00000017174","22",12236370,12317469,81099
"10502","ENSBTAG00000017175","25",38616529,38735137,118608
"10503","ENSBTAG00000017177","10",84568244,84607402,39158
"10504","ENSBTAG00000017179","12",32655066,32715128,60062
"10505","ENSBTAG00000017180","1",102184529,102187471,2942
"10506","ENSBTAG00000017181","29",42323907,42478140,154233
"10507","ENSBTAG00000017183","27",15712971,15743960,30989
"10508","ENSBTAG00000017184","X",4819983,4827596,7613
"10509","ENSBTAG00000017187","X",4830043,4875887,45844
"10510","ENSBTAG00000017188","13",6817156,6909116,91960
"10511","ENSBTAG00000017189","11",9706676,9718212,11536
"10512","ENSBTAG00000017194","21",68618028,68641669,23641
"10513","ENSBTAG00000017195","8",81630504,81880309,249805
"10514","ENSBTAG00000017196","21",55370251,55392458,22207
"10515","ENSBTAG00000017198","13",54242438,54258140,15702
"10516","ENSBTAG00000017199","11",67286584,67291599,5015
"10517","ENSBTAG00000017200","10",75470506,75564630,94124
"10518","ENSBTAG00000017201","21",41679370,41697665,18295
"10519","ENSBTAG00000017204","3",12437151,12449445,12294
"10520","ENSBTAG00000017205","9",38367059,38384930,17871
"10521","ENSBTAG00000017209","X",128772311,128979609,207298
"10522","ENSBTAG00000017211","21",55410998,55420016,9018
"10523","ENSBTAG00000017212","21",55420598,55421853,1255
"10524","ENSBTAG00000017213","21",55423113,55434578,11465
"10525","ENSBTAG00000017214","2",5580308,5583221,2913
"10526","ENSBTAG00000017215","21",55434615,55488834,54219
"10527","ENSBTAG00000017216","21",55493420,55815798,322378
"10528","ENSBTAG00000017218","15",56246885,56403904,157019
"10529","ENSBTAG00000017219","17",45021148,45028147,6999
"10530","ENSBTAG00000017220","19",48117957,48119752,1795
"10531","ENSBTAG00000017221","19",4867726,4868034,308
"10532","ENSBTAG00000017222","20",61624947,62314149,689202
"10533","ENSBTAG00000017223","4",94250156,94263796,13640
"10534","ENSBTAG00000017225","19",17990883,18003360,12477
"10535","ENSBTAG00000017227","23",29121175,29122128,953
"10536","ENSBTAG00000017228","15",75004612,75009213,4601
"10537","ENSBTAG00000017232","8",9440963,9630218,189255
"10538","ENSBTAG00000017233","19",52337266,52363244,25978
"10539","ENSBTAG00000017239","23",28974598,29003173,28575
"10540","ENSBTAG00000017240","6",117399827,117410601,10774
"10541","ENSBTAG00000017241","X",76266655,76267157,502
"10542","ENSBTAG00000017242","19",56520577,56536561,15984
"10543","ENSBTAG00000017243","13",15906719,15935286,28567
"10544","ENSBTAG00000017244","13",28284941,28340069,55128
"10545","ENSBTAG00000017245","4",94264008,94443596,179588
"10546","ENSBTAG00000017246","19",33249951,33251848,1897
"10547","ENSBTAG00000017248","19",56518196,56518567,371
"10548","ENSBTAG00000017249","14",36436043,36467110,31067
"10549","ENSBTAG00000017251","23",9878961,9967961,89000
"10550","ENSBTAG00000017252","19",56501076,56504816,3740
"10551","ENSBTAG00000017253","2",124332402,124368606,36204
"10552","ENSBTAG00000017255","11",75091973,75213880,121907
"10553","ENSBTAG00000017256","3",26468671,26483254,14583
"10554","ENSBTAG00000017258","2",111037664,111113602,75938
"10555","ENSBTAG00000017260","5",89133571,89283293,149722
"10556","ENSBTAG00000017263","26",30781051,30873489,92438
"10557","ENSBTAG00000017265","X",35788891,35812844,23953
"10558","ENSBTAG00000017266","2",24091577,24179151,87574
"10559","ENSBTAG00000017267","21",33764338,33776146,11808
"10560","ENSBTAG00000017268","19",20131148,20138974,7826
"10561","ENSBTAG00000017271","13",17750047,17773222,23175
"10562","ENSBTAG00000017273","7",4771712,4775571,3859
"10563","ENSBTAG00000017275","19",7765308,7787064,21756
"10564","ENSBTAG00000017277","17",71800734,71808096,7362
"10565","ENSBTAG00000017278","13",17781345,17810578,29233
"10566","ENSBTAG00000017279","24",41892909,41928962,36053
"10567","ENSBTAG00000017280","7",17773675,17810616,36941
"10568","ENSBTAG00000017281","14",765421,774581,9160
"10569","ENSBTAG00000017283","11",72308892,72321809,12917
"10570","ENSBTAG00000017284","25",580180,582397,2217
"10571","ENSBTAG00000017287","5",65703174,65738912,35738
"10572","ENSBTAG00000017289","12",86422451,86489884,67433
"10573","ENSBTAG00000017291","7",17759546,17767568,8022
"10574","ENSBTAG00000017294","8",103550934,103555915,4981
"10575","ENSBTAG00000017296","6",116437374,116589597,152223
"10576","ENSBTAG00000017298","29",18154938,18188910,33972
"10577","ENSBTAG00000017299","21",68243678,68304998,61320
"10578","ENSBTAG00000017301","16",3876671,3882191,5520
"10579","ENSBTAG00000017305","17",71131053,71166047,34994
"10580","ENSBTAG00000017306","8",103556544,103604933,48389
"10581","ENSBTAG00000017310","1",2978428,3080528,102100
"10582","ENSBTAG00000017312","1",79657444,79659377,1933
"10583","ENSBTAG00000017313","5",108855713,108879525,23812
"10584","ENSBTAG00000017318","11",21962840,22020615,57775
"10585","ENSBTAG00000017321","1",144687135,144696665,9530
"10586","ENSBTAG00000017322","1",106838580,106839158,578
"10587","ENSBTAG00000017325","15",76578279,76620035,41756
"10588","ENSBTAG00000017326","3",87479245,87544530,65285
"10589","ENSBTAG00000017328","13",74295476,74300845,5369
"10590","ENSBTAG00000017329","23",33008576,33019344,10768
"10591","ENSBTAG00000017330","11",73196933,73197443,510
"10592","ENSBTAG00000017333","18",49741504,49756355,14851
"10593","ENSBTAG00000017335","6",115437171,115444800,7629
"10594","ENSBTAG00000017338","8",59176689,59182194,5505
"10595","ENSBTAG00000017339","14",72301543,72458757,157214
"10596","ENSBTAG00000017346","13",47134626,47157586,22960
"10597","ENSBTAG00000017348","6",94954620,94979098,24478
"10598","ENSBTAG00000017349","7",52469410,52598877,129467
"10599","ENSBTAG00000017350","4",37450375,37838804,388429
"10600","ENSBTAG00000017352","16",1596039,1623678,27639
"10601","ENSBTAG00000017354","13",36304106,36527690,223584
"10602","ENSBTAG00000017355","18",53024536,53039604,15068
"10603","ENSBTAG00000017357","3",57499492,57530509,31017
"10604","ENSBTAG00000017360","7",52716398,52730098,13700
"10605","ENSBTAG00000017362","7",587310,668317,81007
"10606","ENSBTAG00000017363","X",119431920,119435063,3143
"10607","ENSBTAG00000017365","22",14799996,14813665,13669
"10608","ENSBTAG00000017366","19",40104363,40113096,8733
"10609","ENSBTAG00000017367","26",11081800,11091761,9961
"10610","ENSBTAG00000017368","3",103521364,103539465,18101
"10611","ENSBTAG00000017369","8",46233994,46396740,162746
"10612","ENSBTAG00000017370","9",75966230,76132574,166344
"10613","ENSBTAG00000017371","7",52730710,52734386,3676
"10614","ENSBTAG00000017373","10",46905306,46923194,17888
"10615","ENSBTAG00000017375","6",13332381,13375661,43280
"10616","ENSBTAG00000017376","2",39027224,39069644,42420
"10617","ENSBTAG00000017378","5",105403376,105441458,38082
"10618","ENSBTAG00000017379","17",62502050,62556500,54450
"10619","ENSBTAG00000017380","19",20436390,20467849,31459
"10620","ENSBTAG00000017381","3",103498708,103503986,5278
"10621","ENSBTAG00000017382","3",103472227,103491724,19497
"10622","ENSBTAG00000017386","3",103464627,103471995,7368
"10623","ENSBTAG00000017387","3",103401320,103454750,53430
"10624","ENSBTAG00000017388","3",103432470,103438943,6473
"10625","ENSBTAG00000017389","17",62557757,62561808,4051
"10626","ENSBTAG00000017390","6",44589540,44618157,28617
"10627","ENSBTAG00000017391","25",20473436,20590833,117397
"10628","ENSBTAG00000017393","9",68181813,68285685,103872
"10629","ENSBTAG00000017395","5",29736126,29766044,29918
"10630","ENSBTAG00000017397","18",17963193,18309039,345846
"10631","ENSBTAG00000017401","5",49272465,49315761,43296
"10632","ENSBTAG00000017402","13",54954218,54970753,16535
"10633","ENSBTAG00000017404","17",69398667,69421341,22674
"10634","ENSBTAG00000017405","3",18953213,18980402,27189
"10635","ENSBTAG00000017407","1",143641658,143729051,87393
"10636","ENSBTAG00000017409","19",36662421,36667620,5199
"10637","ENSBTAG00000017411","3",67098542,67357363,258821
"10638","ENSBTAG00000017412","24",7020091,7021668,1577
"10639","ENSBTAG00000017416","1",106924853,107002190,77337
"10640","ENSBTAG00000017418","1",143729215,143755086,25871
"10641","ENSBTAG00000017419","3",66975443,67094023,118580
"10642","ENSBTAG00000017420","27",35579543,35955896,376353
"10643","ENSBTAG00000017421","11",26701406,26735016,33610
"10644","ENSBTAG00000017422","25",26272135,26289860,17725
"10645","ENSBTAG00000017423","11",72593792,72602182,8390
"10646","ENSBTAG00000017424","13",57923612,57971092,47480
"10647","ENSBTAG00000017425","12",36079693,36081883,2190
"10648","ENSBTAG00000017426","22",8019066,8087552,68486
"10649","ENSBTAG00000017427","4",99532570,99546135,13565
"10650","ENSBTAG00000017429","11",26734669,26771592,36923
"10651","ENSBTAG00000017430","X",36891613,36895219,3606
"10652","ENSBTAG00000017431","2",118714413,118715459,1046
"10653","ENSBTAG00000017434","3",113431715,113489004,57289
"10654","ENSBTAG00000017435","25",28204182,28215217,11035
"10655","ENSBTAG00000017436","2",90045394,90168893,123499
"10656","ENSBTAG00000017437","2",90171834,90195668,23834
"10657","ENSBTAG00000017438","17",69624116,69628755,4639
"10658","ENSBTAG00000017439","5",110930789,110943940,13151
"10659","ENSBTAG00000017440","19",23381477,23453261,71784
"10660","ENSBTAG00000017441","19",43026103,43028384,2281
"10661","ENSBTAG00000017442","10",4660062,4671522,11460
"10662","ENSBTAG00000017446","29",25699093,25717254,18161
"10663","ENSBTAG00000017448","11",38484912,38554752,69840
"10664","ENSBTAG00000017450","1",83449266,83481681,32415
"10665","ENSBTAG00000017451","7",38116057,38126424,10367
"10666","ENSBTAG00000017452","2",128388785,128422500,33715
"10667","ENSBTAG00000017455","27",34152270,34242502,90232
"10668","ENSBTAG00000017456","25",36066208,36074176,7968
"10669","ENSBTAG00000017457","20",3852216,3975388,123172
"10670","ENSBTAG00000017458","4",10781954,10893236,111282
"10671","ENSBTAG00000017459","17",69618399,69623966,5567
"10672","ENSBTAG00000017460","11",38004972,38007987,3015
"10673","ENSBTAG00000017461","19",50634317,50642204,7887
"10674","ENSBTAG00000017462","5",110946624,110948715,2091
"10675","ENSBTAG00000017463","5",110951323,110954950,3627
"10676","ENSBTAG00000017465","5",49053812,49103597,49785
"10677","ENSBTAG00000017466","10",20147117,20188832,41715
"10678","ENSBTAG00000017468","15",35156660,35179353,22693
"10679","ENSBTAG00000017469","11",38012490,38128602,116112
"10680","ENSBTAG00000017471","10",12018684,12020060,1376
"10681","ENSBTAG00000017473","11",101225317,101291690,66373
"10682","ENSBTAG00000017475","13",57465706,57472529,6823
"10683","ENSBTAG00000017478","14",10798273,10815142,16869
"10684","ENSBTAG00000017480","6",117653872,117685792,31920
"10685","ENSBTAG00000017481","7",34220576,34220978,402
"10686","ENSBTAG00000017482","7",4737566,4740763,3197
"10687","ENSBTAG00000017486","1",144937738,145050738,113000
"10688","ENSBTAG00000017488","6",57942697,57975237,32540
"10689","ENSBTAG00000017489","10",92282330,92431067,148737
"10690","ENSBTAG00000017490","1",95742044,95963408,221364
"10691","ENSBTAG00000017492","14",21013842,21062048,48206
"10692","ENSBTAG00000017493","17",28946726,29148288,201562
"10693","ENSBTAG00000017496","6",117650404,117652345,1941
"10694","ENSBTAG00000017500","11",29914745,29963621,48876
"10695","ENSBTAG00000017502","3",103775476,103807656,32180
"10696","ENSBTAG00000017504","5",29983972,30018827,34855
"10697","ENSBTAG00000017505","4",116913457,116954800,41343
"10698","ENSBTAG00000017507","10",7361671,7574347,212676
"10699","ENSBTAG00000017508","12",18429085,18453189,24104
"10700","ENSBTAG00000017509","28",24593260,24679611,86351
"10701","ENSBTAG00000017512","19",45883594,46004542,120948
"10702","ENSBTAG00000017514","29",46888863,46898541,9678
"10703","ENSBTAG00000017517","24",2336527,2399019,62492
"10704","ENSBTAG00000017521","28",24692164,24692622,458
"10705","ENSBTAG00000017524","13",83249954,83257947,7993
"10706","ENSBTAG00000017525","10",4680316,4702801,22485
"10707","ENSBTAG00000017527","9",43382779,43621183,238404
"10708","ENSBTAG00000017528","18",13911498,13919763,8265
"10709","ENSBTAG00000017529","14",25956319,26038333,82014
"10710","ENSBTAG00000017530","8",39279965,39316564,36599
"10711","ENSBTAG00000017531","1",80560914,80576233,15319
"10712","ENSBTAG00000017533","23",6591481,6728066,136585
"10713","ENSBTAG00000017536","19",43688049,43714818,26769
"10714","ENSBTAG00000017537","13",77588007,77640794,52787
"10715","ENSBTAG00000017540","28",14884139,15019591,135452
"10716","ENSBTAG00000017541","4",61789173,61832723,43550
"10717","ENSBTAG00000017542","23",9304237,9389925,85688
"10718","ENSBTAG00000017543","5",55516050,55539039,22989
"10719","ENSBTAG00000017545","20",8600241,8673697,73456
"10720","ENSBTAG00000017547","22",376628,389614,12986
"10721","ENSBTAG00000017549","5",18250809,18353485,102676
"10722","ENSBTAG00000017550","7",30130216,30246199,115983
"10723","ENSBTAG00000017551","20",41999320,42122009,122689
"10724","ENSBTAG00000017554","9",43328996,43454082,125086
"10725","ENSBTAG00000017557","9",43290550,43329328,38778
"10726","ENSBTAG00000017560","18",43804639,43811979,7340
"10727","ENSBTAG00000017561","16",26010406,26038411,28005
"10728","ENSBTAG00000017564","3",19252157,19277508,25351
"10729","ENSBTAG00000017565","21",41268558,41381665,113107
"10730","ENSBTAG00000017566","3",19199747,19250840,51093
"10731","ENSBTAG00000017567","19",13441162,13726679,285517
"10732","ENSBTAG00000017569","20",41983392,41999154,15762
"10733","ENSBTAG00000017570","27",26414300,26414713,413
"10734","ENSBTAG00000017571","5",90600602,90862839,262237
"10735","ENSBTAG00000017573","12",54427080,54506499,79419
"10736","ENSBTAG00000017574","3",14642915,14670926,28011
"10737","ENSBTAG00000017576","11",95484186,95503624,19438
"10738","ENSBTAG00000017580","3",19463618,19470141,6523
"10739","ENSBTAG00000017582","29",29033507,29051869,18362
"10740","ENSBTAG00000017584","13",69791010,69824050,33040
"10741","ENSBTAG00000017592","6",98289617,98360326,70709
"10742","ENSBTAG00000017593","23",15140484,15155609,15125
"10743","ENSBTAG00000017594","13",69832957,69940039,107082
"10744","ENSBTAG00000017595","3",56965464,57144590,179126
"10745","ENSBTAG00000017597","24",34640036,34669610,29574
"10746","ENSBTAG00000017599","7",93052029,93062127,10098
"10747","ENSBTAG00000017602","29",36039644,36067845,28201
"10748","ENSBTAG00000017604","3",16453323,16457405,4082
"10749","ENSBTAG00000017605","2",120653448,120677193,23745
"10750","ENSBTAG00000017610","29",36070018,36099972,29954
"10751","ENSBTAG00000017611","28",39271703,39426453,154750
"10752","ENSBTAG00000017613","18",64698070,64705250,7180
"10753","ENSBTAG00000017615","3",117013542,117014310,768
"10754","ENSBTAG00000017616","21",69197942,69214268,16326
"10755","ENSBTAG00000017617","23",10250135,10269825,19690
"10756","ENSBTAG00000017618","18",49596994,49612307,15313
"10757","ENSBTAG00000017622","21",69221995,69226412,4417
"10758","ENSBTAG00000017624","3",117020666,117043357,22691
"10759","ENSBTAG00000017626","11",67708302,67766635,58333
"10760","ENSBTAG00000017627","8",74339655,74364212,24557
"10761","ENSBTAG00000017628","X",123141603,123181609,40006
"10762","ENSBTAG00000017629","2",58321111,58324717,3606
"10763","ENSBTAG00000017631","25",1539101,1542233,3132
"10764","ENSBTAG00000017632","21",19591620,19601252,9632
"10765","ENSBTAG00000017633","X",123062600,123072703,10103
"10766","ENSBTAG00000017636","21",69230378,69247284,16906
"10767","ENSBTAG00000017639","X",122949194,123056196,107002
"10768","ENSBTAG00000017642","6",95815372,95844458,29086
"10769","ENSBTAG00000017644","2",131929743,131968598,38855
"10770","ENSBTAG00000017645","19",49986930,49989576,2646
"10771","ENSBTAG00000017648","7",46933223,46936586,3363
"10772","ENSBTAG00000017649","X",125730716,125748684,17968
"10773","ENSBTAG00000017651","18",58426078,58427914,1836
"10774","ENSBTAG00000017652","5",115588183,115607119,18936
"10775","ENSBTAG00000017655","3",43536420,43596800,60380
"10776","ENSBTAG00000017656","3",102126891,102311428,184537
"10777","ENSBTAG00000017659","1",135950798,136027624,76826
"10778","ENSBTAG00000017660","X",86325226,86325591,365
"10779","ENSBTAG00000017661","7",18305239,18398128,92889
"10780","ENSBTAG00000017662","25",19903413,19955828,52415
"10781","ENSBTAG00000017663","19",41926791,41929104,2313
"10782","ENSBTAG00000017664","4",38929386,39010999,81613
"10783","ENSBTAG00000017665","10",21088232,21100627,12395
"10784","ENSBTAG00000017666","1",83122147,83205242,83095
"10785","ENSBTAG00000017670","3",54901260,54983375,82115
"10786","ENSBTAG00000017672","18",57702748,57711801,9053
"10787","ENSBTAG00000017674","16",51229739,51235484,5745
"10788","ENSBTAG00000017676","4",107718449,108101163,382714
"10789","ENSBTAG00000017677","10",58646803,58684773,37970
"10790","ENSBTAG00000017678","18",48197225,48204522,7297
"10791","ENSBTAG00000017679","13",2564282,2782083,217801
"10792","ENSBTAG00000017680","4",113577087,113597490,20403
"10793","ENSBTAG00000017681","29",44382246,44389503,7257
"10794","ENSBTAG00000017682","6",19898416,19995309,96893
"10795","ENSBTAG00000017683","10",58629048,58642428,13380
"10796","ENSBTAG00000017684","2",119287463,119291748,4285
"10797","ENSBTAG00000017685","19",41961520,41987894,26374
"10798","ENSBTAG00000017689","29",44389732,44396778,7046
"10799","ENSBTAG00000017690","29",45310479,45318348,7869
"10800","ENSBTAG00000017691","16",56399984,56400286,302
"10801","ENSBTAG00000017694","14",48629593,48904459,274866
"10802","ENSBTAG00000017695","2",85236757,85328185,91428
"10803","ENSBTAG00000017697","25",26971595,26976313,4718
"10804","ENSBTAG00000017698","24",30636287,30657276,20989
"10805","ENSBTAG00000017701","25",41748481,41752614,4133
"10806","ENSBTAG00000017704","6",36475377,36603209,127832
"10807","ENSBTAG00000017706","7",20936284,20945759,9475
"10808","ENSBTAG00000017709","26",35537128,36348728,811600
"10809","ENSBTAG00000017710","26",25629515,25638721,9206
"10810","ENSBTAG00000017711","21",23081878,23085386,3508
"10811","ENSBTAG00000017713","10",68006356,68118826,112470
"10812","ENSBTAG00000017714","16",4913856,4925086,11230
"10813","ENSBTAG00000017715","21",23113622,23204335,90713
"10814","ENSBTAG00000017716","21",65422668,65451985,29317
"10815","ENSBTAG00000017717","14",77668311,77921529,253218
"10816","ENSBTAG00000017718","18",25365218,25373329,8111
"10817","ENSBTAG00000017719","21",42714751,43212928,498177
"10818","ENSBTAG00000017721","16",39186035,39202452,16417
"10819","ENSBTAG00000017722","16",37159073,37238306,79233
"10820","ENSBTAG00000017727","16",37552133,37694428,142295
"10821","ENSBTAG00000017729","5",24721336,24760106,38770
"10822","ENSBTAG00000017731","14",7126583,7265632,139049
"10823","ENSBTAG00000017733","14",76994568,77012297,17729
"10824","ENSBTAG00000017734","8",53287860,53450193,162333
"10825","ENSBTAG00000017738","17",68507315,68547592,40277
"10826","ENSBTAG00000017739","19",27065301,27073018,7717
"10827","ENSBTAG00000017740","13",43204874,43215099,10225
"10828","ENSBTAG00000017741","8",23375118,23404576,29458
"10829","ENSBTAG00000017743","2",28990245,29067371,77126
"10830","ENSBTAG00000017744","7",37916685,37985670,68985
"10831","ENSBTAG00000017745","20",23191785,23250938,59153
"10832","ENSBTAG00000017746","20",447373,1163533,716160
"10833","ENSBTAG00000017747","19",27073600,27078136,4536
"10834","ENSBTAG00000017748","7",37999787,38005337,5550
"10835","ENSBTAG00000017750","17",68547858,68553021,5163
"10836","ENSBTAG00000017751","19",61994229,62034913,40684
"10837","ENSBTAG00000017752","18",7325125,7343264,18139
"10838","ENSBTAG00000017753","1",10231296,10543984,312688
"10839","ENSBTAG00000017755","17",68553407,68579067,25660
"10840","ENSBTAG00000017759","25",14556755,14613275,56520
"10841","ENSBTAG00000017761","X",90821253,90855974,34721
"10842","ENSBTAG00000017762","18",53762489,53763073,584
"10843","ENSBTAG00000017764","3",118225398,118462734,237336
"10844","ENSBTAG00000017765","3",33667202,33720169,52967
"10845","ENSBTAG00000017767","X",90534290,90555981,21691
"10846","ENSBTAG00000017769","X",90855707,90870094,14387
"10847","ENSBTAG00000017770","4",102906443,102950309,43866
"10848","ENSBTAG00000017771","19",34117303,34168722,51419
"10849","ENSBTAG00000017775","16",33638871,33884332,245461
"10850","ENSBTAG00000017776","21",14083602,14119932,36330
"10851","ENSBTAG00000017778","3",11365444,11368548,3104
"10852","ENSBTAG00000017779","X",90870392,90872909,2517
"10853","ENSBTAG00000017780","26",51837673,51853798,16125
"10854","ENSBTAG00000017781","5",30042064,30047717,5653
"10855","ENSBTAG00000017783","X",90559580,90566629,7049
"10856","ENSBTAG00000017785","X",130878346,131175360,297014
"10857","ENSBTAG00000017786","3",9870119,9891157,21038
"10858","ENSBTAG00000017788","16",33368079,33633753,265674
"10859","ENSBTAG00000017790","19",34106728,34115094,8366
"10860","ENSBTAG00000017793","4",102962181,102978225,16044
"10861","ENSBTAG00000017794","15",29776016,29780250,4234
"10862","ENSBTAG00000017797","2",36454504,36545934,91430
"10863","ENSBTAG00000017798","10",81172307,81184975,12668
"10864","ENSBTAG00000017799","17",67268876,67330126,61250
"10865","ENSBTAG00000017800","8",43580997,43593395,12398
"10866","ENSBTAG00000017801","X",102917633,102935964,18331
"10867","ENSBTAG00000017802","27",41461703,41896044,434341
"10868","ENSBTAG00000017803","8",110594952,110614532,19580
"10869","ENSBTAG00000017804","26",51221616,51226873,5257
"10870","ENSBTAG00000017805","29",50542708,50547511,4803
"10871","ENSBTAG00000017808","6",11555988,11639287,83299
"10872","ENSBTAG00000017809","6",58887610,59020226,132616
"10873","ENSBTAG00000017810","23",24842515,24883070,40555
"10874","ENSBTAG00000017811","10",81185447,81228802,43355
"10875","ENSBTAG00000017812","22",52793611,52815816,22205
"10876","ENSBTAG00000017814","18",45851472,45860240,8768
"10877","ENSBTAG00000017815","19",28658444,28866846,208402
"10878","ENSBTAG00000017816","18",45864083,45868525,4442
"10879","ENSBTAG00000017818","23",28941968,28953585,11617
"10880","ENSBTAG00000017819","3",15659639,15669862,10223
"10881","ENSBTAG00000017823","19",28867611,28893076,25465
"10882","ENSBTAG00000017824","18",11841332,11863438,22106
"10883","ENSBTAG00000017825","22",54326140,54361315,35175
"10884","ENSBTAG00000017826","3",117410453,117441217,30764
"10885","ENSBTAG00000017827","3",17840283,17841593,1310
"10886","ENSBTAG00000017829","6",102563753,102603522,39769
"10887","ENSBTAG00000017830","5",56836859,56890516,53657
"10888","ENSBTAG00000017831","27",33016693,33033829,17136
"10889","ENSBTAG00000017832","X",118815749,118898708,82959
"10890","ENSBTAG00000017833","14",64047857,64103385,55528
"10891","ENSBTAG00000017834","16",1238615,1252736,14121
"10892","ENSBTAG00000017835","7",26915949,26922450,6501
"10893","ENSBTAG00000017836","23",28938566,28943319,4753
"10894","ENSBTAG00000017837","6",65611356,66064698,453342
"10895","ENSBTAG00000017839","1",4192104,4358253,166149
"10896","ENSBTAG00000017840","5",56796775,56831748,34973
"10897","ENSBTAG00000017843","X",20254862,20266772,11910
"10898","ENSBTAG00000017844","3",98940131,98990375,50244
"10899","ENSBTAG00000017845","8",75021403,75032653,11250
"10900","ENSBTAG00000017846","3",8464412,8488977,24565
"10901","ENSBTAG00000017847","18",62291434,62309936,18502
"10902","ENSBTAG00000017850","X",20279959,20395643,115684
"10903","ENSBTAG00000017851","11",105021683,105114871,93188
"10904","ENSBTAG00000017852","3",3220577,3249677,29100
"10905","ENSBTAG00000017855","2",118666034,118680136,14102
"10906","ENSBTAG00000017856","3",8442910,8444112,1202
"10907","ENSBTAG00000017860","4",103050523,103242618,192095
"10908","ENSBTAG00000017863","28",25474775,25490574,15799
"10909","ENSBTAG00000017864","5",30519199,30522802,3603
"10910","ENSBTAG00000017866","4",40380301,40443336,63035
"10911","ENSBTAG00000017867","17",72078583,72082958,4375
"10912","ENSBTAG00000017868","19",10531071,10582764,51693
"10913","ENSBTAG00000017869","4",51865755,51901396,35641
"10914","ENSBTAG00000017871","25",40553061,40625048,71987
"10915","ENSBTAG00000017872","18",64520900,64525539,4639
"10916","ENSBTAG00000017873","3",8436890,8442549,5659
"10917","ENSBTAG00000017875","3",8420191,8435163,14972
"10918","ENSBTAG00000017877","3",8403138,8419412,16274
"10919","ENSBTAG00000017879","9",62541669,62569565,27896
"10920","ENSBTAG00000017882","1",144424403,144426734,2331
"10921","ENSBTAG00000017883","16",54111470,54145850,34380
"10922","ENSBTAG00000017884","8",41747613,41761077,13464
"10923","ENSBTAG00000017885","20",62998087,63063121,65034
"10924","ENSBTAG00000017886","17",68853776,68863080,9304
"10925","ENSBTAG00000017889","20",62979746,62993754,14008
"10926","ENSBTAG00000017890","17",68864267,68887043,22776
"10927","ENSBTAG00000017894","11",72393099,72414662,21563
"10928","ENSBTAG00000017895","19",26833438,26837327,3889
"10929","ENSBTAG00000017901","15",21856519,21880303,23784
"10930","ENSBTAG00000017905","4",98822560,98849268,26708
"10931","ENSBTAG00000017907","12",15582729,15643509,60780
"10932","ENSBTAG00000017911","26",42935679,42944120,8441
"10933","ENSBTAG00000017912","7",13451869,13452804,935
"10934","ENSBTAG00000017913","26",42947094,42959878,12784
"10935","ENSBTAG00000017919","4",99183547,99335717,152170
"10936","ENSBTAG00000017921","6",116624401,116640129,15728
"10937","ENSBTAG00000017922","11",99546701,99556056,9355
"10938","ENSBTAG00000017925","5",119807553,119812020,4467
"10939","ENSBTAG00000017927","X",129877980,129921489,43509
"10940","ENSBTAG00000017929","16",50032369,50033784,1415
"10941","ENSBTAG00000017932","15",29580727,29588723,7996
"10942","ENSBTAG00000017936","8",98701322,98726191,24869
"10943","ENSBTAG00000017938","13",43419524,43424890,5366
"10944","ENSBTAG00000017939","25",33827894,33844327,16433
"10945","ENSBTAG00000017941","25",33820199,33825833,5634
"10946","ENSBTAG00000017942","3",16477455,16487230,9775
"10947","ENSBTAG00000017943","5",28415108,28453480,38372
"10948","ENSBTAG00000017945","X",129855113,129866210,11097
"10949","ENSBTAG00000017946","28",41590579,41593267,2688
"10950","ENSBTAG00000017948","X",96824628,96825377,749
"10951","ENSBTAG00000017950","5",28307834,28382599,74765
"10952","ENSBTAG00000017951","29",45251140,45255878,4738
"10953","ENSBTAG00000017955","11",2042277,2138470,96193
"10954","ENSBTAG00000017956","18",44204421,44219971,15550
"10955","ENSBTAG00000017957","7",50670564,50675970,5406
"10956","ENSBTAG00000017958","9",73330850,73549768,218918
"10957","ENSBTAG00000017964","15",51722733,51729483,6750
"10958","ENSBTAG00000017967","5",56760933,56782192,21259
"10959","ENSBTAG00000017969","19",12803073,12811847,8774
"10960","ENSBTAG00000017970","4",106775572,106788374,12802
"10961","ENSBTAG00000017971","23",14301055,14502729,201674
"10962","ENSBTAG00000017976","11",100988747,101131037,142290
"10963","ENSBTAG00000017980","11",101136448,101136852,404
"10964","ENSBTAG00000017981","27",33208456,33211176,2720
"10965","ENSBTAG00000017982","11",101147884,101179089,31205
"10966","ENSBTAG00000017983","24",42853715,42868611,14896
"10967","ENSBTAG00000017986","3",92479529,92739937,260408
"10968","ENSBTAG00000017992","9",40759545,40770266,10721
"10969","ENSBTAG00000017994","10",77203357,77226739,23382
"10970","ENSBTAG00000017996","18",50048803,50056733,7930
"10971","ENSBTAG00000017999","25",22384180,22480691,96511
"10972","ENSBTAG00000018000","25",26043254,26056357,13103
"10973","ENSBTAG00000018002","5",55880132,55885193,5061
"10974","ENSBTAG00000018003","5",55872512,55879740,7228
"10975","ENSBTAG00000018004","21",24498758,24614322,115564
"10976","ENSBTAG00000018007","21",10562379,10575195,12816
"10977","ENSBTAG00000018009","1",110575012,110642235,67223
"10978","ENSBTAG00000018010","3",49386861,49530772,143911
"10979","ENSBTAG00000018013","18",55038414,55042752,4338
"10980","ENSBTAG00000018015","25",26061018,26066562,5544
"10981","ENSBTAG00000018016","25",26082047,26083376,1329
"10982","ENSBTAG00000018019","21",64193536,64290496,96960
"10983","ENSBTAG00000018020","22",50152601,50157613,5012
"10984","ENSBTAG00000018022","29",42166732,42178313,11581
"10985","ENSBTAG00000018024","27",41987493,42013751,26258
"10986","ENSBTAG00000018025","1",70180444,70226096,45652
"10987","ENSBTAG00000018026","22",717681,801535,83854
"10988","ENSBTAG00000018028","16",51299216,51327827,28611
"10989","ENSBTAG00000018031","22",59838836,59887372,48536
"10990","ENSBTAG00000018033","13",23622885,23808450,185565
"10991","ENSBTAG00000018035","8",64107418,64179245,71827
"10992","ENSBTAG00000018036","27",19986516,20001556,15040
"10993","ENSBTAG00000018037","18",35388066,35413319,25253
"10994","ENSBTAG00000018039","10",94271319,94274745,3426
"10995","ENSBTAG00000018040","18",35417757,35421332,3575
"10996","ENSBTAG00000018041","26",42805983,42855916,49933
"10997","ENSBTAG00000018043","18",35421770,35425011,3241
"10998","ENSBTAG00000018044","25",19969392,20002099,32707
"10999","ENSBTAG00000018045","18",35425222,35447046,21824
"11000","ENSBTAG00000018046","11",60724002,60756539,32537
"11001","ENSBTAG00000018048","17",72431576,72476026,44450
"11002","ENSBTAG00000018049","7",21489873,21501464,11591
"11003","ENSBTAG00000018050","25",20007240,20035715,28475
"11004","ENSBTAG00000018052","7",18936414,19046578,110164
"11005","ENSBTAG00000018053","13",57991890,58045639,53749
"11006","ENSBTAG00000018054","11",47917375,47923252,5877
"11007","ENSBTAG00000018057","22",13325988,13336394,10406
"11008","ENSBTAG00000018059","1",64301489,64323696,22207
"11009","ENSBTAG00000018060","X",86707139,86714145,7006
"11010","ENSBTAG00000018061","2",20906685,21011464,104779
"11011","ENSBTAG00000018062","2",120883700,120910058,26358
"11012","ENSBTAG00000018063","13",77982558,77993066,10508
"11013","ENSBTAG00000018064","4",72036169,72059949,23780
"11014","ENSBTAG00000018065","2",120849154,120881261,32107
"11015","ENSBTAG00000018067","2",120815271,120849384,34113
"11016","ENSBTAG00000018069","8",103968196,103988784,20588
"11017","ENSBTAG00000018070","3",19642451,19644982,2531
"11018","ENSBTAG00000018071","3",19637443,19641926,4483
"11019","ENSBTAG00000018072","23",49111504,49398418,286914
"11020","ENSBTAG00000018073","5",113927819,113940490,12671
"11021","ENSBTAG00000018074","3",19623986,19636738,12752
"11022","ENSBTAG00000018077","18",51674245,51678673,4428
"11023","ENSBTAG00000018080","18",44966713,44967105,392
"11024","ENSBTAG00000018082","25",26490747,26506201,15454
"11025","ENSBTAG00000018084","17",69300856,69305373,4517
"11026","ENSBTAG00000018085","5",25615176,25629603,14427
"11027","ENSBTAG00000018086","17",69307660,69336481,28821
"11028","ENSBTAG00000018088","24",44277567,44682659,405092
"11029","ENSBTAG00000018090","X",18974810,18980914,6104
"11030","ENSBTAG00000018093","15",29140936,29188682,47746
"11031","ENSBTAG00000018094","25",26756299,26760550,4251
"11032","ENSBTAG00000018097","25",13363002,13542457,179455
"11033","ENSBTAG00000018098","X",24731471,24732827,1356
"11034","ENSBTAG00000018101","13",63686723,63702437,15714
"11035","ENSBTAG00000018103","12",30327227,30333011,5784
"11036","ENSBTAG00000018105","22",11825773,11855763,29990
"11037","ENSBTAG00000018106","6",67916175,67961503,45328
"11038","ENSBTAG00000018108","17",62564685,62607750,43065
"11039","ENSBTAG00000018112","X",133337129,133490275,153146
"11040","ENSBTAG00000018114","2",48279649,48374634,94985
"11041","ENSBTAG00000018115","17",57080207,57084736,4529
"11042","ENSBTAG00000018116","17",69423142,69439445,16303
"11043","ENSBTAG00000018119","4",60544208,60732292,188084
"11044","ENSBTAG00000018123","21",56567085,56659651,92566
"11045","ENSBTAG00000018125","2",47212782,47368935,156153
"11046","ENSBTAG00000018126","19",22125877,22249140,123263
"11047","ENSBTAG00000018127","10",72467414,72511866,44452
"11048","ENSBTAG00000018130","2",97414229,97562142,147913
"11049","ENSBTAG00000018131","5",29107518,29171842,64324
"11050","ENSBTAG00000018133","4",36254736,36631147,376411
"11051","ENSBTAG00000018134","6",89379645,89391792,12147
"11052","ENSBTAG00000018137","5",100873612,100891039,17427
"11053","ENSBTAG00000018138","1",126736159,126814507,78348
"11054","ENSBTAG00000018142","16",71416165,71464237,48072
"11055","ENSBTAG00000018143","16",4833621,4845097,11476
"11056","ENSBTAG00000018146","18",5004868,5169828,164960
"11057","ENSBTAG00000018147","2",58351070,58477701,126631
"11058","ENSBTAG00000018151","6",98186192,98225864,39672
"11059","ENSBTAG00000018152","18",61573948,61579533,5585
"11060","ENSBTAG00000018153","11",72234487,72247034,12547
"11061","ENSBTAG00000018155","6",98226288,98231259,4971
"11062","ENSBTAG00000018156","11",72232726,72234923,2197
"11063","ENSBTAG00000018157","11",72210703,72219493,8790
"11064","ENSBTAG00000018158","4",106672135,106677453,5318
"11065","ENSBTAG00000018159","4",106677710,106696081,18371
"11066","ENSBTAG00000018160","24",39951775,40062824,111049
"11067","ENSBTAG00000018161","9",64661525,64689941,28416
"11068","ENSBTAG00000018164","11",72190119,72192915,2796
"11069","ENSBTAG00000018165","23",32786389,32996550,210161
"11070","ENSBTAG00000018167","23",6831277,6848149,16872
"11071","ENSBTAG00000018169","19",55840138,55872606,32468
"11072","ENSBTAG00000018172","19",50145952,50162298,16346
"11073","ENSBTAG00000018175","19",50124642,50146170,21528
"11074","ENSBTAG00000018176","19",50123077,50129117,6040
"11075","ENSBTAG00000018178","19",50101209,50118199,16990
"11076","ENSBTAG00000018179","12",10909872,10914329,4457
"11077","ENSBTAG00000018180","5",17797032,17820349,23317
"11078","ENSBTAG00000018181","18",53692708,53694240,1532
"11079","ENSBTAG00000018185","4",12750329,12843879,93550
"11080","ENSBTAG00000018186","1",143782380,143810301,27921
"11081","ENSBTAG00000018188","29",17978587,17987849,9262
"11082","ENSBTAG00000018189","1",143819489,143823793,4304
"11083","ENSBTAG00000018192","29",17944119,17972248,28129
"11084","ENSBTAG00000018196","11",70866369,70905461,39092
"11085","ENSBTAG00000018198","22",48676660,48680938,4278
"11086","ENSBTAG00000018199","2",121015835,121076671,60836
"11087","ENSBTAG00000018200","17",16050989,16143452,92463
"11088","ENSBTAG00000018201","29",39842588,39854652,12064
"11089","ENSBTAG00000018202","29",39856156,39867484,11328
"11090","ENSBTAG00000018203","3",26201587,26239599,38012
"11091","ENSBTAG00000018204","19",29483027,29507056,24029
"11092","ENSBTAG00000018205","5",100997211,101017135,19924
"11093","ENSBTAG00000018206","14",65960510,66051049,90539
"11094","ENSBTAG00000018207","5",100984954,100998031,13077
"11095","ENSBTAG00000018213","15",31648677,31715116,66439
"11096","ENSBTAG00000018214","12",33338091,33343671,5580
"11097","ENSBTAG00000018216","24",49963943,49995093,31150
"11098","ENSBTAG00000018218","14",4388017,4643810,255793
"11099","ENSBTAG00000018220","16",63544117,63602942,58825
"11100","ENSBTAG00000018223","16",968434,978542,10108
"11101","ENSBTAG00000018224","23",12914475,12946096,31621
"11102","ENSBTAG00000018225","18",47786571,48022839,236268
"11103","ENSBTAG00000018227","22",1752646,1876184,123538
"11104","ENSBTAG00000018229","7",12481482,12575856,94374
"11105","ENSBTAG00000018232","12",23258105,23284263,26158
"11106","ENSBTAG00000018234","20",46730846,46765482,34636
"11107","ENSBTAG00000018235","20",39789136,39827963,38827
"11108","ENSBTAG00000018236","2",71750119,71916145,166026
"11109","ENSBTAG00000018237","12",83879567,84298506,418939
"11110","ENSBTAG00000018238","22",59833785,59839048,5263
"11111","ENSBTAG00000018239","11",74272582,74310523,37941
"11112","ENSBTAG00000018240","18",50379572,50393561,13989
"11113","ENSBTAG00000018242","18",49515378,49516394,1016
"11114","ENSBTAG00000018244","18",1300877,1329800,28923
"11115","ENSBTAG00000018245","20",37571932,37652390,80458
"11116","ENSBTAG00000018246","15",17499425,17533128,33703
"11117","ENSBTAG00000018247","X",13582919,13634768,51849
"11118","ENSBTAG00000018248","22",59639050,59826846,187796
"11119","ENSBTAG00000018249","3",15725419,15891605,166186
"11120","ENSBTAG00000018250","25",16683549,16704431,20882
"11121","ENSBTAG00000018252","21",8734781,8749130,14349
"11122","ENSBTAG00000018253","2",22084295,22103950,19655
"11123","ENSBTAG00000018254","5",97104351,97109627,5276
"11124","ENSBTAG00000018255","10",80672883,80775228,102345
"11125","ENSBTAG00000018256","11",80851889,80925696,73807
"11126","ENSBTAG00000018257","15",65403011,65427122,24111
"11127","ENSBTAG00000018258","19",55043351,55047192,3841
"11128","ENSBTAG00000018260","19",55014709,55043048,28339
"11129","ENSBTAG00000018261","15",65427261,65502624,75363
"11130","ENSBTAG00000018262","11",72359159,72362283,3124
"11131","ENSBTAG00000018263","13",36067572,36144225,76653
"11132","ENSBTAG00000018267","11",72337029,72358244,21215
"11133","ENSBTAG00000018269","11",72324890,72334888,9998
"11134","ENSBTAG00000018270","13",79245983,79384839,138856
"11135","ENSBTAG00000018271","19",51437111,51478799,41688
"11136","ENSBTAG00000018272","16",44771878,45028328,256450
"11137","ENSBTAG00000018274","29",47373220,47375755,2535
"11138","ENSBTAG00000018275","2",5082629,5083828,1199
"11139","ENSBTAG00000018277","10",67880963,67907898,26935
"11140","ENSBTAG00000018278","1",1643628,1651039,7411
"11141","ENSBTAG00000018279","10",65036801,65057305,20504
"11142","ENSBTAG00000018280","8",77514711,77587255,72544
"11143","ENSBTAG00000018281","3",93742043,93749741,7698
"11144","ENSBTAG00000018282","2",89532883,89547944,15061
"11145","ENSBTAG00000018283","22",11581703,11607351,25648
"11146","ENSBTAG00000018284","27",1429185,1431110,1925
"11147","ENSBTAG00000018285","11",49416059,49425368,9309
"11148","ENSBTAG00000018286","11",49411569,49413440,1871
"11149","ENSBTAG00000018287","7",47265962,47309568,43606
"11150","ENSBTAG00000018289","11",49406589,49411187,4598
"11151","ENSBTAG00000018290","7",47325570,47328407,2837
"11152","ENSBTAG00000018291","11",49397839,49403916,6077
"11153","ENSBTAG00000018292","X",128548602,128633196,84594
"11154","ENSBTAG00000018294","22",43096617,43117533,20916
"11155","ENSBTAG00000018295","13",38561341,38592220,30879
"11156","ENSBTAG00000018297","10",79408026,79463976,55950
"11157","ENSBTAG00000018299","10",79466248,79475522,9274
"11158","ENSBTAG00000018300","12",34421457,34509717,88260
"11159","ENSBTAG00000018303","16",57724441,58036056,311615
"11160","ENSBTAG00000018307","22",50161374,50190175,28801
"11161","ENSBTAG00000018309","23",49436878,49437774,896
"11162","ENSBTAG00000018310","21",64414349,64492753,78404
"11163","ENSBTAG00000018312","1",103333840,103334262,422
"11164","ENSBTAG00000018313","12",74410787,74571445,160658
"11165","ENSBTAG00000018314","19",26619637,26621469,1832
"11166","ENSBTAG00000018315","19",26621508,26669665,48157
"11167","ENSBTAG00000018316","19",26609543,26614671,5128
"11168","ENSBTAG00000018317","8",73542079,73620437,78358
"11169","ENSBTAG00000018318","8",59277670,59286526,8856
"11170","ENSBTAG00000018320","10",16343826,16345977,2151
"11171","ENSBTAG00000018321","26",25600415,25628907,28492
"11172","ENSBTAG00000018322","7",46170428,46243671,73243
"11173","ENSBTAG00000018324","3",109752058,109872871,120813
"11174","ENSBTAG00000018326","18",45866897,45877787,10890
"11175","ENSBTAG00000018329","22",54177316,54204380,27064
"11176","ENSBTAG00000018330","17",54377843,54406455,28612
"11177","ENSBTAG00000018331","22",54159393,54165625,6232
"11178","ENSBTAG00000018332","17",54408216,54453472,45256
"11179","ENSBTAG00000018334","13",61683029,61694301,11272
"11180","ENSBTAG00000018339","19",37618130,37621478,3348
"11181","ENSBTAG00000018340","8",16009426,16010079,653
"11182","ENSBTAG00000018342","7",20221723,20252247,30524
"11183","ENSBTAG00000018343","23",27703728,27706071,2343
"11184","ENSBTAG00000018345","19",25139357,25147638,8281
"11185","ENSBTAG00000018347","8",38472459,38546405,73946
"11186","ENSBTAG00000018348","4",48759142,48773761,14619
"11187","ENSBTAG00000018349","7",5054900,5058251,3351
"11188","ENSBTAG00000018352","14",57818275,57829120,10845
"11189","ENSBTAG00000018356","28",41778832,41786982,8150
"11190","ENSBTAG00000018358","5",56193684,56200300,6616
"11191","ENSBTAG00000018360","6",92579816,92650666,70850
"11192","ENSBTAG00000018361","5",56081334,56191524,110190
"11193","ENSBTAG00000018362","29",37252089,37260864,8775
"11194","ENSBTAG00000018363","4",9870503,9877234,6731
"11195","ENSBTAG00000018364","29",37261787,37275691,13904
"11196","ENSBTAG00000018365","26",50165123,50176103,10980
"11197","ENSBTAG00000018366","29",37275550,37290609,15059
"11198","ENSBTAG00000018367","29",37311028,37367705,56677
"11199","ENSBTAG00000018369","17",54706765,54714580,7815
"11200","ENSBTAG00000018372","11",2318512,2337596,19084
"11201","ENSBTAG00000018373","8",73756715,73874845,118130
"11202","ENSBTAG00000018374","2",125814828,125890887,76059
"11203","ENSBTAG00000018375","7",20081660,20119357,37697
"11204","ENSBTAG00000018379","6",117410501,117431835,21334
"11205","ENSBTAG00000018381","19",18107484,18149013,41529
"11206","ENSBTAG00000018382","X",121316662,121367485,50823
"11207","ENSBTAG00000018383","19",18061035,18096596,35561
"11208","ENSBTAG00000018385","2",125150751,125171158,20407
"11209","ENSBTAG00000018386","19",18051752,18059612,7860
"11210","ENSBTAG00000018387","8",111093358,111161253,67895
"11211","ENSBTAG00000018390","15",83633616,83673239,39623
"11212","ENSBTAG00000018394","18",8544509,8557047,12538
"11213","ENSBTAG00000018395","13",24880913,25411834,530921
"11214","ENSBTAG00000018397","1",53068463,53110905,42442
"11215","ENSBTAG00000018398","18",53188839,53190580,1741
"11216","ENSBTAG00000018399","1",53114698,53273181,158483
"11217","ENSBTAG00000018400","21",46014364,46058395,44031
"11218","ENSBTAG00000018401","11",66865277,66958571,93294
"11219","ENSBTAG00000018402","1",117672585,117718237,45652
"11220","ENSBTAG00000018403","5",55984863,55992412,7549
"11221","ENSBTAG00000018404","26",6899619,8313722,1414103
"11222","ENSBTAG00000018405","5",55960451,55988093,27642
"11223","ENSBTAG00000018406","26",7514213,7516578,2365
"11224","ENSBTAG00000018408","9",63862949,63947016,84067
"11225","ENSBTAG00000018410","12",19203457,19233012,29555
"11226","ENSBTAG00000018413","2",126212749,126220286,7537
"11227","ENSBTAG00000018415","2",106656154,106706020,49866
"11228","ENSBTAG00000018416","19",28254408,28267375,12967
"11229","ENSBTAG00000018417","13",59967956,60007443,39487
"11230","ENSBTAG00000018418","13",59953800,59954501,701
"11231","ENSBTAG00000018419","10",20837438,20853263,15825
"11232","ENSBTAG00000018420","19",48660926,48677027,16101
"11233","ENSBTAG00000018421","18",36825623,36970786,145163
"11234","ENSBTAG00000018422","10",20832541,20836686,4145
"11235","ENSBTAG00000018423","19",48678120,48691777,13657
"11236","ENSBTAG00000018424","3",116025262,116037482,12220
"11237","ENSBTAG00000018425","18",36981270,36989873,8603
"11238","ENSBTAG00000018426","11",93141363,93196372,55009
"11239","ENSBTAG00000018427","1",132216626,132292949,76323
"11240","ENSBTAG00000018430","4",43815426,43913447,98021
"11241","ENSBTAG00000018431","29",24801066,25225008,423942
"11242","ENSBTAG00000018432","5",14499023,14556463,57440
"11243","ENSBTAG00000018433","22",43531245,43577589,46344
"11244","ENSBTAG00000018436","9",60811836,60836538,24702
"11245","ENSBTAG00000018437","8",46411542,46530522,118980
"11246","ENSBTAG00000018438","9",60762595,60800465,37870
"11247","ENSBTAG00000018440","4",105049335,105050225,890
"11248","ENSBTAG00000018445","8",91311799,91512676,200877
"11249","ENSBTAG00000018446","2",34070353,34087612,17259
"11250","ENSBTAG00000018447","3",69057556,69065985,8429
"11251","ENSBTAG00000018448","3",68962719,69055498,92779
"11252","ENSBTAG00000018449","15",51643265,51673852,30587
"11253","ENSBTAG00000018451","5",103674096,103679056,4960
"11254","ENSBTAG00000018452","20",8070928,8081268,10340
"11255","ENSBTAG00000018453","27",15651437,15654048,2611
"11256","ENSBTAG00000018454","27",15654102,15674141,20039
"11257","ENSBTAG00000018455","14",347689,349724,2035
"11258","ENSBTAG00000018456","14",332701,339111,6410
"11259","ENSBTAG00000018460","20",67808025,68003907,195882
"11260","ENSBTAG00000018463","13",31653816,31661745,7929
"11261","ENSBTAG00000018464","9",94011802,94302733,290931
"11262","ENSBTAG00000018465","1",111111924,111559606,447682
"11263","ENSBTAG00000018467","10",85384726,85426894,42168
"11264","ENSBTAG00000018469","10",85428884,85447592,18708
"11265","ENSBTAG00000018471","1",111095638,111107466,11828
"11266","ENSBTAG00000018473","2",70736152,70769645,33493
"11267","ENSBTAG00000018474","3",16119373,16173990,54617
"11268","ENSBTAG00000018478","23",16512932,16519583,6651
"11269","ENSBTAG00000018479","15",77368219,77373977,5758
"11270","ENSBTAG00000018481","8",102202002,102207049,5047
"11271","ENSBTAG00000018482","15",77374325,77379012,4687
"11272","ENSBTAG00000018483","15",77379153,77383888,4735
"11273","ENSBTAG00000018487","3",9783460,9813631,30171
"11274","ENSBTAG00000018488","6",101852659,102045732,193073
"11275","ENSBTAG00000018489","1",105877308,105908063,30755
"11276","ENSBTAG00000018493","14",66134855,66162958,28103
"11277","ENSBTAG00000018495","27",36556634,36561575,4941
"11278","ENSBTAG00000018496","X",87009815,87013605,3790
"11279","ENSBTAG00000018497","2",80481033,80494572,13539
"11280","ENSBTAG00000018498","X",87013746,87019562,5816
"11281","ENSBTAG00000018499","28",41953894,41970260,16366
"11282","ENSBTAG00000018501","20",67652634,67715253,62619
"11283","ENSBTAG00000018502","2",118967305,119146003,178698
"11284","ENSBTAG00000018508","1",136031260,136310998,279738
"11285","ENSBTAG00000018509","16",1917347,1934237,16890
"11286","ENSBTAG00000018513","NKLS02002208.1",8690275,8755071,64796
"11287","ENSBTAG00000018517","8",41826623,41860757,34134
"11288","ENSBTAG00000018518","19",14632048,14641729,9681
"11289","ENSBTAG00000018519","19",14621338,14628732,7394
"11290","ENSBTAG00000018520","2",30224956,30320883,95927
"11291","ENSBTAG00000018522","7",21283208,21286244,3036
"11292","ENSBTAG00000018523","23",31932362,31947272,14910
"11293","ENSBTAG00000018524","5",26591483,26597710,6227
"11294","ENSBTAG00000018527","21",24845099,24921366,76267
"11295","ENSBTAG00000018528","9",50266970,50337074,70104
"11296","ENSBTAG00000018530","5",109375096,109394480,19384
"11297","ENSBTAG00000018531","6",86033000,86042396,9396
"11298","ENSBTAG00000018534","17",72596998,72603599,6601
"11299","ENSBTAG00000018535","13",62821113,62883927,62814
"11300","ENSBTAG00000018538","1",130531395,130598375,66980
"11301","ENSBTAG00000018539","18",56877780,56886031,8251
"11302","ENSBTAG00000018540","29",6120515,6303004,182489
"11303","ENSBTAG00000018543","2",106422780,106446519,23739
"11304","ENSBTAG00000018545","18",56887329,56893786,6457
"11305","ENSBTAG00000018546","17",6801065,7555668,754603
"11306","ENSBTAG00000018548","16",71466476,71549865,83389
"11307","ENSBTAG00000018549","2",101338464,101409333,70869
"11308","ENSBTAG00000018554","11",44083506,44083940,434
"11309","ENSBTAG00000018556","5",71706750,71712324,5574
"11310","ENSBTAG00000018557","14",28141155,28204989,63834
"11311","ENSBTAG00000018559","25",18710240,18719578,9338
"11312","ENSBTAG00000018560","25",18722951,18915484,192533
"11313","ENSBTAG00000018562","25",18976399,18992785,16386
"11314","ENSBTAG00000018563","17",3834470,3843041,8571
"11315","ENSBTAG00000018564","26",18884647,18907970,23323
"11316","ENSBTAG00000018566","26",18914097,18919300,5203
"11317","ENSBTAG00000018569","X",5084763,5130143,45380
"11318","ENSBTAG00000018570","14",23428404,23441042,12638
"11319","ENSBTAG00000018571","11",7127282,7165290,38008
"11320","ENSBTAG00000018572","12",31991150,32060002,68852
"11321","ENSBTAG00000018575","5",1921649,2370563,448914
"11322","ENSBTAG00000018576","11",72682465,72771830,89365
"11323","ENSBTAG00000018577","12",30934105,30991889,57784
"11324","ENSBTAG00000018578","11",10089360,10107285,17925
"11325","ENSBTAG00000018579","11",10085663,10088615,2952
"11326","ENSBTAG00000018581","2",47420198,47547292,127094
"11327","ENSBTAG00000018585","7",72984740,73272177,287437
"11328","ENSBTAG00000018588","5",30112133,30128722,16589
"11329","ENSBTAG00000018589","25",33161500,33175530,14030
"11330","ENSBTAG00000018590","11",19304941,19423575,118634
"11331","ENSBTAG00000018593","18",46459392,46460717,1325
"11332","ENSBTAG00000018594","18",46461936,46466855,4919
"11333","ENSBTAG00000018596","10",100170718,100247414,76696
"11334","ENSBTAG00000018598","18",46466912,46469531,2619
"11335","ENSBTAG00000018599","18",46471347,46481526,10179
"11336","ENSBTAG00000018600","22",55581272,55735337,154065
"11337","ENSBTAG00000018601","22",14623349,14628234,4885
"11338","ENSBTAG00000018603","21",13980386,14030897,50511
"11339","ENSBTAG00000018604","26",21809188,21822827,13639
"11340","ENSBTAG00000018607","1",144441578,144619108,177530
"11341","ENSBTAG00000018613","8",83925220,83951207,25987
"11342","ENSBTAG00000018616","20",16842419,16995968,153549
"11343","ENSBTAG00000018622","22",48966805,48976850,10045
"11344","ENSBTAG00000018625","25",2737629,2744243,6614
"11345","ENSBTAG00000018628","22",48945144,48947321,2177
"11346","ENSBTAG00000018629","15",16086700,16224288,137588
"11347","ENSBTAG00000018631","12",35603044,35610878,7834
"11348","ENSBTAG00000018633","18",51273044,51276954,3910
"11349","ENSBTAG00000018635","18",51250015,51269147,19132
"11350","ENSBTAG00000018636","21",64507563,64523335,15772
"11351","ENSBTAG00000018637","21",21732653,21734519,1866
"11352","ENSBTAG00000018638","6",110630319,110751110,120791
"11353","ENSBTAG00000018639","21",21714620,21729672,15052
"11354","ENSBTAG00000018642","21",21704343,21713349,9006
"11355","ENSBTAG00000018643","21",21676334,21699409,23075
"11356","ENSBTAG00000018644","22",28178200,28387545,209345
"11357","ENSBTAG00000018645","4",14404123,14408479,4356
"11358","ENSBTAG00000018646","8",67302821,67329021,26200
"11359","ENSBTAG00000018647","17",71270478,71285172,14694
"11360","ENSBTAG00000018650","29",28381619,28398677,17058
"11361","ENSBTAG00000018652","18",51500305,51506901,6596
"11362","ENSBTAG00000018653","2",80266321,80275110,8789
"11363","ENSBTAG00000018655","7",19470114,19482055,11941
"11364","ENSBTAG00000018656","2",131855266,131891998,36732
"11365","ENSBTAG00000018657","1",74043235,74159562,116327
"11366","ENSBTAG00000018658","19",54051772,54124386,72614
"11367","ENSBTAG00000018660","5",119690576,119751794,61218
"11368","ENSBTAG00000018661","19",54025900,54048017,22117
"11369","ENSBTAG00000018663","19",56971845,57152217,180372
"11370","ENSBTAG00000018667","8",39548658,39743532,194874
"11371","ENSBTAG00000018669","11",71129758,71222960,93202
"11372","ENSBTAG00000018671","12",86663672,86681453,17781
"11373","ENSBTAG00000018673","7",2624069,2631337,7268
"11374","ENSBTAG00000018674","23",45417119,45428455,11336
"11375","ENSBTAG00000018680","11",72006059,72030110,24051
"11376","ENSBTAG00000018681","9",101151142,101160469,9327
"11377","ENSBTAG00000018682","1",148306238,148341194,34956
"11378","ENSBTAG00000018688","1",148440558,148450711,10153
"11379","ENSBTAG00000018689","19",15077781,15098380,20599
"11380","ENSBTAG00000018690","5",32579244,32627762,48518
"11381","ENSBTAG00000018691","28",697339,706882,9543
"11382","ENSBTAG00000018694","5",10671183,10846953,175770
"11383","ENSBTAG00000018697","X",2534675,2628017,93342
"11384","ENSBTAG00000018699","19",36811899,36846612,34713
"11385","ENSBTAG00000018703","1",76065896,76102113,36217
"11386","ENSBTAG00000018704","1",19417655,19437170,19515
"11387","ENSBTAG00000018705","11",74335471,74419717,84246
"11388","ENSBTAG00000018706","19",6232166,6360656,128490
"11389","ENSBTAG00000018707","28",41325428,41384200,58772
"11390","ENSBTAG00000018709","21",56298213,56416217,118004
"11391","ENSBTAG00000018710","11",102451053,102480455,29402
"11392","ENSBTAG00000018711","3",16489959,16502409,12450
"11393","ENSBTAG00000018713","27",35252827,35253824,997
"11394","ENSBTAG00000018715","4",80929262,80931409,2147
"11395","ENSBTAG00000018717","3",31539743,31550254,10511
"11396","ENSBTAG00000018722","16",51825824,51865648,39824
"11397","ENSBTAG00000018723","16",51819919,51824310,4391
"11398","ENSBTAG00000018724","16",51815209,51819141,3932
"11399","ENSBTAG00000018725","16",51777677,51805354,27677
"11400","ENSBTAG00000018726","3",105547552,105567515,19963
"11401","ENSBTAG00000018727","1",99361283,99445684,84401
"11402","ENSBTAG00000018729","16",51634020,51725074,91054
"11403","ENSBTAG00000018730","16",51625615,51631658,6043
"11404","ENSBTAG00000018731","1",45964099,45969615,5516
"11405","ENSBTAG00000018732","13",51444141,51461167,17026
"11406","ENSBTAG00000018735","13",51430650,51443752,13102
"11407","ENSBTAG00000018737","3",51122896,51166887,43991
"11408","ENSBTAG00000018739","3",50994444,51122558,128114
"11409","ENSBTAG00000018742","15",77409614,77429460,19846
"11410","ENSBTAG00000018743","5",17826548,17837426,10878
"11411","ENSBTAG00000018744","2",62784836,63181459,396623
"11412","ENSBTAG00000018745","5",17836747,17895641,58894
"11413","ENSBTAG00000018747","3",89477899,89549744,71845
"11414","ENSBTAG00000018749","1",138547391,138550417,3026
"11415","ENSBTAG00000018752","19",18156522,18196012,39490
"11416","ENSBTAG00000018753","2",62513122,62781938,268816
"11417","ENSBTAG00000018756","3",113406610,113407705,1095
"11418","ENSBTAG00000018761","11",72804692,72820755,16063
"11419","ENSBTAG00000018762","29",42842883,42850239,7356
"11420","ENSBTAG00000018765","1",67239728,67280749,41021
"11421","ENSBTAG00000018767","22",52927961,52930665,2704
"11422","ENSBTAG00000018768","1",139406045,139412414,6369
"11423","ENSBTAG00000018770","18",10436689,10448454,11765
"11424","ENSBTAG00000018771","18",10448568,10469494,20926
"11425","ENSBTAG00000018772","18",10469759,10479608,9849
"11426","ENSBTAG00000018773","5",30923412,30930391,6979
"11427","ENSBTAG00000018774","16",3064040,3083423,19383
"11428","ENSBTAG00000018775","13",61285805,61340092,54287
"11429","ENSBTAG00000018777","1",67666437,67823745,157308
"11430","ENSBTAG00000018778","8",48909585,48978400,68815
"11431","ENSBTAG00000018783","13",57390695,57401557,10862
"11432","ENSBTAG00000018784","13",57379569,57390707,11138
"11433","ENSBTAG00000018785","13",57363948,57370548,6600
"11434","ENSBTAG00000018787","23",45327198,45333290,6092
"11435","ENSBTAG00000018790","9",44880467,44930046,49579
"11436","ENSBTAG00000018792","29",42795815,42811743,15928
"11437","ENSBTAG00000018795","2",6460095,6592355,132260
"11438","ENSBTAG00000018796","10",20893324,20899745,6421
"11439","ENSBTAG00000018799","11",103788091,103818405,30314
"11440","ENSBTAG00000018800","X",78400215,78405064,4849
"11441","ENSBTAG00000018801","9",41870929,41918140,47211
"11442","ENSBTAG00000018802","19",37596244,37611744,15500
"11443","ENSBTAG00000018803","19",37587425,37596407,8982
"11444","ENSBTAG00000018804","3",34131464,34157519,26055
"11445","ENSBTAG00000018805","13",43031397,43046767,15370
"11446","ENSBTAG00000018806","3",34122368,34129175,6807
"11447","ENSBTAG00000018807","3",34107374,34122165,14791
"11448","ENSBTAG00000018808","19",27905299,27909233,3934
"11449","ENSBTAG00000018809","19",27903909,27905323,1414
"11450","ENSBTAG00000018810","9",103154193,103185492,31299
"11451","ENSBTAG00000018811","13",52539174,52640959,101785
"11452","ENSBTAG00000018812","13",52519428,52524691,5263
"11453","ENSBTAG00000018813","13",52514469,52519429,4960
"11454","ENSBTAG00000018819","X",8663162,9308893,645731
"11455","ENSBTAG00000018823","19",44149003,44156201,7198
"11456","ENSBTAG00000018824","16",26096935,26154932,57997
"11457","ENSBTAG00000018825","17",64125282,64176327,51045
"11458","ENSBTAG00000018828","5",103521298,103529979,8681
"11459","ENSBTAG00000018829","12",19398518,19429238,30720
"11460","ENSBTAG00000018831","17",64097586,64114659,17073
"11461","ENSBTAG00000018833","17",64019338,64092372,73034
"11462","ENSBTAG00000018834","18",52764965,52802815,37850
"11463","ENSBTAG00000018837","19",58209287,58503188,293901
"11464","ENSBTAG00000018838","4",113763451,113782491,19040
"11465","ENSBTAG00000018839","X",80203297,80209364,6067
"11466","ENSBTAG00000018841","8",98927206,99092707,165501
"11467","ENSBTAG00000018843","21",59075306,59087375,12069
"11468","ENSBTAG00000018845","7",51800738,51803455,2717
"11469","ENSBTAG00000018846","12",52105328,52113148,7820
"11470","ENSBTAG00000018847","7",51803863,51817052,13189
"11471","ENSBTAG00000018848","12",52117531,52129926,12395
"11472","ENSBTAG00000018849","5",101224468,101234839,10371
"11473","ENSBTAG00000018851","12",52149494,52373739,224245
"11474","ENSBTAG00000018852","10",1167671,1299249,131578
"11475","ENSBTAG00000018854","1",3824601,3833406,8805
"11476","ENSBTAG00000018855","1",3760509,3822150,61641
"11477","ENSBTAG00000018857","28",1197453,1239542,42089
"11478","ENSBTAG00000018859","18",49689373,49704734,15361
"11479","ENSBTAG00000018861","5",49376642,49456410,79768
"11480","ENSBTAG00000018862","22",29921569,29961920,40351
"11481","ENSBTAG00000018863","27",15073007,15119509,46502
"11482","ENSBTAG00000018864","27",15119556,15165355,45799
"11483","ENSBTAG00000018868","25",20098778,20145476,46698
"11484","ENSBTAG00000018869","25",20133171,20142436,9265
"11485","ENSBTAG00000018870","25",20165984,20233744,67760
"11486","ENSBTAG00000018872","7",38898276,38910067,11791
"11487","ENSBTAG00000018873","13",72891431,72905729,14298
"11488","ENSBTAG00000018877","1",67411430,67504231,92801
"11489","ENSBTAG00000018879","23",3051079,3142445,91366
"11490","ENSBTAG00000018880","19",24279228,24301269,22041
"11491","ENSBTAG00000018881","3",29231274,29297466,66192
"11492","ENSBTAG00000018883","8",75981882,75990372,8490
"11493","ENSBTAG00000018884","23",7395562,7399722,4160
"11494","ENSBTAG00000018887","3",102090696,102111545,20849
"11495","ENSBTAG00000018888","3",102085998,102089568,3570
"11496","ENSBTAG00000018889","3",102080670,102084006,3336
"11497","ENSBTAG00000018893","3",33403800,33444827,41027
"11498","ENSBTAG00000018894","7",16347652,16361803,14151
"11499","ENSBTAG00000018897","19",17701898,17729742,27844
"11500","ENSBTAG00000018898","10",70592722,70654759,62037
"11501","ENSBTAG00000018900","18",35196028,35207962,11934
"11502","ENSBTAG00000018901","24",48220180,48542521,322341
"11503","ENSBTAG00000018902","14",41869658,41935413,65755
"11504","ENSBTAG00000018903","18",35207975,35214087,6112
"11505","ENSBTAG00000018904","18",35216700,35220143,3443
"11506","ENSBTAG00000018905","21",21741603,21760748,19145
"11507","ENSBTAG00000018906","18",35220274,35222032,1758
"11508","ENSBTAG00000018908","18",35224968,35264273,39305
"11509","ENSBTAG00000018909","4",67314290,67752296,438006
"11510","ENSBTAG00000018910","22",50975112,50983657,8545
"11511","ENSBTAG00000018912","18",51323403,51343621,20218
"11512","ENSBTAG00000018913","22",50972627,50975586,2959
"11513","ENSBTAG00000018914","3",14700973,14708274,7301
"11514","ENSBTAG00000018915","28",44112887,44157819,44932
"11515","ENSBTAG00000018917","4",117222455,117226427,3972
"11516","ENSBTAG00000018918","22",50968509,50969630,1121
"11517","ENSBTAG00000018919","10",25950779,25951714,935
"11518","ENSBTAG00000018920","19",55741272,55745803,4531
"11519","ENSBTAG00000018921","22",50899782,50909096,9314
"11520","ENSBTAG00000018922","8",61868932,61881692,12760
"11521","ENSBTAG00000018924","22",50920376,50962568,42192
"11522","ENSBTAG00000018925","8",61883371,61888055,4684
"11523","ENSBTAG00000018926","7",44453424,44454339,915
"11524","ENSBTAG00000018928","22",50911689,50919173,7484
"11525","ENSBTAG00000018935","22",22014234,22025063,10829
"11526","ENSBTAG00000018936","1",145889102,145919613,30511
"11527","ENSBTAG00000018937","25",3626012,3654155,28143
"11528","ENSBTAG00000018938","25",3654408,3678764,24356
"11529","ENSBTAG00000018940","5",106146546,106298766,152220
"11530","ENSBTAG00000018941","26",43495815,43632754,136939
"11531","ENSBTAG00000018942","3",59398296,59456577,58281
"11532","ENSBTAG00000018945","15",15543580,15735835,192255
"11533","ENSBTAG00000018946","7",5568730,5586773,18043
"11534","ENSBTAG00000018947","10",73936265,74230784,294519
"11535","ENSBTAG00000018948","18",53558986,53590521,31535
"11536","ENSBTAG00000018951","17",17014136,17141026,126890
"11537","ENSBTAG00000018954","24",20958748,21006451,47703
"11538","ENSBTAG00000018955","12",25276587,25302987,26400
"11539","ENSBTAG00000018959","10",12743190,12762968,19778
"11540","ENSBTAG00000018965","16",49578396,49632261,53865
"11541","ENSBTAG00000018966","26",15469780,15846958,377178
"11542","ENSBTAG00000018967","23",17057485,17062278,4793
"11543","ENSBTAG00000018969","23",17062532,17069399,6867
"11544","ENSBTAG00000018970","23",17071458,17118839,47381
"11545","ENSBTAG00000018971","10",79669849,80286850,617001
"11546","ENSBTAG00000018972","4",65704797,65758270,53473
"11547","ENSBTAG00000018973","19",34886735,34905324,18589
"11548","ENSBTAG00000018975","11",103335988,103387085,51097
"11549","ENSBTAG00000018978","13",38333657,38360021,26364
"11550","ENSBTAG00000018979","2",122527753,122653986,126233
"11551","ENSBTAG00000018984","16",43788707,43850241,61534
"11552","ENSBTAG00000018986","X",58035379,58110124,74745
"11553","ENSBTAG00000018987","3",16449707,16450084,377
"11554","ENSBTAG00000018989","4",33626562,33877961,251399
"11555","ENSBTAG00000018991","11",4203832,4296700,92868
"11556","ENSBTAG00000018993","5",26796739,26811772,15033
"11557","ENSBTAG00000018994","1",94985031,95001222,16191
"11558","ENSBTAG00000018996","9",96966927,98112020,1145093
"11559","ENSBTAG00000018999","25",3755105,3791839,36734
"11560","ENSBTAG00000019001","29",36100991,36167328,66337
"11561","ENSBTAG00000019002","9",72154434,72223405,68971
"11562","ENSBTAG00000019006","25",588604,593763,5159
"11563","ENSBTAG00000019007","1",127035398,127035796,398
"11564","ENSBTAG00000019008","25",595099,606604,11505
"11565","ENSBTAG00000019010","3",101059206,101173067,113861
"11566","ENSBTAG00000019011","3",81911178,81978206,67028
"11567","ENSBTAG00000019012","7",55312292,55622382,310090
"11568","ENSBTAG00000019013","3",101040409,101048376,7967
"11569","ENSBTAG00000019014","1",82499645,82501239,1594
"11570","ENSBTAG00000019015","29",51000587,51001621,1034
"11571","ENSBTAG00000019017","29",51003792,51005106,1314
"11572","ENSBTAG00000019018","11",82978840,82979892,1052
"11573","ENSBTAG00000019020","4",68323940,68407181,83241
"11574","ENSBTAG00000019021","17",35728366,35800211,71845
"11575","ENSBTAG00000019023","8",63192882,63212682,19800
"11576","ENSBTAG00000019024","4",67992971,68321145,328174
"11577","ENSBTAG00000019025","7",18473539,18479129,5590
"11578","ENSBTAG00000019026","3",42410254,42428917,18663
"11579","ENSBTAG00000019027","3",42316067,42410097,94030
"11580","ENSBTAG00000019028","28",25111847,25171619,59772
"11581","ENSBTAG00000019029","3",42259115,42299418,40303
"11582","ENSBTAG00000019031","3",43921627,43976646,55019
"11583","ENSBTAG00000019033","3",9076733,9119524,42791
"11584","ENSBTAG00000019036","24",39834619,39935989,101370
"11585","ENSBTAG00000019039","28",45662208,45663422,1214
"11586","ENSBTAG00000019040","17",61041318,61063762,22444
"11587","ENSBTAG00000019041","22",32966389,33471943,505554
"11588","ENSBTAG00000019043","1",10656634,10691694,35060
"11589","ENSBTAG00000019044","19",51578606,51642239,63633
"11590","ENSBTAG00000019045","15",66742629,66755759,13130
"11591","ENSBTAG00000019048","22",36621574,36622110,536
"11592","ENSBTAG00000019049","19",51538083,51576183,38100
"11593","ENSBTAG00000019051","18",62021731,62025035,3304
"11594","ENSBTAG00000019052","28",15696546,15814967,118421
"11595","ENSBTAG00000019053","17",1932500,1977083,44583
"11596","ENSBTAG00000019054","12",13015397,13115267,99870
"11597","ENSBTAG00000019058","5",107048490,107137449,88959
"11598","ENSBTAG00000019059","15",52351651,52367777,16126
"11599","ENSBTAG00000019060","1",96999962,97014928,14966
"11600","ENSBTAG00000019061","X",14043931,14081572,37641
"11601","ENSBTAG00000019062","15",52372213,52631806,259593
"11602","ENSBTAG00000019065","4",60949038,61140520,191482
"11603","ENSBTAG00000019066","8",7897347,7929036,31689
"11604","ENSBTAG00000019067","19",54013443,54024053,10610
"11605","ENSBTAG00000019069","19",53992203,53995976,3773
"11606","ENSBTAG00000019070","19",32755609,32781362,25753
"11607","ENSBTAG00000019071","7",37598772,37783067,184295
"11608","ENSBTAG00000019072","11",46884578,46900867,16289
"11609","ENSBTAG00000019073","25",1693666,1710441,16775
"11610","ENSBTAG00000019075","2",24470859,24547937,77078
"11611","ENSBTAG00000019076","10",35857579,35895687,38108
"11612","ENSBTAG00000019077","10",22229577,22252106,22529
"11613","ENSBTAG00000019079","10",35905190,35927228,22038
"11614","ENSBTAG00000019080","15",39190651,39193192,2541
"11615","ENSBTAG00000019081","22",51287420,51317102,29682
"11616","ENSBTAG00000019082","19",14978195,14991205,13010
"11617","ENSBTAG00000019084","5",56011447,56022178,10731
"11618","ENSBTAG00000019085","21",45308844,45337119,28275
"11619","ENSBTAG00000019086","25",1173828,1185501,11673
"11620","ENSBTAG00000019090","19",42725940,42734368,8428
"11621","ENSBTAG00000019091","3",39855791,39883179,27388
"11622","ENSBTAG00000019093","3",39784076,39858496,74420
"11623","ENSBTAG00000019094","19",14954563,14963358,8795
"11624","ENSBTAG00000019095","19",42736941,42738908,1967
"11625","ENSBTAG00000019096","22",51275073,51283826,8753
"11626","ENSBTAG00000019097","19",42739776,42753673,13897
"11627","ENSBTAG00000019099","8",70670616,70715966,45350
"11628","ENSBTAG00000019104","19",51224646,51233871,9225
"11629","ENSBTAG00000019105","19",51171780,51221977,50197
"11630","ENSBTAG00000019106","22",13170136,13172696,2560
"11631","ENSBTAG00000019107","19",29045834,29251399,205565
"11632","ENSBTAG00000019110","9",61031143,61035355,4212
"11633","ENSBTAG00000019114","10",50214413,50215390,977
"11634","ENSBTAG00000019116","2",86060754,86090534,29780
"11635","ENSBTAG00000019119","5",38354664,38372270,17606
"11636","ENSBTAG00000019120","10",67450966,67504493,53527
"11637","ENSBTAG00000019121","22",56239343,56308299,68956
"11638","ENSBTAG00000019122","19",21175356,21193833,18477
"11639","ENSBTAG00000019123","25",2693154,2708059,14905
"11640","ENSBTAG00000019125","8",39928081,40003010,74929
"11641","ENSBTAG00000019129","1",152638136,152679233,41097
"11642","ENSBTAG00000019130","28",29237038,29287046,50008
"11643","ENSBTAG00000019131","3",19066204,19081185,14981
"11644","ENSBTAG00000019132","6",102526308,102543087,16779
"11645","ENSBTAG00000019133","3",53224391,53259805,35414
"11646","ENSBTAG00000019134","12",21443115,21543353,100238
"11647","ENSBTAG00000019136","25",583662,586777,3115
"11648","ENSBTAG00000019137","2",29840643,29898509,57866
"11649","ENSBTAG00000019138","11",73459358,73495508,36150
"11650","ENSBTAG00000019139","9",576865,655879,79014
"11651","ENSBTAG00000019140","7",59323453,59399497,76044
"11652","ENSBTAG00000019143","8",64535522,64537732,2210
"11653","ENSBTAG00000019144","15",45906051,45907010,959
"11654","ENSBTAG00000019146","17",69639538,69793488,153950
"11655","ENSBTAG00000019147","14",23278316,23279689,1373
"11656","ENSBTAG00000019150","18",49720027,49730376,10349
"11657","ENSBTAG00000019152","2",113534347,113851603,317256
"11658","ENSBTAG00000019153","19",55052720,55060447,7727
"11659","ENSBTAG00000019155","5",43894715,43908506,13791
"11660","ENSBTAG00000019156","5",43869187,43884991,15804
"11661","ENSBTAG00000019157","5",43863320,43866402,3082
"11662","ENSBTAG00000019158","3",14690553,14695864,5311
"11663","ENSBTAG00000019159","5",75176504,75193657,17153
"11664","ENSBTAG00000019160","19",22065122,22084876,19754
"11665","ENSBTAG00000019161","22",49988945,50001031,12086
"11666","ENSBTAG00000019162","19",22060689,22065001,4312
"11667","ENSBTAG00000019163","22",49994656,49997571,2915
"11668","ENSBTAG00000019164","28",16637438,16777483,140045
"11669","ENSBTAG00000019166","26",41841667,41855422,13755
"11670","ENSBTAG00000019167","15",51828755,51842831,14076
"11671","ENSBTAG00000019168","15",51842812,51847286,4474
"11672","ENSBTAG00000019172","2",134276567,134429921,153354
"11673","ENSBTAG00000019174","21",21403417,21473781,70364
"11674","ENSBTAG00000019175","9",42405900,42571799,165899
"11675","ENSBTAG00000019177","2",5418420,5475051,56631
"11676","ENSBTAG00000019179","18",56116159,56132067,15908
"11677","ENSBTAG00000019180","18",56137559,56165245,27686
"11678","ENSBTAG00000019181","25",37655743,37735318,79575
"11679","ENSBTAG00000019182","11",68523385,68555041,31656
"11680","ENSBTAG00000019183","18",56165187,56170886,5699
"11681","ENSBTAG00000019184","18",14032588,14038555,5967
"11682","ENSBTAG00000019187","8",96644114,96759752,115638
"11683","ENSBTAG00000019188","6",117431876,117479886,48010
"11684","ENSBTAG00000019190","2",95234725,95266752,32027
"11685","ENSBTAG00000019192","3",69636164,69662240,26076
"11686","ENSBTAG00000019193","22",17130385,17176329,45944
"11687","ENSBTAG00000019194","28",41650333,41763371,113038
"11688","ENSBTAG00000019197","13",42953008,43022328,69320
"11689","ENSBTAG00000019198","3",92241241,92262728,21487
"11690","ENSBTAG00000019200","13",62304795,62323150,18355
"11691","ENSBTAG00000019202","1",152450841,152463273,12432
"11692","ENSBTAG00000019203","3",16824126,16826559,2433
"11693","ENSBTAG00000019204","29",42051122,42117332,66210
"11694","ENSBTAG00000019208","29",42120664,42125880,5216
"11695","ENSBTAG00000019209","20",39227867,39234623,6756
"11696","ENSBTAG00000019210","20",65388705,65842986,454281
"11697","ENSBTAG00000019211","20",39219143,39228770,9627
"11698","ENSBTAG00000019213","11",2722676,2758397,35721
"11699","ENSBTAG00000019214","24",35149151,35184341,35190
"11700","ENSBTAG00000019215","24",35184721,35223401,38680
"11701","ENSBTAG00000019216","25",25967782,25971740,3958
"11702","ENSBTAG00000019217","23",39526102,39728514,202412
"11703","ENSBTAG00000019218","19",42555705,42611486,55781
"11704","ENSBTAG00000019219","25",25950650,25956976,6326
"11705","ENSBTAG00000019220","7",15424807,15515086,90279
"11706","ENSBTAG00000019221","X",22473870,22474540,670
"11707","ENSBTAG00000019225","8",69680185,69731751,51566
"11708","ENSBTAG00000019226","29",39726286,39736545,10259
"11709","ENSBTAG00000019227","18",57637619,57641293,3674
"11710","ENSBTAG00000019229","17",40697162,40745537,48375
"11711","ENSBTAG00000019230","3",74185666,74228359,42693
"11712","ENSBTAG00000019231","2",88519695,88531251,11556
"11713","ENSBTAG00000019232","2",88496394,88519396,23002
"11714","ENSBTAG00000019234","23",47503385,47662574,159189
"11715","ENSBTAG00000019235","5",98952626,98963107,10481
"11716","ENSBTAG00000019237","23",47476520,47502237,25717
"11717","ENSBTAG00000019238","8",63081995,63100080,18085
"11718","ENSBTAG00000019242","19",27116487,27131137,14650
"11719","ENSBTAG00000019244","17",72363090,72372252,9162
"11720","ENSBTAG00000019246","15",31876181,31922303,46122
"11721","ENSBTAG00000019249","25",1485418,1491602,6184
"11722","ENSBTAG00000019250","X",50826738,50860719,33981
"11723","ENSBTAG00000019251","24",38880422,38973547,93125
"11724","ENSBTAG00000019252","2",126257409,126270759,13350
"11725","ENSBTAG00000019253","X",50819017,50835992,16975
"11726","ENSBTAG00000019254","11",102485125,102638859,153734
"11727","ENSBTAG00000019255","2",19617026,19649649,32623
"11728","ENSBTAG00000019256","X",50803846,50814062,10216
"11729","ENSBTAG00000019260","5",4889686,4935613,45927
"11730","ENSBTAG00000019262","19",40627306,40653433,26127
"11731","ENSBTAG00000019264","16",65719553,65792435,72882
"11732","ENSBTAG00000019265","4",104801728,104925610,123882
"11733","ENSBTAG00000019266","18",43203605,43231733,28128
"11734","ENSBTAG00000019267","18",23752891,23780118,27227
"11735","ENSBTAG00000019269","1",145807169,145837649,30480
"11736","ENSBTAG00000019271","24",56833284,56849993,16709
"11737","ENSBTAG00000019272","18",23786207,23854907,68700
"11738","ENSBTAG00000019274","2",103327789,103350913,23124
"11739","ENSBTAG00000019275","8",101964109,101990100,25991
"11740","ENSBTAG00000019276","4",33387397,33388681,1284
"11741","ENSBTAG00000019277","5",30274565,30293396,18831
"11742","ENSBTAG00000019278","17",52854278,52922614,68336
"11743","ENSBTAG00000019279","10",86276261,86301871,25610
"11744","ENSBTAG00000019280","17",66251943,66289558,37615
"11745","ENSBTAG00000019281","5",30264979,30274823,9844
"11746","ENSBTAG00000019282","17",66252289,66275059,22770
"11747","ENSBTAG00000019283","5",30233506,30249541,16035
"11748","ENSBTAG00000019284","11",84090372,84091724,1352
"11749","ENSBTAG00000019287","7",94687293,94744875,57582
"11750","ENSBTAG00000019289","20",25976242,26081369,105127
"11751","ENSBTAG00000019290","5",113686864,113804112,117248
"11752","ENSBTAG00000019291","2",31681686,31810646,128960
"11753","ENSBTAG00000019293","8",69996238,70000191,3953
"11754","ENSBTAG00000019294","5",88262950,88412938,149988
"11755","ENSBTAG00000019295","11",62022816,62047723,24907
"11756","ENSBTAG00000019297","26",36464990,36696529,231539
"11757","ENSBTAG00000019298","2",90008658,90040182,31524
"11758","ENSBTAG00000019299","8",61555133,61564033,8900
"11759","ENSBTAG00000019300","23",39431808,39454562,22754
"11760","ENSBTAG00000019302","24",61396513,61588241,191728
"11761","ENSBTAG00000019303","25",41406107,41415030,8923
"11762","ENSBTAG00000019305","22",11868428,11891788,23360
"11763","ENSBTAG00000019309","15",5396356,5452006,55650
"11764","ENSBTAG00000019310","25",39217519,39269527,52008
"11765","ENSBTAG00000019312","5",28610714,28664527,53813
"11766","ENSBTAG00000019313","28",34753087,34944991,191904
"11767","ENSBTAG00000019314","1",21167188,21328190,161002
"11768","ENSBTAG00000019315","23",19924777,19963342,38565
"11769","ENSBTAG00000019317","19",50814166,50821416,7250
"11770","ENSBTAG00000019321","19",50662216,50773701,111485
"11771","ENSBTAG00000019322","26",34026815,34062274,35459
"11772","ENSBTAG00000019325","7",12462094,12472170,10076
"11773","ENSBTAG00000019327","26",34061695,34145490,83795
"11774","ENSBTAG00000019329","7",12473027,12478679,5652
"11775","ENSBTAG00000019330","22",29859914,29883008,23094
"11776","ENSBTAG00000019331","24",46735153,46792974,57821
"11777","ENSBTAG00000019332","1",56963723,57060956,97233
"11778","ENSBTAG00000019334","29",44313580,44323524,9944
"11779","ENSBTAG00000019336","1",82981845,82996905,15060
"11780","ENSBTAG00000019337","2",38753355,38831144,77789
"11781","ENSBTAG00000019338","X",3168607,3246931,78324
"11782","ENSBTAG00000019340","12",40575909,40601637,25728
"11783","ENSBTAG00000019341","19",21237162,21283030,45868
"11784","ENSBTAG00000019342","4",70844945,71041101,196156
"11785","ENSBTAG00000019343","23",15457459,15474705,17246
"11786","ENSBTAG00000019345","8",52453482,52459253,5771
"11787","ENSBTAG00000019347","19",39590711,39657423,66712
"11788","ENSBTAG00000019349","19",21290410,21323440,33030
"11789","ENSBTAG00000019350","21",46881642,47400026,518384
"11790","ENSBTAG00000019353","6",46271030,46455918,184888
"11791","ENSBTAG00000019354","11",46917080,46980824,63744
"11792","ENSBTAG00000019355","10",99915023,100073747,158724
"11793","ENSBTAG00000019357","25",26735144,26737926,2782
"11794","ENSBTAG00000019358","15",27926669,27968545,41876
"11795","ENSBTAG00000019362","6",72211454,72361031,149577
"11796","ENSBTAG00000019365","15",27972090,27993954,21864
"11797","ENSBTAG00000019366","6",72361660,72405612,43952
"11798","ENSBTAG00000019368","6",72405716,72486115,80399
"11799","ENSBTAG00000019369","29",50514096,50524139,10043
"11800","ENSBTAG00000019370","X",92026276,92026920,644
"11801","ENSBTAG00000019371","2",129001537,129038262,36725
"11802","ENSBTAG00000019373","5",78798259,78840817,42558
"11803","ENSBTAG00000019375","17",72508575,72519966,11391
"11804","ENSBTAG00000019376","1",95121236,95406498,285262
"11805","ENSBTAG00000019378","13",67088081,67126785,38704
"11806","ENSBTAG00000019379","19",21603447,21620221,16774
"11807","ENSBTAG00000019382","11",24464835,24474936,10101
"11808","ENSBTAG00000019385","2",31103231,31183473,80242
"11809","ENSBTAG00000019386","23",28548781,28553089,4308
"11810","ENSBTAG00000019387","2",73387424,73397873,10449
"11811","ENSBTAG00000019388","16",41753761,41759448,5687
"11812","ENSBTAG00000019390","10",46649404,46851817,202413
"11813","ENSBTAG00000019391","19",23977636,23981623,3987
"11814","ENSBTAG00000019394","29",22553732,22641639,87907
"11815","ENSBTAG00000019399","2",126911248,126923367,12119
"11816","ENSBTAG00000019401","3",70608442,70718331,109889
"11817","ENSBTAG00000019402","22",60650660,60677471,26811
"11818","ENSBTAG00000019403","4",31917458,31942803,25345
"11819","ENSBTAG00000019404","1",2242523,2314142,71619
"11820","ENSBTAG00000019406","4",31943617,32088119,144502
"11821","ENSBTAG00000019409","5",65570868,65655965,85097
"11822","ENSBTAG00000019410","9",40983487,41068511,85024
"11823","ENSBTAG00000019412","25",17159069,17210746,51677
"11824","ENSBTAG00000019414","7",39743245,39765060,21815
"11825","ENSBTAG00000019416","12",15339148,15340705,1557
"11826","ENSBTAG00000019417","X",50590161,50594596,4435
"11827","ENSBTAG00000019418","9",22791492,22958605,167113
"11828","ENSBTAG00000019419","7",43805788,43814284,8496
"11829","ENSBTAG00000019421","10",70906350,70915756,9406
"11830","ENSBTAG00000019423","25",18162095,18210917,48822
"11831","ENSBTAG00000019425","5",809196,875163,65967
"11832","ENSBTAG00000019426","17",3885204,3950848,65644
"11833","ENSBTAG00000019427","6",113323620,113374209,50589
"11834","ENSBTAG00000019428","22",53225174,53231223,6049
"11835","ENSBTAG00000019429","6",25111328,25137597,26269
"11836","ENSBTAG00000019432","19",48205013,48254361,49348
"11837","ENSBTAG00000019434","26",31436457,31463087,26630
"11838","ENSBTAG00000019436","15",77240232,77248528,8296
"11839","ENSBTAG00000019437","19",14810212,14822401,12189
"11840","ENSBTAG00000019440","12",86516216,86525634,9418
"11841","ENSBTAG00000019441","6",37169216,37175026,5810
"11842","ENSBTAG00000019443","19",26957153,26963304,6151
"11843","ENSBTAG00000019445","4",70699194,70727802,28608
"11844","ENSBTAG00000019446","19",26962514,26969872,7358
"11845","ENSBTAG00000019447","4",70667240,70670595,3355
"11846","ENSBTAG00000019448","19",26970222,26972580,2358
"11847","ENSBTAG00000019451","6",111366487,111425316,58829
"11848","ENSBTAG00000019453","11",100121985,100133453,11468
"11849","ENSBTAG00000019454","10",88045173,88065276,20103
"11850","ENSBTAG00000019455","24",49490278,49824858,334580
"11851","ENSBTAG00000019456","11",63679273,63801394,122121
"11852","ENSBTAG00000019457","7",66108778,66144328,35550
"11853","ENSBTAG00000019458","11",36401341,36519701,118360
"11854","ENSBTAG00000019459","11",36490398,36499906,9508
"11855","ENSBTAG00000019460","9",70257747,70355603,97856
"11856","ENSBTAG00000019461","18",49949052,49973912,24860
"11857","ENSBTAG00000019462","18",49975276,49992107,16831
"11858","ENSBTAG00000019463","19",44126334,44130992,4658
"11859","ENSBTAG00000019464","2",72174303,72176593,2290
"11860","ENSBTAG00000019465","18",49995658,50013372,17714
"11861","ENSBTAG00000019467","8",98462724,98464130,1406
"11862","ENSBTAG00000019468","8",98466288,98467807,1519
"11863","ENSBTAG00000019470","11",95315044,95401330,86286
"11864","ENSBTAG00000019471","16",27529014,27543264,14250
"11865","ENSBTAG00000019472","7",54344785,54463486,118701
"11866","ENSBTAG00000019473","18",57382506,57404990,22484
"11867","ENSBTAG00000019474","10",46372672,46394622,21950
"11868","ENSBTAG00000019478","6",90770495,90794386,23891
"11869","ENSBTAG00000019479","22",16627823,16646002,18179
"11870","ENSBTAG00000019480","2",119442706,119498775,56069
"11871","ENSBTAG00000019486","2",121402133,121416389,14256
"11872","ENSBTAG00000019488","13",12640351,12773414,133063
"11873","ENSBTAG00000019492","23",9415902,9425051,9149
"11874","ENSBTAG00000019494","23",9425849,9428501,2652
"11875","ENSBTAG00000019495","23",9433659,9454855,21196
"11876","ENSBTAG00000019496","10",66925220,66941993,16773
"11877","ENSBTAG00000019497","3",1903037,1970272,67235
"11878","ENSBTAG00000019498","19",36565806,36598451,32645
"11879","ENSBTAG00000019500","10",66946898,66961872,14974
"11880","ENSBTAG00000019501","12",17883601,17889927,6326
"11881","ENSBTAG00000019502","12",17896753,17911232,14479
"11882","ENSBTAG00000019504","13",50910836,50932861,22025
"11883","ENSBTAG00000019506","21",33167722,33171677,3955
"11884","ENSBTAG00000019508","13",12212518,12235247,22729
"11885","ENSBTAG00000019509","13",12189401,12209716,20315
"11886","ENSBTAG00000019510","11",72292597,72297447,4850
"11887","ENSBTAG00000019511","13",12143250,12189634,46384
"11888","ENSBTAG00000019512","X",37570063,37587145,17082
"11889","ENSBTAG00000019513","11",100010583,100017394,6811
"11890","ENSBTAG00000019514","1",73771857,73856448,84591
"11891","ENSBTAG00000019515","11",72286895,72292664,5769
"11892","ENSBTAG00000019516","17",72900703,72915705,15002
"11893","ENSBTAG00000019517","25",33277644,33310763,33119
"11894","ENSBTAG00000019518","11",72283322,72286788,3466
"11895","ENSBTAG00000019519","26",51975175,51984865,9690
"11896","ENSBTAG00000019520","18",13834154,13877327,43173
"11897","ENSBTAG00000019521","25",27479986,27481274,1288
"11898","ENSBTAG00000019522","11",72262171,72282780,20609
"11899","ENSBTAG00000019524","25",27451624,27480928,29304
"11900","ENSBTAG00000019525","28",29426059,29473891,47832
"11901","ENSBTAG00000019526","22",6929371,6951459,22088
"11902","ENSBTAG00000019529","12",33380874,33831448,450574
"11903","ENSBTAG00000019530","25",24778510,24800600,22090
"11904","ENSBTAG00000019532","27",34128053,34143818,15765
"11905","ENSBTAG00000019533","23",44610190,44677675,67485
"11906","ENSBTAG00000019534","22",23148355,23172673,24318
"11907","ENSBTAG00000019535","1",131371915,131372637,722
"11908","ENSBTAG00000019536","22",23123462,23147293,23831
"11909","ENSBTAG00000019537","28",44228057,44339169,111112
"11910","ENSBTAG00000019538","16",27306978,27330898,23920
"11911","ENSBTAG00000019539","8",1832165,1879414,47249
"11912","ENSBTAG00000019542","1",10823242,10849340,26098
"11913","ENSBTAG00000019543","25",2280925,2284966,4041
"11914","ENSBTAG00000019545","12",34185307,34289051,103744
"11915","ENSBTAG00000019546","X",18865991,18878273,12282
"11916","ENSBTAG00000019550","8",63312769,63357767,44998
"11917","ENSBTAG00000019552","X",3623055,3631983,8928
"11918","ENSBTAG00000019553","X",3636897,3645004,8107
"11919","ENSBTAG00000019554","8",81003304,81046397,43093
"11920","ENSBTAG00000019555","3",112322230,112338096,15866
"11921","ENSBTAG00000019556","16",41661865,41672168,10303
"11922","ENSBTAG00000019557","1",64606698,64639471,32773
"11923","ENSBTAG00000019563","5",109738012,109745876,7864
"11924","ENSBTAG00000019564","8",74805225,74834242,29017
"11925","ENSBTAG00000019565","28",44036736,44059067,22331
"11926","ENSBTAG00000019567","25",24941958,25002153,60195
"11927","ENSBTAG00000019568","8",17184479,17277618,93139
"11928","ENSBTAG00000019569","29",50536649,50542885,6236
"11929","ENSBTAG00000019574","5",119618807,119627315,8508
"11930","ENSBTAG00000019577","1",136981306,136983324,2018
"11931","ENSBTAG00000019579","29",49862339,49867959,5620
"11932","ENSBTAG00000019581","14",69174130,69194614,20484
"11933","ENSBTAG00000019584","6",113057646,113097777,40131
"11934","ENSBTAG00000019585","24",37255784,37379159,123375
"11935","ENSBTAG00000019587","14",38154415,38185904,31489
"11936","ENSBTAG00000019588","23",25672686,25680506,7820
"11937","ENSBTAG00000019589","1",144341397,144352212,10815
"11938","ENSBTAG00000019591","X",59472982,59589950,116968
"11939","ENSBTAG00000019592","2",47698242,47756040,57798
"11940","ENSBTAG00000019593","25",17301393,17314330,12937
"11941","ENSBTAG00000019595","20",35967736,36272653,304917
"11942","ENSBTAG00000019596","25",17478832,17498791,19959
"11943","ENSBTAG00000019600","9",12765347,12766533,1186
"11944","ENSBTAG00000019602","5",89019014,89099984,80970
"11945","ENSBTAG00000019603","5",88544523,88562783,18260
"11946","ENSBTAG00000019604","18",53104828,53118627,13799
"11947","ENSBTAG00000019605","18",53151995,53184910,32915
"11948","ENSBTAG00000019606","13",72178837,72216905,38068
"11949","ENSBTAG00000019608","5",97017440,97030497,13057
"11950","ENSBTAG00000019611","3",29703286,29962037,258751
"11951","ENSBTAG00000019612","10",26391241,26412980,21739
"11952","ENSBTAG00000019614","2",125604197,125635148,30951
"11953","ENSBTAG00000019615","3",29624990,29696827,71837
"11954","ENSBTAG00000019616","3",10127730,10129290,1560
"11955","ENSBTAG00000019617","3",29519988,29575960,55972
"11956","ENSBTAG00000019621","13",65740347,65803468,63121
"11957","ENSBTAG00000019622","15",54461865,54463034,1169
"11958","ENSBTAG00000019623","28",40404330,41087444,683114
"11959","ENSBTAG00000019625","1",81877674,81931209,53535
"11960","ENSBTAG00000019627","15",29981019,29986913,5894
"11961","ENSBTAG00000019628","11",44555138,44607245,52107
"11962","ENSBTAG00000019630","16",64794721,64961884,167163
"11963","ENSBTAG00000019633","6",91317426,91647743,330317
"11964","ENSBTAG00000019634","29",50562017,50567664,5647
"11965","ENSBTAG00000019636","8",10796505,10929733,133228
"11966","ENSBTAG00000019639","14",80762499,80798452,35953
"11967","ENSBTAG00000019644","15",74203659,74352950,149291
"11968","ENSBTAG00000019645","12",86721195,86738806,17611
"11969","ENSBTAG00000019646","7",40360504,40370255,9751
"11970","ENSBTAG00000019648","7",40370064,40375831,5767
"11971","ENSBTAG00000019651","7",40384230,40389581,5351
"11972","ENSBTAG00000019652","X",15912813,15979088,66275
"11973","ENSBTAG00000019658","19",43988805,43997148,8343
"11974","ENSBTAG00000019660","19",44005513,44009459,3946
"11975","ENSBTAG00000019662","19",44009199,44017030,7831
"11976","ENSBTAG00000019663","14",73688314,73731818,43504
"11977","ENSBTAG00000019665","11",46815591,46837831,22240
"11978","ENSBTAG00000019667","7",2542859,2546341,3482
"11979","ENSBTAG00000019669","5",101786078,101818046,31968
"11980","ENSBTAG00000019672","23",40831987,40833465,1478
"11981","ENSBTAG00000019674","18",46687670,46701516,13846
"11982","ENSBTAG00000019675","23",40645189,40829586,184397
"11983","ENSBTAG00000019676","24",59163946,59165739,1793
"11984","ENSBTAG00000019678","18",46681510,46687258,5748
"11985","ENSBTAG00000019679","18",46675916,46680973,5057
"11986","ENSBTAG00000019680","3",93541281,93615853,74572
"11987","ENSBTAG00000019682","23",27657894,27671044,13150
"11988","ENSBTAG00000019683","2",46966296,47080898,114602
"11989","ENSBTAG00000019684","23",8351570,8468528,116958
"11990","ENSBTAG00000019685","23",27645741,27656958,11217
"11991","ENSBTAG00000019686","5",25547486,25592783,45297
"11992","ENSBTAG00000019687","8",51126936,51149034,22098
"11993","ENSBTAG00000019689","29",44770598,44830076,59478
"11994","ENSBTAG00000019692","10",21602048,21606907,4859
"11995","ENSBTAG00000019694","2",94711218,94906499,195281
"11996","ENSBTAG00000019695","3",105894662,105974325,79663
"11997","ENSBTAG00000019696","29",44857579,44860660,3081
"11998","ENSBTAG00000019697","11",5846769,5977543,130774
"11999","ENSBTAG00000019698","3",105884724,105887360,2636
"12000","ENSBTAG00000019700","29",44862572,44965356,102784
"12001","ENSBTAG00000019703","X",56240053,56262495,22442
"12002","ENSBTAG00000019704","1",119074041,119137489,63448
"12003","ENSBTAG00000019707","22",59346928,59355012,8084
"12004","ENSBTAG00000019708","7",22477891,22541821,63930
"12005","ENSBTAG00000019711","5",84887467,84938013,50546
"12006","ENSBTAG00000019712","29",36351311,36389968,38657
"12007","ENSBTAG00000019714","7",43824822,43843948,19126
"12008","ENSBTAG00000019716","6",88810418,88814572,4154
"12009","ENSBTAG00000019718","7",43846494,43848179,1685
"12010","ENSBTAG00000019719","9",90804291,90860571,56280
"12011","ENSBTAG00000019721","11",104302962,104312184,9222
"12012","ENSBTAG00000019722","5",95172751,95238347,65596
"12013","ENSBTAG00000019723","19",14763783,14768000,4217
"12014","ENSBTAG00000019725","15",29039838,29082456,42618
"12015","ENSBTAG00000019726","13",3251954,3279640,27686
"12016","ENSBTAG00000019728","2",125905989,125909985,3996
"12017","ENSBTAG00000019729","9",50377200,50401243,24043
"12018","ENSBTAG00000019730","9",50346225,50372811,26586
"12019","ENSBTAG00000019732","8",6959642,7165342,205700
"12020","ENSBTAG00000019733","3",65667175,65807163,139988
"12021","ENSBTAG00000019734","10",20490779,20520933,30154
"12022","ENSBTAG00000019735","11",87980285,88013771,33486
"12023","ENSBTAG00000019738","5",45446653,45475170,28517
"12024","ENSBTAG00000019741","5",101566575,101575901,9326
"12025","ENSBTAG00000019742","5",101544589,101563703,19114
"12026","ENSBTAG00000019743","25",669580,678220,8640
"12027","ENSBTAG00000019745","25",714685,777085,62400
"12028","ENSBTAG00000019746","22",44403376,44442769,39393
"12029","ENSBTAG00000019748","22",44353226,44404518,51292
"12030","ENSBTAG00000019750","4",20366146,20388726,22580
"12031","ENSBTAG00000019752","13",62645078,62655447,10369
"12032","ENSBTAG00000019754","15",46710950,46712568,1618
"12033","ENSBTAG00000019755","28",19629639,19725949,96310
"12034","ENSBTAG00000019757","17",56835071,56879005,43934
"12035","ENSBTAG00000019759","26",13881642,13976189,94547
"12036","ENSBTAG00000019761","6",22062326,22189956,127630
"12037","ENSBTAG00000019764","15",27443936,27446075,2139
"12038","ENSBTAG00000019767","7",43033570,43056703,23133
"12039","ENSBTAG00000019770","15",27475732,27489136,13404
"12040","ENSBTAG00000019771","7",43299601,43324388,24787
"12041","ENSBTAG00000019772","22",17776079,17785745,9666
"12042","ENSBTAG00000019777","5",103597621,103600970,3349
"12043","ENSBTAG00000019779","X",35765821,35770072,4251
"12044","ENSBTAG00000019780","5",103584420,103598534,14114
"12045","ENSBTAG00000019781","2",73071996,73306346,234350
"12046","ENSBTAG00000019782","5",103580087,103583951,3864
"12047","ENSBTAG00000019784","10",75639522,75797041,157519
"12048","ENSBTAG00000019785","18",50982245,51009752,27507
"12049","ENSBTAG00000019787","18",50978701,50981956,3255
"12050","ENSBTAG00000019788","5",106773101,106835002,61901
"12051","ENSBTAG00000019790","23",27558157,27578112,19955
"12052","ENSBTAG00000019791","2",128563987,128600189,36202
"12053","ENSBTAG00000019792","28",15308624,15393525,84901
"12054","ENSBTAG00000019793","14",64289853,64398324,108471
"12055","ENSBTAG00000019794","4",47151949,47180223,28274
"12056","ENSBTAG00000019795","14",64227507,64239663,12156
"12057","ENSBTAG00000019796","16",4689496,4707225,17729
"12058","ENSBTAG00000019798","16",4712913,4731265,18352
"12059","ENSBTAG00000019799","16",4740835,4745514,4679
"12060","ENSBTAG00000019801","3",91635188,91690938,55750
"12061","ENSBTAG00000019803","25",115711,118437,2726
"12062","ENSBTAG00000019804","25",118663,120817,2154
"12063","ENSBTAG00000019805","25",121338,140516,19178
"12064","ENSBTAG00000019806","19",10299297,10362632,63335
"12065","ENSBTAG00000019807","8",103385113,103537033,151920
"12066","ENSBTAG00000019808","6",33504739,34501208,996469
"12067","ENSBTAG00000019810","18",1791809,1813085,21276
"12068","ENSBTAG00000019811","13",50564351,50715147,150796
"12069","ENSBTAG00000019812","19",51050656,51058641,7985
"12070","ENSBTAG00000019814","7",42726724,42735807,9083
"12071","ENSBTAG00000019818","16",42838570,42957501,118931
"12072","ENSBTAG00000019819","10",77562414,77838126,275712
"12073","ENSBTAG00000019820","X",52598488,52605804,7316
"12074","ENSBTAG00000019821","16",63896685,63937888,41203
"12075","ENSBTAG00000019822","18",34997818,35005559,7741
"12076","ENSBTAG00000019823","21",6331524,6739118,407594
"12077","ENSBTAG00000019828","5",110829261,110855258,25997
"12078","ENSBTAG00000019830","21",19474861,19484599,9738
"12079","ENSBTAG00000019831","21",19484255,19495138,10883
"12080","ENSBTAG00000019832","22",5091037,5184321,93284
"12081","ENSBTAG00000019834","20",24929893,25001304,71411
"12082","ENSBTAG00000019836","21",61248344,61271206,22862
"12083","ENSBTAG00000019838","3",15616454,15626916,10462
"12084","ENSBTAG00000019839","11",15473232,15930122,456890
"12085","ENSBTAG00000019841","22",52361996,52398789,36793
"12086","ENSBTAG00000019843","8",25137679,25179189,41510
"12087","ENSBTAG00000019844","4",112614754,112621523,6769
"12088","ENSBTAG00000019845","17",63983620,64006722,23102
"12089","ENSBTAG00000019846","17",63977709,63983574,5865
"12090","ENSBTAG00000019847","6",110152224,110215989,63765
"12091","ENSBTAG00000019851","18",58087595,58126615,39020
"12092","ENSBTAG00000019852","X",123763234,123786124,22890
"12093","ENSBTAG00000019853","19",48732717,48876849,144132
"12094","ENSBTAG00000019854","17",13156554,13187394,30840
"12095","ENSBTAG00000019855","X",123618763,123763627,144864
"12096","ENSBTAG00000019857","17",13109682,13152070,42388
"12097","ENSBTAG00000019859","16",12064219,12071842,7623
"12098","ENSBTAG00000019863","12",21303460,21309643,6183
"12099","ENSBTAG00000019864","14",1040716,1066536,25820
"12100","ENSBTAG00000019866","13",19635324,19782189,146865
"12101","ENSBTAG00000019867","11",60495828,60667407,171579
"12102","ENSBTAG00000019868","7",1706514,1759358,52844
"12103","ENSBTAG00000019869","17",72975731,72990508,14777
"12104","ENSBTAG00000019870","24",45407555,45464253,56698
"12105","ENSBTAG00000019871","17",72990821,72994746,3925
"12106","ENSBTAG00000019872","26",17925643,18029878,104235
"12107","ENSBTAG00000019876","24",25971050,26009225,38175
"12108","ENSBTAG00000019877","3",82924988,83115333,190345
"12109","ENSBTAG00000019881","7",31615385,31702854,87469
"12110","ENSBTAG00000019883","18",39164240,39179493,15253
"12111","ENSBTAG00000019884","18",39085074,39165547,80473
"12112","ENSBTAG00000019885","X",14164154,14211596,47442
"12113","ENSBTAG00000019886","12",47476923,47505656,28733
"12114","ENSBTAG00000019887","18",39068957,39082057,13100
"12115","ENSBTAG00000019888","17",72647476,72693052,45576
"12116","ENSBTAG00000019889","12",47507638,47532823,25185
"12117","ENSBTAG00000019890","16",77406070,77427160,21090
"12118","ENSBTAG00000019891","17",72693872,72696274,2402
"12119","ENSBTAG00000019892","14",18093101,18125211,32110
"12120","ENSBTAG00000019895","12",47532885,47763094,230209
"12121","ENSBTAG00000019900","7",96371532,96466676,95144
"12122","ENSBTAG00000019901","3",99817882,99844140,26258
"12123","ENSBTAG00000019903","19",42799859,42802110,2251
"12124","ENSBTAG00000019906","19",42805687,42810586,4899
"12125","ENSBTAG00000019907","19",42811378,42827596,16218
"12126","ENSBTAG00000019908","23",16786304,16822127,35823
"12127","ENSBTAG00000019909","7",19856911,19865253,8342
"12128","ENSBTAG00000019910","14",24728895,24763264,34369
"12129","ENSBTAG00000019911","19",42827055,42828164,1109
"12130","ENSBTAG00000019912","19",42828503,42836826,8323
"12131","ENSBTAG00000019913","23",16822621,16824968,2347
"12132","ENSBTAG00000019914","19",42837412,42848106,10694
"12133","ENSBTAG00000019915","8",110686132,110733968,47836
"12134","ENSBTAG00000019916","21",60062384,60174358,111974
"12135","ENSBTAG00000019918","19",42859304,42866438,7134
"12136","ENSBTAG00000019919","26",50822833,50865778,42945
"12137","ENSBTAG00000019920","25",2444405,2452317,7912
"12138","ENSBTAG00000019924","10",65673444,65741258,67814
"12139","ENSBTAG00000019926","23",32189851,32242064,52213
"12140","ENSBTAG00000019927","16",79860458,79865626,5168
"12141","ENSBTAG00000019928","29",18381661,18393534,11873
"12142","ENSBTAG00000019929","2",9644368,9749556,105188
"12143","ENSBTAG00000019930","29",18349101,18369616,20515
"12144","ENSBTAG00000019933","3",99527442,99573233,45791
"12145","ENSBTAG00000019937","3",25251271,25286207,34936
"12146","ENSBTAG00000019938","18",16967300,17021360,54060
"12147","ENSBTAG00000019939","8",83028782,83085624,56842
"12148","ENSBTAG00000019940","21",25239271,25341094,101823
"12149","ENSBTAG00000019942","X",39337586,39339608,2022
"12150","ENSBTAG00000019944","5",25092752,25123523,30771
"12151","ENSBTAG00000019946","5",25126563,25151506,24943
"12152","ENSBTAG00000019947","29",39984076,40047258,63182
"12153","ENSBTAG00000019948","7",60664747,60740423,75676
"12154","ENSBTAG00000019949","1",130942894,130955677,12783
"12155","ENSBTAG00000019950","7",60743594,60752561,8967
"12156","ENSBTAG00000019951","7",60754588,60767542,12954
"12157","ENSBTAG00000019952","1",130822345,130930767,108422
"12158","ENSBTAG00000019953","X",105600081,105715767,115686
"12159","ENSBTAG00000019954","21",20576003,20684305,108302
"12160","ENSBTAG00000019956","3",98887940,98924294,36354
"12161","ENSBTAG00000019958","8",89594884,89602592,7708
"12162","ENSBTAG00000019960","1",118858862,118883835,24973
"12163","ENSBTAG00000019961","12",86741907,86746988,5081
"12164","ENSBTAG00000019964","12",86810337,86838896,28559
"12165","ENSBTAG00000019965","12",86782690,86801873,19183
"12166","ENSBTAG00000019966","7",19335555,19337855,2300
"12167","ENSBTAG00000019967","12",86908880,86988568,79688
"12168","ENSBTAG00000019971","12",87032000,87058543,26543
"12169","ENSBTAG00000019972","19",51483169,51493993,10824
"12170","ENSBTAG00000019975","20",38299694,38334389,34695
"12171","ENSBTAG00000019977","17",25029473,25071284,41811
"12172","ENSBTAG00000019979","11",90067533,90083512,15979
"12173","ENSBTAG00000019980","4",101062654,101568352,505698
"12174","ENSBTAG00000019983","11",73541771,73647164,105393
"12175","ENSBTAG00000019984","13",53589805,53606654,16849
"12176","ENSBTAG00000019986","19",50597224,50631413,34189
"12177","ENSBTAG00000019987","22",43011215,43018634,7419
"12178","ENSBTAG00000019988","7",20665428,20685281,19853
"12179","ENSBTAG00000019989","22",42924248,43005784,81536
"12180","ENSBTAG00000019993","X",13690934,13697181,6247
"12181","ENSBTAG00000019994","2",91270021,91271660,1639
"12182","ENSBTAG00000019995","29",9203376,9240814,37438
"12183","ENSBTAG00000019997","14",55317459,55362360,44901
"12184","ENSBTAG00000019998","25",1379520,1393408,13888
"12185","ENSBTAG00000020000","19",23651043,23866131,215088
"12186","ENSBTAG00000020001","25",1403263,1439041,35778
"12187","ENSBTAG00000020003","24",24384932,24499896,114964
"12188","ENSBTAG00000020004","4",91589029,91638634,49605
"12189","ENSBTAG00000020009","29",9132005,9163444,31439
"12190","ENSBTAG00000020010","3",59526632,59586510,59878
"12191","ENSBTAG00000020012","23",17866548,17907737,41189
"12192","ENSBTAG00000020014","16",49231571,49266317,34746
"12193","ENSBTAG00000020015","16",49213732,49228876,15144
"12194","ENSBTAG00000020017","7",18027580,18034407,6827
"12195","ENSBTAG00000020018","9",34593961,34691721,97760
"12196","ENSBTAG00000020019","22",53319181,53320182,1001
"12197","ENSBTAG00000020022","X",63531378,63614928,83550
"12198","ENSBTAG00000020023","21",25950192,25967463,17271
"12199","ENSBTAG00000020026","3",16300763,16309171,8408
"12200","ENSBTAG00000020028","1",129556881,129560370,3489
"12201","ENSBTAG00000020030","13",72746423,72752451,6028
"12202","ENSBTAG00000020031","6",36613501,36672493,58992
"12203","ENSBTAG00000020032","15",6778391,6880855,102464
"12204","ENSBTAG00000020034","14",23134995,23244752,109757
"12205","ENSBTAG00000020035","1",882081,1002223,120142
"12206","ENSBTAG00000020037","3",92033900,92060024,26124
"12207","ENSBTAG00000020040","10",28278976,28287059,8083
"12208","ENSBTAG00000020041","7",49404262,49479615,75353
"12209","ENSBTAG00000020042","21",54698287,54727307,29020
"12210","ENSBTAG00000020043","25",22572555,22676579,104024
"12211","ENSBTAG00000020046","15",33689099,33794265,105166
"12212","ENSBTAG00000020047","22",50341652,50353722,12070
"12213","ENSBTAG00000020048","6",100907869,101279063,371194
"12214","ENSBTAG00000020049","17",62902961,62919845,16884
"12215","ENSBTAG00000020050","17",62933212,62943566,10354
"12216","ENSBTAG00000020051","25",24671805,24673861,2056
"12217","ENSBTAG00000020053","13",33771235,33968002,196767
"12218","ENSBTAG00000020054","23",20418222,20482057,63835
"12219","ENSBTAG00000020055","8",6597009,6632691,35682
"12220","ENSBTAG00000020056","9",14663442,14776366,112924
"12221","ENSBTAG00000020059","11",80822886,80851879,28993
"12222","ENSBTAG00000020060","3",21383711,21387865,4154
"12223","ENSBTAG00000020061","19",35328653,35363115,34462
"12224","ENSBTAG00000020062","18",63227989,63238070,10081
"12225","ENSBTAG00000020066","15",24284251,24319569,35318
"12226","ENSBTAG00000020067","19",55984816,56020314,35498
"12227","ENSBTAG00000020070","19",36047549,36095574,48025
"12228","ENSBTAG00000020073","1",94818555,94882838,64283
"12229","ENSBTAG00000020074","18",52806769,52817013,10244
"12230","ENSBTAG00000020076","22",51671499,51673833,2334
"12231","ENSBTAG00000020079","9",96709109,96779448,70339
"12232","ENSBTAG00000020080","18",56581198,56607181,25983
"12233","ENSBTAG00000020082","18",56608101,56613645,5544
"12234","ENSBTAG00000020084","27",24261580,24281834,20254
"12235","ENSBTAG00000020087","7",61574371,61640274,65903
"12236","ENSBTAG00000020089","19",12577140,12778987,201847
"12237","ENSBTAG00000020090","7",7891255,7896003,4748
"12238","ENSBTAG00000020093","12",86545658,86572523,26865
"12239","ENSBTAG00000020095","15",83149879,83159312,9433
"12240","ENSBTAG00000020096","15",83163839,83173121,9282
"12241","ENSBTAG00000020097","9",75912273,75926756,14483
"12242","ENSBTAG00000020099","14",42811857,42870107,58250
"12243","ENSBTAG00000020100","10",30064006,30087255,23249
"12244","ENSBTAG00000020102","2",130225773,130254992,29219
"12245","ENSBTAG00000020105","8",75135968,75154388,18420
"12246","ENSBTAG00000020106","1",82970702,82977115,6413
"12247","ENSBTAG00000020107","25",2996584,2999606,3022
"12248","ENSBTAG00000020108","6",116734630,116760816,26186
"12249","ENSBTAG00000020109","25",2999547,3048710,49163
"12250","ENSBTAG00000020115","19",55299835,55349164,49329
"12251","ENSBTAG00000020116","23",28663713,28667379,3666
"12252","ENSBTAG00000020117","7",19956235,19976863,20628
"12253","ENSBTAG00000020119","19",9320780,9386860,66080
"12254","ENSBTAG00000020120","13",7424797,7503259,78462
"12255","ENSBTAG00000020121","1",7167841,7170830,2989
"12256","ENSBTAG00000020122","1",7129414,7155271,25857
"12257","ENSBTAG00000020123","11",10110333,10114465,4132
"12258","ENSBTAG00000020124","11",10107424,10111181,3757
"12259","ENSBTAG00000020125","5",73899444,74189188,289744
"12260","ENSBTAG00000020126","20",56233771,56495596,261825
"12261","ENSBTAG00000020127","X",37349741,37378203,28462
"12262","ENSBTAG00000020130","8",1549320,1637689,88369
"12263","ENSBTAG00000020132","8",1641320,1666699,25379
"12264","ENSBTAG00000020133","8",69756418,69835876,79458
"12265","ENSBTAG00000020136","X",101700057,102072977,372920
"12266","ENSBTAG00000020139","14",36623520,36627029,3509
"12267","ENSBTAG00000020140","8",29471364,29474107,2743
"12268","ENSBTAG00000020141","8",29303339,29452913,149574
"12269","ENSBTAG00000020142","20",38105482,38135086,29604
"12270","ENSBTAG00000020143","14",36628450,36655314,26864
"12271","ENSBTAG00000020144","X",101924660,101925790,1130
"12272","ENSBTAG00000020147","29",44554771,44569280,14509
"12273","ENSBTAG00000020148","8",17050131,17153178,103047
"12274","ENSBTAG00000020149","12",20346401,20423092,76691
"12275","ENSBTAG00000020150","3",8389186,8391006,1820
"12276","ENSBTAG00000020152","3",8376916,8388862,11946
"12277","ENSBTAG00000020153","3",8373204,8376843,3639
"12278","ENSBTAG00000020154","3",8363117,8373311,10194
"12279","ENSBTAG00000020159","2",122393085,122438183,45098
"12280","ENSBTAG00000020160","24",25079284,25119123,39839
"12281","ENSBTAG00000020161","17",72491752,72505789,14037
"12282","ENSBTAG00000020164","21",45116769,45202855,86086
"12283","ENSBTAG00000020166","13",77348734,77374973,26239
"12284","ENSBTAG00000020169","3",32227187,32272255,45068
"12285","ENSBTAG00000020172","3",32204153,32224615,20462
"12286","ENSBTAG00000020173","3",112794123,112931963,137840
"12287","ENSBTAG00000020174","9",73010914,73096052,85138
"12288","ENSBTAG00000020175","6",58774573,58850119,75546
"12289","ENSBTAG00000020177","5",26716865,26724410,7545
"12290","ENSBTAG00000020178","7",94867666,94924213,56547
"12291","ENSBTAG00000020179","5",26700451,26716539,16088
"12292","ENSBTAG00000020180","3",50290372,50308915,18543
"12293","ENSBTAG00000020184","25",22801765,22811948,10183
"12294","ENSBTAG00000020185","X",36606459,36607631,1172
"12295","ENSBTAG00000020186","29",44090468,44093581,3113
"12296","ENSBTAG00000020190","25",2371361,2375302,3941
"12297","ENSBTAG00000020191","2",106924715,106928807,4092
"12298","ENSBTAG00000020192","21",66678556,66817662,139106
"12299","ENSBTAG00000020193","26",34282210,34306714,24504
"12300","ENSBTAG00000020194","NKLS02002208.1",6393393,6468819,75426
"12301","ENSBTAG00000020195","21",25500696,25502303,1607
"12302","ENSBTAG00000020196","9",69599029,69687302,88273
"12303","ENSBTAG00000020198","25",606827,617065,10238
"12304","ENSBTAG00000020199","10",7945904,7963558,17654
"12305","ENSBTAG00000020201","10",8059019,8062052,3033
"12306","ENSBTAG00000020202","10",8104261,8118309,14048
"12307","ENSBTAG00000020203","29",44345167,44350015,4848
"12308","ENSBTAG00000020205","10",8336670,8590336,253666
"12309","ENSBTAG00000020209","25",2748254,2749894,1640
"12310","ENSBTAG00000020212","10",8595264,8642850,47586
"12311","ENSBTAG00000020213","7",69101530,69116298,14768
"12312","ENSBTAG00000020214","3",53688735,53713047,24312
"12313","ENSBTAG00000020215","23",52047082,52169604,122522
"12314","ENSBTAG00000020218","28",29386959,29409020,22061
"12315","ENSBTAG00000020219","28",29413416,29417580,4164
"12316","ENSBTAG00000020221","22",45541328,45558117,16789
"12317","ENSBTAG00000020223","3",9474927,9484746,9819
"12318","ENSBTAG00000020225","4",103295391,103468926,173535
"12319","ENSBTAG00000020226","14",3153138,3156593,3455
"12320","ENSBTAG00000020227","16",3986155,3998589,12434
"12321","ENSBTAG00000020229","7",44124692,44145536,20844
"12322","ENSBTAG00000020232","7",44150051,44169237,19186
"12323","ENSBTAG00000020233","26",34591142,34634138,42996
"12324","ENSBTAG00000020237","5",101591716,101603472,11756
"12325","ENSBTAG00000020238","9",11090230,11695382,605152
"12326","ENSBTAG00000020242","29",51048924,51063884,14960
"12327","ENSBTAG00000020243","8",99929908,100106553,176645
"12328","ENSBTAG00000020244","3",15466566,15473164,6598
"12329","ENSBTAG00000020247","4",65266775,65377107,110332
"12330","ENSBTAG00000020249","11",103271493,103279630,8137
"12331","ENSBTAG00000020250","21",22524664,22586295,61631
"12332","ENSBTAG00000020252","19",27087314,27098969,11655
"12333","ENSBTAG00000020253","19",27099426,27100767,1341
"12334","ENSBTAG00000020257","29",25991833,26050347,58514
"12335","ENSBTAG00000020260","22",56921625,56950322,28697
"12336","ENSBTAG00000020261","13",56552858,56590691,37833
"12337","ENSBTAG00000020262","11",36572842,36673067,100225
"12338","ENSBTAG00000020263","22",56946000,56952875,6875
"12339","ENSBTAG00000020264","16",37060066,37075789,15723
"12340","ENSBTAG00000020266","16",37095531,37128086,32555
"12341","ENSBTAG00000020267","7",3155441,3163239,7798
"12342","ENSBTAG00000020268","29",18188931,18332349,143418
"12343","ENSBTAG00000020269","7",43325602,43335553,9951
"12344","ENSBTAG00000020270","6",22205847,22328613,122766
"12345","ENSBTAG00000020272","15",21927820,22054213,126393
"12346","ENSBTAG00000020273","16",4869646,4871892,2246
"12347","ENSBTAG00000020277","15",22055674,22090012,34338
"12348","ENSBTAG00000020279","15",22105770,22219837,114067
"12349","ENSBTAG00000020281","10",43594044,43700027,105983
"12350","ENSBTAG00000020282","27",13880033,13916711,36678
"12351","ENSBTAG00000020283","26",31062738,31075701,12963
"12352","ENSBTAG00000020285","15",80580663,80584707,4044
"12353","ENSBTAG00000020286","24",24694637,24927333,232696
"12354","ENSBTAG00000020289","15",45737686,45740602,2916
"12355","ENSBTAG00000020294","5",103502498,103518817,16319
"12356","ENSBTAG00000020296","2",26314651,26517652,203001
"12357","ENSBTAG00000020297","11",86619510,86632431,12921
"12358","ENSBTAG00000020299","X",37321404,37333672,12268
"12359","ENSBTAG00000020300","X",37333943,37341870,7927
"12360","ENSBTAG00000020301","21",21840568,21933720,93152
"12361","ENSBTAG00000020302","22",38926794,38931475,4681
"12362","ENSBTAG00000020303","7",59800293,59865455,65162
"12363","ENSBTAG00000020304","26",25587524,25599939,12415
"12364","ENSBTAG00000020305","11",100196649,100205818,9169
"12365","ENSBTAG00000020307","11",100206261,100214788,8527
"12366","ENSBTAG00000020308","15",41870512,41881439,10927
"12367","ENSBTAG00000020309","7",62972675,63001442,28767
"12368","ENSBTAG00000020311","11",100215024,100259214,44190
"12369","ENSBTAG00000020312","14",33837784,34119578,281794
"12370","ENSBTAG00000020313","11",100264412,100399918,135506
"12371","ENSBTAG00000020314","28",45772443,45814853,42410
"12372","ENSBTAG00000020315","5",78374551,78590351,215800
"12373","ENSBTAG00000020316","19",14648905,14757836,108931
"12374","ENSBTAG00000020318","18",14764643,14772547,7904
"12375","ENSBTAG00000020319","28",44346285,44392546,46261
"12376","ENSBTAG00000020321","19",38376400,38384920,8520
"12377","ENSBTAG00000020327","10",85277621,85320048,42427
"12378","ENSBTAG00000020329","10",85321516,85333750,12234
"12379","ENSBTAG00000020330","5",22012139,22016602,4463
"12380","ENSBTAG00000020331","10",85333909,85348765,14856
"12381","ENSBTAG00000020332","15",82785664,82813519,27855
"12382","ENSBTAG00000020334","10",85351607,85377557,25950
"12383","ENSBTAG00000020335","4",118112314,118148730,36416
"12384","ENSBTAG00000020338","19",15120579,15156414,35835
"12385","ENSBTAG00000020340","19",15118728,15120467,1739
"12386","ENSBTAG00000020341","5",119477604,119540110,62506
"12387","ENSBTAG00000020342","16",39097744,39111961,14217
"12388","ENSBTAG00000020344","3",48601342,48687899,86557
"12389","ENSBTAG00000020345","3",48568965,48599126,30161
"12390","ENSBTAG00000020346","17",51757127,51793408,36281
"12391","ENSBTAG00000020348","11",2263560,2277825,14265
"12392","ENSBTAG00000020350","11",2282068,2284537,2469
"12393","ENSBTAG00000020351","7",38883110,38898157,15047
"12394","ENSBTAG00000020352","10",16171972,16268128,96156
"12395","ENSBTAG00000020353","7",38897710,38898256,546
"12396","ENSBTAG00000020355","8",97174615,97179335,4720
"12397","ENSBTAG00000020356","3",14893062,15038514,145452
"12398","ENSBTAG00000020357","3",20036707,20083521,46814
"12399","ENSBTAG00000020359","19",45080029,45137328,57299
"12400","ENSBTAG00000020361","28",6720734,7155385,434651
"12401","ENSBTAG00000020363","6",42263476,42395393,131917
"12402","ENSBTAG00000020366","25",1528333,1534807,6474
"12403","ENSBTAG00000020367","6",60859705,60946348,86643
"12404","ENSBTAG00000020369","25",1535120,1536935,1815
"12405","ENSBTAG00000020371","13",74608944,74621591,12647
"12406","ENSBTAG00000020373","22",42346408,42616730,270322
"12407","ENSBTAG00000020374","12",21650959,21679257,28298
"12408","ENSBTAG00000020376","20",31266844,31294238,27394
"12409","ENSBTAG00000020378","1",71513093,71780855,267762
"12410","ENSBTAG00000020379","10",85945768,85988421,42653
"12411","ENSBTAG00000020381","10",85987324,85998914,11590
"12412","ENSBTAG00000020382","13",39364968,39573516,208548
"12413","ENSBTAG00000020384","3",34331946,34394375,62429
"12414","ENSBTAG00000020385","8",62430631,62434231,3600
"12415","ENSBTAG00000020387","25",14044148,14079166,35018
"12416","ENSBTAG00000020389","12",78857711,78915642,57931
"12417","ENSBTAG00000020390","X",51168169,51177599,9430
"12418","ENSBTAG00000020391","24",24983757,25019913,36156
"12419","ENSBTAG00000020393","12",78920744,78929824,9080
"12420","ENSBTAG00000020394","3",19653958,19656771,2813
"12421","ENSBTAG00000020395","3",19645437,19653958,8521
"12422","ENSBTAG00000020397","13",57899598,57910385,10787
"12423","ENSBTAG00000020398","14",15616492,15618384,1892
"12424","ENSBTAG00000020399","14",15593322,15607732,14410
"12425","ENSBTAG00000020400","12",36114554,36115777,1223
"12426","ENSBTAG00000020402","21",68467407,68581286,113879
"12427","ENSBTAG00000020403","12",36133288,36195719,62431
"12428","ENSBTAG00000020404","1",145848081,145863601,15520
"12429","ENSBTAG00000020405","14",15553533,15560939,7406
"12430","ENSBTAG00000020406","X",17366350,17829036,462686
"12431","ENSBTAG00000020407","14",15383762,15553664,169902
"12432","ENSBTAG00000020409","1",145865673,145881365,15692
"12433","ENSBTAG00000020410","9",53248040,53314755,66715
"12434","ENSBTAG00000020412","12",74632896,74673056,40160
"12435","ENSBTAG00000020413","21",27956752,28095169,138417
"12436","ENSBTAG00000020414","17",50838143,50868907,30764
"12437","ENSBTAG00000020415","18",56902571,56906279,3708
"12438","ENSBTAG00000020416","2",85434967,85508402,73435
"12439","ENSBTAG00000020417","7",20040198,20053609,13411
"12440","ENSBTAG00000020418","X",127724914,127752302,27388
"12441","ENSBTAG00000020419","X",127697032,127707709,10677
"12442","ENSBTAG00000020420","X",127670367,127693758,23391
"12443","ENSBTAG00000020421","10",25771978,25806673,34695
"12444","ENSBTAG00000020422","10",25725926,25770778,44852
"12445","ENSBTAG00000020423","17",45045946,45134100,88154
"12446","ENSBTAG00000020425","23",23277603,23337345,59742
"12447","ENSBTAG00000020426","23",23375185,23406742,31557
"12448","ENSBTAG00000020427","26",17644945,17677623,32678
"12449","ENSBTAG00000020428","18",49086545,49091982,5437
"12450","ENSBTAG00000020429","18",49092003,49100532,8529
"12451","ENSBTAG00000020430","17",48170769,48286681,115912
"12452","ENSBTAG00000020431","19",26073451,26082008,8557
"12453","ENSBTAG00000020432","19",26068309,26073084,4775
"12454","ENSBTAG00000020433","19",26027728,26059636,31908
"12455","ENSBTAG00000020434","18",40317748,40330002,12254
"12456","ENSBTAG00000020436","8",77083416,77176341,92925
"12457","ENSBTAG00000020439","25",36983069,36991288,8219
"12458","ENSBTAG00000020440","25",36972761,36983656,10895
"12459","ENSBTAG00000020441","21",32555119,32632018,76899
"12460","ENSBTAG00000020444","3",100071214,100278380,207166
"12461","ENSBTAG00000020445","4",112258742,112281753,23011
"12462","ENSBTAG00000020446","7",20886519,20901121,14602
"12463","ENSBTAG00000020447","18",57407204,57436545,29341
"12464","ENSBTAG00000020448","4",112292273,112296263,3990
"12465","ENSBTAG00000020450","18",57436472,57437754,1282
"12466","ENSBTAG00000020451","3",83117927,83129455,11528
"12467","ENSBTAG00000020453","4",105219646,105231958,12312
"12468","ENSBTAG00000020454","13",52028270,52039191,10921
"12469","ENSBTAG00000020455","22",21523823,21876681,352858
"12470","ENSBTAG00000020456","1",143941826,144025795,83969
"12471","ENSBTAG00000020457","18",50484512,50508692,24180
"12472","ENSBTAG00000020458","16",62097520,62148288,50768
"12473","ENSBTAG00000020459","5",56937139,56964713,27574
"12474","ENSBTAG00000020460","1",54058687,54070616,11929
"12475","ENSBTAG00000020465","13",48251375,48312017,60642
"12476","ENSBTAG00000020466","15",8786754,9437352,650598
"12477","ENSBTAG00000020467","24",32211669,32225654,13985
"12478","ENSBTAG00000020468","27",20100980,20175208,74228
"12479","ENSBTAG00000020469","10",88551975,88581712,29737
"12480","ENSBTAG00000020471","10",88581733,88593184,11451
"12481","ENSBTAG00000020472","5",107225327,107290351,65024
"12482","ENSBTAG00000020474","10",88594829,88615634,20805
"12483","ENSBTAG00000020475","10",88621488,88648386,26898
"12484","ENSBTAG00000020477","10",88648515,88656337,7822
"12485","ENSBTAG00000020480","10",88689279,88784551,95272
"12486","ENSBTAG00000020481","22",28728642,28789368,60726
"12487","ENSBTAG00000020482","9",49096929,49429819,332890
"12488","ENSBTAG00000020484","4",103994401,104008963,14562
"12489","ENSBTAG00000020485","15",54480057,54553148,73091
"12490","ENSBTAG00000020489","7",37316829,37446102,129273
"12491","ENSBTAG00000020490","11",103518410,103598058,79648
"12492","ENSBTAG00000020491","7",69255959,69297638,41679
"12493","ENSBTAG00000020495","8",112764036,112825612,61576
"12494","ENSBTAG00000020496","23",33054916,33067994,13078
"12495","ENSBTAG00000020498","8",112748923,112763330,14407
"12496","ENSBTAG00000020499","2",132561689,132574083,12394
"12497","ENSBTAG00000020503","17",52320433,52322700,2267
"12498","ENSBTAG00000020504","17",52307619,52318172,10553
"12499","ENSBTAG00000020505","17",52247385,52289589,42204
"12500","ENSBTAG00000020510","3",108149712,108190353,40641
"12501","ENSBTAG00000020512","X",79421765,79428791,7026
"12502","ENSBTAG00000020513","X",79444319,79450890,6571
"12503","ENSBTAG00000020514","21",8189560,8265087,75527
"12504","ENSBTAG00000020515","15",46801428,46827698,26270
"12505","ENSBTAG00000020516","8",79402793,79425795,23002
"12506","ENSBTAG00000020517","19",34822995,34828048,5053
"12507","ENSBTAG00000020518","16",45400213,45416993,16780
"12508","ENSBTAG00000020520","19",34819717,34821443,1726
"12509","ENSBTAG00000020522","X",50014321,50028962,14641
"12510","ENSBTAG00000020523","14",80891013,80892329,1316
"12511","ENSBTAG00000020524","25",34519493,34524678,5185
"12512","ENSBTAG00000020525","6",97653816,97713798,59982
"12513","ENSBTAG00000020527","2",96510261,96532002,21741
"12514","ENSBTAG00000020528","25",35954405,35959426,5021
"12515","ENSBTAG00000020530","12",32482758,32486422,3664
"12516","ENSBTAG00000020532","17",49756757,49757212,455
"12517","ENSBTAG00000020533","10",67753220,67834512,81292
"12518","ENSBTAG00000020535","25",27285067,27286399,1332
"12519","ENSBTAG00000020536","6",36309915,36367045,57130
"12520","ENSBTAG00000020537","2",107443938,107465693,21755
"12521","ENSBTAG00000020538","6",36257293,36302174,44881
"12522","ENSBTAG00000020539","2",107462147,107472033,9886
"12523","ENSBTAG00000020540","2",107472513,107478573,6060
"12524","ENSBTAG00000020541","6",36250083,36253466,3383
"12525","ENSBTAG00000020542","3",16086187,16104559,18372
"12526","ENSBTAG00000020543","18",46396872,46405054,8182
"12527","ENSBTAG00000020544","25",33651490,33669383,17893
"12528","ENSBTAG00000020546","13",31562568,31614429,51861
"12529","ENSBTAG00000020547","X",36926664,36955731,29067
"12530","ENSBTAG00000020548","2",120568184,120614958,46774
"12531","ENSBTAG00000020551","X",36955969,36973721,17752
"12532","ENSBTAG00000020552","16",53788899,53921908,133009
"12533","ENSBTAG00000020554","23",27685449,27687723,2274
"12534","ENSBTAG00000020555","13",61041375,61051806,10431
"12535","ENSBTAG00000020556","18",52652024,52654402,2378
"12536","ENSBTAG00000020558","18",52654220,52657199,2979
"12537","ENSBTAG00000020559","23",40127834,40149352,21518
"12538","ENSBTAG00000020560","18",52663736,52691346,27610
"12539","ENSBTAG00000020561","X",119240316,119269365,29049
"12540","ENSBTAG00000020563","16",79300366,79317794,17428
"12541","ENSBTAG00000020564","5",44246155,44252023,5868
"12542","ENSBTAG00000020566","17",71710952,71794863,83911
"12543","ENSBTAG00000020567","11",20910393,20948016,37623
"12544","ENSBTAG00000020569","4",38152730,38673177,520447
"12545","ENSBTAG00000020570","6",94882088,94888983,6895
"12546","ENSBTAG00000020573","15",43499994,43568212,68218
"12547","ENSBTAG00000020575","11",82964863,82966228,1365
"12548","ENSBTAG00000020578","7",30616932,30725290,108358
"12549","ENSBTAG00000020580","15",83058088,83073458,15370
"12550","ENSBTAG00000020582","25",2178123,2182818,4695
"12551","ENSBTAG00000020583","6",71742769,71771956,29187
"12552","ENSBTAG00000020584","17",54062673,54200209,137536
"12553","ENSBTAG00000020589","26",17182841,17283172,100331
"12554","ENSBTAG00000020590","19",44328506,44330388,1882
"12555","ENSBTAG00000020591","16",39142255,39170889,28634
"12556","ENSBTAG00000020592","3",119672384,119673856,1472
"12557","ENSBTAG00000020594","17",18474845,18574676,99831
"12558","ENSBTAG00000020595","23",10377039,10413105,36066
"12559","ENSBTAG00000020596","29",9925891,9932507,6616
"12560","ENSBTAG00000020597","16",38649218,38676447,27229
"12561","ENSBTAG00000020598","6",102716789,102881084,164295
"12562","ENSBTAG00000020600","29",45039827,45049329,9502
"12563","ENSBTAG00000020601","20",9113036,9176650,63614
"12564","ENSBTAG00000020602","27",35026772,35040351,13579
"12565","ENSBTAG00000020605","19",25091088,25113142,22054
"12566","ENSBTAG00000020606","2",107158435,107162015,3580
"12567","ENSBTAG00000020607","2",107162129,107169762,7633
"12568","ENSBTAG00000020608","2",107170269,107179679,9410
"12569","ENSBTAG00000020609","28",39303454,39306025,2571
"12570","ENSBTAG00000020610","2",107179983,107186463,6480
"12571","ENSBTAG00000020611","2",107186405,107194793,8388
"12572","ENSBTAG00000020612","12",21551352,21575176,23824
"12573","ENSBTAG00000020613","2",107194871,107198250,3379
"12574","ENSBTAG00000020614","11",28303215,28635155,331940
"12575","ENSBTAG00000020615","7",8148716,8158332,9616
"12576","ENSBTAG00000020616","3",113062330,113172640,110310
"12577","ENSBTAG00000020617","25",1595164,1626005,30841
"12578","ENSBTAG00000020619","25",1627217,1665417,38200
"12579","ENSBTAG00000020620","4",58359235,58359870,635
"12580","ENSBTAG00000020622","3",105807211,105810027,2816
"12581","ENSBTAG00000020626","8",82558294,82712671,154377
"12582","ENSBTAG00000020629","19",35453978,35513087,59109
"12583","ENSBTAG00000020630","11",49941280,50018731,77451
"12584","ENSBTAG00000020632","18",36784720,36798053,13333
"12585","ENSBTAG00000020633","18",36812455,36829147,16692
"12586","ENSBTAG00000020634","5",71099853,71120096,20243
"12587","ENSBTAG00000020635","3",20490334,20556989,66655
"12588","ENSBTAG00000020636","5",71116001,71201217,85216
"12589","ENSBTAG00000020638","5",71388890,71459269,70379
"12590","ENSBTAG00000020641","3",34012638,34033681,21043
"12591","ENSBTAG00000020642","29",25774040,25825170,51130
"12592","ENSBTAG00000020643","29",32611045,32693235,82190
"12593","ENSBTAG00000020644","X",17148957,17257298,108341
"12594","ENSBTAG00000020645","22",50099960,50120260,20300
"12595","ENSBTAG00000020646","11",144638,189991,45353
"12596","ENSBTAG00000020647","6",68530371,68534898,4527
"12597","ENSBTAG00000020648","6",68538960,68936021,397061
"12598","ENSBTAG00000020649","25",9542154,9600304,58150
"12599","ENSBTAG00000020650","24",35733350,35739930,6580
"12600","ENSBTAG00000020652","2",121199686,121201566,1880
"12601","ENSBTAG00000020653","6",68940818,69005828,65010
"12602","ENSBTAG00000020654","2",36715262,37045806,330544
"12603","ENSBTAG00000020655","2",121176081,121199884,23803
"12604","ENSBTAG00000020657","27",16420193,16546078,125885
"12605","ENSBTAG00000020658","6",69006787,69194162,187375
"12606","ENSBTAG00000020661","8",94603862,94719841,115979
"12607","ENSBTAG00000020662","5",57449443,57498922,49479
"12608","ENSBTAG00000020663","5",57446157,57449119,2962
"12609","ENSBTAG00000020664","5",57438695,57446182,7487
"12610","ENSBTAG00000020665","8",68994965,69102515,107550
"12611","ENSBTAG00000020667","14",8738181,9029965,291784
"12612","ENSBTAG00000020668","13",47546444,47547502,1058
"12613","ENSBTAG00000020671","2",120514777,120551870,37093
"12614","ENSBTAG00000020672","3",112750881,112763801,12920
"12615","ENSBTAG00000020674","23",27712125,27713962,1837
"12616","ENSBTAG00000020676","13",74746976,74754303,7327
"12617","ENSBTAG00000020679","5",39772742,40037754,265012
"12618","ENSBTAG00000020681","12",18729068,18840733,111665
"12619","ENSBTAG00000020684","12",56097142,56098612,1470
"12620","ENSBTAG00000020688","19",27923680,27934590,10910
"12621","ENSBTAG00000020689","18",53006181,53021456,15275
"12622","ENSBTAG00000020693","14",16714564,16738151,23587
"12623","ENSBTAG00000020696","2",84741175,85088822,347647
"12624","ENSBTAG00000020698","16",41872926,41891179,18253
"12625","ENSBTAG00000020699","5",106485063,106549798,64735
"12626","ENSBTAG00000020700","16",41838757,41872918,34161
"12627","ENSBTAG00000020701","7",88250023,88407702,157679
"12628","ENSBTAG00000020704","4",76444976,76493685,48709
"12629","ENSBTAG00000020705","6",6782939,6860029,77090
"12630","ENSBTAG00000020707","9",79769693,79920880,151187
"12631","ENSBTAG00000020709","7",5408672,5440703,32031
"12632","ENSBTAG00000020710","23",22263107,22280742,17635
"12633","ENSBTAG00000020713","9",60047260,60341240,293980
"12634","ENSBTAG00000020714","18",1762017,1783618,21601
"12635","ENSBTAG00000020715","5",91399521,91842738,443217
"12636","ENSBTAG00000020717","X",98556749,98600578,43829
"12637","ENSBTAG00000020720","7",2996902,3000276,3374
"12638","ENSBTAG00000020721","7",2993262,2997182,3920
"12639","ENSBTAG00000020725","X",34207163,34223860,16697
"12640","ENSBTAG00000020726","12",85435193,85536271,101078
"12641","ENSBTAG00000020729","10",72362347,72385747,23400
"12642","ENSBTAG00000020731","15",63515385,63530238,14853
"12643","ENSBTAG00000020733","25",16423491,16429311,5820
"12644","ENSBTAG00000020735","25",16448218,16543421,95203
"12645","ENSBTAG00000020736","13",74842191,74853116,10925
"12646","ENSBTAG00000020737","25",788526,793121,4595
"12647","ENSBTAG00000020739","X",57950305,57957664,7359
"12648","ENSBTAG00000020745","3",104538208,104671493,133285
"12649","ENSBTAG00000020746","15",78585013,78585975,962
"12650","ENSBTAG00000020747","11",100770166,100822252,52086
"12651","ENSBTAG00000020748","15",14489040,14509960,20920
"12652","ENSBTAG00000020749","8",83378729,83396706,17977
"12653","ENSBTAG00000020750","X",31117611,31651654,534043
"12654","ENSBTAG00000020751","14",613328,634349,21021
"12655","ENSBTAG00000020752","8",54148387,54183987,35600
"12656","ENSBTAG00000020754","18",51044301,51049257,4956
"12657","ENSBTAG00000020755","16",37241577,37284986,43409
"12658","ENSBTAG00000020756","18",51032328,51042229,9901
"12659","ENSBTAG00000020757","5",26540444,26559860,19416
"12660","ENSBTAG00000020758","5",26525843,26540451,14608
"12661","ENSBTAG00000020759","7",20631429,20645731,14302
"12662","ENSBTAG00000020760","17",72268871,72277819,8948
"12663","ENSBTAG00000020761","3",66900556,66959868,59312
"12664","ENSBTAG00000020762","1",3501645,3629427,127782
"12665","ENSBTAG00000020764","7",43534716,43543285,8569
"12666","ENSBTAG00000020766","7",43545179,43561826,16647
"12667","ENSBTAG00000020769","29",33982760,34507701,524941
"12668","ENSBTAG00000020772","7",43563371,43575583,12212
"12669","ENSBTAG00000020773","29",43995912,43999323,3411
"12670","ENSBTAG00000020774","19",10403579,10404250,671
"12671","ENSBTAG00000020775","29",43999490,44003899,4409
"12672","ENSBTAG00000020776","7",43579125,43583576,4451
"12673","ENSBTAG00000020777","2",5248748,5279066,30318
"12674","ENSBTAG00000020780","7",43592131,43635409,43278
"12675","ENSBTAG00000020781","18",26299649,26305367,5718
"12676","ENSBTAG00000020782","18",26304976,26388347,83371
"12677","ENSBTAG00000020783","23",9969009,10044336,75327
"12678","ENSBTAG00000020784","5",17119778,17120428,650
"12679","ENSBTAG00000020787","1",151476118,151562607,86489
"12680","ENSBTAG00000020788","8",67230476,67282360,51884
"12681","ENSBTAG00000020789","X",135464887,135622063,157176
"12682","ENSBTAG00000020790","26",11778619,11779418,799
"12683","ENSBTAG00000020791","11",101696993,101834040,137047
"12684","ENSBTAG00000020792","5",1542142,1644590,102448
"12685","ENSBTAG00000020793","15",60728577,60736043,7466
"12686","ENSBTAG00000020795","13",54866473,54867802,1329
"12687","ENSBTAG00000020796","26",666753,703300,36547
"12688","ENSBTAG00000020797","13",54853814,54865432,11618
"12689","ENSBTAG00000020798","3",111552563,111568286,15723
"12690","ENSBTAG00000020799","11",11625730,12344742,719012
"12691","ENSBTAG00000020800","13",28142114,28228457,86343
"12692","ENSBTAG00000020801","14",10694730,10778921,84191
"12693","ENSBTAG00000020802","22",43653910,43831370,177460
"12694","ENSBTAG00000020806","5",47481804,47519482,37678
"12695","ENSBTAG00000020807","29",43326671,43328299,1628
"12696","ENSBTAG00000020809","7",62558340,62584878,26538
"12697","ENSBTAG00000020810","19",47767184,47779681,12497
"12698","ENSBTAG00000020813","13",73496855,73499231,2376
"12699","ENSBTAG00000020814","10",47902447,47904131,1684
"12700","ENSBTAG00000020815","8",38320192,38392701,72509
"12701","ENSBTAG00000020817","9",9970661,10070666,100005
"12702","ENSBTAG00000020819","21",65168061,65193179,25118
"12703","ENSBTAG00000020824","19",41008991,41013346,4355
"12704","ENSBTAG00000020825","9",18468160,18482607,14447
"12705","ENSBTAG00000020826","X",77318642,77359466,40824
"12706","ENSBTAG00000020829","9",66006739,66619640,612901
"12707","ENSBTAG00000020831","3",22381862,22446397,64535
"12708","ENSBTAG00000020835","18",11137546,11185073,47527
"12709","ENSBTAG00000020836","18",11191535,11203373,11838
"12710","ENSBTAG00000020837","16",49542330,49566060,23730
"12711","ENSBTAG00000020839","16",49436521,49536217,99696
"12712","ENSBTAG00000020843","7",95746303,95790112,43809
"12713","ENSBTAG00000020844","8",91193846,91231896,38050
"12714","ENSBTAG00000020848","4",47988419,48021445,33026
"12715","ENSBTAG00000020850","2",132115901,132123552,7651
"12716","ENSBTAG00000020852","19",26825722,26827663,1941
"12717","ENSBTAG00000020853","19",26821869,26825360,3491
"12718","ENSBTAG00000020854","19",26813394,26817380,3986
"12719","ENSBTAG00000020855","2",71546908,71733059,186151
"12720","ENSBTAG00000020856","3",51980905,52089071,108166
"12721","ENSBTAG00000020858","12",87072437,87083048,10611
"12722","ENSBTAG00000020859","19",22832192,22840471,8279
"12723","ENSBTAG00000020860","7",98079213,98154532,75319
"12724","ENSBTAG00000020861","12",87088127,87097222,9095
"12725","ENSBTAG00000020865","11",62517245,62573809,56564
"12726","ENSBTAG00000020869","4",5336436,5441308,104872
"12727","ENSBTAG00000020872","18",54313941,54328002,14061
"12728","ENSBTAG00000020873","11",49465580,49472218,6638
"12729","ENSBTAG00000020878","4",33249637,33286857,37220
"12730","ENSBTAG00000020880","10",70333003,70474703,141700
"12731","ENSBTAG00000020883","17",35217965,35222747,4782
"12732","ENSBTAG00000020884","15",3250231,3269687,19456
"12733","ENSBTAG00000020886","16",73447321,73474258,26937
"12734","ENSBTAG00000020887","16",62415671,62941402,525731
"12735","ENSBTAG00000020889","18",34540150,34557910,17760
"12736","ENSBTAG00000020890","15",43910845,43941742,30897
"12737","ENSBTAG00000020892","13",17455360,17500714,45354
"12738","ENSBTAG00000020893","11",78828218,78841622,13404
"12739","ENSBTAG00000020894","11",78796769,78814735,17966
"12740","ENSBTAG00000020895","26",19336344,19358875,22531
"12741","ENSBTAG00000020896","25",40800339,40801701,1362
"12742","ENSBTAG00000020898","25",40821751,40840680,18929
"12743","ENSBTAG00000020900","29",29550484,29561927,11443
"12744","ENSBTAG00000020904","7",5306153,5323991,17838
"12745","ENSBTAG00000020905","2",129168191,129198058,29867
"12746","ENSBTAG00000020907","19",42650230,42654921,4691
"12747","ENSBTAG00000020911","15",77492393,77513241,20848
"12748","ENSBTAG00000020914","5",42193677,42472416,278739
"12749","ENSBTAG00000020919","4",68797645,68801018,3373
"12750","ENSBTAG00000020921","25",21505000,21881068,376068
"12751","ENSBTAG00000020922","7",4336942,4368789,31847
"12752","ENSBTAG00000020923","7",4333080,4334822,1742
"12753","ENSBTAG00000020924","7",12806915,12811898,4983
"12754","ENSBTAG00000020927","23",7391656,7393771,2115
"12755","ENSBTAG00000020928","12",86648081,86661391,13310
"12756","ENSBTAG00000020929","13",23964738,24056173,91435
"12757","ENSBTAG00000020930","21",49119054,49140569,21515
"12758","ENSBTAG00000020931","4",66634935,66970909,335974
"12759","ENSBTAG00000020933","5",67711299,67799061,87762
"12760","ENSBTAG00000020934","10",65243731,65262569,18838
"12761","ENSBTAG00000020935","10",73836334,73881299,44965
"12762","ENSBTAG00000020936","18",19089956,19119730,29774
"12763","ENSBTAG00000020937","10",73888955,73919879,30924
"12764","ENSBTAG00000020938","5",36650631,36662898,12267
"12765","ENSBTAG00000020939","28",35166730,35178797,12067
"12766","ENSBTAG00000020940","28",35119177,35161497,42320
"12767","ENSBTAG00000020942","18",13924376,13932707,8331
"12768","ENSBTAG00000020943","18",13919854,13939801,19947
"12769","ENSBTAG00000020944","18",13938926,13995874,56948
"12770","ENSBTAG00000020947","11",48278953,48302184,23231
"12771","ENSBTAG00000020953","16",8917769,8920224,2455
"12772","ENSBTAG00000020954","7",40326943,40341657,14714
"12773","ENSBTAG00000020956","15",61161268,61371379,210111
"12774","ENSBTAG00000020957","2",96039164,96040921,1757
"12775","ENSBTAG00000020958","3",53313193,53443924,130731
"12776","ENSBTAG00000020959","11",99200518,99206514,5996
"12777","ENSBTAG00000020961","2",13474287,13490743,16456
"12778","ENSBTAG00000020963","22",50006693,50015926,9233
"12779","ENSBTAG00000020964","3",33374163,33393926,19763
"12780","ENSBTAG00000020965","22",50002503,50006742,4239
"12781","ENSBTAG00000020966","3",33360536,33370572,10036
"12782","ENSBTAG00000020968","3",752398,783103,30705
"12783","ENSBTAG00000020969","3",572630,752300,179670
"12784","ENSBTAG00000020973","22",47812822,47852306,39484
"12785","ENSBTAG00000020975","23",7595783,7624654,28871
"12786","ENSBTAG00000020979","19",37093181,37112123,18942
"12787","ENSBTAG00000020980","15",64975271,65011223,35952
"12788","ENSBTAG00000020981","26",13778743,13829852,51109
"12789","ENSBTAG00000020983","18",56042097,56045849,3752
"12790","ENSBTAG00000020984","2",23607682,23937801,330119
"12791","ENSBTAG00000020985","8",31632080,31648326,16246
"12792","ENSBTAG00000020987","X",119819957,119873105,53148
"12793","ENSBTAG00000020988","13",40490248,40583448,93200
"12794","ENSBTAG00000020989","16",26686341,26820061,133720
"12795","ENSBTAG00000020990","1",116847497,116879544,32047
"12796","ENSBTAG00000020992","19",17824308,17875792,51484
"12797","ENSBTAG00000020994","19",17806067,17817147,11080
"12798","ENSBTAG00000020996","1",42822730,42830190,7460
"12799","ENSBTAG00000020997","1",42839325,42840401,1076
"12800","ENSBTAG00000020998","22",59509018,59540337,31319
"12801","ENSBTAG00000020999","15",77097152,77118221,21069
"12802","ENSBTAG00000021000","1",58345399,58392043,46644
"12803","ENSBTAG00000021002","15",77118095,77125767,7672
"12804","ENSBTAG00000021003","24",2145784,2156850,11066
"12805","ENSBTAG00000021007","15",51792671,51805078,12407
"12806","ENSBTAG00000021008","10",25997903,26000852,2949
"12807","ENSBTAG00000021009","14",30469248,30495868,26620
"12808","ENSBTAG00000021013","7",17981998,17988028,6030
"12809","ENSBTAG00000021015","26",46615113,46676281,61168
"12810","ENSBTAG00000021016","7",18063616,18069587,5971
"12811","ENSBTAG00000021018","7",18035388,18047821,12433
"12812","ENSBTAG00000021019","10",64947924,64973980,26056
"12813","ENSBTAG00000021020","2",44660223,44709690,49467
"12814","ENSBTAG00000021021","21",33543461,33548530,5069
"12815","ENSBTAG00000021023","3",110330490,110491582,161092
"12816","ENSBTAG00000021024","3",106591094,106927295,336201
"12817","ENSBTAG00000021025","1",77130100,77309576,179476
"12818","ENSBTAG00000021026","X",81293360,81298004,4644
"12819","ENSBTAG00000021029","15",66763111,66918831,155720
"12820","ENSBTAG00000021033","13",72150159,72175597,25438
"12821","ENSBTAG00000021035","3",19953196,19966177,12981
"12822","ENSBTAG00000021036","7",17038180,17052477,14297
"12823","ENSBTAG00000021037","3",19884889,19949933,65044
"12824","ENSBTAG00000021039","7",17058539,17098633,40094
"12825","ENSBTAG00000021041","7",17099634,17108565,8931
"12826","ENSBTAG00000021045","23",37486847,37569408,82561
"12827","ENSBTAG00000021046","3",96071533,96166159,94626
"12828","ENSBTAG00000021048","15",42377564,42380500,2936
"12829","ENSBTAG00000021050","2",120118128,120125755,7627
"12830","ENSBTAG00000021051","3",58374383,58469385,95002
"12831","ENSBTAG00000021052","17",72838215,72866148,27933
"12832","ENSBTAG00000021057","18",62106899,62110115,3216
"12833","ENSBTAG00000021058","19",48043369,48071078,27709
"12834","ENSBTAG00000021059","X",49576205,49597762,21557
"12835","ENSBTAG00000021060","19",48069139,48077245,8106
"12836","ENSBTAG00000021061","19",48077622,48082227,4605
"12837","ENSBTAG00000021062","19",48082267,48091889,9622
"12838","ENSBTAG00000021065","26",23071864,23089451,17587
"12839","ENSBTAG00000021066","23",17689202,17695277,6075
"12840","ENSBTAG00000021067","26",23088515,23104847,16332
"12841","ENSBTAG00000021068","26",23107885,23250604,142719
"12842","ENSBTAG00000021069","8",10953326,10986286,32960
"12843","ENSBTAG00000021071","26",23265725,23279452,13727
"12844","ENSBTAG00000021072","11",73701587,73941286,239699
"12845","ENSBTAG00000021073","4",102495608,102614462,118854
"12846","ENSBTAG00000021076","5",111480932,111657764,176832
"12847","ENSBTAG00000021077","23",25607502,25622150,14648
"12848","ENSBTAG00000021078","5",88729876,88756498,26622
"12849","ENSBTAG00000021079","3",102741183,102744239,3056
"12850","ENSBTAG00000021082","3",102754385,102756240,1855
"12851","ENSBTAG00000021083","5",88697522,88730250,32728
"12852","ENSBTAG00000021087","10",38181492,38333647,152155
"12853","ENSBTAG00000021090","25",14330467,14480730,150263
"12854","ENSBTAG00000021091","19",24725920,24776748,50828
"12855","ENSBTAG00000021092","14",76530194,76586635,56441
"12856","ENSBTAG00000021093","18",49122732,49125260,2528
"12857","ENSBTAG00000021096","13",54056133,54076535,20402
"12858","ENSBTAG00000021097","29",44507584,44520056,12472
"12859","ENSBTAG00000021099","9",28261741,28338600,76859
"12860","ENSBTAG00000021100","X",87307441,87324942,17501
"12861","ENSBTAG00000021101","3",42742344,42744302,1958
"12862","ENSBTAG00000021102","11",21021076,21075762,54686
"12863","ENSBTAG00000021103","2",65335291,65377141,41850
"12864","ENSBTAG00000021105","5",36680680,36708918,28238
"12865","ENSBTAG00000021106","7",8096913,8113871,16958
"12866","ENSBTAG00000021107","9",84506918,84661261,154343
"12867","ENSBTAG00000021109","16",30685987,30691637,5650
"12868","ENSBTAG00000021111","23",27982798,27987297,4499
"12869","ENSBTAG00000021113","19",33880139,33886171,6032
"12870","ENSBTAG00000021115","7",42630682,42639054,8372
"12871","ENSBTAG00000021116","26",14225044,14401744,176700
"12872","ENSBTAG00000021118","26",14416061,14419635,3574
"12873","ENSBTAG00000021119","22",52867448,52872061,4613
"12874","ENSBTAG00000021120","11",47933130,47977936,44806
"12875","ENSBTAG00000021121","17",72082606,72100535,17929
"12876","ENSBTAG00000021125","15",77526748,77570322,43574
"12877","ENSBTAG00000021127","8",53465620,53665709,200089
"12878","ENSBTAG00000021128","6",115811540,115902662,91122
"12879","ENSBTAG00000021130","6",115807625,115811707,4082
"12880","ENSBTAG00000021131","8",77218395,77229651,11256
"12881","ENSBTAG00000021132","28",29626166,29634566,8400
"12882","ENSBTAG00000021133","27",13483623,13772466,288843
"12883","ENSBTAG00000021134","7",19428848,19469011,40163
"12884","ENSBTAG00000021135","8",77241944,77244793,2849
"12885","ENSBTAG00000021140","11",48137705,48196047,58342
"12886","ENSBTAG00000021141","11",48118023,48125256,7233
"12887","ENSBTAG00000021143","11",73971560,74074893,103333
"12888","ENSBTAG00000021144","21",32115815,32160464,44649
"12889","ENSBTAG00000021145","18",48365478,48382850,17372
"12890","ENSBTAG00000021147","15",46100648,46101571,923
"12891","ENSBTAG00000021151","19",28063029,28183409,120380
"12892","ENSBTAG00000021156","14",16631171,16698112,66941
"12893","ENSBTAG00000021157","18",62216820,62228726,11906
"12894","ENSBTAG00000021158","1",155431343,155525165,93822
"12895","ENSBTAG00000021160","7",15074208,15086196,11988
"12896","ENSBTAG00000021161","11",6246765,6264954,18189
"12897","ENSBTAG00000021162","12",21581305,21607193,25888
"12898","ENSBTAG00000021164","22",43322856,43471741,148885
"12899","ENSBTAG00000021165","18",14582685,14592543,9858
"12900","ENSBTAG00000021168","17",62623628,62639894,16266
"12901","ENSBTAG00000021170","3",94541126,94702613,161487
"12902","ENSBTAG00000021172","2",5031102,5057954,26852
"12903","ENSBTAG00000021173","5",112813754,112828982,15228
"12904","ENSBTAG00000021174","3",94437449,94540296,102847
"12905","ENSBTAG00000021176","18",10980201,11046041,65840
"12906","ENSBTAG00000021177","28",26827396,26922026,94630
"12907","ENSBTAG00000021180","28",26937388,26951865,14477
"12908","ENSBTAG00000021181","11",1585412,1618575,33163
"12909","ENSBTAG00000021182","4",56119633,56598768,479135
"12910","ENSBTAG00000021183","28",6201972,6259932,57960
"12911","ENSBTAG00000021187","11",88604880,88607401,2521
"12912","ENSBTAG00000021188","15",83015663,83019903,4240
"12913","ENSBTAG00000021189","X",15104472,15112740,8268
"12914","ENSBTAG00000021190","24",28655047,28904115,249068
"12915","ENSBTAG00000021191","18",54627967,54646687,18720
"12916","ENSBTAG00000021192","18",54647475,54657052,9577
"12917","ENSBTAG00000021193","9",89878673,89889302,10629
"12918","ENSBTAG00000021195","26",8455337,8549031,93694
"12919","ENSBTAG00000021196","5",68528021,68565881,37860
"12920","ENSBTAG00000021199","21",68196002,68222814,26812
"12921","ENSBTAG00000021201","2",89605073,89661226,56153
"12922","ENSBTAG00000021202","16",46978211,47087033,108822
"12923","ENSBTAG00000021204","4",52169888,52225054,55166
"12924","ENSBTAG00000021208","14",62133632,62171095,37463
"12925","ENSBTAG00000021209","14",61987835,62126918,139083
"12926","ENSBTAG00000021210","16",46949991,46952597,2606
"12927","ENSBTAG00000021211","16",36297418,36334185,36767
"12928","ENSBTAG00000021214","6",110760351,110805803,45452
"12929","ENSBTAG00000021215","29",26920817,26950666,29849
"12930","ENSBTAG00000021216","4",77539351,77804239,264888
"12931","ENSBTAG00000021217","3",40305057,40530663,225606
"12932","ENSBTAG00000021218","25",26558869,26561866,2997
"12933","ENSBTAG00000021219","25",26562037,26565656,3619
"12934","ENSBTAG00000021222","25",26583806,26592180,8374
"12935","ENSBTAG00000021223","15",75879778,75915413,35635
"12936","ENSBTAG00000021224","20",17842584,18052859,210275
"12937","ENSBTAG00000021226","7",46133106,46163331,30225
"12938","ENSBTAG00000021227","19",56398798,56404689,5891
"12939","ENSBTAG00000021230","11",49329763,49340734,10971
"12940","ENSBTAG00000021231","19",56387312,56398710,11398
"12941","ENSBTAG00000021232","13",53939530,53955455,15925
"12942","ENSBTAG00000021237","23",3622403,3767049,144646
"12943","ENSBTAG00000021240","14",60265369,60283636,18267
"12944","ENSBTAG00000021242","25",16902938,16916479,13541
"12945","ENSBTAG00000021245","17",34353125,34357245,4120
"12946","ENSBTAG00000021248","25",38418897,38430419,11522
"12947","ENSBTAG00000021249","25",25862056,25866924,4868
"12948","ENSBTAG00000021250","24",41621467,41638744,17277
"12949","ENSBTAG00000021251","1",142011078,142037290,26212
"12950","ENSBTAG00000021252","X",51064361,51076881,12520
"12951","ENSBTAG00000021253","1",142065605,142132485,66880
"12952","ENSBTAG00000021254","X",50994358,51062479,68121
"12953","ENSBTAG00000021257","19",56490534,56499714,9180
"12954","ENSBTAG00000021259","1",142142610,142204837,62227
"12955","ENSBTAG00000021260","4",114567409,114591694,24285
"12956","ENSBTAG00000021262","17",71496420,71513527,17107
"12957","ENSBTAG00000021263","27",16249747,16266690,16943
"12958","ENSBTAG00000021270","1",142327757,142403210,75453
"12959","ENSBTAG00000021272","1",142488705,142561127,72422
"12960","ENSBTAG00000021273","21",21590158,21616772,26614
"12961","ENSBTAG00000021275","21",21614984,21621988,7004
"12962","ENSBTAG00000021276","1",142565466,142569246,3780
"12963","ENSBTAG00000021280","1",142660182,142680495,20313
"12964","ENSBTAG00000021282","4",11992415,12063687,71272
"12965","ENSBTAG00000021283","11",86784119,86786428,2309
"12966","ENSBTAG00000021284","1",142759178,142772547,13369
"12967","ENSBTAG00000021286","1",142814827,142872558,57731
"12968","ENSBTAG00000021287","5",53698084,53892992,194908
"12969","ENSBTAG00000021288","3",19371017,19374091,3074
"12970","ENSBTAG00000021289","3",19322591,19369632,47041
"12971","ENSBTAG00000021291","21",35027776,35267297,239521
"12972","ENSBTAG00000021292","19",7149813,7279813,130000
"12973","ENSBTAG00000021293","21",33274068,33291567,17499
"12974","ENSBTAG00000021294","16",51109184,51114581,5397
"12975","ENSBTAG00000021298","16",37760258,37778238,17980
"12976","ENSBTAG00000021301","19",36241221,36273291,32070
"12977","ENSBTAG00000021302","19",36246996,36251557,4561
"12978","ENSBTAG00000021303","19",36230418,36240063,9645
"12979","ENSBTAG00000021304","21",55165216,55233029,67813
"12980","ENSBTAG00000021306","15",54008949,54042826,33877
"12981","ENSBTAG00000021307","8",73631225,73654614,23389
"12982","ENSBTAG00000021308","2",114988515,115174824,186309
"12983","ENSBTAG00000021310","2",115168918,115226839,57921
"12984","ENSBTAG00000021313","4",32564174,32731459,167285
"12985","ENSBTAG00000021316","2",115318013,115478018,160005
"12986","ENSBTAG00000021318","21",33697290,33718541,21251
"12987","ENSBTAG00000021319","2",115486532,115514827,28295
"12988","ENSBTAG00000021321","13",59804887,59814236,9349
"12989","ENSBTAG00000021322","2",115519318,115530237,10919
"12990","ENSBTAG00000021323","2",115629949,115704725,74776
"12991","ENSBTAG00000021325","2",115812583,115843935,31352
"12992","ENSBTAG00000021326","2",115948258,115951955,3697
"12993","ENSBTAG00000021327","2",115992779,116028253,35474
"12994","ENSBTAG00000021328","2",116086973,116277103,190130
"12995","ENSBTAG00000021329","29",41056640,41058181,1541
"12996","ENSBTAG00000021333","16",1936120,1946132,10012
"12997","ENSBTAG00000021334","24",49142850,49148194,5344
"12998","ENSBTAG00000021336","5",55902461,55931562,29101
"12999","ENSBTAG00000021337","5",119752572,119784086,31514
"13000","ENSBTAG00000021338","15",30784117,30802070,17953
"13001","ENSBTAG00000021339","5",28054725,28174539,119814
"13002","ENSBTAG00000021340","15",30816877,30903525,86648
"13003","ENSBTAG00000021341","21",24995072,25045675,50603
"13004","ENSBTAG00000021342","15",30911896,30918652,6756
"13005","ENSBTAG00000021343","15",30922864,31090062,167198
"13006","ENSBTAG00000021345","12",74192308,74193321,1013
"13007","ENSBTAG00000021346","15",58043890,58088286,44396
"13008","ENSBTAG00000021347","6",67633860,67686288,52428
"13009","ENSBTAG00000021351","X",79494732,79517210,22478
"13010","ENSBTAG00000021357","26",17503275,17507723,4448
"13011","ENSBTAG00000021358","26",17515994,17644805,128811
"13012","ENSBTAG00000021359","23",15025399,15039091,13692
"13013","ENSBTAG00000021361","9",68290435,68334821,44386
"13014","ENSBTAG00000021364","1",70600179,70627585,27406
"13015","ENSBTAG00000021365","4",47031326,47099902,68576
"13016","ENSBTAG00000021367","8",63155632,63179637,24005
"13017","ENSBTAG00000021368","13",43687837,43711282,23445
"13018","ENSBTAG00000021370","19",21333634,21374924,41290
"13019","ENSBTAG00000021372","6",91777290,91878094,100804
"13020","ENSBTAG00000021373","11",103037482,103056341,18859
"13021","ENSBTAG00000021374","7",12627896,12637995,10099
"13022","ENSBTAG00000021377","3",16766542,16768597,2055
"13023","ENSBTAG00000021378","3",16756363,16772529,16166
"13024","ENSBTAG00000021381","23",13699642,13832799,133157
"13025","ENSBTAG00000021386","3",82994335,83003679,9344
"13026","ENSBTAG00000021390","22",51261961,51264015,2054
"13027","ENSBTAG00000021392","10",21021437,21029337,7900
"13028","ENSBTAG00000021393","10",97254039,97256021,1982
"13029","ENSBTAG00000021394","10",21017350,21020266,2916
"13030","ENSBTAG00000021395","10",20998111,21026409,28298
"13031","ENSBTAG00000021396","1",69422854,69525187,102333
"13032","ENSBTAG00000021397","26",20530796,20534368,3572
"13033","ENSBTAG00000021398","9",42938244,42947426,9182
"13034","ENSBTAG00000021407","25",2582886,2587864,4978
"13035","ENSBTAG00000021408","16",38808522,38849071,40549
"13036","ENSBTAG00000021410","X",5171523,5175572,4049
"13037","ENSBTAG00000021413","NKLS02002208.1",7367981,7371335,3354
"13038","ENSBTAG00000021414","10",29344214,29359739,15525
"13039","ENSBTAG00000021415","23",20899056,20900663,1607
"13040","ENSBTAG00000021416","28",35805434,35823873,18439
"13041","ENSBTAG00000021417","18",53321794,53328419,6625
"13042","ENSBTAG00000021420","9",56751222,56958827,207605
"13043","ENSBTAG00000021421","X",37011768,37015522,3754
"13044","ENSBTAG00000021422","X",37018705,37046180,27475
"13045","ENSBTAG00000021423","13",53789271,53794699,5428
"13046","ENSBTAG00000021424","21",33873489,33892160,18671
"13047","ENSBTAG00000021425","21",33857063,33868656,11593
"13048","ENSBTAG00000021426","21",33851293,33856082,4789
"13049","ENSBTAG00000021427","19",37918151,37942452,24301
"13050","ENSBTAG00000021428","24",3964837,3993855,29018
"13051","ENSBTAG00000021430","25",34504084,34509114,5030
"13052","ENSBTAG00000021432","16",63482537,63486614,4077
"13053","ENSBTAG00000021433","18",59604000,59606597,2597
"13054","ENSBTAG00000021434","3",104701023,104706947,5924
"13055","ENSBTAG00000021435","5",109963621,109972823,9202
"13056","ENSBTAG00000021437","X",73135024,73136025,1001
"13057","ENSBTAG00000021438","18",39215632,39232695,17063
"13058","ENSBTAG00000021442","22",7458981,7492376,33395
"13059","ENSBTAG00000021444","3",118051375,118103633,52258
"13060","ENSBTAG00000021445","7",100037116,100137609,100493
"13061","ENSBTAG00000021446","9",68038545,68038790,245
"13062","ENSBTAG00000021447","1",148972847,149039609,66762
"13063","ENSBTAG00000021449","14",61045415,61074814,29399
"13064","ENSBTAG00000021452","22",10591437,10687507,96070
"13065","ENSBTAG00000021454","29",43969643,43972286,2643
"13066","ENSBTAG00000021455","29",43973108,43976493,3385
"13067","ENSBTAG00000021456","29",43978620,43984846,6226
"13068","ENSBTAG00000021457","29",43984841,43992126,7285
"13069","ENSBTAG00000021458","4",14390022,14394726,4704
"13070","ENSBTAG00000021461","19",40310336,40323655,13319
"13071","ENSBTAG00000021462","19",40330599,40332907,2308
"13072","ENSBTAG00000021464","5",26888287,26902878,14591
"13073","ENSBTAG00000021466","2",7375289,7414912,39623
"13074","ENSBTAG00000021467","5",26878956,26883908,4952
"13075","ENSBTAG00000021468","19",40334163,40360183,26020
"13076","ENSBTAG00000021469","4",50399810,50651437,251627
"13077","ENSBTAG00000021471","7",102112345,102142034,29689
"13078","ENSBTAG00000021472","14",1153788,1215120,61332
"13079","ENSBTAG00000021474","14",1139890,1146602,6712
"13080","ENSBTAG00000021480","3",113023696,113054163,30467
"13081","ENSBTAG00000021481","3",20375866,20383625,7759
"13082","ENSBTAG00000021482","3",20372002,20376143,4141
"13083","ENSBTAG00000021483","15",45219892,45250906,31014
"13084","ENSBTAG00000021484","15",74830510,75003105,172595
"13085","ENSBTAG00000021485","3",20363111,20369973,6862
"13086","ENSBTAG00000021487","3",20357248,20360783,3535
"13087","ENSBTAG00000021490","1",143087683,143108077,20394
"13088","ENSBTAG00000021491","1",143119850,143131757,11907
"13089","ENSBTAG00000021494","2",70609618,70614377,4759
"13090","ENSBTAG00000021497","28",27570723,27963222,392499
"13091","ENSBTAG00000021499","28",27964205,27997628,33423
"13092","ENSBTAG00000021501","3",57355960,57388867,32907
"13093","ENSBTAG00000021503","12",58618106,58619093,987
"13094","ENSBTAG00000021504","29",29636736,29645141,8405
"13095","ENSBTAG00000021505","19",53522615,53553993,31378
"13096","ENSBTAG00000021506","22",32436509,32457970,21461
"13097","ENSBTAG00000021508","22",32416730,32433834,17104
"13098","ENSBTAG00000021512","3",15577907,15593999,16092
"13099","ENSBTAG00000021514","2",107307884,107321008,13124
"13100","ENSBTAG00000021515","1",70789424,70802153,12729
"13101","ENSBTAG00000021516","23",25122359,25137232,14873
"13102","ENSBTAG00000021517","29",39891387,39895152,3765
"13103","ENSBTAG00000021518","15",28761626,28802624,40998
"13104","ENSBTAG00000021519","7",46248646,46257167,8521
"13105","ENSBTAG00000021520","7",46263607,46314820,51213
"13106","ENSBTAG00000021521","25",13547629,13579860,32231
"13107","ENSBTAG00000021522","25",13581741,13601430,19689
"13108","ENSBTAG00000021523","19",42417949,42491771,73822
"13109","ENSBTAG00000021525","2",124841943,124843301,1358
"13110","ENSBTAG00000021526","2",42650738,42652184,1446
"13111","ENSBTAG00000021527","21",7780293,8080394,300101
"13112","ENSBTAG00000021531","21",8090744,8103335,12591
"13113","ENSBTAG00000021535","4",33083035,33144192,61157
"13114","ENSBTAG00000021537","3",48239823,48252404,12581
"13115","ENSBTAG00000021538","10",50958102,51177537,219435
"13116","ENSBTAG00000021540","26",40839066,40898562,59496
"13117","ENSBTAG00000021543","4",53442844,53541143,98299
"13118","ENSBTAG00000021544","3",102838619,102846235,7616
"13119","ENSBTAG00000021547","3",102768456,102838906,70450
"13120","ENSBTAG00000021550","11",105939635,105947121,7486
"13121","ENSBTAG00000021553","16",69034474,69223706,189232
"13122","ENSBTAG00000021554","23",43019366,43024406,5040
"13123","ENSBTAG00000021556","23",42945450,43017711,72261
"13124","ENSBTAG00000021557","18",55335379,55336413,1034
"13125","ENSBTAG00000021558","13",55061637,55072470,10833
"13126","ENSBTAG00000021565","4",106071878,106075654,3776
"13127","ENSBTAG00000021566","26",21590656,21680714,90058
"13128","ENSBTAG00000021568","29",39779732,39810386,30654
"13129","ENSBTAG00000021569","29",39814479,39843236,28757
"13130","ENSBTAG00000021570","18",34900315,34908340,8025
"13131","ENSBTAG00000021573","8",75491761,75530847,39086
"13132","ENSBTAG00000021574","26",33466276,33668370,202094
"13133","ENSBTAG00000021575","18",18722067,18766993,44926
"13134","ENSBTAG00000021576","16",80548214,80576112,27898
"13135","ENSBTAG00000021577","7",80569078,80618497,49419
"13136","ENSBTAG00000021580","2",19658429,19663581,5152
"13137","ENSBTAG00000021581","24",20336299,20858181,521882
"13138","ENSBTAG00000021582","6",37277323,37378124,100801
"13139","ENSBTAG00000021583","24",20261673,20326422,64749
"13140","ENSBTAG00000021586","8",44894738,44896377,1639
"13141","ENSBTAG00000021587","9",28453559,28470952,17393
"13142","ENSBTAG00000021588","2",111768890,111774486,5596
"13143","ENSBTAG00000021590","15",46864248,46865216,968
"13144","ENSBTAG00000021591","3",19016289,19022195,5906
"13145","ENSBTAG00000021592","27",27121355,27246171,124816
"13146","ENSBTAG00000021594","3",18992376,19014072,21696
"13147","ENSBTAG00000021595","17",52671417,52697372,25955
"13148","ENSBTAG00000021596","2",92144569,92169924,25355
"13149","ENSBTAG00000021600","2",97848310,97972682,124372
"13150","ENSBTAG00000021601","13",78706958,78721688,14730
"13151","ENSBTAG00000021602","3",30834932,30885081,50149
"13152","ENSBTAG00000021603","NKLS02002207.1",333304,334188,884
"13153","ENSBTAG00000021604","29",39867808,39873681,5873
"13154","ENSBTAG00000021606","20",18371101,18422099,50998
"13155","ENSBTAG00000021607","20",18210359,18370943,160584
"13156","ENSBTAG00000021609","23",20213988,20258614,44626
"13157","ENSBTAG00000021611","15",67022721,67089356,66635
"13158","ENSBTAG00000021614","13",6988403,7250848,262445
"13159","ENSBTAG00000021615","5",109432450,109438746,6296
"13160","ENSBTAG00000021616","7",43286640,43291810,5170
"13161","ENSBTAG00000021617","4",102660085,102709502,49417
"13162","ENSBTAG00000021620","2",129122974,129130667,7693
"13163","ENSBTAG00000021626","5",119451454,119473072,21618
"13164","ENSBTAG00000021630","10",11936565,11961634,25069
"13165","ENSBTAG00000021632","8",8755177,9169658,414481
"13166","ENSBTAG00000021633","5",67632504,67653338,20834
"13167","ENSBTAG00000021634","3",21505807,21515218,9411
"13168","ENSBTAG00000021635","3",21512445,21517734,5289
"13169","ENSBTAG00000021636","2",22319664,22358578,38914
"13170","ENSBTAG00000021637","3",21519781,21532978,13197
"13171","ENSBTAG00000021639","14",1741249,1743574,2325
"13172","ENSBTAG00000021643","22",56325258,56343083,17825
"13173","ENSBTAG00000021645","22",56308409,56317560,9151
"13174","ENSBTAG00000021647","18",62527485,62537893,10408
"13175","ENSBTAG00000021649","3",14304650,14305160,510
"13176","ENSBTAG00000021651","25",19647361,19673589,26228
"13177","ENSBTAG00000021652","25",19669079,19688054,18975
"13178","ENSBTAG00000021653","2",117811397,117918447,107050
"13179","ENSBTAG00000021654","29",22044981,22192313,147332
"13180","ENSBTAG00000021656","17",71612407,71698165,85758
"13181","ENSBTAG00000021657","18",61659470,61675273,15803
"13182","ENSBTAG00000021658","5",27865700,27873793,8093
"13183","ENSBTAG00000021660","5",62757513,62781346,23833
"13184","ENSBTAG00000021661","5",62784906,62888247,103341
"13185","ENSBTAG00000021663","9",62573175,62585417,12242
"13186","ENSBTAG00000021664","28",25768939,25781767,12828
"13187","ENSBTAG00000021668","24",36832925,36860472,27547
"13188","ENSBTAG00000021669","13",65838227,65883437,45210
"13189","ENSBTAG00000021671","16",37440402,37442731,2329
"13190","ENSBTAG00000021672","16",12697341,12701473,4132
"13191","ENSBTAG00000021673","24",36860566,36894144,33578
"13192","ENSBTAG00000021675","7",108442760,108492509,49749
"13193","ENSBTAG00000021677","19",9938267,10089721,151454
"13194","ENSBTAG00000021678","8",102470399,102504614,34215
"13195","ENSBTAG00000021680","19",10094307,10124864,30557
"13196","ENSBTAG00000021681","19",10125434,10153162,27728
"13197","ENSBTAG00000021684","X",130164847,130171121,6274
"13198","ENSBTAG00000021685","13",54151514,54159711,8197
"13199","ENSBTAG00000021686","8",60775331,60848414,73083
"13200","ENSBTAG00000021687","7",46067083,46118414,51331
"13201","ENSBTAG00000021688","16",35260924,35288027,27103
"13202","ENSBTAG00000021691","2",34972722,35083065,110343
"13203","ENSBTAG00000021692","2",34958624,34968526,9902
"13204","ENSBTAG00000021693","21",33753196,33753795,599
"13205","ENSBTAG00000021694","11",14696392,14751826,55434
"13206","ENSBTAG00000021695","22",48589696,48595068,5372
"13207","ENSBTAG00000021696","8",60445847,60448238,2391
"13208","ENSBTAG00000021697","5",110665525,110687430,21905
"13209","ENSBTAG00000021699","8",50559389,50763952,204563
"13210","ENSBTAG00000021700","15",77139930,77180691,40761
"13211","ENSBTAG00000021703","1",116654940,117017533,362593
"13212","ENSBTAG00000021705","3",8338252,8362436,24184
"13213","ENSBTAG00000021706","17",60088083,60101025,12942
"13214","ENSBTAG00000021707","15",77180952,77199310,18358
"13215","ENSBTAG00000021708","10",91776872,92255659,478787
"13216","ENSBTAG00000021709","15",77200844,77230554,29710
"13217","ENSBTAG00000021713","X",33093515,33213252,119737
"13218","ENSBTAG00000021714","3",109728960,109733363,4403
"13219","ENSBTAG00000021715","3",109722183,109727879,5696
"13220","ENSBTAG00000021717","21",61081307,61151037,69730
"13221","ENSBTAG00000021720","19",36304898,36309727,4829
"13222","ENSBTAG00000021723","19",36298493,36304862,6369
"13223","ENSBTAG00000021724","22",42918413,42958633,40220
"13224","ENSBTAG00000021725","12",86530490,86545536,15046
"13225","ENSBTAG00000021726","2",16813692,16875835,62143
"13226","ENSBTAG00000021727","13",54606948,54658859,51911
"13227","ENSBTAG00000021728","28",43841934,43868982,27048
"13228","ENSBTAG00000021729","6",103215398,103240042,24644
"13229","ENSBTAG00000021730","10",30254623,30257816,3193
"13230","ENSBTAG00000021731","11",9215779,9243006,27227
"13231","ENSBTAG00000021735","11",68772415,68987963,215548
"13232","ENSBTAG00000021739","16",41822765,41824259,1494
"13233","ENSBTAG00000021741","9",101395794,101728198,332404
"13234","ENSBTAG00000021742","18",47191216,47196464,5248
"13235","ENSBTAG00000021743","14",43837811,44085912,248101
"13236","ENSBTAG00000021744","15",77250425,77258901,8476
"13237","ENSBTAG00000021745","15",77261076,77273571,12495
"13238","ENSBTAG00000021746","6",3557585,3590521,32936
"13239","ENSBTAG00000021747","14",54622915,54628946,6031
"13240","ENSBTAG00000021751","8",76173243,76268355,95112
"13241","ENSBTAG00000021752","3",66664210,66707306,43096
"13242","ENSBTAG00000021754","3",7851912,7861112,9200
"13243","ENSBTAG00000021755","2",60302956,60303918,962
"13244","ENSBTAG00000021756","5",6174722,6273171,98449
"13245","ENSBTAG00000021759","4",104013524,104019157,5633
"13246","ENSBTAG00000021761","4",104027627,104194547,166920
"13247","ENSBTAG00000021762","2",9838366,9859389,21023
"13248","ENSBTAG00000021764","17",42021088,42110395,89307
"13249","ENSBTAG00000021766","7",51533600,51544783,11183
"13250","ENSBTAG00000021767","5",23214338,23255510,41172
"13251","ENSBTAG00000021768","6",91993502,92001791,8289
"13252","ENSBTAG00000021769","2",112586826,112699754,112928
"13253","ENSBTAG00000021770","2",96417867,96420083,2216
"13254","ENSBTAG00000021771","1",144713171,144730575,17404
"13255","ENSBTAG00000021773","25",12833435,12874714,41279
"13256","ENSBTAG00000021774","7",20589314,20621829,32515
"13257","ENSBTAG00000021775","7",51558951,51572952,14001
"13258","ENSBTAG00000021776","29",45455657,45468982,13325
"13259","ENSBTAG00000021777","29",45469517,45480585,11068
"13260","ENSBTAG00000021778","2",127256063,127272993,16930
"13261","ENSBTAG00000021779","17",18024427,18062255,37828
"13262","ENSBTAG00000021780","19",29645573,29668006,22433
"13263","ENSBTAG00000021781","2",127238786,127253787,15001
"13264","ENSBTAG00000021785","25",26290036,26307986,17950
"13265","ENSBTAG00000021786","2",127225459,127237892,12433
"13266","ENSBTAG00000021787","2",127217390,127222938,5548
"13267","ENSBTAG00000021789","18",51171396,51176789,5393
"13268","ENSBTAG00000021790","X",67160294,67265278,104984
"13269","ENSBTAG00000021791","1",66958506,66988476,29970
"13270","ENSBTAG00000021795","17",63165815,63182551,16736
"13271","ENSBTAG00000021796","17",63183519,63193665,10146
"13272","ENSBTAG00000021798","19",40071906,40097898,25992
"13273","ENSBTAG00000021799","18",55968304,55999568,31264
"13274","ENSBTAG00000021801","26",39852025,39946261,94236
"13275","ENSBTAG00000021802","19",40097827,40099201,1374
"13276","ENSBTAG00000021803","5",116838076,116904429,66353
"13277","ENSBTAG00000021805","13",65704810,65712335,7525
"13278","ENSBTAG00000021807","5",56410874,56418016,7142
"13279","ENSBTAG00000021808","5",30949783,30962180,12397
"13280","ENSBTAG00000021809","15",63659355,63688683,29328
"13281","ENSBTAG00000021810","5",30934162,30948954,14792
"13282","ENSBTAG00000021811","13",60191141,60234885,43744
"13283","ENSBTAG00000021813","20",39765282,39781002,15720
"13284","ENSBTAG00000021814","9",12786479,12802327,15848
"13285","ENSBTAG00000021815","12",27785642,28012399,226757
"13286","ENSBTAG00000021818","7",11353129,11371722,18593
"13287","ENSBTAG00000021819","1",2189895,2218344,28449
"13288","ENSBTAG00000021820","7",11344119,11354161,10042
"13289","ENSBTAG00000021821","14",30144524,30145431,907
"13290","ENSBTAG00000021822","28",3714519,3737767,23248
"13291","ENSBTAG00000021823","3",21365083,21369973,4890
"13292","ENSBTAG00000021827","9",72066568,72069851,3283
"13293","ENSBTAG00000021829","7",62495947,62508685,12738
"13294","ENSBTAG00000021830","9",69748258,69818319,70061
"13295","ENSBTAG00000021832","2",129091481,129110145,18664
"13296","ENSBTAG00000021833","3",21753703,21755025,1322
"13297","ENSBTAG00000021835","22",37061676,37323258,261582
"13298","ENSBTAG00000021836","13",53804253,53812586,8333
"13299","ENSBTAG00000021837","13",53798671,53804656,5985
"13300","ENSBTAG00000021838","14",69602149,69660461,58312
"13301","ENSBTAG00000021841","14",26361178,26487977,126799
"13302","ENSBTAG00000021842","3",7931201,7947765,16564
"13303","ENSBTAG00000021843","X",93549709,93551583,1874
"13304","ENSBTAG00000021844","21",41526381,41540316,13935
"13305","ENSBTAG00000021845","21",41543030,41650684,107654
"13306","ENSBTAG00000021846","22",51220718,51248173,27455
"13307","ENSBTAG00000021849","4",48572836,48643612,70776
"13308","ENSBTAG00000021850","22",51201255,51213764,12509
"13309","ENSBTAG00000021853","22",51175603,51199445,23842
"13310","ENSBTAG00000021855","15",56896688,57352721,456033
"13311","ENSBTAG00000021856","26",19261332,19334983,73651
"13312","ENSBTAG00000021857","13",25463655,25592062,128407
"13313","ENSBTAG00000021858","15",57364699,57415989,51290
"13314","ENSBTAG00000021859","9",42600693,42864654,263961
"13315","ENSBTAG00000021861","11",106266337,106274382,8045
"13316","ENSBTAG00000021862","3",16619248,16624026,4778
"13317","ENSBTAG00000021867","13",37876842,37916420,39578
"13318","ENSBTAG00000021869","4",59588215,59594296,6081
"13319","ENSBTAG00000021870","10",34059936,34092922,32986
"13320","ENSBTAG00000021872","10",34100135,34179132,78997
"13321","ENSBTAG00000021874","16",79237466,79278728,41262
"13322","ENSBTAG00000021875","5",68361613,68504478,142865
"13323","ENSBTAG00000021876","10",56554672,56779698,225026
"13324","ENSBTAG00000021879","28",29876700,29989469,112769
"13325","ENSBTAG00000021880","16",29906148,29954708,48560
"13326","ENSBTAG00000021883","28",29991385,30012205,20820
"13327","ENSBTAG00000021884","24",49949350,49954796,5446
"13328","ENSBTAG00000021885","13",60118678,60153362,34684
"13329","ENSBTAG00000021886","1",127145178,127185456,40278
"13330","ENSBTAG00000021887","14",60148619,60239255,90636
"13331","ENSBTAG00000021893","3",8331489,8337654,6165
"13332","ENSBTAG00000021894","3",8326933,8330785,3852
"13333","ENSBTAG00000021896","11",101323401,101414345,90944
"13334","ENSBTAG00000021897","3",8321014,8326857,5843
"13335","ENSBTAG00000021899","1",142930579,143034932,104353
"13336","ENSBTAG00000021900","3",55066989,55200622,133633
"13337","ENSBTAG00000021901","1",144361187,144410547,49360
"13338","ENSBTAG00000021902","23",33183864,33209632,25768
"13339","ENSBTAG00000021903","23",33101994,33175242,73248
"13340","ENSBTAG00000021904","21",68658629,68701100,42471
"13341","ENSBTAG00000021905","4",22389767,23262263,872496
"13342","ENSBTAG00000021910","1",90030089,90204389,174300
"13343","ENSBTAG00000021911","22",39028434,39358064,329630
"13344","ENSBTAG00000021912","22",48825120,48832342,7222
"13345","ENSBTAG00000021913","25",39065693,39127923,62230
"13346","ENSBTAG00000021916","19",46285322,46300142,14820
"13347","ENSBTAG00000021918","19",42754606,42786890,32284
"13348","ENSBTAG00000021919","16",80636726,80688965,52239
"13349","ENSBTAG00000021920","11",2816520,2826541,10021
"13350","ENSBTAG00000021921","11",94280014,94420605,140591
"13351","ENSBTAG00000021922","3",105710017,105757346,47329
"13352","ENSBTAG00000021923","24",25603584,25654023,50439
"13353","ENSBTAG00000021924","10",37390030,37428653,38623
"13354","ENSBTAG00000021927","19",13312212,13420345,108133
"13355","ENSBTAG00000021928","11",104113961,104127351,13390
"13356","ENSBTAG00000021931","19",26803542,26807446,3904
"13357","ENSBTAG00000021932","19",26802642,26804385,1743
"13358","ENSBTAG00000021933","19",26787284,26800417,13133
"13359","ENSBTAG00000021934","11",49642200,49656929,14729
"13360","ENSBTAG00000021935","11",49602748,49642410,39662
"13361","ENSBTAG00000021938","19",31200392,31360769,160377
"13362","ENSBTAG00000021939","19",31362746,31378583,15837
"13363","ENSBTAG00000021940","6",44401700,44520810,119110
"13364","ENSBTAG00000021941","4",116115071,116898738,783667
"13365","ENSBTAG00000021942","26",22751849,22754468,2619
"13366","ENSBTAG00000021943","3",105445057,105510073,65016
"13367","ENSBTAG00000021944","10",44831891,44846457,14566
"13368","ENSBTAG00000021945","10",44846568,44939145,92577
"13369","ENSBTAG00000021948","3",110648270,110694255,45985
"13370","ENSBTAG00000021949","8",72213270,72217537,4267
"13371","ENSBTAG00000021951","13",17400569,17423448,22879
"13372","ENSBTAG00000021953","5",71806170,72364695,558525
"13373","ENSBTAG00000021955","10",85774962,85783794,8832
"13374","ENSBTAG00000021956","10",85783972,85785721,1749
"13375","ENSBTAG00000021957","10",85791017,85898441,107424
"13376","ENSBTAG00000021958","20",24009814,24018787,8973
"13377","ENSBTAG00000021959","20",23940884,24005261,64377
"13378","ENSBTAG00000021960","20",23951563,23956371,4808
"13379","ENSBTAG00000021961","11",11548544,11556964,8420
"13380","ENSBTAG00000021962","X",123192208,123244045,51837
"13381","ENSBTAG00000021963","6",67048510,67117951,69441
"13382","ENSBTAG00000021964","14",70104355,70207101,102746
"13383","ENSBTAG00000021965","20",41067802,41130663,62861
"13384","ENSBTAG00000021967","4",55560579,55618384,57805
"13385","ENSBTAG00000021968","X",56451563,56556285,104722
"13386","ENSBTAG00000021969","11",75240502,75572709,332207
"13387","ENSBTAG00000021970","9",71362334,71725682,363348
"13388","ENSBTAG00000021971","7",31380877,31541086,160209
"13389","ENSBTAG00000021972","20",59226991,59489350,262359
"13390","ENSBTAG00000021974","5",25855722,25862453,6731
"13391","ENSBTAG00000021975","3",83556891,83936160,379269
"13392","ENSBTAG00000021976","2",94460487,94489927,29440
"13393","ENSBTAG00000021977","7",26421249,26467627,46378
"13394","ENSBTAG00000021978","5",114752957,114869584,116627
"13395","ENSBTAG00000021979","2",94490094,94493400,3306
"13396","ENSBTAG00000021980","5",83871044,83894327,23283
"13397","ENSBTAG00000021984","1",145988468,145994118,5650
"13398","ENSBTAG00000021986","10",67525428,67538325,12897
"13399","ENSBTAG00000021988","10",67504612,67518536,13924
"13400","ENSBTAG00000021991","8",90238685,90335315,96630
"13401","ENSBTAG00000021992","8",90334876,90348569,13693
"13402","ENSBTAG00000021993","23",8591537,8608865,17328
"13403","ENSBTAG00000021994","5",108232092,108297995,65903
"13404","ENSBTAG00000021995","5",108245440,108259303,13863
"13405","ENSBTAG00000021996","4",9764439,9772218,7779
"13406","ENSBTAG00000021997","1",1665339,1908788,243449
"13407","ENSBTAG00000021999","29",46164784,46225440,60656
"13408","ENSBTAG00000022000","13",32712262,32993785,281523
"13409","ENSBTAG00000022003","13",33000133,33078041,77908
"13410","ENSBTAG00000022004","22",43132187,43272493,140306
"13411","ENSBTAG00000022005","13",65914512,65925739,11227
"13412","ENSBTAG00000022006","19",55727639,55732562,4923
"13413","ENSBTAG00000022007","13",65915452,65982693,67241
"13414","ENSBTAG00000022009","19",55721539,55726175,4636
"13415","ENSBTAG00000022013","8",1083274,1107894,24620
"13416","ENSBTAG00000022019","17",72102052,72106230,4178
"13417","ENSBTAG00000022020","17",72734557,72735831,1274
"13418","ENSBTAG00000022022","17",71503858,71515630,11772
"13419","ENSBTAG00000022027","17",71335068,71337740,2672
"13420","ENSBTAG00000022028","17",71260779,71262858,2079
"13421","ENSBTAG00000022030","17",71223953,71225401,1448
"13422","ENSBTAG00000022032","17",71226030,71227888,1858
"13423","ENSBTAG00000022036","17",68227493,68400924,173431
"13424","ENSBTAG00000022039","17",64579462,64580550,1088
"13425","ENSBTAG00000022044","17",62472792,62491460,18668
"13426","ENSBTAG00000022058","17",63845551,63976145,130594
"13427","ENSBTAG00000022067","17",54360388,54368947,8559
"13428","ENSBTAG00000022069","17",55178853,55280779,101926
"13429","ENSBTAG00000022083","5",82133898,82134596,698
"13430","ENSBTAG00000022084","17",45034942,45035891,949
"13431","ENSBTAG00000022109","17",17324484,17364038,39554
"13432","ENSBTAG00000022114","14",15675525,15719449,43924
"13433","ENSBTAG00000022120","17",2894488,2932611,38123
"13434","ENSBTAG00000022142","11",82860038,82861977,1939
"13435","ENSBTAG00000022147","29",50613286,50629864,16578
"13436","ENSBTAG00000022150","X",138519497,138540790,21293
"13437","ENSBTAG00000022155","1",65138529,65198315,59786
"13438","ENSBTAG00000022158","29",49579179,49594887,15708
"13439","ENSBTAG00000022160","29",48624179,48676972,52793
"13440","ENSBTAG00000022161","X",130769109,130786365,17256
"13441","ENSBTAG00000022167","5",93887905,94006820,118915
"13442","ENSBTAG00000022169","14",31976746,32270936,294190
"13443","ENSBTAG00000022185","29",46268478,46293180,24702
"13444","ENSBTAG00000022188","29",47421137,47498030,76893
"13445","ENSBTAG00000022199","6",71258398,71263812,5414
"13446","ENSBTAG00000022204","X",52344216,52345355,1139
"13447","ENSBTAG00000022209","29",45396984,45401741,4757
"13448","ENSBTAG00000022227","1",121946372,121974115,27743
"13449","ENSBTAG00000022238","29",44397096,44399344,2248
"13450","ENSBTAG00000022242","29",44521307,44553203,31896
"13451","ENSBTAG00000022244","29",44582264,44596714,14450
"13452","ENSBTAG00000022246","29",44978758,44980433,1675
"13453","ENSBTAG00000022255","X",83085618,83294907,209289
"13454","ENSBTAG00000022275","1",54226950,54227678,728
"13455","ENSBTAG00000022288","X",58619062,58732249,113187
"13456","ENSBTAG00000022292","X",50861910,50864672,2762
"13457","ENSBTAG00000022293","29",40996362,40998547,2185
"13458","ENSBTAG00000022294","29",40244038,40351218,107180
"13459","ENSBTAG00000022314","X",37427208,37430081,2873
"13460","ENSBTAG00000022329","5",88901347,88970366,69019
"13461","ENSBTAG00000022360","5",86028631,86627007,598376
"13462","ENSBTAG00000022372","29",27769046,27769938,892
"13463","ENSBTAG00000022373","X",20493990,20551596,57606
"13464","ENSBTAG00000022379","29",28226459,28231658,5199
"13465","ENSBTAG00000022381","11",10561669,10666478,104809
"13466","ENSBTAG00000022382","29",28532096,28549017,16921
"13467","ENSBTAG00000022394","29",26458417,26461858,3441
"13468","ENSBTAG00000022395","29",26440270,26443827,3557
"13469","ENSBTAG00000022399","X",10491231,10492622,1391
"13470","ENSBTAG00000022427","29",13503659,13504402,743
"13471","ENSBTAG00000022449","6",97461721,97637722,176001
"13472","ENSBTAG00000022450","6",97724566,97745383,20817
"13473","ENSBTAG00000022460","29",36994012,36994509,497
"13474","ENSBTAG00000022461","11",44267491,44323707,56216
"13475","ENSBTAG00000022471","14",28074682,28104548,29866
"13476","ENSBTAG00000022484","12",69202956,69203789,833
"13477","ENSBTAG00000022489","19",52121870,52239797,117927
"13478","ENSBTAG00000022498","4",43148370,43148895,525
"13479","ENSBTAG00000022509","19",30328605,30613943,285338
"13480","ENSBTAG00000022514","3",12508921,12526879,17958
"13481","ENSBTAG00000022520","19",43069372,43139018,69646
"13482","ENSBTAG00000022530","25",7650091,7652689,2598
"13483","ENSBTAG00000022535","25",17645402,17687968,42566
"13484","ENSBTAG00000022539","14",64216926,64220642,3716
"13485","ENSBTAG00000022564","13",43616999,43626832,9833
"13486","ENSBTAG00000022570","13",43733438,43753829,20391
"13487","ENSBTAG00000022571","13",43578475,43587393,8918
"13488","ENSBTAG00000022575","22",59919819,59929774,9955
"13489","ENSBTAG00000022580","3",31565399,31578746,13347
"13490","ENSBTAG00000022583","10",61284100,61419065,134965
"13491","ENSBTAG00000022588","14",32378189,32741893,363704
"13492","ENSBTAG00000022598","22",52511365,52515665,4300
"13493","ENSBTAG00000022613","4",70735436,70738238,2802
"13494","ENSBTAG00000022622","22",49749512,49755490,5978
"13495","ENSBTAG00000022632","22",50697897,50700780,2883
"13496","ENSBTAG00000022635","22",50883645,50897890,14245
"13497","ENSBTAG00000022656","22",42870235,42918332,48097
"13498","ENSBTAG00000022681","22",32535096,32575454,40358
"13499","ENSBTAG00000022689","22",29206404,29277551,71147
"13500","ENSBTAG00000022699","22",17791372,17805224,13852
"13501","ENSBTAG00000022714","20",24638190,24638869,679
"13502","ENSBTAG00000022715","26",42474359,42491825,17466
"13503","ENSBTAG00000022721","22",12645751,12660388,14637
"13504","ENSBTAG00000022731","23",48004741,48039719,34978
"13505","ENSBTAG00000022733","22",10551378,10553204,1826
"13506","ENSBTAG00000022751","22",2858364,2941155,82791
"13507","ENSBTAG00000022762","7",87293323,87297625,4302
"13508","ENSBTAG00000022775","21",69058229,69068334,10105
"13509","ENSBTAG00000022777","16",29958179,30250777,292598
"13510","ENSBTAG00000022779","12",10641503,10665121,23618
"13511","ENSBTAG00000022783","18",29354201,29761883,407682
"13512","ENSBTAG00000022799","11",103935364,103980160,44796
"13513","ENSBTAG00000022801","10",59890308,59967550,77242
"13514","ENSBTAG00000022807","18",62587896,62594465,6569
"13515","ENSBTAG00000022808","26",38953563,39017643,64080
"13516","ENSBTAG00000022813","18",62159120,62167311,8191
"13517","ENSBTAG00000022819","24",56682330,56728117,45787
"13518","ENSBTAG00000022825","25",37736099,37744499,8400
"13519","ENSBTAG00000022829","24",58049671,58122019,72348
"13520","ENSBTAG00000022837","NKLS02002206.1",87021,95745,8724
"13521","ENSBTAG00000022847","21",41836061,41936150,100089
"13522","ENSBTAG00000022861","5",99425439,99435639,10200
"13523","ENSBTAG00000022880","4",88429070,88431290,2220
"13524","ENSBTAG00000022886","28",9910803,10517659,606856
"13525","ENSBTAG00000022887","24",3918526,3931630,13104
"13526","ENSBTAG00000022890","24",2224463,2328579,104116
"13527","ENSBTAG00000022893","3",11746000,11749447,3447
"13528","ENSBTAG00000022902","24",49151058,49154341,3283
"13529","ENSBTAG00000022917","26",45394341,45506195,111854
"13530","ENSBTAG00000022920","X",55260953,55325969,65016
"13531","ENSBTAG00000022922","NKLS02001524.1",51118,80985,29867
"13532","ENSBTAG00000022927","19",50863256,50879273,16017
"13533","ENSBTAG00000022931","13",11282593,11301579,18986
"13534","ENSBTAG00000022947","21",21540535,21540819,284
"13535","ENSBTAG00000022954","3",2569473,2570674,1201
"13536","ENSBTAG00000022960","29",678610,770713,92103
"13537","ENSBTAG00000022962","X",88033121,88205253,172132
"13538","ENSBTAG00000022971","5",44189142,44194069,4927
"13539","ENSBTAG00000022986","5",118304835,118480508,175673
"13540","ENSBTAG00000022989","21",14339186,14379062,39876
"13541","ENSBTAG00000022991","12",25769802,26441648,671846
"13542","ENSBTAG00000023007","17",71897941,71916613,18672
"13543","ENSBTAG00000023018","28",43900420,44015116,114696
"13544","ENSBTAG00000023026","24",12446966,12464311,17345
"13545","ENSBTAG00000023028","28",43020182,43268260,248078
"13546","ENSBTAG00000023032","28",35645847,35650079,4232
"13547","ENSBTAG00000023039","28",30868155,30881816,13661
"13548","ENSBTAG00000023054","28",24858160,24885916,27756
"13549","ENSBTAG00000023064","11",103748130,103771510,23380
"13550","ENSBTAG00000023073","28",3750980,3770591,19611
"13551","ENSBTAG00000023074","28",3562180,3594285,32105
"13552","ENSBTAG00000023106","1",139422600,139432042,9442
"13553","ENSBTAG00000023144","16",77600496,77669271,68775
"13554","ENSBTAG00000023146","27",34246204,34420189,173985
"13555","ENSBTAG00000023147","21",32764174,32782312,18138
"13556","ENSBTAG00000023157","27",6475376,6477354,1978
"13557","ENSBTAG00000023169","13",10758600,10817097,58497
"13558","ENSBTAG00000023172","11",74844189,74898502,54313
"13559","ENSBTAG00000023177","16",6199772,6333310,133538
"13560","ENSBTAG00000023179","14",14779050,14787206,8156
"13561","ENSBTAG00000023182","X",91676599,91858715,182116
"13562","ENSBTAG00000023186","10",3638271,3638663,392
"13563","ENSBTAG00000023192","5",101293270,101299881,6611
"13564","ENSBTAG00000023198","24",62075443,62093177,17734
"13565","ENSBTAG00000023207","22",42696315,42716633,20318
"13566","ENSBTAG00000023218","14",19592402,19612714,20312
"13567","ENSBTAG00000023249","25",22965,23327,362
"13568","ENSBTAG00000023258","5",98625559,98626446,887
"13569","ENSBTAG00000023259","24",32306070,32535370,229300
"13570","ENSBTAG00000023270","24",10174659,10182121,7462
"13571","ENSBTAG00000023274","5",107248410,107257399,8989
"13572","ENSBTAG00000023279","12",28524407,28586101,61694
"13573","ENSBTAG00000023283","15",28881527,28912759,31232
"13574","ENSBTAG00000023289","5",55863909,55870734,6825
"13575","ENSBTAG00000023309","12",72680464,72875927,195463
"13576","ENSBTAG00000023318","11",61783669,61784172,503
"13577","ENSBTAG00000023333","18",63238408,63241746,3338
"13578","ENSBTAG00000023343","18",62099120,62101918,2798
"13579","ENSBTAG00000023365","18",57552574,57558604,6030
"13580","ENSBTAG00000023367","18",53522276,53522839,563
"13581","ENSBTAG00000023369","18",55092790,55122806,30016
"13582","ENSBTAG00000023372","11",82407831,82412205,4374
"13583","ENSBTAG00000023374","18",55377395,55381389,3994
"13584","ENSBTAG00000023375","1",152434570,152450925,16355
"13585","ENSBTAG00000023377","1",152286347,152366452,80105
"13586","ENSBTAG00000023384","1",148346840,148357793,10953
"13587","ENSBTAG00000023393","1",144284837,144298200,13363
"13588","ENSBTAG00000023398","1",142694786,142737902,43116
"13589","ENSBTAG00000023407","1",139747766,139748825,1059
"13590","ENSBTAG00000023411","1",135642794,135686442,43648
"13591","ENSBTAG00000023415","18",55626996,55630621,3625
"13592","ENSBTAG00000023416","1",133116975,133350011,233036
"13593","ENSBTAG00000023417","18",55558487,55574535,16048
"13594","ENSBTAG00000023419","18",54731844,54750238,18394
"13595","ENSBTAG00000023426","1",130488923,130505304,16381
"13596","ENSBTAG00000023429","1",126325256,126418836,93580
"13597","ENSBTAG00000023431","17",64217915,64218597,682
"13598","ENSBTAG00000023434","18",51618421,51622953,4532
"13599","ENSBTAG00000023439","18",51910502,51910885,383
"13600","ENSBTAG00000023445","1",117361864,117380735,18871
"13601","ENSBTAG00000023452","18",50509251,50517302,8051
"13602","ENSBTAG00000023453","18",50013398,50021409,8011
"13603","ENSBTAG00000023462","8",24916124,24920698,4574
"13604","ENSBTAG00000023464","18",47095331,47099279,3948
"13605","ENSBTAG00000023471","5",28363888,28364281,393
"13606","ENSBTAG00000023472","18",48065738,48069952,4214
"13607","ENSBTAG00000023487","5",93936345,93936605,260
"13608","ENSBTAG00000023513","1",86035467,86040735,5268
"13609","ENSBTAG00000023523","8",76973596,77065618,92022
"13610","ENSBTAG00000023529","20",38369475,38572090,202615
"13611","ENSBTAG00000023535","3",32034788,32051900,17112
"13612","ENSBTAG00000023541","23",26990784,26992543,1759
"13613","ENSBTAG00000023549","26",16473502,16520974,47472
"13614","ENSBTAG00000023551","3",99514446,99523394,8948
"13615","ENSBTAG00000023562","18",48131886,48143864,11978
"13616","ENSBTAG00000023563","23",27139269,27146479,7210
"13617","ENSBTAG00000023600","1",72061983,72075639,13656
"13618","ENSBTAG00000023601","18",53008790,53024413,15623
"13619","ENSBTAG00000023607","1",67866129,67952810,86681
"13620","ENSBTAG00000023608","1",67979236,67979548,312
"13621","ENSBTAG00000023610","18",46456974,46459286,2312
"13622","ENSBTAG00000023611","18",46428944,46432573,3629
"13623","ENSBTAG00000023614","18",43165773,43201620,35847
"13624","ENSBTAG00000023628","23",27639809,27641450,1641
"13625","ENSBTAG00000023632","18",34798461,34802590,4129
"13626","ENSBTAG00000023635","5",101642768,101659913,17145
"13627","ENSBTAG00000023648","15",51386896,51443955,57059
"13628","ENSBTAG00000023652","1",38203313,38267163,63850
"13629","ENSBTAG00000023659","18",24042348,24043480,1132
"13630","ENSBTAG00000023666","1",42936757,42941412,4655
"13631","ENSBTAG00000023670","5",25242590,25246328,3738
"13632","ENSBTAG00000023675","1",36063528,36147146,83618
"13633","ENSBTAG00000023697","11",102459398,102459766,368
"13634","ENSBTAG00000023718","1",3183412,3197291,13879
"13635","ENSBTAG00000023730","18",14708940,14717352,8412
"13636","ENSBTAG00000023731","18",14705093,14706843,1750
"13637","ENSBTAG00000023734","18",35214540,35216499,1959
"13638","ENSBTAG00000023736","11",20086106,20111391,25285
"13639","ENSBTAG00000023744","11",69713717,69727353,13636
"13640","ENSBTAG00000023745","18",13381283,13450245,68962
"13641","ENSBTAG00000023752","18",14037920,14043929,6009
"13642","ENSBTAG00000023765","18",7745738,7755153,9415
"13643","ENSBTAG00000023784","16",51119142,51122449,3307
"13644","ENSBTAG00000023787","11",106277920,106279140,1220
"13645","ENSBTAG00000023788","11",106331417,106383658,52241
"13646","ENSBTAG00000023792","9",42069410,42069847,437
"13647","ENSBTAG00000023795","18",1411461,1487893,76432
"13648","ENSBTAG00000023801","11",102648411,102655723,7312
"13649","ENSBTAG00000023806","4",4582609,4879280,296671
"13650","ENSBTAG00000023814","1",94709117,94769544,60427
"13651","ENSBTAG00000023823","11",98327773,98328090,317
"13652","ENSBTAG00000023831","15",62296511,62553952,257441
"13653","ENSBTAG00000023832","26",25733217,25745433,12216
"13654","ENSBTAG00000023840","26",44381768,44410582,28814
"13655","ENSBTAG00000023843","11",97676252,97978475,302223
"13656","ENSBTAG00000023845","26",42740067,42758179,18112
"13657","ENSBTAG00000023846","26",42705547,42724823,19276
"13658","ENSBTAG00000023847","26",42787849,42805854,18005
"13659","ENSBTAG00000023851","11",98609978,98643839,33861
"13660","ENSBTAG00000023860","11",94934572,94935072,500
"13661","ENSBTAG00000023867","11",94013635,94068398,54763
"13662","ENSBTAG00000023885","11",98162344,98177721,15377
"13663","ENSBTAG00000023891","26",31202529,31396918,194389
"13664","ENSBTAG00000023895","17",21203821,21205310,1489
"13665","ENSBTAG00000023907","1",145202138,145296595,94457
"13666","ENSBTAG00000023918","22",58105075,58106777,1702
"13667","ENSBTAG00000023920","13",25958776,26260117,301341
"13668","ENSBTAG00000023928","11",80160549,80165517,4968
"13669","ENSBTAG00000023929","11",71340649,71360069,19420
"13670","ENSBTAG00000023933","11",103886570,103916459,29889
"13671","ENSBTAG00000023938","11",72792306,72798612,6306
"13672","ENSBTAG00000023939","26",21016647,21044571,27924
"13673","ENSBTAG00000023941","26",20959602,20993598,33996
"13674","ENSBTAG00000023947","26",18846873,18854967,8094
"13675","ENSBTAG00000023963","2",115024497,115208409,183912
"13676","ENSBTAG00000023970","NKLS02000567.1",24629,36583,11954
"13677","ENSBTAG00000023976","11",67091343,67183466,92123
"13678","ENSBTAG00000023978","X",35737389,35738755,1366
"13679","ENSBTAG00000023989","15",1765943,1776398,10455
"13680","ENSBTAG00000023997","11",49427905,49431079,3174
"13681","ENSBTAG00000023998","18",45428673,45430823,2150
"13682","ENSBTAG00000023999","11",30916684,30965350,48666
"13683","ENSBTAG00000024000","11",49082202,49126498,44296
"13684","ENSBTAG00000024015","24",40329648,40995218,665570
"13685","ENSBTAG00000024019","11",36710560,36714886,4326
"13686","ENSBTAG00000024021","11",32884867,33050686,165819
"13687","ENSBTAG00000024027","1",45988289,45992514,4225
"13688","ENSBTAG00000024042","11",21205638,21213907,8269
"13689","ENSBTAG00000024044","11",21498947,21549080,50133
"13690","ENSBTAG00000024058","11",11158418,11161386,2968
"13691","ENSBTAG00000024065","4",105264583,105265590,1007
"13692","ENSBTAG00000024075","11",7241330,7296376,55046
"13693","ENSBTAG00000024081","8",84108482,84148356,39874
"13694","ENSBTAG00000024086","3",110694718,110698693,3975
"13695","ENSBTAG00000024091","11",1773930,1807073,33143
"13696","ENSBTAG00000024095","3",109552463,109625086,72623
"13697","ENSBTAG00000024096","3",109482124,109484586,2462
"13698","ENSBTAG00000024097","3",109431030,109437161,6131
"13699","ENSBTAG00000024105","11",1187496,1233256,45760
"13700","ENSBTAG00000024107","3",108007865,108062243,54378
"13701","ENSBTAG00000024115","3",104816227,104836692,20465
"13702","ENSBTAG00000024125","6",25639735,25639989,254
"13703","ENSBTAG00000024132","5",115736399,115818135,81736
"13704","ENSBTAG00000024137","3",101179099,101195422,16323
"13705","ENSBTAG00000024144","3",99870307,99881509,11202
"13706","ENSBTAG00000024157","4",119527577,119572571,44994
"13707","ENSBTAG00000024162","1",145299698,145325287,25589
"13708","ENSBTAG00000024195","3",92211535,92220923,9388
"13709","ENSBTAG00000024199","4",114599696,114852530,252834
"13710","ENSBTAG00000024204","4",113782741,113785400,2659
"13711","ENSBTAG00000024219","4",106181051,106197865,16814
"13712","ENSBTAG00000024233","8",54664424,54665074,650
"13713","ENSBTAG00000024240","3",69086075,69124464,38389
"13714","ENSBTAG00000024255","3",59636716,59736408,99692
"13715","ENSBTAG00000024269","3",51501752,51709606,207854
"13716","ENSBTAG00000024272","3",54620770,54626951,6181
"13717","ENSBTAG00000024275","7",82958858,83339303,380445
"13718","ENSBTAG00000024288","3",39743213,39756192,12979
"13719","ENSBTAG00000024291","4",92647910,92674005,26095
"13720","ENSBTAG00000024311","21",33006835,33008153,1318
"13721","ENSBTAG00000024318","5",102477517,102503677,26160
"13722","ENSBTAG00000024334","4",72118023,72118502,479
"13723","ENSBTAG00000024340","4",67204660,67207092,2432
"13724","ENSBTAG00000024341","4",68894951,68898550,3599
"13725","ENSBTAG00000024378","3",20338181,20351092,12911
"13726","ENSBTAG00000024379","4",44155991,44279731,123740
"13727","ENSBTAG00000024381","9",31675672,31849229,173557
"13728","ENSBTAG00000024387","4",49589564,49629500,39936
"13729","ENSBTAG00000024394","4",35390232,35616774,226542
"13730","ENSBTAG00000024406","4",25290663,25304186,13523
"13731","ENSBTAG00000024407","3",19220981,19221970,989
"13732","ENSBTAG00000024420","4",15425637,15603392,177755
"13733","ENSBTAG00000024426","4",12191129,12534305,343176
"13734","ENSBTAG00000024431","4",9789227,9870626,81399
"13735","ENSBTAG00000024443","16",70756420,70770905,14485
"13736","ENSBTAG00000024449","16",68929292,68991907,62615
"13737","ENSBTAG00000024450","7",19909945,19932216,22271
"13738","ENSBTAG00000024453","16",71969177,71971116,1939
"13739","ENSBTAG00000024470","3",14027673,14037569,9896
"13740","ENSBTAG00000024476","3",15612556,15616057,3501
"13741","ENSBTAG00000024482","16",56061197,56219499,158302
"13742","ENSBTAG00000024485","16",55095155,55166521,71366
"13743","ENSBTAG00000024487","3",16403439,16403984,545
"13744","ENSBTAG00000024490","NKLS02000657.1",3907,5600,1693
"13745","ENSBTAG00000024492","16",51406283,51420997,14714
"13746","ENSBTAG00000024493","16",41110223,41160245,50022
"13747","ENSBTAG00000024496","16",52022459,52038878,16419
"13748","ENSBTAG00000024497","16",52045644,52053426,7782
"13749","ENSBTAG00000024503","3",8286937,8290169,3232
"13750","ENSBTAG00000024507","3",9585689,9610110,24421
"13751","ENSBTAG00000024509","16",50833281,50834787,1506
"13752","ENSBTAG00000024520","16",49204778,49211520,6742
"13753","ENSBTAG00000024525","16",47103751,47104811,1060
"13754","ENSBTAG00000024534","3",1280068,1481060,200992
"13755","ENSBTAG00000024539","16",44108079,44179555,71476
"13756","ENSBTAG00000024542","16",39920499,39922955,2456
"13757","ENSBTAG00000024545","17",3009649,3332773,323124
"13758","ENSBTAG00000024548","16",37056980,37059848,2868
"13759","ENSBTAG00000024549","23",8784910,8795622,10712
"13760","ENSBTAG00000024552","4",117486089,117495638,9549
"13761","ENSBTAG00000024555","16",32202902,32313790,110888
"13762","ENSBTAG00000024560","16",29549972,29611628,61656
"13763","ENSBTAG00000024561","16",29079663,29087860,8197
"13764","ENSBTAG00000024578","6",25915658,25919961,4303
"13765","ENSBTAG00000024582","10",39647709,39648473,764
"13766","ENSBTAG00000024593","20",276084,277795,1711
"13767","ENSBTAG00000024595","9",76835566,76877167,41601
"13768","ENSBTAG00000024603","17",51223745,51460894,237149
"13769","ENSBTAG00000024605","17",62791053,62793922,2869
"13770","ENSBTAG00000024608","13",59420772,59421350,578
"13771","ENSBTAG00000024623","1",112686345,112686731,386
"13772","ENSBTAG00000024632","2",55584017,56790873,1206856
"13773","ENSBTAG00000024633","16",2164207,2241919,77712
"13774","ENSBTAG00000024643","1",110066582,110342096,275514
"13775","ENSBTAG00000024648","15",7854787,7966985,112198
"13776","ENSBTAG00000024657","15",81890485,81926989,36504
"13777","ENSBTAG00000024663","16",80916091,80929327,13236
"13778","ENSBTAG00000024675","X",74032519,74090164,57645
"13779","ENSBTAG00000024688","9",18523257,18646618,123361
"13780","ENSBTAG00000024701","15",80788220,80790815,2595
"13781","ENSBTAG00000024708","17",71345570,71417162,71592
"13782","ENSBTAG00000024715","15",77686573,77861198,174625
"13783","ENSBTAG00000024723","4",96468817,96761348,292531
"13784","ENSBTAG00000024726","3",113516126,113528914,12788
"13785","ENSBTAG00000024751","9",87170608,87183814,13206
"13786","ENSBTAG00000024756","5",119668631,119680303,11672
"13787","ENSBTAG00000024772","25",35784530,35789573,5043
"13788","ENSBTAG00000024773","9",50920530,50922123,1593
"13789","ENSBTAG00000024781","15",46383577,46385081,1504
"13790","ENSBTAG00000024787","6",116389998,116405083,15085
"13791","ENSBTAG00000024788","15",78050177,78051085,908
"13792","ENSBTAG00000024801","20",2765576,3149145,383569
"13793","ENSBTAG00000024803","15",15326369,15361768,35399
"13794","ENSBTAG00000024809","7",42489710,42498706,8996
"13795","ENSBTAG00000024814","29",50897509,50908967,11458
"13796","ENSBTAG00000024815","1",152701411,152833098,131687
"13797","ENSBTAG00000024822","11",102338051,102426270,88219
"13798","ENSBTAG00000024826","6",79787721,79930192,142471
"13799","ENSBTAG00000024839","19",41281287,41281841,554
"13800","ENSBTAG00000024849","3",31974420,31984308,9888
"13801","ENSBTAG00000024851","8",63216626,63241588,24962
"13802","ENSBTAG00000024852","22",51641063,51642757,1694
"13803","ENSBTAG00000024869","18",25383236,25395288,12052
"13804","ENSBTAG00000024874","NKLS02000723.1",7006,14630,7624
"13805","ENSBTAG00000024878","10",6541983,6677304,135321
"13806","ENSBTAG00000024884","25",1947613,1971554,23941
"13807","ENSBTAG00000024888","6",5745779,5894011,148232
"13808","ENSBTAG00000024889","18",25314722,25315535,813
"13809","ENSBTAG00000024899","19",61595260,61612886,17626
"13810","ENSBTAG00000024901","19",56811205,56847041,35836
"13811","ENSBTAG00000024903","19",60628086,60652364,24278
"13812","ENSBTAG00000024904","7",4967285,4978003,10718
"13813","ENSBTAG00000024909","19",55821418,55823783,2365
"13814","ENSBTAG00000024910","19",55583910,55586715,2805
"13815","ENSBTAG00000024915","19",50302442,50330000,27558
"13816","ENSBTAG00000024918","15",6392614,6406143,13529
"13817","ENSBTAG00000024926","19",53928092,53933612,5520
"13818","ENSBTAG00000024928","16",41499543,41534237,34694
"13819","ENSBTAG00000024929","19",51048368,51050321,1953
"13820","ENSBTAG00000024932","19",51236231,51242016,5785
"13821","ENSBTAG00000024934","19",50371764,50373381,1617
"13822","ENSBTAG00000024942","19",45252253,45252618,365
"13823","ENSBTAG00000024947","19",48100055,48108406,8351
"13824","ENSBTAG00000024950","19",47798389,47819083,20694
"13825","ENSBTAG00000024957","6",34853388,35000312,146924
"13826","ENSBTAG00000024958","10",57723231,57808958,85727
"13827","ENSBTAG00000024960","3",12021859,12154133,132274
"13828","ENSBTAG00000024964","12",17980048,17985061,5013
"13829","ENSBTAG00000024974","19",44822055,44828523,6468
"13830","ENSBTAG00000024979","19",42257571,42258084,513
"13831","ENSBTAG00000024980","11",19157433,19280885,123452
"13832","ENSBTAG00000024983","19",39504400,39530964,26564
"13833","ENSBTAG00000024984","14",69906195,69910872,4677
"13834","ENSBTAG00000024991","22",56594306,56600812,6506
"13835","ENSBTAG00000024999","26",25773638,25774852,1214
"13836","ENSBTAG00000025001","19",38966206,38985585,19379
"13837","ENSBTAG00000025003","27",37798728,37832194,33466
"13838","ENSBTAG00000025005","5",28996023,29007097,11074
"13839","ENSBTAG00000025021","28",2953439,3309533,356094
"13840","ENSBTAG00000025023","18",59963092,59964069,977
"13841","ENSBTAG00000025029","7",108794483,109024141,229658
"13842","ENSBTAG00000025035","20",38971752,39100563,128811
"13843","ENSBTAG00000025046","19",34422370,34439576,17206
"13844","ENSBTAG00000025062","X",75619961,75622204,2243
"13845","ENSBTAG00000025071","7",79741698,80302099,560401
"13846","ENSBTAG00000025078","19",33175247,33209224,33977
"13847","ENSBTAG00000025088","19",29028248,29036254,8006
"13848","ENSBTAG00000025099","7",70734078,70796882,62804
"13849","ENSBTAG00000025101","19",26856102,26877499,21397
"13850","ENSBTAG00000025121","19",24365491,24366340,849
"13851","ENSBTAG00000025124","7",62232854,62240214,7360
"13852","ENSBTAG00000025126","19",26063067,26066913,3846
"13853","ENSBTAG00000025129","19",23350891,23367411,16520
"13854","ENSBTAG00000025130","19",23073729,23079162,5433
"13855","ENSBTAG00000025136","7",62030519,62047672,17153
"13856","ENSBTAG00000025140","19",22472035,22494825,22790
"13857","ENSBTAG00000025146","7",14301752,14304506,2754
"13858","ENSBTAG00000025148","7",14408382,14415316,6934
"13859","ENSBTAG00000025149","19",26120560,26128006,7446
"13860","ENSBTAG00000025161","11",104087838,104100209,12371
"13861","ENSBTAG00000025165","19",46308772,46312096,3324
"13862","ENSBTAG00000025167","19",20816663,20821639,4976
"13863","ENSBTAG00000025181","21",64523697,64601628,77931
"13864","ENSBTAG00000025182","7",47371699,47390345,18646
"13865","ENSBTAG00000025183","19",35981207,35987326,6119
"13866","ENSBTAG00000025191","7",45805773,45817876,12103
"13867","ENSBTAG00000025192","12",86895159,86907629,12470
"13868","ENSBTAG00000025200","19",16022746,17228096,1205350
"13869","ENSBTAG00000025202","19",18113450,18114457,1007
"13870","ENSBTAG00000025210","12",85040120,85153241,113121
"13871","ENSBTAG00000025211","12",85262891,85269328,6437
"13872","ENSBTAG00000025212","7",51817094,51824132,7038
"13873","ENSBTAG00000025213","19",18690773,18693479,2706
"13874","ENSBTAG00000025219","19",14864233,14874109,9876
"13875","ENSBTAG00000025220","12",82805244,83413896,608652
"13876","ENSBTAG00000025221","12",79008112,79014993,6881
"13877","ENSBTAG00000025226","7",51314286,51314779,493
"13878","ENSBTAG00000025233","7",43673071,43679019,5948
"13879","ENSBTAG00000025242","19",13692001,13704939,12938
"13880","ENSBTAG00000025246","12",76738408,76742911,4503
"13881","ENSBTAG00000025250","19",14243466,14362161,118695
"13882","ENSBTAG00000025257","19",14339700,14341265,1565
"13883","ENSBTAG00000025258","19",14200469,14234712,34243
"13884","ENSBTAG00000025260","19",14290638,14291733,1095
"13885","ENSBTAG00000025263","17",6101574,6408853,307279
"13886","ENSBTAG00000025277","7",44190928,44199228,8300
"13887","ENSBTAG00000025283","18",14929572,14930102,530
"13888","ENSBTAG00000025297","NKLS02002208.1",8925403,8934589,9186
"13889","ENSBTAG00000025308","10",92548278,92725507,177229
"13890","ENSBTAG00000025313","19",8885982,8893225,7243
"13891","ENSBTAG00000025320","19",7931747,7965102,33355
"13892","ENSBTAG00000025324","10",90495258,91099930,604672
"13893","ENSBTAG00000025329","10",88236338,88238662,2324
"13894","ENSBTAG00000025335","11",73538055,73538448,393
"13895","ENSBTAG00000025337","19",29329634,29377097,47463
"13896","ENSBTAG00000025340","7",38024335,38070254,45919
"13897","ENSBTAG00000025345","7",37840043,37846096,6053
"13898","ENSBTAG00000025358","7",30993858,31052612,58754
"13899","ENSBTAG00000025372","10",84937977,84940480,2503
"13900","ENSBTAG00000025379","22",16105141,16105581,440
"13901","ENSBTAG00000025383","12",36232949,36235371,2422
"13902","ENSBTAG00000025385","10",83129255,83129884,629
"13903","ENSBTAG00000025398","23",29027762,29074861,47099
"13904","ENSBTAG00000025400","12",36398675,36474734,76059
"13905","ENSBTAG00000025401","7",39004313,39009596,5283
"13906","ENSBTAG00000025402","12",35819236,35848643,29407
"13907","ENSBTAG00000025403","10",86918978,87207088,288110
"13908","ENSBTAG00000025405","10",86713963,86736092,22129
"13909","ENSBTAG00000025410","23",27221530,27224272,2742
"13910","ENSBTAG00000025413","23",27209390,27212136,2746
"13911","ENSBTAG00000025424","23",27171388,27196528,25140
"13912","ENSBTAG00000025425","7",38770693,38775449,4756
"13913","ENSBTAG00000025426","7",38621346,38767518,146172
"13914","ENSBTAG00000025434","10",80614620,80620778,6158
"13915","ENSBTAG00000025441","23",27520317,27522790,2473
"13916","ENSBTAG00000025442","23",27523225,27527209,3984
"13917","ENSBTAG00000025443","7",22699064,22818191,119127
"13918","ENSBTAG00000025445","7",21534242,21534796,554
"13919","ENSBTAG00000025448","7",21448720,21451824,3104
"13920","ENSBTAG00000025450","10",76116422,76386867,270445
"13921","ENSBTAG00000025452","7",21392211,21401682,9471
"13922","ENSBTAG00000025458","10",84122761,84405606,282845
"13923","ENSBTAG00000025462","7",21118031,21120298,2267
"13924","ENSBTAG00000025471","23",27716168,27719047,2879
"13925","ENSBTAG00000025477","7",21600405,21687757,87352
"13926","ENSBTAG00000025485","23",25101816,25113151,11335
"13927","ENSBTAG00000025494","23",24783271,24826623,43352
"13928","ENSBTAG00000025496","10",65335566,65382146,46580
"13929","ENSBTAG00000025502","12",11051612,11086878,35266
"13930","ENSBTAG00000025516","23",28420981,28428768,7787
"13931","ENSBTAG00000025522","10",55636874,56319410,682536
"13932","ENSBTAG00000025526","23",28304399,28316822,12423
"13933","ENSBTAG00000025535","23",22288147,22307981,19834
"13934","ENSBTAG00000025540","7",18073858,18075473,1615
"13935","ENSBTAG00000025550","7",18545676,18548664,2988
"13936","ENSBTAG00000025554","23",17053108,17055851,2743
"13937","ENSBTAG00000025564","10",42657516,42657836,320
"13938","ENSBTAG00000025571","23",17178373,17194684,16311
"13939","ENSBTAG00000025589","23",36745642,37444814,699172
"13940","ENSBTAG00000025593","10",36139789,36160950,21161
"13941","ENSBTAG00000025597","7",43514607,43523552,8945
"13942","ENSBTAG00000025604","4",16376195,16376872,677
"13943","ENSBTAG00000025606","7",15362807,15368373,5566
"13944","ENSBTAG00000025612","11",98967372,99005387,38015
"13945","ENSBTAG00000025617","23",10550062,10565808,15746
"13946","ENSBTAG00000025622","23",9270961,9298630,27669
"13947","ENSBTAG00000025632","10",28299475,28303025,3550
"13948","ENSBTAG00000025634","10",29434772,29889488,454716
"13949","ENSBTAG00000025642","10",28728707,29032757,304050
"13950","ENSBTAG00000025644","10",102005601,102013441,7840
"13951","ENSBTAG00000025659","8",103087293,103285983,198690
"13952","ENSBTAG00000025664","10",26170839,26171786,947
"13953","ENSBTAG00000025666","10",26779223,26779393,170
"13954","ENSBTAG00000025667","8",105642638,106693624,1050986
"13955","ENSBTAG00000025669","23",7451914,7453547,1633
"13956","ENSBTAG00000025718","23",4789382,4986934,197552
"13957","ENSBTAG00000025748","7",7532069,7548204,16135
"13958","ENSBTAG00000025752","19",41998195,42004951,6756
"13959","ENSBTAG00000025755","10",21629668,21670962,41294
"13960","ENSBTAG00000025756","8",90070389,90104567,34178
"13961","ENSBTAG00000025760","8",91054950,91066006,11056
"13962","ENSBTAG00000025762","19",42130921,42138136,7215
"13963","ENSBTAG00000025764","21",27882488,27887238,4750
"13964","ENSBTAG00000025767","7",5669911,5676371,6460
"13965","ENSBTAG00000025775","7",5325748,5327331,1583
"13966","ENSBTAG00000025778","10",21010337,21012734,2397
"13967","ENSBTAG00000025782","8",104084879,104113971,29092
"13968","ENSBTAG00000025788","7",5023242,5027895,4653
"13969","ENSBTAG00000025792","8",75991936,75998591,6655
"13970","ENSBTAG00000025803","10",20546893,20559337,12444
"13971","ENSBTAG00000025809","7",5822739,5829866,7127
"13972","ENSBTAG00000025812","5",62897168,62900205,3037
"13973","ENSBTAG00000025814","10",19296226,19328757,32531
"13974","ENSBTAG00000025817","7",4065562,4078533,12971
"13975","ENSBTAG00000025822","10",15035521,15044913,9392
"13976","ENSBTAG00000025826","10",12524013,12550520,26507
"13977","ENSBTAG00000025830","8",70392762,70413064,20302
"13978","ENSBTAG00000025837","5",69980577,70051146,70569
"13979","ENSBTAG00000025848","X",86690453,86694645,4192
"13980","ENSBTAG00000025853","10",10413731,10546778,133047
"13981","ENSBTAG00000025856","10",10305686,10375811,70125
"13982","ENSBTAG00000025859","8",61215357,61488160,272803
"13983","ENSBTAG00000025868","8",59869867,59901292,31425
"13984","ENSBTAG00000025893","20",51049217,51567420,518203
"13985","ENSBTAG00000025898","11",5978170,6119371,141201
"13986","ENSBTAG00000025903","8",38219989,38308310,88321
"13987","ENSBTAG00000025920","6",83688444,83711845,23401
"13988","ENSBTAG00000025928","8",22650137,22650706,569
"13989","ENSBTAG00000025929","8",22191097,22237195,46098
"13990","ENSBTAG00000025931","15",54252856,54267975,15119
"13991","ENSBTAG00000025942","8",6787675,6824508,36833
"13992","ENSBTAG00000025951","X",137508112,137517391,9279
"13993","ENSBTAG00000025952","X",137458499,137467124,8625
"13994","ENSBTAG00000025953","12",9822966,9826585,3619
"13995","ENSBTAG00000025964","20",12444739,12621942,177203
"13996","ENSBTAG00000025968","13",23162791,23164043,1252
"13997","ENSBTAG00000026003","X",57773246,57923243,149997
"13998","ENSBTAG00000026004","18",3420515,3705995,285480
"13999","ENSBTAG00000026008","2",26534429,26545290,10861
"14000","ENSBTAG00000026011","X",13803847,13804218,371
"14001","ENSBTAG00000026025","X",74163752,74223598,59846
"14002","ENSBTAG00000026032","3",93467258,93529229,61971
"14003","ENSBTAG00000026034","11",23597191,23598353,1162
"14004","ENSBTAG00000026063","X",17090134,17090862,728
"14005","ENSBTAG00000026067","X",8634357,8655431,21074
"14006","ENSBTAG00000026068","4",105836216,105838965,2749
"14007","ENSBTAG00000026070","12",71263913,71411435,147522
"14008","ENSBTAG00000026080","18",62817836,62859813,41977
"14009","ENSBTAG00000026088","5",44365581,44371561,5980
"14010","ENSBTAG00000026097","22",53633801,53707789,73988
"14011","ENSBTAG00000026111","11",69617500,69644870,27370
"14012","ENSBTAG00000026114","3",117354167,117399773,45606
"14013","ENSBTAG00000026119","13",74331314,74343568,12254
"14014","ENSBTAG00000026122","2",11572543,11575764,3221
"14015","ENSBTAG00000026139","X",50671370,50673205,1835
"14016","ENSBTAG00000026148","7",10805680,10856126,50446
"14017","ENSBTAG00000026156","1",35036368,35123427,87059
"14018","ENSBTAG00000026163","23",25969346,26113857,144511
"14019","ENSBTAG00000026172","14",13920655,13925713,5058
"14020","ENSBTAG00000026181","3",113300772,113425176,124404
"14021","ENSBTAG00000026191","25",41806273,41819281,13008
"14022","ENSBTAG00000026194","25",40634554,40657410,22856
"14023","ENSBTAG00000026199","25",38799230,38802646,3416
"14024","ENSBTAG00000026234","14",65475373,65785445,310072
"14025","ENSBTAG00000026236","25",36445778,36450266,4488
"14026","ENSBTAG00000026242","14",61264782,61351893,87111
"14027","ENSBTAG00000026243","25",36106542,36107777,1235
"14028","ENSBTAG00000026246","25",35948115,35953198,5083
"14029","ENSBTAG00000026247","14",54884631,55054360,169729
"14030","ENSBTAG00000026248","25",35885025,35886758,1733
"14031","ENSBTAG00000026249","5",34992625,34997925,5300
"14032","ENSBTAG00000026250","6",28639989,28641315,1326
"14033","ENSBTAG00000026254","14",46782509,46801623,19114
"14034","ENSBTAG00000026259","1",1061262,1061597,335
"14035","ENSBTAG00000026260","1",1123943,1131748,7805
"14036","ENSBTAG00000026263","18",52099337,52107295,7958
"14037","ENSBTAG00000026266","24",37417773,37434615,16842
"14038","ENSBTAG00000026275","25",34065905,34069221,3316
"14039","ENSBTAG00000026278","25",33477756,33479301,1545
"14040","ENSBTAG00000026283","14",27016060,27203495,187435
"14041","ENSBTAG00000026286","25",32720293,32750192,29899
"14042","ENSBTAG00000026290","24",13877432,14042408,164976
"14043","ENSBTAG00000026307","25",26901426,26924098,22672
"14044","ENSBTAG00000026309","14",16772152,16792577,20425
"14045","ENSBTAG00000026319","25",26356699,26360506,3807
"14046","ENSBTAG00000026320","14",508418,512819,4401
"14047","ENSBTAG00000026323","5",44347280,44352877,5597
"14048","ENSBTAG00000026326","25",26509758,26513471,3713
"14049","ENSBTAG00000026327","14",321231,324177,2946
"14050","ENSBTAG00000026340","14",1763961,1785316,21355
"14051","ENSBTAG00000026344","14",1225047,1226102,1055
"14052","ENSBTAG00000026350","14",778853,806391,27538
"14053","ENSBTAG00000026356","14",603813,612791,8978
"14054","ENSBTAG00000026369","20",6918477,6930788,12311
"14055","ENSBTAG00000026371","25",10682180,11276292,594112
"14056","ENSBTAG00000026375","25",9989195,9994633,5438
"14057","ENSBTAG00000026381","25",7467949,7484414,16465
"14058","ENSBTAG00000026383","25",4113928,4150780,36852
"14059","ENSBTAG00000026384","12",28670476,28679944,9468
"14060","ENSBTAG00000026394","25",3743869,3749644,5775
"14061","ENSBTAG00000026400","25",3378007,3378979,972
"14062","ENSBTAG00000026403","25",3054344,3173309,118965
"14063","ENSBTAG00000026408","25",2575899,2579242,3343
"14064","ENSBTAG00000026415","25",1350952,1353440,2488
"14065","ENSBTAG00000026422","25",145229,152472,7243
"14066","ENSBTAG00000026428","8",17434137,17435288,1151
"14067","ENSBTAG00000026429","25",385890,396054,10164
"14068","ENSBTAG00000026437","NKLS02000657.1",86279,92859,6580
"14069","ENSBTAG00000026461","25",930615,988927,58312
"14070","ENSBTAG00000026467","5",119828131,119830234,2103
"14071","ENSBTAG00000026481","16",63701887,63732216,30329
"14072","ENSBTAG00000026489","5",112905857,112907803,1946
"14073","ENSBTAG00000026497","5",113536014,113537081,1067
"14074","ENSBTAG00000026501","5",113078007,113082470,4463
"14075","ENSBTAG00000026502","5",113086815,113094984,8169
"14076","ENSBTAG00000026505","20",21931661,21932086,425
"14077","ENSBTAG00000026519","9",80886590,80913788,27198
"14078","ENSBTAG00000026522","5",105166688,105173672,6984
"14079","ENSBTAG00000026523","9",81363245,81407582,44337
"14080","ENSBTAG00000026527","20",71681786,71694743,12957
"14081","ENSBTAG00000026578","9",65660807,65668486,7679
"14082","ENSBTAG00000026580","9",62865870,62866967,1097
"14083","ENSBTAG00000026585","2",129147034,129156032,8998
"14084","ENSBTAG00000026586","9",87305143,87396205,91062
"14085","ENSBTAG00000026604","9",60553611,60555713,2102
"14086","ENSBTAG00000026610","5",95091313,95099829,8516
"14087","ENSBTAG00000026611","5",88093458,88119778,26320
"14088","ENSBTAG00000026613","3",15038527,15042707,4180
"14089","ENSBTAG00000026624","5",84792354,84799340,6986
"14090","ENSBTAG00000026626","17",44283822,44291931,8109
"14091","ENSBTAG00000026637","9",40776340,40863105,86765
"14092","ENSBTAG00000026638","2",126896197,126910286,14089
"14093","ENSBTAG00000026645","19",56372336,56378527,6191
"14094","ENSBTAG00000026650","22",54091023,54091283,260
"14095","ENSBTAG00000026657","5",75135020,75158505,23485
"14096","ENSBTAG00000026660","2",124810107,124834049,23942
"14097","ENSBTAG00000026666","5",71726971,71732441,5470
"14098","ENSBTAG00000026672","9",34075211,34107222,32011
"14099","ENSBTAG00000026673","9",33876376,33923216,46840
"14100","ENSBTAG00000026676","2",122666044,122705716,39672
"14101","ENSBTAG00000026684","2",120951772,120969740,17968
"14102","ENSBTAG00000026696","2",121311608,121316192,4584
"14103","ENSBTAG00000026704","9",24949872,24958580,8708
"14104","ENSBTAG00000026710","2",118846915,118854132,7217
"14105","ENSBTAG00000026716","9",21998531,22080590,82059
"14106","ENSBTAG00000026732","17",62647846,62654912,7066
"14107","ENSBTAG00000026748","8",74669366,74693887,24521
"14108","ENSBTAG00000026751","2",106947262,106982235,34973
"14109","ENSBTAG00000026753","2",106215131,106219158,4027
"14110","ENSBTAG00000026754","5",57103613,57130431,26818
"14111","ENSBTAG00000026758","2",133387813,133397275,9462
"14112","ENSBTAG00000026768","29",49383349,49391410,8061
"14113","ENSBTAG00000026769","29",49311817,49313692,1875
"14114","ENSBTAG00000026772","2",106598789,106618772,19983
"14115","ENSBTAG00000026779","5",44506989,44515796,8807
"14116","ENSBTAG00000026788","2",121446978,121458374,11396
"14117","ENSBTAG00000026796","15",51510994,51515291,4297
"14118","ENSBTAG00000026809","11",21011494,21014844,3350
"14119","ENSBTAG00000026812","2",89366563,89441406,74843
"14120","ENSBTAG00000026813","5",29897816,29914225,16409
"14121","ENSBTAG00000026819","5",32462230,32499023,36793
"14122","ENSBTAG00000026825","2",71236196,71242268,6072
"14123","ENSBTAG00000026829","2",71939113,71941225,2112
"14124","ENSBTAG00000026836","1",45273441,45477104,203663
"14125","ENSBTAG00000026842","2",61831040,62103607,272567
"14126","ENSBTAG00000026848","3",11350806,11351297,491
"14127","ENSBTAG00000026851","2",43534082,43866708,332626
"14128","ENSBTAG00000026882","2",29992210,29995675,3465
"14129","ENSBTAG00000026885","2",27112408,27210473,98065
"14130","ENSBTAG00000026886","21",68460845,68462522,1677
"14131","ENSBTAG00000026893","21",67763709,67772885,9176
"14132","ENSBTAG00000026896","23",51700583,51705418,4835
"14133","ENSBTAG00000026909","7",110516617,110518766,2149
"14134","ENSBTAG00000026913","21",64632130,64661815,29685
"14135","ENSBTAG00000026915","8",1399005,1532028,133023
"14136","ENSBTAG00000026916","5",26568370,26571613,3243
"14137","ENSBTAG00000026917","21",59405098,59413707,8609
"14138","ENSBTAG00000026919","23",50215992,50234047,18055
"14139","ENSBTAG00000026936","6",12992269,13044915,52646
"14140","ENSBTAG00000026953","21",56677264,56744131,66867
"14141","ENSBTAG00000026962","5",49320765,49468018,147253
"14142","ENSBTAG00000026963","14",62384855,62715290,330435
"14143","ENSBTAG00000026966","5",15468393,15502249,33856
"14144","ENSBTAG00000026971","29",43280453,43297228,16775
"14145","ENSBTAG00000026972","5",10284434,10287669,3235
"14146","ENSBTAG00000026977","5",9954681,10250702,296021
"14147","ENSBTAG00000026993","5",47645210,47661694,16484
"14148","ENSBTAG00000026994","2",6100685,6178350,77665
"14149","ENSBTAG00000026995","21",49159484,49166919,7435
"14150","ENSBTAG00000027013","21",45771940,45773604,1664
"14151","ENSBTAG00000027015","11",31113278,31113971,693
"14152","ENSBTAG00000027017","11",27366407,27370463,4056
"14153","ENSBTAG00000027020","2",7198509,7357287,158778
"14154","ENSBTAG00000027024","21",42505542,42581786,76244
"14155","ENSBTAG00000027049","9",9683242,9726933,43691
"14156","ENSBTAG00000027051","2",125201951,125229055,27104
"14157","ENSBTAG00000027058","21",21187980,21190210,2230
"14158","ENSBTAG00000027059","21",21299134,21307567,8433
"14159","ENSBTAG00000027064","5",70577672,70908786,331114
"14160","ENSBTAG00000027069","21",23241767,23247121,5354
"14161","ENSBTAG00000027074","21",15832660,16079922,247262
"14162","ENSBTAG00000027075","21",13957423,13957794,371
"14163","ENSBTAG00000027080","10",81762305,81931753,169448
"14164","ENSBTAG00000027081","21",2758172,2940408,182236
"14165","ENSBTAG00000027118","27",32136982,32281530,144548
"14166","ENSBTAG00000027126","15",57270887,57284289,13402
"14167","ENSBTAG00000027134","4",13061840,13440805,378965
"14168","ENSBTAG00000027151","7",53810968,54280637,469669
"14169","ENSBTAG00000027159","2",120987011,120998937,11926
"14170","ENSBTAG00000027172","3",30167622,30168359,737
"14171","ENSBTAG00000027173","10",36719642,36755883,36241
"14172","ENSBTAG00000027181","24",32711020,32946065,235045
"14173","ENSBTAG00000027182","17",9583647,10018758,435111
"14174","ENSBTAG00000027197","23",13196359,13617580,421221
"14175","ENSBTAG00000027201","2",91652748,91750016,97268
"14176","ENSBTAG00000027204","4",106102213,106107665,5452
"14177","ENSBTAG00000027205","28",2317189,2413142,95953
"14178","ENSBTAG00000027213","1",104351156,104351809,653
"14179","ENSBTAG00000027221","13",53574804,53575268,464
"14180","ENSBTAG00000027245","23",29102226,29103164,938
"14181","ENSBTAG00000027246","23",29117026,29120016,2990
"14182","ENSBTAG00000027274","19",45160546,45189379,28833
"14183","ENSBTAG00000027279","23",29612534,29613169,635
"14184","ENSBTAG00000027312","9",76575373,76637507,62134
"14185","ENSBTAG00000027316","13",78115178,78143441,28263
"14186","ENSBTAG00000027317","13",78003747,78017910,14163
"14187","ENSBTAG00000027319","4",8735637,8740694,5057
"14188","ENSBTAG00000027320","13",77465721,77576217,110496
"14189","ENSBTAG00000027321","3",50177447,50290702,113255
"14190","ENSBTAG00000027326","13",75358504,75363411,4907
"14191","ENSBTAG00000027327","13",75242561,75249138,6577
"14192","ENSBTAG00000027337","13",74649200,74655766,6566
"14193","ENSBTAG00000027341","4",105092855,105101469,8614
"14194","ENSBTAG00000027348","15",83095368,83103258,7890
"14195","ENSBTAG00000027357","7",43258842,43262337,3495
"14196","ENSBTAG00000027361","13",64904969,64906500,1531
"14197","ENSBTAG00000027375","23",52251011,52297870,46859
"14198","ENSBTAG00000027386","13",60693347,60694291,944
"14199","ENSBTAG00000027387","13",60670297,60676670,6373
"14200","ENSBTAG00000027390","13",59446966,59490496,43530
"14201","ENSBTAG00000027396","16",28310572,28311011,439
"14202","ENSBTAG00000027397","13",56608374,56609273,899
"14203","ENSBTAG00000027405","13",54115803,54119242,3439
"14204","ENSBTAG00000027407","13",54054302,54055810,1508
"14205","ENSBTAG00000027409","13",51975288,51986307,11019
"14206","ENSBTAG00000027412","13",51472347,51472805,458
"14207","ENSBTAG00000027416","13",43129781,43130602,821
"14208","ENSBTAG00000027419","13",43770425,43784086,13661
"14209","ENSBTAG00000027420","13",42079466,42116216,36750
"14210","ENSBTAG00000027425","3",6567409,6576468,9059
"14211","ENSBTAG00000027426","16",63365483,63366634,1151
"14212","ENSBTAG00000027431","18",52154975,52167641,12666
"14213","ENSBTAG00000027434","6",113628521,114121393,492872
"14214","ENSBTAG00000027442","8",29852454,30102705,250251
"14215","ENSBTAG00000027444","13",34569531,34751826,182295
"14216","ENSBTAG00000027446","13",31063740,31271103,207363
"14217","ENSBTAG00000027453","6",116189720,116223849,34129
"14218","ENSBTAG00000027464","6",117346407,117358800,12393
"14219","ENSBTAG00000027477","15",83675492,83697268,21776
"14220","ENSBTAG00000027506","13",10562627,10576213,13586
"14221","ENSBTAG00000027513","6",88946402,88948465,2063
"14222","ENSBTAG00000027516","15",80445007,80448574,3567
"14223","ENSBTAG00000027524","15",80805386,80814111,8725
"14224","ENSBTAG00000027525","15",45917256,45918356,1100
"14225","ENSBTAG00000027534","6",88887161,88888249,1088
"14226","ENSBTAG00000027557","15",76642966,76648412,5446
"14227","ENSBTAG00000027562","15",75938260,75938905,645
"14228","ENSBTAG00000027563","15",74373004,74417594,44590
"14229","ENSBTAG00000027569","6",59713923,60095904,381981
"14230","ENSBTAG00000027577","15",64332509,64334453,1944
"14231","ENSBTAG00000027610","15",53690341,53690661,320
"14232","ENSBTAG00000027612","15",53580198,53629168,48970
"14233","ENSBTAG00000027625","27",36211720,36255293,43573
"14234","ENSBTAG00000027626","27",36419319,36436491,17172
"14235","ENSBTAG00000027629","27",36565855,36576598,10743
"14236","ENSBTAG00000027630","6",21963110,21976377,13267
"14237","ENSBTAG00000027635","27",33416459,33421456,4997
"14238","ENSBTAG00000027642","15",46828022,46832117,4095
"14239","ENSBTAG00000027651","15",48161137,48216925,55788
"14240","ENSBTAG00000027654","27",33247066,33269501,22435
"14241","ENSBTAG00000027665","27",33106589,33111356,4767
"14242","ENSBTAG00000027676","15",51640330,51642454,2124
"14243","ENSBTAG00000027684","15",51822102,51825811,3709
"14244","ENSBTAG00000027694","2",19259234,19262164,2930
"14245","ENSBTAG00000027696","2",19325706,19328340,2634
"14246","ENSBTAG00000027711","18",48119994,48129183,9189
"14247","ENSBTAG00000027713","7",90086801,90097728,10927
"14248","ENSBTAG00000027715","26",21188743,21189762,1019
"14249","ENSBTAG00000027716","15",41768051,41768347,296
"14250","ENSBTAG00000027722","15",43190698,43234275,43577
"14251","ENSBTAG00000027723","15",43295935,43296696,761
"14252","ENSBTAG00000027727","7",102468765,102595016,126251
"14253","ENSBTAG00000027728","7",102607083,102621109,14026
"14254","ENSBTAG00000027760","14",20253827,20255382,1555
"14255","ENSBTAG00000027764","10",61370363,61372119,1756
"14256","ENSBTAG00000027766","15",29920448,29922392,1944
"14257","ENSBTAG00000027770","5",315776,316705,929
"14258","ENSBTAG00000027772","15",29588693,29590407,1714
"14259","ENSBTAG00000027782","1",42792045,42793013,968
"14260","ENSBTAG00000027786","11",35187879,35188286,407
"14261","ENSBTAG00000027787","18",65442182,65442602,420
"14262","ENSBTAG00000027789","2",26648100,26689515,41415
"14263","ENSBTAG00000027795","1",108852511,108903175,50664
"14264","ENSBTAG00000027809","16",55481252,55578205,96953
"14265","ENSBTAG00000027825","6",112991815,113029319,37504
"14266","ENSBTAG00000027841","X",136346606,136694634,348028
"14267","ENSBTAG00000027843","X",52052105,52053716,1611
"14268","ENSBTAG00000027854","25",307142,312768,5626
"14269","ENSBTAG00000027865","20",24024507,24035304,10797
"14270","ENSBTAG00000027867","X",67443689,67674349,230660
"14271","ENSBTAG00000027868","29",11312721,12251182,938461
"14272","ENSBTAG00000027875","2",17799007,18020703,221696
"14273","ENSBTAG00000027878","7",6515994,6516491,497
"14274","ENSBTAG00000027879","9",101357585,101370280,12695
"14275","ENSBTAG00000027899","5",67513228,67590364,77136
"14276","ENSBTAG00000027900","5",14559465,14897805,338340
"14277","ENSBTAG00000027911","7",40945599,40946543,944
"14278","ENSBTAG00000027916","24",57775162,57839220,64058
"14279","ENSBTAG00000027924","20",24546479,24575118,28639
"14280","ENSBTAG00000027932","11",14960980,15176529,215549
"14281","ENSBTAG00000027936","3",51167249,51190724,23475
"14282","ENSBTAG00000027962","2",111893314,111893823,509
"14283","ENSBTAG00000027974","5",27188573,27197012,8439
"14284","ENSBTAG00000027978","X",50082237,50088295,6058
"14285","ENSBTAG00000027980","20",10375865,10379392,3527
"14286","ENSBTAG00000027983","20",10193836,10223904,30068
"14287","ENSBTAG00000027991","11",528774,626099,97325
"14288","ENSBTAG00000028036","3",22803213,22803376,163
"14289","ENSBTAG00000028061","10",9253341,9253451,110
"14290","ENSBTAG00000028065","6",60931808,60931922,114
"14291","ENSBTAG00000028094","24",10857708,10857898,190
"14292","ENSBTAG00000028103","5",85504473,85504581,108
"14293","ENSBTAG00000028153","24",45592736,45592842,106
"14294","ENSBTAG00000028229","3",9834671,9834832,161
"14295","ENSBTAG00000028273","16",37498632,37498749,117
"14296","ENSBTAG00000028324","21",42137944,42138066,122
"14297","ENSBTAG00000028358","7",51833316,51833412,96
"14298","ENSBTAG00000028359","19",9572654,9572868,214
"14299","ENSBTAG00000028419","21",44981342,44981500,158
"14300","ENSBTAG00000028421","19",14874860,14875020,160
"14301","ENSBTAG00000028430","18",43527774,43527888,114
"14302","ENSBTAG00000028443","22",58050567,58050685,118
"14303","ENSBTAG00000028457","4",88219942,88220045,103
"14304","ENSBTAG00000028669","13",65031157,65031263,106
"14305","ENSBTAG00000028675","6",44952095,44952205,110
"14306","ENSBTAG00000028682","29",47170779,47170896,117
"14307","ENSBTAG00000028692","19",49460369,49460486,117
"14308","ENSBTAG00000028696","19",9601108,9601318,210
"14309","ENSBTAG00000028860","4",113403220,113403350,130
"14310","ENSBTAG00000028880","16",56752306,56752416,110
"14311","ENSBTAG00000028980","6",6096389,6096502,113
"14312","ENSBTAG00000028988","16",64485072,64485200,128
"14313","ENSBTAG00000029055","7",61562578,61562738,160
"14314","ENSBTAG00000029069","17",53316080,53316260,180
"14315","ENSBTAG00000029075","8",69002381,69002488,107
"14316","ENSBTAG00000029076","11",46904152,46904271,119
"14317","ENSBTAG00000029114","24",11409550,11409675,125
"14318","ENSBTAG00000029115","8",63639555,63639673,118
"14319","ENSBTAG00000029119","16",65415033,65415142,109
"14320","ENSBTAG00000029126","5",89188741,89188850,109
"14321","ENSBTAG00000029173","23",16377849,16377963,114
"14322","ENSBTAG00000029206","7",15507786,15507905,119
"14323","ENSBTAG00000029237","4",112318247,112318367,120
"14324","ENSBTAG00000029283","7",50132003,50132116,113
"14325","ENSBTAG00000029291","25",7518566,7518678,112
"14326","ENSBTAG00000029295","19",22285575,22285686,111
"14327","ENSBTAG00000029317","18",58098539,58098664,125
"14328","ENSBTAG00000029474","23",8661833,8661951,118
"14329","ENSBTAG00000029512","10",43166613,43166773,160
"14330","ENSBTAG00000029576","4",115227674,115227785,111
"14331","ENSBTAG00000029640","18",14823839,14823992,153
"14332","ENSBTAG00000029651","20",19834881,19834994,113
"14333","ENSBTAG00000029761","8",69558096,69558177,81
"14334","ENSBTAG00000029769","17",72954604,72954671,67
"14335","ENSBTAG00000029771","18",36962003,36962116,113
"14336","ENSBTAG00000029772","5",116408410,116408483,73
"14337","ENSBTAG00000029775","19",51569617,51569708,91
"14338","ENSBTAG00000029776","8",9301923,9301993,70
"14339","ENSBTAG00000029778","8",98629023,98629092,69
"14340","ENSBTAG00000029788","5",26040777,26040881,104
"14341","ENSBTAG00000029791","21",65943493,65943618,125
"14342","ENSBTAG00000029792","21",65766670,65766784,114
"14343","ENSBTAG00000029793","13",51282157,51282242,85
"14344","ENSBTAG00000029797","3",74160334,74160419,85
"14345","ENSBTAG00000029802","12",65690103,65690209,106
"14346","ENSBTAG00000029803","X",98126615,98126724,109
"14347","ENSBTAG00000029807","X",18236376,18236457,81
"14348","ENSBTAG00000029811","7",61076246,61076327,81
"14349","ENSBTAG00000029812","19",26938001,26938094,93
"14350","ENSBTAG00000029817","25",36355766,36355842,76
"14351","ENSBTAG00000029818","X",34446937,34447017,80
"14352","ENSBTAG00000029822","19",21237995,21238114,119
"14353","ENSBTAG00000029825","22",48588901,48588990,89
"14354","ENSBTAG00000029826","23",24571300,24571404,104
"14355","ENSBTAG00000029827","1",20385501,20385585,84
"14356","ENSBTAG00000029828","X",76925561,76925668,107
"14357","ENSBTAG00000029830","7",72071548,72071646,98
"14358","ENSBTAG00000029833","15",54537263,54537364,101
"14359","ENSBTAG00000029836","9",10494819,10494902,83
"14360","ENSBTAG00000029844","18",57689557,57689642,85
"14361","ENSBTAG00000029846","8",81617234,81617337,103
"14362","ENSBTAG00000029848","25",13253584,13253670,86
"14363","ENSBTAG00000029850","2",106411182,106411289,107
"14364","ENSBTAG00000029851","24",57588139,57588232,93
"14365","ENSBTAG00000029852","5",25734105,25734194,89
"14366","ENSBTAG00000029853","8",85452957,85453043,86
"14367","ENSBTAG00000029855","3",80335436,80335518,82
"14368","ENSBTAG00000029857","7",60813550,60813637,87
"14369","ENSBTAG00000029862","8",46962508,46962613,105
"14370","ENSBTAG00000029865","14",3002368,3002461,93
"14371","ENSBTAG00000029867","12",19501050,19501144,94
"14372","ENSBTAG00000029869","5",55652073,55652156,83
"14373","ENSBTAG00000029870","X",90985646,90985764,118
"14374","ENSBTAG00000029880","18",57689045,57689153,108
"14375","ENSBTAG00000029881","15",32812702,32812774,72
"14376","ENSBTAG00000029884","4",94636455,94636537,82
"14377","ENSBTAG00000029885","X",18236527,18236618,91
"14378","ENSBTAG00000029886","16",39619547,39619658,111
"14379","ENSBTAG00000029887","21",65217708,65217808,100
"14380","ENSBTAG00000029889","X",34447971,34448055,84
"14381","ENSBTAG00000029890","7",15283405,15283487,82
"14382","ENSBTAG00000029892","19",37912298,37912412,114
"14383","ENSBTAG00000029893","7",88196006,88196092,86
"14384","ENSBTAG00000029896","11",95710188,95710276,88
"14385","ENSBTAG00000029897","19",10803462,10803553,91
"14386","ENSBTAG00000029901","7",11838702,11838776,74
"14387","ENSBTAG00000029903","11",38640690,38640798,108
"14388","ENSBTAG00000029906","24",34456691,34456777,86
"14389","ENSBTAG00000029909","8",77219239,77219385,146
"14390","ENSBTAG00000029913","22",50971462,50971548,86
"14391","ENSBTAG00000029914","19",18461502,18461612,110
"14392","ENSBTAG00000029917","5",61775955,61776054,99
"14393","ENSBTAG00000029918","18",57688886,57688965,79
"14394","ENSBTAG00000029920","25",36355959,36356057,98
"14395","ENSBTAG00000029921","3",33850268,33850375,107
"14396","ENSBTAG00000029924","16",44308925,44309031,106
"14397","ENSBTAG00000029925","15",32763901,32763988,87
"14398","ENSBTAG00000029926","24",34453354,34453464,110
"14399","ENSBTAG00000029927","2",20762743,20762841,98
"14400","ENSBTAG00000029930","19",22811560,22811660,100
"14401","ENSBTAG00000029932","8",39689023,39689113,90
"14402","ENSBTAG00000029933","18",53226503,53226596,93
"14403","ENSBTAG00000029938","18",24910562,24910671,109
"14404","ENSBTAG00000029940","29",43114348,43114453,105
"14405","ENSBTAG00000029949","13",64292583,64292680,97
"14406","ENSBTAG00000029950","X",23321233,23321322,89
"14407","ENSBTAG00000029951","12",65689417,65689500,83
"14408","ENSBTAG00000029954","8",81617785,81617869,84
"14409","ENSBTAG00000029955","19",18474461,18474541,80
"14410","ENSBTAG00000029956","8",23698518,23698618,100
"14411","ENSBTAG00000029957","22",50970980,50971083,103
"14412","ENSBTAG00000029970","4",68873154,68873238,84
"14413","ENSBTAG00000029974","11",98855737,98855836,99
"14414","ENSBTAG00000029976","25",14083795,14083857,62
"14415","ENSBTAG00000029979","11",104085473,104085545,72
"14416","ENSBTAG00000029982","19",9301432,9301518,86
"14417","ENSBTAG00000029983","6",12981071,12981138,67
"14418","ENSBTAG00000029988","5",24946401,24946511,110
"14419","ENSBTAG00000029989","8",81617017,81617103,86
"14420","ENSBTAG00000029993","16",77762664,77762773,109
"14421","ENSBTAG00000029994","5",50983045,50983152,107
"14422","ENSBTAG00000029996","7",11838877,11838949,72
"14423","ENSBTAG00000029998","16",51322680,51322765,85
"14424","ENSBTAG00000030013","X",87740078,87740157,79
"14425","ENSBTAG00000030014","10",54959645,54959739,94
"14426","ENSBTAG00000030016","21",65955335,65955413,78
"14427","ENSBTAG00000030019","X",76853198,76853303,105
"14428","ENSBTAG00000030024","X",18237434,18237542,108
"14429","ENSBTAG00000030035","21",65937001,65937101,100
"14430","ENSBTAG00000030052","21",33466498,33466572,74
"14431","ENSBTAG00000030053","16",23607933,23608029,96
"14432","ENSBTAG00000030056","16",23607646,23607724,78
"14433","ENSBTAG00000030060","19",36241834,36241922,88
"14434","ENSBTAG00000030066","19",10111632,10111745,113
"14435","ENSBTAG00000030068","18",55954104,55954203,99
"14436","ENSBTAG00000030071","7",11839032,11839103,71
"14437","ENSBTAG00000030082","22",35566748,35566823,75
"14438","ENSBTAG00000030083","15",73648217,73648315,98
"14439","ENSBTAG00000030084","X",18242401,18242483,82
"14440","ENSBTAG00000030085","28",30679777,30679861,84
"14441","ENSBTAG00000030086","24",35221931,35222022,91
"14442","ENSBTAG00000030095","4",9736854,9736948,94
"14443","ENSBTAG00000030100","25",13697719,13697800,81
"14444","ENSBTAG00000030105","1",148014653,148014709,56
"14445","ENSBTAG00000030109","19",30697356,30697455,99
"14446","ENSBTAG00000030114","7",60812121,60812221,100
"14447","ENSBTAG00000030117","11",98985275,98985370,95
"14448","ENSBTAG00000030123","29",43114571,43114653,82
"14449","ENSBTAG00000030162","19",62212833,62240091,27258
"14450","ENSBTAG00000030164","19",57192444,57196471,4027
"14451","ENSBTAG00000030166","19",57046406,57074416,28010
"14452","ENSBTAG00000030168","19",56219006,56223201,4195
"14453","ENSBTAG00000030169","19",56285455,56294354,8899
"14454","ENSBTAG00000030170","19",56301937,56318233,16296
"14455","ENSBTAG00000030172","19",55387190,55413082,25892
"14456","ENSBTAG00000030173","19",55416033,55440784,24751
"14457","ENSBTAG00000030174","19",55669917,55690559,20642
"14458","ENSBTAG00000030175","19",55694918,55716391,21473
"14459","ENSBTAG00000030179","5",119917200,119927553,10353
"14460","ENSBTAG00000030180","5",119959166,120006624,47458
"14461","ENSBTAG00000030182","5",119628483,119634547,6064
"14462","ENSBTAG00000030186","19",52491135,52491311,176
"14463","ENSBTAG00000030189","5",114398501,114511655,113154
"14464","ENSBTAG00000030190","3",116782465,116855219,72754
"14465","ENSBTAG00000030193","3",120005503,120020505,15002
"14466","ENSBTAG00000030198","7",109465394,109728291,262897
"14467","ENSBTAG00000030199","5",113563824,113564393,569
"14468","ENSBTAG00000030208","3",117490251,117498544,8293
"14469","ENSBTAG00000030209","19",51024277,51028502,4225
"14470","ENSBTAG00000030210","7",101399859,101511445,111586
"14471","ENSBTAG00000030222","5",112365014,112382131,17117
"14472","ENSBTAG00000030227","7",51980790,51986518,5728
"14473","ENSBTAG00000030230","19",50090108,50090521,413
"14474","ENSBTAG00000030246","11",106414236,106418732,4496
"14475","ENSBTAG00000030247","11",106433973,106439712,5739
"14476","ENSBTAG00000030255","5",109498401,109504537,6136
"14477","ENSBTAG00000030257","5",109484519,109497008,12489
"14478","ENSBTAG00000030258","5",109423829,109432050,8221
"14479","ENSBTAG00000030259","7",80980518,81243270,262752
"14480","ENSBTAG00000030269","2",130852073,130855680,3607
"14481","ENSBTAG00000030274","7",79108303,79109525,1222
"14482","ENSBTAG00000030278","11",104078014,104087183,9169
"14483","ENSBTAG00000030281","11",104132816,104133394,578
"14484","ENSBTAG00000030282","7",71977548,71983246,5698
"14485","ENSBTAG00000030285","5",108315553,108358134,42581
"14486","ENSBTAG00000030286","7",73580713,73638540,57827
"14487","ENSBTAG00000030296","11",106026182,106027931,1749
"14488","ENSBTAG00000030297","7",68202026,68301805,99779
"14489","ENSBTAG00000030301","3",109649571,109671174,21603
"14490","ENSBTAG00000030302","11",105948272,105952220,3948
"14491","ENSBTAG00000030305","19",43289823,43290301,478
"14492","ENSBTAG00000030308","19",43234239,43234428,189
"14493","ENSBTAG00000030317","11",105806918,105810439,3521
"14494","ENSBTAG00000030319","11",103136831,103147276,10445
"14495","ENSBTAG00000030322","2",134156462,134190663,34201
"14496","ENSBTAG00000030325","5",106901262,106904482,3220
"14497","ENSBTAG00000030333","19",42872899,42879842,6943
"14498","ENSBTAG00000030334","19",42863961,42872446,8485
"14499","ENSBTAG00000030335","2",133756949,133790322,33373
"14500","ENSBTAG00000030337","3",107111822,107117831,6009
"14501","ENSBTAG00000030338","3",107109148,107110689,1541
"14502","ENSBTAG00000030340","2",133705999,133751262,45263
"14503","ENSBTAG00000030343","5",105717373,105726492,9119
"14504","ENSBTAG00000030347","19",42720105,42725012,4907
"14505","ENSBTAG00000030348","18",63773648,63785937,12289
"14506","ENSBTAG00000030366","7",62054328,62064514,10186
"14507","ENSBTAG00000030367","2",132887311,132888400,1089
"14508","ENSBTAG00000030369","5",103857364,103869610,12246
"14509","ENSBTAG00000030384","11",104259371,104263171,3800
"14510","ENSBTAG00000030393","18",62337525,62355536,18011
"14511","ENSBTAG00000030403","18",61941890,61947502,5612
"14512","ENSBTAG00000030423","5",99905264,99936312,31048
"14513","ENSBTAG00000030424","5",99860312,99880739,20427
"14514","ENSBTAG00000030425","2",129296772,129298371,1599
"14515","ENSBTAG00000030426","5",99732061,99752814,20753
"14516","ENSBTAG00000030431","17",62195464,62196015,551
"14517","ENSBTAG00000030432","10",100503012,100562243,59231
"14518","ENSBTAG00000030434","2",129056428,129079502,23074
"14519","ENSBTAG00000030435","2",128938566,128942609,4043
"14520","ENSBTAG00000030440","18",60158850,60160418,1568
"14521","ENSBTAG00000030444","18",60198992,60201208,2216
"14522","ENSBTAG00000030453","10",100258195,100300825,42630
"14523","ENSBTAG00000030454","18",59112408,59112683,275
"14524","ENSBTAG00000030456","10",100119398,100157580,38182
"14525","ENSBTAG00000030470","18",58759820,58761133,1313
"14526","ENSBTAG00000030471","5",98588763,98589680,917
"14527","ENSBTAG00000030472","5",98558817,98559755,938
"14528","ENSBTAG00000030474","7",52258295,52341360,83065
"14529","ENSBTAG00000030482","18",56945611,56954174,8563
"14530","ENSBTAG00000030483","18",56959221,56966133,6912
"14531","ENSBTAG00000030484","18",57002427,57006377,3950
"14532","ENSBTAG00000030490","X",102727884,102728396,512
"14533","ENSBTAG00000030493","5",91998258,92008654,10396
"14534","ENSBTAG00000030499","7",52602569,52714255,111686
"14535","ENSBTAG00000030502","18",55747757,55754229,6472
"14536","ENSBTAG00000030503","5",95136650,95137326,676
"14537","ENSBTAG00000030504","5",95139257,95152774,13517
"14538","ENSBTAG00000030505","18",55721186,55731888,10702
"14539","ENSBTAG00000030507","X",17769765,17770925,1160
"14540","ENSBTAG00000030517","7",50730802,50732591,1789
"14541","ENSBTAG00000030518","7",50720267,50729286,9019
"14542","ENSBTAG00000030520","7",50662953,50669077,6124
"14543","ENSBTAG00000030521","11",99627619,99629173,1554
"14544","ENSBTAG00000030523","19",40217187,40226085,8898
"14545","ENSBTAG00000030529","7",49736828,49746610,9782
"14546","ENSBTAG00000030533","22",16322086,16322502,416
"14547","ENSBTAG00000030539","19",40860845,40870069,9224
"14548","ENSBTAG00000030540","11",99223908,99228202,4294
"14549","ENSBTAG00000030542","19",40945832,40953601,7769
"14550","ENSBTAG00000030543","18",55770345,55813187,42842
"14551","ENSBTAG00000030544","10",71970885,71971284,399
"14552","ENSBTAG00000030546","19",40963732,40969876,6144
"14553","ENSBTAG00000030548","19",40975417,40982582,7165
"14554","ENSBTAG00000030555","19",40990474,40998423,7949
"14555","ENSBTAG00000030556","13",81116533,81153629,37096
"14556","ENSBTAG00000030557","10",85448145,85560860,112715
"14557","ENSBTAG00000030563","18",56002108,56008411,6303
"14558","ENSBTAG00000030566","11",99065765,99091383,25618
"14559","ENSBTAG00000030567","11",99034978,99062572,27594
"14560","ENSBTAG00000030575","5",83818249,83821356,3107
"14561","ENSBTAG00000030578","18",56202605,56210298,7693
"14562","ENSBTAG00000030581","1",154096128,154616588,520460
"14563","ENSBTAG00000030584","7",51738224,51743133,4909
"14564","ENSBTAG00000030585","1",148736485,148757447,20962
"14565","ENSBTAG00000030587","19",39454627,39495001,40374
"14566","ENSBTAG00000030589","7",51772645,51778631,5986
"14567","ENSBTAG00000030591","19",39383537,39403756,20219
"14568","ENSBTAG00000030592","1",152412955,152413176,221
"14569","ENSBTAG00000030593","1",153335376,153514351,178975
"14570","ENSBTAG00000030595","10",82020450,82060888,40438
"14571","ENSBTAG00000030599","10",81593314,81739443,146129
"14572","ENSBTAG00000030600","18",2763307,2799457,36150
"14573","ENSBTAG00000030608","11",98883625,98889564,5939
"14574","ENSBTAG00000030616","7",44567086,44580862,13776
"14575","ENSBTAG00000030622","5",82070566,82077399,6833
"14576","ENSBTAG00000030624","13",73482621,73485588,2967
"14577","ENSBTAG00000030629","1",148405188,148407258,2070
"14578","ENSBTAG00000030632","5",76107001,76113238,6237
"14579","ENSBTAG00000030646","5",75479863,75490596,10733
"14580","ENSBTAG00000030648","5",75441888,75452001,10113
"14581","ENSBTAG00000030650","5",75435115,75442678,7563
"14582","ENSBTAG00000030652","5",75415497,75433378,17881
"14583","ENSBTAG00000030667","18",55008781,55034574,25793
"14584","ENSBTAG00000030669","3",86213982,86718004,504022
"14585","ENSBTAG00000030670","1",146001886,146105891,104005
"14586","ENSBTAG00000030671","3",86093399,86163267,69868
"14587","ENSBTAG00000030672","3",105246277,105247600,1323
"14588","ENSBTAG00000030674","3",80160692,80251376,90684
"14589","ENSBTAG00000030675","11",93986475,93994983,8508
"14590","ENSBTAG00000030677","11",93938998,93939945,947
"14591","ENSBTAG00000030678","11",93930436,93931311,875
"14592","ENSBTAG00000030683","5",71698793,71702575,3782
"14593","ENSBTAG00000030686","3",80586058,80721387,135329
"14594","ENSBTAG00000030690","25",39135358,39189367,54009
"14595","ENSBTAG00000030705","18",53775046,53776269,1223
"14596","ENSBTAG00000030706","3",82149562,82208238,58676
"14597","ENSBTAG00000030710","3",82052300,82157897,105597
"14598","ENSBTAG00000030711","7",42512363,42523170,10807
"14599","ENSBTAG00000030718","2",118803760,118824701,20941
"14600","ENSBTAG00000030721","25",41614415,41615906,1491
"14601","ENSBTAG00000030735","7",40939174,40939431,257
"14602","ENSBTAG00000030744","5",67769135,67787287,18152
"14603","ENSBTAG00000030749","3",79928534,80107385,178851
"14604","ENSBTAG00000030757","25",41262535,41265185,2650
"14605","ENSBTAG00000030769","18",54448493,54458165,9672
"14606","ENSBTAG00000030775","1",145395830,145625230,229400
"14607","ENSBTAG00000030784","5",68701383,68753242,51859
"14608","ENSBTAG00000030792","10",74249809,74263081,13272
"14609","ENSBTAG00000030798","13",74462999,74473574,10575
"14610","ENSBTAG00000030801","10",72895064,73105089,210025
"14611","ENSBTAG00000030809","3",78193289,78238376,45087
"14612","ENSBTAG00000030814","1",142614729,142618268,3539
"14613","ENSBTAG00000030817","4",118164563,118297036,132473
"14614","ENSBTAG00000030820","19",34870103,34882343,12240
"14615","ENSBTAG00000030824","10",71747240,71759825,12585
"14616","ENSBTAG00000030834","11",77600906,77601361,455
"14617","ENSBTAG00000030836","1",142235364,142253631,18267
"14618","ENSBTAG00000030838","4",119842607,119844347,1740
"14619","ENSBTAG00000030839","7",43787377,43804425,17048
"14620","ENSBTAG00000030841","10",21174936,21175457,521
"14621","ENSBTAG00000030845","15",82340377,82344478,4101
"14622","ENSBTAG00000030847","15",82122690,82192681,69991
"14623","ENSBTAG00000030852","3",79276910,79495833,218923
"14624","ENSBTAG00000030855","22",60288809,60389500,100691
"14625","ENSBTAG00000030864","11",74947557,74974106,26549
"14626","ENSBTAG00000030876","4",118379151,118383785,4634
"14627","ENSBTAG00000030881","10",69005149,69075633,70484
"14628","ENSBTAG00000030882","18",52866318,52879994,13676
"14629","ENSBTAG00000030885","18",61999364,62021041,21677
"14630","ENSBTAG00000030892","3",120965775,120967515,1740
"14631","ENSBTAG00000030897","4",115029143,115054271,25128
"14632","ENSBTAG00000030898","15",83336563,83357744,21181
"14633","ENSBTAG00000030908","15",81371590,81372534,944
"14634","ENSBTAG00000030910","16",75850895,75887017,36122
"14635","ENSBTAG00000030913","1",141677687,141706496,28809
"14636","ENSBTAG00000030915","22",59047392,59063800,16408
"14637","ENSBTAG00000030920","15",78791037,78836139,45102
"14638","ENSBTAG00000030921","1",141551208,141617001,65793
"14639","ENSBTAG00000030922","18",51930901,51935780,4879
"14640","ENSBTAG00000030927","17",72202848,72205217,2369
"14641","ENSBTAG00000030929","7",15992197,16008612,16415
"14642","ENSBTAG00000030930","22",59150394,59165062,14668
"14643","ENSBTAG00000030932","3",66053647,66071372,17725
"14644","ENSBTAG00000030933","18",51819508,51822907,3399
"14645","ENSBTAG00000030939","18",51736504,51738764,2260
"14646","ENSBTAG00000030940","4",113112102,113120508,8406
"14647","ENSBTAG00000030941","22",59245948,59246502,554
"14648","ENSBTAG00000030942","1",138384449,138441532,57083
"14649","ENSBTAG00000030951","25",36823704,36854971,31267
"14650","ENSBTAG00000030953","8",91601787,91603159,1372
"14651","ENSBTAG00000030960","8",101055832,101073360,17528
"14652","ENSBTAG00000030962","22",59392854,59502236,109382
"14653","ENSBTAG00000030965","25",36349409,36356836,7427
"14654","ENSBTAG00000030966","25",36338014,36345320,7306
"14655","ENSBTAG00000030973","2",107214372,107220493,6121
"14656","ENSBTAG00000030974","2",107196605,107203963,7358
"14657","ENSBTAG00000030977","19",33821553,33860333,38780
"14658","ENSBTAG00000030979","17",72342836,72348560,5724
"14659","ENSBTAG00000030990","13",64573005,64669659,96654
"14660","ENSBTAG00000030993","1",139470703,139512432,41729
"14661","ENSBTAG00000030994","5",62889233,63318266,429033
"14662","ENSBTAG00000031001","18",50923578,50962105,38527
"14663","ENSBTAG00000031004","18",50916109,50918408,2299
"14664","ENSBTAG00000031010","1",136905776,137025947,120171
"14665","ENSBTAG00000031012","3",67430365,67568076,137711
"14666","ENSBTAG00000031014","11",78103100,78189034,85934
"14667","ENSBTAG00000031017","15",80078544,80120961,42417
"14668","ENSBTAG00000031018","17",72426305,72430254,3949
"14669","ENSBTAG00000031020","X",130729214,130732315,3101
"14670","ENSBTAG00000031030","15",78056798,78057697,899
"14671","ENSBTAG00000031032","15",78104674,78105603,929
"14672","ENSBTAG00000031041","2",107020701,107112857,92156
"14673","ENSBTAG00000031044","3",66805158,66883012,77854
"14674","ENSBTAG00000031052","2",106899057,106900178,1121
"14675","ENSBTAG00000031059","4",112737745,112749403,11658
"14676","ENSBTAG00000031061","29",50530776,50535562,4786
"14677","ENSBTAG00000031069","7",30802398,30977434,175036
"14678","ENSBTAG00000031071","19",33088756,33101488,12732
"14679","ENSBTAG00000031076","5",56354793,56355368,575
"14680","ENSBTAG00000031084","19",32923502,32946876,23374
"14681","ENSBTAG00000031106","4",112486138,112508291,22153
"14682","ENSBTAG00000031107","19",31738492,31823297,84805
"14683","ENSBTAG00000031115","22",57132772,57172276,39504
"14684","ENSBTAG00000031119","15",77971869,77972819,950
"14685","ENSBTAG00000031134","17",70503548,70513355,9807
"14686","ENSBTAG00000031135","7",26301527,26313850,12323
"14687","ENSBTAG00000031145","X",124795331,124810537,15206
"14688","ENSBTAG00000031146","5",57378226,57399551,21325
"14689","ENSBTAG00000031150","11",72984743,73002321,17578
"14690","ENSBTAG00000031160","17",70949587,70953164,3577
"14691","ENSBTAG00000031165","10",59648276,59757063,108787
"14692","ENSBTAG00000031166","2",94606160,94620206,14046
"14693","ENSBTAG00000031171","3",57269358,57314453,45095
"14694","ENSBTAG00000031178","1",125042863,125706599,663736
"14695","ENSBTAG00000031184","29",48728420,48730918,2498
"14696","ENSBTAG00000031185","11",72414856,72419512,4656
"14697","ENSBTAG00000031186","3",54583803,54594324,10521
"14698","ENSBTAG00000031188","13",67456808,67467119,10311
"14699","ENSBTAG00000031194","29",48689532,48690587,1055
"14700","ENSBTAG00000031197","6",115032113,115036013,3900
"14701","ENSBTAG00000031205","7",22284793,22285584,791
"14702","ENSBTAG00000031209","7",22087256,22130086,42830
"14703","ENSBTAG00000031214","13",61382771,61393302,10531
"14704","ENSBTAG00000031217","5",57165321,57168025,2704
"14705","ENSBTAG00000031231","7",21938614,21946679,8065
"14706","ENSBTAG00000031234","4",105572011,105573193,1182
"14707","ENSBTAG00000031238","16",63941657,63985594,43937
"14708","ENSBTAG00000031242","21",69414725,69415393,668
"14709","ENSBTAG00000031246","7",21589912,21595092,5180
"14710","ENSBTAG00000031249","23",50462332,50466481,4149
"14711","ENSBTAG00000031252","15",74642574,74699576,57002
"14712","ENSBTAG00000031254","13",61067234,61069998,2764
"14713","ENSBTAG00000031261","X",126295546,126474884,179338
"14714","ENSBTAG00000031265","4",102292874,102379468,86594
"14715","ENSBTAG00000031266","18",48872709,48872817,108
"14716","ENSBTAG00000031267","23",50784498,50793488,8990
"14717","ENSBTAG00000031277","1",130185388,130186521,1133
"14718","ENSBTAG00000031279","17",69961734,69964249,2515
"14719","ENSBTAG00000031287","22",54003481,54005095,1614
"14720","ENSBTAG00000031295","8",101747810,101808119,60309
"14721","ENSBTAG00000031299","15",73461093,73588098,127005
"14722","ENSBTAG00000031306","1",122041887,122092789,50902
"14723","ENSBTAG00000031309","15",67019957,67027721,7764
"14724","ENSBTAG00000031327","21",68165568,68172830,7262
"14725","ENSBTAG00000031332","11",71835379,71932235,96856
"14726","ENSBTAG00000031335","11",71413781,71835625,421844
"14727","ENSBTAG00000031340","22",53488975,53569073,80098
"14728","ENSBTAG00000031346","1",118367157,118397535,30378
"14729","ENSBTAG00000031347","11",70928399,70967857,39458
"14730","ENSBTAG00000031348","22",53413330,53431445,18115
"14731","ENSBTAG00000031351","17",69451575,69467562,15987
"14732","ENSBTAG00000031352","7",20868563,20873708,5145
"14733","ENSBTAG00000031354","13",62824630,62843810,19180
"14734","ENSBTAG00000031355","22",53199438,53206002,6564
"14735","ENSBTAG00000031358","3",45408337,46330781,922444
"14736","ENSBTAG00000031359","8",85569397,85573428,4031
"14737","ENSBTAG00000031361","13",62791793,62810151,18358
"14738","ENSBTAG00000031362","15",25175647,25188639,12992
"14739","ENSBTAG00000031363","7",20734843,20743350,8507
"14740","ENSBTAG00000031376","13",62565844,62575200,9356
"14741","ENSBTAG00000031377","23",45261108,45302248,41140
"14742","ENSBTAG00000031383","7",20433050,20436476,3426
"14743","ENSBTAG00000031385","16",57201765,57426155,224390
"14744","ENSBTAG00000031387","7",20384849,20403319,18470
"14745","ENSBTAG00000031388","10",54845673,54912940,67267
"14746","ENSBTAG00000031395","6",116603966,116605738,1772
"14747","ENSBTAG00000031396","10",54442238,54445147,2909
"14748","ENSBTAG00000031402","13",61807148,61871197,64049
"14749","ENSBTAG00000031412","7",41081476,41082402,926
"14750","ENSBTAG00000031420","18",45976978,46011915,34937
"14751","ENSBTAG00000031432","23",49417555,49509663,92108
"14752","ENSBTAG00000031433","10",53978331,54099037,120706
"14753","ENSBTAG00000031435","1",117507281,117537602,30321
"14754","ENSBTAG00000031439","3",42742189,42956403,214214
"14755","ENSBTAG00000031441","18",45875895,45890910,15015
"14756","ENSBTAG00000031444","23",48528620,48571694,43074
"14757","ENSBTAG00000031447","22",52731581,52739251,7670
"14758","ENSBTAG00000031453","13",61525479,61545528,20049
"14759","ENSBTAG00000031454","22",52671297,52675596,4299
"14760","ENSBTAG00000031458","4",100220736,100222985,2249
"14761","ENSBTAG00000031461","3",44501668,44620479,118811
"14762","ENSBTAG00000031462","13",59442370,59443937,1567
"14763","ENSBTAG00000031464","4",83946063,83946737,674
"14764","ENSBTAG00000031468","17",66340591,66340983,392
"14765","ENSBTAG00000031473","2",89551970,89589796,37826
"14766","ENSBTAG00000031476","9",103923192,103932600,9408
"14767","ENSBTAG00000031481","9",101983669,101992479,8810
"14768","ENSBTAG00000031483","29",39522467,39522916,449
"14769","ENSBTAG00000031497","6",111124401,111127372,2971
"14770","ENSBTAG00000031500","5",56208141,56213412,5271
"14771","ENSBTAG00000031503","5",56205859,56208161,2302
"14772","ENSBTAG00000031509","19",27879985,27895903,15918
"14773","ENSBTAG00000031519","22",52297736,52301963,4227
"14774","ENSBTAG00000031523","X",97200352,97202796,2444
"14775","ENSBTAG00000031532","9",102551963,102558097,6134
"14776","ENSBTAG00000031544","5",55955676,55960509,4833
"14777","ENSBTAG00000031548","4",98884574,98969970,85396
"14778","ENSBTAG00000031551","25",27194320,27199629,5309
"14779","ENSBTAG00000031553","6",117639869,117647357,7488
"14780","ENSBTAG00000031558","21",37872895,37876419,3524
"14781","ENSBTAG00000031561","1",108967043,109414482,447439
"14782","ENSBTAG00000031564","X",92033596,92062014,28418
"14783","ENSBTAG00000031567","22",51958135,52083698,125563
"14784","ENSBTAG00000031569","8",79263894,79310527,46633
"14785","ENSBTAG00000031572","1",107094668,107209406,114738
"14786","ENSBTAG00000031573","7",20064778,20069191,4413
"14787","ENSBTAG00000031575","3",35311502,35742106,430604
"14788","ENSBTAG00000031579","2",89070545,89099327,28782
"14789","ENSBTAG00000031583","25",27771475,27772376,901
"14790","ENSBTAG00000031590","29",45224453,45232151,7698
"14791","ENSBTAG00000031595","2",88247850,88474527,226677
"14792","ENSBTAG00000031598","25",27661422,27688636,27214
"14793","ENSBTAG00000031600","3",106275387,106278741,3354
"14794","ENSBTAG00000031609","15",55762482,55791234,28752
"14795","ENSBTAG00000031614","2",86226319,86295210,68891
"14796","ENSBTAG00000031618","1",99823209,99990635,167426
"14797","ENSBTAG00000031625","13",55005743,55010024,4281
"14798","ENSBTAG00000031631","16",51253733,51257855,4122
"14799","ENSBTAG00000031632","8",73960006,74069341,109335
"14800","ENSBTAG00000031641","18",48185748,48192106,6358
"14801","ENSBTAG00000031647","7",19596244,19599321,3077
"14802","ENSBTAG00000031654","3",31311513,31530748,219235
"14803","ENSBTAG00000031655","3",34324532,34324753,221
"14804","ENSBTAG00000031658","7",19574478,19584168,9690
"14805","ENSBTAG00000031669","11",54799681,55985486,1185805
"14806","ENSBTAG00000031673","7",19261039,19274362,13323
"14807","ENSBTAG00000031677","18",47407443,47407563,120
"14808","ENSBTAG00000031679","6",102192504,102212283,19779
"14809","ENSBTAG00000031682","8",83792462,83801382,8920
"14810","ENSBTAG00000031686","18",47044284,47073493,29209
"14811","ENSBTAG00000031687","18",46874000,46874878,878
"14812","ENSBTAG00000031688","29",44669850,44677601,7751
"14813","ENSBTAG00000031693","17",62234500,62241953,7453
"14814","ENSBTAG00000031696","2",85567851,85752864,185013
"14815","ENSBTAG00000031697","10",42707567,42747501,39934
"14816","ENSBTAG00000031701","9",95362987,95372456,9469
"14817","ENSBTAG00000031704","1",99548884,99579160,30276
"14818","ENSBTAG00000031707","10",44297021,44564023,267002
"14819","ENSBTAG00000031709","1",99744376,99804996,60620
"14820","ENSBTAG00000031711","2",21024923,21025513,590
"14821","ENSBTAG00000031715","13",53650816,53668895,18079
"14822","ENSBTAG00000031716","13",54576866,54581460,4594
"14823","ENSBTAG00000031718","13",54566977,54575829,8852
"14824","ENSBTAG00000031723","17",61837376,61843934,6558
"14825","ENSBTAG00000031724","9",96122643,96123620,977
"14826","ENSBTAG00000031725","19",27283307,27291150,7843
"14827","ENSBTAG00000031731","11",49922458,49922739,281
"14828","ENSBTAG00000031737","19",27112268,27114980,2712
"14829","ENSBTAG00000031741","23",31448749,31458492,9743
"14830","ENSBTAG00000031747","23",31565290,31573268,7978
"14831","ENSBTAG00000031749","16",50965708,50979510,13802
"14832","ENSBTAG00000031750","6",97881687,97916809,35122
"14833","ENSBTAG00000031752","19",27081979,27083126,1147
"14834","ENSBTAG00000031753","23",31585191,31591478,6287
"14835","ENSBTAG00000031764","13",54235833,54238433,2600
"14836","ENSBTAG00000031765","25",26876842,26882751,5909
"14837","ENSBTAG00000031767","23",31756982,31757391,409
"14838","ENSBTAG00000031769","23",31758964,31759531,567
"14839","ENSBTAG00000031772","18",46508965,46524690,15725
"14840","ENSBTAG00000031776","23",31779435,31779815,380
"14841","ENSBTAG00000031777","15",54615540,54706765,91225
"14842","ENSBTAG00000031778","23",31794124,31795097,973
"14843","ENSBTAG00000031789","25",26783860,26794861,11001
"14844","ENSBTAG00000031792","23",28917109,28920535,3426
"14845","ENSBTAG00000031793","8",75723738,75735254,11516
"14846","ENSBTAG00000031794","7",18073040,18073585,545
"14847","ENSBTAG00000031797","22",49379095,49383627,4532
"14848","ENSBTAG00000031800","13",54136171,54137886,1715
"14849","ENSBTAG00000031802","1",94320196,94597863,277667
"14850","ENSBTAG00000031806","25",26575277,26579631,4354
"14851","ENSBTAG00000031809","7",17996263,18005955,9692
"14852","ENSBTAG00000031810","18",43542915,43597082,54167
"14853","ENSBTAG00000031814","17",61030240,61040569,10329
"14854","ENSBTAG00000031824","17",60618709,60739666,120957
"14855","ENSBTAG00000031825","23",29013585,29014232,647
"14856","ENSBTAG00000031828","11",49302385,49306958,4573
"14857","ENSBTAG00000031829","X",86600103,86609996,9893
"14858","ENSBTAG00000031832","23",29191351,29192289,938
"14859","ENSBTAG00000031834","21",58680142,58695531,15389
"14860","ENSBTAG00000031837","22",50962854,50967685,4831
"14861","ENSBTAG00000031846","17",64363942,64405641,41699
"14862","ENSBTAG00000031849","17",64327826,64334251,6425
"14863","ENSBTAG00000031851","17",64298475,64314718,16243
"14864","ENSBTAG00000031852","25",26544203,26555450,11247
"14865","ENSBTAG00000031861","4",114003970,114056805,52835
"14866","ENSBTAG00000031866","4",92565558,92569356,3798
"14867","ENSBTAG00000031869","23",30416140,30427406,11266
"14868","ENSBTAG00000031871","23",30431383,30435000,3617
"14869","ENSBTAG00000031873","23",30561557,30568915,7358
"14870","ENSBTAG00000031874","23",30587543,30599254,11711
"14871","ENSBTAG00000031875","29",44093697,44095654,1957
"14872","ENSBTAG00000031885","21",57811076,57813378,2302
"14873","ENSBTAG00000031886","23",30972348,30976581,4233
"14874","ENSBTAG00000031890","26",46392481,46948728,556247
"14875","ENSBTAG00000031891","1",93147160,93897117,749957
"14876","ENSBTAG00000031895","9",91865619,91932590,66971
"14877","ENSBTAG00000031898","2",76113318,76921405,808087
"14878","ENSBTAG00000031905","23",27828888,27829325,437
"14879","ENSBTAG00000031906","13",53957078,53958761,1683
"14880","ENSBTAG00000031913","23",27796195,27797556,1361
"14881","ENSBTAG00000031917","9",91412046,91605253,193207
"14882","ENSBTAG00000031919","5",45047975,45065127,17152
"14883","ENSBTAG00000031933","19",26727566,26736433,8867
"14884","ENSBTAG00000031940","3",29579106,29618905,39799
"14885","ENSBTAG00000031941","18",43817967,43937996,120029
"14886","ENSBTAG00000031950","5",43657005,43713702,56697
"14887","ENSBTAG00000031958","4",88370599,88377510,6911
"14888","ENSBTAG00000031967","4",82295679,82507550,211871
"14889","ENSBTAG00000031981","10",37869708,37875056,5348
"14890","ENSBTAG00000031998","19",26615705,26620061,4356
"14891","ENSBTAG00000032003","X",76843285,76844026,741
"14892","ENSBTAG00000032007","9",86964642,87022100,57458
"14893","ENSBTAG00000032018","18",39589641,39598027,8386
"14894","ENSBTAG00000032021","2",71941425,72016188,74763
"14895","ENSBTAG00000032024","9",86816821,86851320,34499
"14896","ENSBTAG00000032026","22",50481628,50484009,2381
"14897","ENSBTAG00000032031","23",27463641,27465020,1379
"14898","ENSBTAG00000032047","17",63256432,63263065,6633
"14899","ENSBTAG00000032051","11",44861171,44870370,9199
"14900","ENSBTAG00000032055","10",37550085,37596971,46886
"14901","ENSBTAG00000032057","3",28514070,28514381,311
"14902","ENSBTAG00000032059","21",54998020,55031855,33835
"14903","ENSBTAG00000032068","10",37533181,37547704,14523
"14904","ENSBTAG00000032071","3",28332011,28486280,154269
"14905","ENSBTAG00000032074","6",90680644,90680807,163
"14906","ENSBTAG00000032077","4",84688361,85251322,562961
"14907","ENSBTAG00000032079","15",45275683,45485248,209565
"14908","ENSBTAG00000032083","19",26092262,26109309,17047
"14909","ENSBTAG00000032084","12",76165404,76180037,14633
"14910","ENSBTAG00000032087","25",25974051,25985608,11557
"14911","ENSBTAG00000032089","29",43523082,43528893,5811
"14912","ENSBTAG00000032092","18",32682891,32837077,154186
"14913","ENSBTAG00000032093","8",75010301,75017081,6780
"14914","ENSBTAG00000032097","17",57900735,57938125,37390
"14915","ENSBTAG00000032106","26",40509769,40657136,147367
"14916","ENSBTAG00000032114","5",75406598,75407029,431
"14917","ENSBTAG00000032121","4",80159127,80928936,769809
"14918","ENSBTAG00000032122","25",25905403,25911990,6587
"14919","ENSBTAG00000032130","21",55352680,55370789,18109
"14920","ENSBTAG00000032132","21",55393506,55397020,3514
"14921","ENSBTAG00000032136","25",25840532,25841294,762
"14922","ENSBTAG00000032137","7",16399795,16424614,24819
"14923","ENSBTAG00000032140","25",25816381,25820460,4079
"14924","ENSBTAG00000032148","5",36014715,36610297,595582
"14925","ENSBTAG00000032150","5",35523616,35524047,431
"14926","ENSBTAG00000032152","5",75494237,75529894,35657
"14927","ENSBTAG00000032163","9",81299627,81316078,16451
"14928","ENSBTAG00000032166","4",74533033,74559891,26858
"14929","ENSBTAG00000032178","29",43170300,43176129,5829
"14930","ENSBTAG00000032183","5",35475234,35861464,386230
"14931","ENSBTAG00000032187","3",23660109,23691442,31333
"14932","ENSBTAG00000032193","3",23483918,23508035,24117
"14933","ENSBTAG00000032198","25",225324,225602,278
"14934","ENSBTAG00000032206","8",63102557,63121637,19080
"14935","ENSBTAG00000032209","X",79525678,79527759,2081
"14936","ENSBTAG00000032217","1",83710030,83711034,1004
"14937","ENSBTAG00000032223","25",21049528,21139768,90240
"14938","ENSBTAG00000032227","14",77391292,77396787,5495
"14939","ENSBTAG00000032234","12",75461372,75554716,93344
"14940","ENSBTAG00000032236","14",77144212,77154651,10439
"14941","ENSBTAG00000032237","26",36964317,36984418,20101
"14942","ENSBTAG00000032247","23",28909903,28913055,3152
"14943","ENSBTAG00000032253","22",49169587,49277563,107976
"14944","ENSBTAG00000032260","25",18626888,18681475,54587
"14945","ENSBTAG00000032265","1",79911983,79916543,4560
"14946","ENSBTAG00000032277","2",53739155,53888583,149428
"14947","ENSBTAG00000032279","22",48997519,49029107,31588
"14948","ENSBTAG00000032281","14",73513754,73515454,1700
"14949","ENSBTAG00000032288","4",77139555,77175906,36351
"14950","ENSBTAG00000032289","2",52965089,53630365,665276
"14951","ENSBTAG00000032292","7",15752075,15759370,7295
"14952","ENSBTAG00000032299","26",36749674,36807371,57697
"14953","ENSBTAG00000032301","14",73063026,73212030,149004
"14954","ENSBTAG00000032304","22",48948303,48953164,4861
"14955","ENSBTAG00000032331","5",32498984,32507826,8842
"14956","ENSBTAG00000032339","15",43656307,43656849,542
"14957","ENSBTAG00000032340","10",36000138,36010049,9911
"14958","ENSBTAG00000032347","22",47588803,47589179,376
"14959","ENSBTAG00000032353","17",54667570,54705547,37977
"14960","ENSBTAG00000032360","6",83916857,83918322,1465
"14961","ENSBTAG00000032366","13",47209404,47348038,138634
"14962","ENSBTAG00000032369","2",44826000,44846258,20258
"14963","ENSBTAG00000032372","19",24398955,24401936,2981
"14964","ENSBTAG00000032373","25",20036440,20076862,40422
"14965","ENSBTAG00000032374","22",47024359,47031572,7213
"14966","ENSBTAG00000032382","9",15224041,15224717,676
"14967","ENSBTAG00000032396","18",34909015,34936635,27620
"14968","ENSBTAG00000032424","11",31255653,31450384,194731
"14969","ENSBTAG00000032427","18",34857829,34874225,16396
"14970","ENSBTAG00000032428","5",32094226,32097281,3055
"14971","ENSBTAG00000032429","5",32071996,32074020,2024
"14972","ENSBTAG00000032432","14",66645755,66646231,476
"14973","ENSBTAG00000032433","17",52750181,52762092,11911
"14974","ENSBTAG00000032436","17",50887544,50892468,4924
"14975","ENSBTAG00000032446","3",18249209,18251674,2465
"14976","ENSBTAG00000032450","X",52260731,52264793,4062
"14977","ENSBTAG00000032453","3",20750777,20767701,16924
"14978","ENSBTAG00000032456","3",20724190,20724582,392
"14979","ENSBTAG00000032477","21",41701589,41776463,74874
"14980","ENSBTAG00000032481","2",37488235,37515045,26810
"14981","ENSBTAG00000032485","X",61079936,61150849,70913
"14982","ENSBTAG00000032493","19",42657793,42677130,19337
"14983","ENSBTAG00000032503","25",16864860,16866458,1598
"14984","ENSBTAG00000032509","8",59785446,59787520,2074
"14985","ENSBTAG00000032515","2",36271243,36405254,134011
"14986","ENSBTAG00000032517","17",53304776,53332032,27256
"14987","ENSBTAG00000032518","10",33847959,33966943,118984
"14988","ENSBTAG00000032519","11",26771728,27198776,427048
"14989","ENSBTAG00000032521","11",25888955,25993933,104978
"14990","ENSBTAG00000032527","28",43633382,43704103,70721
"14991","ENSBTAG00000032531","22",48056089,48057235,1146
"14992","ENSBTAG00000032534","17",53509789,53523519,13730
"14993","ENSBTAG00000032538","1",78014932,78184743,169811
"14994","ENSBTAG00000032544","14",64174147,64208187,34040
"14995","ENSBTAG00000032548","14",54705056,54833681,128625
"14996","ENSBTAG00000032557","29",40232832,40236557,3725
"14997","ENSBTAG00000032558","11",29405102,29527513,122411
"14998","ENSBTAG00000032567","5",30485107,30487859,2752
"14999","ENSBTAG00000032576","18",34308154,34330757,22603
"15000","ENSBTAG00000032588","6",97276663,97388558,111895
"15001","ENSBTAG00000032591","14",61130677,61147034,16357
"15002","ENSBTAG00000032598","4",63733826,63746286,12460
"15003","ENSBTAG00000032603","12",69482002,69666089,184087
"15004","ENSBTAG00000032609","13",10363818,10364571,753
"15005","ENSBTAG00000032613","10",30003348,30062539,59191
"15006","ENSBTAG00000032617","16",42023072,42028662,5590
"15007","ENSBTAG00000032623","11",24832853,24885462,52609
"15008","ENSBTAG00000032637","6",71271833,71325454,53621
"15009","ENSBTAG00000032640","25",14258684,14277458,18774
"15010","ENSBTAG00000032642","23",25182280,25204322,22042
"15011","ENSBTAG00000032650","4",61850902,61940801,89899
"15012","ENSBTAG00000032651","11",27914690,27915291,601
"15013","ENSBTAG00000032656","1",73178781,73188076,9295
"15014","ENSBTAG00000032657","15",39748793,40015294,266501
"15015","ENSBTAG00000032660","6",69536636,69596055,59419
"15016","ENSBTAG00000032674","1",71370900,71400231,29331
"15017","ENSBTAG00000032680","23",17658530,17683153,24623
"15018","ENSBTAG00000032684","1",70881969,70909767,27798
"15019","ENSBTAG00000032686","10",21620421,21627524,7103
"15020","ENSBTAG00000032687","13",42163872,42166596,2724
"15021","ENSBTAG00000032702","18",23935627,23936259,632
"15022","ENSBTAG00000032704","13",42039083,42076724,37641
"15023","ENSBTAG00000032705","20",8144460,8145602,1142
"15024","ENSBTAG00000032709","10",21543326,21546661,3335
"15025","ENSBTAG00000032711","12",61176715,61179015,2300
"15026","ENSBTAG00000032719","1",70652654,70679923,27269
"15027","ENSBTAG00000032728","6",67317831,67317953,122
"15028","ENSBTAG00000032733","3",19052981,19059716,6735
"15029","ENSBTAG00000032738","14",47339334,47344613,5279
"15030","ENSBTAG00000032761","26",24059298,24065042,5744
"15031","ENSBTAG00000032763","18",35270307,35327179,56872
"15032","ENSBTAG00000032764","6",333494,338344,4850
"15033","ENSBTAG00000032774","28",41580544,41583091,2547
"15034","ENSBTAG00000032775","11",21528543,21529010,467
"15035","ENSBTAG00000032777","8",61691238,61694543,3305
"15036","ENSBTAG00000032782","15",37342401,37482577,140176
"15037","ENSBTAG00000032787","NKLS02001695.1",37451,43292,5841
"15038","ENSBTAG00000032800","28",41312819,41322731,9912
"15039","ENSBTAG00000032801","10",26879265,26880236,971
"15040","ENSBTAG00000032806","NKLS02001492.1",37865,38743,878
"15041","ENSBTAG00000032808","16",40161168,40170278,9110
"15042","ENSBTAG00000032812","14",42882079,42882390,311
"15043","ENSBTAG00000032819","1",70460152,70476679,16527
"15044","ENSBTAG00000032821","12",52683429,52808583,125154
"15045","ENSBTAG00000032827","13",38680278,38680396,118
"15046","ENSBTAG00000032829","28",39120246,39134155,13909
"15047","ENSBTAG00000032831","14",40508675,40508872,197
"15048","ENSBTAG00000032839","1",70229447,70335542,106095
"15049","ENSBTAG00000032844","4",55322299,55326426,4127
"15050","ENSBTAG00000032848","20",41439630,41491576,51946
"15051","ENSBTAG00000032852","X",49908162,49911108,2946
"15052","ENSBTAG00000032858","28",35718475,35745321,26846
"15053","ENSBTAG00000032859","15",35297140,35302243,5103
"15054","ENSBTAG00000032862","28",35750402,35755041,4639
"15055","ENSBTAG00000032869","10",26596045,26596680,635
"15056","ENSBTAG00000032872","22",37601162,37619598,18436
"15057","ENSBTAG00000032875","X",49761203,49762185,982
"15058","ENSBTAG00000032878","12",51012743,51013105,362
"15059","ENSBTAG00000032880","25",9933491,9934241,750
"15060","ENSBTAG00000032881","14",33489213,33635085,145872
"15061","ENSBTAG00000032884","25",9926429,9928065,1636
"15062","ENSBTAG00000032887","23",18239634,18641106,401472
"15063","ENSBTAG00000032893","13",39359293,39360432,1139
"15064","ENSBTAG00000032899","5",28913670,28916339,2669
"15065","ENSBTAG00000032902","5",28846446,28868817,22371
"15066","ENSBTAG00000032905","11",20358649,20426537,67888
"15067","ENSBTAG00000032908","10",25987818,25990641,2823
"15068","ENSBTAG00000032914","5",28723262,28753680,30418
"15069","ENSBTAG00000032918","29",40802782,40806305,3523
"15070","ENSBTAG00000032923","X",47179812,47180657,845
"15071","ENSBTAG00000032933","20",39249515,39306162,56647
"15072","ENSBTAG00000032944","14",37372318,37377423,5105
"15073","ENSBTAG00000032947","6",61696746,61829320,132574
"15074","ENSBTAG00000032951","21",26547350,26602023,54673
"15075","ENSBTAG00000032961","24",46854677,46871859,17182
"15076","ENSBTAG00000032962","24",46909477,46944529,35052
"15077","ENSBTAG00000032964","24",45912627,45995428,82801
"15078","ENSBTAG00000032979","6",94141650,94142036,386
"15079","ENSBTAG00000032982","14",36382236,36425376,43140
"15080","ENSBTAG00000032996","28",29067217,29167290,100073
"15081","ENSBTAG00000033008","28",29615073,29627462,12389
"15082","ENSBTAG00000033010","11",15188503,15362377,173874
"15083","ENSBTAG00000033015","25",1392519,1394143,1624
"15084","ENSBTAG00000033021","26",21045753,21047128,1375
"15085","ENSBTAG00000033030","29",34445374,34461988,16614
"15086","ENSBTAG00000033032","X",37503995,37509860,5865
"15087","ENSBTAG00000033041","11",14884680,14918172,33492
"15088","ENSBTAG00000033056","16",34429413,34853620,424207
"15089","ENSBTAG00000033076","8",50870453,50910988,40535
"15090","ENSBTAG00000033077","19",20612946,20620127,7181
"15091","ENSBTAG00000033078","18",18450867,18465539,14672
"15092","ENSBTAG00000033080","27",42051425,42055369,3944
"15093","ENSBTAG00000033089","13",32056550,32078493,21943
"15094","ENSBTAG00000033095","20",36672888,36968945,296057
"15095","ENSBTAG00000033096","29",37571936,37581505,9569
"15096","ENSBTAG00000033107","20",35521708,35571511,49803
"15097","ENSBTAG00000033109","9",48470842,48471270,428
"15098","ENSBTAG00000033122","8",44357513,44363324,5811
"15099","ENSBTAG00000033128","14",30517937,30519618,1681
"15100","ENSBTAG00000033136","16",32422375,32429108,6733
"15101","ENSBTAG00000033137","27",38533613,38950549,416936
"15102","ENSBTAG00000033140","27",39292884,39388231,95347
"15103","ENSBTAG00000033143","2",43416111,43416743,632
"15104","ENSBTAG00000033153","9",47889245,48618507,729262
"15105","ENSBTAG00000033160","6",58091341,58145169,53828
"15106","ENSBTAG00000033166","1",66366134,66408044,41910
"15107","ENSBTAG00000033167","X",36139422,36140567,1145
"15108","ENSBTAG00000033169","4",49150890,49196632,45742
"15109","ENSBTAG00000033170","1",65078552,65096582,18030
"15110","ENSBTAG00000033173","14",29274588,29275673,1085
"15111","ENSBTAG00000033174","25",3443804,3456644,12840
"15112","ENSBTAG00000033180","16",30839371,31578649,739278
"15113","ENSBTAG00000033182","27",37757054,37790179,33125
"15114","ENSBTAG00000033186","20",32667447,32834933,167486
"15115","ENSBTAG00000033190","8",44402473,44612836,210363
"15116","ENSBTAG00000033195","9",26897352,27146308,248956
"15117","ENSBTAG00000033197","4",49750583,49787423,36840
"15118","ENSBTAG00000033214","6",46022662,46173614,150952
"15119","ENSBTAG00000033217","3",16318632,16346043,27411
"15120","ENSBTAG00000033220","3",16309672,16312901,3229
"15121","ENSBTAG00000033221","20",31770817,31811825,41008
"15122","ENSBTAG00000033222","7",6521111,6546714,25603
"15123","ENSBTAG00000033225","22",23253383,23782266,528883
"15124","ENSBTAG00000033237","29",36344150,36345409,1259
"15125","ENSBTAG00000033248","18",35970301,36017135,46834
"15126","ENSBTAG00000033254","2",18429582,18435911,6329
"15127","ENSBTAG00000033255","11",10848262,10864265,16003
"15128","ENSBTAG00000033267","16",29239152,29323608,84456
"15129","ENSBTAG00000033268","14",39849340,40051390,202050
"15130","ENSBTAG00000033269","4",43752324,43752487,163
"15131","ENSBTAG00000033270","19",19852996,19854571,1575
"15132","ENSBTAG00000033278","7",6175406,6177619,2213
"15133","ENSBTAG00000033289","NKLS02000966.1",85782,86830,1048
"15134","ENSBTAG00000033290","4",43450254,43454105,3851
"15135","ENSBTAG00000033291","13",23455035,23517704,62669
"15136","ENSBTAG00000033292","5",26686615,26694323,7708
"15137","ENSBTAG00000033298","19",19487860,19503235,15375
"15138","ENSBTAG00000033299","25",1367532,1371456,3924
"15139","ENSBTAG00000033304","27",35232605,35233905,1300
"15140","ENSBTAG00000033313","20",23440943,23542895,101952
"15141","ENSBTAG00000033315","13",22968650,23148498,179848
"15142","ENSBTAG00000033316","8",39092704,39211677,118973
"15143","ENSBTAG00000033319","1",57126575,57147988,21413
"15144","ENSBTAG00000033322","16",28800000,28809577,9577
"15145","ENSBTAG00000033326","18",14525082,14541878,16796
"15146","ENSBTAG00000033330","2",20803593,20806307,2714
"15147","ENSBTAG00000033331","18",14550491,14557240,6749
"15148","ENSBTAG00000033333","18",14568489,14576084,7595
"15149","ENSBTAG00000033334","18",14575038,14579286,4248
"15150","ENSBTAG00000033335","21",13073136,13073525,389
"15151","ENSBTAG00000033339","17",44477204,44499871,22667
"15152","ENSBTAG00000033344","10",19077745,19079771,2026
"15153","ENSBTAG00000033345","27",33312972,33320397,7425
"15154","ENSBTAG00000033351","6",40227778,40249127,21349
"15155","ENSBTAG00000033352","8",43600804,43697170,96366
"15156","ENSBTAG00000033360","1",55457926,55458564,638
"15157","ENSBTAG00000033365","9",39853683,39980056,126373
"15158","ENSBTAG00000033367","9",39796263,39813956,17693
"15159","ENSBTAG00000033377","29",29223890,29224817,927
"15160","ENSBTAG00000033381","27",32705152,32707515,2363
"15161","ENSBTAG00000033384","29",29060611,29067118,6507
"15162","ENSBTAG00000033386","12",29967343,30001111,33768
"15163","ENSBTAG00000033389","25",1169985,1170946,961
"15164","ENSBTAG00000033395","25",1119267,1120754,1487
"15165","ENSBTAG00000033396","8",45949379,46053409,104030
"15166","ENSBTAG00000033398","28",25595174,25634958,39784
"15167","ENSBTAG00000033412","12",29636372,29752743,116371
"15168","ENSBTAG00000033413","28",25177661,25211518,33857
"15169","ENSBTAG00000033422","22",14824749,14834446,9697
"15170","ENSBTAG00000033423","3",15512373,15521191,8818
"15171","ENSBTAG00000033429","9",38336067,38340911,4844
"15172","ENSBTAG00000033441","18",14881869,14919139,37270
"15173","ENSBTAG00000033445","X",38450652,38452121,1469
"15174","ENSBTAG00000033446","14",15560985,15592470,31485
"15175","ENSBTAG00000033449","4",32735267,32783267,48000
"15176","ENSBTAG00000033453","23",10878590,10898204,19614
"15177","ENSBTAG00000033457","28",25046261,25093181,46920
"15178","ENSBTAG00000033460","9",33860214,33872671,12457
"15179","ENSBTAG00000033464","29",28154527,28168618,14091
"15180","ENSBTAG00000033470","7",59472762,59488549,15787
"15181","ENSBTAG00000033486","17",40337328,40340549,3221
"15182","ENSBTAG00000033504","27",29204700,29214791,10091
"15183","ENSBTAG00000033509","15",82745953,82746888,935
"15184","ENSBTAG00000033510","15",28942158,29085061,142903
"15185","ENSBTAG00000033515","23",4026788,4168687,141899
"15186","ENSBTAG00000033523","18",58369009,58375417,6408
"15187","ENSBTAG00000033526","25",677753,678135,382
"15188","ENSBTAG00000033531","5",23237462,23238227,765
"15189","ENSBTAG00000033535","9",34163752,34171792,8040
"15190","ENSBTAG00000033543","8",25185785,25187367,1582
"15191","ENSBTAG00000033545","27",7165176,7180420,15244
"15192","ENSBTAG00000033547","17",39983282,40116757,133475
"15193","ENSBTAG00000033554","9",34181526,34220156,38630
"15194","ENSBTAG00000033562","19",13301089,13307764,6675
"15195","ENSBTAG00000033563","18",46997951,47006904,8953
"15196","ENSBTAG00000033580","25",654368,660856,6488
"15197","ENSBTAG00000033603","23",7852686,7877221,24535
"15198","ENSBTAG00000033604","18",58708543,58708863,320
"15199","ENSBTAG00000033621","29",1372285,1377857,5572
"15200","ENSBTAG00000033642","18",60479470,60653111,173641
"15201","ENSBTAG00000033648","6",19453068,19477589,24521
"15202","ENSBTAG00000033656","29",5368066,5373225,5159
"15203","ENSBTAG00000033657","9",32590637,32757496,166859
"15204","ENSBTAG00000033662","2",13528238,13633956,105718
"15205","ENSBTAG00000033669","22",16828957,16840283,11326
"15206","ENSBTAG00000033672","25",586824,592182,5358
"15207","ENSBTAG00000033679","1",149031196,149199816,168620
"15208","ENSBTAG00000033680","19",62541011,62600652,59641
"15209","ENSBTAG00000033685","26",17413335,17429691,16356
"15210","ENSBTAG00000033690","2",102760020,102854286,94266
"15211","ENSBTAG00000033699","15",76377895,76380011,2116
"15212","ENSBTAG00000033702","X",81741246,81774662,33416
"15213","ENSBTAG00000033721","21",20695021,20709983,14962
"15214","ENSBTAG00000033726","5",47140111,47474250,334139
"15215","ENSBTAG00000033727","27",26494996,26690539,195543
"15216","ENSBTAG00000033731","29",12744375,12830803,86428
"15217","ENSBTAG00000033735","5",68640524,68696996,56472
"15218","ENSBTAG00000033739","25",493606,495785,2179
"15219","ENSBTAG00000033740","1",115264273,115264638,365
"15220","ENSBTAG00000033747","7",50264021,50520479,256458
"15221","ENSBTAG00000033748","11",7203304,7233720,30416
"15222","ENSBTAG00000033749","X",39457848,39459920,2072
"15223","ENSBTAG00000033759","7",59641992,59645773,3781
"15224","ENSBTAG00000033766","19",41824311,41827946,3635
"15225","ENSBTAG00000033801","11",40689183,40797603,108420
"15226","ENSBTAG00000033802","3",101100521,101101039,518
"15227","ENSBTAG00000033803","9",28476062,28479847,3785
"15228","ENSBTAG00000033806","4",31570207,31570769,562
"15229","ENSBTAG00000033835","3",8211117,8216095,4978
"15230","ENSBTAG00000033886","7",4940147,4984507,44360
"15231","ENSBTAG00000033887","11",14571647,14571961,314
"15232","ENSBTAG00000033890","17",71014114,71018423,4309
"15233","ENSBTAG00000033891","10",42659741,42661081,1340
"15234","ENSBTAG00000033897","20",14503743,14504376,633
"15235","ENSBTAG00000033902","14",61074661,61108240,33579
"15236","ENSBTAG00000033961","9",26117013,26238645,121632
"15237","ENSBTAG00000033983","10",13276203,13351206,75003
"15238","ENSBTAG00000033994","16",80270236,80270426,190
"15239","ENSBTAG00000034005","22",16448727,16458201,9474
"15240","ENSBTAG00000034024","25",211765,213545,1780
"15241","ENSBTAG00000034033","12",22798940,23004081,205141
"15242","ENSBTAG00000034045","X",30683591,30723113,39522
"15243","ENSBTAG00000034069","12",25976904,25979327,2423
"15244","ENSBTAG00000034075","17",19415527,19485045,69518
"15245","ENSBTAG00000034077","13",63662796,63668123,5327
"15246","ENSBTAG00000034090","18",60268945,60333737,64792
"15247","ENSBTAG00000034091","4",25025019,25084046,59027
"15248","ENSBTAG00000034106","22",14946435,14949705,3270
"15249","ENSBTAG00000034113","7",65477934,65700088,222154
"15250","ENSBTAG00000034138","20",6840649,6875371,34722
"15251","ENSBTAG00000034139","6",25480627,25512887,32260
"15252","ENSBTAG00000034140","10",12771484,13163546,392062
"15253","ENSBTAG00000034145","NKLS02001139.1",131711,180302,48591
"15254","ENSBTAG00000034147","3",7530483,7580220,49737
"15255","ENSBTAG00000034154","4",23557610,23947179,389569
"15256","ENSBTAG00000034159","3",7901534,7907964,6430
"15257","ENSBTAG00000034176","NKLS02001383.1",32563,57955,25392
"15258","ENSBTAG00000034182","1",40948983,40950338,1355
"15259","ENSBTAG00000034184","11",5537564,5547779,10215
"15260","ENSBTAG00000034185","18",2913010,2915023,2013
"15261","ENSBTAG00000034187","8",24165011,24165117,106
"15262","ENSBTAG00000034189","6",25280923,25304490,23567
"15263","ENSBTAG00000034192","2",90611066,90737262,126196
"15264","ENSBTAG00000034193","15",22513156,22581009,67853
"15265","ENSBTAG00000034196","14",9051285,9075583,24298
"15266","ENSBTAG00000034206","6",24210505,24332244,121739
"15267","ENSBTAG00000034220","8",22096824,22121619,24795
"15268","ENSBTAG00000034222","12",18919920,19003107,83187
"15269","ENSBTAG00000034225","28",1545825,1565465,19640
"15270","ENSBTAG00000034238","25",2540747,2544804,4057
"15271","ENSBTAG00000034246","5",103786617,103794308,7691
"15272","ENSBTAG00000034255","11",4479846,4531610,51764
"15273","ENSBTAG00000034269","12",19099031,19155765,56734
"15274","ENSBTAG00000034281","17",17214946,17255967,41021
"15275","ENSBTAG00000034287","23",9457480,9471815,14335
"15276","ENSBTAG00000034294","8",22773117,22773703,586
"15277","ENSBTAG00000034295","5",103666048,103672761,6713
"15278","ENSBTAG00000034323","16",44379636,44407097,27461
"15279","ENSBTAG00000034332","3",105588541,105590187,1646
"15280","ENSBTAG00000034338","15",21813736,21853035,39299
"15281","ENSBTAG00000034346","15",21787553,21802341,14788
"15282","ENSBTAG00000034347","1",22948185,22967236,19051
"15283","ENSBTAG00000034349","3",66029139,66043630,14491
"15284","ENSBTAG00000034360","20",10091779,10095638,3859
"15285","ENSBTAG00000034366","16",12425569,12428868,3299
"15286","ENSBTAG00000034368","25",2271693,2274504,2811
"15287","ENSBTAG00000034372","25",2213987,2216515,2528
"15288","ENSBTAG00000034373","18",9350020,10154230,804210
"15289","ENSBTAG00000034384","11",3393891,3560303,166412
"15290","ENSBTAG00000034385","5",103623999,103630301,6302
"15291","ENSBTAG00000034391","8",16990433,16997572,7139
"15292","ENSBTAG00000034393","27",16203240,16244220,40980
"15293","ENSBTAG00000034396","19",12884510,12887667,3157
"15294","ENSBTAG00000034398","21",5233821,5234186,365
"15295","ENSBTAG00000034402","X",127901491,127951491,50000
"15296","ENSBTAG00000034430","27",15675423,15688748,13325
"15297","ENSBTAG00000034433","19",12541822,12542451,629
"15298","ENSBTAG00000034435","20",71307541,71311025,3484
"15299","ENSBTAG00000034436","25",2036248,2096458,60210
"15300","ENSBTAG00000034441","13",9649910,9878797,228887
"15301","ENSBTAG00000034442","1",44688566,44729118,40552
"15302","ENSBTAG00000034493","23",8638856,8743421,104565
"15303","ENSBTAG00000034495","12",15282784,15418923,136139
"15304","ENSBTAG00000034496","22",22004736,22004948,212
"15305","ENSBTAG00000034498","14",1655470,1658189,2719
"15306","ENSBTAG00000034501","6",15613508,15664735,51227
"15307","ENSBTAG00000034506","19",11971039,11971269,230
"15308","ENSBTAG00000034519","23",8322845,8325565,2720
"15309","ENSBTAG00000034522","17",11768654,12090661,322007
"15310","ENSBTAG00000034529","23",8313843,8322713,8870
"15311","ENSBTAG00000034531","9",24001196,24028448,27252
"15312","ENSBTAG00000034555","11",45895955,45896826,871
"15313","ENSBTAG00000034560","8",11197314,11197979,665
"15314","ENSBTAG00000034586","11",1848632,1873328,24696
"15315","ENSBTAG00000034597","26",12217316,12218524,1208
"15316","ENSBTAG00000034598","20",5319518,5331743,12225
"15317","ENSBTAG00000034601","3",10907420,10908358,938
"15318","ENSBTAG00000034609","4",106082256,106089046,6790
"15319","ENSBTAG00000034613","14",1132386,1136717,4331
"15320","ENSBTAG00000034626","8",10243225,10317918,74693
"15321","ENSBTAG00000034632","16",3140270,3168939,28669
"15322","ENSBTAG00000034633","28",8905885,8977775,71890
"15323","ENSBTAG00000034645","4",12593909,12631421,37512
"15324","ENSBTAG00000034656","24",12497435,12497827,392
"15325","ENSBTAG00000034657","11",1913421,1918226,4805
"15326","ENSBTAG00000034659","20",3997984,4064029,66045
"15327","ENSBTAG00000034662","9",18251228,18252589,1361
"15328","ENSBTAG00000034674","2",136037136,136049957,12821
"15329","ENSBTAG00000034676","24",8554163,8554444,281
"15330","ENSBTAG00000034680","2",136013445,136037002,23557
"15331","ENSBTAG00000034681","19",574079,1418116,844037
"15332","ENSBTAG00000034689","18",2363234,2451062,87828
"15333","ENSBTAG00000034691","14",1094043,1099107,5064
"15334","ENSBTAG00000034693","5",8650286,9050216,399930
"15335","ENSBTAG00000034700","6",2620816,2722452,101636
"15336","ENSBTAG00000034712","X",14129793,14141239,11446
"15337","ENSBTAG00000034753","12",14057127,14083769,26642
"15338","ENSBTAG00000034776","3",58618306,58775117,156811
"15339","ENSBTAG00000034785","12",13141567,13223945,82378
"15340","ENSBTAG00000034796","22",49131857,49162180,30323
"15341","ENSBTAG00000034823","10",8176687,8223030,46343
"15342","ENSBTAG00000034827","15",4259082,4536080,276998
"15343","ENSBTAG00000034845","29",7358733,7359113,380
"15344","ENSBTAG00000034848","10",8022302,8031994,9692
"15345","ENSBTAG00000034854","1",6112447,6577795,465348
"15346","ENSBTAG00000034867","8",95481976,95541955,59979
"15347","ENSBTAG00000034871","22",7450851,7453049,2198
"15348","ENSBTAG00000034875","6",13098687,13220016,121329
"15349","ENSBTAG00000034883","22",7310614,7315558,4944
"15350","ENSBTAG00000034885","12",11594527,11610166,15639
"15351","ENSBTAG00000034905","4",9735071,9765541,30470
"15352","ENSBTAG00000034918","26",11028206,11035934,7728
"15353","ENSBTAG00000034921","29",5418325,5419395,1070
"15354","ENSBTAG00000034925","9",12753066,12784654,31588
"15355","ENSBTAG00000034936","4",9624288,9725826,101538
"15356","ENSBTAG00000034939","23",25858687,25883331,24644
"15357","ENSBTAG00000034945","23",25885521,25894260,8739
"15358","ENSBTAG00000034949","2",5413002,5413394,392
"15359","ENSBTAG00000034952","27",6063471,6068440,4969
"15360","ENSBTAG00000034963","19",9146071,9161341,15270
"15361","ENSBTAG00000034973","7",2397701,2398255,554
"15362","ENSBTAG00000034978","2",1865381,1906516,41135
"15363","ENSBTAG00000034985","5",5573899,5575874,1975
"15364","ENSBTAG00000034987","13",3683719,3707178,23459
"15365","ENSBTAG00000034992","X",5150330,5159302,8972
"15366","ENSBTAG00000034995","11",2426982,2428625,1643
"15367","ENSBTAG00000034998","10",5026117,5109495,83378
"15368","ENSBTAG00000035005","10",4904503,4905626,1123
"15369","ENSBTAG00000035007","8",4486386,4644589,158203
"15370","ENSBTAG00000035013","3",22335865,22337567,1702
"15371","ENSBTAG00000035018","X",3281607,3284226,2619
"15372","ENSBTAG00000035030","10",4461911,4471313,9402
"15373","ENSBTAG00000035054","9",9301759,9319960,18201
"15374","ENSBTAG00000035064","4",7668476,7697356,28880
"15375","ENSBTAG00000035072","26",50136095,50141643,5548
"15376","ENSBTAG00000035081","2",122233162,122259028,25866
"15377","ENSBTAG00000035083","5",4068535,4072263,3728
"15378","ENSBTAG00000035084","8",10150817,10238564,87747
"15379","ENSBTAG00000035110","29",1403401,1549941,146540
"15380","ENSBTAG00000035144","1",88340909,88350179,9270
"15381","ENSBTAG00000035147","19",7612667,7637250,24583
"15382","ENSBTAG00000035150","X",132666874,132666993,119
"15383","ENSBTAG00000035158","14",584956,586597,1641
"15384","ENSBTAG00000035171","24",61796828,61818412,21584
"15385","ENSBTAG00000035174","10",5185866,5197272,11406
"15386","ENSBTAG00000035175","1",1942815,1954023,11208
"15387","ENSBTAG00000035199","13",2981378,2981575,197
"15388","ENSBTAG00000035206","28",16523910,16527654,3744
"15389","ENSBTAG00000035226","16",61095410,61140756,45346
"15390","ENSBTAG00000035230","16",61055327,61090364,35037
"15391","ENSBTAG00000035244","11",2807896,2815132,7236
"15392","ENSBTAG00000035247","21",27388187,27396222,8035
"15393","ENSBTAG00000035254","14",478582,492655,14073
"15394","ENSBTAG00000035265","17",180928,210111,29183
"15395","ENSBTAG00000035286","22",2676420,2754961,78541
"15396","ENSBTAG00000035293","8",1692075,1693114,1039
"15397","ENSBTAG00000035323","13",680566,739284,58718
"15398","ENSBTAG00000035370","9",72112133,72151639,39506
"15399","ENSBTAG00000035379","4",33212389,33213237,848
"15400","ENSBTAG00000035396","7",13648564,13649502,938
"15401","ENSBTAG00000035437","1",132757274,132922494,165220
"15402","ENSBTAG00000035493","1",2843057,2843218,161
"15403","ENSBTAG00000035530","10",25265958,25267290,1332
"15404","ENSBTAG00000035544","21",64668944,64697472,28528
"15405","ENSBTAG00000035556","1",135867529,135881717,14188
"15406","ENSBTAG00000035572","13",42904959,42906399,1440
"15407","ENSBTAG00000035587","19",26634449,26643103,8654
"15408","ENSBTAG00000035615","X",4167949,4184269,16320
"15409","ENSBTAG00000035643","13",40793420,40794604,1184
"15410","ENSBTAG00000035660","4",13707135,13707455,320
"15411","ENSBTAG00000035662","7",110296879,110565532,268653
"15412","ENSBTAG00000035675","15",46024625,46025557,932
"15413","ENSBTAG00000035696","13",43220975,43225655,4680
"15414","ENSBTAG00000035705","X",95781075,96061928,280853
"15415","ENSBTAG00000035706","19",31097343,31183209,85866
"15416","ENSBTAG00000035708","8",65366197,65377696,11499
"15417","ENSBTAG00000035710","1",100098900,100168463,69563
"15418","ENSBTAG00000035726","6",84162691,84164383,1692
"15419","ENSBTAG00000035735","15",6340328,6365225,24897
"15420","ENSBTAG00000035744","23",28777770,28787696,9926
"15421","ENSBTAG00000035745","NKLS02001410.1",235196,239219,4023
"15422","ENSBTAG00000035776","6",95026428,95733063,706635
"15423","ENSBTAG00000035777","7",14350562,14381871,31309
"15424","ENSBTAG00000035782","25",7517216,7536058,18842
"15425","ENSBTAG00000035827","22",55304352,55578588,274236
"15426","ENSBTAG00000035836","16",64972038,65091021,118983
"15427","ENSBTAG00000035844","1",74163666,74183456,19790
"15428","ENSBTAG00000035855","9",7691510,7692897,1387
"15429","ENSBTAG00000035858","10",663554,985178,321624
"15430","ENSBTAG00000035868","18",57664643,57668067,3424
"15431","ENSBTAG00000035882","X",73993182,73993994,812
"15432","ENSBTAG00000035907","X",102219297,102232936,13639
"15433","ENSBTAG00000035915","25",19423751,19623818,200067
"15434","ENSBTAG00000035926","12",783000,784421,1421
"15435","ENSBTAG00000035945","4",50056455,50082481,26026
"15436","ENSBTAG00000035958","8",70279848,70315972,36124
"15437","ENSBTAG00000035966","7",57065186,57086707,21521
"15438","ENSBTAG00000035995","21",67816188,67826211,10023
"15439","ENSBTAG00000035998","21",68158057,68161297,3240
"15440","ENSBTAG00000036009","15",66946444,66967540,21096
"15441","ENSBTAG00000036016","15",82243028,82258716,15688
"15442","ENSBTAG00000036028","X",52012431,52014011,1580
"15443","ENSBTAG00000036061","9",87207805,87226372,18567
"15444","ENSBTAG00000036078","5",96633068,96654177,21109
"15445","ENSBTAG00000036087","9",41196568,41316355,119787
"15446","ENSBTAG00000036099","11",99351291,99362537,11246
"15447","ENSBTAG00000036101","11",99313258,99331831,18573
"15448","ENSBTAG00000036102","7",68625875,68685772,59897
"15449","ENSBTAG00000036111","28",21753098,21755283,2185
"15450","ENSBTAG00000036113","17",71816210,71864794,48584
"15451","ENSBTAG00000036127","26",23502762,23519884,17122
"15452","ENSBTAG00000036154","4",50142139,50162526,20387
"15453","ENSBTAG00000036183","17",58026797,58141074,114277
"15454","ENSBTAG00000036222","13",10941571,10945554,3983
"15455","ENSBTAG00000036224","18",61009582,61018636,9054
"15456","ENSBTAG00000036242","7",94971287,94974891,3604
"15457","ENSBTAG00000036257","NKLS02002206.1",13885,23089,9204
"15458","ENSBTAG00000036258","2",25523794,25529803,6009
"15459","ENSBTAG00000036260","15",81845565,81887132,41567
"15460","ENSBTAG00000036262","1",29107326,29419066,311740
"15461","ENSBTAG00000036282","5",11902749,11909172,6423
"15462","ENSBTAG00000036287","9",84831407,84831874,467
"15463","ENSBTAG00000036297","24",491877,504604,12727
"15464","ENSBTAG00000036298","24",506283,538803,32520
"15465","ENSBTAG00000036304","14",75914395,76103436,189041
"15466","ENSBTAG00000036343","X",38215753,38217371,1618
"15467","ENSBTAG00000036349","X",18020715,18029096,8381
"15468","ENSBTAG00000036357","22",9705215,9705298,83
"15469","ENSBTAG00000036361","19",38444475,38444560,85
"15470","ENSBTAG00000036362","25",36355563,36355642,79
"15471","ENSBTAG00000036363","13",54735656,54735750,94
"15472","ENSBTAG00000036367","X",76925407,76925519,112
"15473","ENSBTAG00000036389","12",19500915,19501003,88
"15474","ENSBTAG00000036392","18",60903171,60903249,78
"15475","ENSBTAG00000036393","5",109653907,109654002,95
"15476","ENSBTAG00000036395","16",51321445,51321528,83
"15477","ENSBTAG00000036396","21",65920309,65920405,96
"15478","ENSBTAG00000036397","6",12980214,12980288,74
"15479","ENSBTAG00000036398","21",65937962,65938058,96
"15480","ENSBTAG00000036400","23",24567204,24567289,85
"15481","ENSBTAG00000036404","1",10848649,10848713,64
"15482","ENSBTAG00000036410","5",103498826,103498915,89
"15483","ENSBTAG00000036414","19",20238525,20238595,70
"15484","ENSBTAG00000036417","5",116409213,116409295,82
"15485","ENSBTAG00000036418","X",94562822,94562929,107
"15486","ENSBTAG00000036422","6",114336289,114336369,80
"15487","ENSBTAG00000036428","6",12980768,12980837,69
"15488","ENSBTAG00000036429","6",12980357,12980424,67
"15489","ENSBTAG00000036431","21",65922464,65922543,79
"15490","ENSBTAG00000036435","11",38628452,38628561,109
"15491","ENSBTAG00000036437","19",34647548,34647641,93
"15492","ENSBTAG00000036445","21",65945333,65945412,79
"15493","ENSBTAG00000036488","27",19561748,19561866,118
"15494","ENSBTAG00000036578","9",66584228,66584346,118
"15495","ENSBTAG00000036618","7",85272861,85273075,214
"15496","ENSBTAG00000036621","5",94979140,94979261,121
"15497","ENSBTAG00000036625","12",69159507,69159695,188
"15498","ENSBTAG00000036644","16",33894930,33895042,112
"15499","ENSBTAG00000036646","4",88375270,88375393,123
"15500","ENSBTAG00000036659","29",41149205,41149395,190
"15501","ENSBTAG00000036732","24",20762452,20762564,112
"15502","ENSBTAG00000036743","25",18693654,18693772,118
"15503","ENSBTAG00000036744","15",17983260,17983376,116
"15504","ENSBTAG00000036794","17",52366761,52366877,116
"15505","ENSBTAG00000036927","19",9580320,9580479,159
"15506","ENSBTAG00000036946","1",72276586,72276731,145
"15507","ENSBTAG00000036993","2",48250188,48250365,177
"15508","ENSBTAG00000036995","9",69128441,69128541,100
"15509","ENSBTAG00000037010","25",4786474,4786593,119
"15510","ENSBTAG00000037013","21",44967957,44968121,164
"15511","ENSBTAG00000037072","16",44322690,44322852,162
"15512","ENSBTAG00000037085","9",93548457,93548581,124
"15513","ENSBTAG00000037087","8",1046193,1046312,119
"15514","ENSBTAG00000037110","5",113470970,113471119,149
"15515","ENSBTAG00000037111","8",65620413,65620516,103
"15516","ENSBTAG00000037179","21",45017108,45017330,222
"15517","ENSBTAG00000037187","3",22737653,22737810,157
"15518","ENSBTAG00000037226","10",51761262,51761380,118
"15519","ENSBTAG00000037229","7",37342761,37342879,118
"15520","ENSBTAG00000037239","18",10405697,10405815,118
"15521","ENSBTAG00000037264","27",36572754,36572877,123
"15522","ENSBTAG00000037275","3",16316832,16316914,82
"15523","ENSBTAG00000037339","10",21505501,21505608,107
"15524","ENSBTAG00000037348","25",1790895,1790987,92
"15525","ENSBTAG00000037375","18",64587441,64595246,7805
"15526","ENSBTAG00000037377","22",48962168,48965810,3642
"15527","ENSBTAG00000037381","23",28828979,28840652,11673
"15528","ENSBTAG00000037383","21",16215478,16539757,324279
"15529","ENSBTAG00000037389","15",66181718,66291995,110277
"15530","ENSBTAG00000037393","1",87780857,87785489,4632
"15531","ENSBTAG00000037397","25",27236563,27243964,7401
"15532","ENSBTAG00000037400","25",38887202,38970458,83256
"15533","ENSBTAG00000037404","29",44871011,44874127,3116
"15534","ENSBTAG00000037410","22",49048876,49052860,3984
"15535","ENSBTAG00000037413","X",58423905,58602728,178823
"15536","ENSBTAG00000037415","17",58042537,58042794,257
"15537","ENSBTAG00000037418","7",43450410,43457295,6885
"15538","ENSBTAG00000037421","23",28677524,28686666,9142
"15539","ENSBTAG00000037429","9",17090717,17091928,1211
"15540","ENSBTAG00000037434","7",86651007,86652011,1004
"15541","ENSBTAG00000037449","25",18090665,18119714,29049
"15542","ENSBTAG00000037452","10",26644523,26648616,4093
"15543","ENSBTAG00000037453","13",43804270,43821591,17321
"15544","ENSBTAG00000037456","2",125759503,125780816,21313
"15545","ENSBTAG00000037457","24",53580798,53648542,67744
"15546","ENSBTAG00000037461","18",46668498,46669544,1046
"15547","ENSBTAG00000037465","15",47890408,47904741,14333
"15548","ENSBTAG00000037483","15",55112737,55124658,11921
"15549","ENSBTAG00000037488","15",13849723,13851297,1574
"15550","ENSBTAG00000037489","25",27997740,28036980,39240
"15551","ENSBTAG00000037493","14",972914,986379,13465
"15552","ENSBTAG00000037494","16",12893343,12921726,28383
"15553","ENSBTAG00000037500","25",1742695,1742754,59
"15554","ENSBTAG00000037508","7",70286630,70694473,407843
"15555","ENSBTAG00000037509","13",43393448,43407848,14400
"15556","ENSBTAG00000037510","4",113314340,113317506,3166
"15557","ENSBTAG00000037523","16",51269081,51270070,989
"15558","ENSBTAG00000037526","14",44676542,44681059,4517
"15559","ENSBTAG00000037527","17",61394801,61402638,7837
"15560","ENSBTAG00000037531","9",83887090,83892459,5369
"15561","ENSBTAG00000037533","23",27372094,27386883,14789
"15562","ENSBTAG00000037534","5",100228198,100238336,10138
"15563","ENSBTAG00000037537","18",57136169,57143497,7328
"15564","ENSBTAG00000037539","3",42593885,42616930,23045
"15565","ENSBTAG00000037547","1",2497798,2499871,2073
"15566","ENSBTAG00000037552","5",335951,373995,38044
"15567","ENSBTAG00000037555","3",102851923,102860724,8801
"15568","ENSBTAG00000037558","6",89072611,89075133,2522
"15569","ENSBTAG00000037559","26",16075794,16117389,41595
"15570","ENSBTAG00000037565","3",20825101,20863751,38650
"15571","ENSBTAG00000037566","25",3839462,3841534,2072
"15572","ENSBTAG00000037570","29",41423147,41458585,35438
"15573","ENSBTAG00000037571","14",54843587,54861866,18279
"15574","ENSBTAG00000037576","20",56953217,57071806,118589
"15575","ENSBTAG00000037581","18",65786615,65796086,9471
"15576","ENSBTAG00000037600","8",83421783,83422175,392
"15577","ENSBTAG00000037602","7",394780,406898,12118
"15578","ENSBTAG00000037603","15",45960727,45966649,5922
"15579","ENSBTAG00000037605","23",25691259,25695296,4037
"15580","ENSBTAG00000037616","1",149814196,150141048,326852
"15581","ENSBTAG00000037625","10",78121019,78121798,779
"15582","ENSBTAG00000037628","23",29561576,29562523,947
"15583","ENSBTAG00000037632","5",113082371,113089067,6696
"15584","ENSBTAG00000037634","3",54187433,54276697,89264
"15585","ENSBTAG00000037640","2",117023746,117290403,266657
"15586","ENSBTAG00000037644","15",48362236,48363996,1760
"15587","ENSBTAG00000037645","29",41830789,41837747,6958
"15588","ENSBTAG00000037649","4",119626462,119695643,69181
"15589","ENSBTAG00000037650","X",58876457,58882228,5771
"15590","ENSBTAG00000037651","3",16805481,16811823,6342
"15591","ENSBTAG00000037662","1",144498435,144499274,839
"15592","ENSBTAG00000037673","3",33759204,33765942,6738
"15593","ENSBTAG00000037679","10",21610569,21613167,2598
"15594","ENSBTAG00000037686","X",49647897,49678608,30711
"15595","ENSBTAG00000037687","23",20706772,20740185,33413
"15596","ENSBTAG00000037690","26",19476968,19477058,90
"15597","ENSBTAG00000037699","18",60229001,60231052,2051
"15598","ENSBTAG00000037702","2",118362310,118396685,34375
"15599","ENSBTAG00000037703","5",109709317,109737117,27800
"15600","ENSBTAG00000037710","18",57219131,57343755,124624
"15601","ENSBTAG00000037718","9",70806940,70807950,1010
"15602","ENSBTAG00000037721","18",64505119,64540693,35574
"15603","ENSBTAG00000037726","22",11459788,11481247,21459
"15604","ENSBTAG00000037729","7",4313431,4331493,18062
"15605","ENSBTAG00000037735","18",54337816,54342561,4745
"15606","ENSBTAG00000037738","23",32080668,32103739,23071
"15607","ENSBTAG00000037743","5",103320283,103327176,6893
"15608","ENSBTAG00000037746","11",68242066,68249964,7898
"15609","ENSBTAG00000037756","28",24918286,25035716,117430
"15610","ENSBTAG00000037757","13",52422074,52479404,57330
"15611","ENSBTAG00000037765","7",19483938,19503011,19073
"15612","ENSBTAG00000037768","15",5779177,5785763,6586
"15613","ENSBTAG00000037770","3",103020967,103022015,1048
"15614","ENSBTAG00000037773","24",61992814,62015763,22949
"15615","ENSBTAG00000037775","5",30540409,30548298,7889
"15616","ENSBTAG00000037778","6",89061093,89063360,2267
"15617","ENSBTAG00000037781","23",27252845,27254424,1579
"15618","ENSBTAG00000037782","25",1627688,1627759,71
"15619","ENSBTAG00000037786","12",77566984,77847326,280342
"15620","ENSBTAG00000037794","19",29448559,29476191,27632
"15621","ENSBTAG00000037795","26",16125969,16208881,82912
"15622","ENSBTAG00000037799","5",74303467,74319127,15660
"15623","ENSBTAG00000037800","5",110530859,110534614,3755
"15624","ENSBTAG00000037803","22",16427611,16444491,16880
"15625","ENSBTAG00000037804","2",101012199,101190609,178410
"15626","ENSBTAG00000037811","19",15902777,15905368,2591
"15627","ENSBTAG00000037812","11",81091299,81097693,6394
"15628","ENSBTAG00000037815","15",48336979,48338849,1870
"15629","ENSBTAG00000037819","3",310346,330047,19701
"15630","ENSBTAG00000037821","22",52693898,52698200,4302
"15631","ENSBTAG00000037824","14",1600604,1604607,4003
"15632","ENSBTAG00000037826","15",51474978,51495512,20534
"15633","ENSBTAG00000037832","17",66098793,66107865,9072
"15634","ENSBTAG00000037844","20",53333437,53936986,603549
"15635","ENSBTAG00000037856","11",10211644,10218786,7142
"15636","ENSBTAG00000037858","3",99684761,99699604,14843
"15637","ENSBTAG00000037882","18",65680940,65691647,10707
"15638","ENSBTAG00000037885","7",52169913,52172369,2456
"15639","ENSBTAG00000037886","15",49547370,49548474,1104
"15640","ENSBTAG00000037888","18",51993588,51998232,4644
"15641","ENSBTAG00000037890","3",99208577,99222625,14048
"15642","ENSBTAG00000037899","21",65626343,65634828,8485
"15643","ENSBTAG00000037902","2",121201977,121202927,950
"15644","ENSBTAG00000037905","7",37843323,37843427,104
"15645","ENSBTAG00000037907","24",9444509,9454498,9989
"15646","ENSBTAG00000037913","28",44580065,44582051,1986
"15647","ENSBTAG00000037917","23",32034987,32068359,33372
"15648","ENSBTAG00000037921","15",45001013,45024940,23927
"15649","ENSBTAG00000037925","13",73624369,73626520,2151
"15650","ENSBTAG00000037928","15",79993369,79995158,1789
"15651","ENSBTAG00000037929","8",71497023,71577460,80437
"15652","ENSBTAG00000037932","10",82116736,82119485,2749
"15653","ENSBTAG00000037935","5",29799573,29810207,10634
"15654","ENSBTAG00000037937","15",46229081,46235896,6815
"15655","ENSBTAG00000037938","21",45271631,45301018,29387
"15656","ENSBTAG00000037941","7",15188036,15197535,9499
"15657","ENSBTAG00000037945","25",1710629,1722604,11975
"15658","ENSBTAG00000037949","23",25141525,25162882,21357
"15659","ENSBTAG00000037951","1",83545202,83598532,53330
"15660","ENSBTAG00000037953","21",55414001,55414101,100
"15661","ENSBTAG00000037962","15",13888254,14287297,399043
"15662","ENSBTAG00000037964","7",2573757,2575265,1508
"15663","ENSBTAG00000037965","1",158075340,158077174,1834
"15664","ENSBTAG00000037966","18",50091971,50092901,930
"15665","ENSBTAG00000037969","13",20648196,20692833,44637
"15666","ENSBTAG00000037972","22",35068281,35215061,146780
"15667","ENSBTAG00000037980","22",56617910,56661729,43819
"15668","ENSBTAG00000037981","18",64803007,64808625,5618
"15669","ENSBTAG00000037983","18",52480667,52487085,6418
"15670","ENSBTAG00000037985","10",28518864,28520462,1598
"15671","ENSBTAG00000037986","8",73748634,73756508,7874
"15672","ENSBTAG00000037988","23",30377190,30379817,2627
"15673","ENSBTAG00000037996","X",50615553,50620379,4826
"15674","ENSBTAG00000038011","11",44340266,44502072,161806
"15675","ENSBTAG00000038020","21",41959757,41968785,9028
"15676","ENSBTAG00000038034","18",62025056,62031537,6481
"15677","ENSBTAG00000038042","2",106185020,106192570,7550
"15678","ENSBTAG00000038043","5",41480497,41573833,93336
"15679","ENSBTAG00000038045","18",55929651,55939491,9840
"15680","ENSBTAG00000038048","13",32239914,32352564,112650
"15681","ENSBTAG00000038050","18",47496184,47523355,27171
"15682","ENSBTAG00000038051","18",14742474,14762933,20459
"15683","ENSBTAG00000038055","7",44173869,44182700,8831
"15684","ENSBTAG00000038058","15",82005439,82044563,39124
"15685","ENSBTAG00000038062","15",15982525,15983934,1409
"15686","ENSBTAG00000038063","26",10177187,10214647,37460
"15687","ENSBTAG00000038064","8",71366414,71367355,941
"15688","ENSBTAG00000038073","21",66493367,66493444,77
"15689","ENSBTAG00000038074","25",36459459,36466243,6784
"15690","ENSBTAG00000038075","15",49885812,49887388,1576
"15691","ENSBTAG00000038079","16",65437883,65655684,217801
"15692","ENSBTAG00000038080","21",34835231,34837188,1957
"15693","ENSBTAG00000038084","22",50035332,50036349,1017
"15694","ENSBTAG00000038088","18",65252212,65254845,2633
"15695","ENSBTAG00000038107","16",4464620,4514607,49987
"15696","ENSBTAG00000038111","1",126128644,126129171,527
"15697","ENSBTAG00000038112","9",84721763,84734062,12299
"15698","ENSBTAG00000038115","25",2321450,2327963,6513
"15699","ENSBTAG00000038116","11",49661817,49664860,3043
"15700","ENSBTAG00000038117","7",81936684,82199467,262783
"15701","ENSBTAG00000038124","3",8035858,8044343,8485
"15702","ENSBTAG00000038126","19",40490708,40526914,36206
"15703","ENSBTAG00000038128","23",25636255,25643878,7623
"15704","ENSBTAG00000038132","17",72313147,72326846,13699
"15705","ENSBTAG00000038134","18",35006309,35027120,20811
"15706","ENSBTAG00000038138","19",47827687,47838771,11084
"15707","ENSBTAG00000038139","11",99005557,99017657,12100
"15708","ENSBTAG00000038141","18",25595310,25641535,46225
"15709","ENSBTAG00000038146","5",113067623,113076647,9024
"15710","ENSBTAG00000038148","6",91734617,91736950,2333
"15711","ENSBTAG00000038149","18",60905906,60925131,19225
"15712","ENSBTAG00000038151","7",15896010,15902152,6142
"15713","ENSBTAG00000038154","7",6861680,6870122,8442
"15714","ENSBTAG00000038156","X",105545907,105556551,10644
"15715","ENSBTAG00000038159","21",34755350,34758193,2843
"15716","ENSBTAG00000038168","12",58782892,58784982,2090
"15717","ENSBTAG00000038169","29",5828126,5834015,5889
"15718","ENSBTAG00000038171","16",75977678,76010930,33252
"15719","ENSBTAG00000038173","23",31354601,31355275,674
"15720","ENSBTAG00000038174","15",41939131,41940696,1565
"15721","ENSBTAG00000038178","28",13043867,13049402,5535
"15722","ENSBTAG00000038180","2",30880623,31019443,138820
"15723","ENSBTAG00000038181","8",23422760,23725195,302435
"15724","ENSBTAG00000038186","7",95122128,95132776,10648
"15725","ENSBTAG00000038190","9",9785197,9974224,189027
"15726","ENSBTAG00000038195","2",36552660,36579199,26539
"15727","ENSBTAG00000038204","X",50694657,50695742,1085
"15728","ENSBTAG00000038215","3",57607299,57648396,41097
"15729","ENSBTAG00000038221","7",43722703,43737303,14600
"15730","ENSBTAG00000038224","11",78204301,78208326,4025
"15731","ENSBTAG00000038233","3",54715932,54782223,66291
"15732","ENSBTAG00000038234","10",10143679,10158404,14725
"15733","ENSBTAG00000038235","4",65822126,65911847,89721
"15734","ENSBTAG00000038238","16",59224977,59225297,320
"15735","ENSBTAG00000038240","18",64875301,64876602,1301
"15736","ENSBTAG00000038241","4",112782527,112787912,5385
"15737","ENSBTAG00000038242","28",19489827,19489932,105
"15738","ENSBTAG00000038245","15",44941606,44942580,974
"15739","ENSBTAG00000038251","12",11479199,11540859,61660
"15740","ENSBTAG00000038258","17",72394831,72398818,3987
"15741","ENSBTAG00000038260","13",43870665,43881668,11003
"15742","ENSBTAG00000038263","3",12079228,12082762,3534
"15743","ENSBTAG00000038267","15",81304118,81305101,983
"15744","ENSBTAG00000038268","12",76259667,76267138,7471
"15745","ENSBTAG00000038275","2",5297022,5319408,22386
"15746","ENSBTAG00000038281","14",50969629,52273953,1304324
"15747","ENSBTAG00000038283","4",33226967,33248624,21657
"15748","ENSBTAG00000038286","14",19981881,19986371,4490
"15749","ENSBTAG00000038292","3",110065619,110066302,683
"15750","ENSBTAG00000038298","22",57604793,57627714,22921
"15751","ENSBTAG00000038306","19",52751728,52760319,8591
"15752","ENSBTAG00000038312","29",37086016,37103713,17697
"15753","ENSBTAG00000038316","19",44191849,44284815,92966
"15754","ENSBTAG00000038318","2",1473998,1476421,2423
"15755","ENSBTAG00000038321","18",50889179,50907197,18018
"15756","ENSBTAG00000038322","18",54924401,54929698,5297
"15757","ENSBTAG00000038323","15",82127678,82142196,14518
"15758","ENSBTAG00000038325","18",34675658,34690343,14685
"15759","ENSBTAG00000038326","18",64034413,64043302,8889
"15760","ENSBTAG00000038330","25",582900,584292,1392
"15761","ENSBTAG00000038333","10",21924846,21936748,11902
"15762","ENSBTAG00000038335","8",101688282,101721968,33686
"15763","ENSBTAG00000038337","7",50661348,50663428,2080
"15764","ENSBTAG00000038347","29",22471182,22511619,40437
"15765","ENSBTAG00000038361","21",59147788,59161613,13825
"15766","ENSBTAG00000038366","3",11633891,11638174,4283
"15767","ENSBTAG00000038368","6",15219565,15219795,230
"15768","ENSBTAG00000038369","11",44885317,44890533,5216
"15769","ENSBTAG00000038375","8",110740235,110772767,32532
"15770","ENSBTAG00000038377","10",82176146,82178847,2701
"15771","ENSBTAG00000038379","X",37069991,37070473,482
"15772","ENSBTAG00000038381","22",51249161,51259943,10782
"15773","ENSBTAG00000038384","5",27366774,27373266,6492
"15774","ENSBTAG00000038397","23",25795675,25809471,13796
"15775","ENSBTAG00000038409","7",43960115,43968745,8630
"15776","ENSBTAG00000038412","13",62381695,62408299,26604
"15777","ENSBTAG00000038415","5",107148045,107165693,17648
"15778","ENSBTAG00000038421","6",2406344,2417183,10839
"15779","ENSBTAG00000038422","1",23043555,23044082,527
"15780","ENSBTAG00000038426","3",11698349,11717375,19026
"15781","ENSBTAG00000038428","18",52695747,52724172,28425
"15782","ENSBTAG00000038430","23",34453666,34454593,927
"15783","ENSBTAG00000038433","1",7246094,7246462,368
"15784","ENSBTAG00000038434","X",74597105,74880603,283498
"15785","ENSBTAG00000038437","7",11665836,11667614,1778
"15786","ENSBTAG00000038438","10",36644180,36675444,31264
"15787","ENSBTAG00000038442","18",47751736,47768997,17261
"15788","ENSBTAG00000038461","5",100755565,100810941,55376
"15789","ENSBTAG00000038462","11",7459624,7502937,43313
"15790","ENSBTAG00000038464","7",19600448,19611770,11322
"15791","ENSBTAG00000038476","3",20758497,20763522,5025
"15792","ENSBTAG00000038477","11",49449754,49463257,13503
"15793","ENSBTAG00000038480","3",70600177,70608293,8116
"15794","ENSBTAG00000038486","8",110190747,110194281,3534
"15795","ENSBTAG00000038487","18",57807061,57816044,8983
"15796","ENSBTAG00000038488","X",130698907,130701055,2148
"15797","ENSBTAG00000038489","8",110885179,110927184,42005
"15798","ENSBTAG00000038490","5",101616709,101629916,13207
"15799","ENSBTAG00000038495","12",25608293,25689221,80928
"15800","ENSBTAG00000038496","16",5397503,5446979,49476
"15801","ENSBTAG00000038497","X",5451597,5532887,81290
"15802","ENSBTAG00000038498","5",56432132,56434255,2123
"15803","ENSBTAG00000038502","3",11767485,11772652,5167
"15804","ENSBTAG00000038512","1",22966535,22989880,23345
"15805","ENSBTAG00000038523","3",9488276,9520439,32163
"15806","ENSBTAG00000038526","18",57372380,57383648,11268
"15807","ENSBTAG00000038527","4",19017935,19018355,420
"15808","ENSBTAG00000038532","15",51782270,51788157,5887
"15809","ENSBTAG00000038534","18",65720236,65722871,2635
"15810","ENSBTAG00000038536","15",47778463,47795994,17531
"15811","ENSBTAG00000038540","26",24799040,24812913,13873
"15812","ENSBTAG00000038541","7",2336065,2352077,16012
"15813","ENSBTAG00000038544","10",22999008,23012716,13708
"15814","ENSBTAG00000038548","19",33898320,33918228,19908
"15815","ENSBTAG00000038549","7",7443620,7467138,23518
"15816","ENSBTAG00000038576","3",54043364,54062086,18722
"15817","ENSBTAG00000038584","11",105560462,105581640,21178
"15818","ENSBTAG00000038589","X",85731574,85738770,7196
"15819","ENSBTAG00000038595","X",107459559,107473489,13930
"15820","ENSBTAG00000038600","1",73171521,73173275,1754
"15821","ENSBTAG00000038605","4",105805130,105806034,904
"15822","ENSBTAG00000038606","6",104959375,104961361,1986
"15823","ENSBTAG00000038608","23",29515616,29516566,950
"15824","ENSBTAG00000038610","11",94084614,94086044,1430
"15825","ENSBTAG00000038613","25",38500553,38501581,1028
"15826","ENSBTAG00000038616","22",52750412,52771935,21523
"15827","ENSBTAG00000038617","3",109537600,109551436,13836
"15828","ENSBTAG00000038619","23",28493346,28505219,11873
"15829","ENSBTAG00000038620","2",22397395,22442851,45456
"15830","ENSBTAG00000038625","3",53862077,53888176,26099
"15831","ENSBTAG00000038627","18",47278041,47288592,10551
"15832","ENSBTAG00000038629","7",39950418,39951356,938
"15833","ENSBTAG00000038635","18",64948170,65182761,234591
"15834","ENSBTAG00000038636","15",49538012,49538959,947
"15835","ENSBTAG00000038640","22",14885610,14886530,920
"15836","ENSBTAG00000038650","15",83184213,83210703,26490
"15837","ENSBTAG00000038652","5",74561455,74585374,23919
"15838","ENSBTAG00000038655","29",41540989,41567070,26081
"15839","ENSBTAG00000038659","6",62835528,63097599,262071
"15840","ENSBTAG00000038662","12",36052303,36059944,7641
"15841","ENSBTAG00000038665","11",93888892,93889839,947
"15842","ENSBTAG00000038674","18",60074952,60116948,41996
"15843","ENSBTAG00000038682","14",1025239,1039266,14027
"15844","ENSBTAG00000038691","11",106522808,106541868,19060
"15845","ENSBTAG00000038696","7",6874691,6895044,20353
"15846","ENSBTAG00000038698","NKLS02001494.1",423281,435701,12420
"15847","ENSBTAG00000038700","2",112489090,112502288,13198
"15848","ENSBTAG00000038702","18",60418125,60425791,7666
"15849","ENSBTAG00000038706","18",24029352,24032186,2834
"15850","ENSBTAG00000038711","18",50525310,50530086,4776
"15851","ENSBTAG00000038715","18",65314357,65328279,13922
"15852","ENSBTAG00000038716","16",50517026,50569566,52540
"15853","ENSBTAG00000038733","10",21559582,21569094,9512
"15854","ENSBTAG00000038735","18",55571842,55573733,1891
"15855","ENSBTAG00000038737","15",52784745,52790305,5560
"15856","ENSBTAG00000038738","13",63150881,63167809,16928
"15857","ENSBTAG00000038739","24",58263769,58286282,22513
"15858","ENSBTAG00000038745","19",51669524,51676812,7288
"15859","ENSBTAG00000038748","15",48412408,48414036,1628
"15860","ENSBTAG00000038755","18",60530988,60608616,77628
"15861","ENSBTAG00000038756","15",83597287,83624431,27144
"15862","ENSBTAG00000038757","25",213430,215062,1632
"15863","ENSBTAG00000038770","19",6107085,6131518,24433
"15864","ENSBTAG00000038777","8",59921093,59922048,955
"15865","ENSBTAG00000038783","20",9988474,9989095,621
"15866","ENSBTAG00000038794","8",98619608,98686264,66656
"15867","ENSBTAG00000038795","4",49987458,50048654,61196
"15868","ENSBTAG00000038797","18",62970281,62974443,4162
"15869","ENSBTAG00000038798","14",77517729,77534020,16291
"15870","ENSBTAG00000038806","17",44146467,44147730,1263
"15871","ENSBTAG00000038810","23",28142385,28143467,1082
"15872","ENSBTAG00000038815","X",45209466,45296719,87253
"15873","ENSBTAG00000038823","19",7286704,7311297,24593
"15874","ENSBTAG00000038831","11",99424317,99441357,17040
"15875","ENSBTAG00000038835","11",67271674,67278790,7116
"15876","ENSBTAG00000038842","10",20936646,20945396,8750
"15877","ENSBTAG00000038843","5",99552955,99557139,4184
"15878","ENSBTAG00000038844","3",21481384,21498215,16831
"15879","ENSBTAG00000038845","28",26372856,26379917,7061
"15880","ENSBTAG00000038848","11",73985189,73985268,79
"15881","ENSBTAG00000038849","9",27700837,27786164,85327
"15882","ENSBTAG00000038854","4",103019448,103025467,6019
"15883","ENSBTAG00000038858","18",34275364,34294833,19469
"15884","ENSBTAG00000038865","2",129421761,129471183,49422
"15885","ENSBTAG00000038866","25",1039180,1050840,11660
"15886","ENSBTAG00000038869","18",47334544,47342947,8403
"15887","ENSBTAG00000038873","15",43608426,43608651,225
"15888","ENSBTAG00000038878","2",89283574,89354608,71034
"15889","ENSBTAG00000038879","26",23985830,23985978,148
"15890","ENSBTAG00000038888","23",7626590,7629414,2824
"15891","ENSBTAG00000038889","19",22749344,22753428,4084
"15892","ENSBTAG00000038891","9",87121408,87122942,1534
"15893","ENSBTAG00000038893","5",29010266,29011828,1562
"15894","ENSBTAG00000038896","5",57279798,57283196,3398
"15895","ENSBTAG00000038900","1",11580798,11581218,420
"15896","ENSBTAG00000038903","18",58342620,58344707,2087
"15897","ENSBTAG00000038904","23",27235239,27238717,3478
"15898","ENSBTAG00000038910","19",50338357,50345634,7277
"15899","ENSBTAG00000038916","23",15593409,15600022,6613
"15900","ENSBTAG00000038920","10",48035067,48214587,179520
"15901","ENSBTAG00000038921","25",198487,199498,1011
"15902","ENSBTAG00000038926","18",64463752,64475319,11567
"15903","ENSBTAG00000038929","13",78751887,78808970,57083
"15904","ENSBTAG00000038931","9",50274372,50277915,3543
"15905","ENSBTAG00000038938","3",54409369,54433538,24169
"15906","ENSBTAG00000038949","11",4336948,4351724,14776
"15907","ENSBTAG00000038962","22",54859524,54984793,125269
"15908","ENSBTAG00000038970","24",38819318,38822047,2729
"15909","ENSBTAG00000038972","11",103281334,103283945,2611
"15910","ENSBTAG00000038974","13",54079478,54089223,9745
"15911","ENSBTAG00000038978","25",40868421,40883682,15261
"15912","ENSBTAG00000038979","3",34286939,34291820,4881
"15913","ENSBTAG00000038981","7",17503879,17534955,31076
"15914","ENSBTAG00000038990","19",20162947,20171072,8125
"15915","ENSBTAG00000038992","2",107521189,107535476,14287
"15916","ENSBTAG00000039011","1",83104953,83111141,6188
"15917","ENSBTAG00000039012","19",28289946,28292101,2155
"15918","ENSBTAG00000039014","18",14722687,14736830,14143
"15919","ENSBTAG00000039015","18",50963258,50973065,9807
"15920","ENSBTAG00000039018","19",23914679,23915734,1055
"15921","ENSBTAG00000039028","13",73547863,73555170,7307
"15922","ENSBTAG00000039035","3",8031683,8034120,2437
"15923","ENSBTAG00000039037","NKLS02001094.1",5955,12952,6997
"15924","ENSBTAG00000039046","2",117785379,117787180,1801
"15925","ENSBTAG00000039049","X",125703832,125705403,1571
"15926","ENSBTAG00000039050","15",52718507,52725072,6565
"15927","ENSBTAG00000039055","16",51125124,51128060,2936
"15928","ENSBTAG00000039059","17",72793925,72799077,5152
"15929","ENSBTAG00000039065","12",73363796,74075781,711985
"15930","ENSBTAG00000039066","X",69364019,69364177,158
"15931","ENSBTAG00000039068","14",50805781,50806991,1210
"15932","ENSBTAG00000039071","13",42879702,42893359,13657
"15933","ENSBTAG00000039075","18",47386138,47392452,6314
"15934","ENSBTAG00000039080","9",96475870,96569900,94030
"15935","ENSBTAG00000039086","18",62802729,62823366,20637
"15936","ENSBTAG00000039090","X",92752215,92753650,1435
"15937","ENSBTAG00000039091","2",30617671,30798791,181120
"15938","ENSBTAG00000039105","3",16819976,16822889,2913
"15939","ENSBTAG00000039116","23",29344338,29345285,947
"15940","ENSBTAG00000039117","21",54727823,54805148,77325
"15941","ENSBTAG00000039120","10",27099127,27100173,1046
"15942","ENSBTAG00000039121","2",121807999,121817752,9753
"15943","ENSBTAG00000039122","2",132630420,132665213,34793
"15944","ENSBTAG00000039129","29",48540589,48559970,19381
"15945","ENSBTAG00000039130","7",13545544,13547385,1841
"15946","ENSBTAG00000039132","26",17299670,17358772,59102
"15947","ENSBTAG00000039133","22",37620790,37631075,10285
"15948","ENSBTAG00000039138","11",106520891,106521533,642
"15949","ENSBTAG00000039141","14",55633618,55635565,1947
"15950","ENSBTAG00000039145","23",30881509,30882438,929
"15951","ENSBTAG00000039151","1",36006380,36007572,1192
"15952","ENSBTAG00000039153","29",42647702,42661484,13782
"15953","ENSBTAG00000039154","28",42235845,42236871,1026
"15954","ENSBTAG00000039157","5",56441009,56443098,2089
"15955","ENSBTAG00000039160","7",17664498,17728163,63665
"15956","ENSBTAG00000039161","19",33919849,33936140,16291
"15957","ENSBTAG00000039169","9",31478255,31479310,1055
"15958","ENSBTAG00000039170","5",44320272,44325369,5097
"15959","ENSBTAG00000039171","8",71653618,71701899,48281
"15960","ENSBTAG00000039172","11",94096281,94264860,168579
"15961","ENSBTAG00000039186","11",92281916,92299694,17778
"15962","ENSBTAG00000039190","18",34875817,34894810,18993
"15963","ENSBTAG00000039194","22",60447892,60451883,3991
"15964","ENSBTAG00000039195","X",125752995,126094968,341973
"15965","ENSBTAG00000039196","16",5087364,5098716,11352
"15966","ENSBTAG00000039197","6",104996577,105216475,219898
"15967","ENSBTAG00000039206","19",14780282,14789087,8805
"15968","ENSBTAG00000039208","13",57357647,57361337,3690
"15969","ENSBTAG00000039212","18",57058745,57066275,7530
"15970","ENSBTAG00000039215","18",62542301,62552522,10221
"15971","ENSBTAG00000039218","11",60336402,60336899,497
"15972","ENSBTAG00000039223","11",95845901,95850466,4565
"15973","ENSBTAG00000039234","26",10385330,10426417,41087
"15974","ENSBTAG00000039237","17",70688182,70690140,1958
"15975","ENSBTAG00000039241","10",26460479,26461474,995
"15976","ENSBTAG00000039242","17",44156961,44169024,12063
"15977","ENSBTAG00000039246","7",2632097,2640136,8039
"15978","ENSBTAG00000039255","1",5830120,5830797,677
"15979","ENSBTAG00000039256","5",102831822,102863546,31724
"15980","ENSBTAG00000039275","7",96303404,96356159,52755
"15981","ENSBTAG00000039283","19",53483836,53485750,1914
"15982","ENSBTAG00000039287","3",105658238,105673151,14913
"15983","ENSBTAG00000039289","13",43643187,43665142,21955
"15984","ENSBTAG00000039292","26",31588592,31589998,1406
"15985","ENSBTAG00000039299","19",27986397,27987032,635
"15986","ENSBTAG00000039302","7",14654639,14661566,6927
"15987","ENSBTAG00000039307","15",6502784,6634349,131565
"15988","ENSBTAG00000039313","13",63174373,63214476,40103
"15989","ENSBTAG00000039316","17",44224575,44226983,2408
"15990","ENSBTAG00000039319","7",7365805,7426760,60955
"15991","ENSBTAG00000039321","19",42896014,42919772,23758
"15992","ENSBTAG00000039324","26",13438583,13439355,772
"15993","ENSBTAG00000039325","17",14040368,14066548,26180
"15994","ENSBTAG00000039326","23",45452427,45553179,100752
"15995","ENSBTAG00000039328","27",27080811,27120761,39950
"15996","ENSBTAG00000039329","9",87236522,87247606,11084
"15997","ENSBTAG00000039331","15",78751268,78752210,942
"15998","ENSBTAG00000039335","7",5175099,5179620,4521
"15999","ENSBTAG00000039337","7",7483683,7515358,31675
"16000","ENSBTAG00000039340","15",28825538,28845680,20142
"16001","ENSBTAG00000039341","18",64571839,64572891,1052
"16002","ENSBTAG00000039343","11",97614735,97654974,40239
"16003","ENSBTAG00000039346","2",120062271,120065184,2913
"16004","ENSBTAG00000039347","5",101685006,101693399,8393
"16005","ENSBTAG00000039355","7",43158741,43163414,4673
"16006","ENSBTAG00000039356","13",43372229,43385119,12890
"16007","ENSBTAG00000039357","3",18504545,18510502,5957
"16008","ENSBTAG00000039366","3",11417226,11422750,5524
"16009","ENSBTAG00000039372","7",43140374,43145019,4645
"16010","ENSBTAG00000039374","12",75029683,75069614,39931
"16011","ENSBTAG00000039377","X",28690281,28692815,2534
"16012","ENSBTAG00000039384","6",24679654,24720826,41172
"16013","ENSBTAG00000039388","X",20583304,20584815,1511
"16014","ENSBTAG00000039391","X",87575319,87578253,2934
"16015","ENSBTAG00000039397","7",3035810,3087361,51551
"16016","ENSBTAG00000039406","26",5704948,5705889,941
"16017","ENSBTAG00000039413","18",62793883,62798262,4379
"16018","ENSBTAG00000039415","10",20948208,20951937,3729
"16019","ENSBTAG00000039426","18",35460791,35466415,5624
"16020","ENSBTAG00000039435","5",48542860,48614389,71529
"16021","ENSBTAG00000039440","19",20556890,20557410,520
"16022","ENSBTAG00000039441","18",43154652,43155365,713
"16023","ENSBTAG00000039442","1",97388346,97421921,33575
"16024","ENSBTAG00000039446","13",73497774,73555155,57381
"16025","ENSBTAG00000039453","18",65712918,65718607,5689
"16026","ENSBTAG00000039461","29",37111094,37122584,11490
"16027","ENSBTAG00000039462","10",45645746,45653956,8210
"16028","ENSBTAG00000039463","29",41664021,41689067,25046
"16029","ENSBTAG00000039466","19",56432269,56444629,12360
"16030","ENSBTAG00000039477","9",22191179,22192441,1262
"16031","ENSBTAG00000039483","24",25666394,25698964,32570
"16032","ENSBTAG00000039484","7",40917488,40918417,929
"16033","ENSBTAG00000039485","19",44410793,44424220,13427
"16034","ENSBTAG00000039491","18",57741088,57742974,1886
"16035","ENSBTAG00000039499","14",40845053,40845833,780
"16036","ENSBTAG00000039504","19",14300710,14302662,1952
"16037","ENSBTAG00000039509","5",96960382,96980220,19838
"16038","ENSBTAG00000039512","25",36801640,36812095,10455
"16039","ENSBTAG00000039513","23",45510211,45512390,2179
"16040","ENSBTAG00000039517","29",26980192,26981708,1516
"16041","ENSBTAG00000039520","13",53431673,53469664,37991
"16042","ENSBTAG00000039522","2",18779444,18802820,23376
"16043","ENSBTAG00000039523","7",87013448,87014629,1181
"16044","ENSBTAG00000039524","5",74501674,74571162,69488
"16045","ENSBTAG00000039529","3",101200435,101205864,5429
"16046","ENSBTAG00000039530","8",72181225,72186700,5475
"16047","ENSBTAG00000039531","11",105992918,105996520,3602
"16048","ENSBTAG00000039534","23",29442553,29443488,935
"16049","ENSBTAG00000039540","3",92805776,92808149,2373
"16050","ENSBTAG00000039552","17",29774988,29792009,17021
"16051","ENSBTAG00000039555","7",86288717,86290947,2230
"16052","ENSBTAG00000039556","19",61752501,61782684,30183
"16053","ENSBTAG00000039559","4",105721902,105722630,728
"16054","ENSBTAG00000039563","19",6396123,6438741,42618
"16055","ENSBTAG00000039564","24",279769,280707,938
"16056","ENSBTAG00000039571","13",12436967,12479175,42208
"16057","ENSBTAG00000039573","11",105907564,105928629,21065
"16058","ENSBTAG00000039574","9",33156391,33180084,23693
"16059","ENSBTAG00000039575","1",51959902,51960016,114
"16060","ENSBTAG00000039581","2",20759992,20762165,2173
"16061","ENSBTAG00000039582","17",18388646,18392748,4102
"16062","ENSBTAG00000039588","4",112939116,112945712,6596
"16063","ENSBTAG00000039591","7",82914069,82958724,44655
"16064","ENSBTAG00000039593","18",48210210,48214001,3791
"16065","ENSBTAG00000039594","4",112681946,112712040,30094
"16066","ENSBTAG00000039599","19",37913845,37916664,2819
"16067","ENSBTAG00000039601","25",35982674,35984150,1476
"16068","ENSBTAG00000039614","4",106900981,106901922,941
"16069","ENSBTAG00000039618","10",4956740,4966831,10091
"16070","ENSBTAG00000039620","23",27555744,27558048,2304
"16071","ENSBTAG00000039630","17",52081940,52091382,9442
"16072","ENSBTAG00000039635","18",50477993,50488316,10323
"16073","ENSBTAG00000039643","13",43480015,43491625,11610
"16074","ENSBTAG00000039647","6",84673237,84712945,39708
"16075","ENSBTAG00000039652","29",37178750,37187612,8862
"16076","ENSBTAG00000039657","23",31818805,31828988,10183
"16077","ENSBTAG00000039658","10",12071306,12083726,12420
"16078","ENSBTAG00000039662","16",51881399,51918806,37407
"16079","ENSBTAG00000039664","22",49105357,49105932,575
"16080","ENSBTAG00000039671","26",36956649,36959030,2381
"16081","ENSBTAG00000039675","8",23089984,23090572,588
"16082","ENSBTAG00000039682","27",19567096,19632311,65215
"16083","ENSBTAG00000039684","19",42507157,42521900,14743
"16084","ENSBTAG00000039686","3",91689838,91739355,49517
"16085","ENSBTAG00000039688","17",51466603,51469982,3379
"16086","ENSBTAG00000039695","23",28324719,28333411,8692
"16087","ENSBTAG00000039696","7",19783231,19791715,8484
"16088","ENSBTAG00000039702","3",12636941,12680489,43548
"16089","ENSBTAG00000039705","14",712202,715270,3068
"16090","ENSBTAG00000039706","7",40218516,40219466,950
"16091","ENSBTAG00000039708","11",105931316,105934243,2927
"16092","ENSBTAG00000039709","5",65952796,66019889,67093
"16093","ENSBTAG00000039711","7",40047325,40049928,2603
"16094","ENSBTAG00000039714","NKLS02000910.1",775192,957150,181958
"16095","ENSBTAG00000039718","14",44660636,44664496,3860
"16096","ENSBTAG00000039719","3",23565140,23596466,31326
"16097","ENSBTAG00000039720","25",36814410,36823931,9521
"16098","ENSBTAG00000039722","13",43289239,43296959,7720
"16099","ENSBTAG00000039727","22",10736674,10752208,15534
"16100","ENSBTAG00000039728","16",50992698,50993211,513
"16101","ENSBTAG00000039731","2",45698139,45719676,21537
"16102","ENSBTAG00000039732","23",47392832,47417441,24609
"16103","ENSBTAG00000039735","15",49434896,49435837,941
"16104","ENSBTAG00000039738","3",31745649,31829058,83409
"16105","ENSBTAG00000039740","23",27627266,27628964,1698
"16106","ENSBTAG00000039766","17",44624122,44706739,82617
"16107","ENSBTAG00000039770","11",19635217,19659337,24120
"16108","ENSBTAG00000039772","2",118894087,118909985,15898
"16109","ENSBTAG00000039782","25",38506637,38516366,9729
"16110","ENSBTAG00000039784","5",115268496,115320963,52467
"16111","ENSBTAG00000039793","3",14082643,14098646,16003
"16112","ENSBTAG00000039794","X",86116654,86119023,2369
"16113","ENSBTAG00000039803","2",4886912,4990264,103352
"16114","ENSBTAG00000039804","7",40960150,40961073,923
"16115","ENSBTAG00000039808","21",58933764,59038421,104657
"16116","ENSBTAG00000039809","7",13762762,13769861,7099
"16117","ENSBTAG00000039813","21",34746523,34754746,8223
"16118","ENSBTAG00000039815","11",94076975,94079017,2042
"16119","ENSBTAG00000039819","19",22301377,22440866,139489
"16120","ENSBTAG00000039820","1",5770225,5772218,1993
"16121","ENSBTAG00000039823","12",11345513,11414148,68635
"16122","ENSBTAG00000039825","29",5865962,5875027,9065
"16123","ENSBTAG00000039834","26",21843146,21844360,1214
"16124","ENSBTAG00000039839","11",46752632,46756877,4245
"16125","ENSBTAG00000039849","18",60682643,60684957,2314
"16126","ENSBTAG00000039851","11",103462731,103481943,19212
"16127","ENSBTAG00000039855","22",21901729,21995165,93436
"16128","ENSBTAG00000039861","17",61363053,61371004,7951
"16129","ENSBTAG00000039886","7",39087284,39091161,3877
"16130","ENSBTAG00000039888","X",92287353,92293899,6546
"16131","ENSBTAG00000039890","X",18794515,18825185,30670
"16132","ENSBTAG00000039893","15",81258851,81280080,21229
"16133","ENSBTAG00000039914","18",2568360,2572543,4183
"16134","ENSBTAG00000039916","24",47500431,47583313,82882
"16135","ENSBTAG00000039922","6",55445522,55641914,196392
"16136","ENSBTAG00000039929","20",39835996,39837372,1376
"16137","ENSBTAG00000039930","7",40932455,40933408,953
"16138","ENSBTAG00000039933","19",40274445,40275209,764
"16139","ENSBTAG00000039935","18",56494454,56506091,11637
"16140","ENSBTAG00000039937","16",41564624,41613127,48503
"16141","ENSBTAG00000039943","29",17454198,17591609,137411
"16142","ENSBTAG00000039946","18",65375097,65405941,30844
"16143","ENSBTAG00000039951","3",36311513,36312871,1358
"16144","ENSBTAG00000039954","19",38443546,38453501,9955
"16145","ENSBTAG00000039955","4",27854472,27854966,494
"16146","ENSBTAG00000039958","18",55541702,55558358,16656
"16147","ENSBTAG00000039962","25",26595524,26599199,3675
"16148","ENSBTAG00000039967","5",27084247,27092894,8647
"16149","ENSBTAG00000039968","14",73372951,73445265,72314
"16150","ENSBTAG00000039970","29",38376234,38386068,9834
"16151","ENSBTAG00000039971","18",54753785,54771042,17257
"16152","ENSBTAG00000039973","26",14403428,14411376,7948
"16153","ENSBTAG00000039974","25",858332,859438,1106
"16154","ENSBTAG00000039978","14",709459,712018,2559
"16155","ENSBTAG00000039980","5",100319678,100336583,16905
"16156","ENSBTAG00000039981","11",49196739,49202049,5310
"16157","ENSBTAG00000039991","6",84443442,84464670,21228
"16158","ENSBTAG00000039992","5",30565046,30572546,7500
"16159","ENSBTAG00000039993","3",11914670,11919678,5008
"16160","ENSBTAG00000039994","2",122183940,122198209,14269
"16161","ENSBTAG00000039995","16",5627221,5723824,96603
"16162","ENSBTAG00000040000","18",2827665,2831660,3995
"16163","ENSBTAG00000040001","20",10317496,10341306,23810
"16164","ENSBTAG00000040006","23",10502815,10509269,6454
"16165","ENSBTAG00000040018","28",18271209,18271565,356
"16166","ENSBTAG00000040028","7",2685793,2703542,17749
"16167","ENSBTAG00000040034","8",62476008,62522597,46589
"16168","ENSBTAG00000040038","8",8772448,8783747,11299
"16169","ENSBTAG00000040040","4",106631620,106633622,2002
"16170","ENSBTAG00000040042","19",56555365,56571477,16112
"16171","ENSBTAG00000040051","15",31611597,31611944,347
"16172","ENSBTAG00000040053","10",21515534,21545497,29963
"16173","ENSBTAG00000040054","18",54793734,54796515,2781
"16174","ENSBTAG00000040055","2",118530388,118632791,102403
"16175","ENSBTAG00000040056","10",20858847,20863172,4325
"16176","ENSBTAG00000040058","4",45330008,45418109,88101
"16177","ENSBTAG00000040060","3",102121461,102122516,1055
"16178","ENSBTAG00000040061","1",127530714,127574835,44121
"16179","ENSBTAG00000040063","18",47273441,47277130,3689
"16180","ENSBTAG00000040065","5",105578163,105595893,17730
"16181","ENSBTAG00000040067","18",49730322,49738814,8492
"16182","ENSBTAG00000040070","29",40681373,40684239,2866
"16183","ENSBTAG00000040072","17",44110583,44121402,10819
"16184","ENSBTAG00000040076","7",15137070,15164555,27485
"16185","ENSBTAG00000040078","10",86764090,86898356,134266
"16186","ENSBTAG00000040082","4",68862439,68872086,9647
"16187","ENSBTAG00000040084","3",118925291,118929496,4205
"16188","ENSBTAG00000040086","18",10344784,10382141,37357
"16189","ENSBTAG00000040088","6",21792500,21851763,59263
"16190","ENSBTAG00000040098","3",20720417,20725138,4721
"16191","ENSBTAG00000040103","29",49649660,49654076,4416
"16192","ENSBTAG00000040106","5",112387043,112395842,8799
"16193","ENSBTAG00000040111","19",56476437,56483642,7205
"16194","ENSBTAG00000040116","22",59173586,59174230,644
"16195","ENSBTAG00000040126","24",25727491,25767695,40204
"16196","ENSBTAG00000040128","29",8618154,8623002,4848
"16197","ENSBTAG00000040131","3",26709589,26773139,63550
"16198","ENSBTAG00000040132","X",54944822,54946906,2084
"16199","ENSBTAG00000040133","22",57548656,57595689,47033
"16200","ENSBTAG00000040144","1",57570680,57586854,16174
"16201","ENSBTAG00000040146","3",59136182,59136622,440
"16202","ENSBTAG00000040147","13",42413642,42517964,104322
"16203","ENSBTAG00000040151","10",67345440,67400407,54967
"16204","ENSBTAG00000040161","1",70913018,70922405,9387
"16205","ENSBTAG00000040167","10",91761127,91761918,791
"16206","ENSBTAG00000040169","18",65024314,65037998,13684
"16207","ENSBTAG00000040188","23",29305933,29309785,3852
"16208","ENSBTAG00000040190","29",42630756,42645750,14994
"16209","ENSBTAG00000040193","1",152510195,152548791,38596
"16210","ENSBTAG00000040199","1",82824296,82829473,5177
"16211","ENSBTAG00000040202","29",17406353,17422378,16025
"16212","ENSBTAG00000040206","10",30450495,30452561,2066
"16213","ENSBTAG00000040208","10",17735485,17737087,1602
"16214","ENSBTAG00000040209","18",52244074,52270482,26408
"16215","ENSBTAG00000040210","2",125045161,125045487,326
"16216","ENSBTAG00000040215","2",131485408,131837484,352076
"16217","ENSBTAG00000040222","13",11376055,11389221,13166
"16218","ENSBTAG00000040226","11",10205805,10211683,5878
"16219","ENSBTAG00000040242","17",29684354,29684788,434
"16220","ENSBTAG00000040244","5",74600517,74612469,11952
"16221","ENSBTAG00000040248","3",51331168,51334112,2944
"16222","ENSBTAG00000040253","7",71500743,71562032,61289
"16223","ENSBTAG00000040255","X",49736706,49737317,611
"16224","ENSBTAG00000040268","3",81244951,81315175,70224
"16225","ENSBTAG00000040277","23",31774497,31775288,791
"16226","ENSBTAG00000040279","19",40903097,40907225,4128
"16227","ENSBTAG00000040282","19",7389042,7389740,698
"16228","ENSBTAG00000040290","26",24837552,24858231,20679
"16229","ENSBTAG00000040291","1",144560582,144561641,1059
"16230","ENSBTAG00000040293","15",67005342,67008473,3131
"16231","ENSBTAG00000040295","25",27760604,27766328,5724
"16232","ENSBTAG00000040296","11",94189213,94191396,2183
"16233","ENSBTAG00000040298","17",71318878,71326525,7647
"16234","ENSBTAG00000040304","1",83030383,83035642,5259
"16235","ENSBTAG00000040305","7",7978153,7979097,944
"16236","ENSBTAG00000040308","15",35408334,35411050,2716
"16237","ENSBTAG00000040313","3",91528851,91530803,1952
"16238","ENSBTAG00000040318","18",47714276,47729402,15126
"16239","ENSBTAG00000040320","15",80644028,80655865,11837
"16240","ENSBTAG00000040321","14",23475942,23502005,26063
"16241","ENSBTAG00000040323","19",50277497,50279874,2377
"16242","ENSBTAG00000040329","2",129644896,129646029,1133
"16243","ENSBTAG00000040331","4",113131167,113139056,7889
"16244","ENSBTAG00000040333","6",112919767,112939911,20144
"16245","ENSBTAG00000040334","7",43947454,43955283,7829
"16246","ENSBTAG00000040336","17",44195034,44221154,26120
"16247","ENSBTAG00000040338","2",107478709,107500811,22102
"16248","ENSBTAG00000040339","15",49464595,49465551,956
"16249","ENSBTAG00000040347","12",67702395,68209239,506844
"16250","ENSBTAG00000040349","4",88267317,88284027,16710
"16251","ENSBTAG00000040350","X",8198224,8233737,35513
"16252","ENSBTAG00000040351","14",19106847,19109491,2644
"16253","ENSBTAG00000040356","18",14652352,14679143,26791
"16254","ENSBTAG00000040357","X",108854399,108858371,3972
"16255","ENSBTAG00000040358","18",64684152,64718827,34675
"16256","ENSBTAG00000040360","14",1058869,1060642,1773
"16257","ENSBTAG00000040361","25",40757153,40766255,9102
"16258","ENSBTAG00000040367","2",92575447,92576061,614
"16259","ENSBTAG00000040368","10",14030086,14103131,73045
"16260","ENSBTAG00000040380","15",50821755,50823680,1925
"16261","ENSBTAG00000040384","10",52583620,52591121,7501
"16262","ENSBTAG00000040386","X",545113,546201,1088
"16263","ENSBTAG00000040387","4",105683193,105683751,558
"16264","ENSBTAG00000040390","8",73140518,73360380,219862
"16265","ENSBTAG00000040392","18",60856348,60866029,9681
"16266","ENSBTAG00000040393","1",157728794,157745955,17161
"16267","ENSBTAG00000040394","25",2125846,2132837,6991
"16268","ENSBTAG00000040398","6",71604475,71731154,126679
"16269","ENSBTAG00000040399","1",82933517,82945153,11636
"16270","ENSBTAG00000040406","X",108509377,108511530,2153
"16271","ENSBTAG00000040409","16",5920408,6165638,245230
"16272","ENSBTAG00000040413","18",34655283,34668466,13183
"16273","ENSBTAG00000040422","14",47545755,47552999,7244
"16274","ENSBTAG00000040427","26",18481419,18550454,69035
"16275","ENSBTAG00000040432","25",33507968,33509181,1213
"16276","ENSBTAG00000040435","3",100746067,100747183,1116
"16277","ENSBTAG00000040439","20",15587584,15588852,1268
"16278","ENSBTAG00000040442","18",65365400,65367229,1829
"16279","ENSBTAG00000040449","15",16001768,16035987,34219
"16280","ENSBTAG00000040450","5",101375509,101382102,6593
"16281","ENSBTAG00000040460","19",41116547,41134104,17557
"16282","ENSBTAG00000040461","14",77497195,77515623,18428
"16283","ENSBTAG00000040473","7",52428705,52436348,7643
"16284","ENSBTAG00000040477","16",47167118,47225131,58013
"16285","ENSBTAG00000040478","15",49661292,49662230,938
"16286","ENSBTAG00000040490","13",11479616,11570661,91045
"16287","ENSBTAG00000040496","14",35905091,36335697,430606
"16288","ENSBTAG00000040497","2",126708949,126720207,11258
"16289","ENSBTAG00000040504","10",25060218,25061519,1301
"16290","ENSBTAG00000040507","7",16245817,16345949,100132
"16291","ENSBTAG00000040512","3",8231447,8258195,26748
"16292","ENSBTAG00000040518","2",121801089,121802438,1349
"16293","ENSBTAG00000040521","19",36526611,36543419,16808
"16294","ENSBTAG00000040541","X",80184750,80185847,1097
"16295","ENSBTAG00000040543","9",68537667,68539142,1475
"16296","ENSBTAG00000040547","2",132453930,132454775,845
"16297","ENSBTAG00000040551","10",76649277,76678871,29594
"16298","ENSBTAG00000040555","25",27002887,27086008,83121
"16299","ENSBTAG00000040559","18",62242461,62251375,8914
"16300","ENSBTAG00000040564","11",26736270,26736446,176
"16301","ENSBTAG00000040567","15",5950595,5964239,13644
"16302","ENSBTAG00000040569","15",29751059,29769509,18450
"16303","ENSBTAG00000040575","25",2102108,2122816,20708
"16304","ENSBTAG00000040582","23",29661663,29663150,1487
"16305","ENSBTAG00000040584","24",26027840,26063705,35865
"16306","ENSBTAG00000040585","11",95553002,95774429,221427
"16307","ENSBTAG00000040590","10",47008040,47009992,1952
"16308","ENSBTAG00000040596","3",18981628,18983577,1949
"16309","ENSBTAG00000040598","3",120859767,120863495,3728
"16310","ENSBTAG00000040602","2",130801979,130806189,4210
"16311","ENSBTAG00000040603","18",57531832,57538880,7048
"16312","ENSBTAG00000040605","18",12392241,12393281,1040
"16313","ENSBTAG00000040607","13",65711052,65737754,26702
"16314","ENSBTAG00000042090","20",62222198,62222301,103
"16315","ENSBTAG00000042094","1",82862630,82862705,75
"16316","ENSBTAG00000042096","18",22475992,22476116,124
"16317","ENSBTAG00000042099","13",77375801,77375892,91
"16318","ENSBTAG00000042100","12",32616968,32617038,70
"16319","ENSBTAG00000042115","21",2097397,2097487,90
"16320","ENSBTAG00000042117","22",48173028,48173104,76
"16321","ENSBTAG00000042124","22",7619981,7620106,125
"16322","ENSBTAG00000042125","21",2186760,2186809,49
"16323","ENSBTAG00000042126","16",36773109,36773240,131
"16324","ENSBTAG00000042134","15",33680459,33680544,85
"16325","ENSBTAG00000042142","2",122637357,122637439,82
"16326","ENSBTAG00000042143","7",14664956,14665042,86
"16327","ENSBTAG00000042154","17",72999700,72999821,121
"16328","ENSBTAG00000042159","19",35724663,35724749,86
"16329","ENSBTAG00000042160","22",50244428,50244533,105
"16330","ENSBTAG00000042166","5",31115241,31115372,131
"16331","ENSBTAG00000042169","5",56645578,56645657,79
"16332","ENSBTAG00000042170","7",12799678,12799748,70
"16333","ENSBTAG00000042171","14",64580622,64580756,134
"16334","ENSBTAG00000042173","15",53257927,53258034,107
"16335","ENSBTAG00000042176","13",66155015,66155145,130
"16336","ENSBTAG00000042179","11",26425010,26425113,103
"16337","ENSBTAG00000042180","16",55234875,55234951,76
"16338","ENSBTAG00000042181","2",90793916,90794002,86
"16339","ENSBTAG00000042185","X",20467076,20467147,71
"16340","ENSBTAG00000042186","26",22803764,22803877,113
"16341","ENSBTAG00000042194","24",20840693,20840799,106
"16342","ENSBTAG00000042198","13",52520776,52520847,71
"16343","ENSBTAG00000042201","19",20543611,20543742,131
"16344","ENSBTAG00000042215","17",62539528,62539659,131
"16345","ENSBTAG00000042217","16",55236837,55236905,68
"16346","ENSBTAG00000042224","26",39258199,39258328,129
"16347","ENSBTAG00000042226","22",12686788,12686938,150
"16348","ENSBTAG00000042233","10",13360418,13360489,71
"16349","ENSBTAG00000042234","13",52992684,52992818,134
"16350","ENSBTAG00000042237","5",43901783,43901910,127
"16351","ENSBTAG00000042240","17",72000924,72001027,103
"16352","ENSBTAG00000042245","16",44580084,44580187,103
"16353","ENSBTAG00000042256","7",50584707,50584906,199
"16354","ENSBTAG00000042259","8",50952542,50952621,79
"16355","ENSBTAG00000042264","28",25485952,25486031,79
"16356","ENSBTAG00000042268","19",20930117,20930187,70
"16357","ENSBTAG00000042269","4",118621542,118621667,125
"16358","ENSBTAG00000042272","10",92497673,92497816,143
"16359","ENSBTAG00000042273","29",40996431,40996579,148
"16360","ENSBTAG00000042275","9",70977616,70977688,72
"16361","ENSBTAG00000042276","25",26838286,26838416,130
"16362","ENSBTAG00000042280","29",1087043,1087169,126
"16363","ENSBTAG00000042281","28",24944471,24944604,133
"16364","ENSBTAG00000042283","7",18550534,18550613,79
"16365","ENSBTAG00000042289","5",45089836,45089967,131
"16366","ENSBTAG00000042292","3",101233371,101233443,72
"16367","ENSBTAG00000042294","3",66602544,66602647,103
"16368","ENSBTAG00000042297","20",33656058,33656139,81
"16369","ENSBTAG00000042298","5",26557854,26557960,106
"16370","ENSBTAG00000042299","22",4393870,4393975,105
"16371","ENSBTAG00000042305","19",14769240,14769336,96
"16372","ENSBTAG00000042308","28",32123936,32124042,106
"16373","ENSBTAG00000042319","15",54113379,54113515,136
"16374","ENSBTAG00000042322","13",67344057,67344190,133
"16375","ENSBTAG00000042329","11",94040408,94040518,110
"16376","ENSBTAG00000042335","15",43880109,43880237,128
"16377","ENSBTAG00000042339","16",55235622,55235702,80
"16378","ENSBTAG00000042345","17",61775667,61775773,106
"16379","ENSBTAG00000042354","15",43881350,43881479,129
"16380","ENSBTAG00000042357","3",50633298,50633393,95
"16381","ENSBTAG00000042358","3",99486271,99486350,79
"16382","ENSBTAG00000042363","16",30874079,30874205,126
"16383","ENSBTAG00000042366","25",27730678,27730811,133
"16384","ENSBTAG00000042370","X",36213063,36213193,130
"16385","ENSBTAG00000042372","12",21851564,21851695,131
"16386","ENSBTAG00000042377","18",55942970,55943054,84
"16387","ENSBTAG00000042378","15",29159719,29159852,133
"16388","ENSBTAG00000042380","3",92157595,92157724,129
"16389","ENSBTAG00000042383","7",20030719,20030783,64
"16390","ENSBTAG00000042385","17",43381106,43381209,103
"16391","ENSBTAG00000042387","19",23301229,23301322,93
"16392","ENSBTAG00000042388","26",9353293,9353410,117
"16393","ENSBTAG00000042391","6",68404963,68405084,121
"16394","ENSBTAG00000042393","16",64894638,64894740,102
"16395","ENSBTAG00000042394","25",1519879,1520009,130
"16396","ENSBTAG00000042398","19",48366575,48366709,134
"16397","ENSBTAG00000042401","21",65840467,65840541,74
"16398","ENSBTAG00000042406","10",13359516,13359586,70
"16399","ENSBTAG00000042408","12",32616595,32616721,126
"16400","ENSBTAG00000042411","3",42327050,42327155,105
"16401","ENSBTAG00000042414","5",94028129,94028311,182
"16402","ENSBTAG00000042416","19",32975785,32976105,320
"16403","ENSBTAG00000042417","5",62750796,62751043,247
"16404","ENSBTAG00000042418","7",4850198,4850300,102
"16405","ENSBTAG00000042423","17",29707723,29707856,133
"16406","ENSBTAG00000042433","18",18623511,18623592,81
"16407","ENSBTAG00000042434","3",50630367,50630499,132
"16408","ENSBTAG00000042435","2",119228001,119228134,133
"16409","ENSBTAG00000042439","18",18623733,18623802,69
"16410","ENSBTAG00000042440","4",76612259,76612390,131
"16411","ENSBTAG00000042442","21",65877099,65877168,69
"16412","ENSBTAG00000042455","25",19818277,19818384,107
"16413","ENSBTAG00000042456","5",110751521,110751584,63
"16414","ENSBTAG00000042458","8",59833118,59833395,277
"16415","ENSBTAG00000042461","19",55196206,55196290,84
"16416","ENSBTAG00000042464","29",41158023,41158092,69
"16417","ENSBTAG00000042466","X",118655158,118655305,147
"16418","ENSBTAG00000042467","1",140670100,140670206,106
"16419","ENSBTAG00000042470","24",34749010,34749115,105
"16420","ENSBTAG00000042471","29",1091509,1091635,126
"16421","ENSBTAG00000042475","1",80470085,80470216,131
"16422","ENSBTAG00000042478","10",8457395,8457528,133
"16423","ENSBTAG00000042479","29",41157740,41157815,75
"16424","ENSBTAG00000042482","11",104131158,104131289,131
"16425","ENSBTAG00000042484","29",41156573,41156699,126
"16426","ENSBTAG00000042491","21",28250753,28250850,97
"16427","ENSBTAG00000042492","14",69274407,69274541,134
"16428","ENSBTAG00000042493","X",37452984,37453118,134
"16429","ENSBTAG00000042498","8",59017960,59018095,135
"16430","ENSBTAG00000042502","27",24964840,24964974,134
"16431","ENSBTAG00000042503","6",97300515,97300654,139
"16432","ENSBTAG00000042504","16",55236195,55236259,64
"16433","ENSBTAG00000042507","2",94492698,94492831,133
"16434","ENSBTAG00000042518","7",71676630,71676759,129
"16435","ENSBTAG00000042519","21",65881431,65881502,71
"16436","ENSBTAG00000042521","13",69771141,69771247,106
"16437","ENSBTAG00000042522","17",34697409,34697537,128
"16438","ENSBTAG00000042523","28",41218620,41218722,102
"16439","ENSBTAG00000042526","29",41156987,41157062,75
"16440","ENSBTAG00000042532","16",43882904,43883010,106
"16441","ENSBTAG00000042535","1",97292056,97292182,126
"16442","ENSBTAG00000042536","5",31116771,31116909,138
"16443","ENSBTAG00000042543","21",65874705,65874772,67
"16444","ENSBTAG00000042545","3",101232846,101232914,68
"16445","ENSBTAG00000042546","6",58827596,58827718,122
"16446","ENSBTAG00000042551","1",118981050,118981155,105
"16447","ENSBTAG00000042552","9",63721248,63721354,106
"16448","ENSBTAG00000042553","2",124853745,124853818,73
"16449","ENSBTAG00000042555","19",38864114,38864219,105
"16450","ENSBTAG00000042557","1",10488768,10488874,106
"16451","ENSBTAG00000042558","6",60576749,60577071,322
"16452","ENSBTAG00000042559","3",14846190,14846323,133
"16453","ENSBTAG00000042567","10",73255974,73256076,102
"16454","ENSBTAG00000042573","5",88954274,88954376,102
"16455","ENSBTAG00000042579","10",25760558,25760667,109
"16456","ENSBTAG00000042587","23",33279806,33279916,110
"16457","ENSBTAG00000042588","21",65852465,65852537,72
"16458","ENSBTAG00000042589","18",46534445,46534547,102
"16459","ENSBTAG00000042596","7",91799825,91800135,310
"16460","ENSBTAG00000042598","18",29459908,29460036,128
"16461","ENSBTAG00000042599","13",72872107,72872212,105
"16462","ENSBTAG00000042600","11",48729800,48729935,135
"16463","ENSBTAG00000042601","9",39106118,39106431,313
"16464","ENSBTAG00000042602","16",23682025,23682156,131
"16465","ENSBTAG00000042605","8",38143829,38143968,139
"16466","ENSBTAG00000042607","13",52521106,52521176,70
"16467","ENSBTAG00000042610","1",70257049,70257120,71
"16468","ENSBTAG00000042613","18",56863073,56863166,93
"16469","ENSBTAG00000042614","X",92364907,92365035,128
"16470","ENSBTAG00000042621","10",21716175,21716282,107
"16471","ENSBTAG00000042624","7",53663910,53664033,123
"16472","ENSBTAG00000042625","27",19186649,19186721,72
"16473","ENSBTAG00000042626","7",73124173,73124298,125
"16474","ENSBTAG00000042631","13",52521602,52521687,85
"16475","ENSBTAG00000042637","24",22442617,22442719,102
"16476","ENSBTAG00000042638","5",112589353,112589469,116
"16477","ENSBTAG00000042644","13",47487786,47487891,105
"16478","ENSBTAG00000042645","3",101234215,101234318,103
"16479","ENSBTAG00000042649","15",54594237,54594386,149
"16480","ENSBTAG00000042652","13",67325233,67325365,132
"16481","ENSBTAG00000042654","X",92292646,92292773,127
"16482","ENSBTAG00000042661","3",106501834,106501968,134
"16483","ENSBTAG00000042662","13",38233811,38234046,235
"16484","ENSBTAG00000042663","19",49908998,49909201,203
"16485","ENSBTAG00000042664","2",112068065,112068165,100
"16486","ENSBTAG00000042669","25",3753608,3753741,133
"16487","ENSBTAG00000042676","4",112160075,112160170,95
"16488","ENSBTAG00000042677","5",56791576,56791646,70
"16489","ENSBTAG00000042678","13",67340775,67340909,134
"16490","ENSBTAG00000042680","19",18232999,18233121,122
"16491","ENSBTAG00000042683","5",112070479,112070582,103
"16492","ENSBTAG00000042684","15",35410671,35410757,86
"16493","ENSBTAG00000042688","25",1520525,1520658,133
"16494","ENSBTAG00000042690","21",65871386,65871457,71
"16495","ENSBTAG00000042691","26",18679976,18680097,121
"16496","ENSBTAG00000042696","17",6718098,6718166,68
"16497","ENSBTAG00000042699","1",83640377,83640508,131
"16498","ENSBTAG00000042702","1",80469761,80469901,140
"16499","ENSBTAG00000042705","22",7703317,7703420,103
"16500","ENSBTAG00000042706","19",55197780,55197857,77
"16501","ENSBTAG00000042711","29",1103308,1103387,79
"16502","ENSBTAG00000042713","21",67991310,67991435,125
"16503","ENSBTAG00000042718","3",16263650,16263784,134
"16504","ENSBTAG00000042723","2",124806156,124806288,132
"16505","ENSBTAG00000042726","3",82787128,82787234,106
"16506","ENSBTAG00000042727","21",65817559,65817628,69
"16507","ENSBTAG00000042735","18",47204127,47204253,126
"16508","ENSBTAG00000042736","3",66876122,66876229,107
"16509","ENSBTAG00000042739","21",65835252,65835326,74
"16510","ENSBTAG00000042741","19",48366314,48366383,69
"16511","ENSBTAG00000042742","18",56862032,56862125,93
"16512","ENSBTAG00000042744","13",67323533,67323664,131
"16513","ENSBTAG00000042752","16",2233425,2233554,129
"16514","ENSBTAG00000042753","21",41875675,41875823,148
"16515","ENSBTAG00000042757","9",96045925,96046054,129
"16516","ENSBTAG00000042758","29",41156310,41156376,66
"16517","ENSBTAG00000042761","10",12458565,12458672,107
"16518","ENSBTAG00000042769","21",2195192,2195270,78
"16519","ENSBTAG00000042770","8",4235515,4235656,141
"16520","ENSBTAG00000042780","19",23299932,23300026,94
"16521","ENSBTAG00000042784","18",56861548,56861639,91
"16522","ENSBTAG00000042786","18",14490892,14490973,81
"16523","ENSBTAG00000042787","19",18133673,18133803,130
"16524","ENSBTAG00000042789","3",104978901,104979004,103
"16525","ENSBTAG00000042801","9",70979010,70979086,76
"16526","ENSBTAG00000042803","7",1761656,1761785,129
"16527","ENSBTAG00000042806","18",1612662,1612741,79
"16528","ENSBTAG00000042817","4",102386012,102386108,96
"16529","ENSBTAG00000042819","7",86290668,86290730,62
"16530","ENSBTAG00000042825","2",131203436,131203543,107
"16531","ENSBTAG00000042833","9",70980039,70980168,129
"16532","ENSBTAG00000042836","19",27307596,27307730,134
"16533","ENSBTAG00000042837","27",19186465,19186541,76
"16534","ENSBTAG00000042841","4",98792121,98792227,106
"16535","ENSBTAG00000042846","29",1090785,1090858,73
"16536","ENSBTAG00000042858","2",18517905,18518047,142
"16537","ENSBTAG00000042860","2",122617294,122617370,76
"16538","ENSBTAG00000042863","22",56345305,56345444,139
"16539","ENSBTAG00000042865","24",60663791,60663859,68
"16540","ENSBTAG00000042868","19",27310490,27310633,143
"16541","ENSBTAG00000042871","2",124852652,124852782,130
"16542","ENSBTAG00000042873","19",20922062,20922169,107
"16543","ENSBTAG00000042875","22",12696286,12696434,148
"16544","ENSBTAG00000042878","13",29514518,29514641,123
"16545","ENSBTAG00000042879","2",27258416,27258518,102
"16546","ENSBTAG00000042880","2",106259878,106260014,136
"16547","ENSBTAG00000042882","21",65843427,65843500,73
"16548","ENSBTAG00000042883","18",55943531,55943619,88
"16549","ENSBTAG00000042885","X",36950833,36950939,106
"16550","ENSBTAG00000042890","13",32138698,32138783,85
"16551","ENSBTAG00000042893","18",1556994,1557097,103
"16552","ENSBTAG00000042896","10",81348892,81348994,102
"16553","ENSBTAG00000042898","29",1103080,1103151,71
"16554","ENSBTAG00000042916","15",54597712,54597855,143
"16555","ENSBTAG00000042919","5",100747323,100747429,106
"16556","ENSBTAG00000042921","22",52202199,52202301,102
"16557","ENSBTAG00000042923","11",72625235,72625384,149
"16558","ENSBTAG00000042928","5",48767193,48767299,106
"16559","ENSBTAG00000042930","11",104129995,104130118,123
"16560","ENSBTAG00000042931","16",55237412,55237474,62
"16561","ENSBTAG00000042933","2",36398029,36398164,135
"16562","ENSBTAG00000042936","7",40373865,40373943,78
"16563","ENSBTAG00000042937","27",36936421,36936527,106
"16564","ENSBTAG00000042942","22",10088997,10089102,105
"16565","ENSBTAG00000042950","3",69064851,69064929,78
"16566","ENSBTAG00000042951","6",22702726,22702828,102
"16567","ENSBTAG00000042952","5",10229151,10229276,125
"16568","ENSBTAG00000042956","3",101197671,101197787,116
"16569","ENSBTAG00000042963","29",1089786,1089922,136
"16570","ENSBTAG00000042966","21",29560323,29560429,106
"16571","ENSBTAG00000042974","16",55237171,55237252,81
"16572","ENSBTAG00000042984","23",27670553,27670683,130
"16573","ENSBTAG00000042986","2",124852030,124852164,134
"16574","ENSBTAG00000042989","23",27514118,27514184,66
"16575","ENSBTAG00000042990","18",48013961,48014065,104
"16576","ENSBTAG00000042998","9",70846744,70846841,97
"16577","ENSBTAG00000043000","29",1090407,1090540,133
"16578","ENSBTAG00000043001","2",22267736,22267841,105
"16579","ENSBTAG00000043006","4",25846087,25846152,65
"16580","ENSBTAG00000043016","11",104257793,104257867,74
"16581","ENSBTAG00000043023","7",65328755,65328857,102
"16582","ENSBTAG00000043028","16",71246115,71246215,100
"16583","ENSBTAG00000043030","1",141036565,141036872,307
"16584","ENSBTAG00000043035","10",43147261,43147367,106
"16585","ENSBTAG00000043036","13",77376718,77376808,90
"16586","ENSBTAG00000043037","22",43038863,43038970,107
"16587","ENSBTAG00000043040","21",65851501,65851577,76
"16588","ENSBTAG00000043047","11",98180488,98180616,128
"16589","ENSBTAG00000043048","5",56790501,56790575,74
"16590","ENSBTAG00000043049","18",1607891,1607981,90
"16591","ENSBTAG00000043054","11",26142496,26142582,86
"16592","ENSBTAG00000043056","23",6129347,6129450,103
"16593","ENSBTAG00000043066","17",10659512,10659615,103
"16594","ENSBTAG00000043071","17",6176375,6176511,136
"16595","ENSBTAG00000043072","8",50952749,50952806,57
"16596","ENSBTAG00000043073","22",56018849,56018955,106
"16597","ENSBTAG00000043077","13",52522577,52522712,135
"16598","ENSBTAG00000043086","4",112184225,112184336,111
"16599","ENSBTAG00000043088","15",73928453,73928554,101
"16600","ENSBTAG00000043090","26",42010747,42010847,100
"16601","ENSBTAG00000043091","20",17705201,17705293,92
"16602","ENSBTAG00000043093","19",12852860,12852989,129
"16603","ENSBTAG00000043098","15",76693696,76693806,110
"16604","ENSBTAG00000043100","21",67140873,67140989,116
"16605","ENSBTAG00000043101","11",104257030,104257100,70
"16606","ENSBTAG00000043103","8",73407024,73407160,136
"16607","ENSBTAG00000043104","5",56645822,56645893,71
"16608","ENSBTAG00000043105","8",48228250,48228365,115
"16609","ENSBTAG00000043106","10",35610034,35610138,104
"16610","ENSBTAG00000043109","4",70963720,70963845,125
"16611","ENSBTAG00000043112","X",86741965,86742071,106
"16612","ENSBTAG00000043119","2",104062261,104062381,120
"16613","ENSBTAG00000043122","15",74646036,74646158,122
"16614","ENSBTAG00000043125","22",7316631,7316760,129
"16615","ENSBTAG00000043128","X",4151193,4151326,133
"16616","ENSBTAG00000043130","X",37783252,37783337,85
"16617","ENSBTAG00000043133","23",41568225,41568329,104
"16618","ENSBTAG00000043135","2",73247035,73247160,125
"16619","ENSBTAG00000043140","22",48171158,48171234,76
"16620","ENSBTAG00000043151","23",27514626,27514688,62
"16621","ENSBTAG00000043153","8",60323842,60323967,125
"16622","ENSBTAG00000043157","1",97612804,97613233,429
"16623","ENSBTAG00000043158","11",6181144,6181257,113
"16624","ENSBTAG00000043162","28",44027672,44027871,199
"16625","ENSBTAG00000043163","13",3702527,3702634,107
"16626","ENSBTAG00000043164","11",10868293,10868396,103
"16627","ENSBTAG00000043165","19",36917118,36917252,134
"16628","ENSBTAG00000043166","2",94492348,94492427,79
"16629","ENSBTAG00000043167","29",50557435,50557569,134
"16630","ENSBTAG00000043168","18",55951999,55952085,86
"16631","ENSBTAG00000043171","8",18790530,18790834,304
"16632","ENSBTAG00000043177","X",87116385,87116519,134
"16633","ENSBTAG00000043187","21",31217333,31217458,125
"16634","ENSBTAG00000043189","X",86319364,86319466,102
"16635","ENSBTAG00000043192","18",26336421,26336556,135
"16636","ENSBTAG00000043196","10",25766152,25766260,108
"16637","ENSBTAG00000043197","18",55942217,55942300,83
"16638","ENSBTAG00000043199","25",26867375,26867479,104
"16639","ENSBTAG00000043202","9",63787225,63787294,69
"16640","ENSBTAG00000043207","16",55237829,55237908,79
"16641","ENSBTAG00000043209","6",88703322,88703654,332
"16642","ENSBTAG00000043214","5",56321025,56321174,149
"16643","ENSBTAG00000043216","21",45476187,45476293,106
"16644","ENSBTAG00000043217","9",96051890,96052026,136
"16645","ENSBTAG00000043221","1",151148524,151148650,126
"16646","ENSBTAG00000043222","26",21145467,21145614,147
"16647","ENSBTAG00000043226","11",26744001,26744130,129
"16648","ENSBTAG00000043233","8",84490580,84490706,126
"16649","ENSBTAG00000043234","14",31105086,31105172,86
"16650","ENSBTAG00000043236","5",5821032,5821128,96
"16651","ENSBTAG00000043237","X",89629938,89630064,126
"16652","ENSBTAG00000043240","18",54655831,54655940,109
"16653","ENSBTAG00000043243","12",15472536,15472667,131
"16654","ENSBTAG00000043249","5",31107014,31107149,135
"16655","ENSBTAG00000043250","23",25224255,25224585,330
"16656","ENSBTAG00000043255","23",35027165,35027453,288
"16657","ENSBTAG00000043258","29",1088840,1088970,130
"16658","ENSBTAG00000043260","18",56864536,56864626,90
"16659","ENSBTAG00000043261","2",90793056,90793144,88
"16660","ENSBTAG00000043264","13",73016560,73016639,79
"16661","ENSBTAG00000043268","16",55235873,55235953,80
"16662","ENSBTAG00000043271","1",87924393,87924522,129
"16663","ENSBTAG00000043272","13",74583682,74583787,105
"16664","ENSBTAG00000043282","20",66616744,66616876,132
"16665","ENSBTAG00000043295","10",1816633,1816769,136
"16666","ENSBTAG00000043296","2",86018859,86018960,101
"16667","ENSBTAG00000043297","2",119228661,119228740,79
"16668","ENSBTAG00000043301","24",49153133,49153197,64
"16669","ENSBTAG00000043302","29",41155768,41155835,67
"16670","ENSBTAG00000043305","15",43201171,43201355,184
"16671","ENSBTAG00000043306","13",52523457,52523528,71
"16672","ENSBTAG00000043315","2",124853002,124853127,125
"16673","ENSBTAG00000043317","11",6827112,6827197,85
"16674","ENSBTAG00000043319","16",72967480,72967597,117
"16675","ENSBTAG00000043320","X",30108528,30108635,107
"16676","ENSBTAG00000043324","28",7897233,7897367,134
"16677","ENSBTAG00000043325","15",35409537,35409626,89
"16678","ENSBTAG00000043329","17",45079141,45079271,130
"16679","ENSBTAG00000043333","6",45806441,45806544,103
"16680","ENSBTAG00000043341","11",104258594,104258658,64
"16681","ENSBTAG00000043342","21",65838010,65838084,74
"16682","ENSBTAG00000043344","8",60550350,60550481,131
"16683","ENSBTAG00000043347","X",36217425,36217556,131
"16684","ENSBTAG00000043348","8",99627597,99627699,102
"16685","ENSBTAG00000043349","3",99486499,99486570,71
"16686","ENSBTAG00000043350","13",77377020,77377111,91
"16687","ENSBTAG00000043354","21",65845523,65845595,72
"16688","ENSBTAG00000043359","19",39442137,39442272,135
"16689","ENSBTAG00000043364","X",134738624,134738728,104
"16690","ENSBTAG00000043369","5",44505113,44505215,102
"16691","ENSBTAG00000043370","16",18566337,18566443,106
"16692","ENSBTAG00000043377","10",13359971,13360068,97
"16693","ENSBTAG00000043378","16",55234666,55234742,76
"16694","ENSBTAG00000043380","2",124749845,124749951,106
"16695","ENSBTAG00000043382","26",13703834,13703911,77
"16696","ENSBTAG00000043383","11",104256297,104256371,74
"16697","ENSBTAG00000043391","11",21568358,21568467,109
"16698","ENSBTAG00000043394","29",1091085,1091207,122
"16699","ENSBTAG00000043395","8",23618345,23618452,107
"16700","ENSBTAG00000043398","4",76527187,76527322,135
"16701","ENSBTAG00000043399","1",2089684,2089808,124
"16702","ENSBTAG00000043402","X",8235601,8235732,131
"16703","ENSBTAG00000043404","23",16186145,16186251,106
"16704","ENSBTAG00000043406","8",102706348,102706479,131
"16705","ENSBTAG00000043414","19",55195660,55195732,72
"16706","ENSBTAG00000043415","26",15891144,15891246,102
"16707","ENSBTAG00000043422","19",12677241,12677342,101
"16708","ENSBTAG00000043425","16",32297259,32297386,127
"16709","ENSBTAG00000043426","15",27951361,27951498,137
"16710","ENSBTAG00000043432","16",55236501,55236561,60
"16711","ENSBTAG00000043433","18",65477589,65477693,104
"16712","ENSBTAG00000043444","25",30942979,30943068,89
"16713","ENSBTAG00000043446","3",15636617,15636747,130
"16714","ENSBTAG00000043447","3",69064218,69064300,82
"16715","ENSBTAG00000043453","18",55943254,55943324,70
"16716","ENSBTAG00000043460","7",46145257,46145362,105
"16717","ENSBTAG00000043461","4",112179860,112179961,101
"16718","ENSBTAG00000043462","15",33680867,33680954,87
"16719","ENSBTAG00000043467","17",36425393,36425507,114
"16720","ENSBTAG00000043468","9",63787520,63787589,69
"16721","ENSBTAG00000043471","5",86594351,86594679,328
"16722","ENSBTAG00000043472","18",39319204,39319289,85
"16723","ENSBTAG00000043477","18",44986495,44986600,105
"16724","ENSBTAG00000043478","8",100422703,100422835,132
"16725","ENSBTAG00000043480","15",33679549,33679632,83
"16726","ENSBTAG00000043481","10",33868221,33868354,133
"16727","ENSBTAG00000043482","22",45101566,45101869,303
"16728","ENSBTAG00000043486","16",51888944,51889047,103
"16729","ENSBTAG00000043490","21",65875622,65875693,71
"16730","ENSBTAG00000043496","27",5807960,5808065,105
"16731","ENSBTAG00000043508","19",27820782,27820917,135
"16732","ENSBTAG00000043509","29",41157390,41157461,71
"16733","ENSBTAG00000043512","7",5280053,5280186,133
"16734","ENSBTAG00000043519","4",31553706,31553778,72
"16735","ENSBTAG00000043521","5",112812536,112812670,134
"16736","ENSBTAG00000043523","X",11602006,11602320,314
"16737","ENSBTAG00000043525","17",68948365,68948465,100
"16738","ENSBTAG00000043528","18",26326690,26326828,138
"16739","ENSBTAG00000043530","6",6862299,6862429,130
"16740","ENSBTAG00000043531","10",13358779,13358848,69
"16741","ENSBTAG00000043541","4",76527710,76527844,134
"16742","ENSBTAG00000043542","9",13129769,13129871,102
"16743","ENSBTAG00000043544","MT",11907,11976,69
"16744","ENSBTAG00000043545","MT",7229,7299,70
"16745","ENSBTAG00000043546","MT",13913,14440,527
"16746","ENSBTAG00000043547","MT",5376,5444,68
"16747","ENSBTAG00000043548","MT",364,430,66
"16748","ENSBTAG00000043549","MT",4197,4265,68
"16749","ENSBTAG00000043550","MT",14514,15653,1139
"16750","ENSBTAG00000043551","MT",11977,12036,59
"16751","ENSBTAG00000043552","MT",10170,10238,68
"16752","ENSBTAG00000043553","7",62284773,62292964,8191
"16753","ENSBTAG00000043554","MT",9754,9822,68
"16754","ENSBTAG00000043555","MT",3024,3098,74
"16755","ENSBTAG00000043556","MT",7374,8057,683
"16756","ENSBTAG00000043557","MT",5551,5617,66
"16757","ENSBTAG00000043558","MT",3101,4056,955
"16758","ENSBTAG00000043559","MT",10239,10535,296
"16759","ENSBTAG00000043560","MT",8970,9750,780
"16760","ENSBTAG00000043561","MT",5687,7231,1544
"16761","ENSBTAG00000043562","MT",1386,1452,66
"16762","ENSBTAG00000043563","MT",12109,13929,1820
"16763","ENSBTAG00000043564","MT",8129,8329,200
"16764","ENSBTAG00000043565","MT",4123,4194,71
"16765","ENSBTAG00000043566","MT",12038,12108,70
"16766","ENSBTAG00000043567","MT",431,1385,954
"16767","ENSBTAG00000043568","MT",9823,10168,345
"16768","ENSBTAG00000043570","MT",1453,3023,1570
"16769","ENSBTAG00000043571","MT",4266,5307,1041
"16770","ENSBTAG00000043572","MT",15658,15726,68
"16771","ENSBTAG00000043573","MT",5446,5518,72
"16772","ENSBTAG00000043574","MT",7304,7372,68
"16773","ENSBTAG00000043575","MT",4057,4125,68
"16774","ENSBTAG00000043576","MT",8061,8127,66
"16775","ENSBTAG00000043577","MT",10529,11906,1377
"16776","ENSBTAG00000043578","21",66494536,66495438,902
"16777","ENSBTAG00000043579","MT",5308,5374,66
"16778","ENSBTAG00000043580","MT",5618,5685,67
"16779","ENSBTAG00000043581","17",72873707,72900850,27143
"16780","ENSBTAG00000043582","MT",15726,15791,65
"16781","ENSBTAG00000043583","MT",14441,14509,68
"16782","ENSBTAG00000043584","MT",8290,8970,680
"16783","ENSBTAG00000043589","10",26789942,26790089,147
"16784","ENSBTAG00000043590","3",16269734,16269870,136
"16785","ENSBTAG00000043599","21",2192640,2192719,79
"16786","ENSBTAG00000043602","4",43562420,43562734,314
"16787","ENSBTAG00000043615","8",39130362,39130464,102
"16788","ENSBTAG00000043634","X",37013220,37013335,115
"16789","ENSBTAG00000043638","4",101617946,101618310,364
"16790","ENSBTAG00000043639","5",38087770,38088094,324
"16791","ENSBTAG00000043641","26",39259345,39259474,129
"16792","ENSBTAG00000043643","3",106898231,106898370,139
"16793","ENSBTAG00000043649","19",28172175,28172315,140
"16794","ENSBTAG00000043654","7",22785667,22785768,101
"16795","ENSBTAG00000043655","23",39419214,39419330,116
"16796","ENSBTAG00000043657","6",30119684,30119970,286
"16797","ENSBTAG00000043658","18",65422830,65422949,119
"16798","ENSBTAG00000043664","19",19206838,19206961,123
"16799","ENSBTAG00000043670","21",65891272,65891346,74
"16800","ENSBTAG00000043671","4",38302740,38303062,322
"16801","ENSBTAG00000043693","21",22187670,22187767,97
"16802","ENSBTAG00000043694","21",65894209,65894282,73
"16803","ENSBTAG00000043695","X",18236206,18236291,85
"16804","ENSBTAG00000043696","X",3173600,3173727,127
"16805","ENSBTAG00000043700","11",78317735,78317841,106
"16806","ENSBTAG00000043708","13",69783985,69784088,103
"16807","ENSBTAG00000043710","28",13850255,13850386,131
"16808","ENSBTAG00000043711","7",75019478,75019596,118
"16809","ENSBTAG00000043713","2",34079005,34079107,102
"16810","ENSBTAG00000043716","10",88885131,88885213,82
"16811","ENSBTAG00000043717","25",20759499,20759628,129
"16812","ENSBTAG00000043721","23",39006663,39006800,137
"16813","ENSBTAG00000043732","10",85776496,85776681,185
"16814","ENSBTAG00000043738","15",43098601,43098868,267
"16815","ENSBTAG00000043742","1",158254824,158254971,147
"16816","ENSBTAG00000043746","9",58616428,58616750,322
"16817","ENSBTAG00000043747","7",62077274,62077461,187
"16818","ENSBTAG00000043751","1",25298576,25298720,144
"16819","ENSBTAG00000043753","4",116495605,116495700,95
"16820","ENSBTAG00000043760","3",82066562,82066696,134
"16821","ENSBTAG00000043764","28",9419147,9419260,113
"16822","ENSBTAG00000043768","7",63670301,63670542,241
"16823","ENSBTAG00000043774","10",102292208,102292334,126
"16824","ENSBTAG00000043776","7",49898601,49898672,71
"16825","ENSBTAG00000043778","7",12801572,12801643,71
"16826","ENSBTAG00000043784","29",28365238,28365552,314
"16827","ENSBTAG00000043786","19",23128526,23128633,107
"16828","ENSBTAG00000043787","21",55349041,55349123,82
"16829","ENSBTAG00000043792","5",36316090,36316221,131
"16830","ENSBTAG00000043793","3",98961219,98961328,109
"16831","ENSBTAG00000043798","19",21436618,21436775,157
"16832","ENSBTAG00000043800","17",6382898,6383004,106
"16833","ENSBTAG00000043805","4",15943455,15943556,101
"16834","ENSBTAG00000043806","17",29685529,29685709,180
"16835","ENSBTAG00000043814","15",57799281,57799394,113
"16836","ENSBTAG00000043816","10",50584841,50584967,126
"16837","ENSBTAG00000043818","3",21969070,21969354,284
"16838","ENSBTAG00000043822","9",69097518,69097663,145
"16839","ENSBTAG00000043823","16",1257586,1257686,100
"16840","ENSBTAG00000043826","13",53866324,53866398,74
"16841","ENSBTAG00000043830","4",91685454,91685745,291
"16842","ENSBTAG00000043836","5",97291288,97291390,102
"16843","ENSBTAG00000043841","17",34771860,34771997,137
"16844","ENSBTAG00000043843","9",41139596,41139701,105
"16845","ENSBTAG00000043845","9",66331761,66331868,107
"16846","ENSBTAG00000043846","9",41107433,41107562,129
"16847","ENSBTAG00000043848","7",62050494,62050611,117
"16848","ENSBTAG00000043853","19",29083352,29083450,98
"16849","ENSBTAG00000043857","17",65199910,65200208,298
"16850","ENSBTAG00000043859","21",65823511,65823581,70
"16851","ENSBTAG00000043862","2",27389710,27389820,110
"16852","ENSBTAG00000043864","2",122610678,122610759,81
"16853","ENSBTAG00000043867","10",42759261,42759388,127
"16854","ENSBTAG00000043870","X",79329870,79329992,122
"16855","ENSBTAG00000043875","20",63003302,63003431,129
"16856","ENSBTAG00000043880","9",70426259,70426372,113
"16857","ENSBTAG00000043888","X",63654194,63654322,128
"16858","ENSBTAG00000043893","24",22021164,22021278,114
"16859","ENSBTAG00000043896","9",72932402,72932514,112
"16860","ENSBTAG00000043900","26",30834846,30835154,308
"16861","ENSBTAG00000043904","4",43585507,43585651,144
"16862","ENSBTAG00000043914","22",48171770,48171845,75
"16863","ENSBTAG00000043915","19",20930327,20930406,79
"16864","ENSBTAG00000043918","23",47495242,47495379,137
"16865","ENSBTAG00000043928","17",61940720,61940867,147
"16866","ENSBTAG00000043932","22",56108343,56108469,126
"16867","ENSBTAG00000043933","21",65884675,65884747,72
"16868","ENSBTAG00000043935","17",51454130,51454444,314
"16869","ENSBTAG00000043939","2",100225391,100225718,327
"16870","ENSBTAG00000043940","14",80832785,80832927,142
"16871","ENSBTAG00000043944","21",19418953,19419240,287
"16872","ENSBTAG00000043948","20",29111349,29562326,450977
"16873","ENSBTAG00000043949","5",9138248,9257880,119632
"16874","ENSBTAG00000043950","9",19102638,19160682,58044
"16875","ENSBTAG00000043951","24",42749323,42770785,21462
"16876","ENSBTAG00000043953","18",56573070,56580058,6988
"16877","ENSBTAG00000043954","9",79578213,79586431,8218
"16878","ENSBTAG00000043955","4",5806257,5806697,440
"16879","ENSBTAG00000043956","2",15639801,15731672,91871
"16880","ENSBTAG00000043957","1",146562507,146607459,44952
"16881","ENSBTAG00000043958","6",60814779,60834434,19655
"16882","ENSBTAG00000043959","17",42227069,42478276,251207
"16883","ENSBTAG00000043960","6",89092825,89244943,152118
"16884","ENSBTAG00000043961","8",31058380,31211135,152755
"16885","ENSBTAG00000043962","5",40812848,41331737,518889
"16886","ENSBTAG00000043963","17",4673147,4705464,32317
"16887","ENSBTAG00000043964","13",20313813,20334424,20611
"16888","ENSBTAG00000043969","25",28636197,29090972,454775
"16889","ENSBTAG00000043970","14",69055330,69078021,22691
"16890","ENSBTAG00000043971","7",7910635,7950476,39841
"16891","ENSBTAG00000043972","8",24532716,24812024,279308
"16892","ENSBTAG00000043973","9",44948437,45069126,120689
"16893","ENSBTAG00000043974","25",26709871,26712376,2505
"16894","ENSBTAG00000043975","9",89661417,89678324,16907
"16895","ENSBTAG00000043976","17",58188410,58250340,61930
"16896","ENSBTAG00000043978","14",26854867,27012590,157723
"16897","ENSBTAG00000043979","19",36486101,36487196,1095
"16898","ENSBTAG00000043981","15",42392800,42890918,498118
"16899","ENSBTAG00000043983","8",17244041,17255247,11206
"16900","ENSBTAG00000043985","12",46109476,46548484,439008
"16901","ENSBTAG00000043987","8",37733103,38109966,376863
"16902","ENSBTAG00000043989","2",125249517,125390286,140769
"16903","ENSBTAG00000043990","23",270838,961226,690388
"16904","ENSBTAG00000043991","26",18272204,18444938,172734
"16905","ENSBTAG00000043992","20",15106459,15389890,283431
"16906","ENSBTAG00000043993","1",2749168,2768577,19409
"16907","ENSBTAG00000043994","7",38925913,38940622,14709
"16908","ENSBTAG00000043996","14",45624935,46065709,440774
"16909","ENSBTAG00000043999","11",4533386,4616248,82862
"16910","ENSBTAG00000044000","5",56711750,56729540,17790
"16911","ENSBTAG00000044001","1",78452386,79136219,683833
"16912","ENSBTAG00000044003","8",65274027,65320548,46521
"16913","ENSBTAG00000044004","8",101093499,101177309,83810
"16914","ENSBTAG00000044006","18",11648869,11684545,35676
"16915","ENSBTAG00000044007","12",48526712,48803497,276785
"16916","ENSBTAG00000044009","2",14473125,14594115,120990
"16917","ENSBTAG00000044010","20",28687335,28728820,41485
"16918","ENSBTAG00000044012","4",28422955,28496683,73728
"16919","ENSBTAG00000044015","13",64873751,64884908,11157
"16920","ENSBTAG00000044017","5",48332243,48512740,180497
"16921","ENSBTAG00000044018","7",16643893,16647693,3800
"16922","ENSBTAG00000044019","19",42247950,42256261,8311
"16923","ENSBTAG00000044021","11",70782620,70827276,44656
"16924","ENSBTAG00000044022","17",65153148,65283727,130579
"16925","ENSBTAG00000044023","4",9939646,10188536,248890
"16926","ENSBTAG00000044025","X",54505735,54555948,50213
"16927","ENSBTAG00000044027","12",77891049,78126514,235465
"16928","ENSBTAG00000044029","10",28535056,28727307,192251
"16929","ENSBTAG00000044032","29",45089476,45179866,90390
"16930","ENSBTAG00000044033","7",83846108,84324020,477912
"16931","ENSBTAG00000044035","7",38070323,38073091,2768
"16932","ENSBTAG00000044038","19",55649348,55661354,12006
"16933","ENSBTAG00000044040","25",36994695,37003146,8451
"16934","ENSBTAG00000044043","27",20208184,20218557,10373
"16935","ENSBTAG00000044044","6",70874084,70978580,104496
"16936","ENSBTAG00000044046","7",67575790,68016498,440708
"16937","ENSBTAG00000044047","13",22728357,22731125,2768
"16938","ENSBTAG00000044048","5",30713730,30726323,12593
"16939","ENSBTAG00000044049","10",43738868,43756260,17392
"16940","ENSBTAG00000044050","14",22640221,22953771,313550
"16941","ENSBTAG00000044053","9",13086269,13161408,75139
"16942","ENSBTAG00000044055","2",59511857,60421786,909929
"16943","ENSBTAG00000044056","19",39431968,39435985,4017
"16944","ENSBTAG00000044058","17",29733275,29786956,53681
"16945","ENSBTAG00000044061","9",50419564,50488286,68722
"16946","ENSBTAG00000044062","22",3856819,4651964,795145
"16947","ENSBTAG00000044063","24",25459771,25526155,66384
"16948","ENSBTAG00000044064","11",89901723,89994194,92471
"16949","ENSBTAG00000044065","19",49221296,49358241,136945
"16950","ENSBTAG00000044066","16",32580902,32649197,68295
"16951","ENSBTAG00000044067","7",57296638,57317430,20792
"16952","ENSBTAG00000044068","4",5990886,6118221,127335
"16953","ENSBTAG00000044070","8",102004576,102108791,104215
"16954","ENSBTAG00000044071","10",5450044,5474341,24297
"16955","ENSBTAG00000044073","29",44370002,44372646,2644
"16956","ENSBTAG00000044074","13",22747480,22954556,207076
"16957","ENSBTAG00000044075","1",135532008,135573130,41122
"16958","ENSBTAG00000044077","7",90036901,90080728,43827
"16959","ENSBTAG00000044078","17",57955861,58020267,64406
"16960","ENSBTAG00000044079","22",48286485,48289693,3208
"16961","ENSBTAG00000044080","14",31534789,31829014,294225
"16962","ENSBTAG00000044082","6",1970069,2104063,133994
"16963","ENSBTAG00000044083","25",33239249,33265065,25816
"16964","ENSBTAG00000044087","24",19844993,20001606,156613
"16965","ENSBTAG00000044091","13",54128175,54135496,7321
"16966","ENSBTAG00000044092","25",17314251,17475778,161527
"16967","ENSBTAG00000044097","2",95370241,95469238,98997
"16968","ENSBTAG00000044099","19",33472383,33481997,9614
"16969","ENSBTAG00000044100","28",9193299,9244485,51186
"16970","ENSBTAG00000044105","12",21900230,21991693,91463
"16971","ENSBTAG00000044106","14",19129765,19406228,276463
"16972","ENSBTAG00000044107","3",93695638,93726907,31269
"16973","ENSBTAG00000044109","17",43437239,43491735,54496
"16974","ENSBTAG00000044111","1",41409771,41994030,584259
"16975","ENSBTAG00000044112","13",24115799,24140844,25045
"16976","ENSBTAG00000044113","18",56353715,56372775,19060
"16977","ENSBTAG00000044115","X",55443790,55446987,3197
"16978","ENSBTAG00000044117","16",55043280,55090916,47636
"16979","ENSBTAG00000044118","5",47819505,47966760,147255
"16980","ENSBTAG00000044119","17",57231745,57664911,433166
"16981","ENSBTAG00000044121","21",42056643,42376482,319839
"16982","ENSBTAG00000044123","8",5898320,5901264,2944
"16983","ENSBTAG00000044125","3",48293380,48334802,41422
"16984","ENSBTAG00000044126","14",81871605,82123649,252044
"16985","ENSBTAG00000044129","11",98555376,98568425,13049
"16986","ENSBTAG00000044132","18",55294165,55299875,5710
"16987","ENSBTAG00000044135","8",59345169,59351847,6678
"16988","ENSBTAG00000044138","19",55046996,55052712,5716
"16989","ENSBTAG00000044139","27",17563460,17565461,2001
"16990","ENSBTAG00000044144","15",16344121,16845470,501349
"16991","ENSBTAG00000044146","4",76889504,76912254,22750
"16992","ENSBTAG00000044148","1",76047771,76055460,7689
"16993","ENSBTAG00000044150","3",2984979,3059465,74486
"16994","ENSBTAG00000044153","26",24168682,24185907,17225
"16995","ENSBTAG00000044155","8",102605161,102628860,23699
"16996","ENSBTAG00000044157","18",62118907,62122389,3482
"16997","ENSBTAG00000044158","15",66504294,66702598,198304
"16998","ENSBTAG00000044159","17",28685257,28706065,20808
"16999","ENSBTAG00000044160","20",9917221,9992861,75640
"17000","ENSBTAG00000044161","6",71033010,71061233,28223
"17001","ENSBTAG00000044166","6",60646949,60650155,3206
"17002","ENSBTAG00000044167","22",16209293,16269704,60411
"17003","ENSBTAG00000044169","7",56942188,57021301,79113
"17004","ENSBTAG00000044172","1",70125517,70172948,47431
"17005","ENSBTAG00000044173","11",61185353,61540443,355090
"17006","ENSBTAG00000044175","20",13999288,14036032,36744
"17007","ENSBTAG00000044177","15",21560088,21561893,1805
"17008","ENSBTAG00000044178","3",105824376,105867157,42781
"17009","ENSBTAG00000044179","2",27359574,27712447,352873
"17010","ENSBTAG00000044181","9",83287300,83713833,426533
"17011","ENSBTAG00000044183","7",59718860,59723703,4843
"17012","ENSBTAG00000044184","12",86186156,86222088,35932
"17013","ENSBTAG00000044185","15",35833980,36542301,708321
"17014","ENSBTAG00000044190","14",70467827,70513787,45960
"17015","ENSBTAG00000044191","18",16485773,16546587,60814
"17016","ENSBTAG00000044192","18",6508023,6526480,18457
"17017","ENSBTAG00000044194","27",20011366,20073509,62143
"17018","ENSBTAG00000044195","19",57874966,58018225,143259
"17019","ENSBTAG00000044197","28",9081509,9147484,65975
"17020","ENSBTAG00000044198","17",72340278,72342373,2095
"17021","ENSBTAG00000044202","X",121644936,121953599,308663
"17022","ENSBTAG00000044204","19",48132030,48135645,3615
"17023","ENSBTAG00000044207","10",25693007,25710158,17151
"17024","ENSBTAG00000044208","27",25679478,25693390,13912
"17025","ENSBTAG00000044210","13",58813693,58828073,14380
"17026","ENSBTAG00000044214","27",26565754,26565831,77
"17027","ENSBTAG00000044215","18",25021803,25021863,60
"17028","ENSBTAG00000044222","6",110754790,110754862,72
"17029","ENSBTAG00000044224","8",1310564,1310642,78
"17030","ENSBTAG00000044236","12",29635268,29635346,78
"17031","ENSBTAG00000044237","18",8606242,8606345,103
"17032","ENSBTAG00000044258","10",12743326,12743405,79
"17033","ENSBTAG00000044260","8",25172290,25172423,133
"17034","ENSBTAG00000044261","23",8375123,8375248,125
"17035","ENSBTAG00000044262","29",43424900,43424972,72
"17036","ENSBTAG00000044265","19",31369306,31369377,71
"17037","ENSBTAG00000044269","19",49282797,49282907,110
"17038","ENSBTAG00000044270","1",147203769,147203840,71
"17039","ENSBTAG00000044272","29",28717358,28717439,81
"17040","ENSBTAG00000044273","10",81664705,81664809,104
"17041","ENSBTAG00000044275","12",15471361,15471489,128
"17042","ENSBTAG00000044280","18",1582910,1582980,70
"17043","ENSBTAG00000044284","2",120686213,120686291,78
"17044","ENSBTAG00000044289","10",10713653,10713780,127
"17045","ENSBTAG00000044291","1",92802135,92802395,260
"17046","ENSBTAG00000044294","4",49026831,49026906,75
"17047","ENSBTAG00000044304","12",87039058,87039136,78
"17048","ENSBTAG00000044308","16",57228956,57229096,140
"17049","ENSBTAG00000044311","1",80472432,80472500,68
"17050","ENSBTAG00000044315","11",97205617,97205986,369
"17051","ENSBTAG00000044316","22",11368925,11369003,78
"17052","ENSBTAG00000044318","1",67828171,67828285,114
"17053","ENSBTAG00000044332","22",56001533,56001636,103
"17054","ENSBTAG00000044335","7",60953660,60953764,104
"17055","ENSBTAG00000044337","1",102015881,102016296,415
"17056","ENSBTAG00000044340","9",15308733,15308837,104
"17057","ENSBTAG00000044341","8",42534231,42534317,86
"17058","ENSBTAG00000044343","1",61034260,61034483,223
"17059","ENSBTAG00000044345","21",65795004,65795080,76
"17060","ENSBTAG00000044352","8",30205033,30205122,89
"17061","ENSBTAG00000044364","7",31950120,31950245,125
"17062","ENSBTAG00000044374","6",113521279,113521357,78
"17063","ENSBTAG00000044375","2",133428969,133429056,87
"17064","ENSBTAG00000044376","1",64545597,64545719,122
"17065","ENSBTAG00000044378","3",48939774,48939879,105
"17066","ENSBTAG00000044379","10",15141508,15141621,113
"17067","ENSBTAG00000044381","10",102768536,102768637,101
"17068","ENSBTAG00000044384","X",88475785,88475887,102
"17069","ENSBTAG00000044391","X",138862220,138862348,128
"17070","ENSBTAG00000044395","19",22253976,22254051,75
"17071","ENSBTAG00000044400","13",74395477,74395559,82
"17072","ENSBTAG00000044404","14",20950312,20950449,137
"17073","ENSBTAG00000044405","4",15852947,15853005,58
"17074","ENSBTAG00000044406","14",691788,691910,122
"17075","ENSBTAG00000044409","3",78496571,78496690,119
"17076","ENSBTAG00000044417","26",22520668,22520776,108
"17077","ENSBTAG00000044419","2",118296117,118296215,98
"17078","ENSBTAG00000044420","10",79518283,79518392,109
"17079","ENSBTAG00000044422","7",49737453,49737522,69
"17080","ENSBTAG00000044425","10",13239219,13239352,133
"17081","ENSBTAG00000044427","10",26778581,26778913,332
"17082","ENSBTAG00000044430","3",34458623,34458755,132
"17083","ENSBTAG00000044441","2",125541373,125541538,165
"17084","ENSBTAG00000044443","19",54798502,54798689,187
"17085","ENSBTAG00000044450","19",26131673,26131748,75
"17086","ENSBTAG00000044451","5",112376908,112376977,69
"17087","ENSBTAG00000044453","4",112408094,112408402,308
"17088","ENSBTAG00000044454","18",39215918,39215975,57
"17089","ENSBTAG00000044458","14",45940448,45940525,77
"17090","ENSBTAG00000044462","2",27581629,27581703,74
"17091","ENSBTAG00000044466","25",33563364,33563492,128
"17092","ENSBTAG00000044469","11",37330097,37330166,69
"17093","ENSBTAG00000044472","3",115120639,115120772,133
"17094","ENSBTAG00000044473","8",5823335,5823407,72
"17095","ENSBTAG00000044478","5",113103171,113103246,75
"17096","ENSBTAG00000044482","23",19298535,19298641,106
"17097","ENSBTAG00000044485","8",73372401,73372507,106
"17098","ENSBTAG00000044489","8",100510617,100510697,80
"17099","ENSBTAG00000044490","5",57611456,57611609,153
"17100","ENSBTAG00000044499","4",97217425,97217497,72
"17101","ENSBTAG00000044500","20",63650871,63650940,69
"17102","ENSBTAG00000044501","22",39677352,39677421,69
"17103","ENSBTAG00000044503","X",101703765,101703860,95
"17104","ENSBTAG00000044508","18",65553582,65553683,101
"17105","ENSBTAG00000044509","15",51545546,51545617,71
"17106","ENSBTAG00000044512","13",75810450,75810596,146
"17107","ENSBTAG00000044514","12",11248277,11248399,122
"17108","ENSBTAG00000044521","16",41210582,41210725,143
"17109","ENSBTAG00000044522","7",17148728,17148785,57
"17110","ENSBTAG00000044526","3",9764117,9764189,72
"17111","ENSBTAG00000044528","25",16509170,16509279,109
"17112","ENSBTAG00000044536","18",65713783,65713930,147
"17113","ENSBTAG00000044539","6",71845309,71845369,60
"17114","ENSBTAG00000044540","3",42636536,42636742,206
"17115","ENSBTAG00000044542","14",29580067,29580322,255
"17116","ENSBTAG00000044544","4",13669967,13670098,131
"17117","ENSBTAG00000044547","21",61250620,61250717,97
"17118","ENSBTAG00000044548","4",47094216,47094286,70
"17119","ENSBTAG00000044552","25",33715107,33715255,148
"17120","ENSBTAG00000044553","11",73169115,73169238,123
"17121","ENSBTAG00000044561","23",35873412,35873491,79
"17122","ENSBTAG00000044567","20",23518008,23518094,86
"17123","ENSBTAG00000044568","19",22663799,22663899,100
"17124","ENSBTAG00000044573","11",32280416,32280512,96
"17125","ENSBTAG00000044587","21",22667439,22667531,92
"17126","ENSBTAG00000044591","13",78012097,78012227,130
"17127","ENSBTAG00000044593","15",76976442,76976512,70
"17128","ENSBTAG00000044595","X",118591845,118591974,129
"17129","ENSBTAG00000044600","3",34455829,34456164,335
"17130","ENSBTAG00000044604","10",36746722,36746912,190
"17131","ENSBTAG00000044606","25",1742942,1743018,76
"17132","ENSBTAG00000044607","22",51700922,51701030,108
"17133","ENSBTAG00000044614","6",116645201,116645324,123
"17134","ENSBTAG00000044615","9",82870871,82871003,132
"17135","ENSBTAG00000044620","26",49394362,49394435,73
"17136","ENSBTAG00000044622","11",10873974,10874040,66
"17137","ENSBTAG00000044624","5",103520372,103520433,61
"17138","ENSBTAG00000044625","27",40042134,40042208,74
"17139","ENSBTAG00000044628","19",62858782,62858858,76
"17140","ENSBTAG00000044630","2",106011329,106011401,72
"17141","ENSBTAG00000044631","3",113004991,113005252,261
"17142","ENSBTAG00000044633","8",11522207,11522273,66
"17143","ENSBTAG00000044643","19",50907254,50907332,78
"17144","ENSBTAG00000044647","23",28399166,28399243,77
"17145","ENSBTAG00000044649","6",115603194,115603260,66
"17146","ENSBTAG00000044658","2",80748160,80748246,86
"17147","ENSBTAG00000044659","21",60400686,60400959,273
"17148","ENSBTAG00000044661","15",39802379,39802439,60
"17149","ENSBTAG00000044673","4",15184577,15184681,104
"17150","ENSBTAG00000044676","5",110533065,110533171,106
"17151","ENSBTAG00000044677","15",60093944,60094215,271
"17152","ENSBTAG00000044680","5",41732851,41732915,64
"17153","ENSBTAG00000044681","19",53633077,53633180,103
"17154","ENSBTAG00000044686","3",23036894,23037134,240
"17155","ENSBTAG00000044691","10",15688441,15688716,275
"17156","ENSBTAG00000044698","13",23795910,23796015,105
"17157","ENSBTAG00000044699","16",43326637,43326742,105
"17158","ENSBTAG00000044702","26",42109615,42109683,68
"17159","ENSBTAG00000044708","23",13087820,13087888,68
"17160","ENSBTAG00000044712","25",2992795,2992870,75
"17161","ENSBTAG00000044719","3",106035267,106035413,146
"17162","ENSBTAG00000044721","17",52194968,52195079,111
"17163","ENSBTAG00000044723","11",55206927,55207027,100
"17164","ENSBTAG00000044726","26",16026473,16026710,237
"17165","ENSBTAG00000044738","4",61601450,61601554,104
"17166","ENSBTAG00000044740","16",24304598,24304713,115
"17167","ENSBTAG00000044741","15",41876998,41877149,151
"17168","ENSBTAG00000044744","16",34018327,34018474,147
"17169","ENSBTAG00000044746","X",13559632,13559702,70
"17170","ENSBTAG00000044748","10",58016437,58016613,176
"17171","ENSBTAG00000044752","3",43278015,43278129,114
"17172","ENSBTAG00000044754","3",82341405,82341643,238
"17173","ENSBTAG00000044756","3",4460507,4460603,96
"17174","ENSBTAG00000044757","21",61250790,61250894,104
"17175","ENSBTAG00000044758","21",5504531,5504597,66
"17176","ENSBTAG00000044766","14",62724714,62724817,103
"17177","ENSBTAG00000044769","21",2110141,2110222,81
"17178","ENSBTAG00000044774","15",63700296,63700388,92
"17179","ENSBTAG00000044775","25",32930343,32930420,77
"17180","ENSBTAG00000044776","4",48615763,48615892,129
"17181","ENSBTAG00000044778","5",109365612,109365710,98
"17182","ENSBTAG00000044779","9",67700958,67701053,95
"17183","ENSBTAG00000044780","4",26744491,26744611,120
"17184","ENSBTAG00000044782","5",65190290,65190399,109
"17185","ENSBTAG00000044786","3",66685280,66685378,98
"17186","ENSBTAG00000044788","1",80470484,80470660,176
"17187","ENSBTAG00000044791","26",39990558,39990653,95
"17188","ENSBTAG00000044794","27",19576383,19576509,126
"17189","ENSBTAG00000044796","11",99006913,99007007,94
"17190","ENSBTAG00000044802","7",66163440,66163578,138
"17191","ENSBTAG00000044805","3",18708733,18709017,284
"17192","ENSBTAG00000044811","11",95816808,95816910,102
"17193","ENSBTAG00000044812","5",110749417,110749472,55
"17194","ENSBTAG00000044817","3",102340687,102340753,66
"17195","ENSBTAG00000044830","25",41736134,41736211,77
"17196","ENSBTAG00000044837","19",27589400,27589539,139
"17197","ENSBTAG00000044842","5",72195506,72195637,131
"17198","ENSBTAG00000044844","18",44650079,44650174,95
"17199","ENSBTAG00000044849","15",67052906,67052977,71
"17200","ENSBTAG00000044853","5",103893410,103893731,321
"17201","ENSBTAG00000044855","17",52952487,52952620,133
"17202","ENSBTAG00000044856","19",27309365,27309505,140
"17203","ENSBTAG00000044859","29",44875074,44875134,60
"17204","ENSBTAG00000044861","3",112988386,112988659,273
"17205","ENSBTAG00000044862","19",26664518,26664590,72
"17206","ENSBTAG00000044864","7",49639624,49639750,126
"17207","ENSBTAG00000044868","4",92988123,92988191,68
"17208","ENSBTAG00000044869","7",16711356,16711431,75
"17209","ENSBTAG00000044872","3",26211532,26211817,285
"17210","ENSBTAG00000044873","22",50755752,50755854,102
"17211","ENSBTAG00000044874","5",12539886,12539986,100
"17212","ENSBTAG00000044875","25",33926398,33926499,101
"17213","ENSBTAG00000044879","5",57013765,57013835,70
"17214","ENSBTAG00000044880","25",26434689,26434763,74
"17215","ENSBTAG00000044881","9",94334587,94334824,237
"17216","ENSBTAG00000044884","19",44575115,44575188,73
"17217","ENSBTAG00000044887","26",20886795,20886877,82
"17218","ENSBTAG00000044891","X",18469867,18470006,139
"17219","ENSBTAG00000044894","21",42624484,42624577,93
"17220","ENSBTAG00000044897","5",109521558,109521624,66
"17221","ENSBTAG00000044898","7",50582743,50582883,140
"17222","ENSBTAG00000044899","7",53640794,53640861,67
"17223","ENSBTAG00000044900","21",22434714,22434787,73
"17224","ENSBTAG00000044904","2",133090271,133090369,98
"17225","ENSBTAG00000044905","29",24963163,24963237,74
"17226","ENSBTAG00000044906","8",84125333,84125408,75
"17227","ENSBTAG00000044908","2",117250440,117250726,286
"17228","ENSBTAG00000044918","19",55711417,55711519,102
"17229","ENSBTAG00000044924","7",14666379,14666453,74
"17230","ENSBTAG00000044928","22",56833146,56833223,77
"17231","ENSBTAG00000044931","4",7727392,7727495,103
"17232","ENSBTAG00000044934","1",42916950,42917086,136
"17233","ENSBTAG00000044938","15",25200437,25200549,112
"17234","ENSBTAG00000044942","7",14691369,14691440,71
"17235","ENSBTAG00000044943","5",43201330,43201442,112
"17236","ENSBTAG00000044944","4",50635614,50635721,107
"17237","ENSBTAG00000044951","9",25978526,25978597,71
"17238","ENSBTAG00000044952","8",10916162,10916255,93
"17239","ENSBTAG00000044955","19",54038763,54038841,78
"17240","ENSBTAG00000044956","19",20871847,20871918,71
"17241","ENSBTAG00000044959","25",41724882,41724928,46
"17242","ENSBTAG00000044963","10",76446758,76446861,103
"17243","ENSBTAG00000044968","1",48583190,48583251,61
"17244","ENSBTAG00000044972","22",48172220,48172301,81
"17245","ENSBTAG00000044975","2",99976867,99976958,91
"17246","ENSBTAG00000044977","21",65889214,65889285,71
"17247","ENSBTAG00000044981","9",27675568,27675644,76
"17248","ENSBTAG00000044984","9",81479120,81479247,127
"17249","ENSBTAG00000044987","11",1626910,1627016,106
"17250","ENSBTAG00000044998","29",29184838,29184895,57
"17251","ENSBTAG00000045010","2",5466022,5466097,75
"17252","ENSBTAG00000045018","16",39466011,39466203,192
"17253","ENSBTAG00000045019","28",19650204,19650488,284
"17254","ENSBTAG00000045022","19",39440703,39440835,132
"17255","ENSBTAG00000045026","17",52752903,52753033,130
"17256","ENSBTAG00000045027","22",56057993,56058069,76
"17257","ENSBTAG00000045029","10",102801685,102801739,54
"17258","ENSBTAG00000045033","X",37176088,37176149,61
"17259","ENSBTAG00000045039","24",49478018,49478160,142
"17260","ENSBTAG00000045040","29",50643782,50643857,75
"17261","ENSBTAG00000045046","28",36280283,36280418,135
"17262","ENSBTAG00000045047","9",89596179,89596486,307
"17263","ENSBTAG00000045060","7",17141803,17141888,85
"17264","ENSBTAG00000045062","2",90803341,90803426,85
"17265","ENSBTAG00000045064","8",40620793,40620866,73
"17266","ENSBTAG00000045067","19",40341515,40341618,103
"17267","ENSBTAG00000045070","13",11983252,11983380,128
"17268","ENSBTAG00000045071","11",95982677,95982786,109
"17269","ENSBTAG00000045077","24",32486829,32486933,104
"17270","ENSBTAG00000045080","29",1089120,1089190,70
"17271","ENSBTAG00000045086","7",39757891,39758159,268
"17272","ENSBTAG00000045094","17",71652925,71653000,75
"17273","ENSBTAG00000045097","14",23279020,23279086,66
"17274","ENSBTAG00000045099","12",36402572,36402677,105
"17275","ENSBTAG00000045101","1",66763704,66763956,252
"17276","ENSBTAG00000045102","5",103495843,103496087,244
"17277","ENSBTAG00000045109","4",92808114,92808181,67
"17278","ENSBTAG00000045114","29",29319098,29319214,116
"17279","ENSBTAG00000045116","24",54653862,54654034,172
"17280","ENSBTAG00000045117","1",72959121,72959194,73
"17281","ENSBTAG00000045119","2",43664369,43664451,82
"17282","ENSBTAG00000045128","1",15147591,15147925,334
"17283","ENSBTAG00000045139","2",34974785,34974901,116
"17284","ENSBTAG00000045141","20",61968355,61968458,103
"17285","ENSBTAG00000045142","7",56191657,56191709,52
"17286","ENSBTAG00000045149","19",18463796,18463858,62
"17287","ENSBTAG00000045154","5",19313391,19313493,102
"17288","ENSBTAG00000045156","12",16334656,16334800,144
"17289","ENSBTAG00000045162","1",46209142,46209247,105
"17290","ENSBTAG00000045163","8",39700730,39700859,129
"17291","ENSBTAG00000045164","18",57522068,57522167,99
"17292","ENSBTAG00000045168","3",81370539,81370674,135
"17293","ENSBTAG00000045172","2",135236143,135236206,63
"17294","ENSBTAG00000045174","19",14988931,14989001,70
"17295","ENSBTAG00000045180","25",36566390,36566485,95
"17296","ENSBTAG00000045184","21",54837325,54837410,85
"17297","ENSBTAG00000045185","7",22962810,22963146,336
"17298","ENSBTAG00000045186","24",56851547,56851651,104
"17299","ENSBTAG00000045197","17",68603627,68603723,96
"17300","ENSBTAG00000045203","8",83915098,83915230,132
"17301","ENSBTAG00000045206","7",4552553,4552652,99
"17302","ENSBTAG00000045218","5",56324073,56324140,67
"17303","ENSBTAG00000045223","4",65945870,65945945,75
"17304","ENSBTAG00000045226","11",15481907,15482009,102
"17305","ENSBTAG00000045233","8",45210527,45210619,92
"17306","ENSBTAG00000045234","10",102978070,102978172,102
"17307","ENSBTAG00000045235","24",49478228,49478310,82
"17308","ENSBTAG00000045238","7",80356568,80356636,68
"17309","ENSBTAG00000045243","7",82924661,82924798,137
"17310","ENSBTAG00000045249","11",101391713,101391806,93
"17311","ENSBTAG00000045250","12",86644694,86644769,75
"17312","ENSBTAG00000045261","19",33653093,33653189,96
"17313","ENSBTAG00000045262","12",75349712,75349812,100
"17314","ENSBTAG00000045270","7",20047255,20047326,71
"17315","ENSBTAG00000045275","1",106970727,106971049,322
"17316","ENSBTAG00000045281","27",33462772,33462845,73
"17317","ENSBTAG00000045285","28",7836588,7836655,67
"17318","ENSBTAG00000045290","6",97814598,97814674,76
"17319","ENSBTAG00000045293","19",27308447,27308591,144
"17320","ENSBTAG00000045299","15",39058438,39058509,71
"17321","ENSBTAG00000045306","7",49897187,49897251,64
"17322","ENSBTAG00000045308","21",2099847,2099940,93
"17323","ENSBTAG00000045309","5",116408665,116408737,72
"17324","ENSBTAG00000045310","13",43012307,43012435,128
"17325","ENSBTAG00000045316","2",90804129,90804212,83
"17326","ENSBTAG00000045326","21",65819429,65819500,71
"17327","ENSBTAG00000045327","25",1522006,1522132,126
"17328","ENSBTAG00000045330","2",130300980,130301055,75
"17329","ENSBTAG00000045332","6",117380992,117381063,71
"17330","ENSBTAG00000045337","23",7481909,7481976,67
"17331","ENSBTAG00000045341","3",46690600,46690702,102
"17332","ENSBTAG00000045344","X",87102567,87102627,60
"17333","ENSBTAG00000045347","2",122081278,122081399,121
"17334","ENSBTAG00000045350","11",82824622,82824724,102
"17335","ENSBTAG00000045354","1",71525049,71525175,126
"17336","ENSBTAG00000045369","15",76769275,76769349,74
"17337","ENSBTAG00000045370","18",44669110,44669255,145
"17338","ENSBTAG00000045372","17",70464888,70464991,103
"17339","ENSBTAG00000045374","29",20220543,20220809,266
"17340","ENSBTAG00000045375","2",24156202,24156277,75
"17341","ENSBTAG00000045376","21",2094148,2094236,88
"17342","ENSBTAG00000045379","24",25088899,25089045,146
"17343","ENSBTAG00000045383","21",34028868,34029009,141
"17344","ENSBTAG00000045402","3",95835156,95835284,128
"17345","ENSBTAG00000045404","26",13407191,13407333,142
"17346","ENSBTAG00000045408","12",80423119,80423224,105
"17347","ENSBTAG00000045411","1",97264493,97264590,97
"17348","ENSBTAG00000045413","7",102534807,102535118,311
"17349","ENSBTAG00000045414","9",77052746,77052832,86
"17350","ENSBTAG00000045417","16",21841761,21841860,99
"17351","ENSBTAG00000045418","7",61885747,61885828,81
"17352","ENSBTAG00000045419","6",26364841,26365161,320
"17353","ENSBTAG00000045421","5",75672810,75672872,62
"17354","ENSBTAG00000045422","21",65893201,65893346,145
"17355","ENSBTAG00000045425","X",18473659,18473757,98
"17356","ENSBTAG00000045426","21",2114459,2114539,80
"17357","ENSBTAG00000045427","26",31314870,31315149,279
"17358","ENSBTAG00000045434","11",78613170,78613257,87
"17359","ENSBTAG00000045435","3",94781378,94781480,102
"17360","ENSBTAG00000045436","1",65444286,65444408,122
"17361","ENSBTAG00000045443","12",7921780,7921886,106
"17362","ENSBTAG00000045445","29",35524940,35525054,114
"17363","ENSBTAG00000045449","19",53603270,53603334,64
"17364","ENSBTAG00000045451","11",3901395,3901490,95
"17365","ENSBTAG00000045455","1",70174706,70174816,110
"17366","ENSBTAG00000045458","7",27420509,27420575,66
"17367","ENSBTAG00000045460","5",103839995,103840132,137
"17368","ENSBTAG00000045463","22",54901636,54901766,130
"17369","ENSBTAG00000045464","X",95899661,95899764,103
"17370","ENSBTAG00000045466","8",40311803,40311872,69
"17371","ENSBTAG00000045469","5",111845858,111845935,77
"17372","ENSBTAG00000045474","11",37367356,37367428,72
"17373","ENSBTAG00000045478","14",381366,381434,68
"17374","ENSBTAG00000045479","1",7430160,7430266,106
"17375","ENSBTAG00000045480","7",5962626,5962729,103
"17376","ENSBTAG00000045482","28",41168772,41168861,89
"17377","ENSBTAG00000045484","19",20185532,20185628,96
"17378","ENSBTAG00000045486","8",98991264,98991381,117
"17379","ENSBTAG00000045491","27",38169291,38169455,164
"17380","ENSBTAG00000045493","28",23588334,23589608,1274
"17381","ENSBTAG00000045496","6",68399515,68399583,68
"17382","ENSBTAG00000045497","21",65114052,65114440,388
"17383","ENSBTAG00000045498","18",55212028,55247408,35380
"17384","ENSBTAG00000045500","19",23307813,23345953,38140
"17385","ENSBTAG00000045504","9",41851729,41852517,788
"17386","ENSBTAG00000045507","18",13698486,13709861,11375
"17387","ENSBTAG00000045509","13",56602499,56608352,5853
"17388","ENSBTAG00000045510","18",56613654,56620016,6362
"17389","ENSBTAG00000045514","11",47255181,47267139,11958
"17390","ENSBTAG00000045517","1",61183694,61184224,530
"17391","ENSBTAG00000045520","13",53134683,53148819,14136
"17392","ENSBTAG00000045523","6",33571441,33573135,1694
"17393","ENSBTAG00000045525","X",2261469,2261529,60
"17394","ENSBTAG00000045526","13",39882711,39885003,2292
"17395","ENSBTAG00000045528","11",93760983,93761936,953
"17396","ENSBTAG00000045529","18",62512088,62516410,4322
"17397","ENSBTAG00000045530","3",34281165,34281597,432
"17398","ENSBTAG00000045531","27",17780640,17783057,2417
"17399","ENSBTAG00000045535","4",114477816,114533940,56124
"17400","ENSBTAG00000045536","2",19663582,19663655,73
"17401","ENSBTAG00000045542","5",512836,538905,26069
"17402","ENSBTAG00000045547","22",50485830,50487389,1559
"17403","ENSBTAG00000045548","17",72288644,72307365,18721
"17404","ENSBTAG00000045550","X",49636412,49644611,8199
"17405","ENSBTAG00000045551","23",10598199,10598507,308
"17406","ENSBTAG00000045558","15",277741,278697,956
"17407","ENSBTAG00000045565","X",78531955,78603765,71810
"17408","ENSBTAG00000045566","12",74117026,74117604,578
"17409","ENSBTAG00000045567","4",66608858,66610438,1580
"17410","ENSBTAG00000045568","24",12773751,12774847,1096
"17411","ENSBTAG00000045569","X",19278450,19282748,4298
"17412","ENSBTAG00000045571","18",58893635,58894841,1206
"17413","ENSBTAG00000045572","18",25902577,25904786,2209
"17414","ENSBTAG00000045574","5",37115332,37119907,4575
"17415","ENSBTAG00000045575","5",113672591,113673049,458
"17416","ENSBTAG00000045577","23",27756575,27760332,3757
"17417","ENSBTAG00000045578","4",25349573,25366158,16585
"17418","ENSBTAG00000045580","NKLS02001494.1",68776,98861,30085
"17419","ENSBTAG00000045581","18",60378959,60389389,10430
"17420","ENSBTAG00000045582","16",64674639,64684247,9608
"17421","ENSBTAG00000045587","29",50679309,50679414,105
"17422","ENSBTAG00000045588","7",5726148,5730509,4361
"17423","ENSBTAG00000045589","7",42851442,42852383,941
"17424","ENSBTAG00000045590","1",36488119,36490296,2177
"17425","ENSBTAG00000045592","4",56850722,56851003,281
"17426","ENSBTAG00000045593","25",21194266,21229246,34980
"17427","ENSBTAG00000045594","21",69783628,69784584,956
"17428","ENSBTAG00000045596","3",14913465,14932571,19106
"17429","ENSBTAG00000045601","29",17878424,17879107,683
"17430","ENSBTAG00000045602","6",71230750,71247064,16314
"17431","ENSBTAG00000045604","10",82281701,82314251,32550
"17432","ENSBTAG00000045610","5",110989656,111105495,115839
"17433","ENSBTAG00000045617","4",9247873,9254862,6989
"17434","ENSBTAG00000045621","19",14614634,14615948,1314
"17435","ENSBTAG00000045625","25",1975362,1978173,2811
"17436","ENSBTAG00000045628","10",14357643,14362726,5083
"17437","ENSBTAG00000045630","13",74209350,74209544,194
"17438","ENSBTAG00000045633","1",119465679,119521250,55571
"17439","ENSBTAG00000045641","19",20146236,20146302,66
"17440","ENSBTAG00000045643","3",98832725,98834185,1460
"17441","ENSBTAG00000045645","4",92831983,92834051,2068
"17442","ENSBTAG00000045649","27",6956381,6964235,7854
"17443","ENSBTAG00000045652","19",43832593,43833784,1191
"17444","ENSBTAG00000045656","18",46087645,46088262,617
"17445","ENSBTAG00000045658","15",43115610,43120203,4593
"17446","ENSBTAG00000045659","11",47282394,47283086,692
"17447","ENSBTAG00000045662","5",27135903,27142693,6790
"17448","ENSBTAG00000045664","3",99799405,99817768,18363
"17449","ENSBTAG00000045673","4",30029423,30029833,410
"17450","ENSBTAG00000045678","X",73081596,73082174,578
"17451","ENSBTAG00000045683","7",52447920,52454072,6152
"17452","ENSBTAG00000045689","12",15228182,15229597,1415
"17453","ENSBTAG00000045695","20",71183646,71199637,15991
"17454","ENSBTAG00000045697","X",35964513,35973073,8560
"17455","ENSBTAG00000045699","28",22282909,24121400,1838491
"17456","ENSBTAG00000045703","26",20640572,20681513,40941
"17457","ENSBTAG00000045704","1",63749635,63892877,143242
"17458","ENSBTAG00000045708","18",53404734,53412256,7522
"17459","ENSBTAG00000045711","11",106240675,106241679,1004
"17460","ENSBTAG00000045715","X",8507087,8511323,4236
"17461","ENSBTAG00000045716","16",41773507,41773622,115
"17462","ENSBTAG00000045717","28",18928900,18929826,926
"17463","ENSBTAG00000045718","3",14409894,14410001,107
"17464","ENSBTAG00000045727","14",940689,955681,14992
"17465","ENSBTAG00000045732","19",43673337,43676150,2813
"17466","ENSBTAG00000045734","11",106196215,106200561,4346
"17467","ENSBTAG00000045737","18",45131588,45133764,2176
"17468","ENSBTAG00000045744","X",3945041,3961168,16127
"17469","ENSBTAG00000045746","5",114619207,114682683,63476
"17470","ENSBTAG00000045748","22",56467496,56543343,75847
"17471","ENSBTAG00000045751","NKLS02000910.1",1512,147533,146021
"17472","ENSBTAG00000045754","16",49286556,49290320,3764
"17473","ENSBTAG00000045756","X",54423546,54423815,269
"17474","ENSBTAG00000045757","22",48434632,48437765,3133
"17475","ENSBTAG00000045762","7",44220150,44237062,16912
"17476","ENSBTAG00000045764","5",12764827,12764956,129
"17477","ENSBTAG00000045767","25",33176555,33192047,15492
"17478","ENSBTAG00000045770","5",27205200,27218221,13021
"17479","ENSBTAG00000045772","9",93737913,93741085,3172
"17480","ENSBTAG00000045774","10",81808771,81808871,100
"17481","ENSBTAG00000045776","3",108107987,108109056,1069
"17482","ENSBTAG00000045779","X",3930264,3947889,17625
"17483","ENSBTAG00000045781","1",40865156,40865454,298
"17484","ENSBTAG00000045783","16",5344538,5344714,176
"17485","ENSBTAG00000045784","13",51417094,51419830,2736
"17486","ENSBTAG00000045785","5",73547847,73588700,40853
"17487","ENSBTAG00000045787","6",99411738,99488979,77241
"17488","ENSBTAG00000045789","16",80934811,80942857,8046
"17489","ENSBTAG00000045791","14",1071877,1073361,1484
"17490","ENSBTAG00000045792","3",101234756,101234835,79
"17491","ENSBTAG00000045795","18",62754722,62761536,6814
"17492","ENSBTAG00000045806","18",46053846,46054748,902
"17493","ENSBTAG00000045808","5",119366047,119390141,24094
"17494","ENSBTAG00000045810","17",70891134,70893403,2269
"17495","ENSBTAG00000045817","22",48479063,48487708,8645
"17496","ENSBTAG00000045822","15",74043979,74045355,1376
"17497","ENSBTAG00000045824","19",58919579,58923174,3595
"17498","ENSBTAG00000045826","28",27863228,27863599,371
"17499","ENSBTAG00000045828","7",43367474,43378190,10716
"17500","ENSBTAG00000045829","7",43391938,43394873,2935
"17501","ENSBTAG00000045832","24",61054481,61278037,223556
"17502","ENSBTAG00000045834","29",50732092,50734727,2635
"17503","ENSBTAG00000045835","19",37898743,37901190,2447
"17504","ENSBTAG00000045838","2",15839591,15843250,3659
"17505","ENSBTAG00000045841","25",26300132,26302015,1883
"17506","ENSBTAG00000045847","10",62186831,62192924,6093
"17507","ENSBTAG00000045849","10",101723038,101828432,105394
"17508","ENSBTAG00000045852","8",95442948,95443265,317
"17509","ENSBTAG00000045854","18",62462232,62476548,14316
"17510","ENSBTAG00000045856","7",17838214,17838310,96
"17511","ENSBTAG00000045857","25",546281,558068,11787
"17512","ENSBTAG00000045861","18",63294632,63303051,8419
"17513","ENSBTAG00000045862","29",42511025,42529571,18546
"17514","ENSBTAG00000045863","10",23032036,23033790,1754
"17515","ENSBTAG00000045864","18",61899299,61899895,596
"17516","ENSBTAG00000045867","X",104948591,105018940,70349
"17517","ENSBTAG00000045868","8",102289696,102300174,10478
"17518","ENSBTAG00000045876","X",55535071,55555046,19975
"17519","ENSBTAG00000045877","X",56329795,56397086,67291
"17520","ENSBTAG00000045879","9",34209954,34214541,4587
"17521","ENSBTAG00000045880","18",57565772,57600633,34861
"17522","ENSBTAG00000045881","15",13888639,13888722,83
"17523","ENSBTAG00000045885","19",48680498,48680581,83
"17524","ENSBTAG00000045886","7",110575227,110591417,16190
"17525","ENSBTAG00000045887","8",69370989,69394273,23284
"17526","ENSBTAG00000045890","NKLS02001410.1",91098,107018,15920
"17527","ENSBTAG00000045892","19",27036503,27039629,3126
"17528","ENSBTAG00000045893","7",15368533,15370410,1877
"17529","ENSBTAG00000045895","16",2608815,2800803,191988
"17530","ENSBTAG00000045896","25",37500335,37512250,11915
"17531","ENSBTAG00000045898","9",95003487,95003729,242
"17532","ENSBTAG00000045901","25",2433098,2436408,3310
"17533","ENSBTAG00000045902","2",129898024,130038309,140285
"17534","ENSBTAG00000045904","5",119348910,119351736,2826
"17535","ENSBTAG00000045905","26",4657603,5569857,912254
"17536","ENSBTAG00000045909","7",99808416,99830680,22264
"17537","ENSBTAG00000045912","25",2782419,2783311,892
"17538","ENSBTAG00000045914","7",20022563,20022973,410
"17539","ENSBTAG00000045920","12",78103778,78103896,118
"17540","ENSBTAG00000045923","23",7096520,7105588,9068
"17541","ENSBTAG00000045925","X",78364660,78370076,5416
"17542","ENSBTAG00000045929","21",19715966,19720349,4383
"17543","ENSBTAG00000045931","X",74517592,74566517,48925
"17544","ENSBTAG00000045934","X",101900340,101901350,1010
"17545","ENSBTAG00000045936","23",11108189,11109870,1681
"17546","ENSBTAG00000045937","4",16779419,16781333,1914
"17547","ENSBTAG00000045939","15",81969730,81976647,6917
"17548","ENSBTAG00000045943","2",120180193,120185721,5528
"17549","ENSBTAG00000045946","19",26574918,26576224,1306
"17550","ENSBTAG00000045948","3",119425809,119430912,5103
"17551","ENSBTAG00000045951","18",62625845,62636766,10921
"17552","ENSBTAG00000045954","20",71824870,71853183,28313
"17553","ENSBTAG00000045955","17",72591117,72592556,1439
"17554","ENSBTAG00000045956","11",70879550,70879627,77
"17555","ENSBTAG00000045957","5",114694985,114725673,30688
"17556","ENSBTAG00000045966","6",35563653,35565995,2342
"17557","ENSBTAG00000045969","5",56979557,56980940,1383
"17558","ENSBTAG00000045977","17",63117736,63118020,284
"17559","ENSBTAG00000045980","10",42858869,42859396,527
"17560","ENSBTAG00000045981","7",20954134,20954730,596
"17561","ENSBTAG00000045985","18",59968692,59970062,1370
"17562","ENSBTAG00000045989","18",62891327,62891788,461
"17563","ENSBTAG00000045991","1",97337537,97342603,5066
"17564","ENSBTAG00000045994","6",115172940,115174325,1385
"17565","ENSBTAG00000045998","21",1205086,1208637,3551
"17566","ENSBTAG00000046000","2",8834495,8834995,500
"17567","ENSBTAG00000046003","3",20746488,20747479,991
"17568","ENSBTAG00000046004","X",96040828,96041388,560
"17569","ENSBTAG00000046007","16",49303365,49306839,3474
"17570","ENSBTAG00000046008","1",119778890,119779390,500
"17571","ENSBTAG00000046010","25",37796588,37797151,563
"17572","ENSBTAG00000046012","X",4121683,4122645,962
"17573","ENSBTAG00000046014","25",41714514,41725123,10609
"17574","ENSBTAG00000046017","9",44857715,44860928,3213
"17575","ENSBTAG00000046019","20",71804557,71827899,23342
"17576","ENSBTAG00000046022","19",43821266,43822992,1726
"17577","ENSBTAG00000046023","23",29500748,29501680,932
"17578","ENSBTAG00000046026","14",533918,538406,4488
"17579","ENSBTAG00000046031","14",416888,419537,2649
"17580","ENSBTAG00000046033","25",21228703,21240606,11903
"17581","ENSBTAG00000046037","X",3852584,3855433,2849
"17582","ENSBTAG00000046041","12",70341283,70685377,344094
"17583","ENSBTAG00000046044","2",121130303,121145458,15155
"17584","ENSBTAG00000046046","24",40126526,40129341,2815
"17585","ENSBTAG00000046047","NKLS02002206.1",119080,156407,37327
"17586","ENSBTAG00000046052","10",35899557,35900705,1148
"17587","ENSBTAG00000046058","10",26511346,26511942,596
"17588","ENSBTAG00000046066","7",40210022,40210492,470
"17589","ENSBTAG00000046067","17",71364813,71364873,60
"17590","ENSBTAG00000046069","X",86452251,86454588,2337
"17591","ENSBTAG00000046073","16",51079281,51085040,5759
"17592","ENSBTAG00000046076","21",270031,274238,4207
"17593","ENSBTAG00000046078","19",42586453,42586587,134
"17594","ENSBTAG00000046079","8",95456474,95457451,977
"17595","ENSBTAG00000046083","17",70997874,71006261,8387
"17596","ENSBTAG00000046084","X",137170870,137177739,6869
"17597","ENSBTAG00000046088","15",83472894,83474498,1604
"17598","ENSBTAG00000046089","5",27227791,27233514,5723
"17599","ENSBTAG00000046090","29",46309663,46318035,8372
"17600","ENSBTAG00000046092","X",78104530,78344210,239680
"17601","ENSBTAG00000046093","21",2071678,2071771,93
"17602","ENSBTAG00000046096","23",31355274,31355570,296
"17603","ENSBTAG00000046098","25",18426076,18448495,22419
"17604","ENSBTAG00000046100","26",14055286,14056972,1686
"17605","ENSBTAG00000046101","18",63864852,63872963,8111
"17606","ENSBTAG00000046104","1",106376776,106377770,994
"17607","ENSBTAG00000046105","7",43404172,43407636,3464
"17608","ENSBTAG00000046107","23",16856085,16888037,31952
"17609","ENSBTAG00000046110","29",45264284,45274069,9785
"17610","ENSBTAG00000046111","18",63526743,63535355,8612
"17611","ENSBTAG00000046120","9",95347831,95348106,275
"17612","ENSBTAG00000046121","14",76962714,76967783,5069
"17613","ENSBTAG00000046122","11",106326244,106326588,344
"17614","ENSBTAG00000046129","19",20139709,20143944,4235
"17615","ENSBTAG00000046135","14",66865293,66869643,4350
"17616","ENSBTAG00000046138","3",18070542,18071330,788
"17617","ENSBTAG00000046139","7",14124498,14125451,953
"17618","ENSBTAG00000046140","11",106072818,106080084,7266
"17619","ENSBTAG00000046142","25",41917307,41990437,73130
"17620","ENSBTAG00000046148","19",22285426,22288707,3281
"17621","ENSBTAG00000046151","NKLS02002207.1",197312,198351,1039
"17622","ENSBTAG00000046152","4",105285315,105466927,181612
"17623","ENSBTAG00000046153","24",43851006,43852124,1118
"17624","ENSBTAG00000046155","X",85465751,85483092,17341
"17625","ENSBTAG00000046158","23",27415355,27421377,6022
"17626","ENSBTAG00000046160","23",45163467,45184760,21293
"17627","ENSBTAG00000046161","21",337976,338969,993
"17628","ENSBTAG00000046162","19",42177663,42235344,57681
"17629","ENSBTAG00000046169","4",94128586,94135232,6646
"17630","ENSBTAG00000046172","16",59363252,59438293,75041
"17631","ENSBTAG00000046173","5",119303243,119312093,8850
"17632","ENSBTAG00000046174","19",61932055,61960122,28067
"17633","ENSBTAG00000046176","2",107365755,107423369,57614
"17634","ENSBTAG00000046177","16",79714751,79750062,35311
"17635","ENSBTAG00000046178","5",91510159,91510902,743
"17636","ENSBTAG00000046180","23",9813955,9817368,3413
"17637","ENSBTAG00000046185","21",57857951,57947077,89126
"17638","ENSBTAG00000046188","7",43411277,43414454,3177
"17639","ENSBTAG00000046189","10",26069296,26071780,2484
"17640","ENSBTAG00000046190","7",51894458,51897914,3456
"17641","ENSBTAG00000046191","17",35298887,35307547,8660
"17642","ENSBTAG00000046192","20",10375646,10389675,14029
"17643","ENSBTAG00000046193","23",4249733,4261772,12039
"17644","ENSBTAG00000046194","7",58553819,58553895,76
"17645","ENSBTAG00000046199","11",32278324,32766620,488296
"17646","ENSBTAG00000046200","7",42764971,42765894,923
"17647","ENSBTAG00000046204","27",6119983,6125684,5701
"17648","ENSBTAG00000046206","20",71836212,71836325,113
"17649","ENSBTAG00000046218","11",87547144,87558851,11707
"17650","ENSBTAG00000046220","3",102735758,102736414,656
"17651","ENSBTAG00000046222","1",83640845,83641019,174
"17652","ENSBTAG00000046223","11",106200925,106211622,10697
"17653","ENSBTAG00000046231","3",8694108,8697521,3413
"17654","ENSBTAG00000046235","9",60999045,61016030,16985
"17655","ENSBTAG00000046237","23",22122697,22123107,410
"17656","ENSBTAG00000046239","26",18219077,18256221,37144
"17657","ENSBTAG00000046243","16",63169575,63171269,1694
"17658","ENSBTAG00000046248","25",37005358,37018031,12673
"17659","ENSBTAG00000046255","18",39237968,39245893,7925
"17660","ENSBTAG00000046256","17",48417339,48868560,451221
"17661","ENSBTAG00000046257","4",113066865,113074368,7503
"17662","ENSBTAG00000046260","19",46114000,46114377,377
"17663","ENSBTAG00000046263","7",43910025,43918385,8360
"17664","ENSBTAG00000046264","19",42885853,42890067,4214
"17665","ENSBTAG00000046266","7",17963471,17966413,2942
"17666","ENSBTAG00000046268","5",99099765,99105058,5293
"17667","ENSBTAG00000046270","6",19166386,19167821,1435
"17668","ENSBTAG00000046271","12",76721782,76728113,6331
"17669","ENSBTAG00000046273","19",22097877,22106826,8949
"17670","ENSBTAG00000046277","3",6290852,6298224,7372
"17671","ENSBTAG00000046279","1",93392162,93401801,9639
"17672","ENSBTAG00000046280","11",72106815,72110132,3317
"17673","ENSBTAG00000046282","9",33499497,33507315,7818
"17674","ENSBTAG00000046283","19",9665675,9666220,545
"17675","ENSBTAG00000046285","15",79024208,79025137,929
"17676","ENSBTAG00000046286","X",87970000,88000785,30785
"17677","ENSBTAG00000046290","19",29772446,29772853,407
"17678","ENSBTAG00000046291","18",55248320,55257555,9235
"17679","ENSBTAG00000046295","18",48625060,48627516,2456
"17680","ENSBTAG00000046298","5",119854359,119884535,30176
"17681","ENSBTAG00000046301","22",16329359,16337918,8559
"17682","ENSBTAG00000046307","14",19128179,19129773,1594
"17683","ENSBTAG00000046312","X",78109254,78109361,107
"17684","ENSBTAG00000046313","1",51940576,51941806,1230
"17685","ENSBTAG00000046314","X",55340110,55415867,75757
"17686","ENSBTAG00000046316","21",56754575,56755105,530
"17687","ENSBTAG00000046320","15",29479402,29493244,13842
"17688","ENSBTAG00000046321","19",9281063,9297960,16897
"17689","ENSBTAG00000046322","17",70844303,70844716,413
"17690","ENSBTAG00000046324","5",100457856,100506412,48556
"17691","ENSBTAG00000046328","X",138722235,138751873,29638
"17692","ENSBTAG00000046332","28",1400372,1403383,3011
"17693","ENSBTAG00000046333","6",24975010,24980385,5375
"17694","ENSBTAG00000046334","4",76511048,76513580,2532
"17695","ENSBTAG00000046335","29",299133,300179,1046
"17696","ENSBTAG00000046337","24",42799984,42808150,8166
"17697","ENSBTAG00000046339","25",3526090,3536771,10681
"17698","ENSBTAG00000046343","7",71814227,71876639,62412
"17699","ENSBTAG00000046344","13",65986127,65987294,1167
"17700","ENSBTAG00000046345","16",77633793,77634326,533
"17701","ENSBTAG00000046346","21",69621803,69685518,63715
"17702","ENSBTAG00000046348","8",20303380,20443479,140099
"17703","ENSBTAG00000046350","16",79787223,79824967,37744
"17704","ENSBTAG00000046357","28",27453539,27499274,45735
"17705","ENSBTAG00000046358","14",63625556,63643551,17995
"17706","ENSBTAG00000046359","29",50698199,50722052,23853
"17707","ENSBTAG00000046362","26",31463888,31480690,16802
"17708","ENSBTAG00000046363","10",38738161,38738472,311
"17709","ENSBTAG00000046367","18",47312087,47324194,12107
"17710","ENSBTAG00000046372","19",19270701,19279666,8965
"17711","ENSBTAG00000046374","29",9119720,9120241,521
"17712","ENSBTAG00000046375","13",73538136,73539889,1753
"17713","ENSBTAG00000046379","11",106245252,106250935,5683
"17714","ENSBTAG00000046381","23",30131163,30131269,106
"17715","ENSBTAG00000046383","18",62453964,62454894,930
"17716","ENSBTAG00000046385","1",157198501,157232069,33568
"17717","ENSBTAG00000046389","5",99655608,99660385,4777
"17718","ENSBTAG00000046391","10",19099201,19136846,37645
"17719","ENSBTAG00000046392","5",74266329,74267210,881
"17720","ENSBTAG00000046393","1",36052605,36052711,106
"17721","ENSBTAG00000046394","19",20146383,20148654,2271
"17722","ENSBTAG00000046396","24",39306369,39308904,2535
"17723","ENSBTAG00000046399","25",11633241,11647753,14512
"17724","ENSBTAG00000046401","21",68480434,68482061,1627
"17725","ENSBTAG00000046402","5",71006144,71006650,506
"17726","ENSBTAG00000046406","7",43439368,43449545,10177
"17727","ENSBTAG00000046407","X",102107776,102179475,71699
"17728","ENSBTAG00000046408","12",20592801,20707135,114334
"17729","ENSBTAG00000046409","28",18936997,18942296,5299
"17730","ENSBTAG00000046411","24",57295131,57295249,118
"17731","ENSBTAG00000046413","6",30780273,31540156,759883
"17732","ENSBTAG00000046415","11",106210967,106212439,1472
"17733","ENSBTAG00000046418","11",106243655,106244125,470
"17734","ENSBTAG00000046419","11",1621368,1674858,53490
"17735","ENSBTAG00000046421","28",35609626,35620494,10868
"17736","ENSBTAG00000046425","18",49333733,49335689,1956
"17737","ENSBTAG00000046430","4",73324012,73427125,103113
"17738","ENSBTAG00000046435","14",159674,160615,941
"17739","ENSBTAG00000046437","29",50729070,50729167,97
"17740","ENSBTAG00000046440","6",8273766,8274902,1136
"17741","ENSBTAG00000046443","8",22907781,22908419,638
"17742","ENSBTAG00000046447","1",146865776,146877553,11777
"17743","ENSBTAG00000046451","18",53671973,53672507,534
"17744","ENSBTAG00000046454","2",94944568,95001285,56717
"17745","ENSBTAG00000046463","X",64106928,64107640,712
"17746","ENSBTAG00000046465","28",4055309,4055588,279
"17747","ENSBTAG00000046466","25",27734528,27734668,140
"17748","ENSBTAG00000046467","14",2553480,2585780,32300
"17749","ENSBTAG00000046468","20",21798316,21799446,1130
"17750","ENSBTAG00000046470","10",57606475,57639205,32730
"17751","ENSBTAG00000046476","X",15285932,15290968,5036
"17752","ENSBTAG00000046480","21",65940112,65940211,99
"17753","ENSBTAG00000046481","5",26813793,26820606,6813
"17754","ENSBTAG00000046482","10",26058341,26058811,470
"17755","ENSBTAG00000046485","29",44324144,44330325,6181
"17756","ENSBTAG00000046486","8",39860311,39860607,296
"17757","ENSBTAG00000046493","20",71780646,71796533,15887
"17758","ENSBTAG00000046494","16",43127556,43129154,1598
"17759","ENSBTAG00000046495","9",73453529,73454362,833
"17760","ENSBTAG00000046498","25",41821515,41866736,45221
"17761","ENSBTAG00000046499","26",25701872,25703285,1413
"17762","ENSBTAG00000046502","16",61489308,61684117,194809
"17763","ENSBTAG00000046503","9",25359955,25493561,133606
"17764","ENSBTAG00000046509","3",25592621,25593796,1175
"17765","ENSBTAG00000046511","5",44392339,44400094,7755
"17766","ENSBTAG00000046512","22",12509227,12518446,9219
"17767","ENSBTAG00000046514","26",15164983,15186232,21249
"17768","ENSBTAG00000046516","11",106067965,106069085,1120
"17769","ENSBTAG00000046520","13",54528121,54545401,17280
"17770","ENSBTAG00000046524","19",20147597,20147666,69
"17771","ENSBTAG00000046527","15",79013311,79014249,938
"17772","ENSBTAG00000046528","11",70878804,70878879,75
"17773","ENSBTAG00000046529","4",76669524,76669579,55
"17774","ENSBTAG00000046531","7",101914979,101915326,347
"17775","ENSBTAG00000046533","24",41786924,41868538,81614
"17776","ENSBTAG00000046534","22",60733490,60734815,1325
"17777","ENSBTAG00000046540","21",59435015,59482654,47639
"17778","ENSBTAG00000046542","7",43713177,43716027,2850
"17779","ENSBTAG00000046544","18",43644782,43660414,15632
"17780","ENSBTAG00000046545","3",14329333,14359887,30554
"17781","ENSBTAG00000046547","24",42779034,42792110,13076
"17782","ENSBTAG00000046548","11",98573717,98582947,9230
"17783","ENSBTAG00000046549","8",84256055,84311895,55840
"17784","ENSBTAG00000046551","25",33205386,33205508,122
"17785","ENSBTAG00000046552","12",77176134,77220409,44275
"17786","ENSBTAG00000046553","10",61182241,61240007,57766
"17787","ENSBTAG00000046555","X",86765550,86772520,6970
"17788","ENSBTAG00000046561","6",37380296,37557106,176810
"17789","ENSBTAG00000046563","11",36956209,36957453,1244
"17790","ENSBTAG00000046568","21",2068901,2068991,90
"17791","ENSBTAG00000046569","19",39325017,39327756,2739
"17792","ENSBTAG00000046573","23",30390348,30412787,22439
"17793","ENSBTAG00000046574","8",61704750,61865028,160278
"17794","ENSBTAG00000046577","1",114737058,114737164,106
"17795","ENSBTAG00000046580","19",42237031,42247670,10639
"17796","ENSBTAG00000046583","3",91331869,91344823,12954
"17797","ENSBTAG00000046584","17",70683375,70684017,642
"17798","ENSBTAG00000046585","21",65778461,65782456,3995
"17799","ENSBTAG00000046586","4",71063232,71063807,575
"17800","ENSBTAG00000046587","29",44101043,44102573,1530
"17801","ENSBTAG00000046588","4",59583232,59586115,2883
"17802","ENSBTAG00000046589","X",105970182,105972074,1892
"17803","ENSBTAG00000046590","21",58523141,58525558,2417
"17804","ENSBTAG00000046593","9",23513662,23514645,983
"17805","ENSBTAG00000046595","NKLS02000567.1",345,8393,8048
"17806","ENSBTAG00000046597","28",41805170,41807663,2493
"17807","ENSBTAG00000046605","2",121351995,121352100,105
"17808","ENSBTAG00000046607","10",37222172,37228629,6457
"17809","ENSBTAG00000046608","X",49886965,49888671,1706
"17810","ENSBTAG00000046609","5",101333531,101341323,7792
"17811","ENSBTAG00000046612","9",62631692,62725418,93726
"17812","ENSBTAG00000046614","13",73786382,73797126,10744
"17813","ENSBTAG00000046622","25",28248165,28248477,312
"17814","ENSBTAG00000046623","13",63799750,63800272,522
"17815","ENSBTAG00000046626","18",49618631,49626455,7824
"17816","ENSBTAG00000046628","5",44423778,44430774,6996
"17817","ENSBTAG00000046633","21",67530547,67531074,527
"17818","ENSBTAG00000046635","X",120246082,120254216,8134
"17819","ENSBTAG00000046644","29",50756430,50765200,8770
"17820","ENSBTAG00000046648","4",94046269,94070532,24263
"17821","ENSBTAG00000046649","2",110589561,110734612,145051
"17822","ENSBTAG00000046654","5",116906784,116943141,36357
"17823","ENSBTAG00000046662","29",49168667,49189949,21282
"17824","ENSBTAG00000046663","7",1661777,1663690,1913
"17825","ENSBTAG00000046664","12",14768101,14801118,33017
"17826","ENSBTAG00000046666","18",49612763,49615615,2852
"17827","ENSBTAG00000046668","10",26401174,26413011,11837
"17828","ENSBTAG00000046670","19",42643523,42650621,7098
"17829","ENSBTAG00000046671","6",102896904,102928920,32016
"17830","ENSBTAG00000046672","2",126349905,126374294,24389
"17831","ENSBTAG00000046677","17",73066457,73085195,18738
"17832","ENSBTAG00000046684","10",100831725,101280707,448982
"17833","ENSBTAG00000046685","2",31419404,31419510,106
"17834","ENSBTAG00000046690","18",34981737,34982402,665
"17835","ENSBTAG00000046699","2",79568840,79673336,104496
"17836","ENSBTAG00000046700","6",98059818,98061068,1250
"17837","ENSBTAG00000046701","26",18577904,18578593,689
"17838","ENSBTAG00000046708","18",34590076,34591671,1595
"17839","ENSBTAG00000046712","4",44569083,44582371,13288
"17840","ENSBTAG00000046717","7",51902109,51904514,2405
"17841","ENSBTAG00000046720","3",83582571,83584219,1648
"17842","ENSBTAG00000046722","25",1009957,1011972,2015
"17843","ENSBTAG00000046723","16",73169607,73359804,190197
"17844","ENSBTAG00000046724","5",110466292,110475491,9199
"17845","ENSBTAG00000046725","13",74596935,74599856,2921
"17846","ENSBTAG00000046726","9",91886265,91886978,713
"17847","ENSBTAG00000046728","29",45340103,45341524,1421
"17848","ENSBTAG00000046739","14",2499408,2515881,16473
"17849","ENSBTAG00000046740","29",5340117,5343452,3335
"17850","ENSBTAG00000046742","5",100036888,100041664,4776
"17851","ENSBTAG00000046744","7",11631611,11640783,9172
"17852","ENSBTAG00000046746","19",42639186,42642459,3273
"17853","ENSBTAG00000046750","7",5344443,5364373,19930
"17854","ENSBTAG00000046752","25",26427870,26430899,3029
"17855","ENSBTAG00000046753","25",35984122,35987288,3166
"17856","ENSBTAG00000046755","1",24414164,24482074,67910
"17857","ENSBTAG00000046757","23",28159277,28166226,6949
"17858","ENSBTAG00000046758","16",51406585,51407334,749
"17859","ENSBTAG00000046759","27",29225719,29225823,104
"17860","ENSBTAG00000046760","5",119207273,119240470,33197
"17861","ENSBTAG00000046763","22",42723923,42814196,90273
"17862","ENSBTAG00000046765","19",27151658,27171770,20112
"17863","ENSBTAG00000046768","4",76131287,76136846,5559
"17864","ENSBTAG00000046769","X",94099596,94101552,1956
"17865","ENSBTAG00000046771","3",34633213,34658968,25755
"17866","ENSBTAG00000046773","3",59112071,59159718,47647
"17867","ENSBTAG00000046774","X",86423078,86446108,23030
"17868","ENSBTAG00000046775","11",106117505,106128515,11010
"17869","ENSBTAG00000046786","18",997260,1002080,4820
"17870","ENSBTAG00000046788","6",90396979,90400041,3062
"17871","ENSBTAG00000046794","X",98892373,98892621,248
"17872","ENSBTAG00000046797","3",28614965,28624861,9896
"17873","ENSBTAG00000046803","8",80131404,80132573,1169
"17874","ENSBTAG00000046805","18",50068076,50077617,9541
"17875","ENSBTAG00000046806","X",74945072,74945568,496
"17876","ENSBTAG00000046808","7",13825691,13827061,1370
"17877","ENSBTAG00000046812","3",99461138,99462900,1762
"17878","ENSBTAG00000046813","NKLS02001456.1",125707,126158,451
"17879","ENSBTAG00000046814","10",84971509,84978751,7242
"17880","ENSBTAG00000046819","10",22973723,22974707,984
"17881","ENSBTAG00000046821","14",78646008,78649802,3794
"17882","ENSBTAG00000046837","7",16386268,16388881,2613
"17883","ENSBTAG00000046838","X",110460371,111107350,646979
"17884","ENSBTAG00000046840","25",9604176,9618759,14583
"17885","ENSBTAG00000046841","28",7400062,7403452,3390
"17886","ENSBTAG00000046844","5",119514739,119515231,492
"17887","ENSBTAG00000046846","7",6830800,6837079,6279
"17888","ENSBTAG00000046857","21",69765197,69766243,1046
"17889","ENSBTAG00000046862","2",121223027,121225422,2395
"17890","ENSBTAG00000046864","18",58130183,58133216,3033
"17891","ENSBTAG00000046869","29",50793909,50805209,11300
"17892","ENSBTAG00000046875","29",43894846,43900279,5433
"17893","ENSBTAG00000046878","2",26702515,26702856,341
"17894","ENSBTAG00000046887","17",63204673,63205053,380
"17895","ENSBTAG00000046888","6",30244484,30244750,266
"17896","ENSBTAG00000046896","1",113755315,113755612,297
"17897","ENSBTAG00000046900","17",71455671,71471655,15984
"17898","ENSBTAG00000046902","17",24091849,24092961,1112
"17899","ENSBTAG00000046909","1",144408383,144408423,40
"17900","ENSBTAG00000046917","4",48508186,48511734,3548
"17901","ENSBTAG00000046918","8",69336618,69351459,14841
"17902","ENSBTAG00000046919","19",29667889,29675257,7368
"17903","ENSBTAG00000046922","4",27817880,27819874,1994
"17904","ENSBTAG00000046924","22",48445745,48455607,9862
"17905","ENSBTAG00000046926","7",50320206,50320462,256
"17906","ENSBTAG00000046928","24",43011729,43012580,851
"17907","ENSBTAG00000046936","6",113176084,113178183,2099
"17908","ENSBTAG00000046938","27",16383422,16406473,23051
"17909","ENSBTAG00000046939","11",103615330,103619159,3829
"17910","ENSBTAG00000046941","X",66781657,66781938,281
"17911","ENSBTAG00000046943","25",37946723,37948167,1444
"17912","ENSBTAG00000046944","19",14327135,14327967,832
"17913","ENSBTAG00000046949","6",15525968,15526312,344
"17914","ENSBTAG00000046951","8",69357245,69362824,5579
"17915","ENSBTAG00000046952","10",84303892,84304284,392
"17916","ENSBTAG00000046953","7",42798234,42799181,947
"17917","ENSBTAG00000046956","10",11410206,11460277,50071
"17918","ENSBTAG00000046957","24",7406095,7815350,409255
"17919","ENSBTAG00000046959","1",36058732,36063724,4992
"17920","ENSBTAG00000046961","18",61467834,61478161,10327
"17921","ENSBTAG00000046965","25",1020808,1025693,4885
"17922","ENSBTAG00000046967","8",23229328,23229888,560
"17923","ENSBTAG00000046974","19",12320291,12322598,2307
"17924","ENSBTAG00000046977","2",132534610,132542603,7993
"17925","ENSBTAG00000046978","X",2320938,2323270,2332
"17926","ENSBTAG00000046979","21",57379063,57414855,35792
"17927","ENSBTAG00000046980","5",100044286,100060577,16291
"17928","ENSBTAG00000046984","7",42627861,42629258,1397
"17929","ENSBTAG00000046985","X",58480886,58480983,97
"17930","ENSBTAG00000046988","2",132076687,132077658,971
"17931","ENSBTAG00000046989","3",108113644,108120963,7319
"17932","ENSBTAG00000046990","21",57823069,57830906,7837
"17933","ENSBTAG00000046992","23",32156742,32157131,389
"17934","ENSBTAG00000046995","10",24978413,24979024,611
"17935","ENSBTAG00000046996","18",61867768,61878669,10901
"17936","ENSBTAG00000047000","10",73370050,73370853,803
"17937","ENSBTAG00000047003","24",23449909,23608154,158245
"17938","ENSBTAG00000047004","4",15734909,15991563,256654
"17939","ENSBTAG00000047009","23",19970227,19984806,14579
"17940","ENSBTAG00000047022","14",1703032,1704595,1563
"17941","ENSBTAG00000047024","9",40863110,40889767,26657
"17942","ENSBTAG00000047025","15",46092886,46093818,932
"17943","ENSBTAG00000047027","10",21760123,21760551,428
"17944","ENSBTAG00000047029","11",47179770,47180201,431
"17945","ENSBTAG00000047030","18",49282657,49290766,8109
"17946","ENSBTAG00000047031","11",104868346,104884495,16149
"17947","ENSBTAG00000047035","18",56225575,56234780,9205
"17948","ENSBTAG00000047036","2",64935007,65196499,261492
"17949","ENSBTAG00000047039","23",27326531,27330230,3699
"17950","ENSBTAG00000047040","21",59384836,59392749,7913
"17951","ENSBTAG00000047043","19",50854405,50856944,2539
"17952","ENSBTAG00000047047","3",39544,40538,994
"17953","ENSBTAG00000047051","NKLS02001539.1",1948,2871,923
"17954","ENSBTAG00000047054","26",47288256,47304664,16408
"17955","ENSBTAG00000047059","16",80532691,80543813,11122
"17956","ENSBTAG00000047061","11",106224783,106233382,8599
"17957","ENSBTAG00000047062","18",43631532,43646500,14968
"17958","ENSBTAG00000047068","X",133044890,133053472,8582
"17959","ENSBTAG00000047073","16",80402498,80405323,2825
"17960","ENSBTAG00000047075","19",57868356,57868692,336
"17961","ENSBTAG00000047077","26",20622608,20655036,32428
"17962","ENSBTAG00000047078","18",55577964,55580773,2809
"17963","ENSBTAG00000047080","5",119516398,119517993,1595
"17964","ENSBTAG00000047083","15",66124888,66126201,1313
"17965","ENSBTAG00000047087","20",23907747,23913997,6250
"17966","ENSBTAG00000047088","4",99091792,99135175,43383
"17967","ENSBTAG00000047089","X",23349910,23350197,287
"17968","ENSBTAG00000047098","X",4214105,4215262,1157
"17969","ENSBTAG00000047101","10",81312454,81314550,2096
"17970","ENSBTAG00000047103","8",76834195,76849974,15779
"17971","ENSBTAG00000047107","17",68139936,68183686,43750
"17972","ENSBTAG00000047110","29",41246408,41274364,27956
"17973","ENSBTAG00000047111","15",54940726,54955595,14869
"17974","ENSBTAG00000047115","27",40171198,40171321,123
"17975","ENSBTAG00000047121","17",71092573,71125064,32491
"17976","ENSBTAG00000047129","15",56449007,56455145,6138
"17977","ENSBTAG00000047132","7",11660888,11663037,2149
"17978","ENSBTAG00000047133","2",118309402,118313769,4367
"17979","ENSBTAG00000047135","22",12431752,12443560,11808
"17980","ENSBTAG00000047136","14",24496775,24496930,155
"17981","ENSBTAG00000047138","X",37122156,37125019,2863
"17982","ENSBTAG00000047139","17",58250440,58266919,16479
"17983","ENSBTAG00000047140","27",27076382,27076675,293
"17984","ENSBTAG00000047141","29",37942844,38048511,105667
"17985","ENSBTAG00000047143","21",65003590,65003751,161
"17986","ENSBTAG00000047144","1",98022943,98023362,419
"17987","ENSBTAG00000047147","1",42070368,42196081,125713
"17988","ENSBTAG00000047149","11",59794837,59822193,27356
"17989","ENSBTAG00000047155","28",43547662,43551966,4304
"17990","ENSBTAG00000047158","18",49017345,49024476,7131
"17991","ENSBTAG00000047161","X",138618426,138639472,21046
"17992","ENSBTAG00000047165","19",41776859,41783309,6450
"17993","ENSBTAG00000047166","21",30475225,30484483,9258
"17994","ENSBTAG00000047169","X",3909602,3921982,12380
"17995","ENSBTAG00000047171","7",1630549,1630636,87
"17996","ENSBTAG00000047175","18",62393610,62405845,12235
"17997","ENSBTAG00000047181","12",71977720,72139274,161554
"17998","ENSBTAG00000047186","19",35584422,35588719,4297
"17999","ENSBTAG00000047191","5",105332833,105369529,36696
"18000","ENSBTAG00000047194","X",86265023,86269479,4456
"18001","ENSBTAG00000047202","11",106169309,106186378,17069
"18002","ENSBTAG00000047203","5",14646149,14673174,27025
"18003","ENSBTAG00000047206","23",31796098,31796757,659
"18004","ENSBTAG00000047213","X",49935689,49939803,4114
"18005","ENSBTAG00000047214","19",27610779,27612351,1572
"18006","ENSBTAG00000047217","7",43418785,43436614,17829
"18007","ENSBTAG00000047219","18",47238023,47242438,4415
"18008","ENSBTAG00000047223","13",57465320,57532635,67315
"18009","ENSBTAG00000047225","5",97725269,97748884,23615
"18010","ENSBTAG00000047229","21",69755223,69757196,1973
"18011","ENSBTAG00000047231","16",80897787,80906695,8908
"18012","ENSBTAG00000047238","25",27344004,27381713,37709
"18013","ENSBTAG00000047242","15",40852005,40852304,299
"18014","ENSBTAG00000047247","1",107237030,107237770,740
"18015","ENSBTAG00000047249","25",33197879,33219477,21598
"18016","ENSBTAG00000047254","11",106046569,106065509,18940
"18017","ENSBTAG00000047256","16",38696229,38724604,28375
"18018","ENSBTAG00000047262","19",41841920,41849264,7344
"18019","ENSBTAG00000047265","29",42547910,42550015,2105
"18020","ENSBTAG00000047266","25",34671471,34671830,359
"18021","ENSBTAG00000047268","15",63118358,63168835,50477
"18022","ENSBTAG00000047270","18",62714565,62722641,8076
"18023","ENSBTAG00000047274","16",79548497,79581778,33281
"18024","ENSBTAG00000047281","10",36319056,36320976,1920
"18025","ENSBTAG00000047286","4",46337363,46340362,2999
"18026","ENSBTAG00000047287","16",24269638,24292851,23213
"18027","ENSBTAG00000047293","1",22189815,22193285,3470
"18028","ENSBTAG00000047296","19",8484500,8484590,90
"18029","ENSBTAG00000047297","11",105883216,105889151,5935
"18030","ENSBTAG00000047299","17",73123908,73128286,4378
"18031","ENSBTAG00000047301","18",60111587,60112775,1188
"18032","ENSBTAG00000047302","13",67292055,67307842,15787
"18033","ENSBTAG00000047314","3",106328186,106344433,16247
"18034","ENSBTAG00000047315","13",24204540,24206301,1761
"18035","ENSBTAG00000047316","25",3727793,3738216,10423
"18036","ENSBTAG00000047317","28",35390874,35401997,11123
"18037","ENSBTAG00000047319","21",67884902,67885504,602
"18038","ENSBTAG00000047322","10",92174653,92175261,608
"18039","ENSBTAG00000047325","19",37361994,37364912,2918
"18040","ENSBTAG00000047326","X",84448136,84451855,3719
"18041","ENSBTAG00000047330","14",44488895,44494877,5982
"18042","ENSBTAG00000047331","17",14115218,14143540,28322
"18043","ENSBTAG00000047336","13",75227064,75231292,4228
"18044","ENSBTAG00000047338","9",33251298,33325793,74495
"18045","ENSBTAG00000047339","X",103408842,103432576,23734
"18046","ENSBTAG00000047341","1",114370080,114375211,5131
"18047","ENSBTAG00000047343","12",19305384,19305898,514
"18048","ENSBTAG00000047344","15",54313650,54314615,965
"18049","ENSBTAG00000047354","5",32361397,32361766,369
"18050","ENSBTAG00000047356","15",48675985,48677409,1424
"18051","ENSBTAG00000047357","11",106236333,106237133,800
"18052","ENSBTAG00000047358","5",28969375,28982649,13274
"18053","ENSBTAG00000047362","15",62854463,62867520,13057
"18054","ENSBTAG00000047365","2",43458207,43462208,4001
"18055","ENSBTAG00000047367","18",39766889,39769183,2294
"18056","ENSBTAG00000047368","25",2229825,2231746,1921
"18057","ENSBTAG00000047373","7",38809682,38809801,119
"18058","ENSBTAG00000047376","X",78475622,78484845,9223
"18059","ENSBTAG00000047380","15",37508183,37513889,5706
"18060","ENSBTAG00000047383","12",69971487,70218751,247264
"18061","ENSBTAG00000047395","16",64696290,64697393,1103
"18062","ENSBTAG00000047396","15",81148671,81149618,947
"18063","ENSBTAG00000047402","28",43393567,43397864,4297
"18064","ENSBTAG00000047410","X",107106441,107157373,50932
"18065","ENSBTAG00000047411","X",84661088,84663445,2357
"18066","ENSBTAG00000047412","16",40651795,40663004,11209
"18067","ENSBTAG00000047414","7",14168074,14180447,12373
"18068","ENSBTAG00000047416","X",94232113,94370235,138122
"18069","ENSBTAG00000047418","26",15190922,15195504,4582
"18070","ENSBTAG00000047420","7",40086627,40109449,22822
"18071","ENSBTAG00000047423","18",50578593,50581143,2550
"18072","ENSBTAG00000047424","7",17747332,17757129,9797
"18073","ENSBTAG00000047425","15",8673994,8674917,923
"18074","ENSBTAG00000047426","2",46624526,46753941,129415
"18075","ENSBTAG00000047428","16",79118410,79121031,2621
"18076","ENSBTAG00000047431","11",87198961,87199092,131
"18077","ENSBTAG00000047432","6",102152418,102152828,410
"18078","ENSBTAG00000047434","28",4336914,4373964,37050
"18079","ENSBTAG00000047437","16",32282336,32282919,583
"18080","ENSBTAG00000047441","22",13635727,13637448,1721
"18081","ENSBTAG00000047443","3",51426683,51431901,5218
"18082","ENSBTAG00000047446","17",54332066,54332124,58
"18083","ENSBTAG00000047448","25",26478204,26480893,2689
"18084","ENSBTAG00000047449","11",49225771,49228296,2525
"18085","ENSBTAG00000047450","26",24686740,24691181,4441
"18086","ENSBTAG00000047451","21",65944436,65944531,95
"18087","ENSBTAG00000047454","13",29626082,29642910,16828
"18088","ENSBTAG00000047458","19",24164068,24165009,941
"18089","ENSBTAG00000047461","15",5072828,5224496,151668
"18090","ENSBTAG00000047468","3",2713574,2806763,93189
"18091","ENSBTAG00000047472","15",82907742,82908671,929
"18092","ENSBTAG00000047473","18",62490163,62504128,13965
"18093","ENSBTAG00000047474","26",25584171,25585605,1434
"18094","ENSBTAG00000047479","15",49588246,49589307,1061
"18095","ENSBTAG00000047482","4",92537251,92545269,8018
"18096","ENSBTAG00000047483","10",27040646,27041161,515
"18097","ENSBTAG00000047486","20",9865315,9867404,2089
"18098","ENSBTAG00000047488","14",3615121,3712832,97711
"18099","ENSBTAG00000047491","16",79599108,79660665,61557
"18100","ENSBTAG00000047495","29",49197117,49216812,19695
"18101","ENSBTAG00000047496","3",119099383,119100183,800
"18102","ENSBTAG00000047499","20",70038568,70046818,8250
"18103","ENSBTAG00000047502","23",9555619,9672159,116540
"18104","ENSBTAG00000047508","18",61900982,61901500,518
"18105","ENSBTAG00000047510","19",55926566,55927989,1423
"18106","ENSBTAG00000047514","6",101731536,101747428,15892
"18107","ENSBTAG00000047520","25",13816701,13824412,7711
"18108","ENSBTAG00000047524","2",124425343,124429820,4477
"18109","ENSBTAG00000047526","17",72606019,72607163,1144
"18110","ENSBTAG00000047528","3",18945338,18946378,1040
"18111","ENSBTAG00000047529","17",70736538,70736948,410
"18112","ENSBTAG00000047531","X",37125130,37141024,15894
"18113","ENSBTAG00000047532","14",71303539,71417926,114387
"18114","ENSBTAG00000047538","17",72161969,72166774,4805
"18115","ENSBTAG00000047543","21",18837293,19260319,423026
"18116","ENSBTAG00000047545","X",78545112,78549456,4344
"18117","ENSBTAG00000047547","24",46649869,46651883,2014
"18118","ENSBTAG00000047550","8",38683243,38791351,108108
"18119","ENSBTAG00000047559","16",67448413,67448793,380
"18120","ENSBTAG00000047560","7",43101617,43102879,1262
"18121","ENSBTAG00000047567","29",42539450,42542594,3144
"18122","ENSBTAG00000047568","18",64903999,64905966,1967
"18123","ENSBTAG00000047569","24",59864987,59867064,2077
"18124","ENSBTAG00000047572","25",36872481,36879534,7053
"18125","ENSBTAG00000047578","7",44101470,44119960,18490
"18126","ENSBTAG00000047582","5",110047995,110083317,35322
"18127","ENSBTAG00000047585","23",29930410,29931333,923
"18128","ENSBTAG00000047586","6",2433427,2442870,9443
"18129","ENSBTAG00000047590","1",83641288,83641418,130
"18130","ENSBTAG00000047591","23",22323297,22327665,4368
"18131","ENSBTAG00000047594","20",23901697,23903855,2158
"18132","ENSBTAG00000047595","17",36260758,37189201,928443
"18133","ENSBTAG00000047596","11",72502083,72503279,1196
"18134","ENSBTAG00000047599","4",65395787,65411689,15902
"18135","ENSBTAG00000047600","9",33364608,33480511,115903
"18136","ENSBTAG00000047604","19",42627994,42630487,2493
"18137","ENSBTAG00000047605","4",98980494,99055474,74980
"18138","ENSBTAG00000047606","21",69706995,69740920,33925
"18139","ENSBTAG00000047608","1",129741091,129754572,13481
"18140","ENSBTAG00000047611","22",16566968,16567958,990
"18141","ENSBTAG00000047613","6",114593970,114613187,19217
"18142","ENSBTAG00000047616","18",54997342,55002137,4795
"18143","ENSBTAG00000047621","16",5146970,5149550,2580
"18144","ENSBTAG00000047626","17",73014570,73019566,4996
"18145","ENSBTAG00000047628","8",69236316,69327302,90986
"18146","ENSBTAG00000047632","20",71944313,71950871,6558
"18147","ENSBTAG00000047635","24",50318709,50343196,24487
"18148","ENSBTAG00000047637","11",46537344,46538090,746
"18149","ENSBTAG00000047643","27",23421160,23422636,1476
"18150","ENSBTAG00000047646","4",40232708,40262214,29506
"18151","ENSBTAG00000047647","8",65712604,65713395,791
"18152","ENSBTAG00000047648","16",80036572,80130039,93467
"18153","ENSBTAG00000047649","8",86504014,86686160,182146
"18154","ENSBTAG00000047650","5",56216259,56225814,9555
"18155","ENSBTAG00000047655","X",54824358,54829820,5462
"18156","ENSBTAG00000047658","22",48466090,48479025,12935
"18157","ENSBTAG00000047659","11",2422587,2422997,410
"18158","ENSBTAG00000047664","17",71827754,71856313,28559
"18159","ENSBTAG00000047670","18",44032834,44178263,145429
"18160","ENSBTAG00000047673","25",18452580,18456836,4256
"18161","ENSBTAG00000047675","18",57498646,57507296,8650
"18162","ENSBTAG00000047676","17",73105784,73123446,17662
"18163","ENSBTAG00000047677","19",51261145,51261228,83
"18164","ENSBTAG00000047679","3",49610656,49621980,11324
"18165","ENSBTAG00000047680","29",50695300,50698405,3105
"18166","ENSBTAG00000047690","10",22809889,22811420,1531
"18167","ENSBTAG00000047691","18",49007322,49013350,6028
"18168","ENSBTAG00000047694","21",55412327,55414314,1987
"18169","ENSBTAG00000047698","8",22813247,22813828,581
"18170","ENSBTAG00000047699","X",122821073,122823142,2069
"18171","ENSBTAG00000047700","20",71943352,71965884,22532
"18172","ENSBTAG00000047702","X",37144907,37149900,4993
"18173","ENSBTAG00000047706","27",14301797,14308918,7121
"18174","ENSBTAG00000047707","23",7114058,7122883,8825
"18175","ENSBTAG00000047712","18",59089801,59097283,7482
"18176","ENSBTAG00000047713","29",50739784,50744603,4819
"18177","ENSBTAG00000047715","11",106213509,106221057,7548
"18178","ENSBTAG00000047717","19",20174919,20228601,53682
"18179","ENSBTAG00000047719","10",5715882,5718113,2231
"18180","ENSBTAG00000047724","18",45272379,45273765,1386
"18181","ENSBTAG00000047731","3",15382809,15387801,4992
"18182","ENSBTAG00000047734","25",27523808,27537894,14086
"18183","ENSBTAG00000047739","12",14678207,14681664,3457
"18184","ENSBTAG00000047743","6",40250033,41576485,1326452
"18185","ENSBTAG00000047747","7",53073060,53201931,128871
"18186","ENSBTAG00000047749","27",13319532,13427878,108346
"18187","ENSBTAG00000047752","13",24387958,24389403,1445
"18188","ENSBTAG00000047755","16",51040526,51041203,677
"18189","ENSBTAG00000047756","19",27612384,27627113,14729
"18190","ENSBTAG00000047757","X",3690725,3692807,2082
"18191","ENSBTAG00000047760","19",50809985,50815680,5695
"18192","ENSBTAG00000047761","18",58302336,58312289,9953
"18193","ENSBTAG00000047764","NKLS02001494.1",460932,609669,148737
"18194","ENSBTAG00000047768","X",74502511,74507315,4804
"18195","ENSBTAG00000047772","11",66861857,66865204,3347
"18196","ENSBTAG00000047780","20",71828109,71843714,15605
"18197","ENSBTAG00000047781","25",38764287,38765028,741
"18198","ENSBTAG00000047783","2",81258751,81259773,1022
"18199","ENSBTAG00000047786","29",39978830,39980989,2159
"18200","ENSBTAG00000047787","18",39257739,39258131,392
"18201","ENSBTAG00000047789","23",30019010,30019307,297
"18202","ENSBTAG00000047793","29",49191068,49194708,3640
"18203","ENSBTAG00000047794","22",48488285,48533380,45095
"18204","ENSBTAG00000047801","5",119312407,119319443,7036
"18205","ENSBTAG00000047807","11",106094744,106102179,7435
"18206","ENSBTAG00000047808","25",35508854,35511818,2964
"18207","ENSBTAG00000047810","6",113508435,113511325,2890
"18208","ENSBTAG00000047815","18",50139511,50146338,6827
"18209","ENSBTAG00000047816","11",49190623,49193633,3010
"18210","ENSBTAG00000047818","5",51752422,51924620,172198
"18211","ENSBTAG00000047823","26",16854575,16856165,1590
"18212","ENSBTAG00000047824","16",30385884,30386686,802
"18213","ENSBTAG00000047827","X",37149921,37157488,7567
"18214","ENSBTAG00000047828","20",13932899,13938110,5211
"18215","ENSBTAG00000047830","3",83488340,83490482,2142
"18216","ENSBTAG00000047833","6",88543286,88564254,20968
"18217","ENSBTAG00000047834","14",9114129,9202434,88305
"18218","ENSBTAG00000047836","8",64124355,64124654,299
"18219","ENSBTAG00000047839","3",119510492,119511556,1064
"18220","ENSBTAG00000047842","26",38878592,38880872,2280
"18221","ENSBTAG00000047845","4",93615932,93616147,215
"18222","ENSBTAG00000047849","2",89281041,89284548,3507
"18223","ENSBTAG00000047855","X",37222430,37283270,60840
"18224","ENSBTAG00000047856","1",71257814,71346318,88504
"18225","ENSBTAG00000047863","4",69002744,69003498,754
"18226","ENSBTAG00000047865","21",1964407,1964480,73
"18227","ENSBTAG00000047869","13",27925312,27943171,17859
"18228","ENSBTAG00000047871","3",101936564,101939528,2964
"18229","ENSBTAG00000047874","3",34673537,34681037,7500
"18230","ENSBTAG00000047876","6",114487980,114552108,64128
"18231","ENSBTAG00000047877","28",3904873,3963570,58697
"18232","ENSBTAG00000047879","3",32745301,32747031,1730
"18233","ENSBTAG00000047889","21",65955026,65955105,79
"18234","ENSBTAG00000047891","6",18817751,18827328,9577
"18235","ENSBTAG00000047894","13",67535037,67539706,4669
"18236","ENSBTAG00000047902","9",87049719,87056668,6949
"18237","ENSBTAG00000047903","15",56943021,56943156,135
"18238","ENSBTAG00000047904","17",52808443,52809534,1091
"18239","ENSBTAG00000047907","11",100226301,100226812,511
"18240","ENSBTAG00000047914","29",50687389,50694307,6918
"18241","ENSBTAG00000047917","X",36645553,36648213,2660
"18242","ENSBTAG00000047919","4",106056469,106067886,11417
"18243","ENSBTAG00000047924","17",7238746,7239825,1079
"18244","ENSBTAG00000047926","19",23064483,23065876,1393
"18245","ENSBTAG00000047930","27",42324254,42691907,367653
"18246","ENSBTAG00000047939","X",19043489,19055595,12106
"18247","ENSBTAG00000047940","19",6340204,6340656,452
"18248","ENSBTAG00000047942","5",112687401,112706629,19228
"18249","ENSBTAG00000047944","13",54799166,54809284,10118
"18250","ENSBTAG00000047945","15",49412715,49413665,950
"18251","ENSBTAG00000047946","1",59909220,59909921,701
"18252","ENSBTAG00000047948","19",597148,603093,5945
"18253","ENSBTAG00000047951","20",18207482,18207645,163
"18254","ENSBTAG00000047953","18",62409111,62438024,28913
"18255","ENSBTAG00000047954","X",18909568,18949314,39746
"18256","ENSBTAG00000047955","21",22235676,22244051,8375
"18257","ENSBTAG00000047956","19",42618490,42625469,6979
"18258","ENSBTAG00000047958","11",106130453,106134589,4136
"18259","ENSBTAG00000047964","11",106198247,106200508,2261
"18260","ENSBTAG00000047968","15",80953172,80959492,6320
"18261","ENSBTAG00000047969","11",10887584,10890211,2627
"18262","ENSBTAG00000047972","16",79497446,79515409,17963
"18263","ENSBTAG00000047975","13",81893784,82044527,150743
"18264","ENSBTAG00000047986","17",70816976,70817504,528
"18265","ENSBTAG00000047990","8",102232455,102238718,6263
"18266","ENSBTAG00000047991","13",55097812,55162325,64513
"18267","ENSBTAG00000047992","19",26487421,26488183,762
"18268","ENSBTAG00000047996","29",49725732,49736580,10848
"18269","ENSBTAG00000047997","X",130798549,130828342,29793
"18270","ENSBTAG00000047998","11",105268089,105419303,151214
"18271","ENSBTAG00000048002","21",14137379,14137678,299
"18272","ENSBTAG00000048005","18",64048790,64061205,12415
"18273","ENSBTAG00000048007","8",8412698,8413435,737
"18274","ENSBTAG00000048010","21",69532009,69539133,7124
"18275","ENSBTAG00000048011","1",97281198,97282211,1013
"18276","ENSBTAG00000048013","6",84189236,84210644,21408
"18277","ENSBTAG00000048028","X",45933480,45933605,125
"18278","ENSBTAG00000048029","15",5811583,5820952,9369
"18279","ENSBTAG00000048030","17",70862697,70863234,537
"18280","ENSBTAG00000048033","7",65416423,65416647,224
"18281","ENSBTAG00000048034","19",26571233,26572537,1304
"18282","ENSBTAG00000048038","X",2800919,2801014,95
"18283","ENSBTAG00000048041","11",2963146,2974226,11080
"18284","ENSBTAG00000048046","9",10632692,10633051,359
"18285","ENSBTAG00000048048","21",290615,292470,1855
"18286","ENSBTAG00000048049","21",198678,206914,8236
"18287","ENSBTAG00000048052","15",50431553,50432524,971
"18288","ENSBTAG00000048053","7",49732269,49736500,4231
"18289","ENSBTAG00000048054","11",106108207,106117113,8906
"18290","ENSBTAG00000048057","1",64646190,64861271,215081
"18291","ENSBTAG00000048059","29",26067884,26073981,6097
"18292","ENSBTAG00000048061","29",7007877,7197732,189855
"18293","ENSBTAG00000048062","19",27535830,27545702,9872
"18294","ENSBTAG00000048065","11",86541915,86542226,311
"18295","ENSBTAG00000048067","19",39275928,39277067,1139
"18296","ENSBTAG00000048069","7",40826843,40827799,956
"18297","ENSBTAG00000048070","11",70886775,70886859,84
"18298","ENSBTAG00000048071","11",100975458,100985125,9667
"18299","ENSBTAG00000048075","18",52393131,52407580,14449
"18300","ENSBTAG00000048076","21",55229271,55229367,96
"18301","ENSBTAG00000048077","X",89587797,89595308,7511
"18302","ENSBTAG00000048082","28",35535068,35544437,9369
"18303","ENSBTAG00000048086","X",56596559,56601055,4496
"18304","ENSBTAG00000048087","13",53345822,53359460,13638
"18305","ENSBTAG00000048090","1",144659041,144684327,25286
"18306","ENSBTAG00000048093","18",8132119,8132183,64
"18307","ENSBTAG00000048094","21",59334247,59363576,29329
"18308","ENSBTAG00000048096","21",20262339,20263205,866
"18309","ENSBTAG00000048098","29",50874353,50887642,13289
"18310","ENSBTAG00000048103","3",102292645,102292941,296
"18311","ENSBTAG00000048107","7",1608231,1640391,32160
"18312","ENSBTAG00000048114","9",87531057,87535158,4101
"18313","ENSBTAG00000048122","7",43416200,43418803,2603
"18314","ENSBTAG00000048123","17",72595819,72596895,1076
"18315","ENSBTAG00000048125","11",106080954,106086455,5501
"18316","ENSBTAG00000048127","18",55252155,55253024,869
"18317","ENSBTAG00000048135","20",71927027,71928602,1575
"18318","ENSBTAG00000048138","14",34364687,34390720,26033
"18319","ENSBTAG00000048139","10",83522680,83522975,295
"18320","ENSBTAG00000048140","25",41885771,41908876,23105
"18321","ENSBTAG00000048142","11",9209287,9210408,1121
"18322","ENSBTAG00000048143","X",51951931,51953635,1704
"18323","ENSBTAG00000048146","21",65925877,65925980,103
"18324","ENSBTAG00000048151","2",43470324,43528516,58192
"18325","ENSBTAG00000048152","19",42676073,42680834,4761
"18326","ENSBTAG00000048153","28",2657370,2722413,65043
"18327","ENSBTAG00000048155","11",105440661,105450692,10031
"18328","ENSBTAG00000048159","X",112697325,112730062,32737
"18329","ENSBTAG00000048160","14",1111425,1113356,1931
"18330","ENSBTAG00000048166","15",48000889,48001851,962
"18331","ENSBTAG00000048169","4",9704065,9704457,392
"18332","ENSBTAG00000048171","27",6013825,6015791,1966
"18333","ENSBTAG00000048173","X",18677271,18679116,1845
"18334","ENSBTAG00000048179","3",82931826,82932071,245
"18335","ENSBTAG00000048195","1",71232257,71252236,19979
"18336","ENSBTAG00000048204","18",57689833,57699513,9680
"18337","ENSBTAG00000048206","X",71159114,71160016,902
"18338","ENSBTAG00000048217","19",20148444,20148514,70
"18339","ENSBTAG00000048225","1",71868325,71868900,575
"18340","ENSBTAG00000048228","2",124850784,124854007,3223
"18341","ENSBTAG00000048237","12",35378340,35406261,27921
"18342","ENSBTAG00000048241","X",34445007,34445103,96
"18343","ENSBTAG00000048246","2",34382575,34466656,84081
"18344","ENSBTAG00000048250","6",85459411,85472039,12628
"18345","ENSBTAG00000048251","25",498198,498569,371
"18346","ENSBTAG00000048254","9",48474,48590,116
"18347","ENSBTAG00000048256","26",42826574,42827179,605
"18348","ENSBTAG00000048257","7",7567471,7646236,78765
"18349","ENSBTAG00000048262","13",67544671,67564997,20326
"18350","ENSBTAG00000048263","29",50745294,50758086,12792
"18351","ENSBTAG00000048264","29",42434138,42436171,2033
"18352","ENSBTAG00000048265","X",49828579,49829942,1363
"18353","ENSBTAG00000048268","21",358253,359018,765
"18354","ENSBTAG00000048270","7",1598892,1599034,142
"18355","ENSBTAG00000048271","5",109160003,109274608,114605
"18356","ENSBTAG00000048273","6",6006538,6012855,6317
"18357","ENSBTAG00000048276","1",142629559,142634531,4972
"18358","ENSBTAG00000048279","25",10514957,10522807,7850
"18359","ENSBTAG00000048280","5",67619641,67626496,6855
"18360","ENSBTAG00000048286","11",86379649,86401981,22332
"18361","ENSBTAG00000048289","19",63009959,63010267,308
"18362","ENSBTAG00000048296","X",127841454,127878242,36788
"18363","ENSBTAG00000048302","10",25036536,25037611,1075
"18364","ENSBTAG00000048304","23",27112294,27125633,13339
"18365","ENSBTAG00000048308","16",47112357,47119671,7314
"18366","ENSBTAG00000048309","7",24385785,24399648,13863
"18367","ENSBTAG00000048312","3",58314550,58326738,12188
