"","ensembl_gene_id","chromosome_name","start_position","end_position","length"
"1","WBGene00000001","I",5107833,5110183,2350
"2","WBGene00000002","IV",9598986,9601695,2709
"3","WBGene00000003","V",9244402,9246360,1958
"4","WBGene00000004","X",2552436,2557726,5290
"5","WBGene00000005","IV",6272529,6275713,3184
"6","WBGene00000006","I",2571782,2576020,4238
"7","WBGene00000007","V",11466844,11470663,3819
"8","WBGene00000008","II",1386888,1391567,4679
"9","WBGene00000009","IV",3862129,3865042,2913
"10","WBGene00000010","I",11388689,11396660,7971
"11","WBGene00000012","I",3886111,3887080,969
"12","WBGene00000013","I",3885548,3885905,357
"13","WBGene00000014","V",15817410,15817846,436
"14","WBGene00000015","V",20557945,20558379,434
"15","WBGene00000016","X",12792727,12793386,659
"16","WBGene00000017","X",12794118,12794870,752
"17","WBGene00000018","X",10605832,10624185,18353
"18","WBGene00000019","IV",10206189,10214911,8722
"19","WBGene00000020","I",2255923,2272866,16943
"20","WBGene00000021","IV",12950315,12957128,6813
"21","WBGene00000022","V",323774,330725,6951
"22","WBGene00000023","I",12011195,12018668,7473
"23","WBGene00000024","V",10380340,10381826,1486
"24","WBGene00000025","X",1408836,1410652,1816
"25","WBGene00000026","X",17553419,17554449,1030
"26","WBGene00000027","V",2274842,2275977,1135
"27","WBGene00000028","IV",15590697,15591772,1075
"28","WBGene00000029","V",5160671,5161892,1221
"29","WBGene00000030","V",5163396,5164759,1363
"30","WBGene00000031","V",5163269,5194608,31339
"31","WBGene00000032","X",8322111,8323418,1307
"32","WBGene00000033","X",3798179,3799741,1562
"33","WBGene00000034","II",192531,194558,2027
"34","WBGene00000035","X",16367229,16373789,6560
"35","WBGene00000036","I",3302001,3307587,5586
"36","WBGene00000037","II",14205633,14210214,4581
"37","WBGene00000038","II",14198046,14205325,7279
"38","WBGene00000039","X",5092458,5097067,4609
"39","WBGene00000040","X",11339874,11343568,3694
"40","WBGene00000041","III",7973717,7977355,3638
"41","WBGene00000042","X",6702463,6709142,6679
"42","WBGene00000043","X",6709538,6712925,3387
"43","WBGene00000044","III",6509699,6514768,5069
"44","WBGene00000045","I",4359207,4362548,3341
"45","WBGene00000046","II",7845662,7849797,4135
"46","WBGene00000047","X",10412725,10416630,3905
"47","WBGene00000048","X",13642348,13646898,4550
"48","WBGene00000049","X",4022273,4025584,3311
"49","WBGene00000050","I",6621687,6624894,3207
"50","WBGene00000051","X",13532871,13536433,3562
"51","WBGene00000053","II",8174845,8177195,2350
"52","WBGene00000054","V",8552695,8555388,2693
"53","WBGene00000055","V",8561216,8564345,3129
"54","WBGene00000056","V",2608656,2615247,6591
"55","WBGene00000057","V",15551155,15559147,7992
"56","WBGene00000058","I",9031274,9036695,5421
"57","WBGene00000059","II",14373831,14377890,4059
"58","WBGene00000060","III",6581927,6586549,4622
"59","WBGene00000061","X",7503823,7506633,2810
"60","WBGene00000062","V",3651686,3659499,7813
"61","WBGene00000063","V",11079167,11082497,3330
"62","WBGene00000064","V",11076723,11078168,1445
"63","WBGene00000065","V",11071690,11074498,2808
"64","WBGene00000066","X",4960553,4964416,3863
"65","WBGene00000067","III",13604339,13606067,1728
"66","WBGene00000068","III",4722126,4730919,8793
"67","WBGene00000069","V",5976029,5981513,5484
"68","WBGene00000070","III",3774896,3786640,11744
"69","WBGene00000071","V",5624727,5630892,6165
"70","WBGene00000072","X",4854069,4860036,5967
"71","WBGene00000073","V",12009537,12013605,4068
"72","WBGene00000074","X",13687973,13695800,7827
"73","WBGene00000075","X",7795046,7798287,3241
"74","WBGene00000079","I",7773180,7777652,4472
"75","WBGene00000080","III",7230964,7232882,1918
"76","WBGene00000081","III",295651,298556,2905
"77","WBGene00000082","X",12678832,12689279,10447
"78","WBGene00000083","X",7585587,7595414,9827
"79","WBGene00000084","I",7602307,7608245,5938
"80","WBGene00000085","X",9650999,9653116,2117
"81","WBGene00000086","X",751211,759732,8521
"82","WBGene00000088","I",14850054,14855827,5773
"83","WBGene00000089","I",13543079,13545188,2109
"84","WBGene00000090","II",11519323,11527062,7739
"85","WBGene00000092","X",5289728,5303512,13784
"86","WBGene00000093","IV",13368368,13369417,1049
"87","WBGene00000094","II",5371980,5373433,1453
"88","WBGene00000095","I",10193925,10197000,3075
"89","WBGene00000096","I",9522578,9531130,8552
"90","WBGene00000097","V",14012333,14013644,1311
"91","WBGene00000098","V",8221410,8223587,2177
"92","WBGene00000099","I",5937477,5938885,1408
"93","WBGene00000100","X",9078945,9113613,34668
"94","WBGene00000101","II",7472729,7478959,6230
"95","WBGene00000102","V",10248907,10252895,3988
"96","WBGene00000103","X",14147700,14152070,4370
"97","WBGene00000105","X",13949114,13956261,7147
"98","WBGene00000106","II",873176,879001,5825
"99","WBGene00000107","III",5077765,5080665,2900
"100","WBGene00000108","V",1644169,1647728,3559
"101","WBGene00000109","IV",11022603,11025870,3267
"102","WBGene00000110","V",6427212,6429927,2715
"103","WBGene00000111","V",1996100,1999581,3481
"104","WBGene00000112","II",1306240,1310133,3893
"105","WBGene00000113","II",13485792,13491786,5994
"106","WBGene00000114","II",11728949,11731226,2277
"107","WBGene00000115","III",5856018,5859186,3168
"108","WBGene00000116","X",7140504,7143641,3137
"109","WBGene00000117","III",774321,778871,4550
"110","WBGene00000118","III",7454012,7455980,1968
"111","WBGene00000120","IV",9108931,9109753,822
"112","WBGene00000121","IV",9147468,9148579,1111
"113","WBGene00000122","IV",12123155,12124807,1652
"114","WBGene00000123","IV",4248020,4258173,10153
"115","WBGene00000133","X",4571448,4573914,2466
"116","WBGene00000134","IV",13042391,13046858,4467
"117","WBGene00000135","II",8363196,8369159,5963
"118","WBGene00000136","X",4565302,4569393,4091
"119","WBGene00000137","III",3822403,3826261,3858
"120","WBGene00000138","I",12759545,12764960,5415
"121","WBGene00000139","V",20898840,20903441,4601
"122","WBGene00000140","I",4318033,4359080,41047
"123","WBGene00000142","V",10127492,10130295,2803
"124","WBGene00000143","III",8080570,8083701,3131
"125","WBGene00000144","V",10425362,10426399,1037
"126","WBGene00000145","III",4593769,4594426,657
"127","WBGene00000146","V",11675942,11685268,9326
"128","WBGene00000147","I",9232071,9233560,1489
"129","WBGene00000148","I",10340997,10345648,4651
"130","WBGene00000149","X",5112422,5116866,4444
"131","WBGene00000150","I",5342180,5344724,2544
"132","WBGene00000151","II",8047564,8049105,1541
"133","WBGene00000155","I",4964667,4967089,2422
"134","WBGene00000156","I",8050043,8055489,5446
"135","WBGene00000157","X",4458272,4459264,992
"136","WBGene00000158","I",14406028,14417942,11914
"137","WBGene00000159","V",6017970,6018886,916
"138","WBGene00000160","III",2583953,2597034,13081
"139","WBGene00000161","X",9336819,9342970,6151
"140","WBGene00000162","II",3532527,3546431,13904
"141","WBGene00000163","I",7853750,7857850,4100
"142","WBGene00000164","X",954839,957762,2923
"143","WBGene00000165","I",1154511,1156020,1509
"144","WBGene00000166","X",11068527,11071925,3398
"145","WBGene00000168","V",3210189,3223218,13029
"146","WBGene00000169","II",7235834,7238349,2515
"147","WBGene00000170","II",9258913,9261994,3081
"148","WBGene00000171","IV",10961355,10966459,5104
"149","WBGene00000172","V",9737556,9739740,2184
"150","WBGene00000173","V",10491743,10493268,1525
"151","WBGene00000174","V",10648446,10651952,3506
"152","WBGene00000175","X",3025505,3026976,1471
"153","WBGene00000176","X",4702442,4704970,2528
"154","WBGene00000177","I",9605896,9609025,3129
"155","WBGene00000178","II",9768357,9769847,1490
"156","WBGene00000179","III",13673280,13674746,1466
"157","WBGene00000180","II",9674978,9677210,2232
"158","WBGene00000181","IV",11131279,11133785,2506
"159","WBGene00000182","III",5714861,5717585,2724
"160","WBGene00000183","IV",7982526,7983919,1393
"161","WBGene00000184","IV",16947120,16949734,2614
"162","WBGene00000185","X",1786907,1788405,1498
"163","WBGene00000186","IV",12622093,12631022,8929
"164","WBGene00000187","II",8581945,8583080,1135
"165","WBGene00000188","II",14606472,14608342,1870
"166","WBGene00000189","III",9823242,9824132,890
"167","WBGene00000190","IV",7634786,7635710,924
"168","WBGene00000191","X",14980954,14981675,721
"169","WBGene00000192","IV",14798149,14799229,1080
"170","WBGene00000193","III",4813309,4814814,1505
"171","WBGene00000195","X",950782,954233,3451
"172","WBGene00000196","II",11460215,11464129,3914
"173","WBGene00000197","I",3983171,3986915,3744
"174","WBGene00000198","II",6970668,6972235,1567
"175","WBGene00000199","I",2883546,2893718,10172
"176","WBGene00000200","V",10335443,10338355,2912
"177","WBGene00000201","III",12052424,12058458,6034
"178","WBGene00000202","III",860198,861324,1126
"179","WBGene00000203","III",12816789,12818100,1311
"180","WBGene00000204","III",4878658,4879643,985
"181","WBGene00000205","I",3069325,3070150,825
"182","WBGene00000206","III",4594543,4595944,1401
"183","WBGene00000207","X",4469743,4471476,1733
"184","WBGene00000208","II",15039404,15048904,9500
"185","WBGene00000209","I",8692946,8693468,522
"186","WBGene00000210","X",6841258,6842129,871
"187","WBGene00000211","II",6910031,6912697,2666
"188","WBGene00000212","X",11321079,11324251,3172
"189","WBGene00000213","IV",520214,523809,3595
"190","WBGene00000214","V",19049461,19050825,1364
"191","WBGene00000215","V",9203077,9204734,1657
"192","WBGene00000216","X",6791064,6792715,1651
"193","WBGene00000217","X",13218977,13221462,2485
"194","WBGene00000218","V",8272375,8274046,1671
"195","WBGene00000219","V",8267511,8268937,1426
"196","WBGene00000220","II",8751986,8753939,1953
"197","WBGene00000221","X",14808846,14810849,2003
"198","WBGene00000222","X",12480948,12484904,3956
"199","WBGene00000223","III",4491627,4499043,7416
"200","WBGene00000224","IV",17269342,17272183,2841
"201","WBGene00000225","II",14640096,14644083,3987
"202","WBGene00000226","V",9634861,9645595,10734
"203","WBGene00000227","I",183364,208465,25101
"204","WBGene00000228","V",12478413,12484442,6029
"205","WBGene00000229","III",5228417,5230536,2119
"206","WBGene00000230","I",5428469,5429908,1439
"207","WBGene00000231","III",10461389,10468051,6662
"208","WBGene00000232","I",5967250,5973320,6070
"209","WBGene00000233","V",13498786,13511718,12932
"210","WBGene00000235","III",9467464,9468058,594
"211","WBGene00000236","I",6563629,6564451,822
"212","WBGene00000237","I",2949600,2957910,8310
"213","WBGene00000238","X",7166005,7170625,4620
"214","WBGene00000239","III",5612274,5614700,2426
"215","WBGene00000240","II",8762668,8766922,4254
"216","WBGene00000241","I",14371142,14376025,4883
"217","WBGene00000242","IV",7934097,7937746,3649
"218","WBGene00000244","V",6762476,6765072,2596
"219","WBGene00000245","X",6201875,6204922,3047
"220","WBGene00000246","IV",11086074,11092552,6478
"221","WBGene00000247","IV",5661141,5664425,3284
"222","WBGene00000248","III",3537688,3541628,3940
"223","WBGene00000249","V",11644760,11645370,610
"224","WBGene00000250","V",13568850,13570030,1180
"225","WBGene00000251","II",10708765,10712156,3391
"226","WBGene00000252","II",5651394,5652449,1055
"227","WBGene00000253","I",146486,154850,8364
"228","WBGene00000254","I",6342231,6356678,14447
"229","WBGene00000255","III",13427642,13429713,2071
"230","WBGene00000256","IV",6377065,6378195,1130
"231","WBGene00000257","V",14453305,14456998,3693
"232","WBGene00000259","II",6274115,6279699,5584
"233","WBGene00000262","X",13598449,13599687,1238
"234","WBGene00000263","III",909957,910589,632
"235","WBGene00000264","III",3853026,3862958,9932
"236","WBGene00000265","III",6885204,6889523,4319
"237","WBGene00000266","IV",8987130,8990444,3314
"238","WBGene00000267","III",13134014,13139614,5600
"239","WBGene00000268","III",9469920,9485451,15531
"240","WBGene00000269","I",1621346,1628476,7130
"241","WBGene00000270","IV",12049862,12051226,1364
"242","WBGene00000271","II",7305861,7308738,2877
"243","WBGene00000272","I",5186926,5188995,2069
"244","WBGene00000273","III",12020552,12025325,4773
"245","WBGene00000274","II",13200165,13215701,15536
"246","WBGene00000275","I",7251941,7255223,3282
"247","WBGene00000276","III",6932001,6935862,3861
"248","WBGene00000277","X",12199655,12213049,13394
"249","WBGene00000279","III",5083206,5085289,2083
"250","WBGene00000280","II",7480751,7483109,2358
"251","WBGene00000281","X",16487481,16489397,1916
"252","WBGene00000282","X",13542574,13544599,2025
"253","WBGene00000283","X",7020033,7023950,3917
"254","WBGene00000284","I",3629471,3631112,1641
"255","WBGene00000285","V",12514875,12517205,2330
"256","WBGene00000286","II",8960714,8961577,863
"257","WBGene00000287","IV",3829546,3835165,5619
"258","WBGene00000288","IV",10521422,10530597,9175
"259","WBGene00000289","II",9295918,9310304,14386
"260","WBGene00000292","IV",7228403,7230223,1820
"261","WBGene00000293","II",10869196,10870827,1631
"262","WBGene00000294","X",16807461,16813673,6212
"263","WBGene00000295","X",5705719,5710625,4906
"264","WBGene00000296","II",257819,261063,3244
"265","WBGene00000298","V",10564880,10566445,1565
"266","WBGene00000301","IV",9772510,9773470,960
"267","WBGene00000302","V",13557104,13559922,2818
"268","WBGene00000308","X",13665555,13665673,118
"269","WBGene00000310","X",11163358,11163439,81
"270","WBGene00000366","III",9766516,9774825,8309
"271","WBGene00000367","X",7847682,7875954,28272
"272","WBGene00000368","I",3641668,3647009,5341
"273","WBGene00000369","III",11918828,11920237,1409
"274","WBGene00000370","IV",15270160,15275835,5675
"275","WBGene00000371","I",9788749,9790050,1301
"276","WBGene00000372","II",9803620,9805510,1890
"277","WBGene00000373","V",5421018,5423488,2470
"278","WBGene00000374","IV",9101773,9103851,2078
"279","WBGene00000375","II",5503966,5506115,2149
"280","WBGene00000376","IV",12361542,12371852,10310
"281","WBGene00000377","II",8185443,8187601,2158
"282","WBGene00000378","II",8927741,8929820,2079
"283","WBGene00000379","II",8283667,8285711,2044
"284","WBGene00000380","III",4499191,4508114,8923
"285","WBGene00000381","III",5853532,5855687,2155
"286","WBGene00000382","I",4268070,4270287,2217
"287","WBGene00000383","II",5589186,5593628,4442
"288","WBGene00000386","I",6469386,6471995,2609
"289","WBGene00000387","V",1567076,1585532,18456
"290","WBGene00000388","III",8916351,8917929,1578
"291","WBGene00000389","II",10188263,10189469,1206
"292","WBGene00000390","II",7616452,7618245,1793
"293","WBGene00000391","X",8208748,8211149,2401
"294","WBGene00000392","IV",7547118,7547893,775
"295","WBGene00000393","X",6499928,6504613,4685
"296","WBGene00000395","III",7741326,7754448,13122
"297","WBGene00000396","III",4520363,4536991,16628
"298","WBGene00000397","IV",8668941,8676542,7601
"299","WBGene00000399","II",14843177,14850905,7728
"300","WBGene00000401","X",16595238,16602238,7000
"301","WBGene00000402","IV",2436505,2463405,26900
"302","WBGene00000403","II",5945418,5956683,11265
"303","WBGene00000405","III",9747432,9748852,1420
"304","WBGene00000406","X",13515871,13518911,3040
"305","WBGene00000407","III",13464687,13466390,1703
"306","WBGene00000408","I",2281504,2291183,9679
"307","WBGene00000409","I",8702478,8705825,3347
"308","WBGene00000410","I",11323527,11333152,9625
"309","WBGene00000411","II",10785452,10787272,1820
"310","WBGene00000412","V",15921309,15922818,1509
"311","WBGene00000413","I",3223160,3228104,4944
"312","WBGene00000414","III",8426334,8428583,2249
"313","WBGene00000415","I",11851566,11868105,16539
"314","WBGene00000416","IV",1597316,1601620,4304
"315","WBGene00000417","IV",13198372,13204133,5761
"316","WBGene00000418","III",4852313,4855177,2864
"317","WBGene00000419","IV",10484110,10492952,8842
"318","WBGene00000420","III",5595771,5598066,2295
"319","WBGene00000421","III",9570394,9580081,9687
"320","WBGene00000422","X",8414015,8416919,2904
"321","WBGene00000423","III",10335172,10337536,2364
"322","WBGene00000424","IV",3506328,3509527,3199
"323","WBGene00000425","III",9119559,9125153,5594
"324","WBGene00000426","I",10222881,10227009,4128
"325","WBGene00000427","X",8299119,8299654,535
"326","WBGene00000428","X",4653434,4654157,723
"327","WBGene00000429","I",6046832,6050462,3630
"328","WBGene00000430","I",9727169,9728034,865
"329","WBGene00000431","I",8498114,8502412,4298
"330","WBGene00000432","II",8703368,8703829,461
"331","WBGene00000433","I",8245722,8250896,5174
"332","WBGene00000434","I",565436,566414,978
"333","WBGene00000435","III",5799073,5801109,2036
"334","WBGene00000436","I",5840289,5841888,1599
"335","WBGene00000437","III",7555617,7558208,2591
"336","WBGene00000438","X",7528616,7532732,4116
"337","WBGene00000439","III",8622658,8626312,3654
"338","WBGene00000440","I",4568962,4570027,1065
"339","WBGene00000441","X",3843367,3857797,14430
"340","WBGene00000442","IV",7953509,7955898,2389
"341","WBGene00000443","III",6979884,6981785,1901
"342","WBGene00000444","X",1848795,1852736,3941
"343","WBGene00000445","V",10672459,10675644,3185
"344","WBGene00000446","III",7839594,7841491,1897
"345","WBGene00000447","V",13813309,13815272,1963
"346","WBGene00000448","III",8067289,8071455,4166
"347","WBGene00000449","V",11661670,11665085,3415
"348","WBGene00000450","X",13074682,13076092,1410
"349","WBGene00000451","X",3063585,3065551,1966
"350","WBGene00000452","X",3068650,3070396,1746
"351","WBGene00000453","V",11701764,11705400,3636
"352","WBGene00000454","V",5323204,5324616,1412
"353","WBGene00000455","V",5315513,5319577,4064
"354","WBGene00000457","X",14183449,14185597,2148
"355","WBGene00000458","X",14197373,14209153,11780
"356","WBGene00000459","II",6951640,6955399,3759
"357","WBGene00000460","X",1853874,1856189,2315
"358","WBGene00000461","X",12318240,12320777,2537
"359","WBGene00000462","X",1846608,1848675,2067
"360","WBGene00000463","III",4446637,4449943,3306
"361","WBGene00000464","III",2530615,2546420,15805
"362","WBGene00000465","III",4489359,4491392,2033
"363","WBGene00000466","I",9665194,9668664,3470
"364","WBGene00000467","I",8324120,8328853,4733
"365","WBGene00000468","I",8633925,8636044,2119
"366","WBGene00000469","I",14961501,14965361,3860
"367","WBGene00000472","II",11039348,11041206,1858
"368","WBGene00000473","I",5619569,5620668,1099
"369","WBGene00000474","I",5571787,5573019,1232
"370","WBGene00000475","III",10866870,10868727,1857
"371","WBGene00000476","I",9994731,9999928,5197
"372","WBGene00000477","V",5538800,5545766,6966
"373","WBGene00000478","V",3441504,3444877,3373
"374","WBGene00000479","III",7495320,7497832,2512
"375","WBGene00000480","V",118043,122966,4923
"376","WBGene00000481","IV",3613934,3624697,10763
"377","WBGene00000482","X",12846437,12852601,6164
"378","WBGene00000483","I",6517575,6520879,3304
"379","WBGene00000484","X",481378,486504,5126
"380","WBGene00000485","I",8062059,8081671,19612
"381","WBGene00000487","IV",2104056,2111408,7352
"382","WBGene00000488","V",7961539,7968899,7360
"383","WBGene00000490","V",12144295,12150689,6394
"384","WBGene00000491","V",10299473,10307354,7881
"385","WBGene00000492","I",10507000,10515506,8506
"386","WBGene00000493","I",5746633,5754278,7645
"387","WBGene00000496","I",7554855,7559916,5061
"388","WBGene00000497","II",196985,211941,14956
"389","WBGene00000498","V",3757047,3759469,2422
"390","WBGene00000499","V",19908765,19916023,7258
"391","WBGene00000500","I",6181314,6183913,2599
"392","WBGene00000501","IV",13209729,13214566,4837
"393","WBGene00000502","I",5103581,5104956,1375
"394","WBGene00000503","X",3397613,3400017,2404
"395","WBGene00000506","III",2394325,2401308,6983
"396","WBGene00000507","III",8005935,8009821,3886
"397","WBGene00000508","III",8010778,8013774,2996
"398","WBGene00000509","IV",9731737,9737621,5884
"399","WBGene00000510","X",4286737,4291494,4757
"400","WBGene00000511","III",4365285,4367469,2184
"401","WBGene00000512","III",4367832,4370160,2328
"402","WBGene00000513","III",4370885,4372820,1935
"403","WBGene00000514","V",2106398,2109418,3020
"404","WBGene00000515","X",3576608,3578830,2222
"405","WBGene00000516","II",7811240,7812105,865
"406","WBGene00000517","II",7816509,7820301,3792
"407","WBGene00000518","III",5635479,5654558,19079
"408","WBGene00000519","III",11154827,11168820,13993
"409","WBGene00000520","III",4419848,4423368,3520
"410","WBGene00000521","V",12736703,12741211,4508
"411","WBGene00000522","X",11047446,11049271,1825
"412","WBGene00000523","X",7431472,7433548,2076
"413","WBGene00000524","X",3373247,3374740,1493
"414","WBGene00000525","X",10782996,10783907,911
"415","WBGene00000526","X",7433632,7435733,2101
"416","WBGene00000527","I",8705670,8724279,18609
"417","WBGene00000528","II",11846508,11854743,8235
"418","WBGene00000529","II",11358447,11370311,11864
"419","WBGene00000530","II",7217955,7225648,7693
"420","WBGene00000531","X",4094867,4100573,5706
"421","WBGene00000532","II",9094710,9098605,3895
"422","WBGene00000533","V",12060234,12063368,3134
"423","WBGene00000534","V",6044028,6045671,1643
"424","WBGene00000535","IV",6092603,6093680,1077
"425","WBGene00000536","III",5277894,5279344,1450
"426","WBGene00000539","V",11263523,11265711,2188
"427","WBGene00000540","I",5274693,5278708,4015
"428","WBGene00000541","V",8682955,8686160,3205
"429","WBGene00000542","III",7980913,7986327,5414
"430","WBGene00000543","III",4700325,4704054,3729
"431","WBGene00000544","I",12073143,12084221,11078
"432","WBGene00000545","III",1807740,1818323,10583
"433","WBGene00000546","IV",1431272,1435039,3767
"434","WBGene00000547","IV",1435465,1446182,10717
"435","WBGene00000548","II",5466363,5473812,7449
"436","WBGene00000549","III",9055052,9058882,3830
"437","WBGene00000550","III",9516631,9521460,4829
"438","WBGene00000551","IV",7734647,7736409,1762
"439","WBGene00000552","V",1156271,1158174,1903
"440","WBGene00000553","IV",1824481,1834029,9548
"441","WBGene00000554","V",11375742,11377990,2248
"442","WBGene00000555","V",1444044,1444280,236
"443","WBGene00000556","V",1449665,1450189,524
"444","WBGene00000557","V",1448004,1448790,786
"445","WBGene00000558","V",1447195,1447707,512
"446","WBGene00000559","V",1445381,1445832,451
"447","WBGene00000560","III",1763524,1764836,1312
"448","WBGene00000561","III",5240593,5242108,1515
"449","WBGene00000562","V",15025740,15031473,5733
"450","WBGene00000563","IV",9477522,9481037,3515
"451","WBGene00000564","III",10271257,10278579,7322
"452","WBGene00000565","II",12072082,12088868,16786
"453","WBGene00000566","III",10655018,10677521,22503
"454","WBGene00000567","III",9814364,9817137,2773
"455","WBGene00000583","I",6250475,6252834,2359
"456","WBGene00000584","II",14902493,14907533,5040
"457","WBGene00000585","IV",7036960,7039580,2620
"458","WBGene00000591","X",7465193,7475014,9821
"459","WBGene00000592","V",14457475,14460136,2661
"460","WBGene00000593","IV",10084454,10085438,984
"461","WBGene00000594","IV",8824783,8826013,1230
"462","WBGene00000596","I",7401674,7402753,1079
"463","WBGene00000597","III",7019583,7020600,1017
"464","WBGene00000598","X",13590035,13591207,1172
"465","WBGene00000599","V",9164297,9165307,1010
"466","WBGene00000601","V",10423907,10425092,1185
"467","WBGene00000602","V",10420890,10421892,1002
"468","WBGene00000603","IV",7753408,7754651,1243
"469","WBGene00000606","II",4866436,4867576,1140
"470","WBGene00000608","X",421707,423033,1326
"471","WBGene00000609","II",4869607,4870791,1184
"472","WBGene00000610","IV",4263293,4265202,1909
"473","WBGene00000611","IV",4243548,4244610,1062
"474","WBGene00000612","I",7385907,7386935,1028
"475","WBGene00000613","II",7167513,7168662,1149
"476","WBGene00000614","V",12166706,12167753,1047
"477","WBGene00000615","II",8568035,8569089,1054
"478","WBGene00000616","II",10704902,10706019,1117
"479","WBGene00000617","II",1104945,1106925,1980
"480","WBGene00000618","X",15175035,15176481,1446
"481","WBGene00000620","V",8049744,8050893,1149
"482","WBGene00000621","X",13591498,13592461,963
"483","WBGene00000622","I",115739,117438,1699
"484","WBGene00000623","I",741913,745570,3657
"485","WBGene00000624","I",745859,748288,2429
"486","WBGene00000625","I",3010688,3011648,960
"487","WBGene00000626","I",3137185,3138447,1262
"488","WBGene00000627","I",3651230,3652599,1369
"489","WBGene00000628","I",3653997,3655265,1268
"490","WBGene00000629","I",4571214,4572787,1573
"491","WBGene00000630","I",5644729,5646370,1641
"492","WBGene00000631","I",5842709,5844050,1341
"493","WBGene00000632","I",6199673,6200193,520
"494","WBGene00000633","I",6232777,6234280,1503
"495","WBGene00000634","I",6311229,6312413,1184
"496","WBGene00000636","I",7105302,7106926,1624
"497","WBGene00000637","I",7202242,7203533,1291
"498","WBGene00000638","I",7403291,7404374,1083
"499","WBGene00000639","I",8243695,8244963,1268
"500","WBGene00000640","I",9893698,9895596,1898
"501","WBGene00000641","I",11489158,11490630,1472
"502","WBGene00000642","I",11559446,11560565,1119
"503","WBGene00000644","II",104534,105833,1299
"504","WBGene00000645","II",303924,305530,1606
"505","WBGene00000646","II",1470565,1472260,1695
"506","WBGene00000647","II",3500077,3502449,2372
"507","WBGene00000648","II",3520703,3524180,3477
"508","WBGene00000649","II",4872098,4873127,1029
"509","WBGene00000650","II",5830867,5832014,1147
"510","WBGene00000651","II",6426293,6427513,1220
"511","WBGene00000652","II",8204341,8207491,3150
"512","WBGene00000653","II",8358228,8359381,1153
"513","WBGene00000654","II",9152531,9154310,1779
"514","WBGene00000655","II",10703596,10704572,976
"515","WBGene00000656","II",10707201,10708286,1085
"516","WBGene00000657","II",11012397,11013820,1423
"517","WBGene00000658","II",11044135,11045968,1833
"518","WBGene00000659","II",11868535,11869688,1153
"519","WBGene00000660","II",12493800,12495106,1306
"520","WBGene00000661","II",13096009,13098275,2266
"521","WBGene00000662","II",14090075,14094690,4615
"522","WBGene00000663","III",41061,42021,960
"523","WBGene00000664","III",4748127,4749164,1037
"524","WBGene00000665","III",7948838,7950068,1230
"525","WBGene00000666","III",8262355,8263664,1309
"526","WBGene00000667","III",10982166,10983253,1087
"527","WBGene00000668","III",10984555,10985609,1054
"528","WBGene00000669","III",10986826,10987873,1047
"529","WBGene00000670","III",11703885,11705091,1206
"530","WBGene00000671","III",11705713,11706644,931
"531","WBGene00000672","III",12992405,12993707,1302
"532","WBGene00000673","III",13018935,13020226,1291
"533","WBGene00000674","IV",138346,147919,9573
"534","WBGene00000675","IV",325437,326711,1274
"535","WBGene00000676","IV",604444,605876,1432
"536","WBGene00000677","IV",762416,763680,1264
"537","WBGene00000678","IV",1353636,1355305,1669
"538","WBGene00000679","IV",1357816,1359225,1409
"539","WBGene00000680","IV",1459866,1460786,920
"540","WBGene00000681","IV",1548721,1549714,993
"541","WBGene00000682","IV",1768621,1769667,1046
"542","WBGene00000683","IV",1817311,1820253,2942
"543","WBGene00000684","IV",4608201,4609679,1478
"544","WBGene00000685","IV",4655776,4657783,2007
"545","WBGene00000687","IV",7150663,7152501,1838
"546","WBGene00000688","IV",7245505,7246640,1135
"547","WBGene00000689","IV",7988685,7991425,2740
"548","WBGene00000690","IV",8356776,8357854,1078
"549","WBGene00000691","IV",8822962,8824195,1233
"550","WBGene00000692","IV",8848182,8849673,1491
"551","WBGene00000693","IV",8978823,8979812,989
"552","WBGene00000694","IV",9260610,9261787,1177
"553","WBGene00000695","IV",9394934,9396218,1284
"554","WBGene00000696","IV",9563360,9564441,1081
"555","WBGene00000697","IV",9821895,9823112,1217
"556","WBGene00000698","IV",10216450,10217643,1193
"557","WBGene00000699","IV",11225505,11226519,1014
"558","WBGene00000700","IV",11263401,11264331,930
"559","WBGene00000701","IV",11264947,11265877,930
"560","WBGene00000702","IV",11550002,11551987,1985
"561","WBGene00000703","IV",12108672,12110275,1603
"562","WBGene00000704","IV",12427506,12428522,1016
"563","WBGene00000705","IV",13065766,13067300,1534
"564","WBGene00000706","IV",13089578,13091067,1489
"565","WBGene00000707","IV",14098325,14099368,1043
"566","WBGene00000708","IV",15129666,15131797,2131
"567","WBGene00000709","IV",16551492,16554348,2856
"568","WBGene00000710","IV",16601480,16602776,1296
"569","WBGene00000711","IV",17182798,17183740,942
"570","WBGene00000712","V",4652863,4654007,1144
"571","WBGene00000713","V",5835855,5836871,1016
"572","WBGene00000714","V",6829666,6830721,1055
"573","WBGene00000715","V",6831163,6832256,1093
"574","WBGene00000716","V",6835635,6836700,1065
"575","WBGene00000717","V",9159642,9160642,1000
"576","WBGene00000718","V",9162051,9163005,954
"577","WBGene00000719","V",9629943,9631012,1069
"578","WBGene00000720","V",9632029,9633338,1309
"579","WBGene00000721","V",10241784,10242718,934
"580","WBGene00000722","V",10291697,10292869,1172
"581","WBGene00000723","V",10293563,10294623,1060
"582","WBGene00000724","V",10393531,10395232,1701
"583","WBGene00000725","V",10560921,10562150,1229
"584","WBGene00000726","V",10949857,10951821,1964
"585","WBGene00000727","V",11385360,11386529,1169
"586","WBGene00000728","V",11388852,11389876,1024
"587","WBGene00000729","V",11449223,11450357,1134
"588","WBGene00000730","V",11484032,11484998,966
"589","WBGene00000731","V",11829582,11831220,1638
"590","WBGene00000732","V",13198230,13199315,1085
"591","WBGene00000733","V",13200982,13202192,1210
"592","WBGene00000734","V",13317028,13318011,983
"593","WBGene00000735","V",13441967,13443402,1435
"594","WBGene00000736","V",20600095,20602474,2379
"595","WBGene00000737","X",2093475,2094842,1367
"596","WBGene00000738","X",4353618,4354820,1202
"597","WBGene00000739","X",6279801,6281015,1214
"598","WBGene00000740","X",6323297,6324539,1242
"599","WBGene00000741","X",6326191,6327375,1184
"600","WBGene00000742","X",6329160,6330127,967
"601","WBGene00000743","X",6331620,6332686,1066
"602","WBGene00000744","X",6334298,6335221,923
"603","WBGene00000745","X",6672830,6674407,1577
"604","WBGene00000746","X",6875131,6877536,2405
"605","WBGene00000747","X",7546842,7548365,1523
"606","WBGene00000748","X",9233638,9234618,980
"607","WBGene00000749","X",10077597,10078602,1005
"608","WBGene00000750","X",10999742,11001850,2108
"609","WBGene00000751","X",11199455,11200464,1009
"610","WBGene00000752","X",11201465,11202488,1023
"611","WBGene00000753","X",11711307,11712280,973
"612","WBGene00000754","X",12104930,12106081,1151
"613","WBGene00000755","X",12636153,12637056,903
"614","WBGene00000756","X",13466737,13467736,999
"615","WBGene00000757","X",13469387,13470471,1084
"616","WBGene00000758","X",13510110,13511097,987
"617","WBGene00000759","X",15951503,15954570,3067
"618","WBGene00000760","X",16072903,16074852,1949
"619","WBGene00000761","I",5412841,5415629,2788
"620","WBGene00000762","III",6935967,6939443,3476
"621","WBGene00000763","IV",14793119,14796375,3256
"622","WBGene00000764","I",3869214,3870114,900
"623","WBGene00000765","III",7857315,7858457,1142
"624","WBGene00000766","V",9336762,9338858,2096
"625","WBGene00000767","III",4863427,4866949,3522
"626","WBGene00000768","III",10249111,10254709,5598
"627","WBGene00000770","III",9322316,9324733,2417
"628","WBGene00000771","II",6192784,6195170,2386
"629","WBGene00000772","I",5788634,5791752,3118
"630","WBGene00000773","II",8600435,8602479,2044
"631","WBGene00000774","III",13266874,13268897,2023
"632","WBGene00000775","IV",9451338,9453372,2034
"633","WBGene00000776","V",16592572,16595346,2774
"634","WBGene00000777","I",8636123,8637971,1848
"635","WBGene00000778","II",337339,339248,1909
"636","WBGene00000779","I",3987842,3988699,857
"637","WBGene00000780","I",10924240,10925753,1513
"638","WBGene00000781","V",11975515,11976756,1241
"639","WBGene00000782","V",16533004,16534110,1106
"640","WBGene00000783","V",15296853,15298700,1847
"641","WBGene00000784","V",6614674,6615845,1171
"642","WBGene00000785","V",1132598,1134036,1438
"643","WBGene00000786","X",6607203,6609045,1842
"644","WBGene00000787","I",4446577,4448461,1884
"645","WBGene00000788","I",2686639,2689493,2854
"646","WBGene00000789","V",13381189,13383077,1888
"647","WBGene00000792","X",17402540,17414014,11474
"648","WBGene00000793","III",11657738,11693837,36099
"649","WBGene00000794","I",3481987,3484499,2512
"650","WBGene00000795","V",5594615,5595842,1227
"651","WBGene00000796","II",10588042,10592652,4610
"652","WBGene00000797","X",2255852,2258101,2249
"653","WBGene00000798","II",10592752,10593591,839
"654","WBGene00000799","III",9367238,9370385,3147
"655","WBGene00000800","I",2623102,2628577,5475
"656","WBGene00000801","I",2629685,2632320,2635
"657","WBGene00000802","V",6098993,6100553,1560
"658","WBGene00000803","X",15861294,15865918,4624
"659","WBGene00000804","II",13596955,13598068,1113
"660","WBGene00000812","I",71425,81071,9646
"661","WBGene00000813","V",17861368,17870651,9283
"662","WBGene00000814","I",6022660,6026874,4214
"663","WBGene00000815","IV",194745,202586,7841
"664","WBGene00000816","IV",1077463,1087013,9550
"665","WBGene00000817","IV",5649533,5651079,1546
"666","WBGene00000818","IV",13300828,13304145,3317
"667","WBGene00000819","II",13601204,13605057,3853
"668","WBGene00000820","IV",6307739,6315719,7980
"669","WBGene00000821","I",11888501,11890558,2057
"670","WBGene00000822","X",14684877,14688322,3445
"671","WBGene00000829","MtDNA",4504,5621,1117
"672","WBGene00000830","II",14303612,14306329,2717
"673","WBGene00000831","II",14299553,14302083,2530
"674","WBGene00000832","I",2606754,2617360,10606
"675","WBGene00000833","III",10214814,10216635,1821
"676","WBGene00000834","III",13439730,13455307,15577
"677","WBGene00000835","III",7860466,7861004,538
"678","WBGene00000836","III",10471237,10475245,4008
"679","WBGene00000837","III",13687269,13692683,5414
"680","WBGene00000838","V",177421,184966,7545
"681","WBGene00000839","II",7302101,7305760,3659
"682","WBGene00000840","V",10179535,10183154,3619
"683","WBGene00000841","IV",12586511,12590428,3917
"684","WBGene00000843","I",10398944,10400195,1251
"685","WBGene00000845","III",7866509,7868732,2223
"686","WBGene00000846","III",7584181,7591570,7389
"687","WBGene00000851","II",11269124,11271599,2475
"688","WBGene00000853","III",10911460,10916567,5107
"689","WBGene00000854","III",7518628,7520845,2217
"690","WBGene00000857","II",130983,133598,2615
"691","WBGene00000858","IV",10067824,10070251,2427
"692","WBGene00000859","V",4840619,4841269,650
"693","WBGene00000860","V",4841940,4842567,627
"694","WBGene00000861","V",4842836,4843845,1009
"695","WBGene00000862","V",5053619,5056473,2854
"696","WBGene00000863","III",9106702,9109272,2570
"697","WBGene00000864","II",2022673,2023614,941
"698","WBGene00000865","IV",10735259,10737177,1918
"699","WBGene00000866","IV",10985985,10987426,1441
"700","WBGene00000867","I",4114734,4116370,1636
"701","WBGene00000868","V",15395696,15397348,1652
"702","WBGene00000869","I",8022674,8024422,1748
"703","WBGene00000870","II",12980591,12993118,12527
"704","WBGene00000871","I",6780806,6784396,3590
"705","WBGene00000872","III",7023642,7029203,5561
"706","WBGene00000874","III",6020165,6024659,4494
"707","WBGene00000875","III",13768541,13771242,2701
"708","WBGene00000876","V",11991011,11993767,2756
"709","WBGene00000877","V",14356076,14356823,747
"710","WBGene00000878","III",13692668,13693811,1143
"711","WBGene00000879","V",15189927,15190926,999
"712","WBGene00000880","II",10870779,10872611,1832
"713","WBGene00000881","I",15040427,15041274,847
"714","WBGene00000882","III",773403,774159,756
"715","WBGene00000883","V",15186582,15187787,1205
"716","WBGene00000884","X",8911293,8914261,2968
"717","WBGene00000885","III",3697821,3699640,1819
"718","WBGene00000886","II",6912543,6913365,822
"719","WBGene00000887","II",8715132,8716281,1149
"720","WBGene00000888","IV",7132132,7133217,1085
"721","WBGene00000889","IV",17111082,17116666,5584
"722","WBGene00000890","I",8646451,8651777,5326
"723","WBGene00000891","I",13566258,13572063,5805
"724","WBGene00000892","II",12028763,12036742,7979
"725","WBGene00000893","V",5799673,5805666,5993
"726","WBGene00000894","II",8226132,8229122,2990
"727","WBGene00000895","III",816145,821730,5585
"728","WBGene00000896","I",6553481,6554290,809
"729","WBGene00000897","IV",132416,138076,5660
"730","WBGene00000898","III",2995487,3040860,45373
"731","WBGene00000899","X",817927,825475,7548
"732","WBGene00000900","III",5625014,5632322,7308
"733","WBGene00000901","II",14033233,14037721,4488
"734","WBGene00000902","X",14888488,14894297,5809
"735","WBGene00000903","III",811828,813773,1945
"736","WBGene00000904","I",8584081,8587505,3424
"737","WBGene00000905","X",6196927,6200818,3891
"738","WBGene00000906","IV",9136933,9146210,9277
"739","WBGene00000907","V",11718089,11725652,7563
"740","WBGene00000908","X",10644409,10666874,22465
"741","WBGene00000910","IV",10250646,10255844,5198
"742","WBGene00000911","IV",9386208,9394930,8722
"743","WBGene00000912","I",10750343,10776700,26357
"744","WBGene00000913","IV",419938,425181,5243
"745","WBGene00000914","II",10157537,10169346,11809
"746","WBGene00000915","V",14684918,14688543,3625
"747","WBGene00000917","I",332611,337839,5228
"748","WBGene00000920","V",19815133,19816451,1318
"749","WBGene00000923","IV",8290273,8291496,1223
"750","WBGene00000928","II",4562853,4563546,693
"751","WBGene00000929","X",8084210,8086550,2340
"752","WBGene00000930","X",10075288,10076357,1069
"753","WBGene00000931","I",10187515,10190896,3381
"754","WBGene00000932","III",9735265,9736057,792
"755","WBGene00000933","II",10581133,10582519,1386
"756","WBGene00000934","III",9242914,9246802,3888
"757","WBGene00000935","II",5456305,5458609,2304
"758","WBGene00000936","V",6758135,6760418,2283
"759","WBGene00000937","I",6490716,6492727,2011
"760","WBGene00000938","I",7536204,7542157,5953
"761","WBGene00000939","III",8071916,8080281,8365
"762","WBGene00000940","V",20087848,20090743,2895
"763","WBGene00000941","III",1859888,1860381,493
"764","WBGene00000942","IV",7085216,7094364,9148
"765","WBGene00000950","X",7763187,7774915,11728
"766","WBGene00000951","V",11412870,11415159,2289
"767","WBGene00000952","X",14268081,14277040,8959
"768","WBGene00000953","IV",9636980,9642003,5023
"769","WBGene00000955","V",11415342,11420293,4951
"770","WBGene00000958","X",984581,991456,6875
"771","WBGene00000959","X",4494914,4504388,9474
"772","WBGene00000960","III",9163077,9168027,4950
"773","WBGene00000961","X",10920533,10928998,8465
"774","WBGene00000962","I",4386785,4401980,15195
"775","WBGene00000963","I",7238994,7243967,4973
"776","WBGene00000964","IV",9978122,9980770,2648
"777","WBGene00000965","I",5278803,5281526,2723
"778","WBGene00000966","I",5354160,5357026,2866
"779","WBGene00000967","I",8212362,8218361,5999
"780","WBGene00000968","I",9647603,9649238,1635
"781","WBGene00000969","II",5453847,5455977,2130
"782","WBGene00000970","II",5617122,5619319,2197
"783","WBGene00000971","II",7206990,7208460,1470
"784","WBGene00000972","II",14498026,14499755,1729
"785","WBGene00000973","III",5364512,5368045,3533
"786","WBGene00000974","III",10640828,10642872,2044
"787","WBGene00000975","IV",10145249,10146222,973
"788","WBGene00000976","V",1765311,1771734,6423
"789","WBGene00000977","V",2763981,2765274,1293
"790","WBGene00000978","V",2768419,2769854,1435
"791","WBGene00000979","V",5983745,5985473,1728
"792","WBGene00000980","V",6026330,6034923,8593
"793","WBGene00000981","V",11045696,11046899,1203
"794","WBGene00000982","V",11489050,11490328,1278
"795","WBGene00000983","V",11602294,11604563,2269
"796","WBGene00000984","V",12731772,12733645,1873
"797","WBGene00000985","V",14420071,14421450,1379
"798","WBGene00000986","V",15381097,15382305,1208
"799","WBGene00000987","V",19934795,19946629,11834
"800","WBGene00000988","X",1486473,1489326,2853
"801","WBGene00000989","X",3360722,3362493,1771
"802","WBGene00000990","X",3412876,3414708,1832
"803","WBGene00000991","X",6818438,6820080,1642
"804","WBGene00000992","X",7661891,7664919,3028
"805","WBGene00000993","X",17230719,17235838,5119
"806","WBGene00000994","IV",8692086,8696553,4467
"807","WBGene00000995","II",10061287,10074443,13156
"808","WBGene00000996","IV",7551550,7553008,1458
"809","WBGene00000998","III",6746308,6794764,48456
"810","WBGene00001000","X",8050476,8058220,7744
"811","WBGene00001001","IV",10097196,10106556,9360
"812","WBGene00001002","III",10245056,10248905,3849
"813","WBGene00001005","III",6462907,6463801,894
"814","WBGene00001006","X",5479700,5484941,5241
"815","WBGene00001007","IV",13096958,13098836,1878
"816","WBGene00001008","I",12565804,12572801,6997
"817","WBGene00001016","II",11778435,11782231,3796
"818","WBGene00001017","IV",10926730,10933203,6473
"819","WBGene00001018","III",5924394,5925754,1360
"820","WBGene00001019","IV",11299008,11304789,5781
"821","WBGene00001020","IV",11312437,11313980,1543
"822","WBGene00001021","V",15068678,15069504,826
"823","WBGene00001022","I",5282085,5283944,1859
"824","WBGene00001023","II",6853464,6858298,4834
"825","WBGene00001025","X",7194564,7198291,3727
"826","WBGene00001026","II",6594382,6598080,3698
"827","WBGene00001027","II",4852056,4857880,5824
"828","WBGene00001028","III",8631165,8633549,2384
"829","WBGene00001029","IV",6585871,6588186,2315
"830","WBGene00001030","I",14756858,14759354,2496
"831","WBGene00001031","II",11545563,11547366,1803
"832","WBGene00001032","X",4709772,4711744,1972
"833","WBGene00001033","IV",4176388,4178364,1976
"834","WBGene00001034","III",4191141,4193427,2286
"835","WBGene00001035","III",13390850,13393339,2489
"836","WBGene00001036","III",4697987,4699453,1466
"837","WBGene00001037","V",5503033,5504856,1823
"838","WBGene00001038","II",9617426,9624176,6750
"839","WBGene00001039","I",5676827,5677646,819
"840","WBGene00001040","V",8461096,8462116,1020
"841","WBGene00001041","II",9107382,9108600,1218
"842","WBGene00001042","III",5415556,5419565,4009
"843","WBGene00001043","V",20729948,20744385,14437
"844","WBGene00001044","IV",12251111,12252663,1552
"845","WBGene00001045","I",11877803,11887278,9475
"846","WBGene00001046","I",2996401,3001382,4981
"847","WBGene00001047","I",14104429,14113179,8750
"848","WBGene00001048","I",2718027,2721475,3448
"849","WBGene00001049","I",15017283,15023017,5734
"850","WBGene00001050","I",5003351,5005163,1812
"851","WBGene00001051","IV",8513919,8514725,806
"852","WBGene00001052","X",4411359,4416079,4720
"853","WBGene00001053","V",9608562,9614942,6380
"854","WBGene00001054","V",15471335,15476122,4787
"855","WBGene00001055","X",14831824,14838241,6417
"856","WBGene00001056","I",6838354,6843343,4989
"857","WBGene00001057","III",5859308,5861907,2599
"858","WBGene00001058","IV",4802702,4806586,3884
"859","WBGene00001059","III",8038241,8041374,3133
"860","WBGene00001060","IV",4799388,4802592,3204
"861","WBGene00001061","II",9169910,9172565,2655
"862","WBGene00001062","V",13940139,13942182,2043
"863","WBGene00001063","III",2035036,2048007,12971
"864","WBGene00001064","II",6714292,6715971,1679
"865","WBGene00001065","X",2144605,2145647,1042
"866","WBGene00001066","IV",14985543,14986784,1241
"867","WBGene00001067","I",5432158,5433054,896
"868","WBGene00001068","X",8450381,8455640,5259
"869","WBGene00001069","X",7536417,7537792,1375
"870","WBGene00001070","X",5148804,5150476,1672
"871","WBGene00001071","IV",257384,259204,1820
"872","WBGene00001072","II",6710156,6711866,1710
"873","WBGene00001073","V",6511588,6515240,3652
"874","WBGene00001074","IV",4235614,4236710,1096
"875","WBGene00001075","I",6843589,6845134,1545
"876","WBGene00001076","III",5107330,5108497,1167
"877","WBGene00001077","III",11372886,11377980,5094
"878","WBGene00001078","III",8659872,8667482,7610
"879","WBGene00001079","IV",11696443,11699895,3452
"880","WBGene00001080","V",17936332,17949184,12852
"881","WBGene00001081","X",9810202,9822273,12071
"882","WBGene00001082","X",4389365,4393796,4431
"883","WBGene00001085","IV",12445801,12451299,5498
"884","WBGene00001086","III",3813519,3819679,6160
"885","WBGene00001087","III",10763131,10777343,14212
"886","WBGene00001088","V",12191519,12192211,692
"887","WBGene00001089","V",6533614,6546491,12877
"888","WBGene00001090","IV",6607376,6613353,5977
"889","WBGene00001091","IV",6613918,6618498,4580
"890","WBGene00001092","III",13342684,13343337,653
"891","WBGene00001093","IV",5537981,5541365,3384
"892","WBGene00001094","III",9489176,9491236,2060
"893","WBGene00001095","V",12048745,12052182,3437
"894","WBGene00001096","X",15031353,15034541,3188
"895","WBGene00001099","IV",315056,320605,5549
"896","WBGene00001101","II",5214441,5225377,10936
"897","WBGene00001102","II",5078235,5081161,2926
"898","WBGene00001103","IV",1207255,1208102,847
"899","WBGene00001104","IV",1202651,1204970,2319
"900","WBGene00001105","IV",1610236,1612915,2679
"901","WBGene00001106","X",14090389,14095490,5101
"902","WBGene00001107","IV",11619502,11620938,1436
"903","WBGene00001108","IV",11396788,11398317,1529
"904","WBGene00001109","V",12993180,12994822,1642
"905","WBGene00001110","V",11554635,11558127,3492
"906","WBGene00001111","IV",112408,118629,6221
"907","WBGene00001112","I",10464328,10471056,6728
"908","WBGene00001113","IV",9921955,9928223,6268
"909","WBGene00001115","I",1483083,1490494,7411
"910","WBGene00001116","X",14049535,14063884,14349
"911","WBGene00001117","I",4989568,4994675,5107
"912","WBGene00001118","III",13674917,13686445,11528
"913","WBGene00001119","IV",3396581,3399123,2542
"914","WBGene00001121","I",9359075,9364180,5105
"915","WBGene00001122","X",10379693,10386508,6815
"916","WBGene00001123","X",9698678,9701679,3001
"917","WBGene00001127","X",763769,766713,2944
"918","WBGene00001129","II",7168817,7171355,2538
"919","WBGene00001130","X",15568890,15573693,4803
"920","WBGene00001131","I",11526918,11557851,30933
"921","WBGene00001132","IV",8852500,8862228,9728
"922","WBGene00001133","II",14166882,14171648,4766
"923","WBGene00001134","II",9324874,9329665,4791
"924","WBGene00001135","III",9136916,9141822,4906
"925","WBGene00001136","I",7308603,7311939,3336
"926","WBGene00001137","V",13126414,13129995,3581
"927","WBGene00001145","I",9722550,9726282,3732
"928","WBGene00001147","I",14391960,14395241,3281
"929","WBGene00001148","X",15516655,15524020,7365
"930","WBGene00001149","X",12877480,12880328,2848
"931","WBGene00001150","V",15357696,15360738,3042
"932","WBGene00001151","IV",11854828,11856376,1548
"933","WBGene00001152","V",8022218,8023308,1090
"934","WBGene00001153","II",10821015,10822443,1428
"935","WBGene00001154","IV",797023,799922,2899
"936","WBGene00001155","III",9751440,9752922,1482
"937","WBGene00001156","I",14367608,14369773,2165
"938","WBGene00001157","IV",10236626,10239176,2550
"939","WBGene00001158","IV",10233321,10235329,2008
"940","WBGene00001159","II",8346690,8350557,3867
"941","WBGene00001160","III",6164909,6168547,3638
"942","WBGene00001161","V",16958657,16965675,7018
"943","WBGene00001162","II",13406160,13411483,5323
"944","WBGene00001163","IV",10576350,10578288,1938
"945","WBGene00001164","X",13475964,13477456,1492
"946","WBGene00001165","IV",559234,568076,8842
"947","WBGene00001166","III",6009550,6012839,3289
"948","WBGene00001167","I",9163531,9166952,3421
"949","WBGene00001168","III",6970026,6972003,1977
"950","WBGene00001169","X",7823652,7825769,2117
"951","WBGene00001170","V",14431310,14432359,1049
"952","WBGene00001171","V",1288841,1299332,10491
"953","WBGene00001172","V",10169197,10173753,4556
"954","WBGene00001173","IV",1847968,1880587,32619
"955","WBGene00001174","III",7814380,7817127,2747
"956","WBGene00001175","X",5931122,5934532,3410
"957","WBGene00001177","V",20825,43697,22872
"958","WBGene00001178","V",10468411,10476952,8541
"959","WBGene00001179","V",12453955,12463008,9053
"960","WBGene00001182","X",5663837,5674060,10223
"961","WBGene00001184","X",11016410,11023421,7011
"962","WBGene00001185","X",489695,492273,2578
"963","WBGene00001186","IV",1902323,1917841,15518
"964","WBGene00001187","IV",7405460,7418733,13273
"965","WBGene00001188","IV",9812444,9815526,3082
"966","WBGene00001189","IV",10478450,10481844,3394
"967","WBGene00001190","IV",13989094,14012026,22932
"968","WBGene00001193","II",69654,71279,1625
"969","WBGene00001194","II",6835021,6847906,12885
"970","WBGene00001196","I",1835631,1841936,6305
"971","WBGene00001202","X",10734326,10744355,10029
"972","WBGene00001204","IV",10106917,10110412,3495
"973","WBGene00001207","II",9955185,9962344,7159
"974","WBGene00001208","II",5928830,5940815,11985
"975","WBGene00001209","III",7824377,7828626,4249
"976","WBGene00001210","V",6679317,6681573,2256
"977","WBGene00001211","V",9899587,9907644,8057
"978","WBGene00001214","I",7650418,7656336,5918
"979","WBGene00001215","I",11400612,11416427,15815
"980","WBGene00001223","IV",5416906,5419195,2289
"981","WBGene00001224","II",5820712,5823862,3150
"982","WBGene00001225","II",14795404,14798224,2820
"983","WBGene00001226","I",9976393,9979662,3269
"984","WBGene00001227","III",8969638,8971578,1940
"985","WBGene00001228","I",10640465,10642281,1816
"986","WBGene00001229","II",9331643,9333925,2282
"987","WBGene00001230","II",8442765,8444239,1474
"988","WBGene00001231","I",4444719,4446598,1879
"989","WBGene00001232","I",2485867,2489780,3913
"990","WBGene00001233","V",12954002,12955229,1227
"991","WBGene00001234","I",12968921,12970238,1317
"992","WBGene00001235","III",11718834,11719450,616
"993","WBGene00001236","III",1415152,1417188,2036
"994","WBGene00001237","X",1777355,1778146,791
"995","WBGene00001239","IV",9526359,9528350,1991
"996","WBGene00001240","IV",17466060,17467408,1348
"997","WBGene00001241","IV",7237722,7239976,2254
"998","WBGene00001242","III",9332269,9334274,2005
"999","WBGene00001243","IV",5374598,5377137,2539
"1000","WBGene00001244","IV",5386629,5388559,1930
"1001","WBGene00001245","IV",9529947,9531378,1431
"1002","WBGene00001246","III",11230378,11232164,1786
"1003","WBGene00001247","II",14959675,14964108,4433
"1004","WBGene00001248","V",20764955,20770161,5206
"1005","WBGene00001249","IV",9614970,9620140,5170
"1006","WBGene00001250","X",10481240,10483446,2206
"1007","WBGene00001251","X",13934883,13941247,6364
"1008","WBGene00001252","X",10475527,10475959,432
"1009","WBGene00001253","IV",1917854,1921644,3790
"1010","WBGene00001258","V",18860287,18894974,34687
"1011","WBGene00001259","III",4715293,4720670,5377
"1012","WBGene00001262","III",5196678,5199688,3010
"1013","WBGene00001263","III",9336881,9344447,7566
"1014","WBGene00001281","II",8159865,8162170,2305
"1015","WBGene00001284","III",9435083,9441539,6456
"1016","WBGene00001303","V",10896658,10897143,485
"1017","WBGene00001309","I",1842445,1843227,782
"1018","WBGene00001310","V",13985137,13987072,1935
"1019","WBGene00001311","V",14014701,14015850,1149
"1020","WBGene00001320","IV",11653422,11655470,2048
"1021","WBGene00001324","IV",4793202,4799378,6176
"1022","WBGene00001325","X",14603017,14608655,5638
"1023","WBGene00001328","IV",10666827,10679289,12462
"1024","WBGene00001329","X",14815828,14818507,2679
"1025","WBGene00001330","IV",14879490,14900652,21162
"1026","WBGene00001331","X",10156858,10160438,3580
"1027","WBGene00001332","IV",415635,419958,4323
"1028","WBGene00001333","I",5284062,5291604,7542
"1029","WBGene00001334","I",14663209,14674822,11613
"1030","WBGene00001335","X",3800045,3802771,2726
"1031","WBGene00001336","IV",15008503,15013183,4680
"1032","WBGene00001337","I",10336395,10341178,4783
"1033","WBGene00001338","IV",388686,390468,1782
"1034","WBGene00001340","II",162374,170628,8254
"1035","WBGene00001345","V",6003601,6016087,12486
"1036","WBGene00001352","III",4303096,4313128,10032
"1037","WBGene00001358","II",8444307,8445177,870
"1038","WBGene00001365","I",14511431,14518719,7288
"1039","WBGene00001366","IV",8799089,8813539,14450
"1040","WBGene00001368","II",9575971,9581490,5519
"1041","WBGene00001371","II",14412201,14413516,1315
"1042","WBGene00001372","I",11907571,11909280,1709
"1043","WBGene00001373","II",6157167,6161094,3927
"1044","WBGene00001374","V",6139836,6143548,3712
"1045","WBGene00001377","I",14220783,14231360,10577
"1046","WBGene00001385","III",9080371,9081179,808
"1047","WBGene00001386","III",9081679,9082511,832
"1048","WBGene00001387","V",12996787,12997524,737
"1049","WBGene00001388","V",12998427,12999659,1232
"1050","WBGene00001389","V",12995569,12996836,1267
"1051","WBGene00001390","IV",13328359,13329497,1138
"1052","WBGene00001391","II",319785,321445,1660
"1053","WBGene00001392","III",842935,843802,867
"1054","WBGene00001393","IV",13315644,13318811,3167
"1055","WBGene00001394","IV",13323850,13326394,2544
"1056","WBGene00001395","IV",9803023,9806119,3096
"1057","WBGene00001396","IV",9799429,9802638,3209
"1058","WBGene00001397","V",17725004,17726818,1814
"1059","WBGene00001398","IV",11913691,11915796,2105
"1060","WBGene00001399","V",7151353,7153146,1793
"1061","WBGene00001400","X",3196307,3199321,3014
"1062","WBGene00001401","II",6078265,6080843,2578
"1063","WBGene00001402","II",6088866,6091480,2614
"1064","WBGene00001403","IV",9540808,9546250,5442
"1065","WBGene00001404","I",2580935,2586126,5191
"1066","WBGene00001405","I",9711064,9712719,1655
"1067","WBGene00001406","V",20425301,20431337,6036
"1068","WBGene00001410","III",2549927,2560684,10757
"1069","WBGene00001411","IV",5533142,5537992,4850
"1070","WBGene00001412","III",631938,634645,2707
"1071","WBGene00001413","IV",9104966,9107609,2643
"1072","WBGene00001414","I",8623017,8631184,8167
"1073","WBGene00001423","V",15000653,15002273,1620
"1074","WBGene00001424","II",6755136,6755965,829
"1075","WBGene00001425","X",8283282,8285219,1937
"1076","WBGene00001426","IV",11036548,11038148,1600
"1077","WBGene00001427","I",12918722,12919278,556
"1078","WBGene00001428","V",7225223,7226320,1097
"1079","WBGene00001429","V",12785154,12787126,1972
"1080","WBGene00001430","I",3898046,3899840,1794
"1081","WBGene00001431","V",20846113,20847727,1614
"1082","WBGene00001432","I",10667808,10671301,3493
"1083","WBGene00001433","I",12916441,12918108,1667
"1084","WBGene00001434","X",3740208,3742323,2115
"1085","WBGene00001435","X",13421824,13423427,1603
"1086","WBGene00001436","X",13427062,13428842,1780
"1087","WBGene00001437","III",4844662,4846546,1884
"1088","WBGene00001438","II",4379652,4383348,3696
"1089","WBGene00001439","IV",5584661,5610368,25707
"1090","WBGene00001440","II",6189580,6191402,1822
"1091","WBGene00001441","X",3816851,3826963,10112
"1092","WBGene00001442","I",10163475,10165135,1660
"1093","WBGene00001443","III",8675297,8683732,8435
"1094","WBGene00001444","IV",9144692,9146122,1430
"1095","WBGene00001445","X",10094430,10095245,815
"1096","WBGene00001446","X",10091961,10092964,1003
"1097","WBGene00001447","II",10054623,10055594,971
"1098","WBGene00001448","X",8528250,8531033,2783
"1099","WBGene00001449","V",9471975,9473796,1821
"1100","WBGene00001450","X",5885865,5886823,958
"1101","WBGene00001451","X",14881419,14882300,881
"1102","WBGene00001452","IV",12754558,12757673,3115
"1103","WBGene00001453","IV",7868907,7870100,1193
"1104","WBGene00001454","X",4677342,4678129,787
"1105","WBGene00001455","X",4591281,4592404,1123
"1106","WBGene00001456","IV",7696932,7698420,1488
"1107","WBGene00001457","III",12910510,12914930,4420
"1108","WBGene00001458","III",13663400,13667839,4439
"1109","WBGene00001459","II",13235306,13237417,2111
"1110","WBGene00001460","IV",17190177,17191891,1714
"1111","WBGene00001461","X",3012190,3018555,6365
"1112","WBGene00001462","X",10604686,10605828,1142
"1113","WBGene00001463","X",9349276,9349890,614
"1114","WBGene00001464","V",7793367,7794025,658
"1115","WBGene00001465","X",13452667,13456658,3991
"1116","WBGene00001466","V",11936505,11937794,1289
"1117","WBGene00001468","X",15089397,15093585,4188
"1118","WBGene00001470","III",7650549,7656032,5483
"1119","WBGene00001475","V",13019068,13033373,14305
"1120","WBGene00001476","IV",10661857,10664404,2547
"1121","WBGene00001477","IV",10682524,10684385,1861
"1122","WBGene00001478","III",10694590,10698861,4271
"1123","WBGene00001479","V",13603276,13606701,3425
"1124","WBGene00001480","V",899310,903665,4355
"1125","WBGene00001481","I",3211046,3217366,6320
"1126","WBGene00001482","V",20199262,20200640,1378
"1127","WBGene00001483","I",10016778,10018114,1336
"1128","WBGene00001484","X",2445500,2455949,10449
"1129","WBGene00001485","V",20075935,20087733,11798
"1130","WBGene00001486","II",5917422,5918564,1142
"1131","WBGene00001487","IV",10043183,10045739,2556
"1132","WBGene00001488","I",14875784,14900213,24429
"1133","WBGene00001489","III",5976781,5982126,5345
"1134","WBGene00001490","X",11572565,11585126,12561
"1135","WBGene00001491","I",5402889,5408344,5455
"1136","WBGene00001492","IV",32481,48880,16399
"1137","WBGene00001493","V",12302484,12306978,4494
"1138","WBGene00001494","III",3200795,3219150,18355
"1139","WBGene00001495","X",10816968,10838650,21682
"1140","WBGene00001496","V",13463128,13467131,4003
"1141","WBGene00001497","I",6211986,6214645,2659
"1142","WBGene00001498","II",8464848,8467072,2224
"1143","WBGene00001499","III",4937322,4939453,2131
"1144","WBGene00001500","V",7546468,7548012,1544
"1145","WBGene00001501","I",3680178,3680944,766
"1146","WBGene00001502","X",11603709,11605451,1742
"1147","WBGene00001503","III",7465605,7467633,2028
"1148","WBGene00001505","II",8756291,8758723,2432
"1149","WBGene00001506","V",6573983,6575797,1814
"1150","WBGene00001507","II",2819435,2822490,3055
"1151","WBGene00001508","V",5987003,5990252,3249
"1152","WBGene00001509","II",5833328,5836203,2875
"1153","WBGene00001510","II",9640167,9644466,4299
"1154","WBGene00001511","II",5501633,5503908,2275
"1155","WBGene00001512","III",12771878,12779726,7848
"1156","WBGene00001513","V",6431331,6433496,2165
"1157","WBGene00001514","III",5604460,5607549,3089
"1158","WBGene00001515","X",2192504,2195348,2844
"1159","WBGene00001516","X",9472469,9516440,43971
"1160","WBGene00001517","X",6479447,6484810,5363
"1161","WBGene00001518","III",6309378,6320872,11494
"1162","WBGene00001519","V",14564752,14579719,14967
"1163","WBGene00001520","X",15586812,15590397,3585
"1164","WBGene00001522","II",10690452,10693863,3411
"1165","WBGene00001523","II",8485879,8487571,1692
"1166","WBGene00001526","V",8947799,8956294,8495
"1167","WBGene00001527","II",9035562,9038301,2739
"1168","WBGene00001528","II",9512490,9516936,4446
"1169","WBGene00001529","II",9507604,9512095,4491
"1170","WBGene00001530","II",9502757,9507281,4524
"1171","WBGene00001531","II",10304139,10308826,4687
"1172","WBGene00001532","II",10310400,10316219,5819
"1173","WBGene00001533","V",10308291,10314053,5762
"1174","WBGene00001534","V",8387356,8392324,4968
"1175","WBGene00001535","IV",7928159,7933775,5616
"1176","WBGene00001536","X",11332553,11338301,5748
"1177","WBGene00001537","X",17046261,17055581,9320
"1178","WBGene00001538","II",5312046,5319234,7188
"1179","WBGene00001539","V",12363754,12369537,5783
"1180","WBGene00001540","V",14863168,14867992,4824
"1181","WBGene00001541","II",3192420,3197066,4646
"1182","WBGene00001542","I",2223307,2233099,9792
"1183","WBGene00001543","IV",12860137,12865935,5798
"1184","WBGene00001544","II",3250985,3259354,8369
"1185","WBGene00001545","V",16248583,16253787,5204
"1186","WBGene00001546","II",2659670,2665022,5352
"1187","WBGene00001547","V",20820366,20825028,4662
"1188","WBGene00001548","IV",3282885,3289337,6452
"1189","WBGene00001549","IV",15872933,15882377,9444
"1190","WBGene00001550","IV",17432977,17436652,3675
"1191","WBGene00001551","X",2420462,2427504,7042
"1192","WBGene00001552","V",13912080,13915436,3356
"1193","WBGene00001553","V",11995868,12001965,6097
"1194","WBGene00001554","V",13383019,13385898,2879
"1195","WBGene00001555","I",13325230,13333508,8278
"1196","WBGene00001556","X",15479017,15485700,6683
"1197","WBGene00001557","IV",2150650,2159162,8512
"1198","WBGene00001558","IV",14790818,14792887,2069
"1199","WBGene00001559","III",3344875,3363409,18534
"1200","WBGene00001560","X",12795216,12813947,18731
"1201","WBGene00001561","III",344307,378250,33943
"1202","WBGene00001562","IV",13888089,13893985,5896
"1203","WBGene00001563","V",7226376,7230848,4472
"1204","WBGene00001564","V",724207,728103,3896
"1205","WBGene00001565","III",8111166,8126222,15056
"1206","WBGene00001566","IV",8496486,8498871,2385
"1207","WBGene00001568","I",8962322,8966129,3807
"1208","WBGene00001569","X",1986429,1989607,3178
"1209","WBGene00001570","III",9631994,9637116,5122
"1210","WBGene00001571","II",8273543,8276231,2688
"1211","WBGene00001572","X",6820005,6823268,3263
"1212","WBGene00001574","I",9100846,9107939,7093
"1213","WBGene00001575","IV",13981087,13982525,1438
"1214","WBGene00001577","IV",11745640,11748640,3000
"1215","WBGene00001578","V",1427653,1432137,4484
"1216","WBGene00001579","IV",572723,583577,10854
"1217","WBGene00001580","IV",12404374,12408697,4323
"1218","WBGene00001581","V",6392541,6399921,7380
"1219","WBGene00001582","I",9737823,9744190,6367
"1220","WBGene00001583","X",14480572,14484702,4130
"1221","WBGene00001584","IV",7646200,7654262,8062
"1222","WBGene00001585","IV",11521290,11522214,924
"1223","WBGene00001586","II",10695013,10702524,7511
"1224","WBGene00001587","X",6070497,6081833,11336
"1225","WBGene00001588","II",5130384,5133215,2831
"1226","WBGene00001589","III",2347591,2362056,14465
"1227","WBGene00001590","I",9226905,9228184,1279
"1228","WBGene00001591","V",16219541,16221948,2407
"1229","WBGene00001592","I",4885062,4888002,2940
"1230","WBGene00001593","V",5449287,5453715,4428
"1231","WBGene00001594","II",7172204,7174936,2732
"1232","WBGene00001595","I",7695661,7698227,2566
"1233","WBGene00001596","I",6369934,6386183,16249
"1234","WBGene00001597","II",7132643,7137522,4879
"1235","WBGene00001598","I",6854688,6857529,2841
"1236","WBGene00001599","I",6513928,6517507,3579
"1237","WBGene00001600","I",5792324,5795114,2790
"1238","WBGene00001601","I",3726011,3731265,5254
"1239","WBGene00001602","X",6058255,6060242,1987
"1240","WBGene00001603","III",9943243,9944823,1580
"1241","WBGene00001604","IV",16167785,16170859,3074
"1242","WBGene00001605","III",13601760,13603156,1396
"1243","WBGene00001606","IV",17272231,17273652,1421
"1244","WBGene00001607","IV",9739219,9740908,1689
"1245","WBGene00001608","X",9870804,9872654,1850
"1246","WBGene00001609","III",9092241,9099698,7457
"1247","WBGene00001612","III",8584186,8588642,4456
"1248","WBGene00001613","III",7138683,7144832,6149
"1249","WBGene00001614","I",7117808,7121545,3737
"1250","WBGene00001615","II",7785100,7794319,9219
"1251","WBGene00001616","V",8716495,8720893,4398
"1252","WBGene00001617","X",6836386,6840615,4229
"1253","WBGene00001618","X",2413909,2419877,5968
"1254","WBGene00001619","X",6506276,6509882,3606
"1255","WBGene00001620","X",3496026,3499165,3139
"1256","WBGene00001621","IV",10130257,10133283,3026
"1257","WBGene00001622","X",6403424,6406981,3557
"1258","WBGene00001623","II",9706483,9708885,2402
"1259","WBGene00001624","IV",7503622,7506447,2825
"1260","WBGene00001625","IV",532135,535703,3568
"1261","WBGene00001626","II",10900042,10902204,2162
"1262","WBGene00001627","I",6507894,6511630,3736
"1263","WBGene00001628","III",7914314,7917767,3453
"1264","WBGene00001629","V",19881374,19895350,13976
"1265","WBGene00001630","III",13187392,13204897,17505
"1266","WBGene00001631","III",4324280,4331227,6947
"1267","WBGene00001632","V",1815852,1821323,5471
"1268","WBGene00001633","III",11624991,11628238,3247
"1269","WBGene00001635","IV",13778866,13782396,3530
"1270","WBGene00001636","III",12171353,12177245,5892
"1271","WBGene00001637","X",7485864,7490707,4843
"1272","WBGene00001638","X",9293664,9296622,2958
"1273","WBGene00001639","III",3490363,3493234,2871
"1274","WBGene00001640","I",12462176,12465831,3655
"1275","WBGene00001641","I",12379335,12381032,1697
"1276","WBGene00001643","I",7110240,7112287,2047
"1277","WBGene00001644","I",7112903,7115001,2098
"1278","WBGene00001645","V",11282572,11286039,3467
"1279","WBGene00001646","V",10319535,10320158,623
"1280","WBGene00001647","I",7699543,7700958,1415
"1281","WBGene00001648","I",7522116,7526703,4587
"1282","WBGene00001649","X",15493536,15497504,3968
"1283","WBGene00001650","IV",9934767,9953433,18666
"1284","WBGene00001651","I",8549513,8570998,21485
"1285","WBGene00001653","IV",10197820,10202993,5173
"1286","WBGene00001660","III",5254438,5258922,4484
"1287","WBGene00001661","III",5259023,5260512,1489
"1288","WBGene00001662","III",5260693,5263837,3144
"1289","WBGene00001663","V",11174567,11177559,2992
"1290","WBGene00001664","V",8371014,8374027,3013
"1291","WBGene00001665","V",9356750,9359774,3024
"1292","WBGene00001666","IV",401695,405346,3651
"1293","WBGene00001667","X",2118894,2121061,2167
"1294","WBGene00001668","X",13191246,13193955,2709
"1295","WBGene00001669","IV",10404012,10408530,4518
"1296","WBGene00001670","V",12638852,12640470,1618
"1297","WBGene00001671","V",12646827,12649313,2486
"1298","WBGene00001672","V",6852568,6854803,2235
"1299","WBGene00001673","II",4247197,4255281,8084
"1300","WBGene00001674","X",9247007,9249103,2096
"1301","WBGene00001675","V",12752762,12754893,2131
"1302","WBGene00001676","I",5942419,5945537,3118
"1303","WBGene00001677","I",8531760,8534527,2767
"1304","WBGene00001678","I",897286,906077,8791
"1305","WBGene00001679","II",11742814,11748603,5789
"1306","WBGene00001680","I",7318290,7321085,2795
"1307","WBGene00001681","X",12881126,12884989,3863
"1308","WBGene00001682","I",6757763,6758178,415
"1309","WBGene00001683","II",10394114,10395349,1235
"1310","WBGene00001684","X",3113434,3114771,1337
"1311","WBGene00001685","X",3112083,3113382,1299
"1312","WBGene00001686","II",10171255,10172497,1242
"1313","WBGene00001687","X",15681693,15687477,5784
"1314","WBGene00001688","III",8628926,8630776,1850
"1315","WBGene00001689","III",9391270,9393164,1894
"1316","WBGene00001690","X",11109440,11115887,6447
"1317","WBGene00001691","V",20609794,20613929,4135
"1318","WBGene00001692","IV",3439655,3440453,798
"1319","WBGene00001693","X",8501245,8502289,1044
"1320","WBGene00001694","V",8619032,8619869,837
"1321","WBGene00001695","V",9221866,9224354,2488
"1322","WBGene00001696","X",7267989,7269479,1490
"1323","WBGene00001697","V",7842543,7844299,1756
"1324","WBGene00001698","V",5895388,5898602,3214
"1325","WBGene00001699","IV",3441055,3441770,715
"1326","WBGene00001700","V",20356802,20365718,8916
"1327","WBGene00001701","V",14978505,14980159,1654
"1328","WBGene00001702","IV",3438312,3439503,1191
"1329","WBGene00001703","X",8499664,8501037,1373
"1330","WBGene00001704","I",13564567,13566362,1795
"1331","WBGene00001705","IV",2476700,2480218,3518
"1332","WBGene00001706","V",16990810,16991459,649
"1333","WBGene00001707","I",1259374,1268155,8781
"1334","WBGene00001708","X",9991255,9999178,7923
"1335","WBGene00001709","III",676122,680253,4131
"1336","WBGene00001710","V",5530725,5533845,3120
"1337","WBGene00001711","V",12944861,12946853,1992
"1338","WBGene00001712","V",11411511,11412769,1258
"1339","WBGene00001713","IV",7309838,7310760,922
"1340","WBGene00001714","V",4412748,4414663,1915
"1341","WBGene00001715","X",6449959,6450939,980
"1342","WBGene00001716","V",11344831,11347012,2181
"1343","WBGene00001717","V",6731831,6733092,1261
"1344","WBGene00001718","V",6730281,6731694,1413
"1345","WBGene00001719","V",7774441,7775759,1318
"1346","WBGene00001720","III",9117349,9118364,1015
"1347","WBGene00001721","V",8635820,8637006,1186
"1348","WBGene00001722","V",4362722,4364650,1928
"1349","WBGene00001723","V",20825559,20827740,2181
"1350","WBGene00001724","III",12232632,12235711,3079
"1351","WBGene00001725","I",572177,575120,2943
"1352","WBGene00001726","V",13562105,13563913,1808
"1353","WBGene00001727","V",5485697,5488866,3169
"1354","WBGene00001728","IV",251970,252554,584
"1355","WBGene00001729","IV",2126145,2128852,2707
"1356","WBGene00001730","IV",10737474,10738189,715
"1357","WBGene00001731","III",5413137,5413993,856
"1358","WBGene00001732","V",12575308,12576895,1587
"1359","WBGene00001733","IV",17475417,17475838,421
"1360","WBGene00001734","III",8962295,8965638,3343
"1361","WBGene00001735","IV",321571,323022,1451
"1362","WBGene00001736","V",3575055,3575874,819
"1363","WBGene00001737","V",3551346,3551865,519
"1364","WBGene00001738","V",3554611,3555236,625
"1365","WBGene00001739","V",3556286,3556804,518
"1366","WBGene00001740","III",5265113,5267204,2091
"1367","WBGene00001743","III",8085705,8088449,2744
"1368","WBGene00001744","III",5159729,5163627,3898
"1369","WBGene00001745","I",1068484,1075010,6526
"1370","WBGene00001746","I",12819216,12825562,6346
"1371","WBGene00001747","V",10682422,10686537,4115
"1372","WBGene00001748","III",7336587,7338765,2178
"1373","WBGene00001749","III",9059314,9060181,867
"1374","WBGene00001750","IV",10140330,10141513,1183
"1375","WBGene00001751","IV",10139380,10140285,905
"1376","WBGene00001752","IV",10142135,10143099,964
"1377","WBGene00001753","II",10950350,10951604,1254
"1378","WBGene00001754","II",4879885,4881105,1220
"1379","WBGene00001755","II",4882062,4883358,1296
"1380","WBGene00001756","II",4883749,4884602,853
"1381","WBGene00001757","II",4891573,4893573,2000
"1382","WBGene00001758","V",2561690,2564701,3011
"1383","WBGene00001759","X",3632367,3633747,1380
"1384","WBGene00001760","II",13616685,13618061,1376
"1385","WBGene00001761","II",9231457,9232340,883
"1386","WBGene00001762","II",13614788,13616100,1312
"1387","WBGene00001763","II",13611771,13613196,1425
"1388","WBGene00001764","II",13622967,13624502,1535
"1389","WBGene00001765","II",13628017,13628774,757
"1390","WBGene00001766","II",13629799,13630887,1088
"1391","WBGene00001767","II",13625544,13627141,1597
"1392","WBGene00001768","II",13608154,13609824,1670
"1393","WBGene00001769","V",1730759,1732000,1241
"1394","WBGene00001770","V",16231032,16232317,1285
"1395","WBGene00001771","V",3243287,3244495,1208
"1396","WBGene00001772","II",13610443,13611349,906
"1397","WBGene00001773","I",1451122,1453077,1955
"1398","WBGene00001774","II",15163808,15164646,838
"1399","WBGene00001775","II",15164890,15165731,841
"1400","WBGene00001776","II",15166194,15167406,1212
"1401","WBGene00001777","II",15168538,15169860,1322
"1402","WBGene00001778","II",4933883,4935038,1155
"1403","WBGene00001779","II",15174271,15174965,694
"1404","WBGene00001780","II",15177372,15178594,1222
"1405","WBGene00001781","V",3467453,3468545,1092
"1406","WBGene00001782","II",15179971,15183232,3261
"1407","WBGene00001783","II",15183801,15185385,1584
"1408","WBGene00001784","X",9861646,9862960,1314
"1409","WBGene00001785","V",1921621,1922381,760
"1410","WBGene00001786","V",15915216,15916079,863
"1411","WBGene00001787","II",15171163,15171912,749
"1412","WBGene00001788","IV",760610,762342,1732
"1413","WBGene00001789","V",7398390,7399302,912
"1414","WBGene00001790","X",11726271,11727936,1665
"1415","WBGene00001791","I",2901325,2903006,1681
"1416","WBGene00001792","V",16390891,16392406,1515
"1417","WBGene00001793","II",12866448,12878116,11668
"1418","WBGene00001794","IV",10180660,10183939,3279
"1419","WBGene00001795","IV",11248884,11259535,10651
"1420","WBGene00001796","IV",11273483,11281924,8441
"1421","WBGene00001803","X",6226131,6230701,4570
"1422","WBGene00001804","X",10402526,10406303,3777
"1423","WBGene00001805","II",14104773,14108072,3299
"1424","WBGene00001806","II",5285329,5288908,3579
"1425","WBGene00001808","V",13497690,13498819,1129
"1426","WBGene00001811","IV",17376427,17379317,2890
"1427","WBGene00001812","II",7353576,7356426,2850
"1428","WBGene00001813","V",15760426,15766172,5746
"1429","WBGene00001814","I",489969,496150,6181
"1430","WBGene00001815","III",11091548,11099964,8416
"1431","WBGene00001816","I",1162880,1175868,12988
"1432","WBGene00001817","V",14773258,14777697,4439
"1433","WBGene00001818","IV",14694032,14699940,5908
"1434","WBGene00001819","I",6081782,6085962,4180
"1435","WBGene00001820","IV",12542034,12545729,3695
"1436","WBGene00001821","X",4554691,4559404,4713
"1437","WBGene00001823","III",5263943,5264996,1053
"1438","WBGene00001824","X",5822277,5827755,5478
"1439","WBGene00001827","IV",7770770,7774275,3505
"1440","WBGene00001828","X",14696412,14699977,3565
"1441","WBGene00001829","V",6594194,6599208,5014
"1442","WBGene00001830","V",9645746,9650297,4551
"1443","WBGene00001831","III",9615306,9616470,1164
"1444","WBGene00001832","I",3862775,3865938,3163
"1445","WBGene00001833","I",5165152,5171313,6161
"1446","WBGene00001834","V",14525389,14527411,2022
"1447","WBGene00001835","II",8020780,8022561,1781
"1448","WBGene00001836","I",11912791,11917719,4928
"1449","WBGene00001837","X",16729559,16744698,15139
"1450","WBGene00001838","II",13882705,13888031,5326
"1451","WBGene00001839","IV",11946106,11949817,3711
"1452","WBGene00001840","II",8326852,8328870,2018
"1453","WBGene00001841","X",7116205,7116996,791
"1454","WBGene00001842","V",9697129,9701552,4423
"1455","WBGene00001843","I",9049460,9055457,5997
"1456","WBGene00001844","X",2489044,2494339,5295
"1457","WBGene00001851","V",20780413,20785259,4846
"1458","WBGene00001852","V",14949777,14952796,3019
"1459","WBGene00001853","IV",6294234,6295219,985
"1460","WBGene00001854","X",8159153,8160084,931
"1461","WBGene00001855","V",4754313,4755469,1156
"1462","WBGene00001856","I",5774585,5775610,1025
"1463","WBGene00001857","V",2030619,2031475,856
"1464","WBGene00001858","IV",6646034,6646936,902
"1465","WBGene00001859","I",5463480,5469627,6147
"1466","WBGene00001860","I",4951570,4957667,6097
"1467","WBGene00001862","IV",6977517,6978943,1426
"1468","WBGene00001863","X",9717589,9753764,36175
"1469","WBGene00001864","V",14090719,14092435,1716
"1470","WBGene00001865","IV",12490791,12495298,4507
"1471","WBGene00001867","IV",10561905,10563947,2042
"1472","WBGene00001869","III",5803260,5805112,1852
"1473","WBGene00001872","II",7065020,7069966,4946
"1474","WBGene00001874","V",13176711,13180189,3478
"1475","WBGene00001875","V",16042486,16043013,527
"1476","WBGene00001876","V",16041828,16042283,455
"1477","WBGene00001877","V",16040771,16041288,517
"1478","WBGene00001878","V",16040029,16040548,519
"1479","WBGene00001879","V",8535177,8535662,485
"1480","WBGene00001880","V",8534387,8534977,590
"1481","WBGene00001881","V",8533379,8533869,490
"1482","WBGene00001882","V",8532540,8533098,558
"1483","WBGene00001885","II",13821778,13822333,555
"1484","WBGene00001890","II",13817759,13818143,384
"1485","WBGene00001891","V",8897458,8897992,534
"1486","WBGene00001892","V",8898195,8898645,450
"1487","WBGene00001898","X",14490094,14491115,1021
"1488","WBGene00001899","II",13824686,13825294,608
"1489","WBGene00001905","IV",8333557,8334021,464
"1490","WBGene00001906","IV",8334298,8334862,564
"1491","WBGene00001909","V",9544611,9545398,787
"1492","WBGene00001910","V",9546092,9546838,746
"1493","WBGene00001911","V",9547083,9547607,524
"1494","WBGene00001912","X",7309413,7309908,495
"1495","WBGene00001913","V",8536513,8536716,203
"1496","WBGene00001914","X",7310110,7310698,588
"1497","WBGene00001915","V",9545494,9546264,770
"1498","WBGene00001916","II",13828287,13828697,410
"1499","WBGene00001917","II",13827326,13827709,383
"1500","WBGene00001919","IV",11326557,11327090,533
"1501","WBGene00001920","IV",11326018,11326329,311
"1502","WBGene00001921","IV",11323885,11324470,585
"1503","WBGene00001922","IV",11324719,11325222,503
"1504","WBGene00001929","IV",11337733,11338295,562
"1505","WBGene00001930","IV",11338522,11338833,311
"1506","WBGene00001931","IV",11340412,11341703,1291
"1507","WBGene00001932","IV",11339630,11340132,502
"1508","WBGene00001933","IV",7488216,7488956,740
"1509","WBGene00001934","IV",7487560,7488025,465
"1510","WBGene00001935","IV",7485733,7486254,521
"1511","WBGene00001936","IV",7486519,7486962,443
"1512","WBGene00001937","IV",11406365,11406893,528
"1513","WBGene00001938","IV",11407084,11407496,412
"1514","WBGene00001939","IV",11401059,11401564,505
"1515","WBGene00001940","IV",11400311,11400812,501
"1516","WBGene00001941","I",9988341,9988826,485
"1517","WBGene00001942","I",9989061,9989617,556
"1518","WBGene00001943","III",4058272,4058743,471
"1519","WBGene00001944","III",4059647,4060172,525
"1520","WBGene00001945","X",7981382,7982070,688
"1521","WBGene00001946","III",12367474,12369050,1576
"1522","WBGene00001947","II",13183450,13183845,395
"1523","WBGene00001948","II",4518560,4522523,3963
"1524","WBGene00001949","I",7190834,7193924,3090
"1525","WBGene00001950","II",9086608,9087917,1309
"1526","WBGene00001951","III",9737469,9738839,1370
"1527","WBGene00001952","II",9613463,9614812,1349
"1528","WBGene00001953","X",8116636,8120133,3497
"1529","WBGene00001954","V",9280702,9282154,1452
"1530","WBGene00001955","III",9619711,9626537,6826
"1531","WBGene00001956","IV",8478577,8479446,869
"1532","WBGene00001957","X",4249249,4250764,1515
"1533","WBGene00001958","II",5737790,5738888,1098
"1534","WBGene00001959","X",2412953,2413377,424
"1535","WBGene00001960","I",8767019,8768042,1023
"1536","WBGene00001961","IV",16254764,16256274,1510
"1537","WBGene00001962","X",555788,557191,1403
"1538","WBGene00001963","III",185652,186922,1270
"1539","WBGene00001964","II",5535240,5536149,909
"1540","WBGene00001965","II",5532857,5533738,881
"1541","WBGene00001966","II",5539081,5540211,1130
"1542","WBGene00001967","X",17551057,17551877,820
"1543","WBGene00001968","X",17547817,17548637,820
"1544","WBGene00001971","II",14250683,14251448,765
"1545","WBGene00001972","III",6280380,6282411,2031
"1546","WBGene00001973","I",5815609,5818132,2523
"1547","WBGene00001974","III",7379143,7381609,2466
"1548","WBGene00001975","IV",7644895,7646219,1324
"1549","WBGene00001976","II",4672798,4673746,948
"1550","WBGene00001977","II",11916513,11917643,1130
"1551","WBGene00001978","V",11845877,11852165,6288
"1552","WBGene00001979","I",14738882,14742657,3775
"1553","WBGene00001980","I",11075758,11134667,58909
"1554","WBGene00001981","X",11684661,11685778,1117
"1555","WBGene00001983","IV",4739490,4744269,4779
"1556","WBGene00001984","X",5851954,5854260,2306
"1557","WBGene00001985","I",4208515,4210341,1826
"1558","WBGene00001986","V",14621135,14629384,8249
"1559","WBGene00001987","V",19174806,19187899,13093
"1560","WBGene00001988","II",13930648,13931997,1349
"1561","WBGene00001989","III",6220537,6224451,3914
"1562","WBGene00001990","I",8683220,8687217,3997
"1563","WBGene00001991","V",11021069,11022884,1815
"1564","WBGene00001992","II",14211439,14213123,1684
"1565","WBGene00001993","III",10535526,10537682,2156
"1566","WBGene00001994","X",4210573,4217290,6717
"1567","WBGene00001995","X",13245390,13247044,1654
"1568","WBGene00001996","III",10752254,10755523,3269
"1569","WBGene00001997","III",10621541,10626398,4857
"1570","WBGene00001998","II",13153461,13157093,3632
"1571","WBGene00001999","IV",3336927,3338867,1940
"1572","WBGene00002000","I",12060271,12064897,4626
"1573","WBGene00002001","IV",10858957,10861295,2338
"1574","WBGene00002002","IV",12565983,12567226,1243
"1575","WBGene00002003","III",4345339,4350079,4740
"1576","WBGene00002004","I",11953512,11961984,8472
"1577","WBGene00002005","IV",17278959,17281330,2371
"1578","WBGene00002006","X",3293290,3294369,1079
"1579","WBGene00002007","X",6089033,6092124,3091
"1580","WBGene00002008","II",7350121,7352636,2515
"1581","WBGene00002010","V",4824130,4826760,2630
"1582","WBGene00002011","III",8138090,8139645,1555
"1583","WBGene00002012","IV",9444791,9445507,716
"1584","WBGene00002013","IV",9446385,9446884,499
"1585","WBGene00002015","V",9087293,9087782,489
"1586","WBGene00002016","V",1804334,1804971,637
"1587","WBGene00002017","V",9090077,9090604,527
"1588","WBGene00002018","V",1805178,1805875,697
"1589","WBGene00002019","V",9088131,9088617,486
"1590","WBGene00002020","V",9089280,9089766,486
"1591","WBGene00002021","V",8384774,8386268,1494
"1592","WBGene00002023","X",6034463,6039496,5033
"1593","WBGene00002024","X",6233149,6235541,2392
"1594","WBGene00002025","III",1619742,1625797,6055
"1595","WBGene00002026","I",9320325,9322534,2209
"1596","WBGene00002027","I",9626241,9630848,4607
"1597","WBGene00002028","IV",8688273,8691513,3240
"1598","WBGene00002029","X",11204117,11207155,3038
"1599","WBGene00002030","II",6165721,6169231,3510
"1600","WBGene00002031","X",5275567,5278813,3246
"1601","WBGene00002032","IV",5390184,5391557,1373
"1602","WBGene00002033","IV",6419500,6420898,1398
"1603","WBGene00002034","I",4827072,4829794,2722
"1604","WBGene00002035","I",8845809,8851116,5307
"1605","WBGene00002036","V",9386179,9400062,13883
"1606","WBGene00002037","X",11420474,11433524,13050
"1607","WBGene00002038","III",4029115,4036840,7725
"1608","WBGene00002039","X",2303082,2314914,11832
"1609","WBGene00002040","I",585831,607601,21770
"1610","WBGene00002041","IV",429214,440554,11340
"1611","WBGene00002042","I",3698102,3699300,1198
"1612","WBGene00002043","IV",8539123,8544403,5280
"1613","WBGene00002044","X",4696952,4699461,2509
"1614","WBGene00002045","II",6587577,6588679,1102
"1615","WBGene00002046","IV",9094541,9095653,1112
"1616","WBGene00002047","I",2304512,2306816,2304
"1617","WBGene00002048","III",5755496,5765815,10319
"1618","WBGene00002050","X",11271184,11275482,4298
"1619","WBGene00002051","X",16267257,16270056,2799
"1620","WBGene00002052","X",4912308,4915979,3671
"1621","WBGene00002053","II",5765618,5772084,6466
"1622","WBGene00002054","II",5750190,5754140,3950
"1623","WBGene00002055","V",2881393,2883753,2360
"1624","WBGene00002056","X",642156,654903,12747
"1625","WBGene00002057","X",8820703,8824448,3745
"1626","WBGene00002058","X",813852,815929,2077
"1627","WBGene00002059","III",13343574,13344616,1042
"1628","WBGene00002060","X",381338,382709,1371
"1629","WBGene00002061","V",6588,7822,1234
"1630","WBGene00002062","X",1104212,1106247,2035
"1631","WBGene00002063","II",12280662,12284133,3471
"1632","WBGene00002064","III",9745864,9747193,1329
"1633","WBGene00002065","II",8559394,8561352,1958
"1634","WBGene00002066","II",8217231,8222395,5164
"1635","WBGene00002067","X",9675844,9680169,4325
"1636","WBGene00002068","II",5054084,5055338,1254
"1637","WBGene00002069","I",9685398,9688653,3255
"1638","WBGene00002070","I",9609501,9611620,2119
"1639","WBGene00002071","X",768596,770776,2180
"1640","WBGene00002072","V",11239675,11241780,2105
"1641","WBGene00002073","I",6315233,6317267,2034
"1642","WBGene00002074","IV",7558726,7561664,2938
"1643","WBGene00002075","I",4920707,4926233,5526
"1644","WBGene00002076","II",14365705,14373899,8194
"1645","WBGene00002077","I",310981,314989,4008
"1646","WBGene00002078","V",7805064,7814656,9592
"1647","WBGene00002079","I",318390,323352,4962
"1648","WBGene00002080","IV",7916699,7924129,7430
"1649","WBGene00002081","III",9168040,9172802,4762
"1650","WBGene00002083","III",6930039,6931953,1914
"1651","WBGene00002084","IV",10436708,10438410,1702
"1652","WBGene00002085","II",5988526,5989394,868
"1653","WBGene00002086","II",5990103,5990818,715
"1654","WBGene00002087","II",5996370,5997007,637
"1655","WBGene00002088","II",5997803,5999019,1216
"1656","WBGene00002089","II",6000421,6001009,588
"1657","WBGene00002090","IV",9682013,9682826,813
"1658","WBGene00002091","IV",9680387,9680941,554
"1659","WBGene00002092","X",8866238,8866640,402
"1660","WBGene00002093","V",14033950,14034393,443
"1661","WBGene00002094","II",5556761,5557088,327
"1662","WBGene00002095","II",5554617,5555306,689
"1663","WBGene00002096","II",5544585,5544851,266
"1664","WBGene00002097","II",6745435,6745960,525
"1665","WBGene00002098","II",6744339,6744735,396
"1666","WBGene00002099","III",2060673,2060957,284
"1667","WBGene00002100","III",4476888,4477583,695
"1668","WBGene00002101","I",8147400,8149723,2323
"1669","WBGene00002102","II",3126037,3126441,404
"1670","WBGene00002103","II",6010844,6011321,477
"1671","WBGene00002104","III",10023804,10024120,316
"1672","WBGene00002105","III",10026289,10026673,384
"1673","WBGene00002106","III",10028247,10028600,353
"1674","WBGene00002107","I",14031147,14031667,520
"1675","WBGene00002108","I",14020364,14021155,791
"1676","WBGene00002109","I",14037151,14037803,652
"1677","WBGene00002110","I",14027236,14027588,352
"1678","WBGene00002111","I",14012369,14013629,1260
"1679","WBGene00002112","I",14018785,14019759,974
"1680","WBGene00002113","I",14035096,14036057,961
"1681","WBGene00002114","II",3127041,3127790,749
"1682","WBGene00002115","II",3802959,3803324,365
"1683","WBGene00002116","I",13637845,13639311,1466
"1684","WBGene00002117","IV",14106584,14107715,1131
"1685","WBGene00002118","V",20375536,20376301,765
"1686","WBGene00002119","I",11212426,11215091,2665
"1687","WBGene00002120","II",13835103,13835709,606
"1688","WBGene00002121","II",5530501,5530928,427
"1689","WBGene00002123","X",6943740,6956399,12659
"1690","WBGene00002124","X",11294962,11296731,1769
"1691","WBGene00002125","X",5996156,5998243,2087
"1692","WBGene00002127","X",8300030,8302395,2365
"1693","WBGene00002128","IV",12746584,12749721,3137
"1694","WBGene00002129","IV",5943981,5946754,2773
"1695","WBGene00002130","IV",11673816,11675635,1819
"1696","WBGene00002131","IV",11676354,11678497,2143
"1697","WBGene00002132","V",9204703,9207467,2764
"1698","WBGene00002133","V",12487266,12493264,5998
"1699","WBGene00002134","I",3755457,3759077,3620
"1700","WBGene00002135","I",3748523,3753958,5435
"1701","WBGene00002136","I",7350312,7352235,1923
"1702","WBGene00002137","I",4159014,4161149,2135
"1703","WBGene00002138","I",4162035,4165015,2980
"1704","WBGene00002139","I",4165135,4167229,2094
"1705","WBGene00002140","IV",606355,614021,7666
"1706","WBGene00002141","I",2451908,2464637,12729
"1707","WBGene00002142","I",9874698,9879119,4421
"1708","WBGene00002143","I",3611909,3618317,6408
"1709","WBGene00002144","I",3608395,3612301,3906
"1710","WBGene00002146","X",6031469,6034525,3056
"1711","WBGene00002147","II",8112262,8124910,12648
"1712","WBGene00002148","V",6606439,6611158,4719
"1713","WBGene00002149","X",6766083,6772946,6863
"1714","WBGene00002150","X",703029,714478,11449
"1715","WBGene00002151","X",14353309,14370370,17061
"1716","WBGene00002152","IV",10368607,10373136,4529
"1717","WBGene00002153","I",10180249,10184075,3826
"1718","WBGene00002162","IV",8133789,8136055,2266
"1719","WBGene00002163","X",7126648,7139646,12998
"1720","WBGene00002169","III",6703993,6710084,6091
"1721","WBGene00002173","IV",7675174,7696923,21749
"1722","WBGene00002174","I",2802822,2815786,12964
"1723","WBGene00002175","IV",15997858,16026847,28989
"1724","WBGene00002176","II",1326995,1350136,23141
"1725","WBGene00002177","X",5368468,5372059,3591
"1726","WBGene00002178","IV",6957641,6963716,6075
"1727","WBGene00002179","I",7946186,7951593,5407
"1728","WBGene00002180","IV",1420929,1421770,841
"1729","WBGene00002181","I",14128594,14142207,13613
"1730","WBGene00002182","III",7339001,7343626,4625
"1731","WBGene00002183","II",7073796,7075551,1755
"1732","WBGene00002184","II",11688970,11696003,7033
"1733","WBGene00002185","III",13464829,13471348,6519
"1734","WBGene00002186","III",10098469,10101608,3139
"1735","WBGene00002187","IV",405621,410033,4412
"1736","WBGene00002188","IV",3606784,3609229,2445
"1737","WBGene00002189","I",14913623,14951924,38301
"1738","WBGene00002190","X",5970677,5977854,7177
"1739","WBGene00002191","I",10734022,10736615,2593
"1740","WBGene00002192","IV",11425742,11447060,21318
"1741","WBGene00002193","IV",9967095,9969181,2086
"1742","WBGene00002194","II",11640454,11641778,1324
"1743","WBGene00002195","X",8432663,8437346,4683
"1744","WBGene00002196","I",8288959,8291077,2118
"1745","WBGene00002198","I",7075918,7079566,3648
"1746","WBGene00002199","II",9431383,9433709,2326
"1747","WBGene00002200","II",9434021,9436120,2099
"1748","WBGene00002201","III",6118627,6124055,5428
"1749","WBGene00002202","III",4084003,4086636,2633
"1750","WBGene00002203","X",15269074,15281110,12036
"1751","WBGene00002204","IV",9832935,9834822,1887
"1752","WBGene00002205","I",11640687,11642206,1519
"1753","WBGene00002206","IV",9839057,9841084,2027
"1754","WBGene00002207","X",17186380,17193289,6909
"1755","WBGene00002208","IV",7875727,7877881,2154
"1756","WBGene00002210","X",2843922,2852520,8598
"1757","WBGene00002211","V",15244756,15247707,2951
"1758","WBGene00002212","III",8671772,8673626,1854
"1759","WBGene00002213","I",5086317,5093793,7476
"1760","WBGene00002214","IV",11083735,11086050,2315
"1761","WBGene00002215","V",5576481,5581713,5232
"1762","WBGene00002216","II",7842353,7845653,3300
"1763","WBGene00002217","X",3171424,3178695,7271
"1764","WBGene00002218","III",5030929,5036548,5619
"1765","WBGene00002219","III",10805930,10810999,5069
"1766","WBGene00002220","X",3159940,3164424,4484
"1767","WBGene00002221","IV",7797192,7800252,3060
"1768","WBGene00002222","IV",8756735,8762057,5322
"1769","WBGene00002223","IV",11341325,11359863,18538
"1770","WBGene00002224","X",5984975,5992103,7128
"1771","WBGene00002225","I",5577055,5579394,2339
"1772","WBGene00002226","I",9512428,9514755,2327
"1773","WBGene00002227","II",11465940,11467641,1701
"1774","WBGene00002228","IV",7040211,7043694,3483
"1775","WBGene00002229","III",13302743,13307259,4516
"1776","WBGene00002230","III",209992,230450,20458
"1777","WBGene00002231","III",8250636,8254286,3650
"1778","WBGene00002232","I",11675850,11680975,5125
"1779","WBGene00002233","X",6619022,6628017,8995
"1780","WBGene00002234","X",8243131,8246369,3238
"1781","WBGene00002235","II",13703877,13712911,9034
"1782","WBGene00002238","II",7070183,7072415,2232
"1783","WBGene00002239","X",8275158,8283301,8143
"1784","WBGene00002240","I",12047469,12059798,12329
"1785","WBGene00002241","V",12032257,12040873,8616
"1786","WBGene00002242","X",7690590,7707086,16496
"1787","WBGene00002243","IV",2964365,2978461,14096
"1788","WBGene00002244","III",2769358,2779053,9695
"1789","WBGene00002245","IV",6095411,6110639,15228
"1790","WBGene00002246","V",3188350,3189841,1491
"1791","WBGene00002247","IV",5173280,5183708,10428
"1792","WBGene00002248","I",10608466,10621433,12967
"1793","WBGene00002249","III",8399190,8401928,2738
"1794","WBGene00002250","V",13043712,13046355,2643
"1795","WBGene00002251","II",8896841,8908666,11825
"1796","WBGene00002252","II",4359082,4368332,9250
"1797","WBGene00002253","X",3259087,3259855,768
"1798","WBGene00002254","X",3260610,3261470,860
"1799","WBGene00002255","X",3257010,3258155,1145
"1800","WBGene00002256","V",7820578,7821477,899
"1801","WBGene00002257","I",6731267,6732280,1013
"1802","WBGene00002258","I",6728290,6729376,1086
"1803","WBGene00002259","V",13879552,13880213,661
"1804","WBGene00002260","V",13890679,13891364,685
"1805","WBGene00002261","X",11028917,11040612,11695
"1806","WBGene00002262","II",11724204,11726533,2329
"1807","WBGene00002263","V",10011871,10028158,16287
"1808","WBGene00002264","II",13195549,13199603,4054
"1809","WBGene00002265","II",10009608,10016183,6575
"1810","WBGene00002266","II",9991160,10000350,9190
"1811","WBGene00002267","III",3771425,3773394,1969
"1812","WBGene00002268","II",5839639,5841134,1495
"1813","WBGene00002269","III",599509,600366,857
"1814","WBGene00002270","X",9852139,9852909,770
"1815","WBGene00002271","X",9850209,9851375,1166
"1816","WBGene00002272","X",17600412,17601503,1091
"1817","WBGene00002273","V",6488203,6489120,917
"1818","WBGene00002274","IV",6588184,6590307,2123
"1819","WBGene00002275","II",14063450,14066170,2720
"1820","WBGene00002276","I",9578526,9581267,2741
"1821","WBGene00002280","X",16380597,16389371,8774
"1822","WBGene00002282","X",14577935,14580921,2986
"1823","WBGene00002295","II",8770975,8782020,11045
"1824","WBGene00002297","II",10778389,10783962,5573
"1825","WBGene00002299","II",9197518,9207210,9692
"1826","WBGene00002324","I",14820381,14821651,1270
"1827","WBGene00002335","IV",11688227,11691088,2861
"1828","WBGene00002344","IV",11080989,11082253,1264
"1829","WBGene00002348","I",7258915,7267117,8202
"1830","WBGene00002363","IV",11856629,11860460,3831
"1831","WBGene00002368","IV",12567842,12570622,2780
"1832","WBGene00002393","I",557375,561671,4296
"1833","WBGene00002497","II",10033309,10039980,6671
"1834","WBGene00002583","I",5245743,5263413,17670
"1835","WBGene00002601","I",6320289,6324018,3729
"1836","WBGene00002632","V",7972924,7977774,4850
"1837","WBGene00002637","V",5826833,5832866,6033
"1838","WBGene00002694","I",4738171,4744321,6150
"1839","WBGene00002696","I",4129469,4132292,2823
"1840","WBGene00002717","I",5300901,5317392,16491
"1841","WBGene00002783","I",6574004,6585510,11506
"1842","WBGene00002804","I",5162599,5164884,2285
"1843","WBGene00002827","IV",11885530,11891081,5551
"1844","WBGene00002845","III",6946718,6958882,12164
"1845","WBGene00002850","III",6383552,6389401,5849
"1846","WBGene00002855","III",6444693,6446943,2250
"1847","WBGene00002879","III",7949975,7951915,1940
"1848","WBGene00002881","III",6407129,6410018,2889
"1849","WBGene00002889","III",6592567,6601171,8604
"1850","WBGene00002891","III",6338508,6340228,1720
"1851","WBGene00002915","III",2658083,2681112,23029
"1852","WBGene00002957","II",11022370,11027909,5539
"1853","WBGene00002974","IV",13174157,13179457,5300
"1854","WBGene00002975","X",11560915,11563697,2782
"1855","WBGene00002976","X",6281847,6291732,9885
"1856","WBGene00002977","I",14390333,14400222,9889
"1857","WBGene00002978","I",14621173,14631254,10081
"1858","WBGene00002979","I",5023889,5041149,17260
"1859","WBGene00002980","II",6346960,6347719,759
"1860","WBGene00002981","IV",10934186,10935914,1728
"1861","WBGene00002982","III",5697477,5698013,536
"1862","WBGene00002983","X",5525199,5538514,13315
"1863","WBGene00002985","V",10814113,10816718,2605
"1864","WBGene00002986","III",7521004,7524836,3832
"1865","WBGene00002987","X",3869753,3873295,3542
"1866","WBGene00002988","X",1073908,1079451,5543
"1867","WBGene00002989","I",5716574,5725772,9198
"1868","WBGene00002990","IV",2275864,2300351,24487
"1869","WBGene00002991","X",12399517,12414037,14520
"1870","WBGene00002992","IV",11054308,11063613,9305
"1871","WBGene00002994","II",7860574,7863563,2989
"1872","WBGene00002996","II",14346877,14348792,1915
"1873","WBGene00002997","II",3056822,3060207,3385
"1874","WBGene00002998","III",8900237,8904160,3923
"1875","WBGene00002999","I",8109746,8119314,9568
"1876","WBGene00003000","I",10248256,10255327,7071
"1877","WBGene00003001","III",9060096,9071760,11664
"1878","WBGene00003002","III",7700338,7709491,9153
"1879","WBGene00003003","X",11465557,11484368,18811
"1880","WBGene00003006","I",2706883,2717549,10666
"1881","WBGene00003007","X",3958497,3961907,3410
"1882","WBGene00003008","IV",3019738,3022315,2577
"1883","WBGene00003009","II",6371295,6374544,3249
"1884","WBGene00003010","IV",12129504,12135096,5592
"1885","WBGene00003011","V",12649858,12658718,8860
"1886","WBGene00003012","II",7682198,7684760,2562
"1887","WBGene00003014","I",8407802,8410804,3002
"1888","WBGene00003015","II",11917642,11935343,17701
"1889","WBGene00003017","II",3982549,3986944,4395
"1890","WBGene00003018","X",2229208,2230122,914
"1891","WBGene00003019","IV",5930645,5933326,2681
"1892","WBGene00003020","I",5807709,5815637,7928
"1893","WBGene00003021","III",8016648,8020873,4225
"1894","WBGene00003022","III",7070800,7072552,1752
"1895","WBGene00003024","III",7528641,7536632,7991
"1896","WBGene00003025","V",3704988,3712796,7808
"1897","WBGene00003026","I",9334812,9342496,7684
"1898","WBGene00003029","I",4126056,4129307,3251
"1899","WBGene00003030","IV",6742538,6748424,5886
"1900","WBGene00003031","V",12968855,12970730,1875
"1901","WBGene00003033","III",3745461,3747451,1990
"1902","WBGene00003034","IV",8620683,8626149,5466
"1903","WBGene00003035","III",9824081,9824750,669
"1904","WBGene00003036","I",9618207,9619760,1553
"1905","WBGene00003037","IV",13241051,13243401,2350
"1906","WBGene00003038","II",10450607,10452004,1397
"1907","WBGene00003039","V",14364412,14364509,97
"1908","WBGene00003040","I",3713142,3721157,8015
"1909","WBGene00003041","I",7248828,7251422,2594
"1910","WBGene00003043","IV",6842964,6845805,2841
"1911","WBGene00003044","II",7672010,7682359,10349
"1912","WBGene00003045","II",7667993,7671905,3912
"1913","WBGene00003046","II",11183075,11184807,1732
"1914","WBGene00003047","III",13371175,13376710,5535
"1915","WBGene00003048","III",13701993,13724401,22408
"1916","WBGene00003052","I",8762986,8765633,2647
"1917","WBGene00003053","X",6376459,6377684,1225
"1918","WBGene00003055","III",5474478,5478005,3527
"1919","WBGene00003056","X",4738964,4749083,10119
"1920","WBGene00003057","V",12197437,12198645,1208
"1921","WBGene00003058","II",10109279,10121825,12546
"1922","WBGene00003059","I",6253701,6254947,1246
"1923","WBGene00003060","I",3565012,3600729,35717
"1924","WBGene00003061","I",4372255,4373018,763
"1925","WBGene00003062","I",3144410,3147793,3383
"1926","WBGene00003063","III",7573350,7575263,1913
"1927","WBGene00003064","IV",10387413,10388345,932
"1928","WBGene00003065","V",10579309,10580693,1384
"1929","WBGene00003066","IV",9092281,9093975,1694
"1930","WBGene00003067","III",9504764,9507081,2317
"1931","WBGene00003068","I",10879769,10894239,14470
"1932","WBGene00003071","I",7614176,7634135,19959
"1933","WBGene00003072","I",3935272,3953991,18719
"1934","WBGene00003073","III",4181543,4186825,5282
"1935","WBGene00003074","I",7457153,7460756,3603
"1936","WBGene00003075","V",12252623,12255450,2827
"1937","WBGene00003076","II",11126932,11127530,598
"1938","WBGene00003077","IV",13387469,13389209,1740
"1939","WBGene00003078","II",7252230,7253222,992
"1940","WBGene00003079","V",15569935,15570742,807
"1941","WBGene00003080","I",1701361,1701808,447
"1942","WBGene00003081","IV",10933502,10934200,698
"1943","WBGene00003082","IV",6326526,6329461,2935
"1944","WBGene00003083","I",10588177,10590464,2287
"1945","WBGene00003084","X",4378004,4383366,5362
"1946","WBGene00003085","IV",14071503,14076743,5240
"1947","WBGene00003086","IV",14061005,14069854,8849
"1948","WBGene00003087","X",2089659,2093253,3594
"1949","WBGene00003088","V",10647232,10647304,72
"1950","WBGene00003089","II",8088427,8092754,4327
"1951","WBGene00003090","V",10277827,10279127,1300
"1952","WBGene00003091","V",10280310,10281474,1164
"1953","WBGene00003092","V",10282204,10283544,1340
"1954","WBGene00003093","IV",11621443,11623174,1731
"1955","WBGene00003094","IV",11624255,11625582,1327
"1956","WBGene00003095","IV",11626910,11627947,1037
"1957","WBGene00003096","V",3481421,3482600,1179
"1958","WBGene00003097","II",5586165,5587651,1486
"1959","WBGene00003098","I",12454853,12455826,973
"1960","WBGene00003099","IV",8332826,8333559,733
"1961","WBGene00003100","II",9732137,9738035,5898
"1962","WBGene00003102","III",7776835,7783454,6619
"1963","WBGene00003104","X",892228,898117,5889
"1964","WBGene00003106","II",516014,521605,5591
"1965","WBGene00003107","II",10528084,10533880,5796
"1966","WBGene00003111","I",1644588,1651394,6806
"1967","WBGene00003112","III",4600737,4603052,2315
"1968","WBGene00003114","V",10633058,10635411,2353
"1969","WBGene00003119","II",13311459,13320911,9452
"1970","WBGene00003123","I",11912005,11912677,672
"1971","WBGene00003124","X",3114668,3116538,1870
"1972","WBGene00003129","IV",3683537,3686865,3328
"1973","WBGene00003130","IV",16847829,16854943,7114
"1974","WBGene00003132","I",5123916,5127199,3283
"1975","WBGene00003133","II",11112719,11120788,8069
"1976","WBGene00003134","III",475454,482322,6868
"1977","WBGene00003136","I",8125801,8130091,4290
"1978","WBGene00003142","IV",13378016,13380407,2391
"1979","WBGene00003143","V",13098910,13110337,11427
"1980","WBGene00003144","II",13014331,13025838,11507
"1981","WBGene00003148","IV",11479358,11480369,1011
"1982","WBGene00003149","X",14819909,14824540,4631
"1983","WBGene00003150","IV",13009116,13035955,26839
"1984","WBGene00003151","IV",9625910,9634948,9038
"1985","WBGene00003153","IV",3103157,3133147,29990
"1986","WBGene00003154","II",12001510,12006625,5115
"1987","WBGene00003155","V",15056719,15059599,2880
"1988","WBGene00003156","I",2318291,2321847,3556
"1989","WBGene00003157","III",4288264,4291283,3019
"1990","WBGene00003158","III",9794367,9798643,4276
"1991","WBGene00003159","V",4347166,4349768,2602
"1992","WBGene00003160","V",9541782,9544226,2444
"1993","WBGene00003161","IV",2636228,2641117,4889
"1994","WBGene00003162","III",6606247,6608106,1859
"1995","WBGene00003163","X",6742351,6743899,1548
"1996","WBGene00003164","V",7058547,7059624,1077
"1997","WBGene00003165","V",6956537,6966422,9885
"1998","WBGene00003166","X",5567240,5590815,23575
"1999","WBGene00003167","IV",10458863,10461766,2903
"2000","WBGene00003168","X",16803368,16807125,3757
"2001","WBGene00003169","X",15944009,15948951,4942
"2002","WBGene00003170","I",6724917,6728330,3413
"2003","WBGene00003171","X",7774859,7776689,1830
"2004","WBGene00003172","I",9441010,9450731,9721
"2005","WBGene00003173","V",9907632,9915103,7471
"2006","WBGene00003174","X",8465832,8470256,4424
"2007","WBGene00003175","III",3131574,3139234,7660
"2008","WBGene00003176","III",7190207,7192992,2785
"2009","WBGene00003177","II",10236936,10239695,2759
"2010","WBGene00003178","IV",7983854,7987183,3329
"2011","WBGene00003179","X",4271169,4274229,3060
"2012","WBGene00003180","X",12430609,12431268,659
"2013","WBGene00003181","III",6884503,6885027,524
"2014","WBGene00003182","I",9095957,9100862,4905
"2015","WBGene00003183","I",8294881,8296940,2059
"2016","WBGene00003184","I",6564749,6565868,1119
"2017","WBGene00003185","X",7479248,7481010,1762
"2018","WBGene00003186","I",3005403,3013448,8045
"2019","WBGene00003196","II",9358531,9369098,10567
"2020","WBGene00003209","I",9132538,9135753,3215
"2021","WBGene00003210","III",4786080,4792391,6311
"2022","WBGene00003214","III",6440145,6443000,2855
"2023","WBGene00003218","IV",11524642,11527954,3312
"2024","WBGene00003219","X",11857478,11862373,4895
"2025","WBGene00003220","II",14383973,14388454,4481
"2026","WBGene00003221","I",4996839,5003161,6322
"2027","WBGene00003222","V",13433050,13437545,4495
"2028","WBGene00003224","IV",8511284,8513476,2192
"2029","WBGene00003225","III",10334267,10335171,904
"2030","WBGene00003228","II",11968637,11972334,3697
"2031","WBGene00003229","I",127297,134065,6768
"2032","WBGene00003230","IV",13353723,13356104,2381
"2033","WBGene00003231","II",9524174,9526390,2216
"2034","WBGene00003232","X",9968517,9976392,7875
"2035","WBGene00003233","I",10384219,10391388,7169
"2036","WBGene00003234","III",11848152,11849522,1370
"2037","WBGene00003235","V",11976777,11978459,1682
"2038","WBGene00003236","I",7312797,7313525,728
"2039","WBGene00003237","IV",6335249,6335994,745
"2040","WBGene00003238","I",948569,957404,8835
"2041","WBGene00003239","X",11548608,11550740,2132
"2042","WBGene00003241","II",8182323,8185023,2700
"2043","WBGene00003242","V",7827201,7842388,15187
"2044","WBGene00003243","III",8279108,8305832,26724
"2045","WBGene00003245","X",4796095,4800128,4033
"2046","WBGene00003246","II",13741742,13749983,8241
"2047","WBGene00003247","X",10421655,10428650,6995
"2048","WBGene00003248","V",11446633,11449245,2612
"2049","WBGene00003249","III",13403234,13404514,1280
"2050","WBGene00003252","III",5877020,5878419,1399
"2051","WBGene00003253","III",8763291,8767342,4051
"2052","WBGene00003254","X",5945821,5948869,3048
"2053","WBGene00003258","I",3233391,3255678,22287
"2054","WBGene00003260","I",6172662,6172757,95
"2055","WBGene00003261","I",9372768,9372865,97
"2056","WBGene00003262","X",2969752,2969848,96
"2057","WBGene00003265","II",11537833,11537930,97
"2058","WBGene00003266","II",11537933,11538027,94
"2059","WBGene00003267","II",11538089,11538175,86
"2060","WBGene00003269","II",11538308,11538404,96
"2061","WBGene00003270","II",11889811,11889905,94
"2062","WBGene00003272","II",11890023,11890118,95
"2063","WBGene00003273","II",11880944,11881039,95
"2064","WBGene00003274","III",13660515,13660611,96
"2065","WBGene00003275","X",13921250,13921346,96
"2066","WBGene00003277","X",9989282,9989378,96
"2067","WBGene00003278","I",1738635,1738733,98
"2068","WBGene00003279","IV",11026013,11026112,99
"2069","WBGene00003280","IV",14034008,14034107,99
"2070","WBGene00003281","IV",11027593,11027691,98
"2071","WBGene00003282","X",13144996,13145094,98
"2072","WBGene00003283","X",13144827,13144924,97
"2073","WBGene00003284","X",13144691,13144787,96
"2074","WBGene00003286","IV",3233254,3233350,96
"2075","WBGene00003287","IV",11309154,11309253,99
"2076","WBGene00003289","V",11770060,11770156,96
"2077","WBGene00003290","X",12692608,12692665,57
"2078","WBGene00003291","X",17598765,17598868,103
"2079","WBGene00003292","III",2172848,2172957,109
"2080","WBGene00003293","III",2173002,2173101,99
"2081","WBGene00003295","III",5931349,5931447,98
"2082","WBGene00003298","V",6665536,6665635,99
"2083","WBGene00003299","I",9379927,9380020,93
"2084","WBGene00003300","II",2452838,2452936,98
"2085","WBGene00003304","III",3142045,3142141,96
"2086","WBGene00003305","II",12519268,12519367,99
"2087","WBGene00003307","I",9332946,9333043,97
"2088","WBGene00003308","III",8865270,8865367,97
"2089","WBGene00003309","X",2431072,2431179,107
"2090","WBGene00003310","X",2435258,2435354,96
"2091","WBGene00003311","IV",7841631,7841728,97
"2092","WBGene00003312","X",16022404,16022478,74
"2093","WBGene00003313","II",8393553,8393658,105
"2094","WBGene00003314","III",11936637,11936734,97
"2095","WBGene00003317","V",10634199,10634223,24
"2096","WBGene00003318","III",8873987,8874084,97
"2097","WBGene00003319","IV",11871738,11871833,95
"2098","WBGene00003321","IV",5562025,5562122,97
"2099","WBGene00003322","III",2172452,2172566,114
"2100","WBGene00003323","X",5803892,5803989,97
"2101","WBGene00003324","III",7545057,7545155,98
"2102","WBGene00003325","IV",10994169,10994266,97
"2103","WBGene00003326","X",12078587,12078684,97
"2104","WBGene00003328","I",6162291,6162387,96
"2105","WBGene00003329","II",7030180,7030277,97
"2106","WBGene00003331","III",8867328,8867425,97
"2107","WBGene00003332","X",11792445,11792542,97
"2108","WBGene00003333","X",11791302,11791399,97
"2109","WBGene00003334","X",7882622,7882718,96
"2110","WBGene00003335","V",14366188,14366283,95
"2111","WBGene00003336","IV",4274247,4274342,95
"2112","WBGene00003337","IV",4450779,4450876,97
"2113","WBGene00003338","I",4684316,4684414,98
"2114","WBGene00003339","I",7887371,7887467,96
"2115","WBGene00003340","IV",10940134,10940230,96
"2116","WBGene00003342","X",2262373,2262470,97
"2117","WBGene00003345","X",11004728,11004824,96
"2118","WBGene00003349","V",5440639,5440748,109
"2119","WBGene00003350","V",6956043,6956143,100
"2120","WBGene00003351","V",17140668,17140769,101
"2121","WBGene00003353","V",10539025,10539125,100
"2122","WBGene00003354","II",3306234,3306336,102
"2123","WBGene00003355","II",5969058,5969156,98
"2124","WBGene00003356","V",18736683,18736790,107
"2125","WBGene00003357","X",2819254,2819346,92
"2126","WBGene00003359","X",3755150,3755243,93
"2127","WBGene00003360","II",12638134,12638226,92
"2128","WBGene00003361","V",11137110,11137204,94
"2129","WBGene00003362","IV",273900,273993,93
"2130","WBGene00003363","IV",3258455,3258549,94
"2131","WBGene00003365","III",11637966,11638060,94
"2132","WBGene00003366","II",14947039,14947132,93
"2133","WBGene00003367","II",10824294,10841424,17130
"2134","WBGene00003368","X",10027856,10030130,2274
"2135","WBGene00003369","X",17459115,17460778,1663
"2136","WBGene00003370","X",17455779,17456586,807
"2137","WBGene00003371","III",5565025,5567382,2357
"2138","WBGene00003372","III",3392514,3393787,1273
"2139","WBGene00003373","III",13509301,13514570,5269
"2140","WBGene00003374","V",5056378,5064803,8425
"2141","WBGene00003375","III",5971530,5973664,2134
"2142","WBGene00003376","III",7460341,7461931,1590
"2143","WBGene00003377","X",4758804,4761612,2808
"2144","WBGene00003378","III",7370131,7374731,4600
"2145","WBGene00003380","X",7422641,7424881,2240
"2146","WBGene00003384","X",10136129,10138620,2491
"2147","WBGene00003385","V",6502369,6504181,1812
"2148","WBGene00003386","V",8909725,8914033,4308
"2149","WBGene00003387","I",3035193,3047794,12601
"2150","WBGene00003388","II",13160545,13165733,5188
"2151","WBGene00003389","III",9952056,9956271,4215
"2152","WBGene00003390","II",4324361,4326089,1728
"2153","WBGene00003391","III",5308600,5311140,2540
"2154","WBGene00003392","II",14552501,14561599,9098
"2155","WBGene00003393","II",5399538,5405810,6272
"2156","WBGene00003394","X",6293124,6298195,5071
"2157","WBGene00003395","V",8355953,8358185,2232
"2158","WBGene00003396","I",9895693,9900817,5124
"2159","WBGene00003397","I",9965580,9970037,4457
"2160","WBGene00003400","I",1305562,1328348,22786
"2161","WBGene00003401","III",4216764,4228108,11344
"2162","WBGene00003402","II",5104118,5108901,4783
"2163","WBGene00003403","II",6292652,6294356,1704
"2164","WBGene00003404","II",10738635,10775061,36426
"2165","WBGene00003405","V",10733931,10736892,2961
"2166","WBGene00003406","III",12871195,12874654,3459
"2167","WBGene00003407","X",576318,587483,11165
"2168","WBGene00003408","X",563719,572701,8982
"2169","WBGene00003409","X",15929958,15939324,9366
"2170","WBGene00003410","X",9884278,9889704,5426
"2171","WBGene00003411","X",14938502,14946317,7815
"2172","WBGene00003412","X",4177917,4186756,8839
"2173","WBGene00003413","V",19674843,19693043,18200
"2174","WBGene00003414","III",12283208,12303216,20008
"2175","WBGene00003415","IV",11631941,11635487,3546
"2176","WBGene00003417","III",11747042,11750160,3118
"2177","WBGene00003418","I",3694296,3697549,3253
"2178","WBGene00003420","II",7077848,7078569,721
"2179","WBGene00003421","IV",13155228,13164056,8828
"2180","WBGene00003422","I",3449326,3462177,12851
"2181","WBGene00003423","III",3964663,3976391,11728
"2182","WBGene00003424","II",4785861,4786316,455
"2183","WBGene00003425","IV",9837616,9838065,449
"2184","WBGene00003426","IV",5260554,5261010,456
"2185","WBGene00003429","II",4916179,4916562,383
"2186","WBGene00003430","II",4898829,4899188,359
"2187","WBGene00003431","II",4892270,4892728,458
"2188","WBGene00003432","IV",10095398,10095851,453
"2189","WBGene00003433","IV",10143995,10144175,180
"2190","WBGene00003434","IV",10143312,10143775,463
"2191","WBGene00003435","II",4825380,4825837,457
"2192","WBGene00003437","II",4787159,4787520,361
"2193","WBGene00003438","II",5156700,5157083,383
"2194","WBGene00003442","II",5194332,5194792,460
"2195","WBGene00003443","II",5199763,5200223,460
"2196","WBGene00003444","IV",5294922,5295375,453
"2197","WBGene00003445","IV",5265592,5265921,329
"2198","WBGene00003446","IV",5064643,5065153,510
"2199","WBGene00003448","IV",5055593,5056049,456
"2200","WBGene00003449","IV",9841443,9841961,518
"2201","WBGene00003450","IV",5062534,5062995,461
"2202","WBGene00003451","IV",5308593,5308826,233
"2203","WBGene00003452","IV",5312693,5313149,456
"2204","WBGene00003456","II",5797036,5797482,446
"2205","WBGene00003457","II",5809917,5810342,425
"2206","WBGene00003458","IV",5316487,5316944,457
"2207","WBGene00003460","II",5012874,5013275,401
"2208","WBGene00003462","II",5115102,5115335,233
"2209","WBGene00003463","IV",9688982,9689433,451
"2210","WBGene00003464","IV",9894596,9895038,442
"2211","WBGene00003465","IV",9770013,9770459,446
"2212","WBGene00003466","IV",9766745,9767187,442
"2213","WBGene00003467","IV",9835991,9836452,461
"2214","WBGene00003468","IV",5297927,5298380,453
"2215","WBGene00003469","II",5797893,5798341,448
"2216","WBGene00003470","II",4932991,4933450,459
"2217","WBGene00003471","I",15001854,15005608,3754
"2218","WBGene00003472","I",5795404,5801299,5895
"2219","WBGene00003473","V",6691371,6691863,492
"2220","WBGene00003474","V",14018270,14018673,403
"2221","WBGene00003475","I",5134709,5137971,3262
"2222","WBGene00003476","III",3789982,3800547,10565
"2223","WBGene00003477","X",5234669,5243408,8739
"2224","WBGene00003478","III",13347085,13355683,8598
"2225","WBGene00003479","V",3743576,3749401,5825
"2226","WBGene00003480","II",6618218,6622168,3950
"2227","WBGene00003482","III",10160697,10183529,22832
"2228","WBGene00003485","X",16262295,16265686,3391
"2229","WBGene00003495","X",6408470,6410359,1889
"2230","WBGene00003497","III",7479680,7489075,9395
"2231","WBGene00003499","I",6356614,6358410,1796
"2232","WBGene00003504","III",9539031,9542380,3349
"2233","WBGene00003507","V",5658713,5660704,1991
"2234","WBGene00003508","I",10080159,10085777,5618
"2235","WBGene00003509","V",11244839,11245927,1088
"2236","WBGene00003510","III",186951,188131,1180
"2237","WBGene00003511","X",13349639,13350804,1165
"2238","WBGene00003514","X",12468061,12475348,7287
"2239","WBGene00003515","V",12226816,12234343,7527
"2240","WBGene00003516","I",4229577,4236039,6462
"2241","WBGene00003517","X",14895145,14898449,3304
"2242","WBGene00003518","III",9038779,9043300,4521
"2243","WBGene00003519","III",10152795,10157923,5128
"2244","WBGene00003520","III",13405965,13409292,3327
"2245","WBGene00003522","V",9478163,9479601,1438
"2246","WBGene00003523","III",6411816,6414993,3177
"2247","WBGene00003524","I",9886200,9888154,1954
"2248","WBGene00003525","IV",17486871,17490779,3908
"2249","WBGene00003526","II",7400544,7402724,2180
"2250","WBGene00003527","IV",7114899,7119926,5027
"2251","WBGene00003528","V",4836027,4840010,3983
"2252","WBGene00003529","X",10960982,10964725,3743
"2253","WBGene00003530","X",6713577,6716381,2804
"2254","WBGene00003531","IV",10224023,10226342,2319
"2255","WBGene00003532","X",15425274,15428180,2906
"2256","WBGene00003533","IV",13170544,13173694,3150
"2257","WBGene00003534","X",777721,780514,2793
"2258","WBGene00003535","V",11392320,11393508,1188
"2259","WBGene00003536","V",11398916,11400528,1612
"2260","WBGene00003537","V",11396434,11397717,1283
"2261","WBGene00003538","V",11401195,11402690,1495
"2262","WBGene00003539","V",11470868,11472349,1481
"2263","WBGene00003540","V",11472561,11473973,1412
"2264","WBGene00003541","V",11474699,11477951,3252
"2265","WBGene00003542","II",7491399,7493699,2300
"2266","WBGene00003543","V",13769669,13771279,1610
"2267","WBGene00003544","II",8826069,8828215,2146
"2268","WBGene00003545","II",1175976,1179323,3347
"2269","WBGene00003546","III",6181078,6183218,2140
"2270","WBGene00003547","II",5138648,5142036,3388
"2271","WBGene00003548","I",943664,947710,4046
"2272","WBGene00003549","V",10918861,10921847,2986
"2273","WBGene00003550","V",894930,899187,4257
"2274","WBGene00003551","X",6451800,6455179,3379
"2275","WBGene00003552","I",7527224,7531715,4491
"2276","WBGene00003553","X",9944844,9949060,4216
"2277","WBGene00003554","X",558141,563657,5516
"2278","WBGene00003555","X",16456927,16471325,14398
"2279","WBGene00003556","V",15837524,15839522,1998
"2280","WBGene00003558","III",4965571,4979729,14158
"2281","WBGene00003559","III",7719791,7738105,18314
"2282","WBGene00003561","X",4472244,4488851,16607
"2283","WBGene00003562","III",8258345,8265805,7460
"2284","WBGene00003563","X",960569,963202,2633
"2285","WBGene00003564","I",10033461,10034816,1355
"2286","WBGene00003565","X",1054081,1056843,2762
"2287","WBGene00003566","V",20105632,20120675,15043
"2288","WBGene00003567","V",5303689,5311246,7557
"2289","WBGene00003568","IV",10716648,10721755,5107
"2290","WBGene00003569","I",9808904,9813075,4171
"2291","WBGene00003570","V",10486473,10490048,3575
"2292","WBGene00003571","III",9710312,9713928,3616
"2293","WBGene00003572","III",9715883,9720291,4408
"2294","WBGene00003573","V",4983748,4987197,3449
"2295","WBGene00003574","V",4991505,4995214,3709
"2296","WBGene00003575","V",7930475,7933098,2623
"2297","WBGene00003576","IV",10086137,10088437,2300
"2298","WBGene00003577","III",4462833,4467377,4544
"2299","WBGene00003578","I",12679207,12681816,2609
"2300","WBGene00003579","V",2662964,2665003,2039
"2301","WBGene00003580","II",4953589,4954503,914
"2302","WBGene00003581","I",13792645,13794152,1507
"2303","WBGene00003582","IV",13513369,13521870,8501
"2304","WBGene00003583","II",5388829,5390104,1275
"2305","WBGene00003584","I",4239088,4242727,3639
"2306","WBGene00003585","I",13503045,13507064,4019
"2307","WBGene00003586","IV",11009981,11012020,2039
"2308","WBGene00003587","I",10373368,10373862,494
"2309","WBGene00003588","III",5225621,5226801,1180
"2310","WBGene00003589","III",10325613,10330422,4809
"2311","WBGene00003590","III",4442081,4444237,2156
"2312","WBGene00003591","V",4851472,4857260,5788
"2313","WBGene00003592","II",7538187,7543000,4813
"2314","WBGene00003593","III",6159842,6164588,4746
"2315","WBGene00003594","III",11923886,11929376,5490
"2316","WBGene00003595","IV",2626132,2628271,2139
"2317","WBGene00003596","I",8394728,8398626,3898
"2318","WBGene00003597","III",9147395,9153909,6514
"2319","WBGene00003598","III",4894647,4899085,4438
"2320","WBGene00003599","II",595207,602120,6913
"2321","WBGene00003600","X",17518445,17528197,9752
"2322","WBGene00003601","I",5818477,5821134,2657
"2323","WBGene00003602","X",14558504,14561425,2921
"2324","WBGene00003603","IV",9879329,9882152,2823
"2325","WBGene00003604","IV",15400284,15407160,6876
"2326","WBGene00003605","III",3573585,3578771,5186
"2327","WBGene00003606","IV",11266290,11271352,5062
"2328","WBGene00003607","IV",7710975,7714198,3223
"2329","WBGene00003608","III",7095553,7097079,1526
"2330","WBGene00003609","III",7112300,7115438,3138
"2331","WBGene00003610","IV",9070010,9073622,3612
"2332","WBGene00003611","V",10082141,10084043,1902
"2333","WBGene00003612","V",2192477,2196823,4346
"2334","WBGene00003613","X",8473723,8476176,2453
"2335","WBGene00003614","V",320204,323647,3443
"2336","WBGene00003615","II",4438867,4440867,2000
"2337","WBGene00003616","X",12663760,12667854,4094
"2338","WBGene00003617","V",2227203,2228981,1778
"2339","WBGene00003618","II",9598197,9605526,7329
"2340","WBGene00003619","III",4230436,4233219,2783
"2341","WBGene00003620","II",7339229,7349124,9895
"2342","WBGene00003621","II",6446079,6449819,3740
"2343","WBGene00003622","I",7214745,7221781,7036
"2344","WBGene00003623","X",13008493,13013962,5469
"2345","WBGene00003624","X",16354976,16359654,4678
"2346","WBGene00003625","IV",8022656,8029513,6857
"2347","WBGene00003626","X",13251964,13256282,4318
"2348","WBGene00003627","IV",9664365,9675672,11307
"2349","WBGene00003628","X",4532430,4537545,5115
"2350","WBGene00003629","IV",9710202,9712419,2217
"2351","WBGene00003630","X",2594003,2606732,12729
"2352","WBGene00003632","V",6998819,7000651,1832
"2353","WBGene00003633","IV",11899683,11902910,3227
"2354","WBGene00003634","V",8961915,8964099,2184
"2355","WBGene00003635","X",4656433,4660318,3885
"2356","WBGene00003636","IV",5747376,5757862,10486
"2357","WBGene00003637","V",5505253,5509956,4703
"2358","WBGene00003638","X",15708195,15716444,8249
"2359","WBGene00003639","I",9869632,9874676,5044
"2360","WBGene00003640","V",15997761,16000653,2892
"2361","WBGene00003641","V",15674026,15675620,1594
"2362","WBGene00003642","V",15677582,15680074,2492
"2363","WBGene00003643","V",15700606,15702363,1757
"2364","WBGene00003644","V",16503947,16505917,1970
"2365","WBGene00003645","V",478162,480710,2548
"2366","WBGene00003646","V",2219004,2221305,2301
"2367","WBGene00003647","V",4131925,4134981,3056
"2368","WBGene00003648","V",532290,534064,1774
"2369","WBGene00003649","V",2276018,2278246,2228
"2370","WBGene00003650","V",15770302,15773239,2937
"2371","WBGene00003651","II",14816136,14840005,23869
"2372","WBGene00003652","I",9839598,9844809,5211
"2373","WBGene00003653","V",16002588,16004728,2140
"2374","WBGene00003654","I",3094513,3109596,15083
"2375","WBGene00003655","V",18839310,18845401,6091
"2376","WBGene00003656","IV",8226337,8236602,10265
"2377","WBGene00003657","IV",11169834,11174783,4949
"2378","WBGene00003658","V",11573440,11575709,2269
"2379","WBGene00003659","I",9879183,9881504,2321
"2380","WBGene00003660","V",18616599,18620043,3444
"2381","WBGene00003661","X",13747315,13751777,4462
"2382","WBGene00003662","II",3849053,3850725,1672
"2383","WBGene00003663","I",11433671,11436018,2347
"2384","WBGene00003664","I",11429029,11432145,3116
"2385","WBGene00003665","II",3866798,3868243,1445
"2386","WBGene00003667","I",12384277,12385731,1454
"2387","WBGene00003668","IV",4274341,4277875,3534
"2388","WBGene00003669","V",19207684,19211895,4211
"2389","WBGene00003670","III",12170,14869,2699
"2390","WBGene00003671","I",12328100,12329508,1408
"2391","WBGene00003672","I",12245456,12246751,1295
"2392","WBGene00003673","V",632155,633893,1738
"2393","WBGene00003674","V",15876732,15879619,2887
"2394","WBGene00003675","I",13055664,13062122,6458
"2395","WBGene00003676","V",2061111,2066844,5733
"2396","WBGene00003677","IV",1624064,1626666,2602
"2397","WBGene00003678","II",2976639,2987023,10384
"2398","WBGene00003679","I",12439936,12441253,1317
"2399","WBGene00003680","V",610445,612513,2068
"2400","WBGene00003681","X",15309374,15314899,5525
"2401","WBGene00003682","IV",1620094,1623739,3645
"2402","WBGene00003683","V",3536196,3538407,2211
"2403","WBGene00003684","V",7684363,7686335,1972
"2404","WBGene00003685","V",19076654,19082641,5987
"2405","WBGene00003686","V",2233482,2235138,1656
"2406","WBGene00003687","IV",9757648,9764494,6846
"2407","WBGene00003688","V",454009,456772,2763
"2408","WBGene00003689","V",474791,477150,2359
"2409","WBGene00003690","IV",9728676,9731314,2638
"2410","WBGene00003691","V",11570400,11572370,1970
"2411","WBGene00003692","V",15874093,15876408,2315
"2412","WBGene00003693","V",2225430,2227042,1612
"2413","WBGene00003694","IV",4784233,4788692,4459
"2414","WBGene00003695","IV",7049954,7053450,3496
"2415","WBGene00003696","V",489647,491430,1783
"2416","WBGene00003697","V",6995215,6997123,1908
"2417","WBGene00003698","V",15922939,15924471,1532
"2418","WBGene00003699","II",4433332,4435169,1837
"2419","WBGene00003700","V",1622636,1624433,1797
"2420","WBGene00003701","V",16123055,16124781,1726
"2421","WBGene00003702","V",16722061,16723844,1783
"2422","WBGene00003703","I",11473218,11475677,2459
"2423","WBGene00003704","V",4187185,4190008,2823
"2424","WBGene00003705","V",2288487,2294798,6311
"2425","WBGene00003706","V",16912234,16915350,3116
"2426","WBGene00003707","V",1619194,1621536,2342
"2427","WBGene00003708","V",4407819,4410280,2461
"2428","WBGene00003709","II",2794974,2800600,5626
"2429","WBGene00003710","X",6636561,6640620,4059
"2430","WBGene00003711","III",2449382,2454949,5567
"2431","WBGene00003712","IV",1613897,1616766,2869
"2432","WBGene00003713","V",451451,453746,2295
"2433","WBGene00003714","V",3880798,3886204,5406
"2434","WBGene00003715","V",4322121,4325515,3394
"2435","WBGene00003716","V",2229081,2230984,1903
"2436","WBGene00003717","V",16261647,16263953,2306
"2437","WBGene00003718","V",2221948,2225296,3348
"2438","WBGene00003719","V",13329193,13331019,1826
"2439","WBGene00003720","V",480811,483355,2544
"2440","WBGene00003721","V",494499,497287,2788
"2441","WBGene00003722","V",534446,536226,1780
"2442","WBGene00003723","V",2210516,2212114,1598
"2443","WBGene00003724","V",2231124,2233381,2257
"2444","WBGene00003725","V",7091714,7093770,2056
"2445","WBGene00003726","V",12107142,12109201,2059
"2446","WBGene00003727","X",6661791,6669011,7220
"2447","WBGene00003728","IV",9725251,9728576,3325
"2448","WBGene00003729","X",16017263,16021776,4513
"2449","WBGene00003730","II",7690711,7693957,3246
"2450","WBGene00003731","V",7540890,7544838,3948
"2451","WBGene00003732","X",6914254,6921126,6872
"2452","WBGene00003733","X",10576960,10581054,4094
"2453","WBGene00003734","II",1670833,1674337,3504
"2454","WBGene00003735","I",12825664,12834143,8479
"2455","WBGene00003736","IV",11930872,11935718,4846
"2456","WBGene00003738","V",12910113,12917198,7085
"2457","WBGene00003739","X",3727553,3728446,893
"2458","WBGene00003740","X",2343947,2344766,819
"2459","WBGene00003741","X",13177856,13178447,591
"2460","WBGene00003742","I",10517324,10518055,731
"2461","WBGene00003743","II",8238455,8243747,5292
"2462","WBGene00003744","X",17662458,17665357,2899
"2463","WBGene00003745","X",8593187,8593974,787
"2464","WBGene00003746","I",7800458,7801822,1364
"2465","WBGene00003747","V",4219643,4222197,2554
"2466","WBGene00003748","III",3933577,3935908,2331
"2467","WBGene00003749","II",9689664,9691939,2275
"2468","WBGene00003750","I",1843384,1843899,515
"2469","WBGene00003751","V",4236418,4238056,1638
"2470","WBGene00003752","X",8917421,8919423,2002
"2471","WBGene00003753","I",12988223,12995475,7252
"2472","WBGene00003754","IV",6255071,6259858,4787
"2473","WBGene00003755","IV",13505270,13505762,492
"2474","WBGene00003756","II",11027962,11030404,2442
"2475","WBGene00003757","X",10958761,10959178,417
"2476","WBGene00003758","IV",7642052,7643096,1044
"2477","WBGene00003759","III",11388606,11393261,4655
"2478","WBGene00003760","X",2341359,2342089,730
"2479","WBGene00003761","X",2342458,2342967,509
"2480","WBGene00003762","V",11616283,11616829,546
"2481","WBGene00003763","V",19607511,19608346,835
"2482","WBGene00003764","V",19613461,19614533,1072
"2483","WBGene00003765","V",3989377,3989770,393
"2484","WBGene00003766","V",3987900,3988312,412
"2485","WBGene00003767","V",3984413,3984847,434
"2486","WBGene00003768","V",3981980,3982741,761
"2487","WBGene00003769","V",3980055,3980622,567
"2488","WBGene00003770","III",486123,486547,424
"2489","WBGene00003771","V",11147336,11147737,401
"2490","WBGene00003772","IV",12170824,12178335,7511
"2491","WBGene00003773","II",10000335,10001198,863
"2492","WBGene00003774","II",5440243,5446705,6462
"2493","WBGene00003775","V",15006412,15011660,5248
"2494","WBGene00003776","X",2909536,2918038,8502
"2495","WBGene00003777","I",7926623,7934577,7954
"2496","WBGene00003778","X",6122315,6127541,5226
"2497","WBGene00003779","III",12077747,12084316,6569
"2498","WBGene00003783","II",10951879,10953165,1286
"2499","WBGene00003784","II",7065618,7067051,1433
"2500","WBGene00003785","II",9746316,9750454,4138
"2501","WBGene00003786","V",7075877,7081569,5692
"2502","WBGene00003787","IV",9858488,9862118,3630
"2503","WBGene00003788","I",8291289,8293640,2351
"2504","WBGene00003789","II",11865523,11874702,9179
"2505","WBGene00003790","I",14701122,14706522,5400
"2506","WBGene00003791","II",11596767,11599809,3042
"2507","WBGene00003792","I",5176466,5182801,6335
"2508","WBGene00003793","I",5691838,5697506,5668
"2509","WBGene00003794","IV",1567921,1595824,27903
"2510","WBGene00003795","III",3400644,3404479,3835
"2511","WBGene00003796","III",6013536,6019562,6026
"2512","WBGene00003797","I",3817996,3821505,3509
"2513","WBGene00003798","I",6447304,6453933,6629
"2514","WBGene00003799","I",2097346,2123443,26097
"2515","WBGene00003800","I",9660174,9664915,4741
"2516","WBGene00003801","III",7929013,7932993,3980
"2517","WBGene00003802","III",11915891,11917876,1985
"2518","WBGene00003803","I",10026188,10030058,3870
"2519","WBGene00003804","III",13296853,13299122,2269
"2520","WBGene00003805","II",10796646,10798479,1833
"2521","WBGene00003806","IV",1490653,1496022,5369
"2522","WBGene00003807","X",4767178,4769985,2807
"2523","WBGene00003808","IV",9568828,9580071,11243
"2524","WBGene00003812","V",13828208,13831040,2832
"2525","WBGene00003813","II",8028953,8032742,3789
"2526","WBGene00003815","I",7088030,7090062,2032
"2527","WBGene00003816","V",8546128,8548880,2752
"2528","WBGene00003818","I",7766532,7772231,5699
"2529","WBGene00003821","II",8280855,8283208,2353
"2530","WBGene00003822","II",5022764,5029982,7218
"2531","WBGene00003825","II",4372740,4376742,4002
"2532","WBGene00003826","III",11831008,11846465,15457
"2533","WBGene00003827","IV",7910575,7915184,4609
"2534","WBGene00003828","X",9539905,9542430,2525
"2535","WBGene00003829","III",13341527,13342607,1080
"2536","WBGene00003830","V",20829811,20837552,7741
"2537","WBGene00003831","II",11097841,11100146,2305
"2538","WBGene00003834","V",14412400,14415014,2614
"2539","WBGene00003835","V",14416067,14417835,1768
"2540","WBGene00003836","I",2929736,2931361,1625
"2541","WBGene00003837","IV",8464752,8472605,7853
"2542","WBGene00003838","V",10764366,10768454,4088
"2543","WBGene00003839","IV",8213826,8220036,6210
"2544","WBGene00003840","X",15168722,15173621,4899
"2545","WBGene00003841","IV",7329620,7332811,3191
"2546","WBGene00003842","I",9888356,9892223,3867
"2547","WBGene00003843","X",11346455,11350244,3789
"2548","WBGene00003844","V",6898540,6900223,1683
"2549","WBGene00003845","III",7108322,7109741,1419
"2550","WBGene00003846","X",6159388,6160523,1135
"2551","WBGene00003847","I",10409302,10414707,5405
"2552","WBGene00003848","X",13544822,13550824,6002
"2553","WBGene00003849","V",7103697,7114436,10739
"2554","WBGene00003850","V",13246591,13249536,2945
"2555","WBGene00003851","III",6730781,6733935,3154
"2556","WBGene00003854","X",12459069,12461639,2570
"2557","WBGene00003856","X",6864313,6865939,1626
"2558","WBGene00003858","III",7145816,7153795,7979
"2559","WBGene00003859","III",6524051,6525660,1609
"2560","WBGene00003860","II",13006610,13008164,1554
"2561","WBGene00003861","V",14729643,14731129,1486
"2562","WBGene00003862","II",9866648,9868736,2088
"2563","WBGene00003863","II",9847483,9849597,2114
"2564","WBGene00003864","IV",8888976,8890999,2023
"2565","WBGene00003865","V",8029439,8031214,1775
"2566","WBGene00003868","II",11493231,11495321,2090
"2567","WBGene00003870","II",8993169,8994533,1364
"2568","WBGene00003876","IV",10790598,10794597,3999
"2569","WBGene00003877","X",6456687,6461767,5080
"2570","WBGene00003878","I",6133245,6137978,4733
"2571","WBGene00003879","IV",7977836,7979014,1178
"2572","WBGene00003882","II",10873931,10877934,4003
"2573","WBGene00003883","X",16541330,16551211,9881
"2574","WBGene00003884","IV",3796306,3800461,4155
"2575","WBGene00003885","X",2984278,2991375,7097
"2576","WBGene00003886","V",11924632,11927406,2774
"2577","WBGene00003887","III",13576188,13580662,4474
"2578","WBGene00003888","II",7604193,7605401,1208
"2579","WBGene00003889","IV",3551090,3557431,6341
"2580","WBGene00003890","III",7243305,7245743,2438
"2581","WBGene00003891","X",17420211,17421582,1371
"2582","WBGene00003892","III",12191056,12202450,11394
"2583","WBGene00003893","IV",1107396,1110856,3460
"2584","WBGene00003898","III",10858284,10866994,8710
"2585","WBGene00003901","III",5450106,5453137,3031
"2586","WBGene00003902","I",10432815,10435882,3067
"2587","WBGene00003903","X",13522264,13527483,5219
"2588","WBGene00003904","I",9420907,9421992,1085
"2589","WBGene00003905","I",12878595,12902806,24211
"2590","WBGene00003906","I",4984760,4986739,1979
"2591","WBGene00003907","X",4291475,4297630,6155
"2592","WBGene00003909","X",14951200,14954544,3344
"2593","WBGene00003911","X",6044309,6048610,4301
"2594","WBGene00003912","III",4804708,4809489,4781
"2595","WBGene00003914","IV",7543984,7550812,6828
"2596","WBGene00003915","III",4562738,4566276,3538
"2597","WBGene00003916","V",14112039,14145411,33372
"2598","WBGene00003917","III",1081402,1095073,13671
"2599","WBGene00003918","III",5664234,5676732,12498
"2600","WBGene00003919","V",18098676,18106868,8192
"2601","WBGene00003920","IV",11820505,11821917,1412
"2602","WBGene00003921","I",12669380,12674447,5067
"2603","WBGene00003922","V",14421566,14422618,1052
"2604","WBGene00003923","V",10770321,10771351,1030
"2605","WBGene00003924","I",5105110,5106204,1094
"2606","WBGene00003925","I",8727214,8728497,1283
"2607","WBGene00003926","I",10566350,10567300,950
"2608","WBGene00003927","V",5583161,5584343,1182
"2609","WBGene00003928","II",10098782,10099867,1085
"2610","WBGene00003929","III",8818899,8825270,6371
"2611","WBGene00003930","III",3908929,3914149,5220
"2612","WBGene00003931","III",89453,94809,5356
"2613","WBGene00003932","IV",261886,264232,2346
"2614","WBGene00003933","X",16536837,16540207,3370
"2615","WBGene00003934","I",5018770,5020166,1396
"2616","WBGene00003936","III",727211,752426,25215
"2617","WBGene00003937","V",8224965,8226037,1072
"2618","WBGene00003938","IV",4199501,4204375,4874
"2619","WBGene00003939","II",10146746,10152445,5699
"2620","WBGene00003941","III",2681451,2686463,5012
"2621","WBGene00003943","X",10954134,10958236,4102
"2622","WBGene00003947","IV",1708804,1709745,941
"2623","WBGene00003948","I",12967216,12968280,1064
"2624","WBGene00003949","II",4954480,4955427,947
"2625","WBGene00003950","I",3908747,3909701,954
"2626","WBGene00003951","I",14719167,14720477,1310
"2627","WBGene00003952","III",8243122,8244092,970
"2628","WBGene00003953","I",8695205,8696376,1171
"2629","WBGene00003954","V",5960585,5963882,3297
"2630","WBGene00003955","IV",4047937,4049448,1511
"2631","WBGene00003956","III",7758730,7761273,2543
"2632","WBGene00003957","IV",9160640,9165127,4487
"2633","WBGene00003958","IV",9155079,9159019,3940
"2634","WBGene00003959","V",19822748,19830099,7351
"2635","WBGene00003960","II",11574940,11577258,2318
"2636","WBGene00003961","IV",8176479,8188879,12400
"2637","WBGene00003962","III",3699740,3701476,1736
"2638","WBGene00003963","X",4524155,4526536,2381
"2639","WBGene00003964","I",7015912,7021743,5831
"2640","WBGene00003965","X",1321353,1327985,6632
"2641","WBGene00003966","II",7183806,7185192,1386
"2642","WBGene00003967","III",13771448,13773348,1900
"2643","WBGene00003968","X",2215630,2218980,3350
"2644","WBGene00003969","III",919528,926314,6786
"2645","WBGene00003970","X",11410181,11414887,4706
"2646","WBGene00003975","III",11343272,11344147,875
"2647","WBGene00003976","IV",5002752,5005418,2666
"2648","WBGene00003977","I",11355236,11356370,1134
"2649","WBGene00003978","III",1216116,1222072,5956
"2650","WBGene00003979","II",11827933,11830020,2087
"2651","WBGene00003980","I",14263301,14271321,8020
"2652","WBGene00003981","X",9251818,9255717,3899
"2653","WBGene00003982","V",14595268,14597067,1799
"2654","WBGene00003983","II",12846203,12847836,1633
"2655","WBGene00003986","X",4921252,4929757,8505
"2656","WBGene00003987","X",6901378,6903985,2607
"2657","WBGene00003989","I",12922004,12923548,1544
"2658","WBGene00003990","X",5353033,5354144,1111
"2659","WBGene00003991","X",1079446,1080653,1207
"2660","WBGene00003992","IV",6974401,6977318,2917
"2661","WBGene00003993","III",8670543,8675051,4508
"2662","WBGene00003994","V",4755985,4758584,2599
"2663","WBGene00003995","IV",12591697,12599169,7472
"2664","WBGene00003996","I",5886613,5895970,9357
"2665","WBGene00003997","X",11352136,11357094,4958
"2666","WBGene00003998","X",11358395,11364049,5654
"2667","WBGene00003999","X",10854320,10859297,4977
"2668","WBGene00004000","X",10871181,10877465,6284
"2669","WBGene00004001","X",10864969,10870237,5268
"2670","WBGene00004002","X",10859351,10864422,5071
"2671","WBGene00004003","V",17755892,17764751,8859
"2672","WBGene00004004","X",7159036,7166021,6985
"2673","WBGene00004005","II",7995587,8003152,7565
"2674","WBGene00004006","X",12731850,12737440,5590
"2675","WBGene00004007","X",12738882,12744057,5175
"2676","WBGene00004008","X",12744723,12749580,4857
"2677","WBGene00004009","X",12751377,12755962,4585
"2678","WBGene00004010","III",11131775,11136380,4605
"2679","WBGene00004011","X",633703,636993,3290
"2680","WBGene00004013","V",20752883,20760317,7434
"2681","WBGene00004014","I",2071352,2072547,1195
"2682","WBGene00004015","II",6251411,6252797,1386
"2683","WBGene00004016","III",2343573,2347329,3756
"2684","WBGene00004017","II",10137658,10139216,1558
"2685","WBGene00004020","II",5233154,5235926,2772
"2686","WBGene00004023","II",5236258,5238514,2256
"2687","WBGene00004024","III",12074290,12077556,3266
"2688","WBGene00004025","IV",12211098,12215987,4889
"2689","WBGene00004026","V",16833316,16839141,5825
"2690","WBGene00004027","III",12426862,12429195,2333
"2691","WBGene00004028","I",719929,731078,11149
"2692","WBGene00004029","IV",13416041,13421927,5886
"2693","WBGene00004030","IV",12793816,12796164,2348
"2694","WBGene00004031","IV",9791945,9796592,4647
"2695","WBGene00004032","V",12014385,12032131,17746
"2696","WBGene00004033","X",9364818,9386035,21217
"2697","WBGene00004034","II",5380027,5384169,4142
"2698","WBGene00004035","IV",15227883,15234973,7090
"2699","WBGene00004036","X",10794852,10815004,20152
"2700","WBGene00004037","V",15192572,15197661,5089
"2701","WBGene00004038","II",10222877,10229440,6563
"2702","WBGene00004039","IV",7509479,7512667,3188
"2703","WBGene00004040","II",5083848,5091690,7842
"2704","WBGene00004041","III",8852264,8864451,12187
"2705","WBGene00004042","III",8101348,8104076,2728
"2706","WBGene00004043","I",2755540,2758204,2664
"2707","WBGene00004044","IV",7470860,7473340,2480
"2708","WBGene00004045","III",365949,377560,11611
"2709","WBGene00004046","IV",7633360,7634657,1297
"2710","WBGene00004047","IV",959452,984392,24940
"2711","WBGene00004048","II",14417889,14424891,7002
"2712","WBGene00004049","I",2907730,2924713,16983
"2713","WBGene00004050","II",9593037,9595128,2091
"2714","WBGene00004051","IV",8746252,8752676,6424
"2715","WBGene00004052","IV",8712635,8715027,2392
"2716","WBGene00004053","V",1276420,1285700,9280
"2717","WBGene00004054","X",242291,252767,10476
"2718","WBGene00004055","IV",8148794,8151156,2362
"2719","WBGene00004056","IV",8143500,8148647,5147
"2720","WBGene00004057","IV",8139219,8143151,3932
"2721","WBGene00004058","II",6880701,6883754,3053
"2722","WBGene00004059","II",6884049,6887805,3756
"2723","WBGene00004060","V",14646739,14653464,6725
"2724","WBGene00004061","IV",17402463,17405630,3167
"2725","WBGene00004062","V",6662191,6665813,3622
"2726","WBGene00004063","I",13004437,13023625,19188
"2727","WBGene00004064","V",11566804,11573091,6287
"2728","WBGene00004068","I",6295067,6297625,2558
"2729","WBGene00004075","III",13514945,13524110,9165
"2730","WBGene00004076","II",1136781,1152701,15920
"2731","WBGene00004077","I",2823254,2830311,7057
"2732","WBGene00004078","V",8414085,8415254,1169
"2733","WBGene00004083","V",10702549,10704906,2357
"2734","WBGene00004084","IV",11876156,11877839,1683
"2735","WBGene00004085","III",12345323,12351336,6013
"2736","WBGene00004086","III",12374126,12377248,3122
"2737","WBGene00004087","I",5358522,5365170,6648
"2738","WBGene00004088","III",2102295,2107497,5202
"2739","WBGene00004089","X",12968950,12975643,6693
"2740","WBGene00004090","II",6965800,6967648,1848
"2741","WBGene00004091","IV",10162008,10164390,2382
"2742","WBGene00004092","V",6624702,6626344,1642
"2743","WBGene00004093","I",4185197,4189956,4759
"2744","WBGene00004094","I",5158511,5162231,3720
"2745","WBGene00004095","III",5311246,5321732,10486
"2746","WBGene00004096","II",11150299,11152600,2301
"2747","WBGene00004097","III",9736030,9736869,839
"2748","WBGene00004098","V",10382442,10384063,1621
"2749","WBGene00004099","V",5158623,5159907,1284
"2750","WBGene00004100","III",9996205,9997955,1750
"2751","WBGene00004101","IV",8201378,8206048,4670
"2752","WBGene00004102","III",6528202,6532088,3886
"2753","WBGene00004103","X",15966112,15972300,6188
"2754","WBGene00004104","V",5669611,5676111,6500
"2755","WBGene00004105","II",8966921,8969366,2445
"2756","WBGene00004106","X",4297860,4307574,9714
"2757","WBGene00004107","V",9174089,9175250,1161
"2758","WBGene00004108","X",12907832,12920176,12344
"2759","WBGene00004109","I",5902106,5904695,2589
"2760","WBGene00004110","I",6791025,6797470,6445
"2761","WBGene00004111","I",6773976,6780151,6175
"2762","WBGene00004112","IV",6019705,6033639,13934
"2763","WBGene00004113","I",4564035,4565976,1941
"2764","WBGene00004114","III",5509189,5512602,3413
"2765","WBGene00004115","I",8771275,8777514,6239
"2766","WBGene00004116","II",13448835,13460642,11807
"2767","WBGene00004117","I",8416831,8425042,8211
"2768","WBGene00004118","III",4643999,4646346,2347
"2769","WBGene00004119","V",9109584,9111013,1429
"2770","WBGene00004120","II",13108019,13110169,2150
"2771","WBGene00004121","X",17021821,17030219,8398
"2772","WBGene00004122","II",4612989,4626107,13118
"2773","WBGene00004123","X",15409149,15415493,6344
"2774","WBGene00004124","X",3247045,3250529,3484
"2775","WBGene00004125","III",8025210,8028042,2832
"2776","WBGene00004126","X",13965676,13968672,2996
"2777","WBGene00004127","X",450446,457648,7202
"2778","WBGene00004128","III",1905962,1939568,33606
"2779","WBGene00004129","II",2452970,2458981,6011
"2780","WBGene00004130","V",2781943,2807934,25991
"2781","WBGene00004131","I",5372854,5384508,11654
"2782","WBGene00004132","III",4471407,4475150,3743
"2783","WBGene00004133","III",6941889,6945895,4006
"2784","WBGene00004134","II",10496987,10502541,5554
"2785","WBGene00004135","II",4038868,4043070,4202
"2786","WBGene00004136","V",5049541,5052214,2673
"2787","WBGene00004138","V",12063432,12065391,1959
"2788","WBGene00004139","V",1464990,1466360,1370
"2789","WBGene00004140","IV",10286955,10293013,6058
"2790","WBGene00004141","X",8319308,8320986,1678
"2791","WBGene00004143","I",379071,381902,2831
"2792","WBGene00004144","V",504028,504616,588
"2793","WBGene00004145","X",5196110,5204250,8140
"2794","WBGene00004146","V",9616031,9617654,1623
"2795","WBGene00004147","I",3732982,3740479,7497
"2796","WBGene00004148","X",4610926,4620423,9497
"2797","WBGene00004149","II",2086719,2090618,3899
"2798","WBGene00004150","V",12924441,12928173,3732
"2799","WBGene00004151","V",12952636,12953208,572
"2800","WBGene00004152","V",11226314,11228703,2389
"2801","WBGene00004153","V",15465677,15467099,1422
"2802","WBGene00004154","I",3269406,3280883,11477
"2803","WBGene00004155","II",8540720,8545452,4732
"2804","WBGene00004156","IV",13329508,13331406,1898
"2805","WBGene00004157","IV",4072327,4077644,5317
"2806","WBGene00004158","IV",15579086,15580161,1075
"2807","WBGene00004161","III",12626568,12651757,25189
"2808","WBGene00004163","III",1849047,1852902,3855
"2809","WBGene00004164","III",13087479,13099455,11976
"2810","WBGene00004165","III",11700280,11702856,2576
"2811","WBGene00004166","II",240722,255182,14460
"2812","WBGene00004167","II",12209228,12225086,15858
"2813","WBGene00004168","I",1655616,1656726,1110
"2814","WBGene00004169","IV",6506726,6511042,4316
"2815","WBGene00004170","IV",15289901,15291262,1361
"2816","WBGene00004171","IV",15291907,15293444,1537
"2817","WBGene00004172","III",12307771,12311924,4153
"2818","WBGene00004173","V",20278160,20279861,1701
"2819","WBGene00004174","II",9225186,9227261,2075
"2820","WBGene00004175","III",8438061,8439412,1351
"2821","WBGene00004176","V",609144,609726,582
"2822","WBGene00004177","V",603665,604205,540
"2823","WBGene00004178","I",7585324,7588367,3043
"2824","WBGene00004179","IV",6526962,6529802,2840
"2825","WBGene00004180","III",9612254,9614281,2027
"2826","WBGene00004181","I",12528312,12532182,3870
"2827","WBGene00004182","III",6990168,7002310,12142
"2828","WBGene00004183","III",3363668,3370209,6541
"2829","WBGene00004184","X",3940141,3943313,3172
"2830","WBGene00004185","II",10539438,10541996,2558
"2831","WBGene00004186","I",7091309,7094537,3228
"2832","WBGene00004187","III",8164373,8172702,8329
"2833","WBGene00004188","II",484866,490403,5537
"2834","WBGene00004189","III",7238607,7241284,2677
"2835","WBGene00004190","I",12486872,12490931,4059
"2836","WBGene00004191","X",14313721,14326800,13079
"2837","WBGene00004192","IV",11644129,11646190,2061
"2838","WBGene00004193","X",6110754,6113057,2303
"2839","WBGene00004194","II",8704824,8706768,1944
"2840","WBGene00004195","V",4715388,4720148,4760
"2841","WBGene00004196","I",12971120,12972347,1227
"2842","WBGene00004197","X",11393293,11394619,1326
"2843","WBGene00004198","II",7250151,7252010,1859
"2844","WBGene00004199","IV",11183132,11184310,1178
"2845","WBGene00004201","III",8807482,8809329,1847
"2846","WBGene00004202","I",14172840,14179360,6520
"2847","WBGene00004203","V",20239180,20249482,10302
"2848","WBGene00004204","IV",11126024,11131162,5138
"2849","WBGene00004205","IV",4653293,4655848,2555
"2850","WBGene00004206","V",5943474,5950991,7517
"2851","WBGene00004207","II",10675602,10690271,14669
"2852","WBGene00004208","II",7893229,7900510,7281
"2853","WBGene00004209","II",6083628,6085858,2230
"2854","WBGene00004210","II",2845384,2852593,7209
"2855","WBGene00004211","V",9250275,9254223,3948
"2856","WBGene00004212","III",763810,771366,7556
"2857","WBGene00004213","III",3590734,3611993,21259
"2858","WBGene00004214","II",5918626,5921617,2991
"2859","WBGene00004215","II",10968386,11012247,43861
"2860","WBGene00004216","V",9177949,9181719,3770
"2861","WBGene00004217","I",3789309,3792797,3488
"2862","WBGene00004218","II",362495,367555,5060
"2863","WBGene00004219","X",6060754,6065986,5232
"2864","WBGene00004220","X",17318584,17326603,8019
"2865","WBGene00004221","II",5242452,5246837,4385
"2866","WBGene00004222","II",10889279,10893288,4009
"2867","WBGene00004223","III",9157243,9161653,4410
"2868","WBGene00004224","I",5662143,5667160,5017
"2869","WBGene00004225","I",160172,166819,6647
"2870","WBGene00004226","I",2587527,2595294,7767
"2871","WBGene00004227","II",11157094,11162481,5387
"2872","WBGene00004228","IV",10615427,10620958,5531
"2873","WBGene00004229","V",6966396,6970127,3731
"2874","WBGene00004230","V",1165673,1174969,9296
"2875","WBGene00004231","I",12834665,12843233,8568
"2876","WBGene00004232","II",12965546,12978168,12622
"2877","WBGene00004233","III",10781853,10791252,9399
"2878","WBGene00004234","II",15158180,15163614,5434
"2879","WBGene00004235","I",550696,556638,5942
"2880","WBGene00004236","V",18919296,18931379,12083
"2881","WBGene00004237","I",14909240,14913083,3843
"2882","WBGene00004238","X",13338052,13348118,10066
"2883","WBGene00004239","IV",13510307,13512162,1855
"2884","WBGene00004240","IV",3204559,3210582,6023
"2885","WBGene00004241","II",8575541,8577732,2191
"2886","WBGene00004242","II",13039790,13043476,3686
"2887","WBGene00004243","IV",5486685,5490322,3637
"2888","WBGene00004244","II",7296110,7298247,2137
"2889","WBGene00004245","X",5841592,5845987,4395
"2890","WBGene00004246","I",212256,215491,3235
"2891","WBGene00004248","V",16792764,16795007,2243
"2892","WBGene00004249","III",1821150,1824180,3030
"2893","WBGene00004254","IV",10164331,10174341,10010
"2894","WBGene00004255","III",10189218,10195399,6181
"2895","WBGene00004256","V",8494889,8502336,7447
"2896","WBGene00004257","X",10972172,10979265,7093
"2897","WBGene00004258","V",11817783,11822529,4746
"2898","WBGene00004259","II",8651109,8658808,7699
"2899","WBGene00004264","II",8198803,8204001,5198
"2900","WBGene00004265","IV",13561861,13574440,12579
"2901","WBGene00004266","V",1262628,1263989,1361
"2902","WBGene00004267","II",5721791,5727651,5860
"2903","WBGene00004268","I",9308442,9310221,1779
"2904","WBGene00004269","III",9004821,9005955,1134
"2905","WBGene00004270","X",17222475,17224464,1989
"2906","WBGene00004271","II",11965339,11966931,1592
"2907","WBGene00004272","I",3682772,3684118,1346
"2908","WBGene00004273","I",6457061,6458479,1418
"2909","WBGene00004274","I",108670,110107,1437
"2910","WBGene00004275","I",11633002,11638491,5489
"2911","WBGene00004276","X",15604635,15606635,2000
"2912","WBGene00004277","III",1078150,1080775,2625
"2913","WBGene00004278","IV",13382055,13384316,2261
"2914","WBGene00004279","II",8713992,8715013,1021
"2915","WBGene00004281","IV",9242225,9243999,1774
"2916","WBGene00004282","III",10563026,10565603,2577
"2917","WBGene00004283","III",10500284,10503853,3569
"2918","WBGene00004284","III",11306560,11311566,5006
"2919","WBGene00004285","X",4227857,4235846,7989
"2920","WBGene00004286","II",9321858,9322916,1058
"2921","WBGene00004287","IV",16308225,16309829,1604
"2922","WBGene00004296","V",12245594,12251246,5652
"2923","WBGene00004297","IV",10281637,10284244,2607
"2924","WBGene00004298","I",9065087,9070264,5177
"2925","WBGene00004300","II",11015588,11016881,1293
"2926","WBGene00004301","X",14550138,14556297,6159
"2927","WBGene00004302","III",10746581,10747728,1147
"2928","WBGene00004303","III",7933535,7937708,4173
"2929","WBGene00004304","II",8322612,8325052,2440
"2930","WBGene00004305","I",8591215,8591978,763
"2931","WBGene00004306","II",6048109,6049686,1577
"2932","WBGene00004307","IV",8916408,8918890,2482
"2933","WBGene00004308","V",15061488,15064087,2599
"2934","WBGene00004309","IV",11177286,11178200,914
"2935","WBGene00004310","II",12345285,12352243,6958
"2936","WBGene00004311","III",4737589,4740075,2486
"2937","WBGene00004312","I",9616508,9618107,1599
"2938","WBGene00004313","X",14611380,14624824,13444
"2939","WBGene00004314","III",2512283,2528628,16345
"2940","WBGene00004315","IV",12724948,12730095,5147
"2941","WBGene00004316","III",6675801,6703974,28173
"2942","WBGene00004317","X",14983533,14987365,3832
"2943","WBGene00004318","I",7962052,7972443,10391
"2944","WBGene00004319","IV",10920075,10926807,6732
"2945","WBGene00004320","V",9689686,9690615,929
"2946","WBGene00004321","III",5682310,5684098,1788
"2947","WBGene00004322","III",4052807,4057976,5169
"2948","WBGene00004323","V",9987916,9991642,3726
"2949","WBGene00004324","I",7280552,7282871,2319
"2950","WBGene00004326","III",10217302,10218646,1344
"2951","WBGene00004328","V",13598331,13600982,2651
"2952","WBGene00004332","I",717893,719816,1923
"2953","WBGene00004333","IV",13348870,13353193,4323
"2954","WBGene00004334","II",10218471,10220025,1554
"2955","WBGene00004335","X",7744239,7750010,5771
"2956","WBGene00004336","V",14829177,14847413,18236
"2957","WBGene00004337","V",14642739,14645979,3240
"2958","WBGene00004338","IV",1347316,1352977,5661
"2959","WBGene00004339","IV",13095762,13097065,1303
"2960","WBGene00004340","III",6972210,6973717,1507
"2961","WBGene00004341","III",7021167,7023652,2485
"2962","WBGene00004342","III",8226478,8227650,1172
"2963","WBGene00004343","III",9393981,9404532,10551
"2964","WBGene00004344","III",10014188,10016558,2370
"2965","WBGene00004345","X",12712653,12728391,15738
"2966","WBGene00004346","II",6100060,6110122,10062
"2967","WBGene00004347","II",12662759,12671920,9161
"2968","WBGene00004348","III",5698430,5702304,3874
"2969","WBGene00004349","X",5720438,5728656,8218
"2970","WBGene00004350","X",3542558,3557599,15041
"2971","WBGene00004352","X",1915258,1917162,1904
"2972","WBGene00004353","X",14962922,14963995,1073
"2973","WBGene00004354","X",14964553,14965976,1423
"2974","WBGene00004355","II",8878496,8883659,5163
"2975","WBGene00004356","X",4508509,4510960,2451
"2976","WBGene00004357","IV",16482784,16489021,6237
"2977","WBGene00004358","V",5428160,5430431,2271
"2978","WBGene00004359","V",11727900,11730160,2260
"2979","WBGene00004360","IV",11578757,11584066,5309
"2980","WBGene00004361","III",10742777,10746675,3898
"2981","WBGene00004363","IV",7818251,7821195,2944
"2982","WBGene00004364","V",10261131,10270314,9183
"2983","WBGene00004367","IV",2642979,2650104,7125
"2984","WBGene00004368","I",3778089,3781690,3601
"2985","WBGene00004369","X",8660619,8671753,11134
"2986","WBGene00004370","X",6853618,6860922,7304
"2987","WBGene00004371","IV",7991410,8004136,12726
"2988","WBGene00004372","I",9565394,9574377,8983
"2989","WBGene00004373","V",6208840,6217647,8807
"2990","WBGene00004374","IV",5469961,5473174,3213
"2991","WBGene00004375","X",10373235,10377832,4597
"2992","WBGene00004377","X",1097152,1103320,6168
"2993","WBGene00004378","I",8083583,8095574,11991
"2994","WBGene00004380","I",6009782,6011586,1804
"2995","WBGene00004381","III",4164275,4166845,2570
"2996","WBGene00004382","II",4995551,4998035,2484
"2997","WBGene00004383","II",8517150,8518412,1262
"2998","WBGene00004384","V",12192273,12194445,2172
"2999","WBGene00004385","IV",4172076,4173988,1912
"3000","WBGene00004386","IV",4174089,4176279,2190
"3001","WBGene00004387","III",4406286,4407326,1040
"3002","WBGene00004388","III",852801,853909,1108
"3003","WBGene00004389","I",3539554,3546904,7350
"3004","WBGene00004390","III",7158912,7161157,2245
"3005","WBGene00004391","III",9225374,9228786,3412
"3006","WBGene00004392","III",4093306,4094921,1615
"3007","WBGene00004393","I",5776154,5788610,12456
"3008","WBGene00004394","II",12172571,12176069,3498
"3009","WBGene00004395","V",8228300,8238409,10109
"3010","WBGene00004397","II",8733050,8734314,1264
"3011","WBGene00004398","II",7544069,7545335,1266
"3012","WBGene00004400","III",4907217,4908968,1751
"3013","WBGene00004401","III",9592282,9595667,3385
"3014","WBGene00004402","IV",16965284,16970490,5206
"3015","WBGene00004403","IV",16995777,17014953,19176
"3016","WBGene00004404","I",3217296,3222950,5654
"3017","WBGene00004405","V",10252821,10255055,2234
"3018","WBGene00004408","I",10567894,10569019,1125
"3019","WBGene00004409","I",2069086,2069587,501
"3020","WBGene00004410","IV",13369424,13370285,861
"3021","WBGene00004411","IV",7160135,7165748,5613
"3022","WBGene00004412","I",2875395,2876324,929
"3023","WBGene00004413","V",20479689,20480846,1157
"3024","WBGene00004414","III",3867852,3869587,1735
"3025","WBGene00004415","I",4645641,4646963,1322
"3026","WBGene00004416","II",8569927,8571100,1173
"3027","WBGene00004417","III",7208432,7209863,1431
"3028","WBGene00004418","I",111038,112417,1379
"3029","WBGene00004419","IV",4389135,4390649,1514
"3030","WBGene00004420","III",7572105,7572831,726
"3031","WBGene00004421","II",8143863,8144671,808
"3032","WBGene00004422","V",3585313,3586064,751
"3033","WBGene00004423","X",2241738,2242618,880
"3034","WBGene00004424","IV",13239588,13240651,1063
"3035","WBGene00004425","I",3788036,3788909,873
"3036","WBGene00004426","I",9689185,9690084,899
"3037","WBGene00004427","IV",653436,654576,1140
"3038","WBGene00004428","III",3502841,3503724,883
"3039","WBGene00004429","I",1156579,1157474,895
"3040","WBGene00004430","IV",13777808,13778812,1004
"3041","WBGene00004431","I",5484779,5486354,1575
"3042","WBGene00004432","IV",4749012,4749778,766
"3043","WBGene00004433","III",8129551,8130227,676
"3044","WBGene00004434","II",5055616,5056214,598
"3045","WBGene00004435","III",5705521,5706129,608
"3046","WBGene00004436","I",4585115,4586177,1062
"3047","WBGene00004437","I",9669415,9670098,683
"3048","WBGene00004438","X",4715178,4715801,623
"3049","WBGene00004439","I",8329062,8329684,622
"3050","WBGene00004440","II",8602787,8603581,794
"3051","WBGene00004441","I",1834881,1835439,558
"3052","WBGene00004442","V",12727593,12728112,519
"3053","WBGene00004443","IV",13882225,13882620,395
"3054","WBGene00004444","I",10436254,10436884,630
"3055","WBGene00004445","I",13652939,13653704,765
"3056","WBGene00004446","II",9056499,9057111,612
"3057","WBGene00004447","II",7105556,7106462,906
"3058","WBGene00004448","IV",12268995,12269533,538
"3059","WBGene00004449","III",7855118,7855680,562
"3060","WBGene00004450","III",7180249,7180677,428
"3061","WBGene00004451","III",3528547,3528968,421
"3062","WBGene00004452","V",15512166,15512780,614
"3063","WBGene00004453","V",7775742,7776079,337
"3064","WBGene00004454","II",11096542,11097204,662
"3065","WBGene00004455","II",11092713,11093871,1158
"3066","WBGene00004456","II",14155280,14155660,380
"3067","WBGene00004457","V",8805416,8819955,14539
"3068","WBGene00004458","IV",6906415,6909913,3498
"3069","WBGene00004459","III",6198902,6202594,3692
"3070","WBGene00004460","III",8447353,8449346,1993
"3071","WBGene00004461","II",4696419,4698427,2008
"3072","WBGene00004462","III",6959110,6962027,2917
"3073","WBGene00004463","IV",9316639,9318632,1993
"3074","WBGene00004464","I",4175319,4177271,1952
"3075","WBGene00004465","II",11237447,11239092,1645
"3076","WBGene00004466","I",10730712,10732448,1736
"3077","WBGene00004467","II",4043059,4044330,1271
"3078","WBGene00004468","II",11653096,11654194,1098
"3079","WBGene00004469","III",4752998,4754083,1085
"3080","WBGene00004470","III",4475918,4476887,969
"3081","WBGene00004471","IV",7925298,7926391,1093
"3082","WBGene00004472","III",6206803,6207971,1168
"3083","WBGene00004473","IV",7083694,7084682,988
"3084","WBGene00004474","IV",11110102,11111045,943
"3085","WBGene00004475","I",13952159,13953194,1035
"3086","WBGene00004476","I",10330879,10331808,929
"3087","WBGene00004477","IV",7312981,7313864,883
"3088","WBGene00004478","II",11125371,11126362,991
"3089","WBGene00004479","I",4583873,4584505,632
"3090","WBGene00004480","IV",11602641,11603283,642
"3091","WBGene00004481","III",5679298,5680187,889
"3092","WBGene00004482","III",6374048,6374997,949
"3093","WBGene00004483","III",7178984,7179606,622
"3094","WBGene00004484","I",8815554,8816193,639
"3095","WBGene00004485","V",15000011,15000594,583
"3096","WBGene00004486","I",6220090,6220766,676
"3097","WBGene00004487","IV",14825679,14826448,769
"3098","WBGene00004488","I",9621160,9625796,4636
"3099","WBGene00004489","I",14468321,14469354,1033
"3100","WBGene00004490","III",7189142,7189631,489
"3101","WBGene00004491","III",1950492,1951426,934
"3102","WBGene00004492","IV",12390264,12391396,1132
"3103","WBGene00004493","IV",385894,386607,713
"3104","WBGene00004494","IV",5947036,5947607,571
"3105","WBGene00004495","I",14759918,14760654,736
"3106","WBGene00004496","V",103394,104064,670
"3107","WBGene00004497","IV",1659691,1660011,320
"3108","WBGene00004498","III",794300,795120,820
"3109","WBGene00004499","V",7776576,7777236,660
"3110","WBGene00004501","V",11980502,11982450,1948
"3111","WBGene00004502","V",6016049,6017669,1620
"3112","WBGene00004503","III",6489793,6491282,1489
"3113","WBGene00004504","II",42181,46216,4035
"3114","WBGene00004505","I",5741868,5743571,1703
"3115","WBGene00004506","III",12370456,12372625,2169
"3116","WBGene00004507","II",6702233,6705643,3410
"3117","WBGene00004508","I",7643431,7649777,6346
"3118","WBGene00004509","I",12098671,12106112,7441
"3119","WBGene00004510","II",8162465,8168644,6179
"3120","WBGene00004512","I",15062083,15063836,1753
"3121","WBGene00004513","I",15069280,15071033,1753
"3122","WBGene00004567","I",15064301,15064453,152
"3123","WBGene00004622","I",15064838,15068346,3508
"3124","WBGene00004677","I",15060299,15061150,851
"3125","WBGene00004679","III",4914096,4917129,3033
"3126","WBGene00004680","II",6125559,6127942,2383
"3127","WBGene00004681","IV",13521970,13540271,18301
"3128","WBGene00004682","X",11798505,11803656,5151
"3129","WBGene00004684","I",8358254,8363858,5604
"3130","WBGene00004698","II",11453362,11455864,2502
"3131","WBGene00004699","II",11451444,11452955,1511
"3132","WBGene00004700","III",12686243,12687916,1673
"3133","WBGene00004701","II",5387411,5388830,1419
"3134","WBGene00004702","II",6490158,6491340,1182
"3135","WBGene00004703","IV",7789847,7791229,1382
"3136","WBGene00004704","II",10659206,10662317,3111
"3137","WBGene00004705","III",11826215,11830996,4781
"3138","WBGene00004706","I",11177805,11182115,4310
"3139","WBGene00004716","X",14228920,14228991,71
"3140","WBGene00004719","X",13487555,13500662,13107
"3141","WBGene00004721","I",6407458,6409212,1754
"3142","WBGene00004723","II",8034250,8035767,1517
"3143","WBGene00004726","III",8314349,8318588,4239
"3144","WBGene00004727","X",3646320,3650150,3830
"3145","WBGene00004728","III",5109701,5130673,20972
"3146","WBGene00004729","X",3451945,3465925,13980
"3147","WBGene00004732","IV",8062669,8084087,21418
"3148","WBGene00004735","III",11428367,11442566,14199
"3149","WBGene00004736","III",10811906,10816844,4938
"3150","WBGene00004737","II",4698721,4700994,2273
"3151","WBGene00004738","V",12763945,12767933,3988
"3152","WBGene00004739","X",12503885,12514048,10163
"3153","WBGene00004740","V",6633269,6639665,6396
"3154","WBGene00004742","IV",13056376,13057271,895
"3155","WBGene00004743","I",1862607,1872306,9699
"3156","WBGene00004744","II",9334014,9338896,4882
"3157","WBGene00004745","X",16275769,16282436,6667
"3158","WBGene00004746","X",11522707,11533450,10743
"3159","WBGene00004747","V",15039152,15048207,9055
"3160","WBGene00004748","V",20798218,20801207,2989
"3161","WBGene00004749","X",10589780,10593334,3554
"3162","WBGene00004750","II",3671908,3673593,1685
"3163","WBGene00004751","II",3950145,3972137,21992
"3164","WBGene00004752","II",9173175,9177152,3977
"3165","WBGene00004753","I",10446661,10452071,5410
"3166","WBGene00004754","V",20091263,20105685,14422
"3167","WBGene00004755","IV",11561986,11566194,4208
"3168","WBGene00004756","IV",12355604,12360792,5188
"3169","WBGene00004758","X",7816720,7821045,4325
"3170","WBGene00004759","V",12560710,12563383,2673
"3171","WBGene00004760","III",4596134,4612384,16250
"3172","WBGene00004762","III",4571753,4578437,6684
"3173","WBGene00004764","X",14332770,14340481,7711
"3174","WBGene00004765","III",3612951,3627142,14191
"3175","WBGene00004766","V",8301490,8302580,1090
"3176","WBGene00004767","V",13818132,13822980,4848
"3177","WBGene00004768","V",11767328,11769899,2571
"3178","WBGene00004769","X",915874,918290,2416
"3179","WBGene00004771","I",5204540,5215218,10678
"3180","WBGene00004773","I",7038900,7048832,9932
"3181","WBGene00004774","X",7959452,7961723,2271
"3182","WBGene00004775","I",3433157,3438543,5386
"3183","WBGene00004776","X",16579745,16587624,7879
"3184","WBGene00004777","X",15286579,15302963,16384
"3185","WBGene00004778","I",6820532,6823093,2561
"3186","WBGene00004779","III",1723194,1733101,9907
"3187","WBGene00004780","X",2673471,2682379,8908
"3188","WBGene00004781","III",6450792,6452372,1580
"3189","WBGene00004782","III",4922446,4930204,7758
"3190","WBGene00004783","IV",6329578,6333554,3976
"3191","WBGene00004786","X",10201329,10205433,4104
"3192","WBGene00004787","III",3086693,3091738,5045
"3193","WBGene00004788","X",5778875,5780758,1883
"3194","WBGene00004789","X",16254843,16262151,7308
"3195","WBGene00004790","II",8782029,8783670,1641
"3196","WBGene00004793","V",12973261,12987127,13866
"3197","WBGene00004795","V",5119939,5126916,6977
"3198","WBGene00004796","III",13679445,13682450,3005
"3199","WBGene00004798","III",10506106,10506801,695
"3200","WBGene00004800","IV",10363318,10366249,2931
"3201","WBGene00004801","X",13328252,13331248,2996
"3202","WBGene00004802","X",13332014,13333825,1811
"3203","WBGene00004803","I",5990741,5992658,1917
"3204","WBGene00004804","IV",5651087,5660523,9436
"3205","WBGene00004806","V",11645481,11650090,4609
"3206","WBGene00004807","I",9471341,9472642,1301
"3207","WBGene00004808","I",9469704,9470633,929
"3208","WBGene00004809","V",16121824,16122648,824
"3209","WBGene00004810","V",19924224,19925033,809
"3210","WBGene00004811","V",17347922,17348625,703
"3211","WBGene00004812","V",18269616,18269985,369
"3212","WBGene00004813","V",4422406,4423065,659
"3213","WBGene00004814","IV",17165191,17165855,664
"3214","WBGene00004815","IV",17163554,17164226,672
"3215","WBGene00004816","IV",15946784,15947438,654
"3216","WBGene00004817","V",16389241,16389865,624
"3217","WBGene00004818","IV",17167253,17168051,798
"3218","WBGene00004819","IV",17162024,17162634,610
"3219","WBGene00004820","V",4420997,4421596,599
"3220","WBGene00004821","II",3824148,3825614,1466
"3221","WBGene00004822","IV",7168710,7169346,636
"3222","WBGene00004823","II",7783829,7784654,825
"3223","WBGene00004824","IV",786234,794326,8092
"3224","WBGene00004825","X",13223644,13224712,1068
"3225","WBGene00004826","X",13222920,13223546,626
"3226","WBGene00004827","X",13225818,13226678,860
"3227","WBGene00004829","X",720330,725957,5627
"3228","WBGene00004830","V",18492265,18508201,15936
"3229","WBGene00004831","X",11394605,11405931,11326
"3230","WBGene00004833","II",5844865,5844974,109
"3231","WBGene00004834","II",5543598,5543707,109
"3232","WBGene00004835","II",5544164,5544273,109
"3233","WBGene00004836","I",4172206,4172315,109
"3234","WBGene00004837","III",7140447,7140553,106
"3235","WBGene00004838","I",9055149,9055262,113
"3236","WBGene00004839","I",9057890,9057999,109
"3237","WBGene00004840","III",12250465,12250575,110
"3238","WBGene00004841","I",13297877,13297985,108
"3239","WBGene00004842","IV",9130721,9130829,108
"3240","WBGene00004843","IV",9140415,9140523,108
"3241","WBGene00004844","IV",5261913,5262022,109
"3242","WBGene00004845","IV",5063422,5063531,109
"3243","WBGene00004846","III",11090412,11090523,111
"3244","WBGene00004847","III",11091010,11091121,111
"3245","WBGene00004848","III",7141391,7141499,108
"3246","WBGene00004849","IV",5317260,5317368,108
"3247","WBGene00004850","III",7142291,7142397,106
"3248","WBGene00004851","IV",5264907,5265021,114
"3249","WBGene00004854","X",14674328,14683326,8998
"3250","WBGene00004855","V",11899072,11916623,17551
"3251","WBGene00004856","III",8749763,8757069,7306
"3252","WBGene00004857","III",6860939,6863968,3029
"3253","WBGene00004858","III",5816203,5820200,3997
"3254","WBGene00004859","X",11997524,12005092,7568
"3255","WBGene00004860","II",6324484,6327355,2871
"3256","WBGene00004862","X",10769288,10782973,13685
"3257","WBGene00004873","III",11290911,11306145,15234
"3258","WBGene00004874","III",4587415,4593124,5709
"3259","WBGene00004875","I",14048085,14051003,2918
"3260","WBGene00004876","X",6719666,6723066,3400
"3261","WBGene00004877","X",6716358,6718670,2312
"3262","WBGene00004878","IV",2619875,2625438,5563
"3263","WBGene00004879","I",6900947,6913579,12632
"3264","WBGene00004880","I",1176471,1190829,14358
"3265","WBGene00004881","IV",6362395,6373087,10692
"3266","WBGene00004882","V",9775935,9777743,1808
"3267","WBGene00004883","I",6734029,6736161,2132
"3268","WBGene00004884","III",2473868,2486620,12752
"3269","WBGene00004885","IV",6740496,6742443,1947
"3270","WBGene00004886","III",1878365,1880866,2501
"3271","WBGene00004887","I",9511181,9512236,1055
"3272","WBGene00004888","I",1340678,1341258,580
"3273","WBGene00004889","I",14807467,14815725,8258
"3274","WBGene00004890","I",3666923,3671700,4777
"3275","WBGene00004891","III",1143172,1145211,2039
"3276","WBGene00004892","IV",11482668,11498167,15499
"3277","WBGene00004893","X",944826,948883,4057
"3278","WBGene00004894","III",1583155,1601140,17985
"3279","WBGene00004895","I",12995803,13012859,17056
"3280","WBGene00004896","II",3482408,3490143,7735
"3281","WBGene00004897","V",6655562,6656501,939
"3282","WBGene00004898","V",12344188,12345919,1731
"3283","WBGene00004899","III",8203091,8205114,2023
"3284","WBGene00004900","I",4980307,4983958,3651
"3285","WBGene00004901","I",8871791,8875253,3462
"3286","WBGene00004902","II",1092006,1097899,5893
"3287","WBGene00004903","II",12832915,12835824,2909
"3288","WBGene00004904","II",12861963,12865883,3920
"3289","WBGene00004905","III",1520224,1532768,12544
"3290","WBGene00004906","III",13005461,13011130,5669
"3291","WBGene00004907","IV",11965665,11968703,3038
"3292","WBGene00004908","IV",17312141,17315462,3321
"3293","WBGene00004909","V",10438366,10440823,2457
"3294","WBGene00004910","V",11305070,11308446,3376
"3295","WBGene00004911","X",9029478,9033955,4477
"3296","WBGene00004912","X",7327605,7329677,2072
"3297","WBGene00004913","IV",1805037,1815099,10062
"3298","WBGene00004914","IV",17088058,17088834,776
"3299","WBGene00004915","I",13339397,13340224,827
"3300","WBGene00004916","II",6488830,6489761,931
"3301","WBGene00004917","V",11978518,11979970,1452
"3302","WBGene00004918","III",7862070,7862577,507
"3303","WBGene00004919","III",12429172,12429630,458
"3304","WBGene00004920","I",2727014,2727545,531
"3305","WBGene00004921","II",6810963,6816443,5480
"3306","WBGene00004922","III",786532,793733,7201
"3307","WBGene00004923","V",1358187,1363784,5597
"3308","WBGene00004924","I",6436058,6441192,5134
"3309","WBGene00004925","V",1393112,1411616,18504
"3310","WBGene00004926","II",745418,750164,4746
"3311","WBGene00004927","X",1128986,1132925,3939
"3312","WBGene00004928","V",4642952,4646931,3979
"3313","WBGene00004929","IV",5127006,5152485,25479
"3314","WBGene00004930","II",6972712,6973892,1180
"3315","WBGene00004931","I",8417124,8435811,18687
"3316","WBGene00004932","X",17092718,17094223,1505
"3317","WBGene00004933","III",9497019,9500202,3183
"3318","WBGene00004944","I",7389049,7395918,6869
"3319","WBGene00004945","II",12339944,12344795,4851
"3320","WBGene00004946","I",2761158,2776097,14939
"3321","WBGene00004947","V",4517643,4549291,31648
"3322","WBGene00004949","X",7458293,7463736,5443
"3323","WBGene00004950","X",14690846,14692999,2153
"3324","WBGene00004951","X",3117439,3127073,9634
"3325","WBGene00004952","I",1030629,1033436,2807
"3326","WBGene00004953","I",8966985,8970158,3173
"3327","WBGene00004954","IV",6762716,6765200,2484
"3328","WBGene00004955","I",5171285,5176664,5379
"3329","WBGene00004958","I",7454660,7456953,2293
"3330","WBGene00004959","I",5101682,5103467,1785
"3331","WBGene00004960","III",11505535,11508919,3384
"3332","WBGene00004962","I",118109,120870,2761
"3333","WBGene00004963","I",11582743,11586069,3326
"3334","WBGene00004964","V",10384157,10385711,1554
"3335","WBGene00004965","I",5330578,5332194,1616
"3336","WBGene00004966","I",8224539,8226297,1758
"3337","WBGene00004969","I",1446497,1465358,18861
"3338","WBGene00004971","IV",12013420,12014045,625
"3339","WBGene00004972","IV",10389578,10391969,2391
"3340","WBGene00004973","IV",5864529,5865918,1389
"3341","WBGene00004974","IV",9933910,9934285,375
"3342","WBGene00004975","V",6785457,6787866,2409
"3343","WBGene00004976","III",3439023,3444207,5184
"3344","WBGene00004978","I",3467132,3478515,11383
"3345","WBGene00004979","IV",8132175,8133692,1517
"3346","WBGene00004980","III",9456563,9463004,6441
"3347","WBGene00004981","IV",379898,383185,3287
"3348","WBGene00004984","V",6783187,6784922,1735
"3349","WBGene00004985","IV",11123133,11124862,1729
"3350","WBGene00004986","III",10355122,10355982,860
"3351","WBGene00004987","X",7315995,7316818,823
"3352","WBGene00004988","X",7314969,7315353,384
"3353","WBGene00004989","X",7318239,7318798,559
"3354","WBGene00004990","X",7319935,7320384,449
"3355","WBGene00004991","X",7317341,7317681,340
"3356","WBGene00004992","IV",5412827,5415771,2944
"3357","WBGene00004993","IV",8481664,8483710,2046
"3358","WBGene00004994","X",11487788,11488178,390
"3359","WBGene00004995","IV",8477182,8480656,3474
"3360","WBGene00004996","II",6405391,6407379,1988
"3361","WBGene00004997","V",13889918,13890295,377
"3362","WBGene00004998","X",8417424,8418524,1100
"3363","WBGene00004999","X",7725955,7726383,428
"3364","WBGene00005000","I",6249556,6250197,641
"3365","WBGene00005001","V",10900563,10901303,740
"3366","WBGene00005002","I",1016403,1017180,777
"3367","WBGene00005003","IV",9593667,9594425,758
"3368","WBGene00005004","V",6560228,6561492,1264
"3369","WBGene00005005","V",6557767,6558310,543
"3370","WBGene00005006","V",8126663,8129352,2689
"3371","WBGene00005007","IV",8891466,8892747,1281
"3372","WBGene00005008","X",4514099,4516894,2795
"3373","WBGene00005009","I",8103601,8109227,5626
"3374","WBGene00005010","I",13438058,13450216,12158
"3375","WBGene00005011","III",4903997,4905473,1476
"3376","WBGene00005013","II",11806567,11808805,2238
"3377","WBGene00005014","III",69073,69817,744
"3378","WBGene00005015","IV",12051484,12055785,4301
"3379","WBGene00005016","II",11336693,11337837,1144
"3380","WBGene00005017","II",23328,24458,1130
"3381","WBGene00005018","V",12352994,12354314,1320
"3382","WBGene00005019","IV",8361089,8363370,2281
"3383","WBGene00005020","II",2889104,2894395,5291
"3384","WBGene00005021","III",9778782,9780350,1568
"3385","WBGene00005022","V",10659635,10661467,1832
"3386","WBGene00005023","I",9947812,9953387,5575
"3387","WBGene00005024","V",951454,964800,13346
"3388","WBGene00005025","II",7010798,7012690,1892
"3389","WBGene00005026","II",9647887,9649367,1480
"3390","WBGene00005027","II",9520200,9521670,1470
"3391","WBGene00005028","II",9528780,9529862,1082
"3392","WBGene00005029","II",9539274,9540823,1549
"3393","WBGene00005030","II",9541601,9542885,1284
"3394","WBGene00005031","II",9546438,9547647,1209
"3395","WBGene00005032","II",9548405,9549698,1293
"3396","WBGene00005033","II",9544686,9546208,1522
"3397","WBGene00005035","II",9532299,9533974,1675
"3398","WBGene00005036","II",10893275,10895088,1813
"3399","WBGene00005037","II",10908808,10910319,1511
"3400","WBGene00005038","II",10902756,10904479,1723
"3401","WBGene00005039","II",8407685,8409237,1552
"3402","WBGene00005040","II",12885276,12888606,3330
"3403","WBGene00005041","II",9527031,9528253,1222
"3404","WBGene00005042","II",9530517,9531253,736
"3405","WBGene00005043","I",12688727,12690572,1845
"3406","WBGene00005044","I",12692169,12693724,1555
"3407","WBGene00005045","I",12694406,12695934,1528
"3408","WBGene00005046","I",12696558,12698214,1656
"3409","WBGene00005047","I",12699430,12701093,1663
"3410","WBGene00005048","I",12701439,12702886,1447
"3411","WBGene00005049","I",12703435,12704727,1292
"3412","WBGene00005050","I",12705097,12706983,1886
"3413","WBGene00005051","I",12686116,12688206,2090
"3414","WBGene00005052","II",6649789,6651819,2030
"3415","WBGene00005053","II",6569014,6570434,1420
"3416","WBGene00005054","II",6570547,6573777,3230
"3417","WBGene00005055","II",6574378,6575747,1369
"3418","WBGene00005056","IV",15192299,15203023,10724
"3419","WBGene00005057","II",6576974,6578478,1504
"3420","WBGene00005058","II",4529636,4531964,2328
"3421","WBGene00005059","II",4534742,4537241,2499
"3422","WBGene00005060","II",4541865,4543668,1803
"3423","WBGene00005061","II",4524634,4527900,3266
"3424","WBGene00005062","II",4538988,4540731,1743
"3425","WBGene00005063","X",13890993,13893334,2341
"3426","WBGene00005064","X",13897934,13900147,2213
"3427","WBGene00005065","X",13901064,13903428,2364
"3428","WBGene00005066","II",5169726,5171032,1306
"3429","WBGene00005067","II",5168110,5169324,1214
"3430","WBGene00005068","II",5165315,5166838,1523
"3431","WBGene00005069","II",5163868,5165020,1152
"3432","WBGene00005070","II",5161995,5163383,1388
"3433","WBGene00005071","II",10194905,10196835,1930
"3434","WBGene00005072","III",7177530,7178853,1323
"3435","WBGene00005074","III",7174073,7175806,1733
"3436","WBGene00005075","III",6493553,6494781,1228
"3437","WBGene00005076","III",6491368,6492907,1539
"3438","WBGene00005077","I",1566929,1580196,13267
"3439","WBGene00005078","I",14322237,14328965,6728
"3440","WBGene00005079","II",10180199,10182734,2535
"3441","WBGene00005080","II",10185789,10187908,2119
"3442","WBGene00005081","II",126938,128706,1768
"3443","WBGene00005082","V",12184949,12186245,1296
"3444","WBGene00005083","IV",5672633,5674542,1909
"3445","WBGene00005084","IV",5647432,5648910,1478
"3446","WBGene00005085","IV",10785024,10786831,1807
"3447","WBGene00005086","IV",5643349,5645614,2265
"3448","WBGene00005087","V",5351783,5353067,1284
"3449","WBGene00005088","IV",13575058,13576740,1682
"3450","WBGene00005089","V",13617851,13619686,1835
"3451","WBGene00005090","IV",5628792,5630239,1447
"3452","WBGene00005091","IV",5633818,5635651,1833
"3453","WBGene00005092","IV",5637835,5640190,2355
"3454","WBGene00005093","V",5904917,5906352,1435
"3455","WBGene00005094","V",5898538,5900040,1502
"3456","WBGene00005095","V",13430651,13432714,2063
"3457","WBGene00005096","V",13425572,13426882,1310
"3458","WBGene00005097","V",13427607,13428760,1153
"3459","WBGene00005098","V",6055589,6056743,1154
"3460","WBGene00005099","V",16629900,16631155,1255
"3461","WBGene00005100","V",4954250,4955989,1739
"3462","WBGene00005101","IV",15179922,15182953,3031
"3463","WBGene00005102","V",16632737,16634085,1348
"3464","WBGene00005103","V",7632032,7633172,1140
"3465","WBGene00005104","V",14161551,14162841,1290
"3466","WBGene00005105","V",15803383,15804451,1068
"3467","WBGene00005106","V",15250604,15251671,1067
"3468","WBGene00005107","V",7635769,7636882,1113
"3469","WBGene00005108","V",7629804,7631298,1494
"3470","WBGene00005109","V",7633399,7634757,1358
"3471","WBGene00005110","V",4865648,4870355,4707
"3472","WBGene00005111","V",4872303,4874200,1897
"3473","WBGene00005112","V",10547598,10549081,1483
"3474","WBGene00005113","V",12964376,12966022,1646
"3475","WBGene00005114","X",13293415,13294773,1358
"3476","WBGene00005115","X",13295164,13297885,2721
"3477","WBGene00005116","X",13291806,13292984,1178
"3478","WBGene00005117","X",13298994,13300523,1529
"3479","WBGene00005118","X",12323739,12325432,1693
"3480","WBGene00005119","X",12326724,12328365,1641
"3481","WBGene00005120","X",13301599,13303457,1858
"3482","WBGene00005121","X",13303905,13305844,1939
"3483","WBGene00005122","X",12338440,12340248,1808
"3484","WBGene00005123","X",12328976,12330526,1550
"3485","WBGene00005124","X",12332095,12333302,1207
"3486","WBGene00005125","X",12333642,12335290,1648
"3487","WBGene00005126","X",12336108,12337752,1644
"3488","WBGene00005127","V",10094720,10096311,1591
"3489","WBGene00005128","X",13478621,13481804,3183
"3490","WBGene00005129","X",13482649,13484913,2264
"3491","WBGene00005130","II",7435852,7436999,1147
"3492","WBGene00005131","I",7294038,7295687,1649
"3493","WBGene00005132","II",7432696,7434216,1520
"3494","WBGene00005133","II",7408492,7410747,2255
"3495","WBGene00005134","II",7202016,7203210,1194
"3496","WBGene00005135","II",7203911,7205051,1140
"3497","WBGene00005136","II",7205688,7206892,1204
"3498","WBGene00005137","V",2419081,2421583,2502
"3499","WBGene00005139","V",2505636,2509407,3771
"3500","WBGene00005140","V",16392482,16393828,1346
"3501","WBGene00005141","III",1692081,1695106,3025
"3502","WBGene00005142","III",2222438,2224000,1562
"3503","WBGene00005143","III",1980823,1982647,1824
"3504","WBGene00005144","III",2244165,2245827,1662
"3505","WBGene00005145","V",16901215,16902826,1611
"3506","WBGene00005146","III",2362948,2366278,3330
"3507","WBGene00005147","V",20454111,20456433,2322
"3508","WBGene00005149","II",7709789,7711444,1655
"3509","WBGene00005150","II",8100375,8102141,1766
"3510","WBGene00005153","IV",12849506,12854408,4902
"3511","WBGene00005159","III",6256948,6258362,1414
"3512","WBGene00005160","III",6258590,6260215,1625
"3513","WBGene00005161","III",6269081,6270377,1296
"3514","WBGene00005162","III",6260216,6262085,1869
"3515","WBGene00005163","III",6262509,6263862,1353
"3516","WBGene00005164","III",6264460,6266011,1551
"3517","WBGene00005165","III",6266510,6268159,1649
"3518","WBGene00005166","III",6253553,6254837,1284
"3519","WBGene00005167","III",6255459,6256775,1316
"3520","WBGene00005168","III",4677766,4679663,1897
"3521","WBGene00005169","III",4680013,4681562,1549
"3522","WBGene00005170","III",4672249,4674207,1958
"3523","WBGene00005171","I",6312750,6314624,1874
"3524","WBGene00005172","II",8709069,8710413,1344
"3525","WBGene00005173","II",12467732,12469369,1637
"3526","WBGene00005174","II",12473706,12475234,1528
"3527","WBGene00005175","II",8712068,8713412,1344
"3528","WBGene00005176","IV",15637236,15640521,3285
"3529","WBGene00005177","II",1636692,1638967,2275
"3530","WBGene00005178","II",3088474,3091296,2822
"3531","WBGene00005179","II",3091503,3093452,1949
"3532","WBGene00005180","II",3093902,3096160,2258
"3533","WBGene00005181","II",3098403,3100646,2243
"3534","WBGene00005182","V",5342139,5344365,2226
"3535","WBGene00005183","V",5331267,5333055,1788
"3536","WBGene00005184","V",5339797,5341309,1512
"3537","WBGene00005185","V",5334888,5336329,1441
"3538","WBGene00005186","V",5337184,5339013,1829
"3539","WBGene00005187","V",6716855,6718297,1442
"3540","WBGene00005188","V",6951550,6953897,2347
"3541","WBGene00005189","V",10587167,10588794,1627
"3542","WBGene00005190","V",8292064,8293516,1452
"3543","WBGene00005191","V",18562178,18564886,2708
"3544","WBGene00005192","V",15624355,15625515,1160
"3545","WBGene00005193","X",14229668,14230876,1208
"3546","WBGene00005194","X",14233944,14235285,1341
"3547","WBGene00005195","V",11152575,11155653,3078
"3548","WBGene00005196","V",11151339,11152430,1091
"3549","WBGene00005197","V",11163036,11164575,1539
"3550","WBGene00005198","V",11160452,11161891,1439
"3551","WBGene00005199","V",11157090,11158706,1616
"3552","WBGene00005200","V",17553870,17555775,1905
"3553","WBGene00005201","V",17328797,17330610,1813
"3554","WBGene00005202","V",12307490,12308658,1168
"3555","WBGene00005203","V",13363715,13364728,1013
"3556","WBGene00005204","V",14554980,14556287,1307
"3557","WBGene00005205","IV",7072410,7073625,1215
"3558","WBGene00005206","IV",7070858,7071736,878
"3559","WBGene00005207","IV",7074030,7075163,1133
"3560","WBGene00005208","IV",15139101,15140932,1831
"3561","WBGene00005210","V",879793,881574,1781
"3562","WBGene00005211","V",14921988,14924204,2216
"3563","WBGene00005212","V",14926710,14928342,1632
"3564","WBGene00005213","V",2735531,2738274,2743
"3565","WBGene00005214","V",2732177,2734460,2283
"3566","WBGene00005215","V",2758174,2759556,1382
"3567","WBGene00005216","V",2722903,2725325,2422
"3568","WBGene00005217","V",2721290,2722655,1365
"3569","WBGene00005218","V",2739163,2740280,1117
"3570","WBGene00005219","V",2740444,2744326,3882
"3571","WBGene00005221","X",15736844,15740626,3782
"3572","WBGene00005222","V",5483086,5484966,1880
"3573","WBGene00005223","V",5480750,5482415,1665
"3574","WBGene00005224","V",5461528,5462994,1466
"3575","WBGene00005225","V",5463791,5465435,1644
"3576","WBGene00005226","II",5355712,5357341,1629
"3577","WBGene00005227","V",11485858,11487266,1408
"3578","WBGene00005228","V",728312,734279,5967
"3579","WBGene00005229","V",1682579,1685089,2510
"3580","WBGene00005230","V",4010470,4011966,1496
"3581","WBGene00005231","V",1685628,1686864,1236
"3582","WBGene00005232","V",4015587,4016938,1351
"3583","WBGene00005233","V",4008227,4009818,1591
"3584","WBGene00005234","V",4005567,4007517,1950
"3585","WBGene00005235","V",11478413,11479243,830
"3586","WBGene00005236","V",6065507,6067140,1633
"3587","WBGene00005237","X",8317637,8319050,1413
"3588","WBGene00005238","X",8315524,8316278,754
"3589","WBGene00005239","X",8313128,8314267,1139
"3590","WBGene00005240","V",13320984,13322355,1371
"3591","WBGene00005241","V",12292214,12293802,1588
"3592","WBGene00005242","V",14661305,14662928,1623
"3593","WBGene00005243","V",13318464,13320080,1616
"3594","WBGene00005244","X",1413144,1416545,3401
"3595","WBGene00005245","V",4924918,4926224,1306
"3596","WBGene00005246","V",4926671,4928181,1510
"3597","WBGene00005247","V",4923292,4924594,1302
"3598","WBGene00005248","V",4921102,4922616,1514
"3599","WBGene00005249","V",12432365,12433817,1452
"3600","WBGene00005250","II",12448541,12449887,1346
"3601","WBGene00005251","V",6774351,6776196,1845
"3602","WBGene00005252","V",6775997,6777311,1314
"3603","WBGene00005253","V",6769662,6771704,2042
"3604","WBGene00005254","V",17707184,17709823,2639
"3605","WBGene00005255","V",17701212,17703285,2073
"3606","WBGene00005256","V",441820,443293,1473
"3607","WBGene00005257","V",444893,446674,1781
"3608","WBGene00005258","V",447569,449230,1661
"3609","WBGene00005259","V",2819581,2821668,2087
"3610","WBGene00005260","V",511194,512520,1326
"3611","WBGene00005261","V",2920600,2922694,2094
"3612","WBGene00005262","II",7763937,7765516,1579
"3613","WBGene00005263","III",6610822,6612263,1441
"3614","WBGene00005264","II",14285780,14287377,1597
"3615","WBGene00005265","II",14287632,14289068,1436
"3616","WBGene00005266","II",14289696,14290875,1179
"3617","WBGene00005267","II",11515075,11518154,3079
"3618","WBGene00005268","V",11303651,11304979,1328
"3619","WBGene00005269","V",11301607,11302886,1279
"3620","WBGene00005270","V",11299373,11300639,1266
"3621","WBGene00005271","II",9380822,9384995,4173
"3622","WBGene00005272","I",6297767,6299729,1962
"3623","WBGene00005273","I",6302474,6304263,1789
"3624","WBGene00005274","I",6300493,6302298,1805
"3625","WBGene00005275","V",15374900,15376323,1423
"3626","WBGene00005276","V",15151845,15153369,1524
"3627","WBGene00005277","V",15155139,15156457,1318
"3628","WBGene00005278","V",15153577,15154994,1417
"3629","WBGene00005279","V",2771860,2773519,1659
"3630","WBGene00005281","II",3582052,3583505,1453
"3631","WBGene00005282","II",3583987,3586063,2076
"3632","WBGene00005283","II",12514972,12516413,1441
"3633","WBGene00005284","V",401688,403128,1440
"3634","WBGene00005285","IV",14523868,14525197,1329
"3635","WBGene00005286","IV",14522464,14523677,1213
"3636","WBGene00005287","II",12510682,12511814,1132
"3637","WBGene00005288","II",12508950,12510135,1185
"3638","WBGene00005289","II",12507338,12508452,1114
"3639","WBGene00005290","II",12513618,12514715,1097
"3640","WBGene00005291","II",12516753,12517858,1105
"3641","WBGene00005292","II",3123506,3124899,1393
"3642","WBGene00005293","II",1639213,1640596,1383
"3643","WBGene00005294","II",12512166,12513316,1150
"3644","WBGene00005295","V",11047227,11048744,1517
"3645","WBGene00005296","V",11055306,11057143,1837
"3646","WBGene00005297","V",5833831,5835183,1352
"3647","WBGene00005298","V",222995,226947,3952
"3648","WBGene00005299","V",217154,219473,2319
"3649","WBGene00005300","V",7497740,7499055,1315
"3650","WBGene00005301","V",219932,222776,2844
"3651","WBGene00005302","V",143047,144617,1570
"3652","WBGene00005303","V",145194,146931,1737
"3653","WBGene00005304","V",7164510,7165895,1385
"3654","WBGene00005305","V",2988460,2990091,1631
"3655","WBGene00005306","V",2986192,2987507,1315
"3656","WBGene00005307","V",2969349,2971164,1815
"3657","WBGene00005308","V",2944379,2945682,1303
"3658","WBGene00005309","V",2963566,2964886,1320
"3659","WBGene00005310","V",7463453,7464796,1343
"3660","WBGene00005311","II",3885032,3887995,2963
"3661","WBGene00005312","V",7461750,7462949,1199
"3662","WBGene00005313","V",7459685,7460998,1313
"3663","WBGene00005314","V",7458252,7459150,898
"3664","WBGene00005315","V",16246879,16248455,1576
"3665","WBGene00005316","V",17017087,17019800,2713
"3666","WBGene00005317","V",16235171,16235747,576
"3667","WBGene00005318","II",3715000,3716555,1555
"3668","WBGene00005319","II",3713188,3714695,1507
"3669","WBGene00005320","V",660681,661954,1273
"3670","WBGene00005321","V",17162900,17165509,2609
"3671","WBGene00005322","V",16241217,16242445,1228
"3672","WBGene00005323","V",16242818,16244178,1360
"3673","WBGene00005324","II",503229,506014,2785
"3674","WBGene00005325","V",15363604,15365013,1409
"3675","WBGene00005326","V",15365298,15366825,1527
"3676","WBGene00005327","V",15367159,15368289,1130
"3677","WBGene00005328","V",17219253,17220445,1192
"3678","WBGene00005329","V",17478333,17479386,1053
"3679","WBGene00005330","V",17484045,17485178,1133
"3680","WBGene00005331","V",17225086,17226219,1133
"3681","WBGene00005332","V",17213043,17214212,1169
"3682","WBGene00005333","V",17472319,17473481,1162
"3683","WBGene00005334","V",17255754,17257194,1440
"3684","WBGene00005335","V",17252931,17255128,2197
"3685","WBGene00005336","V",17271730,17272888,1158
"3686","WBGene00005337","V",17494306,17496171,1865
"3687","WBGene00005338","V",16972434,16974088,1654
"3688","WBGene00005339","V",17395674,17398034,2360
"3689","WBGene00005340","V",15376501,15378003,1502
"3690","WBGene00005341","V",17473999,17475471,1472
"3691","WBGene00005342","V",7475626,7476866,1240
"3692","WBGene00005343","V",7421855,7422937,1082
"3693","WBGene00005344","V",2893276,2895584,2308
"3694","WBGene00005345","II",2703371,2705316,1945
"3695","WBGene00005346","V",5142300,5143798,1498
"3696","WBGene00005347","V",5151180,5152982,1802
"3697","WBGene00005348","V",17005489,17006753,1264
"3698","WBGene00005349","V",17410255,17411705,1450
"3699","WBGene00005350","V",18012413,18014216,1803
"3700","WBGene00005351","V",18014641,18017326,2685
"3701","WBGene00005352","II",10226043,10227130,1087
"3702","WBGene00005353","V",16495994,16497596,1602
"3703","WBGene00005354","V",16715480,16716718,1238
"3704","WBGene00005355","V",16469367,16471016,1649
"3705","WBGene00005356","V",16483981,16485382,1401
"3706","WBGene00005357","V",15722188,15723999,1811
"3707","WBGene00005358","V",16443926,16445734,1808
"3708","WBGene00005359","V",16459388,16460965,1577
"3709","WBGene00005360","V",16412687,16413786,1099
"3710","WBGene00005361","V",16410713,16411843,1130
"3711","WBGene00005362","V",2914248,2916172,1924
"3712","WBGene00005363","V",15848088,15850573,2485
"3713","WBGene00005364","V",15856828,15858403,1575
"3714","WBGene00005365","V",15839967,15841195,1228
"3715","WBGene00005366","V",15845931,15847306,1375
"3716","WBGene00005367","V",15859960,15860985,1025
"3717","WBGene00005368","V",15841837,15844214,2377
"3718","WBGene00005369","V",15855012,15856148,1136
"3719","WBGene00005370","V",17440427,17441774,1347
"3720","WBGene00005371","V",17180149,17181556,1407
"3721","WBGene00005372","V",17450808,17452131,1323
"3722","WBGene00005373","V",17448332,17449590,1258
"3723","WBGene00005374","V",17442581,17445668,3087
"3724","WBGene00005375","V",17182345,17183624,1279
"3725","WBGene00005376","V",17446348,17447636,1288
"3726","WBGene00005377","V",17452676,17453805,1129
"3727","WBGene00005378","V",17184396,17186082,1686
"3728","WBGene00005379","V",10798360,10799475,1115
"3729","WBGene00005380","II",3801171,3802589,1418
"3730","WBGene00005381","V",15219946,15221377,1431
"3731","WBGene00005382","V",20524700,20525866,1166
"3732","WBGene00005383","V",16333712,16335063,1351
"3733","WBGene00005384","V",15639678,15642499,2821
"3734","WBGene00005385","V",4047841,4049354,1513
"3735","WBGene00005386","V",15386923,15388870,1947
"3736","WBGene00005387","V",19965700,19972559,6859
"3737","WBGene00005388","V",19959044,19960916,1872
"3738","WBGene00005389","V",19973284,19975063,1779
"3739","WBGene00005390","V",17178757,17180002,1245
"3740","WBGene00005391","V",17439111,17440372,1261
"3741","WBGene00005392","V",20367480,20369253,1773
"3742","WBGene00005393","V",18478467,18480331,1864
"3743","WBGene00005394","V",18476390,18478061,1671
"3744","WBGene00005395","V",16317567,16318805,1238
"3745","WBGene00005396","V",18474523,18476268,1745
"3746","WBGene00005397","V",18471985,18473530,1545
"3747","WBGene00005398","V",19975610,19978320,2710
"3748","WBGene00005399","V",10796863,10798157,1294
"3749","WBGene00005400","V",3066228,3067497,1269
"3750","WBGene00005401","V",15955797,15957028,1231
"3751","WBGene00005402","V",7338633,7339831,1198
"3752","WBGene00005403","V",7366534,7367619,1085
"3753","WBGene00005404","V",3903107,3904545,1438
"3754","WBGene00005405","V",4311993,4315157,3164
"3755","WBGene00005406","V",4288412,4290193,1781
"3756","WBGene00005407","V",4291836,4293525,1689
"3757","WBGene00005408","II",2114554,2116894,2340
"3758","WBGene00005409","V",18417749,18419893,2144
"3759","WBGene00005410","V",1750001,1751549,1548
"3760","WBGene00005411","V",7652338,7653667,1329
"3761","WBGene00005412","V",9012199,9013865,1666
"3762","WBGene00005413","V",17186873,17188680,1807
"3763","WBGene00005414","V",17454495,17456297,1802
"3764","WBGene00005415","V",4239150,4240392,1242
"3765","WBGene00005416","V",16953754,16954866,1112
"3766","WBGene00005417","V",18409043,18410242,1199
"3767","WBGene00005418","V",19317362,19318500,1138
"3768","WBGene00005419","V",18403722,18404867,1145
"3769","WBGene00005420","V",4069424,4071542,2118
"3770","WBGene00005421","V",4078061,4079813,1752
"3771","WBGene00005422","V",3595191,3597152,1961
"3772","WBGene00005423","V",3592768,3594973,2205
"3773","WBGene00005424","V",16828235,16829755,1520
"3774","WBGene00005426","V",16825290,16827592,2302
"3775","WBGene00005427","V",20193463,20195246,1783
"3776","WBGene00005428","V",15493980,15495761,1781
"3777","WBGene00005429","V",15496269,15497567,1298
"3778","WBGene00005430","IV",3976429,3978015,1586
"3779","WBGene00005431","V",7499652,7500958,1306
"3780","WBGene00005432","IV",3979825,3981205,1380
"3781","WBGene00005433","IV",3981901,3983609,1708
"3782","WBGene00005434","IV",16341625,16345442,3817
"3783","WBGene00005437","V",7502840,7504371,1531
"3784","WBGene00005438","V",7501534,7502673,1139
"3785","WBGene00005439","V",7350881,7352236,1355
"3786","WBGene00005440","V",20049382,20052565,3183
"3787","WBGene00005441","V",7650242,7651857,1615
"3788","WBGene00005442","V",17470223,17471664,1441
"3789","WBGene00005443","V",17210716,17212039,1323
"3790","WBGene00005444","V",17090362,17091693,1331
"3791","WBGene00005445","V",15452333,15455840,3507
"3792","WBGene00005446","V",15445853,15447282,1429
"3793","WBGene00005447","V",2865199,2867284,2085
"3794","WBGene00005448","V",2867792,2869603,1811
"3795","WBGene00005449","V",2870427,2872106,1679
"3796","WBGene00005450","V",7344061,7345234,1173
"3797","WBGene00005451","V",654727,655923,1196
"3798","WBGene00005452","V",656499,657778,1279
"3799","WBGene00005453","V",2933143,2934175,1032
"3800","WBGene00005454","V",2954404,2955442,1038
"3801","WBGene00005455","V",2935178,2936199,1021
"3802","WBGene00005456","II",3878630,3879891,1261
"3803","WBGene00005457","V",15378367,15379917,1550
"3804","WBGene00005458","V",17222386,17223405,1019
"3805","WBGene00005459","V",17480851,17481855,1004
"3806","WBGene00005460","V",15441324,15442979,1655
"3807","WBGene00005461","V",17064976,17066471,1495
"3808","WBGene00005462","V",17063417,17064823,1406
"3809","WBGene00005463","V",15407228,15411380,4152
"3810","WBGene00005464","V",15405159,15406760,1601
"3811","WBGene00005465","V",16490760,16491547,787
"3812","WBGene00005466","V",16492170,16493458,1288
"3813","WBGene00005467","V",17497419,17498997,1578
"3814","WBGene00005468","V",17275889,17278272,2383
"3815","WBGene00005469","V",15419820,15421506,1686
"3816","WBGene00005470","V",15414147,15415349,1202
"3817","WBGene00005472","V",664797,665923,1126
"3818","WBGene00005473","V",7504653,7505945,1292
"3819","WBGene00005474","V",7539315,7540891,1576
"3820","WBGene00005475","V",16590101,16592042,1941
"3821","WBGene00005476","V",2860130,2861605,1475
"3822","WBGene00005477","V",2618999,2620714,1715
"3823","WBGene00005478","V",2863333,2865001,1668
"3824","WBGene00005479","II",983142,984620,1478
"3825","WBGene00005480","V",7353040,7354254,1214
"3826","WBGene00005481","V",15529369,15530767,1398
"3827","WBGene00005482","V",16185403,16186920,1517
"3828","WBGene00005483","V",15170462,15171642,1180
"3829","WBGene00005484","V",16193356,16194581,1225
"3830","WBGene00005485","V",16187728,16189129,1401
"3831","WBGene00005486","V",16190785,16192262,1477
"3832","WBGene00005487","IV",272315,273263,948
"3833","WBGene00005488","V",17765348,17766780,1432
"3834","WBGene00005489","V",17767549,17769621,2072
"3835","WBGene00005490","V",17841483,17844206,2723
"3836","WBGene00005491","V",17800838,17801906,1068
"3837","WBGene00005492","V",17794909,17795755,846
"3838","WBGene00005493","V",17792679,17794086,1407
"3839","WBGene00005494","V",17790491,17792470,1979
"3840","WBGene00005495","V",17805623,17808611,2988
"3841","WBGene00005496","V",17802769,17803923,1154
"3842","WBGene00005497","V",15866139,15867333,1194
"3843","WBGene00005498","V",15865088,15865811,723
"3844","WBGene00005499","V",15330614,15332774,2160
"3845","WBGene00005500","V",17810353,17812794,2441
"3846","WBGene00005501","II",3228885,3230522,1637
"3847","WBGene00005502","V",17818867,17821003,2136
"3848","WBGene00005503","V",15863342,15864458,1116
"3849","WBGene00005504","V",17822105,17823889,1784
"3850","WBGene00005505","V",17824910,17827774,2864
"3851","WBGene00005506","V",17838831,17841188,2357
"3852","WBGene00005507","V",17831650,17833418,1768
"3853","WBGene00005508","V",17828610,17829983,1373
"3854","WBGene00005510","II",3593823,3595166,1343
"3855","WBGene00005511","V",18017904,18020014,2110
"3856","WBGene00005512","II",508245,509326,1081
"3857","WBGene00005513","V",15966245,15967642,1397
"3858","WBGene00005514","V",15963849,15965212,1363
"3859","WBGene00005515","V",15962086,15963232,1146
"3860","WBGene00005516","V",748344,750467,2123
"3861","WBGene00005517","I",11182817,11186137,3320
"3862","WBGene00005518","V",13185684,13187428,1744
"3863","WBGene00005519","V",15400327,15401820,1493
"3864","WBGene00005520","II",10472439,10473726,1287
"3865","WBGene00005521","V",17001467,17003587,2120
"3866","WBGene00005522","V",18804080,18806509,2429
"3867","WBGene00005523","I",11695339,11697943,2604
"3868","WBGene00005524","I",11699169,11701178,2009
"3869","WBGene00005527","I",12151021,12154333,3312
"3870","WBGene00005528","I",12148080,12150741,2661
"3871","WBGene00005529","I",12144007,12146977,2970
"3872","WBGene00005530","V",10258661,10260554,1893
"3873","WBGene00005531","IV",10958372,10961208,2836
"3874","WBGene00005532","V",10368556,10369868,1312
"3875","WBGene00005533","V",3549853,3551269,1416
"3876","WBGene00005534","V",7555810,7557387,1577
"3877","WBGene00005535","V",8998599,9001352,2753
"3878","WBGene00005536","V",15212169,15213706,1537
"3879","WBGene00005537","V",15217005,15219320,2315
"3880","WBGene00005538","V",15215475,15216889,1414
"3881","WBGene00005539","V",1725653,1727632,1979
"3882","WBGene00005540","II",3048678,3050435,1757
"3883","WBGene00005541","II",3044323,3046115,1792
"3884","WBGene00005542","II",3046219,3048154,1935
"3885","WBGene00005543","II",3051003,3052322,1319
"3886","WBGene00005544","II",3153050,3154483,1433
"3887","WBGene00005545","II",3155167,3156849,1682
"3888","WBGene00005546","II",3157491,3159085,1594
"3889","WBGene00005547","V",16222323,16223415,1092
"3890","WBGene00005548","II",2583782,2585593,1811
"3891","WBGene00005549","II",2629570,2631231,1661
"3892","WBGene00005550","II",2610862,2612359,1497
"3893","WBGene00005551","II",2587504,2589754,2250
"3894","WBGene00005552","II",3177963,3180476,2513
"3895","WBGene00005553","II",2634210,2635321,1111
"3896","WBGene00005554","II",3140918,3142955,2037
"3897","WBGene00005555","II",3143394,3144652,1258
"3898","WBGene00005556","II",671542,673844,2302
"3899","WBGene00005557","II",660091,661796,1705
"3900","WBGene00005558","II",669506,671125,1619
"3901","WBGene00005559","II",2656906,2658258,1352
"3902","WBGene00005560","II",3199583,3200906,1323
"3903","WBGene00005561","II",2652841,2654464,1623
"3904","WBGene00005562","II",3203715,3205543,1828
"3905","WBGene00005563","II",3197613,3199098,1485
"3906","WBGene00005564","II",2655339,2656475,1136
"3907","WBGene00005565","II",3201204,3202619,1415
"3908","WBGene00005566","II",3135581,3137904,2323
"3909","WBGene00005567","II",2666283,2668162,1879
"3910","WBGene00005568","II",3134099,3135283,1184
"3911","WBGene00005569","II",2670533,2672128,1595
"3912","WBGene00005570","II",3187286,3188828,1542
"3913","WBGene00005571","II",2668589,2670075,1486
"3914","WBGene00005572","II",2701389,2702857,1468
"3915","WBGene00005573","II",2698865,2700329,1464
"3916","WBGene00005574","II",2696939,2698478,1539
"3917","WBGene00005575","II",3287373,3289031,1658
"3918","WBGene00005576","V",16384490,16386136,1646
"3919","WBGene00005577","V",16386662,16388368,1706
"3920","WBGene00005578","V",17060287,17061675,1388
"3921","WBGene00005579","V",19987984,19990504,2520
"3922","WBGene00005580","V",18320110,18321527,1417
"3923","WBGene00005581","V",17007232,17008402,1170
"3924","WBGene00005582","V",17303054,17304438,1384
"3925","WBGene00005583","II",2627749,2629196,1447
"3926","WBGene00005584","V",566719,568205,1486
"3927","WBGene00005585","V",564391,566084,1693
"3928","WBGene00005586","II",2580901,2583346,2445
"3929","WBGene00005587","II",2578536,2579595,1059
"3930","WBGene00005588","II",2606774,2608558,1784
"3931","WBGene00005589","II",2603208,2605419,2211
"3932","WBGene00005590","II",3185158,3186790,1632
"3933","WBGene00005591","IV",11963910,11965427,1517
"3934","WBGene00005592","V",12163206,12164535,1329
"3935","WBGene00005593","V",651837,653040,1203
"3936","WBGene00005594","V",653303,654502,1199
"3937","WBGene00005595","V",3245003,3246722,1719
"3938","WBGene00005596","V",3247815,3249140,1325
"3939","WBGene00005597","V",3432259,3433658,1399
"3940","WBGene00005598","V",16072765,16073956,1191
"3941","WBGene00005599","V",3241424,3242636,1212
"3942","WBGene00005600","V",529277,530557,1280
"3943","WBGene00005601","V",7402655,7403910,1255
"3944","WBGene00005602","V",7369759,7372131,2372
"3945","WBGene00005603","V",1962815,1964906,2091
"3946","WBGene00005604","V",1953912,1956560,2648
"3947","WBGene00005605","V",2776442,2779233,2791
"3948","WBGene00005606","V",2774342,2776258,1916
"3949","WBGene00005607","V",2568876,2570743,1867
"3950","WBGene00005608","V",2571527,2573208,1681
"3951","WBGene00005609","V",10745429,10746469,1040
"3952","WBGene00005610","V",10742466,10743749,1283
"3953","WBGene00005611","V",1451634,1454340,2706
"3954","WBGene00005612","V",736803,738870,2067
"3955","WBGene00005613","V",734420,736271,1851
"3956","WBGene00005614","V",18421097,18423477,2380
"3957","WBGene00005615","V",15126212,15127513,1301
"3958","WBGene00005616","V",16075659,16077308,1649
"3959","WBGene00005617","V",7296300,7297363,1063
"3960","WBGene00005618","V",9935548,9937535,1987
"3961","WBGene00005619","V",9941691,9942999,1308
"3962","WBGene00005620","V",9932254,9935220,2966
"3963","WBGene00005621","V",638628,639928,1300
"3964","WBGene00005622","V",882176,884424,2248
"3965","WBGene00005623","V",4104598,4106244,1646
"3966","WBGene00005624","V",4101867,4103893,2026
"3967","WBGene00005625","IV",15250152,15252257,2105
"3968","WBGene00005626","V",2844563,2845871,1308
"3969","WBGene00005627","V",2835411,2836601,1190
"3970","WBGene00005628","V",2846250,2848340,2090
"3971","WBGene00005629","V",2832966,2834921,1955
"3972","WBGene00005630","V",2918830,2920008,1178
"3973","WBGene00005631","V",695326,696014,688
"3974","WBGene00005632","V",693541,694725,1184
"3975","WBGene00005633","V",2858660,2859838,1178
"3976","WBGene00005634","V",2856082,2857942,1860
"3977","WBGene00005635","V",2854393,2855573,1180
"3978","WBGene00005638","IV",5012549,5014604,2055
"3979","WBGene00005639","IV",5008678,5010789,2111
"3980","WBGene00005640","V",6284920,6286434,1514
"3981","WBGene00005641","II",7460110,7463614,3504
"3982","WBGene00005642","V",753283,755124,1841
"3983","WBGene00005643","V",762734,764593,1859
"3984","WBGene00005644","V",1908855,1910692,1837
"3985","WBGene00005646","V",7382021,7383309,1288
"3986","WBGene00005647","V",7384232,7386173,1941
"3987","WBGene00005648","V",8179131,8183442,4311
"3988","WBGene00005649","V",8183730,8185772,2042
"3989","WBGene00005650","V",16894230,16895553,1323
"3990","WBGene00005651","V",16896358,16897728,1370
"3991","WBGene00005652","V",13049730,13053910,4180
"3992","WBGene00005653","V",19213685,19217138,3453
"3993","WBGene00005654","V",16506897,16508705,1808
"3994","WBGene00005655","V",5019224,5022369,3145
"3995","WBGene00005656","V",5007229,5011702,4473
"3996","WBGene00005657","V",5012994,5015059,2065
"3997","WBGene00005658","V",15128171,15129986,1815
"3998","WBGene00005659","V",5001686,5003414,1728
"3999","WBGene00005660","V",7738010,7739596,1586
"4000","WBGene00005661","V",7735619,7737024,1405
"4001","WBGene00005662","IV",4357631,4359936,2305
"4002","WBGene00005663","IV",10003726,10005599,1873
"4003","WBGene00005664","IV",9488670,9490194,1524
"4004","WBGene00005665","IV",9486272,9487631,1359
"4005","WBGene00005666","IV",9496606,9497888,1282
"4006","WBGene00005667","IV",9498388,9499588,1200
"4007","WBGene00005668","IV",9494032,9495519,1487
"4008","WBGene00005669","IV",9490620,9491991,1371
"4009","WBGene00005670","IV",8492542,8494487,1945
"4010","WBGene00005671","V",9843866,9846161,2295
"4011","WBGene00005672","IV",13588993,13590337,1344
"4012","WBGene00005673","IV",12518127,12518970,843
"4013","WBGene00005674","IV",13584946,13587288,2342
"4014","WBGene00005675","IV",13583209,13584479,1270
"4015","WBGene00005676","IV",12521239,12522621,1382
"4016","WBGene00005677","IV",17393974,17395333,1359
"4017","WBGene00005678","IV",17396210,17397491,1281
"4018","WBGene00005679","IV",13579253,13582112,2859
"4019","WBGene00005680","IV",12505697,12507381,1684
"4020","WBGene00005681","IV",12502256,12504055,1799
"4021","WBGene00005682","IV",12498538,12500413,1875
"4022","WBGene00005683","IV",12496065,12497844,1779
"4023","WBGene00005684","IV",13626769,13632697,5928
"4024","WBGene00005685","V",15972907,15974936,2029
"4025","WBGene00005686","V",15970433,15972579,2146
"4026","WBGene00005687","V",667896,671442,3546
"4027","WBGene00005688","V",672245,674313,2068
"4028","WBGene00005689","IV",12487579,12489721,2142
"4029","WBGene00005690","V",1499440,1500687,1247
"4030","WBGene00005691","V",1506295,1508096,1801
"4031","WBGene00005692","V",9811461,9812619,1158
"4032","WBGene00005693","V",9813838,9815007,1169
"4033","WBGene00005694","V",9816690,9817862,1172
"4034","WBGene00005695","V",9819279,9820210,931
"4035","WBGene00005696","V",9807635,9809434,1799
"4036","WBGene00005697","V",9827156,9828401,1245
"4037","WBGene00005698","IV",8788449,8790244,1795
"4038","WBGene00005699","V",9841676,9843179,1503
"4039","WBGene00005700","V",9805461,9806600,1139
"4040","WBGene00005701","V",9834463,9836088,1625
"4041","WBGene00005702","V",9803476,9804607,1131
"4042","WBGene00005703","V",9832742,9834000,1258
"4043","WBGene00005704","II",1520384,1521842,1458
"4044","WBGene00005705","V",15650467,15652413,1946
"4045","WBGene00005706","V",14434563,14435743,1180
"4046","WBGene00005707","V",16466466,16467940,1474
"4047","WBGene00005708","V",16565939,16567572,1633
"4048","WBGene00005709","V",2171418,2174412,2994
"4049","WBGene00005710","I",11289044,11291868,2824
"4050","WBGene00005711","X",5180174,5181495,1321
"4051","WBGene00005712","III",6851254,6853130,1876
"4052","WBGene00005713","II",10600599,10602276,1677
"4053","WBGene00005714","V",19706285,19708949,2664
"4054","WBGene00005715","IV",4285403,4288432,3029
"4055","WBGene00005716","X",4252356,4254174,1818
"4056","WBGene00005717","X",4257061,4259094,2033
"4057","WBGene00005718","X",5642911,5644940,2029
"4058","WBGene00005719","V",13419217,13420740,1523
"4059","WBGene00005720","V",13421140,13423147,2007
"4060","WBGene00005721","V",13423908,13425266,1358
"4061","WBGene00005722","IV",16219652,16221659,2007
"4062","WBGene00005723","IV",10051286,10053650,2364
"4063","WBGene00005724","IV",6405176,6408236,3060
"4064","WBGene00005725","IV",15891707,15894229,2522
"4065","WBGene00005726","IV",15906582,15910091,3509
"4066","WBGene00005727","IV",15931822,15933914,2092
"4067","WBGene00005728","IV",5867689,5870172,2483
"4068","WBGene00005729","IV",5871143,5871737,594
"4069","WBGene00005730","IV",5871976,5873925,1949
"4070","WBGene00005731","IV",5874559,5875659,1100
"4071","WBGene00005732","IV",5876092,5877346,1254
"4072","WBGene00005734","IV",5880720,5882335,1615
"4073","WBGene00005735","IV",6288364,6290841,2477
"4074","WBGene00005736","IV",6302159,6303742,1583
"4075","WBGene00005737","IV",6299273,6301864,2591
"4076","WBGene00005738","IV",6296279,6298347,2068
"4077","WBGene00005739","IV",6261058,6263344,2286
"4078","WBGene00005740","IV",6264894,6266599,1705
"4079","WBGene00005741","IV",6267457,6269446,1989
"4080","WBGene00005742","IV",6269773,6272023,2250
"4081","WBGene00005743","IV",6280147,6282243,2096
"4082","WBGene00005744","IV",6282931,6284387,1456
"4083","WBGene00005745","V",16372417,16374776,2359
"4084","WBGene00005746","V",16378892,16380488,1596
"4085","WBGene00005747","V",16320797,16327477,6680
"4086","WBGene00005748","V",15198255,15199396,1141
"4087","WBGene00005749","V",2830878,2832554,1676
"4088","WBGene00005750","V",7705616,7706955,1339
"4089","WBGene00005751","V",2887191,2888781,1590
"4090","WBGene00005752","III",12769564,12771594,2030
"4091","WBGene00005753","V",3808636,3810708,2072
"4092","WBGene00005754","V",3806261,3807752,1491
"4093","WBGene00005755","V",3032578,3034336,1758
"4094","WBGene00005756","III",12757667,12759619,1952
"4095","WBGene00005757","III",12755348,12756613,1265
"4096","WBGene00005758","V",15239070,15240315,1245
"4097","WBGene00005759","V",15237334,15238650,1316
"4098","WBGene00005760","V",15232500,15233844,1344
"4099","WBGene00005761","V",15225950,15227472,1522
"4100","WBGene00005762","V",15230543,15231893,1350
"4101","WBGene00005763","V",15273383,15274857,1474
"4102","WBGene00005764","V",15275443,15276900,1457
"4103","WBGene00005765","V",15277612,15278972,1360
"4104","WBGene00005766","V",15279782,15281395,1613
"4105","WBGene00005767","V",17078257,17079895,1638
"4106","WBGene00005768","V",15488064,15489401,1337
"4107","WBGene00005769","V",15268602,15269748,1146
"4108","WBGene00005770","V",16873942,16875455,1513
"4109","WBGene00005771","V",15223968,15225359,1391
"4110","WBGene00005772","V",15176768,15179484,2716
"4111","WBGene00005773","V",15931292,15932490,1198
"4112","WBGene00005774","V",15933267,15934976,1709
"4113","WBGene00005775","V",15935948,15937110,1162
"4114","WBGene00005776","V",16423099,16424528,1429
"4115","WBGene00005777","V",17287383,17288666,1283
"4116","WBGene00005778","V",17506589,17508506,1917
"4117","WBGene00005779","V",17508793,17510214,1421
"4118","WBGene00005780","V",15449631,15451521,1890
"4119","WBGene00005781","V",16520600,16522309,1709
"4120","WBGene00005782","V",16472513,16473397,884
"4121","WBGene00005783","V",16683186,16684174,988
"4122","WBGene00005784","V",17028884,17030448,1564
"4123","WBGene00005785","V",19836442,19839342,2900
"4124","WBGene00005786","V",20169480,20172041,2561
"4125","WBGene00005788","V",16697478,16699773,2295
"4126","WBGene00005789","V",16692125,16693832,1707
"4127","WBGene00005790","V",16686025,16687083,1058
"4128","WBGene00005791","V",16680281,16682656,2375
"4129","WBGene00005792","V",17511533,17519857,8324
"4130","WBGene00005793","V",17292214,17293729,1515
"4131","WBGene00005794","V",17260674,17262325,1651
"4132","WBGene00005795","V",16420996,16422774,1778
"4133","WBGene00005796","V",15800750,15802239,1489
"4134","WBGene00005797","V",15248175,15249457,1282
"4135","WBGene00005798","V",17169442,17170922,1480
"4136","WBGene00005799","V",15937194,15938538,1344
"4137","WBGene00005800","V",15943425,15944854,1429
"4138","WBGene00005802","V",15938776,15940354,1578
"4139","WBGene00005803","V",15951432,15952862,1430
"4140","WBGene00005804","V",15953595,15955032,1437
"4141","WBGene00005805","V",15947299,15948461,1162
"4142","WBGene00005806","V",15949716,15951003,1287
"4143","WBGene00005807","II",2958608,2961883,3275
"4144","WBGene00005808","IV",16236732,16238655,1923
"4145","WBGene00005809","II",7825407,7826694,1287
"4146","WBGene00005810","IV",14014024,14015944,1920
"4147","WBGene00005811","IV",7060192,7061778,1586
"4148","WBGene00005812","V",20500810,20503228,2418
"4149","WBGene00005813","II",1269540,1271914,2374
"4150","WBGene00005814","V",7417660,7419828,2168
"4151","WBGene00005815","V",7425259,7426694,1435
"4152","WBGene00005816","V",7427326,7428980,1654
"4153","WBGene00005817","V",15328656,15330064,1408
"4154","WBGene00005818","V",7429684,7431116,1432
"4155","WBGene00005819","V",17467051,17468561,1510
"4156","WBGene00005820","V",16586742,16588528,1786
"4157","WBGene00005822","V",16634250,16635619,1369
"4158","WBGene00005823","V",16636883,16638304,1421
"4159","WBGene00005824","V",16641849,16643658,1809
"4160","WBGene00005825","V",7431822,7433160,1338
"4161","WBGene00005826","II",2946738,2948434,1696
"4162","WBGene00005827","V",12238938,12240316,1378
"4163","WBGene00005828","V",18398450,18400374,1924
"4164","WBGene00005829","V",18431750,18434172,2422
"4165","WBGene00005830","V",18426580,18430537,3957
"4166","WBGene00005831","V",19381268,19384760,3492
"4167","WBGene00005832","V",19429440,19431687,2247
"4168","WBGene00005833","V",19400142,19400715,573
"4169","WBGene00005834","V",16336626,16338277,1651
"4170","WBGene00005835","I",12720205,12722036,1831
"4171","WBGene00005836","V",4017080,4019026,1946
"4172","WBGene00005837","V",1702051,1704053,2002
"4173","WBGene00005838","V",1679208,1680870,1662
"4174","WBGene00005839","I",14826558,14827779,1221
"4175","WBGene00005840","I",14828200,14829594,1394
"4176","WBGene00005841","IV",4814485,4817316,2831
"4177","WBGene00005842","IV",4812075,4814029,1954
"4178","WBGene00005843","V",1673543,1675613,2070
"4179","WBGene00005844","II",1667522,1669013,1491
"4180","WBGene00005845","V",1676474,1678328,1854
"4181","WBGene00005846","V",1708741,1710663,1922
"4182","WBGene00005847","V",1711209,1715399,4190
"4183","WBGene00005848","V",1722266,1725261,2995
"4184","WBGene00005849","V",1720227,1721973,1746
"4185","WBGene00005850","V",1717243,1719464,2221
"4186","WBGene00005851","V",508112,509803,1691
"4187","WBGene00005852","V",513390,515226,1836
"4188","WBGene00005853","V",515787,517388,1601
"4189","WBGene00005854","V",519852,521617,1765
"4190","WBGene00005855","V",527902,528869,967
"4191","WBGene00005857","V",604723,606183,1460
"4192","WBGene00005858","I",12122811,12125586,2775
"4193","WBGene00005859","V",3004141,3006064,1923
"4194","WBGene00005860","V",15333151,15334571,1420
"4195","WBGene00005861","V",3000426,3002016,1590
"4196","WBGene00005862","V",2992622,2993916,1294
"4197","WBGene00005863","V",2965422,2966702,1280
"4198","WBGene00005864","V",2982152,2983451,1299
"4199","WBGene00005865","V",2978760,2980078,1318
"4200","WBGene00005866","V",2998542,2999836,1294
"4201","WBGene00005867","V",2994899,2996205,1306
"4202","WBGene00005868","V",2990313,2991585,1272
"4203","WBGene00005869","V",2950712,2952202,1490
"4204","WBGene00005870","V",2974029,2975385,1356
"4205","WBGene00005871","V",2976587,2977886,1299
"4206","WBGene00005872","V",2997092,2997917,825
"4207","WBGene00005873","V",2953193,2954289,1096
"4208","WBGene00005874","V",7012917,7014412,1495
"4209","WBGene00005875","V",2946813,2948416,1603
"4210","WBGene00005876","V",2971949,2973485,1536
"4211","WBGene00005877","V",3546969,3548898,1929
"4212","WBGene00005878","V",3006728,3008123,1395
"4213","WBGene00005879","V",4106373,4108138,1765
"4214","WBGene00005880","V",4113335,4114727,1392
"4215","WBGene00005881","V",4110634,4112616,1982
"4216","WBGene00005882","V",3010927,3011671,744
"4217","WBGene00005883","V",3008907,3010568,1661
"4218","WBGene00005884","V",2942571,2943959,1388
"4219","WBGene00005885","V",2961632,2963060,1428
"4220","WBGene00005886","V",2984077,2985409,1332
"4221","WBGene00005887","V",5165726,5167241,1515
"4222","WBGene00005888","V",2937311,2938597,1286
"4223","WBGene00005889","V",2957016,2958302,1286
"4224","WBGene00005890","V",2939603,2941505,1902
"4225","WBGene00005891","V",2959189,2960994,1805
"4226","WBGene00005892","V",9003709,9004967,1258
"4227","WBGene00005893","V",9009475,9010788,1313
"4228","WBGene00005894","V",9005543,9006931,1388
"4229","WBGene00005895","V",690875,692770,1895
"4230","WBGene00005896","V",700079,701669,1590
"4231","WBGene00005897","V",7311726,7313333,1607
"4232","WBGene00005898","V",560195,562956,2761
"4233","WBGene00005899","V",554374,556155,1781
"4234","WBGene00005900","V",7393550,7395459,1909
"4235","WBGene00005901","V",13945248,13946485,1237
"4236","WBGene00005902","V",7914420,7915728,1308
"4237","WBGene00005903","IV",1045983,1049506,3523
"4238","WBGene00005904","IV",1114697,1118666,3969
"4239","WBGene00005905","IV",1111462,1113738,2276
"4240","WBGene00005906","IV",9021515,9023607,2092
"4241","WBGene00005907","V",6976347,6977387,1040
"4242","WBGene00005908","V",13841146,13842481,1335
"4243","WBGene00005909","V",17796200,17798889,2689
"4244","WBGene00005910","IV",6873258,6874774,1516
"4245","WBGene00005912","V",677034,678920,1886
"4246","WBGene00005913","V",679963,681465,1502
"4247","WBGene00005914","V",682331,683970,1639
"4248","WBGene00005915","V",2748152,2750106,1954
"4249","WBGene00005916","V",2745013,2746947,1934
"4250","WBGene00005917","V",2751256,2753107,1851
"4251","WBGene00005918","V",2753306,2755158,1852
"4252","WBGene00005919","V",2755701,2757276,1575
"4253","WBGene00005920","V",15696785,15698199,1414
"4254","WBGene00005921","V",823156,824972,1816
"4255","WBGene00005923","V",819486,820729,1243
"4256","WBGene00005924","V",7117452,7118896,1444
"4257","WBGene00005925","V",7119063,7120268,1205
"4258","WBGene00005926","V",7120715,7122495,1780
"4259","WBGene00005927","V",7129707,7131074,1367
"4260","WBGene00005928","V",7131595,7132324,729
"4261","WBGene00005929","V",5154057,5155516,1459
"4262","WBGene00005931","V",15397385,15398828,1443
"4263","WBGene00005932","V",3634688,3637173,2485
"4264","WBGene00005933","V",13921030,13922404,1374
"4265","WBGene00005934","V",16017971,16019862,1891
"4266","WBGene00005935","V",16020342,16022652,2310
"4267","WBGene00005936","III",9304034,9306696,2662
"4268","WBGene00005937","V",9353247,9354497,1250
"4269","WBGene00005938","V",9349987,9351332,1345
"4270","WBGene00005939","V",15302371,15303725,1354
"4271","WBGene00005940","V",15299190,15301890,2700
"4272","WBGene00005941","IV",7057977,7059911,1934
"4273","WBGene00005942","V",15281899,15283562,1663
"4274","WBGene00005943","V",17402524,17404186,1662
"4275","WBGene00005944","V",17400121,17401561,1440
"4276","WBGene00005945","V",16975219,16976717,1498
"4277","WBGene00005947","V",7374390,7375594,1204
"4278","WBGene00005948","V",7376409,7377742,1333
"4279","WBGene00005949","V",15352775,15353862,1087
"4280","WBGene00005950","V",6971867,6973149,1282
"4281","WBGene00005951","V",7400888,7402192,1304
"4282","WBGene00005952","V",3909098,3910945,1847
"4283","WBGene00005953","V",3994780,3995938,1158
"4284","WBGene00005954","V",3931626,3933394,1768
"4285","WBGene00005955","V",3929399,3930678,1279
"4286","WBGene00005956","V",3921935,3922964,1029
"4287","WBGene00005957","V",3919589,3920825,1236
"4288","WBGene00005958","V",3917419,3918446,1027
"4289","WBGene00005959","V",3912772,3914597,1825
"4290","WBGene00005960","V",3923376,3926642,3266
"4291","WBGene00005961","V",3933960,3934950,990
"4292","WBGene00005962","V",11558319,11559881,1562
"4293","WBGene00005963","V",11560078,11561650,1572
"4294","WBGene00005964","V",4663616,4665751,2135
"4295","WBGene00005965","V",4658949,4662500,3551
"4296","WBGene00005966","V",4656158,4657812,1654
"4297","WBGene00005967","V",11891812,11893451,1639
"4298","WBGene00005968","V",4666745,4668736,1991
"4299","WBGene00005969","V",15095049,15097452,2403
"4300","WBGene00005970","V",15097674,15099554,1880
"4301","WBGene00005971","V",11593727,11594971,1244
"4302","WBGene00005972","V",11595919,11597096,1177
"4303","WBGene00005973","V",11589733,11592931,3198
"4304","WBGene00005974","V",11597346,11598897,1551
"4305","WBGene00005975","V",11599107,11600628,1521
"4306","WBGene00005976","V",11552679,11554222,1543
"4307","WBGene00005977","V",11562943,11564508,1565
"4308","WBGene00005978","V",11564873,11566771,1898
"4309","WBGene00005979","V",11583512,11585115,1603
"4310","WBGene00005980","V",11586259,11588135,1876
"4311","WBGene00005981","V",11581126,11582458,1332
"4312","WBGene00005982","V",11576631,11577911,1280
"4313","WBGene00005983","V",7324038,7325385,1347
"4314","WBGene00005984","V",3619459,3620708,1249
"4315","WBGene00005986","II",6753126,6754774,1648
"4316","WBGene00005987","V",13711360,13713019,1659
"4317","WBGene00005988","II",3667179,3668664,1485
"4318","WBGene00005989","II",3669321,3671056,1735
"4319","WBGene00005990","II",3685952,3687133,1181
"4320","WBGene00005991","II",3691784,3693231,1447
"4321","WBGene00005992","II",3689467,3690746,1279
"4322","WBGene00005993","II",3693401,3694764,1363
"4323","WBGene00005994","II",3695383,3698162,2779
"4324","WBGene00005995","II",3698599,3699691,1092
"4325","WBGene00005996","II",3699834,3701405,1571
"4326","WBGene00005997","II",3701708,3703250,1542
"4327","WBGene00005998","II",3703721,3704945,1224
"4328","WBGene00005999","II",3705620,3707065,1445
"4329","WBGene00006000","II",3707610,3709221,1611
"4330","WBGene00006001","II",3709555,3710952,1397
"4331","WBGene00006002","II",3757799,3759252,1453
"4332","WBGene00006003","II",3763447,3764586,1139
"4333","WBGene00006004","V",12630170,12632148,1978
"4334","WBGene00006005","II",5431476,5433048,1572
"4335","WBGene00006006","V",8771899,8773781,1882
"4336","WBGene00006007","V",12670907,12672726,1819
"4337","WBGene00006008","V",5644487,5646231,1744
"4338","WBGene00006009","II",12525828,12527868,2040
"4339","WBGene00006010","II",12528247,12529746,1499
"4340","WBGene00006011","II",12531258,12532977,1719
"4341","WBGene00006012","V",3370942,3372773,1831
"4342","WBGene00006013","V",3296108,3297864,1756
"4343","WBGene00006014","V",5731312,5734595,3283
"4344","WBGene00006015","V",5727502,5729593,2091
"4345","WBGene00006016","V",13367252,13369990,2738
"4346","WBGene00006017","V",16475677,16476825,1148
"4347","WBGene00006018","V",13943462,13944589,1127
"4348","WBGene00006019","V",13837473,13838682,1209
"4349","WBGene00006020","V",13834251,13836581,2330
"4350","WBGene00006021","V",13843447,13844962,1515
"4351","WBGene00006022","V",13845436,13846727,1291
"4352","WBGene00006023","V",13847230,13848414,1184
"4353","WBGene00006024","V",13848679,13849969,1290
"4354","WBGene00006025","V",13854878,13856476,1598
"4355","WBGene00006026","V",13859301,13861321,2020
"4356","WBGene00006027","V",13857448,13858942,1494
"4357","WBGene00006028","V",13862805,13864110,1305
"4358","WBGene00006029","V",6973523,6974832,1309
"4359","WBGene00006038","IV",4994324,4994739,415
"4360","WBGene00006039","IV",9850648,9851070,422
"4361","WBGene00006040","IV",4999434,4999853,419
"4362","WBGene00006044","I",6102032,6102463,431
"4363","WBGene00006047","I",2562616,2563049,433
"4364","WBGene00006048","I",13219056,13219545,489
"4365","WBGene00006049","IV",9895388,9896147,759
"4366","WBGene00006050","IV",9852550,9853609,1059
"4367","WBGene00006051","IV",4996142,4997559,1417
"4368","WBGene00006052","IV",7111604,7112861,1257
"4369","WBGene00006053","IV",5016479,5017741,1262
"4370","WBGene00006055","X",2823501,2826827,3326
"4371","WBGene00006056","IV",9892739,9893779,1040
"4372","WBGene00006057","V",14346059,14346967,908
"4373","WBGene00006058","I",5006706,5007991,1285
"4374","WBGene00006059","II",8563714,8566139,2425
"4375","WBGene00006060","V",8052137,8053730,1593
"4376","WBGene00006061","I",9486642,9488229,1587
"4377","WBGene00006062","I",9501268,9505173,3905
"4378","WBGene00006063","X",7562831,7564805,1974
"4379","WBGene00006064","X",5307489,5323385,15896
"4380","WBGene00006065","X",11620047,11621996,1949
"4381","WBGene00006066","X",11644143,11647425,3282
"4382","WBGene00006067","X",16816260,16839975,23715
"4383","WBGene00006068","X",11632407,11636508,4101
"4384","WBGene00006069","IV",7173789,7175008,1219
"4385","WBGene00006070","V",9822619,9824249,1630
"4386","WBGene00006071","IV",11098448,11100371,1923
"4387","WBGene00006072","V",13337991,13339718,1727
"4388","WBGene00006074","V",15748997,15750230,1233
"4389","WBGene00006075","V",16097985,16100209,2224
"4390","WBGene00006076","V",15755031,15756394,1363
"4391","WBGene00006077","V",15758749,15760417,1668
"4392","WBGene00006078","X",13082626,13084235,1609
"4393","WBGene00006079","IV",15288019,15289505,1486
"4394","WBGene00006080","V",15610890,15612591,1701
"4395","WBGene00006081","V",2725902,2727201,1299
"4396","WBGene00006082","V",16453393,16455165,1772
"4397","WBGene00006083","V",16457269,16458814,1545
"4398","WBGene00006084","V",3236874,3240436,3562
"4399","WBGene00006085","V",15740517,15741951,1434
"4400","WBGene00006086","V",15743260,15744478,1218
"4401","WBGene00006087","V",756469,757892,1423
"4402","WBGene00006088","II",1791981,1792962,981
"4403","WBGene00006089","II",1802107,1803302,1195
"4404","WBGene00006090","V",15644875,15646478,1603
"4405","WBGene00006091","V",7404821,7405871,1050
"4406","WBGene00006092","V",16115681,16116897,1216
"4407","WBGene00006093","V",15734023,15735820,1797
"4408","WBGene00006094","V",7471651,7472915,1264
"4409","WBGene00006095","V",7473299,7475013,1714
"4410","WBGene00006096","V",3725072,3726775,1703
"4411","WBGene00006097","V",7506914,7508265,1351
"4412","WBGene00006098","V",4879945,4881477,1532
"4413","WBGene00006099","V",2728536,2730243,1707
"4414","WBGene00006101","V",4474843,4476996,2153
"4415","WBGene00006102","V",13327763,13328866,1103
"4416","WBGene00006103","V",15730779,15732309,1530
"4417","WBGene00006104","V",2877804,2879901,2097
"4418","WBGene00006105","V",3068135,3069201,1066
"4419","WBGene00006106","V",7411995,7413059,1064
"4420","WBGene00006107","V",4013021,4014628,1607
"4421","WBGene00006108","V",15750932,15752149,1217
"4422","WBGene00006109","IV",7177187,7178423,1236
"4423","WBGene00006110","V",15158991,15160546,1555
"4424","WBGene00006111","V",2898436,2899967,1531
"4425","WBGene00006112","V",7645754,7647069,1315
"4426","WBGene00006113","IV",7122194,7123947,1753
"4427","WBGene00006114","IV",7124481,7125516,1035
"4428","WBGene00006115","IV",7127683,7130462,2779
"4429","WBGene00006116","IV",7126365,7127461,1096
"4430","WBGene00006117","V",2145485,2146144,659
"4431","WBGene00006118","V",874008,875728,1720
"4432","WBGene00006119","V",525666,526691,1025
"4433","WBGene00006120","V",16415694,16417114,1420
"4434","WBGene00006121","V",15872573,15873770,1197
"4435","WBGene00006122","V",15871170,15872351,1181
"4436","WBGene00006123","V",3253469,3254590,1121
"4437","WBGene00006125","V",16669339,16671290,1951
"4438","WBGene00006126","V",3351566,3352773,1207
"4439","WBGene00006127","V",3283257,3284930,1673
"4440","WBGene00006128","V",3103128,3104234,1106
"4441","WBGene00006129","V",1062588,1064591,2003
"4442","WBGene00006130","V",3106228,3107550,1322
"4443","WBGene00006131","V",3104790,3105910,1120
"4444","WBGene00006132","V",3095090,3096177,1087
"4445","WBGene00006133","V",15457815,15459188,1373
"4446","WBGene00006134","V",16430240,16431861,1621
"4447","WBGene00006135","X",10239805,10241039,1234
"4448","WBGene00006137","V",17718947,17721293,2346
"4449","WBGene00006138","IV",15143773,15147204,3431
"4450","WBGene00006139","X",1969875,1972657,2782
"4451","WBGene00006140","V",19225543,19251083,25540
"4452","WBGene00006141","V",3974661,3976264,1603
"4453","WBGene00006142","V",3977264,3978811,1547
"4454","WBGene00006143","V",8979522,8980929,1407
"4455","WBGene00006144","V",8984525,8985840,1315
"4456","WBGene00006145","V",8982387,8983704,1317
"4457","WBGene00006146","V",8986694,8987965,1271
"4458","WBGene00006147","V",15382439,15383839,1400
"4459","WBGene00006148","V",17668882,17671330,2448
"4460","WBGene00006149","V",8102484,8106905,4421
"4461","WBGene00006150","V",17674946,17676653,1707
"4462","WBGene00006151","V",17671700,17673443,1743
"4463","WBGene00006152","V",9248031,9249306,1275
"4464","WBGene00006153","V",15292490,15293965,1475
"4465","WBGene00006154","V",16153855,16155211,1356
"4466","WBGene00006155","V",16157335,16158491,1156
"4467","WBGene00006156","V",15710787,15711998,1211
"4468","WBGene00006157","V",15385033,15386653,1620
"4469","WBGene00006158","V",16117363,16118701,1338
"4470","WBGene00006159","V",16180650,16181861,1211
"4471","WBGene00006160","V",16166236,16167409,1173
"4472","WBGene00006161","V",16160685,16162224,1539
"4473","WBGene00006162","V",16167875,16169126,1251
"4474","WBGene00006163","V",7136277,7138417,2140
"4475","WBGene00006164","V",3664871,3666987,2116
"4476","WBGene00006165","V",3649773,3651457,1684
"4477","WBGene00006166","V",11269091,11270426,1335
"4478","WBGene00006167","V",11266981,11268323,1342
"4479","WBGene00006168","V",15437132,15438673,1541
"4480","WBGene00006169","V",10052155,10053893,1738
"4481","WBGene00006172","V",252364,254691,2327
"4482","WBGene00006173","IV",4065905,4068412,2507
"4483","WBGene00006174","X",12790336,12791751,1415
"4484","WBGene00006175","X",12787661,12789256,1595
"4485","WBGene00006176","V",17074290,17076000,1710
"4486","WBGene00006177","V",8085884,8087283,1399
"4487","WBGene00006178","V",8090973,8092485,1512
"4488","WBGene00006179","V",8089319,8090695,1376
"4489","WBGene00006180","V",8080367,8081678,1311
"4490","WBGene00006181","V",746397,747649,1252
"4491","WBGene00006182","V",743648,745475,1827
"4492","WBGene00006183","V",8279375,8282167,2792
"4493","WBGene00006184","V",8277516,8278930,1414
"4494","WBGene00006185","V",8275898,8277041,1143
"4495","WBGene00006186","V",8060873,8062174,1301
"4496","WBGene00006187","V",8058659,8060317,1658
"4497","WBGene00006188","V",8065780,8067900,2120
"4498","WBGene00006189","V",11322322,11323820,1498
"4499","WBGene00006190","V",8068152,8069737,1585
"4500","WBGene00006191","V",8070643,8072266,1623
"4501","WBGene00006192","V",8096394,8098339,1945
"4502","WBGene00006193","V",8093335,8095468,2133
"4503","WBGene00006194","V",7690594,7692043,1449
"4504","WBGene00006195","II",1046505,1048276,1771
"4505","WBGene00006196","V",16573468,16574952,1484
"4506","WBGene00006197","V",16583273,16585174,1901
"4507","WBGene00006198","V",16576200,16578126,1926
"4508","WBGene00006199","IV",4934414,4936643,2229
"4509","WBGene00006201","IV",4915989,4917553,1564
"4510","WBGene00006202","IV",4913390,4914866,1476
"4511","WBGene00006203","IV",4918074,4919632,1558
"4512","WBGene00006204","IV",4909339,4910962,1623
"4513","WBGene00006205","V",1734869,1736767,1898
"4514","WBGene00006206","IV",4902422,4904061,1639
"4515","WBGene00006207","IV",4992389,4993857,1468
"4516","WBGene00006208","IV",4954187,4958206,4019
"4517","WBGene00006209","IV",4960735,4963147,2412
"4518","WBGene00006210","V",13831113,13832905,1792
"4519","WBGene00006211","IV",4884296,4886897,2601
"4520","WBGene00006212","IV",4939315,4941506,2191
"4521","WBGene00006213","IV",4946105,4948518,2413
"4522","WBGene00006214","IV",4877402,4880315,2913
"4523","WBGene00006215","V",15130497,15132516,2019
"4524","WBGene00006216","IV",4864978,4867659,2681
"4525","WBGene00006217","IV",4862185,4864141,1956
"4526","WBGene00006218","IV",4872267,4874703,2436
"4527","WBGene00006219","IV",4868609,4870646,2037
"4528","WBGene00006220","IV",8460999,8463816,2817
"4529","WBGene00006221","V",9197751,9198987,1236
"4530","WBGene00006222","V",12714503,12716549,2046
"4531","WBGene00006223","II",1746189,1747582,1393
"4532","WBGene00006224","V",6667400,6668841,1441
"4533","WBGene00006225","V",12716616,12718722,2106
"4534","WBGene00006226","V",10231821,10233430,1609
"4535","WBGene00006227","V",16275913,16277698,1785
"4536","WBGene00006228","IV",4427713,4429782,2069
"4537","WBGene00006229","IV",17265579,17266926,1347
"4538","WBGene00006230","V",9716697,9718051,1354
"4539","WBGene00006231","V",7477241,7478504,1263
"4540","WBGene00006232","V",9820554,9821824,1270
"4541","WBGene00006233","V",491732,493641,1909
"4542","WBGene00006234","V",16047808,16049147,1339
"4543","WBGene00006235","V",17189186,17190499,1313
"4544","WBGene00006236","V",17456619,17458169,1550
"4545","WBGene00006237","V",7159691,7161016,1325
"4546","WBGene00006238","V",4928278,4929942,1664
"4547","WBGene00006239","V",6218134,6219562,1428
"4548","WBGene00006240","V",4951734,4953035,1301
"4549","WBGene00006241","V",4956829,4958572,1743
"4550","WBGene00006242","V",4948935,4951024,2089
"4551","WBGene00006243","V",4945662,4948299,2637
"4552","WBGene00006244","V",4943116,4944319,1203
"4553","WBGene00006245","V",4941196,4942414,1218
"4554","WBGene00006246","V",4939260,4940641,1381
"4555","WBGene00006247","V",16315304,16317226,1922
"4556","WBGene00006248","V",1532030,1533304,1274
"4557","WBGene00006250","IV",7171489,7172691,1202
"4558","WBGene00006251","IV",7169931,7171322,1391
"4559","WBGene00006252","V",1640308,1642287,1979
"4560","WBGene00006253","V",1636159,1639281,3122
"4561","WBGene00006254","II",12564185,12565943,1758
"4562","WBGene00006255","V",1056548,1058987,2439
"4563","WBGene00006256","V",3507822,3509251,1429
"4564","WBGene00006257","V",3512681,3514343,1662
"4565","WBGene00006258","V",3518189,3519801,1612
"4566","WBGene00006259","V",3510178,3512038,1860
"4567","WBGene00006260","V",3900497,3902558,2061
"4568","WBGene00006261","V",14209170,14210873,1703
"4569","WBGene00006262","V",16006304,16007605,1301
"4570","WBGene00006263","V",16014509,16015752,1243
"4571","WBGene00006264","V",16008332,16009664,1332
"4572","WBGene00006265","V",1526467,1528085,1618
"4573","WBGene00006266","V",765032,772585,7553
"4574","WBGene00006267","V",1524502,1525687,1185
"4575","WBGene00006268","V",1520463,1521945,1482
"4576","WBGene00006270","V",1522785,1524224,1439
"4577","WBGene00006271","V",3057699,3059096,1397
"4578","WBGene00006272","I",14852818,14854607,1789
"4579","WBGene00006273","III",11077704,11079446,1742
"4580","WBGene00006274","V",3954039,3955460,1421
"4581","WBGene00006275","V",15628125,15629643,1518
"4582","WBGene00006276","IV",7185283,7186856,1573
"4583","WBGene00006277","V",13918641,13920032,1391
"4584","WBGene00006278","V",13916496,13918051,1555
"4585","WBGene00006279","V",2252804,2254603,1799
"4586","WBGene00006280","V",16151978,16153475,1497
"4587","WBGene00006281","V",2161500,2163835,2335
"4588","WBGene00006282","V",499770,501330,1560
"4589","WBGene00006285","V",7481868,7483171,1303
"4590","WBGene00006286","V",3527182,3530413,3231
"4591","WBGene00006287","III",11074536,11077494,2958
"4592","WBGene00006288","V",751326,752779,1453
"4593","WBGene00006289","V",15613186,15614968,1782
"4594","WBGene00006306","I",7360199,7371534,11335
"4595","WBGene00006307","II",8603846,8606744,2898
"4596","WBGene00006308","X",3267294,3270906,3612
"4597","WBGene00006309","V",8157746,8159844,2098
"4598","WBGene00006310","X",7827085,7834535,7450
"4599","WBGene00006311","V",13191707,13193538,1831
"4600","WBGene00006315","II",12944803,12944967,164
"4601","WBGene00006318","II",2684669,2686977,2308
"4602","WBGene00006319","X",17528344,17531980,3636
"4603","WBGene00006321","X",3904591,3907671,3080
"4604","WBGene00006324","I",8792965,8797293,4328
"4605","WBGene00006327","X",8877340,8877411,71
"4606","WBGene00006331","III",4276266,4280217,3951
"4607","WBGene00006342","V",8786551,8792771,6220
"4608","WBGene00006349","I",14777139,14787804,10665
"4609","WBGene00006351","X",7301357,7305570,4213
"4610","WBGene00006352","I",9754122,9757898,3776
"4611","WBGene00006353","X",16376595,16380047,3452
"4612","WBGene00006359","III",5702248,5705464,3216
"4613","WBGene00006363","II",7585731,7594912,9181
"4614","WBGene00006364","X",10549123,10555239,6116
"4615","WBGene00006365","X",2509608,2515317,5709
"4616","WBGene00006366","X",14581654,14584374,2720
"4617","WBGene00006367","II",9178514,9188331,9817
"4618","WBGene00006368","X",5776251,5778884,2633
"4619","WBGene00006369","X",14164634,14169779,5145
"4620","WBGene00006371","X",5349098,5352423,3325
"4621","WBGene00006372","X",13960064,13962830,2766
"4622","WBGene00006373","V",11764904,11767222,2318
"4623","WBGene00006374","IV",8457280,8458933,1653
"4624","WBGene00006375","V",16405751,16407699,1948
"4625","WBGene00006376","V",5536681,5537713,1032
"4626","WBGene00006377","I",8663048,8664143,1095
"4627","WBGene00006379","I",9980064,9984848,4784
"4628","WBGene00006380","II",6803758,6804863,1105
"4629","WBGene00006381","II",14752891,14753907,1016
"4630","WBGene00006382","I",13861472,13887468,25996
"4631","WBGene00006383","IV",3584314,3593613,9299
"4632","WBGene00006384","X",16332440,16346027,13587
"4633","WBGene00006385","I",382648,388564,5916
"4634","WBGene00006386","I",7848975,7853631,4656
"4635","WBGene00006387","II",1127976,1132352,4376
"4636","WBGene00006388","X",11836068,11837478,1410
"4637","WBGene00006389","III",12671307,12673421,2114
"4638","WBGene00006390","II",9669324,9671499,2175
"4639","WBGene00006391","III",13624195,13626007,1812
"4640","WBGene00006392","V",4687107,4688028,921
"4641","WBGene00006393","X",4255154,4256812,1658
"4642","WBGene00006394","I",7132747,7134312,1565
"4643","WBGene00006395","III",10503965,10505250,1285
"4644","WBGene00006396","III",11862393,11869281,6888
"4645","WBGene00006397","II",10605030,10605612,582
"4646","WBGene00006399","I",14984178,14987658,3480
"4647","WBGene00006402","II",5657710,5659854,2144
"4648","WBGene00006404","II",13632655,13636986,4331
"4649","WBGene00006405","IV",17119684,17126266,6582
"4650","WBGene00006406","IV",11570500,11578699,8199
"4651","WBGene00006407","I",9181819,9220766,38947
"4652","WBGene00006408","X",3731894,3733457,1563
"4653","WBGene00006409","IV",8874129,8877022,2893
"4654","WBGene00006410","X",4148648,4153443,4795
"4655","WBGene00006411","X",5609155,5611250,2095
"4656","WBGene00006412","X",13625373,13631166,5793
"4657","WBGene00006414","II",11301359,11302783,1424
"4658","WBGene00006415","IV",11850950,11855159,4209
"4659","WBGene00006416","IV",6277435,6279572,2137
"4660","WBGene00006418","V",9144630,9146899,2269
"4661","WBGene00006419","V",246618,251756,5138
"4662","WBGene00006423","I",6877080,6888217,11137
"4663","WBGene00006424","X",5862708,5873320,10612
"4664","WBGene00006428","IV",5112929,5122019,9090
"4665","WBGene00006429","II",9412565,9414144,1579
"4666","WBGene00006430","III",854219,856535,2316
"4667","WBGene00006431","X",3674041,3678557,4516
"4668","WBGene00006432","X",14711579,14718787,7208
"4669","WBGene00006433","II",9350648,9352801,2153
"4670","WBGene00006434","II",5378068,5379632,1564
"4671","WBGene00006435","V",8549289,8551165,1876
"4672","WBGene00006436","V",6120909,6202626,81717
"4673","WBGene00006437","V",6257392,6267287,9895
"4674","WBGene00006438","IV",9119098,9130378,11280
"4675","WBGene00006439","III",13463163,13464657,1494
"4676","WBGene00006440","I",3439108,3449175,10067
"4677","WBGene00006441","IV",15361555,15368260,6705
"4678","WBGene00006442","V",13675988,13678598,2610
"4679","WBGene00006443","V",11036462,11039425,2963
"4680","WBGene00006444","II",11384594,11390862,6268
"4681","WBGene00006445","I",10501585,10505949,4364
"4682","WBGene00006446","V",15575498,15577443,1945
"4683","WBGene00006447","I",10159982,10161883,1901
"4684","WBGene00006448","III",4153599,4154650,1051
"4685","WBGene00006449","III",9887210,9891458,4248
"4686","WBGene00006450","IV",8503493,8510559,7066
"4687","WBGene00006452","III",3198477,3199516,1039
"4688","WBGene00006454","X",3729281,3731960,2679
"4689","WBGene00006459","IV",11394543,11396728,2185
"4690","WBGene00006460","V",10532894,10536388,3494
"4691","WBGene00006461","I",1845221,1850523,5302
"4692","WBGene00006462","X",15369974,15377685,7711
"4693","WBGene00006463","III",6465157,6467208,2051
"4694","WBGene00006464","II",1601789,1604618,2829
"4695","WBGene00006465","V",14447629,14449587,1958
"4696","WBGene00006466","IV",13237281,13239441,2160
"4697","WBGene00006467","V",8792696,8800996,8300
"4698","WBGene00006468","X",10697854,10711869,14015
"4699","WBGene00006470","V",9706603,9709877,3274
"4700","WBGene00006471","V",16569387,16570797,1410
"4701","WBGene00006472","X",8418646,8422055,3409
"4702","WBGene00006473","II",9591292,9592936,1644
"4703","WBGene00006474","III",3705265,3706784,1519
"4704","WBGene00006475","X",4948049,4955331,7282
"4705","WBGene00006476","II",4100788,4127849,27061
"4706","WBGene00006477","X",8792160,8796110,3950
"4707","WBGene00006478","III",4317702,4320341,2639
"4708","WBGene00006479","X",9150694,9160646,9952
"4709","WBGene00006481","V",10806131,10807973,1842
"4710","WBGene00006483","IV",8631334,8644019,12685
"4711","WBGene00006484","I",12934767,12937252,2485
"4712","WBGene00006486","V",11462999,11466770,3771
"4713","WBGene00006487","IV",17364791,17366491,1700
"4714","WBGene00006488","IV",3903255,3903644,389
"4715","WBGene00006489","V",10210444,10212127,1683
"4716","WBGene00006490","IV",11038662,11047422,8760
"4717","WBGene00006491","IV",11650715,11652033,1318
"4718","WBGene00006492","I",6038406,6041265,2859
"4719","WBGene00006493","X",12624655,12634354,9699
"4720","WBGene00006494","X",15506037,15507880,1843
"4721","WBGene00006495","II",4186666,4208499,21833
"4722","WBGene00006496","X",2772042,2799247,27205
"4723","WBGene00006497","II",4710277,4713690,3413
"4724","WBGene00006498","III",6820935,6847283,26348
"4725","WBGene00006499","V",9323085,9327209,4124
"4726","WBGene00006503","I",9063588,9064403,815
"4727","WBGene00006504","IV",7206246,7218000,11754
"4728","WBGene00006505","I",13724577,13732046,7469
"4729","WBGene00006508","I",5583407,5607529,24122
"4730","WBGene00006509","III",13459546,13460638,1092
"4731","WBGene00006510","II",9285932,9289136,3204
"4732","WBGene00006512","V",12761044,12763375,2331
"4733","WBGene00006513","III",1789084,1806859,17775
"4734","WBGene00006514","II",8997827,8999722,1895
"4735","WBGene00006515","III",6432178,6433145,967
"4736","WBGene00006516","III",6433239,6436502,3263
"4737","WBGene00006517","X",14284775,14296658,11883
"4738","WBGene00006518","I",7727267,7729092,1825
"4739","WBGene00006519","III",5081726,5082995,1269
"4740","WBGene00006520","II",9323955,9324873,918
"4741","WBGene00006522","II",6532163,6535455,3292
"4742","WBGene00006523","V",4958603,4963098,4495
"4743","WBGene00006524","X",14589624,14591821,2197
"4744","WBGene00006525","I",9020945,9025553,4608
"4745","WBGene00006526","III",9181550,9185649,4099
"4746","WBGene00006527","IV",10493071,10501599,8528
"4747","WBGene00006528","I",9785778,9787624,1846
"4748","WBGene00006529","I",12964674,12966876,2202
"4749","WBGene00006530","II",10918706,10920202,1496
"4750","WBGene00006531","I",8353410,8357828,4418
"4751","WBGene00006532","I",8994002,8998593,4591
"4752","WBGene00006533","III",11368415,11371775,3360
"4753","WBGene00006534","X",9455485,9458348,2863
"4754","WBGene00006535","X",3252963,3256265,3302
"4755","WBGene00006536","III",10740868,10742461,1593
"4756","WBGene00006537","III",4015769,4017643,1874
"4757","WBGene00006538","X",9434452,9436893,2441
"4758","WBGene00006539","V",12261804,12263368,1564
"4759","WBGene00006540","III",9626532,9629154,2622
"4760","WBGene00006541","X",15500259,15504895,4636
"4761","WBGene00006542","III",7384033,7386132,2099
"4762","WBGene00006543","III",5130923,5136319,5396
"4763","WBGene00006544","III",6025090,6028532,3442
"4764","WBGene00006545","III",10347575,10349740,2165
"4765","WBGene00006546","III",10339984,10341858,1874
"4766","WBGene00006547","III",6045771,6046981,1210
"4767","WBGene00006550","X",1671148,1674165,3017
"4768","WBGene00006551","X",1655522,1656936,1414
"4769","WBGene00006552","III",11633216,11636840,3624
"4770","WBGene00006553","III",11216398,11218260,1862
"4771","WBGene00006554","II",5524200,5525379,1179
"4772","WBGene00006555","IV",11950570,11952208,1638
"4773","WBGene00006556","III",11224800,11227125,2325
"4774","WBGene00006557","III",11784147,11786052,1905
"4775","WBGene00006558","IV",15323893,15325189,1296
"4776","WBGene00006559","IV",15326939,15328186,1247
"4777","WBGene00006560","X",1865246,1866638,1392
"4778","WBGene00006561","IV",179008,183261,4253
"4779","WBGene00006562","II",8270567,8273611,3044
"4780","WBGene00006563","III",11312251,11317055,4804
"4781","WBGene00006565","I",14101236,14104475,3239
"4782","WBGene00006566","IV",11957547,11959804,2257
"4783","WBGene00006567","V",18998345,19000918,2573
"4784","WBGene00006568","IV",10279457,10281582,2125
"4785","WBGene00006570","V",4726721,4730234,3513
"4786","WBGene00006571","III",12240367,12250164,9797
"4787","WBGene00006572","IV",7044058,7044602,544
"4788","WBGene00006573","III",11500867,11502852,1985
"4789","WBGene00006574","I",8759204,8759788,584
"4790","WBGene00006575","III",3869591,3901466,31875
"4791","WBGene00006576","III",9383796,9387605,3809
"4792","WBGene00006577","I",8697923,8701971,4048
"4793","WBGene00006578","I",10536115,10538086,1971
"4794","WBGene00006579","III",9699876,9710268,10392
"4795","WBGene00006580","IV",13701240,13704082,2842
"4796","WBGene00006582","V",8336658,8340675,4017
"4797","WBGene00006583","II",10466852,10468344,1492
"4798","WBGene00006584","X",11375887,11377470,1583
"4799","WBGene00006585","V",16833638,16835144,1506
"4800","WBGene00006586","IV",5204591,5207138,2547
"4801","WBGene00006587","X",8721557,8723552,1995
"4802","WBGene00006588","X",7937635,7945048,7413
"4803","WBGene00006589","V",1989476,1992918,3442
"4804","WBGene00006590","III",5275225,5277797,2572
"4805","WBGene00006591","III",3804772,3809030,4258
"4806","WBGene00006592","III",7202661,7207664,5003
"4807","WBGene00006593","I",443999,461605,17606
"4808","WBGene00006594","I",5546120,5561642,15522
"4809","WBGene00006595","I",13292506,13297555,5049
"4810","WBGene00006596","III",11949918,11960180,10262
"4811","WBGene00006597","IV",13984251,13985805,1554
"4812","WBGene00006598","IV",13982636,13984141,1505
"4813","WBGene00006599","IV",92016,110756,18740
"4814","WBGene00006600","II",7549335,7551977,2642
"4815","WBGene00006601","II",12036842,12039139,2297
"4816","WBGene00006602","X",17467121,17474585,7464
"4817","WBGene00006603","II",14600902,14610554,9652
"4818","WBGene00006604","III",11170889,11195207,24318
"4819","WBGene00006605","II",6955402,6965687,10285
"4820","WBGene00006606","IV",14436367,14444183,7816
"4821","WBGene00006607","I",6554729,6558623,3894
"4822","WBGene00006608","IV",6876737,6883461,6724
"4823","WBGene00006609","V",11709775,11715903,6128
"4824","WBGene00006610","X",13472155,13475899,3744
"4825","WBGene00006611","II",53013,55304,2291
"4826","WBGene00006612","III",13430462,13433394,2932
"4827","WBGene00006613","V",14183124,14185667,2543
"4828","WBGene00006614","III",8535131,8542748,7617
"4829","WBGene00006615","III",991881,1001907,10026
"4830","WBGene00006616","I",13899085,13913854,14769
"4831","WBGene00006617","II",11691326,11695657,4331
"4832","WBGene00006618","I",8768325,8771248,2923
"4833","WBGene00006619","II",4948154,4949527,1373
"4834","WBGene00006620","IV",8206614,8213723,7109
"4835","WBGene00006621","IV",6557171,6560881,3710
"4836","WBGene00006622","V",20859344,20861153,1809
"4837","WBGene00006623","V",9345772,9348687,2915
"4838","WBGene00006624","I",6585039,6587882,2843
"4839","WBGene00006625","I",6640662,6642643,1981
"4840","WBGene00006626","II",4706821,4710052,3231
"4841","WBGene00006627","III",8237995,8239423,1428
"4842","WBGene00006628","III",8236984,8237881,897
"4843","WBGene00006629","III",13212666,13214371,1705
"4844","WBGene00006630","IV",12519118,12520231,1113
"4845","WBGene00006631","IV",13590607,13591745,1138
"4846","WBGene00006632","X",2820431,2822433,2002
"4847","WBGene00006633","I",9970037,9973177,3140
"4848","WBGene00006634","X",14726626,14729482,2856
"4849","WBGene00006635","X",1245984,1247892,1908
"4850","WBGene00006636","II",6718532,6720294,1762
"4851","WBGene00006637","X",9163164,9166368,3204
"4852","WBGene00006638","IV",10149166,10150602,1436
"4853","WBGene00006639","V",19154106,19157674,3568
"4854","WBGene00006640","X",4866684,4874657,7973
"4855","WBGene00006641","I",8928748,8931089,2341
"4856","WBGene00006642","X",6994784,6996620,1836
"4857","WBGene00006643","X",3681170,3684232,3062
"4858","WBGene00006644","II",5904552,5906308,1756
"4859","WBGene00006645","I",6616304,6618560,2256
"4860","WBGene00006646","X",12031598,12034037,2439
"4861","WBGene00006647","II",2460842,2473370,12528
"4862","WBGene00006648","V",156825,166866,10041
"4863","WBGene00006649","X",8422480,8423731,1251
"4864","WBGene00006650","X",1504131,1504841,710
"4865","WBGene00006651","II",10201125,10202230,1105
"4866","WBGene00006652","V",20053733,20064174,10441
"4867","WBGene00006654","X",11764456,11769378,4922
"4868","WBGene00006655","II",8154096,8156937,2841
"4869","WBGene00006656","I",7269179,7273005,3826
"4870","WBGene00006657","II",4441265,4453151,11886
"4871","WBGene00006658","II",8210662,8212751,2089
"4872","WBGene00006659","II",9187220,9194295,7075
"4873","WBGene00006660","II",11483201,11485359,2158
"4874","WBGene00006661","III",4742968,4744649,1681
"4875","WBGene00006662","III",8634078,8643739,9661
"4876","WBGene00006663","IV",9082361,9087554,5193
"4877","WBGene00006664","IV",9693202,9697005,3803
"4878","WBGene00006665","V",6552348,6560196,7848
"4879","WBGene00006666","V",7028329,7036570,8241
"4880","WBGene00006667","V",10667586,10670860,3274
"4881","WBGene00006668","V",12320187,12337744,17557
"4882","WBGene00006669","V",12387041,12395706,8665
"4883","WBGene00006670","X",3081125,3085336,4211
"4884","WBGene00006671","X",7599836,7608135,8299
"4885","WBGene00006672","X",8988137,8991972,3835
"4886","WBGene00006673","X",13639877,13642256,2379
"4887","WBGene00006674","X",16299904,16304122,4218
"4888","WBGene00006675","X",16306464,16314998,8534
"4889","WBGene00006676","X",13817999,13823582,5583
"4890","WBGene00006677","V",12265707,12269549,3842
"4891","WBGene00006678","IV",11504716,11509723,5007
"4892","WBGene00006679","X",3050365,3054585,4220
"4893","WBGene00006680","X",4274786,4279344,4558
"4894","WBGene00006681","I",9463760,9468917,5157
"4895","WBGene00006682","I",8808992,8811712,2720
"4896","WBGene00006683","III",11410712,11424655,13943
"4897","WBGene00006684","V",13796641,13800577,3936
"4898","WBGene00006685","V",17710040,17714377,4337
"4899","WBGene00006686","V",15704960,15709528,4568
"4900","WBGene00006687","V",20862969,20865743,2774
"4901","WBGene00006688","V",17743651,17747059,3408
"4902","WBGene00006689","I",6269561,6271541,1980
"4903","WBGene00006690","III",11795748,11803243,7495
"4904","WBGene00006691","III",13486643,13492430,5787
"4905","WBGene00006692","V",17726799,17730381,3582
"4906","WBGene00006693","V",13346278,13356101,9823
"4907","WBGene00006694","X",11622967,11627113,4146
"4908","WBGene00006695","III",2793323,2801900,8577
"4909","WBGene00006696","V",19060180,19067034,6854
"4910","WBGene00006697","III",1062793,1076555,13762
"4911","WBGene00006698","IV",17116763,17118760,1997
"4912","WBGene00006699","IV",9989670,9995034,5364
"4913","WBGene00006700","I",12741588,12749318,7730
"4914","WBGene00006701","IV",4103020,4106220,3200
"4915","WBGene00006702","I",1698094,1701128,3034
"4916","WBGene00006703","II",7479064,7480713,1649
"4917","WBGene00006704","III",9630085,9631167,1082
"4918","WBGene00006705","IV",2704741,2707238,2497
"4919","WBGene00006706","IV",4651044,4652468,1424
"4920","WBGene00006707","I",11911324,11912052,728
"4921","WBGene00006708","IV",2922591,2925691,3100
"4922","WBGene00006709","I",13581698,13585295,3597
"4923","WBGene00006710","II",2901404,2913603,12199
"4924","WBGene00006711","I",14822050,14823996,1946
"4925","WBGene00006712","X",7050577,7055667,5090
"4926","WBGene00006713","III",7067686,7068570,884
"4927","WBGene00006714","V",18686315,18689843,3528
"4928","WBGene00006715","III",188838,190974,2136
"4929","WBGene00006716","X",8869625,8871901,2276
"4930","WBGene00006717","X",8867603,8869153,1550
"4931","WBGene00006718","X",8844288,8846275,1987
"4932","WBGene00006719","II",8405603,8406924,1321
"4933","WBGene00006720","I",10562968,10564914,1946
"4934","WBGene00006721","V",6509910,6511409,1499
"4935","WBGene00006722","V",6508907,6509884,977
"4936","WBGene00006723","V",6506752,6508803,2051
"4937","WBGene00006724","II",8038271,8039597,1326
"4938","WBGene00006725","III",3068306,3069210,904
"4939","WBGene00006726","I",5607820,5608841,1021
"4940","WBGene00006727","III",5940244,5943835,3591
"4941","WBGene00006728","III",12977910,12978523,613
"4942","WBGene00006729","V",9334773,9336668,1895
"4943","WBGene00006730","I",14790244,14790934,690
"4944","WBGene00006731","III",5583135,5584213,1078
"4945","WBGene00006732","I",9310329,9312641,2312
"4946","WBGene00006733","IV",12329407,12331054,1647
"4947","WBGene00006734","II",8062741,8066193,3452
"4948","WBGene00006735","III",4918277,4920319,2042
"4949","WBGene00006736","III",5165659,5169799,4140
"4950","WBGene00006737","II",4955646,4959876,4230
"4951","WBGene00006738","IV",1963191,1964724,1533
"4952","WBGene00006739","II",8129960,8134742,4782
"4953","WBGene00006740","I",6812664,6814248,1584
"4954","WBGene00006741","X",1057487,1062447,4960
"4955","WBGene00006742","X",2710918,2763526,52608
"4956","WBGene00006743","X",14773538,14783564,10026
"4957","WBGene00006744","II",9897754,9900376,2622
"4958","WBGene00006745","IV",5495666,5528338,32672
"4959","WBGene00006746","X",6889689,6897147,7458
"4960","WBGene00006747","X",15120975,15147740,26765
"4961","WBGene00006748","IV",7197153,7203643,6490
"4962","WBGene00006749","X",13212390,13216707,4317
"4963","WBGene00006750","X",7272334,7280322,7988
"4964","WBGene00006751","I",3798566,3805737,7171
"4965","WBGene00006752","I",7422785,7454088,31303
"4966","WBGene00006753","I",7122614,7128423,5809
"4967","WBGene00006754","I",7376604,7383197,6593
"4968","WBGene00006755","III",9546258,9556514,10256
"4969","WBGene00006756","IV",3618259,3624697,6438
"4970","WBGene00006757","X",7682896,7686040,3144
"4971","WBGene00006759","IV",11972697,12011007,38310
"4972","WBGene00006760","V",8936359,8939676,3317
"4973","WBGene00006761","IV",7979883,7982005,2122
"4974","WBGene00006762","III",12942617,12949899,7282
"4975","WBGene00006763","IV",13261556,13272514,10958
"4976","WBGene00006764","X",8789456,8790621,1165
"4977","WBGene00006765","I",8897613,8901435,3822
"4978","WBGene00006766","IV",13119096,13124387,5291
"4979","WBGene00006767","IV",12773862,12787513,13651
"4980","WBGene00006768","III",8905615,8911749,6134
"4981","WBGene00006769","IV",3516819,3526602,9783
"4982","WBGene00006770","V",982534,996207,13673
"4983","WBGene00006771","I",1721592,1740670,19078
"4984","WBGene00006772","III",8193844,8201206,7362
"4985","WBGene00006773","I",6742293,6745341,3048
"4986","WBGene00006774","I",4897620,4900977,3357
"4987","WBGene00006775","V",14373389,14375799,2410
"4988","WBGene00006776","I",5679844,5691503,11659
"4989","WBGene00006777","V",9966404,9976226,9822
"4990","WBGene00006778","V",9764645,9769361,4716
"4991","WBGene00006779","IV",10324255,10350217,25962
"4992","WBGene00006780","IV",5966656,6004857,38201
"4993","WBGene00006781","III",491547,502625,11078
"4994","WBGene00006782","V",5097150,5098907,1757
"4995","WBGene00006783","III",10183794,10186390,2596
"4996","WBGene00006784","III",10520676,10532705,12029
"4997","WBGene00006785","III",10314490,10318162,3672
"4998","WBGene00006786","V",19995986,20004485,8499
"4999","WBGene00006787","II",14647325,14684456,37131
"5000","WBGene00006788","II",11058096,11089456,31360
"5001","WBGene00006789","I",14855901,14863573,7672
"5002","WBGene00006790","I",7899037,7903334,4297
"5003","WBGene00006791","I",4675135,4679409,4274
"5004","WBGene00006792","X",10104612,10125483,20871
"5005","WBGene00006793","I",13629227,13633494,4267
"5006","WBGene00006794","V",1475086,1479581,4495
"5007","WBGene00006795","V",14731095,14734237,3142
"5008","WBGene00006796","V",4497463,4511449,13986
"5009","WBGene00006797","I",5141675,5149226,7551
"5010","WBGene00006798","III",13277261,13283883,6622
"5011","WBGene00006801","V",6901697,6929038,27341
"5012","WBGene00006802","III",10318939,10320021,1082
"5013","WBGene00006803","V",6881340,6891836,10496
"5014","WBGene00006804","III",12881037,12891738,10701
"5015","WBGene00006805","I",3999348,4031739,32391
"5016","WBGene00006807","I",11592302,11602095,9793
"5017","WBGene00006808","V",15071748,15080152,8404
"5018","WBGene00006809","IV",6157310,6183857,26547
"5019","WBGene00006810","X",3408664,3411683,3019
"5020","WBGene00006811","III",4066717,4082794,16077
"5021","WBGene00006812","V",20879854,20898906,19052
"5022","WBGene00006814","IV",7424498,7444660,20162
"5023","WBGene00006815","V",6465065,6487880,22815
"5024","WBGene00006816","X",13584775,13589820,5045
"5025","WBGene00006817","II",4702069,4703219,1150
"5026","WBGene00006818","III",8212750,8216336,3586
"5027","WBGene00006819","I",6761228,6767797,6569
"5028","WBGene00006820","I",4035702,4090884,55182
"5029","WBGene00006822","III",3644375,3648822,4447
"5030","WBGene00006823","I",5992661,6003363,10702
"5031","WBGene00006824","I",14381344,14384737,3393
"5032","WBGene00006825","X",611120,621290,10170
"5033","WBGene00006826","X",5593133,5594965,1832
"5034","WBGene00006827","X",7570374,7573751,3377
"5035","WBGene00006829","I",12508299,12513419,5120
"5036","WBGene00006830","III",4115226,4147255,32029
"5037","WBGene00006831","II",6994987,7010624,15637
"5038","WBGene00006832","II",8116356,8122904,6548
"5039","WBGene00006833","I",3822883,3826514,3631
"5040","WBGene00006836","V",14691854,14697107,5253
"5041","WBGene00006839","X",10146889,10153142,6253
"5042","WBGene00006840","III",8351249,8355174,3925
"5043","WBGene00006843","III",10902648,10908927,6279
"5044","WBGene00006844","I",8460225,8463015,2790
"5045","WBGene00006845","I",14872112,14875378,3266
"5046","WBGene00006852","IV",9002837,9005410,2573
"5047","WBGene00006853","II",11281986,11283953,1967
"5048","WBGene00006856","II",14485624,14488688,3064
"5049","WBGene00006861","X",5074399,5078120,3721
"5050","WBGene00006862","X",5087840,5092538,4698
"5051","WBGene00006863","X",3537641,3540940,3299
"5052","WBGene00006864","X",3522780,3531826,9046
"5053","WBGene00006865","X",3393864,3397656,3792
"5054","WBGene00006868","II",4572000,4590970,18970
"5055","WBGene00006869","IV",3761192,3766826,5634
"5056","WBGene00006870","X",10505988,10519563,13575
"5057","WBGene00006873","III",10920336,10926041,5705
"5058","WBGene00006874","V",12213327,12225935,12608
"5059","WBGene00006875","II",8636233,8637711,1478
"5060","WBGene00006876","I",11747428,11792118,44690
"5061","WBGene00006881","X",9847275,9849518,2243
"5062","WBGene00006882","II",2443279,2451130,7851
"5063","WBGene00006886","X",17393789,17396556,2767
"5064","WBGene00006887","X",9216867,9232075,15208
"5065","WBGene00006888","I",3150346,3162387,12041
"5066","WBGene00006889","I",12728137,12729870,1733
"5067","WBGene00006890","X",8087554,8089427,1873
"5068","WBGene00006893","II",7116557,7120558,4001
"5069","WBGene00006894","III",156824,163542,6718
"5070","WBGene00006895","III",148087,150197,2110
"5071","WBGene00006896","X",10992483,10997846,5363
"5072","WBGene00006897","X",10982351,10987928,5577
"5073","WBGene00006902","I",13269984,13272784,2800
"5074","WBGene00006910","III",9781243,9782057,814
"5075","WBGene00006911","III",9782164,9783212,1048
"5076","WBGene00006912","IV",2314589,2315990,1401
"5077","WBGene00006913","II",7878083,7879406,1323
"5078","WBGene00006914","IV",8303968,8307369,3401
"5079","WBGene00006915","II",11435212,11438464,3252
"5080","WBGene00006916","IV",12640447,12650652,10205
"5081","WBGene00006917","IV",6791074,6792629,1555
"5082","WBGene00006919","I",5609310,5610270,960
"5083","WBGene00006920","IV",2307819,2314567,6748
"5084","WBGene00006921","X",4191094,4193144,2050
"5085","WBGene00006922","X",11307360,11308400,1040
"5086","WBGene00006923","II",5323005,5340826,17821
"5087","WBGene00006924","II",1321037,1323170,2133
"5088","WBGene00006925","X",7727889,7733168,5279
"5089","WBGene00006926","X",5101032,5106173,5141
"5090","WBGene00006927","X",3567355,3572549,5194
"5091","WBGene00006928","X",3558839,3563974,5135
"5092","WBGene00006929","X",3403471,3408603,5132
"5093","WBGene00006930","IV",8261134,8266462,5328
"5094","WBGene00006931","IV",9339403,9341790,2387
"5095","WBGene00006932","I",6028486,6033457,4971
"5096","WBGene00006933","II",5907794,5911222,3428
"5097","WBGene00006934","V",10566365,10576419,10054
"5098","WBGene00006935","V",8031411,8035014,3603
"5099","WBGene00006936","I",13547898,13559361,11463
"5100","WBGene00006937","III",11990167,11999552,9385
"5101","WBGene00006938","II",9581756,9583548,1792
"5102","WBGene00006939","II",14583706,14585733,2027
"5103","WBGene00006940","II",9713737,9716467,2730
"5104","WBGene00006941","IV",9200102,9212235,12133
"5105","WBGene00006942","X",8387448,8392584,5136
"5106","WBGene00006943","III",5722824,5727115,4291
"5107","WBGene00006944","II",6554977,6559267,4290
"5108","WBGene00006945","V",18853127,18859221,6094
"5109","WBGene00006946","III",5236410,5240055,3645
"5110","WBGene00006947","II",7531145,7533246,2101
"5111","WBGene00006948","X",3092395,3094448,2053
"5112","WBGene00006949","IV",9475863,9477446,1583
"5113","WBGene00006950","X",15752258,15757269,5011
"5114","WBGene00006951","IV",4050049,4051639,1590
"5115","WBGene00006952","X",3480251,3483649,3398
"5116","WBGene00006953","V",15334782,15337505,2723
"5117","WBGene00006954","V",15342056,15344572,2516
"5118","WBGene00006955","X",1576637,1591296,14659
"5119","WBGene00006956","II",7533300,7534563,1263
"5120","WBGene00006957","IV",8188904,8198951,10047
"5121","WBGene00006958","I",11924785,11929511,4726
"5122","WBGene00006959","III",4193809,4195358,1549
"5123","WBGene00006960","V",14980354,14982626,2272
"5124","WBGene00006961","I",4665744,4671738,5994
"5125","WBGene00006962","X",8041327,8044409,3082
"5126","WBGene00006963","I",7159714,7160917,1203
"5127","WBGene00006964","II",14155768,14166018,10250
"5128","WBGene00006965","X",11852794,11853729,935
"5129","WBGene00006966","X",12315568,12317673,2105
"5130","WBGene00006968","IV",4710861,4712624,1763
"5131","WBGene00006970","IV",3855843,3861552,5709
"5132","WBGene00006971","III",6853113,6856804,3691
"5133","WBGene00006974","IV",6118219,6121775,3556
"5134","WBGene00006975","III",8792847,8806305,13458
"5135","WBGene00006976","I",8529380,8531338,1958
"5136","WBGene00006977","III",9002779,9004839,2060
"5137","WBGene00006978","I",9847406,9850082,2676
"5138","WBGene00006979","X",12340378,12341438,1060
"5139","WBGene00006980","X",7930738,7931808,1070
"5140","WBGene00006981","X",7925434,7926594,1160
"5141","WBGene00006982","III",10951225,10953505,2280
"5142","WBGene00006983","X",5186921,5189077,2156
"5143","WBGene00006984","I",4790644,4792560,1916
"5144","WBGene00006985","III",13119820,13133938,14118
"5145","WBGene00006986","III",12333745,12345347,11602
"5146","WBGene00006987","III",5926898,5932953,6055
"5147","WBGene00006988","II",5649737,5654422,4685
"5148","WBGene00006993","III",12058844,12072293,13449
"5149","WBGene00006994","II",8457818,8464517,6699
"5150","WBGene00006996","II",8017669,8020785,3116
"5151","WBGene00006997","II",4949902,4953488,3586
"5152","WBGene00006999","II",13056814,13071530,14716
"5153","WBGene00007000","III",2811870,2814969,3099
"5154","WBGene00007001","I",4247754,4249415,1661
"5155","WBGene00007006","IV",11459984,11463195,3211
"5156","WBGene00007007","IV",885346,890200,4854
"5157","WBGene00007008","III",8358625,8362496,3871
"5158","WBGene00007009","I",537122,542200,5078
"5159","WBGene00007010","III",9957357,9963171,5814
"5160","WBGene00007011","X",17151522,17154595,3073
"5161","WBGene00007012","II",4942107,4943949,1842
"5162","WBGene00007013","II",11527172,11533814,6642
"5163","WBGene00007014","II",7853880,7855042,1162
"5164","WBGene00007015","III",5021224,5021910,686
"5165","WBGene00007016","III",5828603,5833745,5142
"5166","WBGene00007017","V",20250881,20267244,16363
"5167","WBGene00007018","I",6492722,6494754,2032
"5168","WBGene00007019","III",2598057,2603299,5242
"5169","WBGene00007020","IV",1187799,1192977,5178
"5170","WBGene00007021","III",11774950,11776675,1725
"5171","WBGene00007022","II",10301163,10301888,725
"5172","WBGene00007023","V",9209463,9213654,4191
"5173","WBGene00007024","I",7057170,7059351,2181
"5174","WBGene00007025","III",13773456,13778896,5440
"5175","WBGene00007026","I",8966130,8967004,874
"5176","WBGene00007027","III",12714566,12743929,29363
"5177","WBGene00007028","II",11661583,11675927,14344
"5178","WBGene00007029","V",7081537,7084662,3125
"5179","WBGene00007030","III",12599304,12608604,9300
"5180","WBGene00007036","II",4417683,4419131,1448
"5181","WBGene00007041","II",11323051,11329429,6378
"5182","WBGene00007042","I",7495437,7503577,8140
"5183","WBGene00007043","I",9960370,9961973,1603
"5184","WBGene00007044","II",7711871,7718591,6720
"5185","WBGene00007045","III",4705413,4706949,1536
"5186","WBGene00007047","I",10291870,10297927,6057
"5187","WBGene00007048","III",6375379,6379190,3811
"5188","WBGene00007049","V",14534446,14536309,1863
"5189","WBGene00007050","II",6536380,6554846,18466
"5190","WBGene00007053","I",4685865,4698575,12710
"5191","WBGene00007054","I",10085713,10102012,16299
"5192","WBGene00007055","V",8594914,8597500,2586
"5193","WBGene00007056","III",8268609,8270680,2071
"5194","WBGene00007057","I",6729996,6730959,963
"5195","WBGene00007058","IV",14616603,14623961,7358
"5196","WBGene00007059","X",7565323,7568152,2829
"5197","WBGene00007060","III",6471720,6475246,3526
"5198","WBGene00007063","II",1848,4717,2869
"5199","WBGene00007064","II",15268212,15275689,7477
"5200","WBGene00007065","III",13780220,13781133,913
"5201","WBGene00007066","III",13782587,13783459,872
"5202","WBGene00007067","IV",17480396,17483332,2936
"5203","WBGene00007068","X",17714968,17718720,3752
"5204","WBGene00007069","X",17714456,17714832,376
"5205","WBGene00007070","V",10372325,10374245,1920
"5206","WBGene00007071","V",10388402,10393504,5102
"5207","WBGene00007072","V",10395663,10397817,2154
"5208","WBGene00007073","V",10398717,10401307,2590
"5209","WBGene00007074","X",248343,249802,1459
"5210","WBGene00007077","X",221017,225084,4067
"5211","WBGene00007080","II",9517567,9518876,1309
"5212","WBGene00007081","II",9519055,9520205,1150
"5213","WBGene00007082","V",14146499,14148784,2285
"5214","WBGene00007083","V",14156831,14157622,791
"5215","WBGene00007085","V",14137348,14137640,292
"5216","WBGene00007087","IV",12146486,12150975,4489
"5217","WBGene00007088","IV",12143431,12145731,2300
"5218","WBGene00007089","IV",12135074,12138193,3119
"5219","WBGene00007090","IV",12141161,12143331,2170
"5220","WBGene00007091","IV",12156838,12164266,7428
"5221","WBGene00007092","IV",12151170,12154245,3075
"5222","WBGene00007093","IV",12138847,12141057,2210
"5223","WBGene00007094","I",12773659,12782282,8623
"5224","WBGene00007096","V",10287564,10289272,1708
"5225","WBGene00007097","V",10297399,10298865,1466
"5226","WBGene00007099","V",10314641,10315304,663
"5227","WBGene00007100","V",10315245,10317394,2149
"5228","WBGene00007101","V",10317490,10319534,2044
"5229","WBGene00007102","V",10320715,10322304,1589
"5230","WBGene00007103","V",10322288,10332112,9824
"5231","WBGene00007104","V",10289721,10291710,1989
"5232","WBGene00007105","IV",11310972,11312515,1543
"5233","WBGene00007106","IV",11314078,11315116,1038
"5234","WBGene00007107","IV",11315142,11315877,735
"5235","WBGene00007108","IV",11317419,11319951,2532
"5236","WBGene00007109","IV",11320800,11323634,2834
"5237","WBGene00007110","IV",11327576,11329369,1793
"5238","WBGene00007111","IV",11329466,11332969,3503
"5239","WBGene00007112","IV",11304721,11306762,2041
"5240","WBGene00007113","IV",11296952,11298388,1436
"5241","WBGene00007114","IV",11295074,11296887,1813
"5242","WBGene00007115","X",12028711,12031498,2787
"5243","WBGene00007116","X",12042593,12057049,14456
"5244","WBGene00007117","V",11733733,11736968,3235
"5245","WBGene00007118","V",11731120,11733472,2352
"5246","WBGene00007119","V",20476748,20479089,2341
"5247","WBGene00007120","V",20468349,20469413,1064
"5248","WBGene00007121","V",20458654,20464486,5832
"5249","WBGene00007122","V",20493924,20497348,3424
"5250","WBGene00007123","V",20490771,20492485,1714
"5251","WBGene00007124","V",20473022,20476061,3039
"5252","WBGene00007125","V",20469703,20470485,782
"5253","WBGene00007126","V",20480792,20485385,4593
"5254","WBGene00007127","V",20487645,20489202,1557
"5255","WBGene00007128","X",9440079,9441571,1492
"5256","WBGene00007129","X",9431432,9432745,1313
"5257","WBGene00007130","X",9428431,9430424,1993
"5258","WBGene00007131","III",4376503,4379200,2697
"5259","WBGene00007132","III",4381739,4384141,2402
"5260","WBGene00007133","III",4379368,4381041,1673
"5261","WBGene00007134","III",4384787,4387757,2970
"5262","WBGene00007135","III",4332996,4340464,7468
"5263","WBGene00007136","III",4341983,4343336,1353
"5264","WBGene00007137","III",4343446,4345366,1920
"5265","WBGene00007138","III",4352246,4355888,3642
"5266","WBGene00007139","III",4356539,4364974,8435
"5267","WBGene00007140","V",9654755,9657975,3220
"5268","WBGene00007141","V",9658931,9661614,2683
"5269","WBGene00007142","II",11485510,11486774,1264
"5270","WBGene00007143","II",11489605,11493039,3434
"5271","WBGene00007144","II",11495692,11496663,971
"5272","WBGene00007145","II",11497665,11499620,1955
"5273","WBGene00007146","II",11510673,11513890,3217
"5274","WBGene00007147","II",11480432,11482385,1953
"5275","WBGene00007148","II",11518488,11519571,1083
"5276","WBGene00007149","II",11488302,11489619,1317
"5277","WBGene00007150","V",13116488,13120167,3679
"5278","WBGene00007151","V",13120676,13123421,2745
"5279","WBGene00007152","V",13133750,13134886,1136
"5280","WBGene00007153","V",13134965,13138101,3136
"5281","WBGene00007154","V",13138981,13152466,13485
"5282","WBGene00007155","I",10074952,10077749,2797
"5283","WBGene00007156","I",10070923,10071900,977
"5284","WBGene00007158","I",10097317,10097777,460
"5285","WBGene00007159","I",10072578,10074399,1821
"5286","WBGene00007160","V",15618180,15619395,1215
"5287","WBGene00007161","V",15614937,15617611,2674
"5288","WBGene00007162","V",15605673,15610384,4711
"5289","WBGene00007163","V",15602915,15605155,2240
"5290","WBGene00007164","V",15593462,15593799,337
"5291","WBGene00007165","V",15585067,15593185,8118
"5292","WBGene00007166","V",15600400,15602345,1945
"5293","WBGene00007167","III",4754432,4757017,2585
"5294","WBGene00007168","III",4757201,4759728,2527
"5295","WBGene00007169","III",4759744,4763609,3865
"5296","WBGene00007170","III",4765833,4776342,10509
"5297","WBGene00007171","III",4780130,4781987,1857
"5298","WBGene00007172","III",4776264,4778065,1801
"5299","WBGene00007173","III",4751878,4752370,492
"5300","WBGene00007174","X",16030806,16034816,4010
"5301","WBGene00007175","X",16035055,16039514,4459
"5302","WBGene00007176","V",19565386,19606115,40729
"5303","WBGene00007177","V",19551008,19555969,4961
"5304","WBGene00007178","II",8924572,8926678,2106
"5305","WBGene00007179","II",8910913,8912029,1116
"5306","WBGene00007180","II",8922423,8924373,1950
"5307","WBGene00007181","V",18325035,18328791,3756
"5308","WBGene00007182","V",18318595,18319744,1149
"5309","WBGene00007183","V",18329112,18331179,2067
"5310","WBGene00007184","III",9491640,9497044,5404
"5311","WBGene00007185","III",9488731,9489188,457
"5312","WBGene00007186","III",9462989,9465965,2976
"5313","WBGene00007187","III",9468157,9469899,1742
"5314","WBGene00007188","III",9465767,9467177,1410
"5315","WBGene00007189","II",11348430,11349946,1516
"5316","WBGene00007190","II",11338451,11339620,1169
"5317","WBGene00007191","II",11340092,11343530,3438
"5318","WBGene00007192","II",11343716,11345743,2027
"5319","WBGene00007193","II",11345943,11348248,2305
"5320","WBGene00007194","II",11350192,11351373,1181
"5321","WBGene00007195","IV",13882734,13884177,1443
"5322","WBGene00007196","IV",13880138,13881546,1408
"5323","WBGene00007197","IV",13868556,13876615,8059
"5324","WBGene00007198","IV",13854355,13857353,2998
"5325","WBGene00007199","IV",13847777,13852712,4935
"5326","WBGene00007200","IV",13860339,13865346,5007
"5327","WBGene00007201","IV",13099378,13100608,1230
"5328","WBGene00007202","IV",13107659,13111500,3841
"5329","WBGene00007203","IV",13108141,13109799,1658
"5330","WBGene00007204","IV",13111520,13113082,1562
"5331","WBGene00007207","IV",13100715,13104641,3926
"5332","WBGene00007209","III",12787643,12789520,1877
"5333","WBGene00007210","III",12793386,12798157,4771
"5334","WBGene00007211","III",12808026,12811650,3624
"5335","WBGene00007212","III",12813541,12816798,3257
"5336","WBGene00007213","I",13409933,13411451,1518
"5337","WBGene00007214","I",13397270,13398529,1259
"5338","WBGene00007215","I",13387819,13391450,3631
"5339","WBGene00007216","I",13392118,13394001,1883
"5340","WBGene00007217","I",13384752,13387084,2332
"5341","WBGene00007218","I",13379917,13384371,4454
"5342","WBGene00007219","I",13402447,13404106,1659
"5343","WBGene00007220","II",13771575,13779015,7440
"5344","WBGene00007221","IV",9096842,9099364,2522
"5345","WBGene00007222","IV",9099242,9101592,2350
"5346","WBGene00007223","IV",9095754,9096231,477
"5347","WBGene00007224","II",9267336,9268303,967
"5348","WBGene00007225","II",9269888,9271267,1379
"5349","WBGene00007226","II",9271265,9273042,1777
"5350","WBGene00007227","II",9275024,9280098,5074
"5351","WBGene00007228","II",9292017,9294050,2033
"5352","WBGene00007229","II",9294029,9295753,1724
"5353","WBGene00007230","V",15099747,15104389,4642
"5354","WBGene00007231","V",15089740,15090021,281
"5355","WBGene00007232","V",15089077,15089538,461
"5356","WBGene00007233","V",15087656,15088336,680
"5357","WBGene00007234","V",15085747,15087064,1317
"5358","WBGene00007235","V",15084059,15085382,1323
"5359","WBGene00007236","V",15082530,15084139,1609
"5360","WBGene00007237","V",15080134,15082533,2399
"5361","WBGene00007238","V",15106094,15106473,379
"5362","WBGene00007239","V",15105327,15105943,616
"5363","WBGene00007240","V",15086913,15087326,413
"5364","WBGene00007241","V",15092966,15094338,1372
"5365","WBGene00007242","II",14573615,14576558,2943
"5366","WBGene00007243","II",14578313,14578597,284
"5367","WBGene00007244","II",14581377,14582361,984
"5368","WBGene00007245","II",14586527,14587507,980
"5369","WBGene00007246","II",14587957,14588241,284
"5370","WBGene00007247","II",14588621,14591893,3272
"5371","WBGene00007248","II",14593581,14597657,4076
"5372","WBGene00007249","II",14579016,14580124,1108
"5373","WBGene00007250","II",14580254,14581043,789
"5374","WBGene00007251","II",14580859,14581275,416
"5375","WBGene00007252","I",7204541,7207717,3176
"5376","WBGene00007253","I",7208028,7209866,1838
"5377","WBGene00007254","I",7210515,7212579,2064
"5378","WBGene00007255","I",7222296,7224381,2085
"5379","WBGene00007256","I",7224656,7227767,3111
"5380","WBGene00007257","I",7227859,7229434,1575
"5381","WBGene00007258","I",7229433,7233121,3688
"5382","WBGene00007259","X",12658476,12661062,2586
"5383","WBGene00007260","X",15537662,15546323,8661
"5384","WBGene00007261","X",15546688,15552233,5545
"5385","WBGene00007262","X",15284182,15286227,2045
"5386","WBGene00007264","IV",10513887,10515228,1341
"5387","WBGene00007265","IV",10523462,10524145,683
"5388","WBGene00007266","X",11257361,11260225,2864
"5389","WBGene00007267","X",11262848,11266324,3476
"5390","WBGene00007268","X",11267391,11269023,1632
"5391","WBGene00007269","III",4091126,4093311,2185
"5392","WBGene00007270","III",4096896,4098190,1294
"5393","WBGene00007271","III",4089766,4092120,2354
"5394","WBGene00007273","III",4096045,4096915,870
"5395","WBGene00007274","I",10014547,10015495,948
"5396","WBGene00007275","I",9668628,9670726,2098
"5397","WBGene00007277","I",9658274,9660080,1806
"5398","WBGene00007278","I",9657012,9657871,859
"5399","WBGene00007279","V",11291188,11292569,1381
"5400","WBGene00007281","V",11286602,11288412,1810
"5401","WBGene00007282","V",11273148,11278161,5013
"5402","WBGene00007283","V",11271351,11272467,1116
"5403","WBGene00007284","X",15689449,15696423,6974
"5404","WBGene00007285","X",13660519,13662980,2461
"5405","WBGene00007286","X",13665958,13668830,2872
"5406","WBGene00007287","X",13677192,13682340,5148
"5407","WBGene00007288","X",13664589,13665352,763
"5408","WBGene00007289","X",12280707,12282559,1852
"5409","WBGene00007290","X",12283285,12285307,2022
"5410","WBGene00007291","X",12285824,12287253,1429
"5411","WBGene00007292","X",12290839,12293267,2428
"5412","WBGene00007293","X",12287659,12288354,695
"5413","WBGene00007294","X",12275042,12275677,635
"5414","WBGene00007295","X",14020590,14022409,1819
"5415","WBGene00007296","X",14033794,14037447,3653
"5416","WBGene00007297","I",9673668,9678553,4885
"5417","WBGene00007299","I",9690079,9690557,478
"5418","WBGene00007300","I",9692701,9693781,1080
"5419","WBGene00007301","I",9695707,9696762,1055
"5420","WBGene00007302","I",9697237,9699561,2324
"5421","WBGene00007303","I",9710093,9710767,674
"5422","WBGene00007304","IV",10088367,10089894,1527
"5423","WBGene00007305","IV",10090658,10092379,1721
"5424","WBGene00007306","IV",10094198,10095259,1061
"5425","WBGene00007307","IV",10110347,10111577,1230
"5426","WBGene00007308","IV",10112870,10114287,1417
"5427","WBGene00007309","IV",10115389,10118084,2695
"5428","WBGene00007310","IV",10119460,10122305,2845
"5429","WBGene00007311","II",7958844,7960237,1393
"5430","WBGene00007312","II",14534300,14535365,1065
"5431","WBGene00007313","II",14535923,14537579,1656
"5432","WBGene00007314","II",14540895,14548791,7896
"5433","WBGene00007315","II",14537946,14539162,1216
"5434","WBGene00007316","II",14550913,14552476,1563
"5435","WBGene00007317","X",10842658,10844674,2016
"5436","WBGene00007319","III",9987768,9988421,653
"5437","WBGene00007320","III",9999819,10000528,709
"5438","WBGene00007321","III",9993885,9996235,2350
"5439","WBGene00007322","III",10001400,10003856,2456
"5440","WBGene00007323","III",10007966,10010177,2211
"5441","WBGene00007324","III",10005459,10006784,1325
"5442","WBGene00007325","X",11160981,11164006,3025
"5443","WBGene00007326","X",11153065,11157643,4578
"5444","WBGene00007327","X",11142971,11152820,9849
"5445","WBGene00007328","II",9918125,9920568,2443
"5446","WBGene00007329","II",9922248,9930830,8582
"5447","WBGene00007330","II",9934403,9936893,2490
"5448","WBGene00007331","II",9931845,9934443,2598
"5449","WBGene00007332","II",9939040,9940432,1392
"5450","WBGene00007333","II",9940758,9944006,3248
"5451","WBGene00007334","II",9938106,9938971,865
"5452","WBGene00007335","IV",11253985,11255703,1718
"5453","WBGene00007336","IV",11246451,11248081,1630
"5454","WBGene00007337","IV",11260412,11261185,773
"5455","WBGene00007338","IV",11231670,11233124,1454
"5456","WBGene00007339","II",11412232,11415820,3588
"5457","WBGene00007340","II",11418314,11423393,5079
"5458","WBGene00007341","II",11431709,11432766,1057
"5459","WBGene00007342","II",11434221,11434958,737
"5460","WBGene00007343","X",12941441,12943547,2106
"5461","WBGene00007344","X",12938695,12940792,2097
"5462","WBGene00007345","X",12945616,12946562,946
"5463","WBGene00007346","X",12965485,12968731,3246
"5464","WBGene00007347","X",14734443,14740088,5645
"5465","WBGene00007348","X",14747298,14750441,3143
"5466","WBGene00007349","X",14750849,14752011,1162
"5467","WBGene00007350","X",14754026,14756459,2433
"5468","WBGene00007351","X",14756075,14760963,4888
"5469","WBGene00007352","II",10560018,10563407,3389
"5470","WBGene00007353","II",10570602,10572530,1928
"5471","WBGene00007354","II",10572247,10574067,1820
"5472","WBGene00007355","II",10579366,10579955,589
"5473","WBGene00007356","II",10564175,10564678,503
"5474","WBGene00007357","IV",17427717,17429602,1885
"5475","WBGene00007358","IV",17429637,17431968,2331
"5476","WBGene00007359","IV",17437338,17438155,817
"5477","WBGene00007360","V",13902795,13903886,1091
"5478","WBGene00007361","V",13899513,13902653,3140
"5479","WBGene00007362","V",13896663,13898488,1825
"5480","WBGene00007363","V",13906492,13908135,1643
"5481","WBGene00007364","V",13904611,13905996,1385
"5482","WBGene00007365","V",13908133,13909513,1380
"5483","WBGene00007366","V",13909686,13911524,1838
"5484","WBGene00007367","V",15479398,15481677,2279
"5485","WBGene00007368","V",15476086,15478566,2480
"5486","WBGene00007369","V",15484054,15484637,583
"5487","WBGene00007370","V",15491003,15492770,1767
"5488","WBGene00007372","V",15498743,15511421,12678
"5489","WBGene00007373","V",15486388,15487118,730
"5490","WBGene00007374","II",9369178,9372485,3307
"5491","WBGene00007375","II",9373291,9374889,1598
"5492","WBGene00007376","II",9380106,9381355,1249
"5493","WBGene00007377","II",9385541,9386537,996
"5494","WBGene00007378","II",9386584,9390900,4316
"5495","WBGene00007379","V",16010708,16012112,1404
"5496","WBGene00007380","V",15988754,15991609,2855
"5497","WBGene00007381","V",15992150,15995607,3457
"5498","WBGene00007382","V",15997136,15997768,632
"5499","WBGene00007383","V",15996214,15996745,531
"5500","WBGene00007384","IV",10778985,10780711,1726
"5501","WBGene00007385","V",11122820,11123867,1047
"5502","WBGene00007386","V",11125222,11127306,2084
"5503","WBGene00007387","V",11127497,11130085,2588
"5504","WBGene00007388","V",11141498,11143121,1623
"5505","WBGene00007389","V",11134609,11140323,5714
"5506","WBGene00007390","V",11124303,11125053,750
"5507","WBGene00007391","V",11143062,11144758,1696
"5508","WBGene00007392","V",17895268,17896804,1536
"5509","WBGene00007393","V",17899803,17901913,2110
"5510","WBGene00007394","V",17879844,17888984,9140
"5511","WBGene00007395","V",17910304,17917241,6937
"5512","WBGene00007396","X",10167096,10171668,4572
"5513","WBGene00007397","X",10172326,10174185,1859
"5514","WBGene00007398","X",10174985,10175896,911
"5515","WBGene00007399","III",9723282,9725214,1932
"5516","WBGene00007400","III",9694668,9696517,1849
"5517","WBGene00007401","III",9681524,9682829,1305
"5518","WBGene00007402","III",9676320,9679051,2731
"5519","WBGene00007403","III",9691030,9694572,3542
"5520","WBGene00007404","III",9686990,9690253,3263
"5521","WBGene00007405","III",9663290,9667640,4350
"5522","WBGene00007406","III",9685170,9686726,1556
"5523","WBGene00007407","X",9516393,9517187,794
"5524","WBGene00007408","X",9522488,9523173,685
"5525","WBGene00007409","X",9529533,9536631,7098
"5526","WBGene00007410","X",9519022,9521486,2464
"5527","WBGene00007411","IV",9185040,9186023,983
"5528","WBGene00007412","II",10346981,10350007,3026
"5529","WBGene00007413","II",10339692,10345112,5420
"5530","WBGene00007414","II",10353584,10357518,3934
"5531","WBGene00007415","II",10360871,10362915,2044
"5532","WBGene00007416","II",10363584,10365709,2125
"5533","WBGene00007417","II",10367741,10369597,1856
"5534","WBGene00007418","II",10352263,10353463,1200
"5535","WBGene00007419","II",10350760,10351613,853
"5536","WBGene00007420","II",10346375,10347001,626
"5537","WBGene00007421","II",9091109,9093696,2587
"5538","WBGene00007422","V",10102592,10104946,2354
"5539","WBGene00007423","V",10105712,10106694,982
"5540","WBGene00007424","V",10109872,10112287,2415
"5541","WBGene00007425","V",10114629,10117368,2739
"5542","WBGene00007426","V",10117765,10119688,1923
"5543","WBGene00007427","V",10123638,10124689,1051
"5544","WBGene00007428","V",10130405,10134148,3743
"5545","WBGene00007429","V",10134643,10143081,8438
"5546","WBGene00007430","V",10125052,10127570,2518
"5547","WBGene00007431","V",10107684,10109905,2221
"5548","WBGene00007432","V",10119574,10120986,1412
"5549","WBGene00007433","II",8022649,8027756,5107
"5550","WBGene00007434","II",8035869,8037346,1477
"5551","WBGene00007435","II",8040006,8041732,1726
"5552","WBGene00007436","II",8037316,8038167,851
"5553","WBGene00007437","V",18361051,18362543,1492
"5554","WBGene00007438","V",18353510,18355842,2332
"5555","WBGene00007439","V",18350148,18350464,316
"5556","WBGene00007440","V",18371846,18373528,1682
"5557","WBGene00007441","V",18359818,18359988,170
"5558","WBGene00007442","V",18368243,18368422,179
"5559","WBGene00007443","IV",11150113,11150930,817
"5560","WBGene00007444","IV",11149189,11154334,5145
"5561","WBGene00007445","IV",11155029,11156634,1605
"5562","WBGene00007446","IV",11157102,11159492,2390
"5563","WBGene00007447","IV",11161787,11162551,764
"5564","WBGene00007448","IV",11162768,11164622,1854
"5565","WBGene00007449","IV",11178077,11178595,518
"5566","WBGene00007450","IV",13623833,13625432,1599
"5567","WBGene00007451","IV",13621987,13623134,1147
"5568","WBGene00007452","IV",13619508,13621513,2005
"5569","WBGene00007453","IV",13633499,13635179,1680
"5570","WBGene00007454","IV",13637288,13638525,1237
"5571","WBGene00007455","IV",13639260,13644402,5142
"5572","WBGene00007456","IV",13644463,13645923,1460
"5573","WBGene00007457","IV",13648039,13649335,1296
"5574","WBGene00007458","IV",13646735,13647658,923
"5575","WBGene00007459","IV",13651014,13651512,498
"5576","WBGene00007460","IV",13607436,13609892,2456
"5577","WBGene00007461","IV",13612805,13618061,5256
"5578","WBGene00007462","II",9875179,9878008,2829
"5579","WBGene00007463","II",9886557,9891081,4524
"5580","WBGene00007464","II",9882728,9886442,3714
"5581","WBGene00007465","II",9862431,9866404,3973
"5582","WBGene00007466","II",9873249,9874521,1272
"5583","WBGene00007467","II",9859784,9861473,1689
"5584","WBGene00007468","II",9851471,9853394,1923
"5585","WBGene00007469","II",9853811,9855695,1884
"5586","WBGene00007470","II",9858110,9859639,1529
"5587","WBGene00007471","II",9855936,9857857,1921
"5588","WBGene00007472","II",9869456,9871172,1716
"5589","WBGene00007473","II",9871608,9872986,1378
"5590","WBGene00007474","II",9881193,9882530,1337
"5591","WBGene00007476","IV",1275865,1277091,1226
"5592","WBGene00007478","II",14698701,14699362,661
"5593","WBGene00007479","II",14705512,14712800,7288
"5594","WBGene00007480","II",14720552,14733524,12972
"5595","WBGene00007482","X",11053915,11056970,3055
"5596","WBGene00007483","X",11041032,11042877,1845
"5597","WBGene00007484","X",15977762,15982600,4838
"5598","WBGene00007485","X",15986163,15987594,1431
"5599","WBGene00007486","X",15987971,15996936,8965
"5600","WBGene00007487","X",15959100,15962344,3244
"5601","WBGene00007488","II",10702509,10714297,11788
"5602","WBGene00007489","II",10714886,10716416,1530
"5603","WBGene00007490","II",10720231,10729252,9021
"5604","WBGene00007492","IV",8862173,8865483,3310
"5605","WBGene00007493","IV",8868036,8869679,1643
"5606","WBGene00007494","IV",8869962,8873057,3095
"5607","WBGene00007495","IV",8886528,8888602,2074
"5608","WBGene00007496","IV",8877553,8879910,2357
"5609","WBGene00007497","IV",8881481,8882240,759
"5610","WBGene00007499","II",11100479,11103779,3300
"5611","WBGene00007500","II",11106616,11108070,1454
"5612","WBGene00007501","II",11108159,11109583,1424
"5613","WBGene00007502","II",11109584,11111169,1585
"5614","WBGene00007503","II",11104462,11106046,1584
"5615","WBGene00007504","II",11095048,11096475,1427
"5616","WBGene00007505","IV",9343358,9366506,23148
"5617","WBGene00007506","IV",9371508,9373636,2128
"5618","WBGene00007507","IV",9374733,9376492,1759
"5619","WBGene00007508","IV",9378552,9380450,1898
"5620","WBGene00007509","IV",9381515,9383115,1600
"5621","WBGene00007511","IV",9385126,9385713,587
"5622","WBGene00007512","IV",11463609,11465189,1580
"5623","WBGene00007513","IV",11470185,11473419,3234
"5624","WBGene00007514","IV",11473363,11479251,5888
"5625","WBGene00007515","IV",11465433,11467239,1806
"5626","WBGene00007516","X",9584664,9586344,1680
"5627","WBGene00007517","X",9587942,9588879,937
"5628","WBGene00007518","X",9589423,9595459,6036
"5629","WBGene00007520","X",9610563,9617045,6482
"5630","WBGene00007521","X",9617219,9619122,1903
"5631","WBGene00007522","X",9623304,9624714,1410
"5632","WBGene00007523","X",16329217,16329997,780
"5633","WBGene00007525","X",15157359,15158749,1390
"5634","WBGene00007528","X",14304946,14307767,2821
"5635","WBGene00007529","X",14307863,14311683,3820
"5636","WBGene00007530","X",14298102,14303178,5076
"5637","WBGene00007531","X",14327409,14330195,2786
"5638","WBGene00007533","I",9327857,9330928,3071
"5639","WBGene00007534","V",10236160,10238902,2742
"5640","WBGene00007535","V",10226885,10227434,549
"5641","WBGene00007536","V",10223513,10225760,2247
"5642","WBGene00007537","V",10239590,10240185,595
"5643","WBGene00007538","V",10242787,10243205,418
"5644","WBGene00007539","II",11484683,11484752,69
"5645","WBGene00007540","V",10219455,10220470,1015
"5646","WBGene00007541","V",10228043,10228460,417
"5647","WBGene00007542","V",10228641,10229322,681
"5648","WBGene00007543","V",10229807,10230163,356
"5649","WBGene00007544","V",10231232,10231594,362
"5650","WBGene00007545","II",14470371,14479627,9256
"5651","WBGene00007546","V",12104273,12106507,2234
"5652","WBGene00007547","V",12101293,12103286,1993
"5653","WBGene00007548","V",12109168,12110978,1810
"5654","WBGene00007549","V",12114993,12117443,2450
"5655","WBGene00007550","V",12121587,12125096,3509
"5656","WBGene00007551","V",12118828,12120814,1986
"5657","WBGene00007552","V",12523647,12525656,2009
"5658","WBGene00007553","V",11011589,11012465,876
"5659","WBGene00007554","V",11027153,11030845,3692
"5660","WBGene00007555","II",10579955,10581045,1090
"5661","WBGene00007556","II",10584336,10587928,3592
"5662","WBGene00007557","II",10593529,10594776,1247
"5663","WBGene00007558","II",10595266,10596562,1296
"5664","WBGene00007559","II",10597174,10598100,926
"5665","WBGene00007560","II",10599337,10600529,1192
"5666","WBGene00007561","II",10605717,10607275,1558
"5667","WBGene00007562","II",10613043,10618332,5289
"5668","WBGene00007563","II",10618471,10620503,2032
"5669","WBGene00007564","II",10582618,10584236,1618
"5670","WBGene00007565","V",18157878,18159614,1736
"5671","WBGene00007567","V",18146377,18146635,258
"5672","WBGene00007569","V",18163439,18164858,1419
"5673","WBGene00007570","V",18165294,18167261,1967
"5674","WBGene00007571","V",18167634,18168450,816
"5675","WBGene00007572","V",18169087,18171618,2531
"5676","WBGene00007573","III",3702260,3703172,912
"5677","WBGene00007574","III",3703564,3705046,1482
"5678","WBGene00007576","III",3706886,3709225,2339
"5679","WBGene00007577","III",3713463,3718745,5282
"5680","WBGene00007578","III",3719904,3723597,3693
"5681","WBGene00007579","III",3718655,3719722,1067
"5682","WBGene00007580","III",3725075,3726500,1425
"5683","WBGene00007581","III",3709330,3713282,3952
"5684","WBGene00007583","V",19332425,19349495,17070
"5685","WBGene00007584","V",12588309,12589644,1335
"5686","WBGene00007585","V",12590979,12592477,1498
"5687","WBGene00007586","V",12596393,12599151,2758
"5688","WBGene00007587","V",12592568,12596296,3728
"5689","WBGene00007588","V",12600192,12607304,7112
"5690","WBGene00007589","V",12607413,12608107,694
"5691","WBGene00007590","V",12589633,12590717,1084
"5692","WBGene00007591","X",10233739,10236944,3205
"5693","WBGene00007592","X",10242325,10252879,10554
"5694","WBGene00007593","X",10220644,10228137,7493
"5695","WBGene00007594","X",12065264,12067432,2168
"5696","WBGene00007595","X",12070743,12073863,3120
"5697","WBGene00007597","I",7384398,7388792,4394
"5698","WBGene00007598","I",7398824,7401023,2199
"5699","WBGene00007599","I",7404950,7408511,3561
"5700","WBGene00007600","I",12202232,12203717,1485
"5701","WBGene00007601","I",12203800,12205809,2009
"5702","WBGene00007602","I",12207097,12212206,5109
"5703","WBGene00007603","I",12213109,12215184,2075
"5704","WBGene00007604","V",12734183,12736041,1858
"5705","WBGene00007605","V",12742041,12744207,2166
"5706","WBGene00007606","V",12745201,12747463,2262
"5707","WBGene00007607","V",12748292,12749963,1671
"5708","WBGene00007608","V",12750030,12751545,1515
"5709","WBGene00007609","V",12744165,12745050,885
"5710","WBGene00007610","III",9650422,9651971,1549
"5711","WBGene00007611","III",9654409,9655859,1450
"5712","WBGene00007613","V",14393804,14394463,659
"5713","WBGene00007614","V",14409078,14411986,2908
"5714","WBGene00007615","V",14417903,14420096,2193
"5715","WBGene00007616","V",14422720,14423383,663
"5716","WBGene00007617","V",14423776,14425008,1232
"5717","WBGene00007618","V",14392240,14392772,532
"5718","WBGene00007619","V",14415814,14416176,362
"5719","WBGene00007620","I",9715321,9728108,12787
"5720","WBGene00007621","I",9712824,9715230,2406
"5721","WBGene00007622","III",4178783,4181438,2655
"5722","WBGene00007623","III",4177532,4178664,1132
"5723","WBGene00007624","III",4172337,4176159,3822
"5724","WBGene00007625","III",4171336,4172223,887
"5725","WBGene00007626","III",4168797,4170949,2152
"5726","WBGene00007627","III",4166944,4168765,1821
"5727","WBGene00007628","III",4161951,4164171,2220
"5728","WBGene00007629","III",4155388,4157394,2006
"5729","WBGene00007630","III",4152054,4152915,861
"5730","WBGene00007631","III",4147425,4151598,4173
"5731","WBGene00007632","III",4176678,4177578,900
"5732","WBGene00007633","II",9131663,9134543,2880
"5733","WBGene00007634","X",12525344,12525783,439
"5734","WBGene00007635","X",12537014,12551677,14663
"5735","WBGene00007636","X",12526660,12527286,626
"5736","WBGene00007637","I",11611672,11616244,4572
"5737","WBGene00007639","I",11585922,11587294,1372
"5738","WBGene00007640","I",11604027,11611314,7287
"5739","WBGene00007641","I",9408356,9410094,1738
"5740","WBGene00007642","I",9412314,9413222,908
"5741","WBGene00007643","I",9416704,9418884,2180
"5742","WBGene00007644","I",9419368,9419998,630
"5743","WBGene00007645","I",9422556,9431120,8564
"5744","WBGene00007646","I",9431098,9433828,2730
"5745","WBGene00007647","I",9435377,9441029,5652
"5746","WBGene00007648","X",9919302,9920346,1044
"5747","WBGene00007649","X",9921557,9922843,1286
"5748","WBGene00007650","X",9922910,9925173,2263
"5749","WBGene00007651","X",9925728,9931460,5732
"5750","WBGene00007652","X",9941630,9944838,3208
"5751","WBGene00007653","X",9952579,9954533,1954
"5752","WBGene00007654","I",13117629,13120324,2695
"5753","WBGene00007655","I",13085106,13103119,18013
"5754","WBGene00007656","I",13104253,13106298,2045
"5755","WBGene00007657","I",13107492,13112443,4951
"5756","WBGene00007658","I",13113487,13116434,2947
"5757","WBGene00007659","I",13130808,13132464,1656
"5758","WBGene00007660","I",13136467,13138521,2054
"5759","WBGene00007661","I",13128470,13130409,1939
"5760","WBGene00007662","I",13121092,13123513,2421
"5761","WBGene00007663","X",15012684,15012926,242
"5762","WBGene00007664","X",15026308,15031084,4776
"5763","WBGene00007666","X",15036662,15040602,3940
"5764","WBGene00007667","X",15042956,15045353,2397
"5765","WBGene00007668","X",15004064,15007308,3244
"5766","WBGene00007669","II",10056988,10058993,2005
"5767","WBGene00007670","II",10056311,10060582,4271
"5768","WBGene00007672","V",17521037,17527479,6442
"5769","WBGene00007673","V",17532353,17532786,433
"5770","WBGene00007674","V",17530813,17531510,697
"5771","WBGene00007675","V",17535615,17538373,2758
"5772","WBGene00007677","V",17544175,17546974,2799
"5773","WBGene00007678","V",17528029,17529910,1881
"5774","WBGene00007679","III",11816569,11819806,3237
"5775","WBGene00007680","III",11819745,11822526,2781
"5776","WBGene00007681","III",11823327,11824975,1648
"5777","WBGene00007682","III",11810556,11811046,490
"5778","WBGene00007683","II",8965006,8966919,1913
"5779","WBGene00007684","II",8964238,8964901,663
"5780","WBGene00007685","II",8969980,8971967,1987
"5781","WBGene00007686","II",8971965,8973566,1601
"5782","WBGene00007687","II",8978475,8982783,4308
"5783","WBGene00007688","II",8985900,8988062,2162
"5784","WBGene00007689","II",8988359,8989544,1185
"5785","WBGene00007690","II",8955239,8964149,8910
"5786","WBGene00007691","X",12219710,12222745,3035
"5787","WBGene00007692","X",12226203,12229861,3658
"5788","WBGene00007693","X",12229951,12233244,3293
"5789","WBGene00007694","X",12235621,12240781,5160
"5790","WBGene00007695","X",12222869,12226047,3178
"5791","WBGene00007696","IV",10219373,10221281,1908
"5792","WBGene00007697","IV",10222472,10223745,1273
"5793","WBGene00007698","IV",10214986,10219308,4322
"5794","WBGene00007699","III",11787690,11789496,1806
"5795","WBGene00007700","III",11790497,11792295,1798
"5796","WBGene00007701","III",11782112,11784074,1962
"5797","WBGene00007702","III",11780235,11781035,800
"5798","WBGene00007703","III",11751320,11773681,22361
"5799","WBGene00007704","III",11777625,11779629,2004
"5800","WBGene00007705","I",10162379,10163578,1199
"5801","WBGene00007707","I",10177181,10178921,1740
"5802","WBGene00007709","I",10184478,10185470,992
"5803","WBGene00007710","I",10185780,10187550,1770
"5804","WBGene00007711","I",10191273,10192894,1621
"5805","WBGene00007712","I",10193242,10193999,757
"5806","WBGene00007713","I",10197321,10197596,275
"5807","WBGene00007714","V",15036237,15036869,632
"5808","WBGene00007715","V",15037795,15038835,1040
"5809","WBGene00007716","V",15051011,15052530,1519
"5810","WBGene00007717","V",15053765,15056280,2515
"5811","WBGene00007718","V",15066298,15067464,1166
"5812","WBGene00007719","V",15065135,15065317,182
"5813","WBGene00007720","V",15067465,15068581,1116
"5814","WBGene00007721","V",15032142,15034069,1927
"5815","WBGene00007722","V",15060249,15061530,1281
"5816","WBGene00007723","V",19421471,19426774,5303
"5817","WBGene00007724","V",19411274,19413914,2640
"5818","WBGene00007725","V",19407739,19410857,3118
"5819","WBGene00007726","V",19403530,19405326,1796
"5820","WBGene00007727","V",19395055,19396609,1554
"5821","WBGene00007728","V",19416633,19418004,1371
"5822","WBGene00007729","IV",12438659,12441190,2531
"5823","WBGene00007730","IV",12443236,12444046,810
"5824","WBGene00007731","IV",12444450,12445884,1434
"5825","WBGene00007732","IV",12452066,12454215,2149
"5826","WBGene00007733","IV",12455097,12456175,1078
"5827","WBGene00007734","IV",12456913,12458561,1648
"5828","WBGene00007735","IV",12459819,12463412,3593
"5829","WBGene00007736","IV",12468658,12474889,6231
"5830","WBGene00007739","I",7532315,7535997,3682
"5831","WBGene00007740","I",7505951,7506693,742
"5832","WBGene00007741","I",7508721,7512593,3872
"5833","WBGene00007742","I",7503576,7505580,2004
"5834","WBGene00007743","I",7514117,7515126,1009
"5835","WBGene00007744","II",8325386,8329658,4272
"5836","WBGene00007745","II",8329758,8333481,3723
"5837","WBGene00007746","II",8350535,8354700,4165
"5838","WBGene00007747","V",13297520,13298050,530
"5839","WBGene00007748","V",13305138,13307271,2133
"5840","WBGene00007749","V",13301652,13304785,3133
"5841","WBGene00007750","X",14654972,14662841,7869
"5842","WBGene00007751","X",14664289,14671336,7047
"5843","WBGene00007752","IV",12653403,12674773,21370
"5844","WBGene00007753","V",12131442,12137395,5953
"5845","WBGene00007754","V",12138354,12140322,1968
"5846","WBGene00007755","V",12140876,12144259,3383
"5847","WBGene00007756","V",12154875,12162299,7424
"5848","WBGene00007757","V",12124850,12130788,5938
"5849","WBGene00007758","V",12153076,12154264,1188
"5850","WBGene00007759","V",12154263,12154654,391
"5851","WBGene00007760","IV",8892858,8893854,996
"5852","WBGene00007761","IV",8894081,8901386,7305
"5853","WBGene00007762","IV",8901646,8903177,1531
"5854","WBGene00007763","IV",8903222,8906205,2983
"5855","WBGene00007764","IV",8907047,8915383,8336
"5856","WBGene00007765","IV",8915472,8916110,638
"5857","WBGene00007766","I",11439289,11440709,1420
"5858","WBGene00007768","I",11423993,11426054,2061
"5859","WBGene00007769","I",11422190,11423600,1410
"5860","WBGene00007771","X",14852552,14853762,1210
"5861","WBGene00007772","X",14845937,14849217,3280
"5862","WBGene00007773","X",14863678,14865844,2166
"5863","WBGene00007774","X",14854131,14856518,2387
"5864","WBGene00007775","X",14849275,14852619,3344
"5865","WBGene00007776","X",14857303,14861801,4498
"5866","WBGene00007777","IV",12717831,12719391,1560
"5867","WBGene00007778","IV",12712765,12714771,2006
"5868","WBGene00007779","IV",12706714,12711744,5030
"5869","WBGene00007780","IV",12704111,12706755,2644
"5870","WBGene00007784","V",9978791,9980802,2011
"5871","WBGene00007785","V",9981249,9982766,1517
"5872","WBGene00007786","V",9983924,9986277,2353
"5873","WBGene00007787","V",9986330,9987788,1458
"5874","WBGene00007788","III",4429618,4434399,4781
"5875","WBGene00007789","III",4434750,4439543,4793
"5876","WBGene00007791","III",4423711,4429499,5788
"5877","WBGene00007792","IV",9743765,9745003,1238
"5878","WBGene00007793","IV",9745555,9746862,1307
"5879","WBGene00007794","IV",9741875,9743147,1272
"5880","WBGene00007795","IV",9747228,9748442,1214
"5881","WBGene00007796","IV",9738510,9739220,710
"5882","WBGene00007797","V",10812343,10813487,1144
"5883","WBGene00007798","V",10809191,10811076,1885
"5884","WBGene00007799","V",10825012,10846695,21683
"5885","WBGene00007800","V",10847193,10852502,5309
"5886","WBGene00007801","IV",11864532,11875738,11206
"5887","WBGene00007802","IV",11878549,11883407,4858
"5888","WBGene00007804","V",15346674,15347411,737
"5889","WBGene00007805","V",15349449,15350662,1213
"5890","WBGene00007806","V",15347847,15349144,1297
"5891","WBGene00007807","V",15354833,15357572,2739
"5892","WBGene00007808","IV",11226502,11230307,3805
"5893","WBGene00007809","IV",11222048,11223936,1888
"5894","WBGene00007810","X",13412463,13414617,2154
"5895","WBGene00007811","X",13416078,13418220,2142
"5896","WBGene00007812","X",13418841,13419934,1093
"5897","WBGene00007813","X",13436454,13441883,5429
"5898","WBGene00007816","X",16076809,16085215,8406
"5899","WBGene00007817","X",16082435,16085799,3364
"5900","WBGene00007818","X",16075061,16075668,607
"5901","WBGene00007819","X",16094067,16096497,2430
"5902","WBGene00007820","IV",17351886,17357895,6009
"5903","WBGene00007821","IV",17358139,17360635,2496
"5904","WBGene00007822","IV",17361443,17364583,3140
"5905","WBGene00007823","IV",17371769,17375638,3869
"5906","WBGene00007824","IV",17380626,17382225,1599
"5907","WBGene00007825","IV",17382298,17383087,789
"5908","WBGene00007826","IV",17379247,17380188,941
"5909","WBGene00007827","IV",17368592,17370618,2026
"5910","WBGene00007829","V",16292709,16295600,2891
"5911","WBGene00007831","V",16297370,16298278,908
"5912","WBGene00007832","V",16300576,16301478,902
"5913","WBGene00007833","V",16302717,16306156,3439
"5914","WBGene00007834","V",16307682,16309623,1941
"5915","WBGene00007835","V",16309805,16314752,4947
"5916","WBGene00007836","II",13636929,13638480,1551
"5917","WBGene00007837","II",13641495,13643821,2326
"5918","WBGene00007838","II",13645781,13648850,3069
"5919","WBGene00007840","II",13655837,13662081,6244
"5920","WBGene00007841","II",13669104,13669713,609
"5921","WBGene00007842","X",13984491,13985692,1201
"5922","WBGene00007844","X",13986607,13989009,2402
"5923","WBGene00007845","X",13989496,13990180,684
"5924","WBGene00007846","X",13991458,13995834,4376
"5925","WBGene00007847","X",13996307,13999351,3044
"5926","WBGene00007848","X",14001902,14003080,1178
"5927","WBGene00007849","X",14003020,14012595,9575
"5928","WBGene00007850","V",18179943,18181373,1430
"5929","WBGene00007851","V",18186111,18188331,2220
"5930","WBGene00007852","V",18185210,18185461,251
"5931","WBGene00007853","V",18172484,18178759,6275
"5932","WBGene00007854","I",9025779,9031232,5453
"5933","WBGene00007855","I",9042270,9042599,329
"5934","WBGene00007856","I",9048188,9049427,1239
"5935","WBGene00007857","I",9043315,9046889,3574
"5936","WBGene00007858","I",9041374,9041988,614
"5937","WBGene00007859","III",3627986,3630368,2382
"5938","WBGene00007860","III",3635876,3643670,7794
"5939","WBGene00007861","X",10258733,10260135,1402
"5940","WBGene00007862","V",10636022,10645135,9113
"5941","WBGene00007863","V",10645020,10646963,1943
"5942","WBGene00007864","IV",12912790,12914969,2179
"5943","WBGene00007865","IV",12916043,12917293,1250
"5944","WBGene00007866","IV",12918611,12920393,1782
"5945","WBGene00007867","IV",12921264,12923288,2024
"5946","WBGene00007868","IV",12923525,12924432,907
"5947","WBGene00007869","IV",12925866,12926805,939
"5948","WBGene00007870","IV",12930889,12931514,625
"5949","WBGene00007872","IV",12935011,12936271,1260
"5950","WBGene00007873","IV",12936738,12937988,1250
"5951","WBGene00007874","IV",12938213,12939071,858
"5952","WBGene00007875","IV",12940106,12941405,1299
"5953","WBGene00007876","IV",12942933,12944526,1593
"5954","WBGene00007877","X",15355238,15363861,8623
"5955","WBGene00007878","X",15365994,15369999,4005
"5956","WBGene00007880","IV",9523764,9524895,1131
"5957","WBGene00007881","IV",9518367,9518927,560
"5958","WBGene00007882","IV",9510748,9513002,2254
"5959","WBGene00007883","IV",9510055,9510594,539
"5960","WBGene00007885","IV",9500311,9502568,2257
"5961","WBGene00007886","IV",9506936,9508779,1843
"5962","WBGene00007887","IV",9482053,9485140,3087
"5963","WBGene00007888","IV",9505615,9506326,711
"5964","WBGene00007889","IV",9502572,9505292,2720
"5965","WBGene00007890","IV",9516992,9518410,1418
"5966","WBGene00007891","II",11370315,11372145,1830
"5967","WBGene00007892","II",11375608,11376269,661
"5968","WBGene00007893","II",11383327,11384570,1243
"5969","WBGene00007894","X",10485350,10486757,1407
"5970","WBGene00007895","X",10489063,10489821,758
"5971","WBGene00007896","X",10491344,10497264,5920
"5972","WBGene00007897","IV",8796881,8798355,1474
"5973","WBGene00007898","IV",8790742,8793294,2552
"5974","WBGene00007899","IV",8778721,8780872,2151
"5975","WBGene00007900","IV",8773977,8778145,4168
"5976","WBGene00007901","IV",8785764,8786650,886
"5977","WBGene00007902","IV",8773952,8775274,1322
"5978","WBGene00007903","X",14064313,14067984,3671
"5979","WBGene00007904","X",14071162,14076295,5133
"5980","WBGene00007905","X",14076316,14078674,2358
"5981","WBGene00007906","X",14080381,14084318,3937
"5982","WBGene00007907","V",13083055,13090260,7205
"5983","WBGene00007908","V",13066640,13071152,4512
"5984","WBGene00007909","V",13089803,13092512,2709
"5985","WBGene00007910","V",13095954,13097457,1503
"5986","WBGene00007911","I",8330552,8332783,2231
"5987","WBGene00007912","I",8336966,8341826,4860
"5988","WBGene00007913","I",8341709,8346023,4314
"5989","WBGene00007914","I",8333082,8336144,3062
"5990","WBGene00007916","II",8691789,8694180,2391
"5991","WBGene00007917","II",8696591,8698928,2337
"5992","WBGene00007918","II",8699045,8702193,3148
"5993","WBGene00007919","II",8707155,8708860,1705
"5994","WBGene00007920","III",3454345,3455850,1505
"5995","WBGene00007921","III",3456435,3460106,3671
"5996","WBGene00007922","III",3461703,3467687,5984
"5997","WBGene00007923","III",3467664,3469827,2163
"5998","WBGene00007924","III",3472003,3473718,1715
"5999","WBGene00007925","III",3482591,3484843,2252
"6000","WBGene00007926","III",3484813,3488341,3528
"6001","WBGene00007927","III",3460406,3461590,1184
"6002","WBGene00007928","III",3474019,3475450,1431
"6003","WBGene00007929","V",13222620,13225941,3321
"6004","WBGene00007930","V",13236171,13236604,433
"6005","WBGene00007931","V",13257097,13259311,2214
"6006","WBGene00007932","V",13264546,13269820,5274
"6007","WBGene00007933","X",12930336,12932025,1689
"6008","WBGene00007934","X",12932205,12934978,2773
"6009","WBGene00007935","X",11805378,11814653,9275
"6010","WBGene00007937","X",11804210,11805306,1096
"6011","WBGene00007938","X",11192485,11196841,4356
"6012","WBGene00007939","X",11207250,11208994,1744
"6013","WBGene00007941","X",11210107,11215470,5363
"6014","WBGene00007942","X",11215696,11218305,2609
"6015","WBGene00007943","X",11218135,11222811,4676
"6016","WBGene00007944","X",11229213,11237383,8170
"6017","WBGene00007945","X",11202476,11203990,1514
"6018","WBGene00007946","V",10493406,10496477,3071
"6019","WBGene00007947","V",10499355,10501395,2040
"6020","WBGene00007948","V",10497059,10499324,2265
"6021","WBGene00007949","V",10505850,10507829,1979
"6022","WBGene00007950","V",10509055,10510451,1396
"6023","WBGene00007951","V",10510684,10514371,3687
"6024","WBGene00007952","V",10521992,10525908,3916
"6025","WBGene00007953","V",10526298,10528396,2098
"6026","WBGene00007954","X",11537714,11541417,3703
"6027","WBGene00007955","X",11545091,11546495,1404
"6028","WBGene00007956","X",11563923,11569531,5608
"6029","WBGene00007957","X",11534004,11536574,2570
"6030","WBGene00007958","X",11536568,11537124,556
"6031","WBGene00007959","X",11554795,11559858,5063
"6032","WBGene00007960","IV",16347168,16347430,262
"6033","WBGene00007961","IV",16350990,16351601,611
"6034","WBGene00007962","IV",16366996,16368943,1947
"6035","WBGene00007963","III",3832591,3834522,1931
"6036","WBGene00007964","III",3835221,3837211,1990
"6037","WBGene00007965","III",3841262,3843614,2352
"6038","WBGene00007966","III",3844893,3848341,3448
"6039","WBGene00007967","III",3849907,3852076,2169
"6040","WBGene00007969","III",3864036,3867098,3062
"6041","WBGene00007970","III",3829830,3830235,405
"6042","WBGene00007971","I",8728687,8730054,1367
"6043","WBGene00007972","I",8733413,8735717,2304
"6044","WBGene00007973","I",8732219,8733436,1217
"6045","WBGene00007974","I",8736213,8737038,825
"6046","WBGene00007975","I",8737072,8742548,5476
"6047","WBGene00007976","I",8743849,8746925,3076
"6048","WBGene00007977","I",8749616,8751397,1781
"6049","WBGene00007978","I",8755846,8757603,1757
"6050","WBGene00007979","I",8752236,8755678,3442
"6051","WBGene00007980","III",3999286,4004143,4857
"6052","WBGene00007981","III",3989298,3992174,2876
"6053","WBGene00007982","III",4006142,4009960,3818
"6054","WBGene00007983","III",4012336,4015763,3427
"6055","WBGene00007984","I",9536465,9540966,4501
"6056","WBGene00007985","I",9544733,9558096,13363
"6057","WBGene00007986","I",9574762,9576141,1379
"6058","WBGene00007987","IV",12743039,12744813,1774
"6059","WBGene00007988","I",14158506,14161718,3212
"6060","WBGene00007989","I",14155470,14156316,846
"6061","WBGene00007990","I",14153270,14154168,898
"6062","WBGene00007991","I",14163447,14168309,4862
"6063","WBGene00007992","I",14157611,14158076,465
"6064","WBGene00007993","X",14170864,14174063,3199
"6065","WBGene00007994","X",14176050,14178608,2558
"6066","WBGene00007995","X",14180451,14181705,1254
"6067","WBGene00007996","II",14633123,14634657,1534
"6068","WBGene00007997","II",14634656,14636837,2181
"6069","WBGene00007998","II",14630553,14632636,2083
"6070","WBGene00007999","II",14627630,14630121,2491
"6071","WBGene00008000","III",9387601,9390107,2506
"6072","WBGene00008001","III",9384172,9385643,1471
"6073","WBGene00008002","III",9400645,9401136,491
"6074","WBGene00008003","III",4783194,4785290,2096
"6075","WBGene00008005","III",4793086,4795423,2337
"6076","WBGene00008006","III",4796839,4802907,6068
"6077","WBGene00008007","III",4810031,4811162,1131
"6078","WBGene00008008","III",4803007,4804753,1746
"6079","WBGene00008009","V",17563171,17566003,2832
"6080","WBGene00008010","V",17567513,17571603,4090
"6081","WBGene00008012","V",17584793,17585876,1083
"6082","WBGene00008013","V",17586852,17591975,5123
"6083","WBGene00008014","V",17559271,17561612,2341
"6084","WBGene00008015","V",17555854,17558477,2623
"6085","WBGene00008016","V",17551506,17552816,1310
"6086","WBGene00008017","V",17549675,17551196,1521
"6087","WBGene00008018","III",10364951,10373231,8280
"6088","WBGene00008019","III",10381740,10385335,3595
"6089","WBGene00008020","III",10385313,10386572,1259
"6090","WBGene00008021","X",10460546,10463580,3034
"6091","WBGene00008022","X",10454309,10460341,6032
"6092","WBGene00008023","X",10444169,10444674,505
"6093","WBGene00008024","X",10445005,10445439,434
"6094","WBGene00008025","X",10447351,10447755,404
"6095","WBGene00008026","IV",13061774,13063205,1431
"6096","WBGene00008027","IV",13064003,13065159,1156
"6097","WBGene00008028","IV",13068751,13070290,1539
"6098","WBGene00008029","IV",13070479,13071221,742
"6099","WBGene00008030","IV",13071754,13072478,724
"6100","WBGene00008031","IV",13072660,13076720,4060
"6101","WBGene00008032","IV",13079446,13082781,3335
"6102","WBGene00008033","IV",13087005,13089619,2614
"6103","WBGene00008034","IV",13091187,13093853,2666
"6104","WBGene00008035","IV",13094007,13095490,1483
"6105","WBGene00008036","X",13647605,13648261,656
"6106","WBGene00008037","X",13651149,13651844,695
"6107","WBGene00008038","III",9318044,9319271,1227
"6108","WBGene00008039","III",9327307,9329366,2059
"6109","WBGene00008040","III",9330316,9330928,612
"6110","WBGene00008041","III",9331514,9332284,770
"6111","WBGene00008042","III",9325048,9327031,1983
"6112","WBGene00008043","III",9314714,9317365,2651
"6113","WBGene00008044","III",9320040,9321663,1623
"6114","WBGene00008045","X",11754776,11756762,1986
"6115","WBGene00008047","X",11759198,11764535,5337
"6116","WBGene00008048","X",11775190,11775728,538
"6117","WBGene00008049","X",11746076,11747249,1173
"6118","WBGene00008050","II",8105614,8106967,1353
"6119","WBGene00008051","II",8108941,8112163,3222
"6120","WBGene00008052","II",8134765,8136916,2151
"6121","WBGene00008053","II",8137880,8141276,3396
"6122","WBGene00008054","II",8107645,8108954,1309
"6123","WBGene00008055","V",15228092,15230075,1983
"6124","WBGene00008056","V",15233894,15235761,1867
"6125","WBGene00008057","V",15221682,15223114,1432
"6126","WBGene00008059","V",15208422,15209332,910
"6127","WBGene00008061","I",9517026,9518736,1710
"6128","WBGene00008062","I",9519244,9521275,2031
"6129","WBGene00008063","I",9526540,9527441,901
"6130","WBGene00008064","I",9533580,9536271,2691
"6131","WBGene00008065","X",9690745,9696718,5973
"6132","WBGene00008066","V",19329563,19330747,1184
"6133","WBGene00008067","V",19321901,19322487,586
"6134","WBGene00008068","V",19320624,19321203,579
"6135","WBGene00008069","V",19319033,19319460,427
"6136","WBGene00008070","V",19310583,19311058,475
"6137","WBGene00008071","V",19313275,19316512,3237
"6138","WBGene00008072","IV",10587553,10589147,1594
"6139","WBGene00008073","IV",10589294,10590749,1455
"6140","WBGene00008074","IV",10590925,10593042,2117
"6141","WBGene00008075","IV",10593068,10593575,507
"6142","WBGene00008076","IV",10578667,10581786,3119
"6143","WBGene00008077","IV",10584537,10587400,2863
"6144","WBGene00008078","III",10869193,10874528,5335
"6145","WBGene00008079","III",10875459,10878061,2602
"6146","WBGene00008080","III",10878191,10880183,1992
"6147","WBGene00008081","III",10882345,10893672,11327
"6148","WBGene00008082","III",10896363,10901836,5473
"6149","WBGene00008083","X",11704888,11707238,2350
"6150","WBGene00008084","X",11702525,11704500,1975
"6151","WBGene00008085","X",11693464,11695750,2286
"6152","WBGene00008086","X",11691109,11692456,1347
"6153","WBGene00008087","X",11698384,11699098,714
"6154","WBGene00008088","X",11687000,11688269,1269
"6155","WBGene00008089","X",11713240,11716511,3271
"6156","WBGene00008090","X",11690314,11690789,475
"6157","WBGene00008091","III",3760378,3765556,5178
"6158","WBGene00008092","III",3768500,3770321,1821
"6159","WBGene00008093","X",14572719,14576102,3383
"6160","WBGene00008094","X",14568854,14589101,20247
"6161","WBGene00008095","X",14596476,14599158,2682
"6162","WBGene00008096","X",14595125,14595944,819
"6163","WBGene00008097","V",12827770,12830109,2339
"6164","WBGene00008098","V",12830804,12834438,3634
"6165","WBGene00008099","V",12835708,12839783,4075
"6166","WBGene00008100","V",12846721,12849864,3143
"6167","WBGene00008101","V",12842494,12845330,2836
"6168","WBGene00008102","V",12853015,12854839,1824
"6169","WBGene00008105","V",11042817,11043855,1038
"6170","WBGene00008106","V",11041824,11042301,477
"6171","WBGene00008107","I",9221834,9226390,4556
"6172","WBGene00008110","IV",9216952,9220397,3445
"6173","WBGene00008111","IV",9225125,9227781,2656
"6174","WBGene00008112","IV",9186815,9191122,4307
"6175","WBGene00008113","IV",9191639,9192622,983
"6176","WBGene00008114","IV",9212375,9214236,1861
"6177","WBGene00008117","III",3650905,3652973,2068
"6178","WBGene00008118","III",3648792,3650832,2040
"6179","WBGene00008119","III",3657716,3664494,6778
"6180","WBGene00008120","III",3652866,3657602,4736
"6181","WBGene00008121","III",3667022,3670436,3414
"6182","WBGene00008122","IV",13715906,13716379,473
"6183","WBGene00008123","IV",13726930,13732829,5899
"6184","WBGene00008124","IV",13740951,13742344,1393
"6185","WBGene00008125","IV",13745709,13745967,258
"6186","WBGene00008126","V",17769653,17773208,3555
"6187","WBGene00008127","V",17774187,17777227,3040
"6188","WBGene00008128","V",17780448,17783639,3191
"6189","WBGene00008129","V",17777924,17779487,1563
"6190","WBGene00008130","I",12960313,12961606,1293
"6191","WBGene00008131","I",12962042,12964579,2537
"6192","WBGene00008132","I",12975183,12978749,3566
"6193","WBGene00008133","I",12978839,12982452,3613
"6194","WBGene00008134","I",12983004,12983974,970
"6195","WBGene00008136","II",11676306,11679197,2891
"6196","WBGene00008137","II",11679091,11681068,1977
"6197","WBGene00008138","II",11681825,11682881,1056
"6198","WBGene00008139","II",11683479,11685289,1810
"6199","WBGene00008140","II",11696171,11705371,9200
"6200","WBGene00008141","V",14666005,14667158,1153
"6201","WBGene00008142","V",14680314,14683751,3437
"6202","WBGene00008143","V",14683706,14685528,1822
"6203","WBGene00008144","V",14689154,14691861,2707
"6204","WBGene00008145","V",14698957,14707601,8644
"6205","WBGene00008146","V",14663306,14665927,2621
"6206","WBGene00008147","IV",10001972,10003534,1562
"6207","WBGene00008148","IV",9999047,10001846,2799
"6208","WBGene00008149","IV",9995472,9999032,3560
"6209","WBGene00008150","IV",9983195,9989678,6483
"6210","WBGene00008151","IV",9980724,9982276,1552
"6211","WBGene00008152","IV",9974672,9975484,812
"6212","WBGene00008153","IV",9972800,9973984,1184
"6213","WBGene00008154","IV",9969400,9971200,1800
"6214","WBGene00008155","IV",9972037,9972652,615
"6215","WBGene00008156","IV",10005570,10006892,1322
"6216","WBGene00008157","I",12335035,12336605,1570
"6217","WBGene00008158","I",12331085,12333413,2328
"6218","WBGene00008159","I",12315193,12316688,1495
"6219","WBGene00008160","I",12317321,12318735,1414
"6220","WBGene00008161","I",12321937,12324062,2125
"6221","WBGene00008162","I",12319350,12320854,1504
"6222","WBGene00008163","I",12326441,12327030,589
"6223","WBGene00008164","II",11288690,11290159,1469
"6224","WBGene00008165","II",11290843,11293606,2763
"6225","WBGene00008166","II",11297700,11301254,3554
"6226","WBGene00008167","III",9586617,9592192,5575
"6227","WBGene00008168","III",9581220,9582361,1141
"6228","WBGene00008169","III",9557448,9558563,1115
"6229","WBGene00008170","III",9558669,9559427,758
"6230","WBGene00008171","III",9559831,9561258,1427
"6231","WBGene00008172","III",9562336,9563335,999
"6232","WBGene00008173","III",9563437,9564510,1073
"6233","WBGene00008174","III",9564605,9566115,1510
"6234","WBGene00008175","III",9597359,9598361,1002
"6235","WBGene00008176","III",9568751,9570460,1709
"6236","WBGene00008177","IV",13193563,13197382,3819
"6237","WBGene00008178","IV",13221961,13232974,11013
"6238","WBGene00008179","II",11334013,11334084,71
"6239","WBGene00008180","III",3578716,3581736,3020
"6240","WBGene00008183","V",14784167,14815659,31492
"6241","WBGene00008184","I",14213681,14215790,2109
"6242","WBGene00008185","I",14209215,14212501,3286
"6243","WBGene00008186","I",14216756,14220624,3868
"6244","WBGene00008187","I",14237359,14241188,3829
"6245","WBGene00008188","I",14246228,14247314,1086
"6246","WBGene00008190","I",14233035,14235948,2913
"6247","WBGene00008191","I",14241898,14244452,2554
"6248","WBGene00008192","IV",17316710,17318246,1536
"6249","WBGene00008193","IV",17319353,17320027,674
"6250","WBGene00008194","IV",17320795,17328662,7867
"6251","WBGene00008195","IV",17329192,17330737,1545
"6252","WBGene00008196","IV",17331527,17332447,920
"6253","WBGene00008197","IV",17332573,17333645,1072
"6254","WBGene00008198","IV",17335203,17336681,1478
"6255","WBGene00008199","IV",17339640,17342314,2674
"6256","WBGene00008200","IV",17336800,17338984,2184
"6257","WBGene00008201","IV",17343782,17344805,1023
"6258","WBGene00008202","IV",17345568,17346695,1127
"6259","WBGene00008203","IV",17347168,17351076,3908
"6260","WBGene00008204","IV",17334193,17335094,901
"6261","WBGene00008205","X",11965962,11969784,3822
"6262","WBGene00008206","X",11970030,11974679,4649
"6263","WBGene00008207","X",11982791,11983899,1108
"6264","WBGene00008208","X",11980209,11982045,1836
"6265","WBGene00008209","X",11985880,11987229,1349
"6266","WBGene00008210","X",11988314,11991292,2978
"6267","WBGene00008211","X",11994766,11995839,1073
"6268","WBGene00008212","X",11960145,11961509,1364
"6269","WBGene00008213","X",13361201,13365294,4093
"6270","WBGene00008214","X",13371612,13376793,5181
"6271","WBGene00008215","X",13386057,13387547,1490
"6272","WBGene00008216","I",12564356,12565893,1537
"6273","WBGene00008217","V",13308916,13309423,507
"6274","WBGene00008218","V",13310186,13312260,2074
"6275","WBGene00008219","V",13313575,13315812,2237
"6276","WBGene00008220","V",13322369,13324979,2610
"6277","WBGene00008221","V",13331117,13333871,2754
"6278","WBGene00008222","V",13336369,13337957,1588
"6279","WBGene00008223","V",13340240,13343040,2800
"6280","WBGene00008224","V",13565863,13566968,1105
"6281","WBGene00008225","V",13566931,13568657,1726
"6282","WBGene00008226","V",13572037,13573423,1386
"6283","WBGene00008227","V",13580993,13584643,3650
"6284","WBGene00008228","V",13578972,13580807,1835
"6285","WBGene00008229","V",9526698,9529259,2561
"6286","WBGene00008230","V",9531819,9534537,2718
"6287","WBGene00008231","V",9534926,9536404,1478
"6288","WBGene00008232","V",9536771,9537769,998
"6289","WBGene00008233","V",9517519,9518933,1414
"6290","WBGene00008234","V",9523167,9524199,1032
"6291","WBGene00008235","V",9529951,9531577,1626
"6292","WBGene00008236","V",9537672,9539738,2066
"6293","WBGene00008237","V",9547606,9549836,2230
"6294","WBGene00008238","V",9539844,9541606,1762
"6295","WBGene00008239","V",9889839,9894849,5010
"6296","WBGene00008240","V",9916975,9919167,2192
"6297","WBGene00008241","V",9918770,9919790,1020
"6298","WBGene00008242","V",9921337,9922194,857
"6299","WBGene00008243","V",9923285,9923936,651
"6300","WBGene00008244","V",9905854,9906215,361
"6301","WBGene00008245","V",9914163,9914529,366
"6302","WBGene00008246","V",9926544,9927884,1340
"6303","WBGene00008247","V",10149093,10150383,1290
"6304","WBGene00008248","V",10150066,10152159,2093
"6305","WBGene00008249","V",10152583,10154756,2173
"6306","WBGene00008250","V",10154998,10156381,1383
"6307","WBGene00008251","V",10158833,10160297,1464
"6308","WBGene00008252","V",10164135,10166463,2328
"6309","WBGene00008253","V",10144408,10145251,843
"6310","WBGene00008254","V",10145905,10148977,3072
"6311","WBGene00008255","V",10160439,10161161,722
"6312","WBGene00008256","II",10729804,10731627,1823
"6313","WBGene00008257","II",10737402,10738628,1226
"6314","WBGene00008258","V",11982901,11985587,2686
"6315","WBGene00008259","V",11994295,11995858,1563
"6316","WBGene00008260","X",12843311,12845384,2073
"6317","WBGene00008261","X",12845811,12846143,332
"6318","WBGene00008262","V",14523329,14524129,800
"6319","WBGene00008263","V",14522810,14523177,367
"6320","WBGene00008265","V",14531115,14542893,11778
"6321","WBGene00008266","V",14543588,14545866,2278
"6322","WBGene00008267","V",14557038,14558866,1828
"6323","WBGene00008268","V",14559612,14561293,1681
"6324","WBGene00008269","V",14562889,14564639,1750
"6325","WBGene00008270","V",14546873,14554546,7673
"6326","WBGene00008271","IV",8968290,8970565,2275
"6327","WBGene00008272","IV",8966183,8967903,1720
"6328","WBGene00008273","IV",8970868,8973707,2839
"6329","WBGene00008274","IV",8975532,8984706,9174
"6330","WBGene00008275","IV",8984866,8986774,1908
"6331","WBGene00008277","IV",8993086,9000774,7688
"6332","WBGene00008278","X",13018848,13022023,3175
"6333","WBGene00008279","X",13048558,13050885,2327
"6334","WBGene00008280","IV",9016788,9019101,2313
"6335","WBGene00008281","IV",9019175,9020940,1765
"6336","WBGene00008282","IV",9024738,9027598,2860
"6337","WBGene00008283","IV",9027686,9032659,4973
"6338","WBGene00008284","IV",9034845,9037163,2318
"6339","WBGene00008285","IV",9001145,9002734,1589
"6340","WBGene00008286","III",3553649,3556627,2978
"6341","WBGene00008287","III",3549410,3549850,440
"6342","WBGene00008288","III",3534660,3537496,2836
"6343","WBGene00008289","I",12442299,12443728,1429
"6344","WBGene00008290","I",12444587,12446502,1915
"6345","WBGene00008291","I",12447167,12448421,1254
"6346","WBGene00008292","I",12449977,12452027,2050
"6347","WBGene00008293","I",12453389,12454764,1375
"6348","WBGene00008294","I",12459499,12460903,1404
"6349","WBGene00008295","I",12461645,12461925,280
"6350","WBGene00008296","V",12414640,12415709,1069
"6351","WBGene00008297","V",12416358,12417377,1019
"6352","WBGene00008298","V",12418592,12419428,836
"6353","WBGene00008299","V",12419492,12420944,1452
"6354","WBGene00008300","V",12429357,12431196,1839
"6355","WBGene00008301","V",12441806,12443835,2029
"6356","WBGene00008302","V",12445184,12446956,1772
"6357","WBGene00008303","V",12447499,12448661,1162
"6358","WBGene00008304","V",12448685,12450002,1317
"6359","WBGene00008306","V",18815036,18818593,3557
"6360","WBGene00008307","V",18819766,18831422,11656
"6361","WBGene00008308","V",18811005,18813481,2476
"6362","WBGene00008309","V",18796106,18800822,4716
"6363","WBGene00008310","V",18808069,18808670,601
"6364","WBGene00008311","I",8014412,8019572,5160
"6365","WBGene00008312","I",8006650,8009118,2468
"6366","WBGene00008313","I",8005127,8006448,1321
"6367","WBGene00008314","I",7996728,8003179,6451
"6368","WBGene00008315","I",7995738,7996669,931
"6369","WBGene00008316","I",8019578,8020901,1323
"6370","WBGene00008317","I",8019501,8022730,3229
"6371","WBGene00008318","I",8024880,8026525,1645
"6372","WBGene00008319","V",14641101,14641382,281
"6373","WBGene00008320","V",14653491,14658174,4683
"6374","WBGene00008321","V",15621818,15623077,1259
"6375","WBGene00008322","V",15642639,15643491,852
"6376","WBGene00008323","V",15648102,15648848,746
"6377","WBGene00008324","V",15646983,15647809,826
"6378","WBGene00008325","V",15626452,15627326,874
"6379","WBGene00008326","V",15625861,15626223,362
"6380","WBGene00008327","V",15637416,15638953,1537
"6381","WBGene00008328","V",15635563,15637240,1677
"6382","WBGene00008330","V",11503811,11504884,1073
"6383","WBGene00008331","V",11509068,11512318,3250
"6384","WBGene00008332","V",11512313,11513436,1123
"6385","WBGene00008333","V",11516445,11517889,1444
"6386","WBGene00008334","V",11515084,11516191,1107
"6387","WBGene00008335","V",11513665,11514737,1072
"6388","WBGene00008336","V",11519335,11520530,1195
"6389","WBGene00008337","V",11518100,11518702,602
"6390","WBGene00008338","V",11521653,11523384,1731
"6391","WBGene00008339","V",11505352,11508271,2919
"6392","WBGene00008340","V",11520515,11521554,1039
"6393","WBGene00008341","V",13529562,13530744,1182
"6394","WBGene00008342","V",13531743,13536105,4362
"6395","WBGene00008343","V",13550520,13551810,1290
"6396","WBGene00008344","V",13551911,13553373,1462
"6397","WBGene00008345","V",13553374,13556408,3034
"6398","WBGene00008346","V",13560278,13561992,1714
"6399","WBGene00008348","III",3389894,3392525,2631
"6400","WBGene00008349","X",261,7587,7326
"6401","WBGene00008350","X",7582,9933,2351
"6402","WBGene00008351","X",1316,1935,619
"6403","WBGene00008352","III",1271,3092,1821
"6404","WBGene00008353","X",14520763,14522705,1942
"6405","WBGene00008354","X",14514136,14515073,937
"6406","WBGene00008355","X",14511248,14512912,1664
"6407","WBGene00008356","X",14529788,14530214,426
"6408","WBGene00008357","X",14523575,14523997,422
"6409","WBGene00008358","X",14527173,14527569,396
"6410","WBGene00008359","X",14524758,14525181,423
"6411","WBGene00008360","X",14528717,14529074,357
"6412","WBGene00008361","II",11582849,11588536,5687
"6413","WBGene00008362","IV",8926335,8930315,3980
"6414","WBGene00008363","IV",8924161,8926112,1951
"6415","WBGene00008364","IV",8930442,8932791,2349
"6416","WBGene00008365","IV",8933997,8937400,3403
"6417","WBGene00008366","IV",8956489,8965534,9045
"6418","WBGene00008367","X",11728151,11728891,740
"6419","WBGene00008368","X",11729586,11733698,4112
"6420","WBGene00008369","X",11721724,11724195,2471
"6421","WBGene00008370","V",10768465,10770217,1752
"6422","WBGene00008371","V",10771451,10772832,1381
"6423","WBGene00008372","V",10772819,10776578,3759
"6424","WBGene00008373","V",10778475,10780019,1544
"6425","WBGene00008374","V",10781459,10783380,1921
"6426","WBGene00008375","V",10784236,10785367,1131
"6427","WBGene00008376","V",10785801,10791057,5256
"6428","WBGene00008377","V",10791975,10792830,855
"6429","WBGene00008378","V",10793793,10794924,1131
"6430","WBGene00008379","V",10802336,10804474,2138
"6431","WBGene00008380","V",10804721,10806034,1313
"6432","WBGene00008381","I",8463356,8469309,5953
"6433","WBGene00008382","I",8474886,8476282,1396
"6434","WBGene00008383","I",8481152,8482538,1386
"6435","WBGene00008384","I",8482759,8485694,2935
"6436","WBGene00008385","I",8487618,8490938,3320
"6437","WBGene00008386","I",8491291,8495855,4564
"6438","WBGene00008387","I",8485876,8487043,1167
"6439","WBGene00008388","V",14098858,14100390,1532
"6440","WBGene00008389","V",14097038,14098668,1630
"6441","WBGene00008390","V",14092792,14093986,1194
"6442","WBGene00008392","V",14088893,14090359,1466
"6443","WBGene00008393","V",14079801,14081766,1965
"6444","WBGene00008394","V",14084270,14085811,1541
"6445","WBGene00008395","V",14094105,14097088,2983
"6446","WBGene00008396","V",14104270,14106416,2146
"6447","WBGene00008397","I",7784498,7785624,1126
"6448","WBGene00008398","I",7813761,7815042,1281
"6449","WBGene00008399","I",7814972,7819410,4438
"6450","WBGene00008400","I",7820831,7826433,5602
"6451","WBGene00008401","I",7786205,7793539,7334
"6452","WBGene00008402","II",9319865,9321888,2023
"6453","WBGene00008403","II",9317551,9319627,2076
"6454","WBGene00008404","II",9329757,9331510,1753
"6455","WBGene00008405","II",9338890,9341394,2504
"6456","WBGene00008407","V",11802105,11811943,9838
"6457","WBGene00008408","V",11825033,11825762,729
"6458","WBGene00008409","V",11825897,11827067,1170
"6459","WBGene00008410","V",11827306,11829370,2064
"6460","WBGene00008411","I",7567775,7571250,3475
"6461","WBGene00008412","I",7574195,7578564,4369
"6462","WBGene00008413","I",7578512,7580833,2321
"6463","WBGene00008414","I",7580944,7581628,684
"6464","WBGene00008415","I",7582106,7583349,1243
"6465","WBGene00008417","I",7588580,7590565,1985
"6466","WBGene00008418","I",7591288,7595198,3910
"6467","WBGene00008419","I",7596507,7602203,5696
"6468","WBGene00008420","I",7590543,7591204,661
"6469","WBGene00008421","I",7583810,7585340,1530
"6470","WBGene00008422","III",10452719,10460551,7832
"6471","WBGene00008423","III",10468107,10469503,1396
"6472","WBGene00008424","III",10479807,10482285,2478
"6473","WBGene00008425","III",10482288,10483926,1638
"6474","WBGene00008426","III",10475245,10479758,4513
"6475","WBGene00008427","II",8659135,8659800,665
"6476","WBGene00008428","II",8661869,8664721,2852
"6477","WBGene00008429","II",8664833,8669154,4321
"6478","WBGene00008430","II",8669133,8684897,15764
"6479","WBGene00008431","II",8659782,8661712,1930
"6480","WBGene00008432","II",8641381,8648227,6846
"6481","WBGene00008433","II",10660225,10660959,734
"6482","WBGene00008434","II",10663605,10665131,1526
"6483","WBGene00008435","II",8008619,8011633,3014
"6484","WBGene00008436","II",8012816,8015264,2448
"6485","WBGene00008438","II",7976614,7994206,17592
"6486","WBGene00008439","I",8779731,8785415,5684
"6487","WBGene00008440","I",8758156,8759032,876
"6488","WBGene00008441","V",17924916,17934225,9309
"6489","WBGene00008442","V",17921776,17924185,2409
"6490","WBGene00008443","II",14919705,14953312,33607
"6491","WBGene00008444","II",13437579,13447593,10014
"6492","WBGene00008446","II",13460991,13469602,8611
"6493","WBGene00008447","II",13472401,13473995,1594
"6494","WBGene00008448","II",13482405,13485780,3375
"6495","WBGene00008449","X",12260881,12266537,5656
"6496","WBGene00008450","X",12256644,12258971,2327
"6497","WBGene00008451","X",12241627,12244637,3010
"6498","WBGene00008452","V",12563487,12565785,2298
"6499","WBGene00008453","V",12579674,12587991,8317
"6500","WBGene00008454","V",12566016,12567951,1935
"6501","WBGene00008455","II",9589865,9591221,1356
"6502","WBGene00008456","II",9588212,9589767,1555
"6503","WBGene00008457","II",9595224,9596598,1374
"6504","WBGene00008458","II",9596701,9597528,827
"6505","WBGene00008459","II",9597622,9598201,579
"6506","WBGene00008460","X",14277364,14281599,4235
"6507","WBGene00008462","X",14257969,14262435,4466
"6508","WBGene00008463","X",14253957,14254823,866
"6509","WBGene00008464","X",14250512,14252146,1634
"6510","WBGene00008465","III",4060591,4062822,2231
"6511","WBGene00008468","X",15926549,15928487,1938
"6512","WBGene00008470","I",12403110,12404489,1379
"6513","WBGene00008471","I",12405525,12406946,1421
"6514","WBGene00008472","I",12407564,12411435,3871
"6515","WBGene00008473","I",12413809,12415745,1936
"6516","WBGene00008474","I",12417386,12418800,1414
"6517","WBGene00008475","I",12421239,12424411,3172
"6518","WBGene00008476","I",12424555,12426850,2295
"6519","WBGene00008477","I",12430028,12431500,1472
"6520","WBGene00008478","I",12433061,12434886,1825
"6521","WBGene00008479","I",12435726,12437285,1559
"6522","WBGene00008480","II",10416786,10419237,2451
"6523","WBGene00008481","II",10419230,10422026,2796
"6524","WBGene00008482","II",10436144,10440087,3943
"6525","WBGene00008483","II",10440286,10442515,2229
"6526","WBGene00008484","II",10411289,10412670,1381
"6527","WBGene00008485","IV",10464588,10467240,2652
"6528","WBGene00008486","IV",10469741,10471899,2158
"6529","WBGene00008487","IV",10473637,10475791,2154
"6530","WBGene00008488","IV",10482629,10483655,1026
"6531","WBGene00008489","IV",10454432,10457237,2805
"6532","WBGene00008490","IV",10450802,10453098,2296
"6533","WBGene00008491","IV",10472778,10478168,5390
"6534","WBGene00008492","II",13996958,13997606,648
"6535","WBGene00008493","II",13998497,13999064,567
"6536","WBGene00008494","II",13999059,14000144,1085
"6537","WBGene00008495","II",14001686,14002306,620
"6538","WBGene00008496","II",14006511,14008514,2003
"6539","WBGene00008497","II",14008666,14010583,1917
"6540","WBGene00008498","II",14010706,14013826,3120
"6541","WBGene00008499","II",14013825,14016965,3140
"6542","WBGene00008500","II",14017839,14021330,3491
"6543","WBGene00008501","II",13995401,13995876,475
"6544","WBGene00008502","IV",11135566,11142360,6794
"6545","WBGene00008503","IV",11143345,11145923,2578
"6546","WBGene00008504","IV",11146106,11147247,1141
"6547","WBGene00008505","IV",11146940,11149504,2564
"6548","WBGene00008506","IV",10243591,10245752,2161
"6549","WBGene00008507","IV",10231375,10232552,1177
"6550","WBGene00008508","IV",10227987,10231060,3073
"6551","WBGene00008509","IV",10226334,10227639,1305
"6552","WBGene00008510","IV",10239278,10241859,2581
"6553","WBGene00008511","IV",10255755,10259657,3902
"6554","WBGene00008512","IV",10246160,10249785,3625
"6555","WBGene00008513","III",9075726,9077804,2078
"6556","WBGene00008514","III",9084479,9089373,4894
"6557","WBGene00008515","X",13402083,13406415,4332
"6558","WBGene00008516","X",13398198,13399230,1032
"6559","WBGene00008517","X",13397323,13397710,387
"6560","WBGene00008518","X",13391949,13395149,3200
"6561","WBGene00008519","X",13406674,13409644,2970
"6562","WBGene00008520","V",14972907,14978779,5872
"6563","WBGene00008521","V",14984893,14987571,2678
"6564","WBGene00008522","V",14971436,14972419,983
"6565","WBGene00008523","X",13462668,13463893,1225
"6566","WBGene00008524","X",13456889,13462619,5730
"6567","WBGene00008526","X",13449586,13451678,2092
"6568","WBGene00008527","X",13444980,13448230,3250
"6569","WBGene00008528","I",8406828,8407645,817
"6570","WBGene00008529","I",8404547,8405955,1408
"6571","WBGene00008530","I",8424993,8426093,1100
"6572","WBGene00008531","I",8413253,8416195,2942
"6573","WBGene00008532","I",8429931,8435864,5933
"6574","WBGene00008533","I",8427089,8429832,2743
"6575","WBGene00008534","IV",14199263,14201780,2517
"6576","WBGene00008535","IV",14196440,14198824,2384
"6577","WBGene00008536","IV",14203427,14205357,1930
"6578","WBGene00008537","IV",14207564,14219159,11595
"6579","WBGene00008538","IV",14219871,14224439,4568
"6580","WBGene00008539","IV",14229336,14230899,1563
"6581","WBGene00008540","IV",14225918,14228169,2251
"6582","WBGene00008541","I",7352415,7353701,1286
"6583","WBGene00008542","I",7354491,7357180,2689
"6584","WBGene00008543","I",7357180,7359100,1920
"6585","WBGene00008545","II",11588464,11592060,3596
"6586","WBGene00008546","II",11592392,11596590,4198
"6587","WBGene00008547","II",11603956,11611532,7576
"6588","WBGene00008548","II",11612257,11614391,2134
"6589","WBGene00008549","II",11614636,11633609,18973
"6590","WBGene00008550","V",11261264,11263116,1852
"6591","WBGene00008551","V",11256521,11258996,2475
"6592","WBGene00008552","V",11254013,11255080,1067
"6593","WBGene00008553","IV",12791171,12791685,514
"6594","WBGene00008554","IV",12789041,12790512,1471
"6595","WBGene00008555","IV",12805931,12830112,24181
"6596","WBGene00008556","V",9460686,9462705,2019
"6597","WBGene00008557","II",8791927,8792740,813
"6598","WBGene00008558","II",8792912,8794162,1250
"6599","WBGene00008559","II",8801130,8804889,3759
"6600","WBGene00008560","II",8804835,8807021,2186
"6601","WBGene00008561","II",8807133,8808582,1449
"6602","WBGene00008563","II",8790558,8791318,760
"6603","WBGene00008564","I",12938555,12942224,3669
"6604","WBGene00008565","I",12942280,12946562,4282
"6605","WBGene00008566","I",12946937,12950991,4054
"6606","WBGene00008567","I",12951025,12954015,2990
"6607","WBGene00008568","I",12955328,12957902,2574
"6608","WBGene00008569","I",12958639,12959955,1316
"6609","WBGene00008570","I",8174888,8208740,33852
"6610","WBGene00008571","X",11384773,11392779,8006
"6611","WBGene00008572","X",11407054,11407730,676
"6612","WBGene00008574","V",17476790,17478083,1293
"6613","WBGene00008575","V",17486431,17487205,774
"6614","WBGene00008576","II",13830592,13831213,621
"6615","WBGene00008577","II",13832870,13833653,783
"6616","WBGene00008578","II",13836241,13841139,4898
"6617","WBGene00008579","II",13852311,13855290,2979
"6618","WBGene00008580","IV",12408895,12410468,1573
"6619","WBGene00008581","IV",12410467,12412219,1752
"6620","WBGene00008582","IV",12412923,12417582,4659
"6621","WBGene00008583","IV",12425217,12432533,7316
"6622","WBGene00008584","IV",12435802,12438274,2472
"6623","WBGene00008585","X",11302074,11305873,3799
"6624","WBGene00008586","X",11298036,11299784,1748
"6625","WBGene00008587","X",11300283,11302094,1811
"6626","WBGene00008588","X",11308864,11310285,1421
"6627","WBGene00008589","X",11317050,11318036,986
"6628","WBGene00008590","V",14460624,14461132,508
"6629","WBGene00008591","V",14461943,14462809,866
"6630","WBGene00008592","V",14463588,14464428,840
"6631","WBGene00008593","V",14472529,14474374,1845
"6632","WBGene00008594","V",14469191,14472448,3257
"6633","WBGene00008595","V",14474399,14476794,2395
"6634","WBGene00008596","V",14476903,14479003,2100
"6635","WBGene00008597","V",14479284,14482195,2911
"6636","WBGene00008598","X",13130263,13134124,3861
"6637","WBGene00008599","X",13135107,13139771,4664
"6638","WBGene00008600","X",13141601,13152474,10873
"6639","WBGene00008601","X",13152821,13170113,17292
"6640","WBGene00008602","X",10139374,10142013,2639
"6641","WBGene00008603","X",10160631,10161809,1178
"6642","WBGene00008604","X",10154821,10156856,2035
"6643","WBGene00008605","X",15101787,15107967,6180
"6644","WBGene00008606","X",15098066,15100416,2350
"6645","WBGene00008607","X",15095343,15097954,2611
"6646","WBGene00008609","X",15084749,15088135,3386
"6647","WBGene00008610","I",14271893,14274213,2320
"6648","WBGene00008611","I",14285937,14287077,1140
"6649","WBGene00008612","I",14287872,14295898,8026
"6650","WBGene00008613","I",14283464,14285319,1855
"6651","WBGene00008615","V",16887413,16888479,1066
"6652","WBGene00008616","V",16889275,16890749,1474
"6653","WBGene00008617","V",16878724,16880154,1430
"6654","WBGene00008618","V",16898457,16899455,998
"6655","WBGene00008619","V",16904912,16906787,1875
"6656","WBGene00008620","V",16915373,16916179,806
"6657","WBGene00008621","X",16159648,16163548,3900
"6658","WBGene00008622","X",16140507,16147022,6515
"6659","WBGene00008623","IV",13138991,13142354,3363
"6660","WBGene00008624","IV",13150552,13154441,3889
"6661","WBGene00008625","IV",13165516,13166815,1299
"6662","WBGene00008626","IV",13149576,13150569,993
"6663","WBGene00008627","V",13850470,13853199,2729
"6664","WBGene00008628","V",13853834,13855260,1426
"6665","WBGene00008629","V",13873153,13875891,2738
"6666","WBGene00008630","V",13866706,13868473,1767
"6667","WBGene00008631","V",16140314,16141164,850
"6668","WBGene00008632","V",16142008,16143116,1108
"6669","WBGene00008633","V",16143615,16144653,1038
"6670","WBGene00008634","V",16149125,16151870,2745
"6671","WBGene00008635","V",16155451,16156722,1271
"6672","WBGene00008636","V",16162685,16163795,1110
"6673","WBGene00008637","V",16164019,16165473,1454
"6674","WBGene00008638","V",16144986,16145869,883
"6675","WBGene00008639","II",8144762,8147236,2474
"6676","WBGene00008640","II",8147190,8150030,2840
"6677","WBGene00008641","II",8158349,8159925,1576
"6678","WBGene00008642","II",8141213,8143478,2265
"6679","WBGene00008643","II",8157362,8158045,683
"6680","WBGene00008644","V",12021164,12023600,2436
"6681","WBGene00008645","V",12041556,12045347,3791
"6682","WBGene00008646","V",12045432,12048631,3199
"6683","WBGene00008647","V",12053952,12056320,2368
"6684","WBGene00008648","I",8435958,8438638,2680
"6685","WBGene00008649","I",8439971,8440488,517
"6686","WBGene00008650","I",8441543,8442452,909
"6687","WBGene00008651","I",8442695,8444934,2239
"6688","WBGene00008652","I",8445351,8451023,5672
"6689","WBGene00008654","III",4618853,4643305,24452
"6690","WBGene00008655","III",4616479,4618893,2414
"6691","WBGene00008656","III",4623052,4626158,3106
"6692","WBGene00008657","III",4638328,4640562,2234
"6693","WBGene00008658","III",4632407,4634428,2021
"6694","WBGene00008659","III",4628465,4631131,2666
"6695","WBGene00008660","III",4635330,4637490,2160
"6696","WBGene00008661","I",10019643,10021069,1426
"6697","WBGene00008662","I",10021702,10022872,1170
"6698","WBGene00008663","I",10023810,10025831,2021
"6699","WBGene00008664","I",10046442,10048028,1586
"6700","WBGene00008665","I",10030174,10046760,16586
"6701","WBGene00008666","I",10050691,10062026,11335
"6702","WBGene00008667","I",10048087,10050770,2683
"6703","WBGene00008668","X",10656598,10659576,2978
"6704","WBGene00008669","V",9508079,9510476,2397
"6705","WBGene00008670","V",9513824,9517585,3761
"6706","WBGene00008671","V",16194939,16195544,605
"6707","WBGene00008672","V",16195679,16196290,611
"6708","WBGene00008673","V",16198379,16201045,2666
"6709","WBGene00008675","V",16205188,16206818,1630
"6710","WBGene00008676","V",16206943,16209916,2973
"6711","WBGene00008677","V",16214890,16217706,2816
"6712","WBGene00008678","V",16224327,16225540,1213
"6713","WBGene00008679","V",16226013,16226681,668
"6714","WBGene00008680","V",16217701,16218605,904
"6715","WBGene00008681","I",11680913,11682441,1528
"6716","WBGene00008682","IV",12079463,12084362,4899
"6717","WBGene00008683","IV",12084478,12085320,842
"6718","WBGene00008684","IV",12089247,12092213,2966
"6719","WBGene00008685","IV",12096779,12105762,8983
"6720","WBGene00008686","IV",12094372,12096692,2320
"6721","WBGene00008687","IV",12087017,12089095,2078
"6722","WBGene00008688","IV",12085423,12087060,1637
"6723","WBGene00008690","X",12987334,12990365,3031
"6724","WBGene00008691","X",12985790,12987219,1429
"6725","WBGene00008692","X",12981775,12985852,4077
"6726","WBGene00008693","X",12978505,12979854,1349
"6727","WBGene00008694","X",12991447,12999638,8191
"6728","WBGene00008695","I",14867924,14871467,3543
"6729","WBGene00008696","V",18769767,18770723,956
"6730","WBGene00008698","V",18757982,18760285,2303
"6731","WBGene00008699","V",18761378,18761613,235
"6732","WBGene00008700","V",18753500,18754428,928
"6733","WBGene00008701","V",18752482,18753136,654
"6734","WBGene00008702","V",18747943,18748826,883
"6735","WBGene00008703","V",18745718,18746987,1269
"6736","WBGene00008706","IV",17473334,17479397,6063
"6737","WBGene00008707","IV",17470510,17472025,1515
"6738","WBGene00008708","IV",17469347,17470387,1040
"6739","WBGene00008709","IV",17464451,17465986,1535
"6740","WBGene00008710","IV",17457834,17461272,3438
"6741","WBGene00008711","IV",17444125,17450543,6418
"6742","WBGene00008712","IV",17474243,17475382,1139
"6743","WBGene00008713","IV",17461909,17463158,1249
"6744","WBGene00008714","III",13395633,13400563,4930
"6745","WBGene00008716","III",13400962,13401773,811
"6746","WBGene00008717","III",13402208,13403036,828
"6747","WBGene00008719","III",13404737,13405645,908
"6748","WBGene00008720","IV",11585224,11588321,3097
"6749","WBGene00008722","IV",11558737,11561891,3154
"6750","WBGene00008723","IV",11554489,11558261,3772
"6751","WBGene00008724","V",16376239,16377949,1710
"6752","WBGene00008725","V",16382167,16383829,1662
"6753","WBGene00008726","V",16394015,16395075,1060
"6754","WBGene00008727","V",16396359,16398502,2143
"6755","WBGene00008728","V",16399688,16401625,1937
"6756","WBGene00008729","IV",10422610,10424635,2025
"6757","WBGene00008730","IV",10426231,10429110,2879
"6758","WBGene00008731","IV",10439123,10443819,4696
"6759","WBGene00008732","IV",10444583,10449899,5316
"6760","WBGene00008733","IV",10414030,10417881,3851
"6761","WBGene00008734","IV",10444094,10444584,490
"6762","WBGene00008735","X",11163958,11189591,25633
"6763","WBGene00008736","X",11178899,11181272,2373
"6764","WBGene00008737","X",11185812,11187520,1708
"6765","WBGene00008739","II",11720444,11722308,1864
"6766","WBGene00008740","II",11726814,11728541,1727
"6767","WBGene00008741","II",11739456,11742876,3420
"6768","WBGene00008742","II",11731165,11732594,1429
"6769","WBGene00008743","II",11707452,11709587,2135
"6770","WBGene00008744","II",11713721,11716811,3090
"6771","WBGene00008745","X",10675706,10677109,1403
"6772","WBGene00008746","X",10668280,10674293,6013
"6773","WBGene00008747","X",10681998,10682963,965
"6774","WBGene00008748","X",10691943,10694461,2518
"6775","WBGene00008749","X",10695312,10697894,2582
"6776","WBGene00008750","IV",10864331,10873632,9301
"6777","WBGene00008751","IV",10877144,10877296,152
"6778","WBGene00008752","IV",10880564,10880716,152
"6779","WBGene00008753","IV",10895225,10896612,1387
"6780","WBGene00008754","IV",10882972,10884363,1391
"6781","WBGene00008755","IV",10877836,10879727,1891
"6782","WBGene00008757","IV",10893648,10894355,707
"6783","WBGene00008758","IV",10897655,10899180,1525
"6784","WBGene00008759","IV",10885238,10886015,777
"6785","WBGene00008760","IV",10865258,10869180,3922
"6786","WBGene00008761","IV",10873673,10874627,954
"6787","WBGene00008762","I",7291272,7293331,2059
"6788","WBGene00008763","I",7296913,7299983,3070
"6789","WBGene00008764","I",7300062,7300913,851
"6790","WBGene00008765","I",7301007,7303227,2220
"6791","WBGene00008766","I",7303300,7304690,1390
"6792","WBGene00008767","I",7304918,7307010,2092
"6793","WBGene00008768","I",7313585,7314277,692
"6794","WBGene00008769","I",7307117,7308626,1509
"6795","WBGene00008770","I",7295753,7297004,1251
"6796","WBGene00008772","IV",14633099,14634405,1306
"6797","WBGene00008773","IV",11004573,11005070,497
"6798","WBGene00008774","IV",11012119,11015883,3764
"6799","WBGene00008775","IV",11016229,11021902,5673
"6800","WBGene00008776","IV",10990999,10994137,3138
"6801","WBGene00008777","IV",11009296,11010103,807
"6802","WBGene00008778","IV",9292296,9293925,1629
"6803","WBGene00008779","I",9265951,9270919,4968
"6804","WBGene00008780","I",9271443,9278689,7246
"6805","WBGene00008781","I",9280963,9286577,5614
"6806","WBGene00008782","I",12216249,12217766,1517
"6807","WBGene00008783","I",12218433,12222298,3865
"6808","WBGene00008784","I",12230418,12232303,1885
"6809","WBGene00008785","I",12236018,12238252,2234
"6810","WBGene00008786","I",12239160,12241808,2648
"6811","WBGene00008787","I",12232689,12235193,2504
"6812","WBGene00008788","V",14288733,14289718,985
"6813","WBGene00008789","V",14291910,14293712,1802
"6814","WBGene00008790","V",14296799,14297222,423
"6815","WBGene00008791","V",14295828,14298132,2304
"6816","WBGene00008792","V",14299180,14299642,462
"6817","WBGene00008793","V",14301413,14306444,5031
"6818","WBGene00008794","V",14306475,14306871,396
"6819","WBGene00008795","V",14311882,14312788,906
"6820","WBGene00008796","V",14294696,14295550,854
"6821","WBGene00008797","V",14308464,14308856,392
"6822","WBGene00008798","V",14310389,14311236,847
"6823","WBGene00008799","II",8417618,8419758,2140
"6824","WBGene00008800","II",8423951,8428855,4904
"6825","WBGene00008801","II",8435347,8437135,1788
"6826","WBGene00008802","II",8429959,8432054,2095
"6827","WBGene00008803","II",8439118,8442151,3033
"6828","WBGene00008804","II",8432773,8435105,2332
"6829","WBGene00008805","X",10524898,10528437,3539
"6830","WBGene00008806","X",10521806,10524565,2759
"6831","WBGene00008807","X",10520817,10521464,647
"6832","WBGene00008808","X",14925031,14928934,3903
"6833","WBGene00008809","III",13021009,13023949,2940
"6834","WBGene00008810","III",13024547,13028012,3465
"6835","WBGene00008811","III",13028393,13029708,1315
"6836","WBGene00008812","III",13032001,13036344,4343
"6837","WBGene00008813","V",16673423,16674690,1267
"6838","WBGene00008814","V",16675853,16677551,1698
"6839","WBGene00008815","V",16677623,16679337,1714
"6840","WBGene00008816","V",16671622,16672186,564
"6841","WBGene00008818","V",16694838,16696592,1754
"6842","WBGene00008819","II",8305745,8321471,15726
"6843","WBGene00008820","II",8294829,8295396,567
"6844","WBGene00008821","V",16049492,16051554,2062
"6845","WBGene00008822","V",16051923,16053510,1587
"6846","WBGene00008823","V",16053900,16055072,1172
"6847","WBGene00008824","V",16055806,16057054,1248
"6848","WBGene00008825","V",16057322,16058892,1570
"6849","WBGene00008826","V",16060526,16062093,1567
"6850","WBGene00008827","V",16064447,16067002,2555
"6851","WBGene00008828","V",16067947,16068763,816
"6852","WBGene00008829","V",16069238,16071301,2063
"6853","WBGene00008830","V",16071325,16072738,1413
"6854","WBGene00008831","V",16074113,16075323,1210
"6855","WBGene00008832","V",15011870,15014222,2352
"6856","WBGene00008833","V",15019224,15020325,1101
"6857","WBGene00008834","V",15023844,15025150,1306
"6858","WBGene00008835","V",15021032,15022049,1017
"6859","WBGene00008837","II",12457575,12459510,1935
"6860","WBGene00008838","II",12462418,12464078,1660
"6861","WBGene00008839","II",12465872,12467519,1647
"6862","WBGene00008840","II",12469374,12471211,1837
"6863","WBGene00008841","II",12471805,12473084,1279
"6864","WBGene00008842","II",12475514,12478917,3403
"6865","WBGene00008843","II",12479590,12480910,1320
"6866","WBGene00008844","II",12484544,12485160,616
"6867","WBGene00008847","II",12482931,12484279,1348
"6868","WBGene00008848","V",13002317,13006987,4670
"6869","WBGene00008849","V",13010282,13013286,3004
"6870","WBGene00008850","V",13014144,13016641,2497
"6871","WBGene00008851","V",12988543,12992185,3642
"6872","WBGene00008852","I",7021946,7029076,7130
"6873","WBGene00008853","I",11560637,11564387,3750
"6874","WBGene00008854","I",11565238,11570803,5565
"6875","WBGene00008855","I",11570886,11571178,292
"6876","WBGene00008856","I",11572121,11577488,5367
"6877","WBGene00008857","I",11578641,11579612,971
"6878","WBGene00008858","I",11579861,11581986,2125
"6879","WBGene00008859","II",13216092,13216764,672
"6880","WBGene00008860","II",13237404,13237907,503
"6881","WBGene00008861","II",13239249,13243121,3872
"6882","WBGene00008862","II",13245348,13247774,2426
"6883","WBGene00008863","II",13249189,13249895,706
"6884","WBGene00008865","X",9706926,9708563,1637
"6885","WBGene00008866","X",9708590,9713713,5123
"6886","WBGene00008868","X",9733072,9737750,4678
"6887","WBGene00008869","X",9709836,9713112,3276
"6888","WBGene00008870","I",12157151,12158712,1561
"6889","WBGene00008871","V",10426633,10428731,2098
"6890","WBGene00008872","V",10417617,10419053,1436
"6891","WBGene00008873","V",10410240,10412149,1909
"6892","WBGene00008874","V",10403184,10406424,3240
"6893","WBGene00008875","V",10401447,10402904,1457
"6894","WBGene00008876","I",9393948,9404024,10076
"6895","WBGene00008877","I",9390829,9393095,2266
"6896","WBGene00008878","I",9364099,9389982,25883
"6897","WBGene00008879","X",14085508,14089581,4073
"6898","WBGene00008880","X",14095738,14098664,2926
"6899","WBGene00008881","X",14099656,14101568,1912
"6900","WBGene00008882","X",14102359,14107905,5546
"6901","WBGene00008883","X",14108545,14109714,1169
"6902","WBGene00008884","X",14111263,14113447,2184
"6903","WBGene00008885","I",10147325,10149888,2563
"6904","WBGene00008886","I",10150280,10155131,4851
"6905","WBGene00008887","I",8363954,8369917,5963
"6906","WBGene00008889","I",8375490,8377565,2075
"6907","WBGene00008890","I",8384931,8387039,2108
"6908","WBGene00008891","V",18191412,18194167,2755
"6909","WBGene00008892","V",18189560,18191047,1487
"6910","WBGene00008893","V",18195306,18197863,2557
"6911","WBGene00008894","V",18198721,18205815,7094
"6912","WBGene00008897","V",18207064,18209171,2107
"6913","WBGene00008899","V",18217084,18222299,5215
"6914","WBGene00008900","V",18222746,18224447,1701
"6915","WBGene00008901","X",12705624,12808249,102625
"6916","WBGene00008902","X",12306865,12308193,1328
"6917","WBGene00008903","X",12310812,12312730,1918
"6918","WBGene00008904","X",12321657,12322993,1336
"6919","WBGene00008905","I",13184852,13188234,3382
"6920","WBGene00008906","I",13191983,13194645,2662
"6921","WBGene00008907","I",13197179,13198374,1195
"6922","WBGene00008908","I",13199359,13200980,1621
"6923","WBGene00008909","I",13204497,13205403,906
"6924","WBGene00008910","III",4731938,4734034,2096
"6925","WBGene00008911","III",4744870,4746025,1155
"6926","WBGene00008912","III",4736050,4737258,1208
"6927","WBGene00008914","V",10948212,10949129,917
"6928","WBGene00008915","V",10951818,10953472,1654
"6929","WBGene00008916","V",10953501,10954434,933
"6930","WBGene00008917","V",10955091,10955952,861
"6931","WBGene00008918","V",10956910,10958821,1911
"6932","WBGene00008919","V",10958928,10960919,1991
"6933","WBGene00008920","V",10965675,10968070,2395
"6934","WBGene00008921","V",10961722,10965562,3840
"6935","WBGene00008922","V",10937633,10938849,1216
"6936","WBGene00008923","V",10934228,10936920,2692
"6937","WBGene00008924","X",12394265,12399534,5269
"6938","WBGene00008925","X",13105184,13108543,3359
"6939","WBGene00008926","X",13113772,13116390,2618
"6940","WBGene00008927","X",13116352,13122291,5939
"6941","WBGene00008928","X",13125976,13126520,544
"6942","WBGene00008929","II",13032778,13036505,3727
"6943","WBGene00008930","II",13036348,13036965,617
"6944","WBGene00008932","II",13009265,13012817,3552
"6945","WBGene00008933","II",13043951,13045975,2024
"6946","WBGene00008934","I",8095740,8098444,2704
"6947","WBGene00008935","I",8060791,8061793,1002
"6948","WBGene00008936","V",12757591,12760227,2636
"6949","WBGene00008937","V",12769268,12770845,1577
"6950","WBGene00008939","X",13519663,13521537,1874
"6951","WBGene00008940","X",13529088,13532032,2944
"6952","WBGene00008941","V",20174988,20182756,7768
"6953","WBGene00008942","V",20172821,20173999,1178
"6954","WBGene00008943","V",20167309,20169283,1974
"6955","WBGene00008944","V",20162649,20164561,1912
"6956","WBGene00008945","V",20158523,20161788,3265
"6957","WBGene00008946","V",20151732,20155442,3710
"6958","WBGene00008947","V",20183843,20186679,2836
"6959","WBGene00008948","IV",12330984,12336041,5057
"6960","WBGene00008949","IV",12327190,12328718,1528
"6961","WBGene00008950","IV",12337577,12340436,2859
"6962","WBGene00008951","X",10000935,10005408,4473
"6963","WBGene00008952","X",10005733,10008755,3022
"6964","WBGene00008953","X",10015045,10018025,2980
"6965","WBGene00008954","X",9982402,9985005,2603
"6966","WBGene00008955","X",13834427,13836522,2095
"6967","WBGene00008956","X",12389594,12391474,1880
"6968","WBGene00008957","X",12374223,12378393,4170
"6969","WBGene00008958","X",12368452,12371421,2969
"6970","WBGene00008959","X",12365688,12367255,1567
"6971","WBGene00008960","X",12363713,12364904,1191
"6972","WBGene00008961","X",12362397,12363102,705
"6973","WBGene00008963","II",14604139,14605697,1558
"6974","WBGene00008964","II",14616068,14622612,6544
"6975","WBGene00008965","II",14623063,14626442,3379
"6976","WBGene00008966","IV",12183103,12186567,3464
"6977","WBGene00008967","IV",12168244,12169216,972
"6978","WBGene00008968","IV",8753195,8754823,1628
"6979","WBGene00008969","IV",8764867,8767450,2583
"6980","WBGene00008970","IV",8767688,8770092,2404
"6981","WBGene00008971","IV",8771558,8773206,1648
"6982","WBGene00008972","IV",8744411,8745691,1280
"6983","WBGene00008973","X",14968900,14970271,1371
"6984","WBGene00008974","X",14970751,14974779,4028
"6985","WBGene00008975","X",14976117,14978714,2597
"6986","WBGene00008976","X",14982140,14982804,664
"6987","WBGene00008977","X",14987369,14991380,4011
"6988","WBGene00008978","X",14994752,14999198,4446
"6989","WBGene00008979","X",15002034,15003941,1907
"6990","WBGene00008980","X",14979374,14980435,1061
"6991","WBGene00008981","V",17458533,17460161,1628
"6992","WBGene00008982","V",17436985,17438417,1432
"6993","WBGene00008983","V",17460811,17462432,1621
"6994","WBGene00008984","V",17464578,17466730,2152
"6995","WBGene00008985","V",13752267,13753580,1313
"6996","WBGene00008986","V",13755011,13756409,1398
"6997","WBGene00008987","V",13765926,13768552,2626
"6998","WBGene00008988","V",13771508,13773695,2187
"6999","WBGene00008989","V",13763077,13765980,2903
"7000","WBGene00008990","I",7918443,7926338,7895
"7001","WBGene00008991","I",7913937,7918341,4404
"7002","WBGene00008992","V",15533806,15533964,158
"7003","WBGene00008993","V",15517713,15519681,1968
"7004","WBGene00008994","V",15536620,15537986,1366
"7005","WBGene00008995","V",15538244,15547020,8776
"7006","WBGene00008996","V",15543161,15544994,1833
"7007","WBGene00008997","V",15512765,15522020,9255
"7008","WBGene00008998","X",10177237,10180662,3425
"7009","WBGene00008999","X",10180953,10194377,13424
"7010","WBGene00009000","X",10183980,10186228,2248
"7011","WBGene00009001","I",7274282,7278573,4291
"7012","WBGene00009002","I",7279658,7280501,843
"7013","WBGene00009004","I",7282964,7283818,854
"7014","WBGene00009005","I",7283907,7285762,1855
"7015","WBGene00009006","IV",8725722,8728060,2338
"7016","WBGene00009007","IV",8728139,8730510,2371
"7017","WBGene00009008","IV",8730721,8735686,4965
"7018","WBGene00009009","IV",8738087,8739101,1014
"7019","WBGene00009010","IV",8735695,8739394,3699
"7020","WBGene00009011","IV",8740140,8741388,1248
"7021","WBGene00009012","IV",8741383,8743704,2321
"7022","WBGene00009013","IV",8739504,8740026,522
"7023","WBGene00009014","IV",8724020,8724876,856
"7024","WBGene00009015","V",19264597,19269661,5064
"7025","WBGene00009016","V",19258483,19262449,3966
"7026","WBGene00009017","V",19257583,19257753,170
"7027","WBGene00009018","V",19253820,19256758,2938
"7028","WBGene00009019","V",19247395,19251089,3694
"7029","WBGene00009020","V",19242878,19244988,2110
"7030","WBGene00009021","V",19279218,19279988,770
"7031","WBGene00009023","X",9889618,9892328,2710
"7032","WBGene00009024","X",9895144,9897057,1913
"7033","WBGene00009025","X",9897313,9899476,2163
"7034","WBGene00009026","X",9906148,9908116,1968
"7035","WBGene00009027","X",9908794,9917448,8654
"7036","WBGene00009028","V",16227127,16229893,2766
"7037","WBGene00009029","V",16232652,16233335,683
"7038","WBGene00009030","V",16233924,16234896,972
"7039","WBGene00009031","V",16237523,16238824,1301
"7040","WBGene00009032","V",16254301,16256398,2097
"7041","WBGene00009033","V",16230203,16231043,840
"7042","WBGene00009035","IV",11410228,11413001,2773
"7043","WBGene00009036","IV",11415598,11416824,1226
"7044","WBGene00009038","IV",11417581,11421796,4215
"7045","WBGene00009039","IV",11422711,11425251,2540
"7046","WBGene00009041","II",8445168,8446831,1663
"7047","WBGene00009042","II",8449701,8452739,3038
"7048","WBGene00009043","II",8453254,8454613,1359
"7049","WBGene00009044","II",8454612,8456194,1582
"7050","WBGene00009045","II",8467174,8468010,836
"7051","WBGene00009046","V",16090985,16092117,1132
"7052","WBGene00009047","V",16086572,16088217,1645
"7053","WBGene00009048","V",16100627,16102750,2123
"7054","WBGene00009049","V",16094584,16097320,2736
"7055","WBGene00009050","I",7079868,7081520,1652
"7056","WBGene00009051","I",7090623,7091371,748
"7057","WBGene00009052","I",7095486,7098406,2920
"7058","WBGene00009054","I",7099810,7101775,1965
"7059","WBGene00009055","I",7098649,7099005,356
"7060","WBGene00009056","I",7102216,7103392,1176
"7061","WBGene00009057","X",12762078,12765904,3826
"7062","WBGene00009058","V",10453748,10457347,3599
"7063","WBGene00009059","V",10462282,10464660,2378
"7064","WBGene00009060","V",10459188,10463364,4176
"7065","WBGene00009061","I",13139132,13141789,2657
"7066","WBGene00009063","I",13152575,13153706,1131
"7067","WBGene00009064","I",13155239,13161508,6269
"7068","WBGene00009065","I",13162492,13182725,20233
"7069","WBGene00009067","X",16217392,16217666,274
"7070","WBGene00009068","X",16220010,16223519,3509
"7071","WBGene00009069","X",16212606,16213072,466
"7072","WBGene00009070","X",16229463,16236856,7393
"7073","WBGene00009071","X",16237273,16240702,3429
"7074","WBGene00009073","IV",9132600,9135477,2877
"7075","WBGene00009075","IV",9150491,9152043,1552
"7076","WBGene00009076","IV",9152201,9152528,327
"7077","WBGene00009077","IV",9152819,9154320,1501
"7078","WBGene00009078","IV",9146337,9146869,532
"7079","WBGene00009079","V",14429165,14430410,1245
"7080","WBGene00009081","V",14441057,14445346,4289
"7081","WBGene00009082","V",14445324,14447608,2284
"7082","WBGene00009084","V",14449697,14452971,3274
"7083","WBGene00009085","X",14425445,14428152,2707
"7084","WBGene00009086","X",14416121,14421579,5458
"7085","WBGene00009087","X",14442621,14443446,825
"7086","WBGene00009088","X",14445001,14446165,1164
"7087","WBGene00009089","X",14448224,14453562,5338
"7088","WBGene00009090","X",14423405,14423883,478
"7089","WBGene00009091","X",14453557,14453835,278
"7090","WBGene00009092","V",12342314,12343469,1155
"7091","WBGene00009093","V",12345935,12350451,4516
"7092","WBGene00009094","V",12358647,12363691,5044
"7093","WBGene00009095","V",12371730,12372870,1140
"7094","WBGene00009096","V",12361301,12361839,538
"7095","WBGene00009097","V",12365348,12365866,518
"7096","WBGene00009098","V",9550644,9556064,5420
"7097","WBGene00009099","V",9577332,9579946,2614
"7098","WBGene00009100","V",9556226,9561643,5417
"7099","WBGene00009101","V",9565450,9568788,3338
"7100","WBGene00009102","V",9568749,9570295,1546
"7101","WBGene00009103","V",9580041,9582644,2603
"7102","WBGene00009104","V",20907470,20909746,2276
"7103","WBGene00009106","V",20903977,20907433,3456
"7104","WBGene00009107","V",10530641,10532848,2207
"7105","WBGene00009108","V",10528754,10530568,1814
"7106","WBGene00009109","V",10540324,10545742,5418
"7107","WBGene00009110","V",10545741,10546799,1058
"7108","WBGene00009112","I",10401065,10402774,1709
"7109","WBGene00009113","I",10418234,10421858,3624
"7110","WBGene00009114","I",10422958,10429026,6068
"7111","WBGene00009115","III",4508855,4512162,3307
"7112","WBGene00009116","I",10543024,10546435,3411
"7113","WBGene00009117","I",10547721,10549876,2155
"7114","WBGene00009118","I",10551972,10553035,1063
"7115","WBGene00009119","I",10553116,10553913,797
"7116","WBGene00009120","I",10554366,10557838,3472
"7117","WBGene00009121","I",10558323,10560006,1683
"7118","WBGene00009122","I",10569112,10570030,918
"7119","WBGene00009123","I",10570079,10571916,1837
"7120","WBGene00009124","I",10571954,10577135,5181
"7121","WBGene00009125","I",9179941,9181119,1178
"7122","WBGene00009126","I",9168432,9177488,9056
"7123","WBGene00009127","I",9159938,9163261,3323
"7124","WBGene00009128","I",9159015,9159757,742
"7125","WBGene00009129","I",9155513,9157411,1898
"7126","WBGene00009130","I",9177664,9178703,1039
"7127","WBGene00009131","IV",9930899,9932240,1341
"7128","WBGene00009132","IV",9932235,9933879,1644
"7129","WBGene00009133","IV",9916530,9921996,5466
"7130","WBGene00009134","V",13453634,13455447,1813
"7131","WBGene00009135","V",13458083,13459504,1421
"7132","WBGene00009136","V",13455748,13457506,1758
"7133","WBGene00009137","V",13459525,13461803,2278
"7134","WBGene00009138","V",13466924,13468361,1437
"7135","WBGene00009139","V",13468376,13469087,711
"7136","WBGene00009140","I",7640338,7641767,1429
"7137","WBGene00009141","I",7642270,7643328,1058
"7138","WBGene00009142","I",7656978,7658291,1313
"7139","WBGene00009143","I",7667729,7669900,2171
"7140","WBGene00009144","I",7670314,7672714,2400
"7141","WBGene00009145","I",7674734,7676127,1393
"7142","WBGene00009146","II",9895538,9897351,1813
"7143","WBGene00009147","II",9903059,9915099,12040
"7144","WBGene00009148","V",16407963,16410270,2307
"7145","WBGene00009149","V",16424854,16429603,4749
"7146","WBGene00009150","V",16432009,16433572,1563
"7147","WBGene00009151","V",16434722,16435610,888
"7148","WBGene00009152","V",16435855,16436736,881
"7149","WBGene00009153","V",16437846,16438934,1088
"7150","WBGene00009154","V",16418433,16420425,1992
"7151","WBGene00009155","IV",17275581,17276864,1283
"7152","WBGene00009156","IV",17276956,17277748,792
"7153","WBGene00009157","I",9757854,9760787,2933
"7154","WBGene00009158","I",9762403,9767873,5470
"7155","WBGene00009159","I",9771061,9772565,1504
"7156","WBGene00009160","I",9768836,9771068,2232
"7157","WBGene00009161","I",9773172,9774012,840
"7158","WBGene00009162","I",9774165,9779541,5376
"7159","WBGene00009163","I",9781338,9785722,4384
"7160","WBGene00009164","I",9793756,9796675,2919
"7161","WBGene00009165","I",9780287,9781418,1131
"7162","WBGene00009166","V",20559080,20561895,2815
"7163","WBGene00009168","V",20565410,20566541,1131
"7164","WBGene00009169","V",20569295,20570191,896
"7165","WBGene00009170","V",20573717,20574000,283
"7166","WBGene00009171","V",20574625,20577636,3011
"7167","WBGene00009172","V",20580990,20590339,9349
"7168","WBGene00009173","I",9287437,9289770,2333
"7169","WBGene00009174","I",9289753,9294035,4282
"7170","WBGene00009176","I",9305751,9306844,1093
"7171","WBGene00009177","I",9312635,9314488,1853
"7172","WBGene00009178","I",9317736,9327279,9543
"7173","WBGene00009179","II",14389236,14390116,880
"7174","WBGene00009180","II",14390718,14407905,17187
"7175","WBGene00009182","II",14408612,14410836,2224
"7176","WBGene00009183","IV",9596497,9599081,2584
"7177","WBGene00009184","IV",9595088,9595933,845
"7178","WBGene00009185","IV",9589795,9592529,2734
"7179","WBGene00009186","IV",9587100,9588834,1734
"7180","WBGene00009187","I",7702429,7704584,2155
"7181","WBGene00009188","I",7704565,7707049,2484
"7182","WBGene00009189","I",7725019,7727112,2093
"7183","WBGene00009190","I",7731121,7737995,6874
"7184","WBGene00009191","I",7723754,7724656,902
"7185","WBGene00009192","II",10139590,10141406,1816
"7186","WBGene00009193","II",10141457,10144192,2735
"7187","WBGene00009194","II",10128254,10131860,3606
"7188","WBGene00009195","V",17042592,17043783,1191
"7189","WBGene00009196","V",17044786,17049822,5036
"7190","WBGene00009197","V",17052004,17059919,7915
"7191","WBGene00009200","V",12450807,12453336,2529
"7192","WBGene00009201","V",12468683,12473533,4850
"7193","WBGene00009202","II",8590984,8593010,2026
"7194","WBGene00009203","II",8594190,8596294,2104
"7195","WBGene00009204","II",8596286,8600265,3979
"7196","WBGene00009205","II",8599508,8600506,998
"7197","WBGene00009206","IV",13870265,13870336,71
"7198","WBGene00009207","II",8606849,8607749,900
"7199","WBGene00009208","II",8608876,8610110,1234
"7200","WBGene00009209","II",8607889,8608865,976
"7201","WBGene00009210","I",12691318,12691762,444
"7202","WBGene00009211","IV",12372253,12374908,2655
"7203","WBGene00009212","IV",12374709,12376121,1412
"7204","WBGene00009213","IV",12380104,12380857,753
"7205","WBGene00009214","IV",12381592,12382339,747
"7206","WBGene00009215","IV",12383170,12384019,849
"7207","WBGene00009216","IV",12384507,12385161,654
"7208","WBGene00009217","IV",12387720,12390095,2375
"7209","WBGene00009218","IV",12392121,12398706,6585
"7210","WBGene00009219","IV",12391591,12392120,529
"7211","WBGene00009220","I",11168607,11177726,9119
"7212","WBGene00009221","V",15567394,15569889,2495
"7213","WBGene00009222","V",15571489,15572715,1226
"7214","WBGene00009223","V",15574098,15575403,1305
"7215","WBGene00009224","V",15578984,15590617,11633
"7216","WBGene00009225","V",15571490,15574106,2616
"7217","WBGene00009226","V",16278191,16280612,2421
"7218","WBGene00009227","V",16280602,16282321,1719
"7219","WBGene00009228","V",16286151,16287719,1568
"7220","WBGene00009229","V",16283018,16285894,2876
"7221","WBGene00009230","V",16288788,16292154,3366
"7222","WBGene00009231","X",14141946,14144889,2943
"7223","WBGene00009232","X",14137997,14140070,2073
"7224","WBGene00009233","X",14127877,14133525,5648
"7225","WBGene00009234","X",14117069,14125879,8810
"7226","WBGene00009235","X",14116111,14116751,640
"7227","WBGene00009236","V",10747944,10748938,994
"7228","WBGene00009237","V",10749607,10750788,1181
"7229","WBGene00009238","V",10746548,10747337,789
"7230","WBGene00009239","V",10754469,10756664,2195
"7231","WBGene00009240","V",10751057,10754147,3090
"7232","WBGene00009241","V",10758958,10760663,1705
"7233","WBGene00009242","V",10760658,10762790,2132
"7234","WBGene00009243","I",10579413,10580890,1477
"7235","WBGene00009245","II",13098249,13116806,18557
"7236","WBGene00009246","II",13117483,13122085,4602
"7237","WBGene00009247","II",13123038,13124789,1751
"7238","WBGene00009248","II",13129902,13130189,287
"7239","WBGene00009249","II",13126024,13126152,128
"7240","WBGene00009250","I",8840634,8841163,529
"7241","WBGene00009251","I",8841770,8842323,553
"7242","WBGene00009252","I",8842552,8845595,3043
"7243","WBGene00009254","I",7634494,7639780,5286
"7244","WBGene00009255","V",10654417,10656976,2559
"7245","WBGene00009256","V",10658194,10659658,1464
"7246","WBGene00009257","X",11502267,11509432,7165
"7247","WBGene00009258","X",11509446,11511451,2005
"7248","WBGene00009259","X",11511558,11519062,7504
"7249","WBGene00009260","I",9472642,9474794,2152
"7250","WBGene00009261","I",9479101,9480774,1673
"7251","WBGene00009262","I",9492615,9494589,1974
"7252","WBGene00009263","I",9483810,9486540,2730
"7253","WBGene00009264","I",9488488,9492620,4132
"7254","WBGene00009266","I",9504515,9505768,1253
"7255","WBGene00009267","I",9506553,9511184,4631
"7256","WBGene00009268","I",9477478,9478098,620
"7257","WBGene00009269","I",9481629,9482275,646
"7258","WBGene00009270","I",7832692,7835453,2761
"7259","WBGene00009271","I",7826442,7831629,5187
"7260","WBGene00009272","I",7835814,7836967,1153
"7261","WBGene00009274","I",7847246,7848920,1674
"7262","WBGene00009276","I",7837063,7840022,2959
"7263","WBGene00009277","I",7840442,7846923,6481
"7264","WBGene00009278","X",15910638,15914159,3521
"7265","WBGene00009279","X",15918137,15920423,2286
"7266","WBGene00009280","X",15923738,15925169,1431
"7267","WBGene00009281","X",15915699,15917100,1401
"7268","WBGene00009283","X",10804741,10805433,692
"7269","WBGene00009284","I",15036373,15040487,4114
"7270","WBGene00009285","I",15041433,15050700,9267
"7271","WBGene00009286","I",15050797,15052420,1623
"7272","WBGene00009287","I",15053025,15053670,645
"7273","WBGene00009288","I",15053617,15059003,5386
"7274","WBGene00009289","V",20838865,20841582,2717
"7275","WBGene00009290","V",20841573,20845546,3973
"7276","WBGene00009291","V",20847702,20850666,2964
"7277","WBGene00009292","V",20854143,20858576,4433
"7278","WBGene00009293","V",20866749,20868429,1680
"7279","WBGene00009294","V",20850833,20851897,1064
"7280","WBGene00009295","V",17319596,17322444,2848
"7281","WBGene00009296","V",17322615,17324518,1903
"7282","WBGene00009297","V",17326453,17327967,1514
"7283","WBGene00009298","V",17318147,17319515,1368
"7284","WBGene00009299","V",17313602,17315153,1551
"7285","WBGene00009300","X",14867101,14868300,1199
"7286","WBGene00009301","X",14869606,14870675,1069
"7287","WBGene00009302","X",14871836,14872867,1031
"7288","WBGene00009303","X",14898505,14900772,2267
"7289","WBGene00009304","I",14829667,14834839,5172
"7290","WBGene00009305","I",14839856,14843128,3272
"7291","WBGene00009306","I",14846476,14850137,3661
"7292","WBGene00009307","II",13157333,13160462,3129
"7293","WBGene00009308","II",13151459,13153399,1940
"7294","WBGene00009309","II",13135034,13137394,2360
"7295","WBGene00009310","II",13131009,13134212,3203
"7296","WBGene00009311","II",13139465,13145225,5760
"7297","WBGene00009312","I",11510066,11512769,2703
"7298","WBGene00009313","I",11512840,11513853,1013
"7299","WBGene00009314","I",11517558,11526962,9404
"7300","WBGene00009315","I",11517748,11520660,2912
"7301","WBGene00009316","I",11515127,11517108,1981
"7302","WBGene00009318","I",11501625,11507129,5504
"7303","WBGene00009319","IV",9884556,9887150,2594
"7304","WBGene00009320","IV",9882132,9884383,2251
"7305","WBGene00009321","IV",9890585,9892038,1453
"7306","WBGene00009322","IV",9899012,9902513,3501
"7307","WBGene00009323","IV",9903908,9905903,1995
"7308","WBGene00009324","IV",9887190,9889929,2739
"7309","WBGene00009325","V",10904059,10906774,2715
"7310","WBGene00009326","V",10880837,10883399,2562
"7311","WBGene00009327","V",10883778,10886102,2324
"7312","WBGene00009328","V",10886837,10887965,1128
"7313","WBGene00009329","V",10891338,10893560,2222
"7314","WBGene00009330","V",10894800,10895953,1153
"7315","WBGene00009331","V",10898435,10900701,2266
"7316","WBGene00009332","V",10901480,10902782,1302
"7317","WBGene00009333","V",10906755,10909171,2416
"7318","WBGene00009334","V",10888572,10891030,2458
"7319","WBGene00009335","V",10895654,10896543,889
"7320","WBGene00009336","V",10893649,10894788,1139
"7321","WBGene00009337","V",13273153,13295978,22825
"7322","WBGene00009338","V",10550017,10554493,4476
"7323","WBGene00009339","V",10554616,10555238,622
"7324","WBGene00009340","V",10557976,10560793,2817
"7325","WBGene00009341","I",8971139,8973063,1924
"7326","WBGene00009342","I",8975384,8986534,11150
"7327","WBGene00009343","I",8998532,8999564,1032
"7328","WBGene00009344","I",8995572,8997290,1718
"7329","WBGene00009345","I",8989938,8993461,3523
"7330","WBGene00009346","I",8970293,8971031,738
"7331","WBGene00009347","V",13356101,13358079,1978
"7332","WBGene00009349","V",13359334,13360024,690
"7333","WBGene00009350","V",13361203,13363357,2154
"7334","WBGene00009352","II",11045786,11049030,3244
"7335","WBGene00009353","II",11049144,11049913,769
"7336","WBGene00009354","II",11050260,11058102,7842
"7337","WBGene00009355","II",11023834,11025666,1832
"7338","WBGene00009356","II",11036074,11039471,3397
"7339","WBGene00009357","X",14721398,14723437,2039
"7340","WBGene00009358","X",14732283,14734457,2174
"7341","WBGene00009359","I",12579897,12580957,1060
"7342","WBGene00009360","I",12582074,12584711,2637
"7343","WBGene00009361","I",12591116,12597442,6326
"7344","WBGene00009362","I",12587242,12591091,3849
"7345","WBGene00009363","I",12585382,12585971,589
"7346","WBGene00009364","II",10172923,10174346,1423
"7347","WBGene00009365","II",10174572,10180183,5611
"7348","WBGene00009366","I",15023092,15027761,4669
"7349","WBGene00009367","I",15034517,15035467,950
"7350","WBGene00009368","I",15005603,15013904,8301
"7351","WBGene00009369","I",15014851,15016595,1744
"7352","WBGene00009370","I",15027717,15030666,2949
"7353","WBGene00009371","I",15031145,15033039,1894
"7354","WBGene00009372","III",3729493,3735039,5546
"7355","WBGene00009373","III",3734205,3734851,646
"7356","WBGene00009374","III",3736602,3739765,3163
"7357","WBGene00009375","III",3747560,3759412,11852
"7358","WBGene00009377","III",3730775,3731248,473
"7359","WBGene00009378","X",9626135,9626849,714
"7360","WBGene00009379","X",9630423,9630875,452
"7361","WBGene00009380","X",9633284,9635647,2363
"7362","WBGene00009381","X",9648532,9650928,2396
"7363","WBGene00009382","X",9635693,9636884,1191
"7364","WBGene00009383","V",11604482,11606524,2042
"7365","WBGene00009384","V",11609096,11610149,1053
"7366","WBGene00009385","V",11610708,11613054,2346
"7367","WBGene00009386","V",11613307,11614888,1581
"7368","WBGene00009387","V",11616812,11618266,1454
"7369","WBGene00009388","V",11601119,11602358,1239
"7370","WBGene00009389","V",11625954,11629322,3368
"7371","WBGene00009390","II",12880815,12881968,1153
"7372","WBGene00009391","II",12888762,12890460,1698
"7373","WBGene00009392","II",12890630,12892024,1394
"7374","WBGene00009393","II",12893065,12895098,2033
"7375","WBGene00009394","II",12895638,12897462,1824
"7376","WBGene00009395","II",12898242,12900435,2193
"7377","WBGene00009396","II",12901264,12903336,2072
"7378","WBGene00009397","II",12904398,12906686,2288
"7379","WBGene00009398","II",12907370,12907783,413
"7380","WBGene00009399","II",12909079,12910334,1255
"7381","WBGene00009400","II",12910229,12914603,4374
"7382","WBGene00009401","II",8244185,8246409,2224
"7383","WBGene00009402","II",8246776,8248263,1487
"7384","WBGene00009403","II",8249879,8251980,2101
"7385","WBGene00009404","II",8253740,8255319,1579
"7386","WBGene00009405","II",8258074,8259210,1136
"7387","WBGene00009406","II",8256313,8257605,1292
"7388","WBGene00009408","I",9813034,9823448,10414
"7389","WBGene00009409","I",11738726,11740762,2036
"7390","WBGene00009410","I",11736637,11737699,1062
"7391","WBGene00009411","I",11733940,11735964,2024
"7392","WBGene00009412","I",11741603,11743951,2348
"7393","WBGene00009413","I",11707818,11712197,4379
"7394","WBGene00009414","I",11714956,11717616,2660
"7395","WBGene00009415","I",11718864,11719790,926
"7396","WBGene00009416","I",11723427,11726326,2899
"7397","WBGene00009417","V",15904192,15905630,1438
"7398","WBGene00009418","V",15905620,15907032,1412
"7399","WBGene00009420","V",15912148,15913056,908
"7400","WBGene00009421","V",15914014,15915142,1128
"7401","WBGene00009422","V",15916334,15917558,1224
"7402","WBGene00009423","V",15919434,15920373,939
"7403","WBGene00009424","V",15923279,15926154,2875
"7404","WBGene00009425","V",13721249,13722196,947
"7405","WBGene00009426","V",13722254,13724881,2627
"7406","WBGene00009427","V",13725905,13727014,1109
"7407","WBGene00009428","V",13731506,13733387,1881
"7408","WBGene00009429","V",13737007,13738474,1467
"7409","WBGene00009430","V",13734118,13736247,2129
"7410","WBGene00009431","V",13727763,13730776,3013
"7411","WBGene00009432","V",13749181,13751972,2791
"7412","WBGene00009433","V",13741321,13745127,3806
"7413","WBGene00009434","V",13745696,13748758,3062
"7414","WBGene00009435","IV",12200978,12207956,6978
"7415","WBGene00009436","IV",12208192,12209010,818
"7416","WBGene00009437","IV",12209708,12210737,1029
"7417","WBGene00009438","IV",12219609,12222889,3280
"7418","WBGene00009439","III",4566279,4568144,1865
"7419","WBGene00009440","III",4567325,4571835,4510
"7420","WBGene00009441","III",4578855,4581696,2841
"7421","WBGene00009442","III",4584583,4586753,2170
"7422","WBGene00009443","III",4586628,4587330,702
"7423","WBGene00009444","III",4593176,4593832,656
"7424","WBGene00009445","III",4581795,4583893,2098
"7425","WBGene00009446","II",9552631,9553279,648
"7426","WBGene00009447","II",9555503,9557532,2029
"7427","WBGene00009448","II",9557646,9559516,1870
"7428","WBGene00009449","II",9559497,9560029,532
"7429","WBGene00009450","II",9584384,9586815,2431
"7430","WBGene00009451","I",8804799,8808081,3282
"7431","WBGene00009452","I",8801612,8804697,3085
"7432","WBGene00009453","I",8798785,8801694,2909
"7433","WBGene00009454","I",8813761,8814979,1218
"7434","WBGene00009455","I",8808775,8813298,4523
"7435","WBGene00009456","I",8816978,8821359,4381
"7436","WBGene00009457","I",8819499,8820139,640
"7437","WBGene00009458","I",8822188,8823637,1449
"7438","WBGene00009459","I",8826167,8826670,503
"7439","WBGene00009460","I",8828048,8838719,10671
"7440","WBGene00009461","I",11276451,11280018,3567
"7441","WBGene00009462","I",11282473,11286290,3817
"7442","WBGene00009463","I",11271708,11272346,638
"7443","WBGene00009464","I",11266070,11266474,404
"7444","WBGene00009465","I",11269946,11271226,1280
"7445","WBGene00009466","I",11263066,11263661,595
"7446","WBGene00009467","I",11256550,11259225,2675
"7447","WBGene00009468","I",11274899,11276346,1447
"7448","WBGene00009469","V",16499352,16502879,3527
"7449","WBGene00009470","V",16516472,16517719,1247
"7450","WBGene00009471","V",16510377,16515240,4863
"7451","WBGene00009472","V",16518183,16520245,2062
"7452","WBGene00009473","V",16527158,16528586,1428
"7453","WBGene00009474","V",16531373,16532690,1317
"7454","WBGene00009475","I",9018623,9020304,1681
"7455","WBGene00009476","I",9016755,9017994,1239
"7456","WBGene00009477","I",9009260,9013885,4625
"7457","WBGene00009478","I",9001913,9003963,2050
"7458","WBGene00009479","I",9004513,9008708,4195
"7459","WBGene00009480","I",9000097,9001721,1624
"7460","WBGene00009481","I",9015357,9015711,354
"7461","WBGene00009482","X",9780375,9789275,8900
"7462","WBGene00009483","X",9792407,9794273,1866
"7463","WBGene00009484","X",9798839,9801038,2199
"7464","WBGene00009485","V",15957406,15959554,2148
"7465","WBGene00009486","V",15968474,15969753,1279
"7466","WBGene00009487","V",15976152,15977569,1417
"7467","WBGene00009488","V",15978714,15981666,2952
"7468","WBGene00009489","V",15983294,15986649,3355
"7469","WBGene00009490","V",15981691,15982854,1163
"7470","WBGene00009491","V",15987494,15988174,680
"7471","WBGene00009492","IV",11050128,11052430,2302
"7472","WBGene00009493","IV",11030160,11031082,922
"7473","WBGene00009494","IV",11028477,11029105,628
"7474","WBGene00009495","IV",11031171,11033581,2410
"7475","WBGene00009496","IV",11049171,11049632,461
"7476","WBGene00009497","IV",11052816,11053634,818
"7477","WBGene00009498","I",9234174,9245924,11750
"7478","WBGene00009499","I",9246028,9249383,3355
"7479","WBGene00009500","I",9251838,9261657,9819
"7480","WBGene00009501","III",3928436,3929233,797
"7481","WBGene00009502","III",3929530,3931523,1993
"7482","WBGene00009503","III",3956624,3958161,1537
"7483","WBGene00009504","II",9026968,9029263,2295
"7484","WBGene00009505","II",9039820,9041406,1586
"7485","WBGene00009507","I",10479283,10484969,5686
"7486","WBGene00009508","I",10475522,10478129,2607
"7487","WBGene00009509","I",10486714,10487322,608
"7488","WBGene00009510","I",10488648,10489569,921
"7489","WBGene00009511","II",11171446,11175479,4033
"7490","WBGene00009512","II",11181654,11183147,1493
"7491","WBGene00009513","II",11186028,11188080,2052
"7492","WBGene00009514","II",11188206,11189437,1231
"7493","WBGene00009515","IV",1266866,1274425,7559
"7494","WBGene00009517","IV",1253137,1255732,2595
"7495","WBGene00009518","IV",1249018,1251366,2348
"7496","WBGene00009519","IV",1251861,1252470,609
"7497","WBGene00009520","IV",1256956,1259344,2388
"7498","WBGene00009521","IV",1232872,1239852,6980
"7499","WBGene00009522","IV",1244247,1245344,1097
"7500","WBGene00009523","IV",1245399,1246886,1487
"7501","WBGene00009524","IV",1247386,1249025,1639
"7502","WBGene00009525","IV",1265228,1265848,620
"7503","WBGene00009526","IV",1261272,1264622,3350
"7504","WBGene00009527","X",12661164,12661247,83
"7505","WBGene00009528","V",20773743,20775369,1626
"7506","WBGene00009529","X",11278401,11279376,975
"7507","WBGene00009530","X",11281716,11286346,4630
"7508","WBGene00009531","X",11286443,11287717,1274
"7509","WBGene00009532","V",11527831,11541219,13388
"7510","WBGene00009533","V",11543857,11545290,1433
"7511","WBGene00009534","V",11549107,11551560,2453
"7512","WBGene00009535","IV",16247431,16251790,4359
"7513","WBGene00009536","IV",16271263,16273187,1924
"7514","WBGene00009537","IV",16278202,16279018,816
"7515","WBGene00009538","IV",16279634,16280714,1080
"7516","WBGene00009539","IV",16276647,16277391,744
"7517","WBGene00009540","IV",16257668,16259417,1749
"7518","WBGene00009541","IV",9449473,9457501,8028
"7519","WBGene00009542","IV",9459731,9463998,4267
"7520","WBGene00009543","IV",9463951,9467518,3567
"7521","WBGene00009544","IV",9442877,9444516,1639
"7522","WBGene00009546","IV",11838980,11840423,1443
"7523","WBGene00009547","IV",11842421,11846350,3929
"7524","WBGene00009548","IV",11848232,11850309,2077
"7525","WBGene00009549","IV",11852193,11853146,953
"7526","WBGene00009550","IV",11847009,11847871,862
"7527","WBGene00009551","IV",11860555,11862498,1943
"7528","WBGene00009552","X",15234829,15246365,11536
"7529","WBGene00009553","I",14791040,14794371,3331
"7530","WBGene00009554","I",14788125,14789517,1392
"7531","WBGene00009556","I",14775184,14776663,1479
"7532","WBGene00009557","I",14770689,14775007,4318
"7533","WBGene00009558","I",14760644,14768980,8336
"7534","WBGene00009559","I",14755154,14756432,1278
"7535","WBGene00009560","X",15407931,15419290,11359
"7536","WBGene00009561","X",15420979,15425114,4135
"7537","WBGene00009562","I",8658874,8659967,1093
"7538","WBGene00009563","I",8664925,8666499,1574
"7539","WBGene00009565","I",8696603,8697596,993
"7540","WBGene00009566","V",17176716,17178067,1351
"7541","WBGene00009567","V",17174038,17175530,1492
"7542","WBGene00009568","V",17171851,17173313,1462
"7543","WBGene00009569","V",17166028,17167557,1529
"7544","WBGene00009570","V",17167833,17169279,1446
"7545","WBGene00009571","V",17159874,17162621,2747
"7546","WBGene00009572","V",17156033,17157254,1221
"7547","WBGene00009573","X",14701790,14703682,1892
"7548","WBGene00009574","X",14703715,14706859,3144
"7549","WBGene00009575","II",11127634,11129256,1622
"7550","WBGene00009576","II",11129289,11130187,898
"7551","WBGene00009577","II",11139407,11140275,868
"7552","WBGene00009578","II",11132861,11135140,2279
"7553","WBGene00009579","II",11142751,11150381,7630
"7554","WBGene00009580","V",9703055,9707824,4769
"7555","WBGene00009581","V",9715209,9716380,1171
"7556","WBGene00009582","V",9719743,9724118,4375
"7557","WBGene00009583","V",9725972,9729510,3538
"7558","WBGene00009584","V",9730110,9734022,3912
"7559","WBGene00009585","V",9734103,9735316,1213
"7560","WBGene00009586","V",9711447,9713632,2185
"7561","WBGene00009587","IV",11594244,11601695,7451
"7562","WBGene00009588","IV",11592351,11594003,1652
"7563","WBGene00009589","IV",11588263,11592240,3977
"7564","WBGene00009590","III",9916190,9916657,467
"7565","WBGene00009592","III",9918645,9920864,2219
"7566","WBGene00009593","III",9893155,9898426,5271
"7567","WBGene00009594","III",9898602,9910658,12056
"7568","WBGene00009595","III",9914261,9915883,1622
"7569","WBGene00009596","V",14257107,14259231,2124
"7570","WBGene00009597","V",14259544,14260931,1387
"7571","WBGene00009598","V",14261990,14267317,5327
"7572","WBGene00009599","V",14267761,14268639,878
"7573","WBGene00009600","V",14269182,14270636,1454
"7574","WBGene00009601","V",14271143,14273047,1904
"7575","WBGene00009602","V",14275669,14276343,674
"7576","WBGene00009603","V",14278312,14279877,1565
"7577","WBGene00009604","V",14282482,14282997,515
"7578","WBGene00009605","V",14283528,14285327,1799
"7579","WBGene00009606","V",14286171,14288056,1885
"7580","WBGene00009607","I",12247771,12250210,2439
"7581","WBGene00009608","I",12251906,12253554,1648
"7582","WBGene00009609","I",12254506,12257180,2674
"7583","WBGene00009610","I",12259912,12262848,2936
"7584","WBGene00009611","I",12264521,12266267,1746
"7585","WBGene00009612","I",12267045,12267491,446
"7586","WBGene00009613","I",12267499,12268128,629
"7587","WBGene00009614","I",12272981,12274636,1655
"7588","WBGene00009615","I",12269255,12272190,2935
"7589","WBGene00009616","I",12276893,12278775,1882
"7590","WBGene00009617","X",10279599,10282842,3243
"7591","WBGene00009618","X",10273692,10278261,4569
"7592","WBGene00009619","X",10282825,10285734,2909
"7593","WBGene00009620","X",10302622,10303143,521
"7594","WBGene00009621","X",10304507,10304947,440
"7595","WBGene00009622","X",10307137,10310466,3329
"7596","WBGene00009623","X",10307873,10312182,4309
"7597","WBGene00009624","X",10306595,10306951,356
"7598","WBGene00009625","X",10312756,10316005,3249
"7599","WBGene00009626","II",9341397,9346590,5193
"7600","WBGene00009627","II",9353000,9354327,1327
"7601","WBGene00009628","X",14791008,14792980,1972
"7602","WBGene00009629","X",14794217,14804359,10142
"7603","WBGene00009630","V",13062429,13063617,1188
"7604","WBGene00009631","V",13065461,13065794,333
"7605","WBGene00009632","X",11368719,11374358,5639
"7606","WBGene00009633","X",11374599,11375609,1010
"7607","WBGene00009634","X",12342946,12343379,433
"7608","WBGene00009635","X",12350578,12351788,1210
"7609","WBGene00009636","X",12351978,12352949,971
"7610","WBGene00009637","X",12357427,12357919,492
"7611","WBGene00009638","X",12358614,12359097,483
"7612","WBGene00009639","X",12360737,12361184,447
"7613","WBGene00009640","X",12343609,12344043,434
"7614","WBGene00009641","II",13047941,13050807,2866
"7615","WBGene00009642","II",13073493,13076223,2730
"7616","WBGene00009643","II",13079093,13080762,1669
"7617","WBGene00009644","II",13046548,13047287,739
"7618","WBGene00009645","X",10018046,10022304,4258
"7619","WBGene00009646","I",9576357,9577907,1550
"7620","WBGene00009647","III",4209492,4216724,7232
"7621","WBGene00009648","III",4243674,4244385,711
"7622","WBGene00009649","III",4229141,4230427,1286
"7623","WBGene00009650","V",14612432,14613706,1274
"7624","WBGene00009651","V",14635582,14637751,2169
"7625","WBGene00009652","V",14631891,14633106,1215
"7626","WBGene00009653","III",10488128,10500267,12139
"7627","WBGene00009654","III",10507058,10518391,11333
"7628","WBGene00009656","II",11782987,11784086,1099
"7629","WBGene00009657","II",11790759,11797322,6563
"7630","WBGene00009658","II",11814839,11816706,1867
"7631","WBGene00009659","II",11810790,11811665,875
"7632","WBGene00009660","II",11812294,11814113,1819
"7633","WBGene00009661","II",11774669,11777943,3274
"7634","WBGene00009662","II",11809347,11810307,960
"7635","WBGene00009663","II",11799037,11802412,3375
"7636","WBGene00009664","I",8606404,8608631,2227
"7637","WBGene00009665","I",8609925,8611066,1141
"7638","WBGene00009666","I",8612728,8615175,2447
"7639","WBGene00009667","I",8610894,8612602,1708
"7640","WBGene00009668","I",8615388,8616420,1032
"7641","WBGene00009670","I",8617400,8618889,1489
"7642","WBGene00009671","I",8638514,8640236,1722
"7643","WBGene00009672","I",8640508,8644399,3891
"7644","WBGene00009673","I",8605263,8606584,1321
"7645","WBGene00009674","X",10197706,10200407,2701
"7646","WBGene00009675","X",10212771,10214165,1394
"7647","WBGene00009676","X",10214443,10215495,1052
"7648","WBGene00009677","X",10217310,10218760,1450
"7649","WBGene00009678","IV",10009354,10014187,4833
"7650","WBGene00009679","IV",10013958,10016398,2440
"7651","WBGene00009680","IV",10022263,10022705,442
"7652","WBGene00009681","IV",10026413,10027666,1253
"7653","WBGene00009682","IV",10029055,10029498,443
"7654","WBGene00009683","IV",10033363,10034820,1457
"7655","WBGene00009684","IV",10035638,10035967,329
"7656","WBGene00009685","IV",10023291,10025226,1935
"7657","WBGene00009686","IV",10017425,10021286,3861
"7658","WBGene00009687","IV",10036627,10037066,439
"7659","WBGene00009688","II",11774144,11774559,415
"7660","WBGene00009689","II",11766772,11768622,1850
"7661","WBGene00009690","II",11762166,11765662,3496
"7662","WBGene00009691","II",11757106,11759323,2217
"7663","WBGene00009692","II",11759640,11761853,2213
"7664","WBGene00009693","I",13250519,13252902,2383
"7665","WBGene00009695","I",13254141,13257729,3588
"7666","WBGene00009696","I",13263803,13265570,1767
"7667","WBGene00009697","I",13258381,13260217,1836
"7668","WBGene00009698","I",13260933,13262727,1794
"7669","WBGene00009700","II",10880925,10882427,1502
"7670","WBGene00009701","II",10882408,10884462,2054
"7671","WBGene00009702","II",10884705,10885878,1173
"7672","WBGene00009704","II",10915280,10915832,552
"7673","WBGene00009705","II",10915901,10917274,1373
"7674","WBGene00009706","V",16103894,16105950,2056
"7675","WBGene00009707","V",16112992,16114337,1345
"7676","WBGene00009708","V",16133781,16137143,3362
"7677","WBGene00009709","V",16131180,16132805,1625
"7678","WBGene00009710","V",16138846,16139627,781
"7679","WBGene00009711","II",8994636,8996269,1633
"7680","WBGene00009712","II",8996364,8997037,673
"7681","WBGene00009713","II",8997027,8997662,635
"7682","WBGene00009714","II",8999727,9000431,704
"7683","WBGene00009715","II",9000872,9001793,921
"7684","WBGene00009716","II",9002527,9005167,2640
"7685","WBGene00009717","II",9005796,9019775,13979
"7686","WBGene00009720","X",14960544,14961571,1027
"7687","WBGene00009721","V",12527058,12528023,965
"7688","WBGene00009722","V",12541040,12542973,1933
"7689","WBGene00009723","V",12549216,12550385,1169
"7690","WBGene00009724","V",12552211,12553301,1090
"7691","WBGene00009725","X",12475659,12477441,1782
"7692","WBGene00009726","X",12485054,12491102,6048
"7693","WBGene00009727","X",12492865,12495862,2997
"7694","WBGene00009728","X",12502802,12503338,536
"7695","WBGene00009729","II",11052140,11055303,3163
"7696","WBGene00009730","III",13409895,13423537,13642
"7697","WBGene00009731","III",13423514,13426204,2690
"7698","WBGene00009732","III",13426100,13427715,1615
"7699","WBGene00009733","III",13433447,13434504,1057
"7700","WBGene00009734","III",13434861,13435670,809
"7701","WBGene00009735","III",13435771,13436943,1172
"7702","WBGene00009736","III",13437054,13439586,2532
"7703","WBGene00009738","III",3377408,3389970,12562
"7704","WBGene00009739","II",13491803,13493050,1247
"7705","WBGene00009740","II",13493181,13494600,1419
"7706","WBGene00009741","II",13495050,13495900,850
"7707","WBGene00009742","II",13501877,13503822,1945
"7708","WBGene00009743","I",10366621,10371699,5078
"7709","WBGene00009744","I",10374809,10379631,4822
"7710","WBGene00009745","I",10381082,10382040,958
"7711","WBGene00009746","I",11242732,11243526,794
"7712","WBGene00009747","I",11241225,11241970,745
"7713","WBGene00009748","I",11239684,11240473,789
"7714","WBGene00009749","I",11243836,11245003,1167
"7715","WBGene00009750","I",11238117,11238227,110
"7716","WBGene00009751","I",11235882,11236707,825
"7717","WBGene00009752","I",11252238,11252981,743
"7718","WBGene00009753","I",11253256,11256022,2766
"7719","WBGene00009754","I",9457456,9458842,1386
"7720","WBGene00009755","I",9459287,9460550,1263
"7721","WBGene00009756","V",20596210,20597244,1034
"7722","WBGene00009757","V",20598508,20599492,984
"7723","WBGene00009758","V",20603366,20604378,1012
"7724","WBGene00009759","V",20607804,20608559,755
"7725","WBGene00009760","V",20618120,20618656,536
"7726","WBGene00009761","V",20622650,20623160,510
"7727","WBGene00009762","V",20625186,20626143,957
"7728","WBGene00009763","V",20626711,20628206,1495
"7729","WBGene00009764","V",20628422,20629802,1380
"7730","WBGene00009765","V",20630148,20631329,1181
"7731","WBGene00009766","V",20632985,20633689,704
"7732","WBGene00009767","V",20634630,20635313,683
"7733","WBGene00009768","V",9772430,9774881,2451
"7734","WBGene00009769","V",9777863,9779518,1655
"7735","WBGene00009770","V",9779550,9783062,3512
"7736","WBGene00009771","V",9783167,9786868,3701
"7737","WBGene00009772","V",9786949,9789707,2758
"7738","WBGene00009773","V",9791567,9793234,1667
"7739","WBGene00009774","V",9796862,9798270,1408
"7740","WBGene00009775","V",9801463,9802028,565
"7741","WBGene00009776","V",9774897,9775834,937
"7742","WBGene00009777","X",11416653,11418740,2087
"7743","WBGene00009778","II",8820149,8821248,1099
"7744","WBGene00009779","II",8828196,8829287,1091
"7745","WBGene00009780","II",8836175,8839313,3138
"7746","WBGene00009781","II",8840200,8844515,4315
"7747","WBGene00009782","II",8839325,8840243,918
"7748","WBGene00009783","II",8811353,8812633,1280
"7749","WBGene00009784","II",8808636,8810729,2093
"7750","WBGene00009785","II",8817593,8818426,833
"7751","WBGene00009786","X",15250809,15253877,3068
"7752","WBGene00009787","X",15259579,15260290,711
"7753","WBGene00009788","X",15257597,15259048,1451
"7754","WBGene00009789","X",15262727,15267857,5130
"7755","WBGene00009790","V",11669348,11672594,3246
"7756","WBGene00009791","V",11667476,11669390,1914
"7757","WBGene00009793","X",10397243,10402573,5330
"7758","WBGene00009796","X",13310227,13311830,1603
"7759","WBGene00009797","X",13322963,13327854,4891
"7760","WBGene00009798","X",13334046,13336784,2738
"7761","WBGene00009799","X",9801091,9807662,6571
"7762","WBGene00009800","X",9823752,9831249,7497
"7763","WBGene00009801","X",9833352,9838039,4687
"7764","WBGene00009802","V",14313759,14314333,574
"7765","WBGene00009803","V",14315859,14316625,766
"7766","WBGene00009804","V",14321371,14323003,1632
"7767","WBGene00009805","V",14323607,14324631,1024
"7768","WBGene00009806","V",14325787,14327876,2089
"7769","WBGene00009807","V",14329069,14330080,1011
"7770","WBGene00009808","V",14333416,14334803,1387
"7771","WBGene00009809","V",14331674,14332667,993
"7772","WBGene00009810","V",14337049,14338808,1759
"7773","WBGene00009811","V",14343068,14346964,3896
"7774","WBGene00009812","X",10897678,10900114,2436
"7775","WBGene00009813","X",10893567,10896598,3031
"7776","WBGene00009814","X",10892190,10893569,1379
"7777","WBGene00009815","X",10891295,10891707,412
"7778","WBGene00009816","X",10889041,10890556,1515
"7779","WBGene00009817","X",10888506,10889028,522
"7780","WBGene00009818","X",10903278,10905107,1829
"7781","WBGene00009819","X",10905181,10910768,5587
"7782","WBGene00009820","X",10912118,10914081,1963
"7783","WBGene00009822","I",14054593,14056894,2301
"7784","WBGene00009823","I",14078193,14082643,4450
"7785","WBGene00009824","I",14075836,14078211,2375
"7786","WBGene00009825","I",14062749,14068803,6054
"7787","WBGene00009826","I",14060876,14062137,1261
"7788","WBGene00009827","I",14059411,14060829,1418
"7789","WBGene00009828","I",14052136,14054154,2018
"7790","WBGene00009829","V",11323965,11326964,2999
"7791","WBGene00009830","V",11313400,11316901,3501
"7792","WBGene00009831","V",11317214,11321786,4572
"7793","WBGene00009833","V",11329400,11330775,1375
"7794","WBGene00009834","V",17348665,17350180,1515
"7795","WBGene00009835","V",17353325,17360212,6887
"7796","WBGene00009836","V",17331570,17335546,3976
"7797","WBGene00009837","V",17336138,17338335,2197
"7798","WBGene00009838","V",17339084,17342780,3696
"7799","WBGene00009839","V",17343312,17348239,4927
"7800","WBGene00009840","V",17345228,17347775,2547
"7801","WBGene00009841","V",17350387,17352870,2483
"7802","WBGene00009842","X",11444424,11446635,2211
"7803","WBGene00009843","X",11451617,11454195,2578
"7804","WBGene00009844","X",13182463,13189961,7498
"7805","WBGene00009846","V",20440232,20446477,6245
"7806","WBGene00009848","V",20448288,20453202,4914
"7807","WBGene00009849","X",13963509,13965718,2209
"7808","WBGene00009850","X",13975660,13976920,1260
"7809","WBGene00009851","X",13977829,13979031,1202
"7810","WBGene00009852","X",13979240,13980515,1275
"7811","WBGene00009853","X",13980840,13981629,789
"7812","WBGene00009854","V",16856437,16858077,1640
"7813","WBGene00009855","V",16858429,16860040,1611
"7814","WBGene00009856","V",16862012,16863890,1878
"7815","WBGene00009857","V",16865704,16867226,1522
"7816","WBGene00009858","V",16870742,16871487,745
"7817","WBGene00009859","V",16867678,16869845,2167
"7818","WBGene00009860","V",16860228,16861869,1641
"7819","WBGene00009861","I",14298755,14299763,1008
"7820","WBGene00009862","I",14297287,14298265,978
"7821","WBGene00009863","I",14311009,14312871,1862
"7822","WBGene00009864","I",14316650,14318522,1872
"7823","WBGene00009865","I",14331085,14339831,8746
"7824","WBGene00009866","II",12536503,12538599,2096
"7825","WBGene00009867","II",12535760,12542569,6809
"7826","WBGene00009868","II",12546030,12546513,483
"7827","WBGene00009869","II",12566165,12568297,2132
"7828","WBGene00009871","IV",9294899,9296406,1507
"7829","WBGene00009872","IV",9298024,9299220,1196
"7830","WBGene00009873","IV",9300427,9301951,1524
"7831","WBGene00009874","IV",9302665,9304094,1429
"7832","WBGene00009875","IV",9304917,9307165,2248
"7833","WBGene00009876","IV",9307338,9309109,1771
"7834","WBGene00009877","IV",9309108,9312927,3819
"7835","WBGene00009878","IV",9314810,9316215,1405
"7836","WBGene00009879","IV",9318153,9319286,1133
"7837","WBGene00009880","IV",9319380,9320143,763
"7838","WBGene00009881","IV",9320122,9321089,967
"7839","WBGene00009882","IV",9321801,9322528,727
"7840","WBGene00009883","IV",9322489,9324145,1656
"7841","WBGene00009884","IV",9324435,9327516,3081
"7842","WBGene00009885","X",9561850,9565981,4131
"7843","WBGene00009886","X",9567296,9573723,6427
"7844","WBGene00009887","X",9573741,9575866,2125
"7845","WBGene00009888","X",9543670,9560801,17131
"7846","WBGene00009889","IV",13035956,13039021,3065
"7847","WBGene00009890","IV",13047197,13048262,1065
"7848","WBGene00009891","IV",13048457,13049835,1378
"7849","WBGene00009892","IV",13051377,13052149,772
"7850","WBGene00009893","IV",13053297,13055154,1857
"7851","WBGene00009894","IV",13055357,13055939,582
"7852","WBGene00009895","IV",13057678,13059085,1407
"7853","WBGene00009896","IV",13059618,13060695,1077
"7854","WBGene00009897","II",8400299,8404848,4549
"7855","WBGene00009898","II",8398161,8399160,999
"7856","WBGene00009899","II",8412671,8416857,4186
"7857","WBGene00009900","II",8395276,8396141,865
"7858","WBGene00009901","II",8392571,8394202,1631
"7859","WBGene00009902","II",8388051,8389891,1840
"7860","WBGene00009903","II",8391088,8392281,1193
"7861","WBGene00009904","II",8381497,8383905,2408
"7862","WBGene00009905","V",17010014,17011849,1835
"7863","WBGene00009906","V",17012127,17013332,1205
"7864","WBGene00009907","V",17014408,17015326,918
"7865","WBGene00009908","V",17023473,17025347,1874
"7866","WBGene00009909","V",17022370,17022663,293
"7867","WBGene00009910","V",17030738,17032772,2034
"7868","WBGene00009911","V",17036410,17037862,1452
"7869","WBGene00009912","V",17033218,17035950,2732
"7870","WBGene00009914","V",17008673,17009388,715
"7871","WBGene00009915","I",7317646,7318337,691
"7872","WBGene00009916","I",7322270,7324415,2145
"7873","WBGene00009917","I",7339204,7345949,6745
"7874","WBGene00009918","I",7345932,7347427,1495
"7875","WBGene00009919","I",7347222,7350386,3164
"7876","WBGene00009920","I",8296917,8307566,10649
"7877","WBGene00009921","I",8315898,8318250,2352
"7878","WBGene00009922","I",8318347,8323987,5640
"7879","WBGene00009923","I",8313228,8315432,2204
"7880","WBGene00009924","IV",14077441,14083559,6118
"7881","WBGene00009925","IV",14083318,14084695,1377
"7882","WBGene00009926","IV",14091254,14096617,5363
"7883","WBGene00009927","IV",14102095,14103231,1136
"7884","WBGene00009929","X",11585675,11589757,4082
"7885","WBGene00009930","X",11589686,11591719,2033
"7886","WBGene00009931","X",11617462,11619795,2333
"7887","WBGene00009933","X",16282806,16283203,397
"7888","WBGene00009934","X",16283803,16284069,266
"7889","WBGene00009935","X",16285598,16292990,7392
"7890","WBGene00009936","X",15297471,15297544,73
"7891","WBGene00009937","I",9901255,9902929,1674
"7892","WBGene00009938","I",9921211,9921961,750
"7893","WBGene00009939","I",9902943,9910545,7602
"7894","WBGene00009940","I",9928946,9930885,1939
"7895","WBGene00009941","I",9923610,9924280,670
"7896","WBGene00009942","I",9925978,9929032,3054
"7897","WBGene00009943","IV",13543402,13548230,4828
"7898","WBGene00009944","II",10030895,10033213,2318
"7899","WBGene00009945","II",10042780,10045270,2490
"7900","WBGene00009946","II",10041134,10042515,1381
"7901","WBGene00009947","II",10030195,10030970,775
"7902","WBGene00009948","II",10026595,10027966,1371
"7903","WBGene00009949","III",13322392,13324839,2447
"7904","WBGene00009950","III",13334600,13336422,1822
"7905","WBGene00009951","III",13336940,13339768,2828
"7906","WBGene00009952","III",13344917,13346866,1949
"7907","WBGene00009953","III",13356610,13359354,2744
"7908","WBGene00009954","IV",12517110,12518128,1018
"7909","WBGene00009955","IV",12524478,12525509,1031
"7910","WBGene00009956","IV",12528529,12531166,2637
"7911","WBGene00009957","IV",12526260,12527339,1079
"7912","WBGene00009958","I",8931035,8942287,11252
"7913","WBGene00009959","I",8947304,8948711,1407
"7914","WBGene00009960","I",8950448,8951053,605
"7915","WBGene00009961","I",8954559,8957482,2923
"7916","WBGene00009962","I",8948778,8954394,5616
"7917","WBGene00009963","I",8946686,8947201,515
"7918","WBGene00009964","I",8945533,8946205,672
"7919","WBGene00009965","V",10992099,10994817,2718
"7920","WBGene00009966","V",10999658,11000713,1055
"7921","WBGene00009967","V",11000957,11002534,1577
"7922","WBGene00009968","V",10970399,10981213,10814
"7923","WBGene00009969","V",10999102,10999642,540
"7924","WBGene00009971","V",13775751,13777767,2016
"7925","WBGene00009972","V",13778633,13781625,2992
"7926","WBGene00009973","V",13782399,13784102,1703
"7927","WBGene00009974","V",13784095,13787712,3617
"7928","WBGene00009975","V",13787536,13796254,8718
"7929","WBGene00009976","V",13800976,13804282,3306
"7930","WBGene00009977","V",13804395,13807237,2842
"7931","WBGene00009978","V",15652438,15668300,15862
"7932","WBGene00009979","V",13404031,13406014,1983
"7933","WBGene00009980","V",13406816,13408265,1449
"7934","WBGene00009981","V",13408242,13409832,1590
"7935","WBGene00009982","V",13411077,13411717,640
"7936","WBGene00009983","V",13414902,13416121,1219
"7937","WBGene00009984","V",13416103,13417604,1501
"7938","WBGene00009985","V",13584903,13585369,466
"7939","WBGene00009986","V",13588612,13589585,973
"7940","WBGene00009987","V",13592124,13593183,1059
"7941","WBGene00009988","V",13593383,13598269,4886
"7942","WBGene00009990","V",13612439,13613979,1540
"7943","WBGene00009991","V",13614236,13617723,3487
"7944","WBGene00009992","V",13624625,13625567,942
"7945","WBGene00009993","V",13622107,13624525,2418
"7946","WBGene00009994","V",13626031,13627482,1451
"7947","WBGene00009995","V",13611337,13611888,551
"7948","WBGene00009996","V",13627573,13629831,2258
"7949","WBGene00009997","V",13620976,13621459,483
"7950","WBGene00009998","V",20685683,20688770,3087
"7951","WBGene00009999","V",20681420,20683014,1594
"7952","WBGene00010000","V",20688734,20689532,798
"7953","WBGene00010001","V",20690582,20691685,1103
"7954","WBGene00010002","V",20700340,20704048,3708
"7955","WBGene00010003","V",20704537,20709794,5257
"7956","WBGene00010004","V",20387715,20393367,5652
"7957","WBGene00010005","V",20394073,20394700,627
"7958","WBGene00010006","V",20396078,20422035,25957
"7959","WBGene00010007","X",15857153,15857974,821
"7960","WBGene00010008","X",15885604,15887593,1989
"7961","WBGene00010009","X",15866411,15868764,2353
"7962","WBGene00010010","X",15879096,15885617,6521
"7963","WBGene00010011","X",15852935,15860608,7673
"7964","WBGene00010012","V",10852519,10865792,13273
"7965","WBGene00010013","II",10251266,10268168,16902
"7966","WBGene00010014","II",10268143,10270152,2009
"7967","WBGene00010015","II",10248991,10251165,2174
"7968","WBGene00010016","V",15810784,15811330,546
"7969","WBGene00010017","V",15812282,15813104,822
"7970","WBGene00010018","V",15814237,15815659,1422
"7971","WBGene00010019","V",15816464,15817143,679
"7972","WBGene00010020","V",15820283,15821383,1100
"7973","WBGene00010021","V",15821698,15822884,1186
"7974","WBGene00010022","V",15823898,15824966,1068
"7975","WBGene00010023","V",15826410,15827429,1019
"7976","WBGene00010024","V",15827823,15828882,1059
"7977","WBGene00010025","V",15832436,15833722,1286
"7978","WBGene00010026","V",15830586,15831686,1100
"7979","WBGene00010027","X",13592618,13593643,1025
"7980","WBGene00010028","X",13594121,13596068,1947
"7981","WBGene00010030","X",13600436,13601534,1098
"7982","WBGene00010031","X",13602200,13603918,1718
"7983","WBGene00010032","X",13605567,13608369,2802
"7984","WBGene00010033","X",13582120,13582757,637
"7985","WBGene00010034","X",13578783,13581728,2945
"7986","WBGene00010035","III",9439699,9440929,1230
"7987","WBGene00010036","III",9434057,9435100,1043
"7988","WBGene00010037","III",9441557,9443634,2077
"7989","WBGene00010038","III",9454163,9456030,1867
"7990","WBGene00010039","III",9444360,9449931,5571
"7991","WBGene00010040","III",9451595,9454062,2467
"7992","WBGene00010041","II",8566508,8566857,349
"7993","WBGene00010042","II",8571085,8572904,1819
"7994","WBGene00010043","II",8573355,8575045,1690
"7995","WBGene00010044","II",8578049,8581513,3464
"7996","WBGene00010045","II",8583034,8585086,2052
"7997","WBGene00010046","IV",11261844,11263075,1231
"7998","WBGene00010047","IV",11287811,11294913,7102
"7999","WBGene00010048","II",11573180,11575000,1820
"8000","WBGene00010049","II",11571805,11573025,1220
"8001","WBGene00010050","II",11569818,11571002,1184
"8002","WBGene00010051","II",11564385,11567020,2635
"8003","WBGene00010052","II",11547481,11549313,1832
"8004","WBGene00010053","II",11542636,11544875,2239
"8005","WBGene00010054","II",11540772,11542579,1807
"8006","WBGene00010055","II",11538904,11540630,1726
"8007","WBGene00010056","II",11578716,11582758,4042
"8008","WBGene00010057","II",11558715,11564227,5512
"8009","WBGene00010058","X",14625452,14628916,3464
"8010","WBGene00010059","X",14632092,14636472,4380
"8011","WBGene00010060","X",14641391,14645486,4095
"8012","WBGene00010061","IV",11333079,11337184,4105
"8013","WBGene00010062","V",12919952,12921692,1740
"8014","WBGene00010063","V",12922608,12924156,1548
"8015","WBGene00010064","X",11843663,11845337,1674
"8016","WBGene00010065","X",11849392,11850182,790
"8017","WBGene00010066","X",11865383,11866827,1444
"8018","WBGene00010067","X",11867971,11869360,1389
"8019","WBGene00010068","X",11853818,11854996,1178
"8020","WBGene00010069","II",13504082,13506905,2823
"8021","WBGene00010070","II",13507806,13516479,8673
"8022","WBGene00010071","II",13517912,13522925,5013
"8023","WBGene00010072","III",13049588,13055485,5897
"8024","WBGene00010073","III",13040100,13049434,9334
"8025","WBGene00010074","III",9155116,9157165,2049
"8026","WBGene00010075","V",11763140,11764382,1242
"8027","WBGene00010077","V",11770456,11773495,3039
"8028","WBGene00010079","V",11776838,11783422,6584
"8029","WBGene00010080","V",11784573,11787443,2870
"8030","WBGene00010081","V",11788157,11789121,964
"8031","WBGene00010082","V",11783340,11784616,1276
"8032","WBGene00010083","IV",14401114,14412894,11780
"8033","WBGene00010084","IV",14422268,14423294,1026
"8034","WBGene00010085","IV",14424693,14425859,1166
"8035","WBGene00010086","IV",14429574,14430920,1346
"8036","WBGene00010087","IV",14427695,14428464,769
"8037","WBGene00010088","V",13815374,13816977,1603
"8038","WBGene00010089","V",13823052,13825222,2170
"8039","WBGene00010091","V",12263369,12263896,527
"8040","WBGene00010092","V",12264002,12265492,1490
"8041","WBGene00010093","V",12271873,12275676,3803
"8042","WBGene00010094","V",12270271,12271551,1280
"8043","WBGene00010095","V",12279506,12281461,1955
"8044","WBGene00010096","V",12284060,12288615,4555
"8045","WBGene00010097","V",12288922,12291658,2736
"8046","WBGene00010098","V",12283487,12283999,512
"8047","WBGene00010099","V",19282614,19284594,1980
"8048","WBGene00010100","V",19287009,19288173,1164
"8049","WBGene00010101","V",19288755,19289889,1134
"8050","WBGene00010102","V",19290616,19291028,412
"8051","WBGene00010103","V",19293632,19296823,3191
"8052","WBGene00010104","V",19297810,19298749,939
"8053","WBGene00010105","V",19301076,19302034,958
"8054","WBGene00010106","V",19304126,19305072,946
"8055","WBGene00010107","V",19307242,19307583,341
"8056","WBGene00010108","V",11386698,11388678,1980
"8057","WBGene00010109","V",11383105,11384353,1248
"8058","WBGene00010110","I",7884319,7885769,1450
"8059","WBGene00010111","I",7889310,7894864,5554
"8060","WBGene00010112","I",7896125,7897725,1600
"8061","WBGene00010113","I",7906826,7914269,7443
"8062","WBGene00010114","I",7901932,7903243,1311
"8063","WBGene00010115","X",13755771,13759391,3620
"8064","WBGene00010116","X",13760237,13763998,3761
"8065","WBGene00010117","X",13765331,13770558,5227
"8066","WBGene00010118","X",13785479,13789238,3759
"8067","WBGene00010119","X",11924461,11927032,2571
"8068","WBGene00010120","X",11929899,11931646,1747
"8069","WBGene00010121","X",11940336,11942051,1715
"8070","WBGene00010122","IV",12944887,12946577,1690
"8071","WBGene00010123","IV",12967448,12969289,1841
"8072","WBGene00010124","IV",12973624,12975591,1967
"8073","WBGene00010125","IV",12965387,12967318,1931
"8074","WBGene00010126","IV",12958030,12959594,1564
"8075","WBGene00010127","IV",12960436,12962120,1684
"8076","WBGene00010128","IV",12962808,12964625,1817
"8077","WBGene00010129","IV",12948770,12950075,1305
"8078","WBGene00010130","III",9508074,9509806,1732
"8079","WBGene00010131","III",9511470,9513375,1905
"8080","WBGene00010132","III",9513348,9516248,2900
"8081","WBGene00010133","I",8866907,8868293,1386
"8082","WBGene00010134","I",8876319,8893051,16732
"8083","WBGene00010135","I",8893308,8894137,829
"8084","WBGene00010136","I",8869709,8871698,1989
"8085","WBGene00010137","I",8853686,8861274,7588
"8086","WBGene00010138","III",13246578,13253615,7037
"8087","WBGene00010139","III",13256878,13262905,6027
"8088","WBGene00010140","III",13263268,13265038,1770
"8089","WBGene00010141","III",13265866,13266932,1066
"8090","WBGene00010142","III",13285817,13286779,962
"8091","WBGene00010143","V",14376099,14379066,2967
"8092","WBGene00010144","IV",10637060,10639213,2153
"8093","WBGene00010145","IV",10639277,10642690,3413
"8094","WBGene00010146","IV",10642912,10654147,11235
"8095","WBGene00010147","IV",9396920,9398603,1683
"8096","WBGene00010148","IV",9399653,9401293,1640
"8097","WBGene00010149","IV",9407213,9408121,908
"8098","WBGene00010150","IV",9401922,9412653,10731
"8099","WBGene00010152","IV",9418432,9422506,4074
"8100","WBGene00010153","IV",9423395,9424415,1020
"8101","WBGene00010155","III",4468878,4470808,1930
"8102","WBGene00010157","I",11342087,11347288,5201
"8103","WBGene00010158","I",11358167,11359301,1134
"8104","WBGene00010159","I",11374620,11380127,5507
"8105","WBGene00010160","I",11380231,11388751,8520
"8106","WBGene00010161","I",11364321,11374334,10013
"8107","WBGene00010162","I",12281221,12282615,1394
"8108","WBGene00010163","I",12287199,12289307,2108
"8109","WBGene00010164","I",12289552,12290191,639
"8110","WBGene00010165","I",12290449,12292212,1763
"8111","WBGene00010166","I",12292269,12293936,1667
"8112","WBGene00010167","I",12294380,12296263,1883
"8113","WBGene00010168","I",12297734,12300817,3083
"8114","WBGene00010169","I",12301424,12303157,1733
"8115","WBGene00010170","I",12303599,12306820,3221
"8116","WBGene00010171","I",12307731,12310406,2675
"8117","WBGene00010172","I",12312335,12314895,2560
"8118","WBGene00010173","I",12283270,12285384,2114
"8119","WBGene00010174","V",12637663,12638237,574
"8120","WBGene00010175","IV",9531357,9533171,1814
"8121","WBGene00010176","IV",9528355,9529569,1214
"8122","WBGene00010177","V",10037340,10048726,11386
"8123","WBGene00010178","V",10050047,10054913,4866
"8124","WBGene00010179","V",10067087,10068818,1731
"8125","WBGene00010180","V",10069369,10070641,1272
"8126","WBGene00010181","V",10071945,10073893,1948
"8127","WBGene00010182","V",10075749,10077804,2055
"8128","WBGene00010183","V",10064503,10064939,436
"8129","WBGene00010184","V",15766575,15767272,697
"8130","WBGene00010185","V",15769438,15770371,933
"8131","WBGene00010186","V",15774946,15776676,1730
"8132","WBGene00010187","V",13193933,13195648,1715
"8133","WBGene00010188","V",13207763,13208762,999
"8134","WBGene00010189","V",13209645,13213462,3817
"8135","WBGene00010191","V",11438770,11441618,2848
"8136","WBGene00010192","V",11441925,11443603,1678
"8137","WBGene00010193","II",14522385,14523522,1137
"8138","WBGene00010194","II",14520868,14522137,1269
"8139","WBGene00010195","II",14524173,14525112,939
"8140","WBGene00010196","II",14525312,14526031,719
"8141","WBGene00010197","II",14526213,14528296,2083
"8142","WBGene00010198","II",14528754,14534173,5419
"8143","WBGene00010199","X",10569273,10575718,6445
"8144","WBGene00010200","X",10581062,10589538,8476
"8145","WBGene00010202","V",16481580,16482000,420
"8146","WBGene00010203","V",16482420,16483144,724
"8147","WBGene00010204","V",12003028,12004600,1572
"8148","WBGene00010205","V",12004616,12006605,1989
"8149","WBGene00010206","V",17623530,17624559,1029
"8150","WBGene00010209","V",17637982,17640042,2060
"8151","WBGene00010212","V",17640672,17650527,9855
"8152","WBGene00010214","V",16339024,16341536,2512
"8153","WBGene00010215","V",16342497,16344272,1775
"8154","WBGene00010216","V",16329370,16330242,872
"8155","WBGene00010217","II",12406822,12408817,1995
"8156","WBGene00010218","II",12404951,12406494,1543
"8157","WBGene00010219","II",12409320,12410207,887
"8158","WBGene00010220","II",12399399,12401891,2492
"8159","WBGene00010221","X",12169092,12171681,2589
"8160","WBGene00010222","X",12156407,12160039,3632
"8161","WBGene00010223","X",11012662,11014412,1750
"8162","WBGene00010224","X",11009558,11010640,1082
"8163","WBGene00010225","X",11008266,11009070,804
"8164","WBGene00010226","III",9598475,9600049,1574
"8165","WBGene00010227","III",9600038,9600745,707
"8166","WBGene00010228","III",9603030,9608688,5658
"8167","WBGene00010229","III",9614425,9615332,907
"8168","WBGene00010230","III",9629246,9629917,671
"8169","WBGene00010231","IV",11628757,11631850,3093
"8170","WBGene00010232","IV",11636648,11638208,1560
"8171","WBGene00010233","IV",11638316,11640097,1781
"8172","WBGene00010234","IV",11640047,11641015,968
"8173","WBGene00010235","V",10917648,10918401,753
"8174","WBGene00010236","V",10929811,10930774,963
"8175","WBGene00010237","V",10930778,10931289,511
"8176","WBGene00010238","V",10932647,10934245,1598
"8177","WBGene00010239","V",10925322,10926796,1474
"8178","WBGene00010240","IV",13183072,13186984,3912
"8179","WBGene00010241","IV",13189717,13192349,2632
"8180","WBGene00010242","I",12066010,12068668,2658
"8181","WBGene00010243","I",12069806,12072878,3072
"8182","WBGene00010244","I",12041035,12045200,4165
"8183","WBGene00010245","I",12034072,12037230,3158
"8184","WBGene00010246","I",12032289,12033706,1417
"8185","WBGene00010247","I",12029927,12031762,1835
"8186","WBGene00010248","I",12045201,12046617,1416
"8187","WBGene00010250","V",14057840,14064529,6689
"8188","WBGene00010251","V",9741206,9744326,3120
"8189","WBGene00010253","V",9749971,9750408,437
"8190","WBGene00010254","V",9753423,9754581,1158
"8191","WBGene00010255","V",9752076,9752861,785
"8192","WBGene00010256","V",9756485,9757019,534
"8193","WBGene00010257","V",9755076,9755808,732
"8194","WBGene00010258","V",9756954,9757984,1030
"8195","WBGene00010259","V",13987166,14006079,18913
"8196","WBGene00010260","V",14008768,14012218,3450
"8197","WBGene00010261","V",14015978,14017576,1598
"8198","WBGene00010262","V",13992660,13993476,816
"8199","WBGene00010263","II",12919551,12923377,3826
"8200","WBGene00010264","II",12915417,12919018,3601
"8201","WBGene00010265","II",12925981,12928341,2360
"8202","WBGene00010266","II",12931873,12933515,1642
"8203","WBGene00010267","II",12933854,12935362,1508
"8204","WBGene00010268","II",12938869,12943867,4998
"8205","WBGene00010269","II",12943862,12948143,4281
"8206","WBGene00010270","II",12925304,12925602,298
"8207","WBGene00010271","II",12924026,12925241,1215
"8208","WBGene00010272","IV",9644245,9647934,3689
"8209","WBGene00010273","IV",9648982,9650490,1508
"8210","WBGene00010274","IV",9653535,9654175,640
"8211","WBGene00010275","IV",9658053,9663941,5888
"8212","WBGene00010277","IV",9654317,9655588,1271
"8213","WBGene00010278","IV",9643422,9644268,846
"8214","WBGene00010279","V",13661261,13664233,2972
"8215","WBGene00010280","V",13665397,13669292,3895
"8216","WBGene00010281","V",13669353,13671958,2605
"8217","WBGene00010282","V",13672597,13676024,3427
"8218","WBGene00010283","V",13678875,13681539,2664
"8219","WBGene00010284","V",11927661,11933246,5585
"8220","WBGene00010285","V",11929073,11929993,920
"8221","WBGene00010286","V",11933881,11935052,1171
"8222","WBGene00010288","V",11958393,11962699,4306
"8223","WBGene00010289","V",11942625,11944656,2031
"8224","WBGene00010290","V",11963007,11964821,1814
"8225","WBGene00010291","I",7755778,7756353,575
"8226","WBGene00010292","V",17685192,17686074,882
"8227","WBGene00010293","V",17656892,17658198,1306
"8228","WBGene00010294","V",17655581,17656654,1073
"8229","WBGene00010295","V",17653482,17655281,1799
"8230","WBGene00010296","V",17660303,17661810,1507
"8231","WBGene00010297","V",17661802,17665475,3673
"8232","WBGene00010298","V",17666075,17667776,1701
"8233","WBGene00010299","V",17687211,17690994,3783
"8234","WBGene00010300","V",17680661,17683872,3211
"8235","WBGene00010301","V",17684149,17684968,819
"8236","WBGene00010303","III",3396585,3397675,1090
"8237","WBGene00010304","III",3397743,3400644,2901
"8238","WBGene00010305","III",3404863,3405469,606
"8239","WBGene00010306","III",3405570,3425447,19877
"8240","WBGene00010307","III",8994645,8996786,2141
"8241","WBGene00010309","III",8999828,9001973,2145
"8242","WBGene00010310","III",9007974,9010121,2147
"8243","WBGene00010311","III",9010676,9012409,1733
"8244","WBGene00010313","III",9013003,9016961,3958
"8245","WBGene00010314","III",9017607,9020960,3353
"8246","WBGene00010315","III",9023964,9027044,3080
"8247","WBGene00010316","IV",9428259,9439077,10818
"8248","WBGene00010317","IV",9439043,9440893,1850
"8249","WBGene00010318","II",10507269,10509932,2663
"8250","WBGene00010319","II",10510542,10512991,2449
"8251","WBGene00010320","II",10513827,10519108,5281
"8252","WBGene00010321","II",10521788,10523191,1403
"8253","WBGene00010322","II",10523274,10524474,1200
"8254","WBGene00010323","I",10522091,10523996,1905
"8255","WBGene00010324","I",10524424,10525509,1085
"8256","WBGene00010325","I",10518379,10519263,884
"8257","WBGene00010326","I",10519360,10520761,1401
"8258","WBGene00010327","I",10508966,10513396,4430
"8259","WBGene00010328","I",10532667,10534484,1817
"8260","WBGene00010329","X",15666761,15672363,5602
"8261","WBGene00010330","X",15672743,15675722,2979
"8262","WBGene00010331","X",15648263,15650905,2642
"8263","WBGene00010332","X",15646380,15647369,989
"8264","WBGene00010333","II",10872879,10873796,917
"8265","WBGene00010334","X",11004984,11008181,3197
"8266","WBGene00010335","X",10998004,10999276,1272
"8267","WBGene00010336","X",15834052,15838546,4494
"8268","WBGene00010337","X",15841572,15842379,807
"8269","WBGene00010338","X",15842356,15847593,5237
"8270","WBGene00010339","X",15849885,15851771,1886
"8271","WBGene00010340","X",10529294,10532677,3383
"8272","WBGene00010341","X",10533699,10537114,3415
"8273","WBGene00010342","X",10537141,10542423,5282
"8274","WBGene00010343","X",10543042,10543410,368
"8275","WBGene00010344","X",10546062,10548962,2900
"8276","WBGene00010345","X",10559503,10566668,7165
"8277","WBGene00010348","IV",11803273,11804152,879
"8278","WBGene00010349","IV",11798667,11801088,2421
"8279","WBGene00010350","IV",11783941,11792593,8652
"8280","WBGene00010351","IV",11372991,11377627,4636
"8281","WBGene00010352","IV",11378174,11379348,1174
"8282","WBGene00010353","IV",11401884,11403338,1454
"8283","WBGene00010354","IV",11403961,11406066,2105
"8284","WBGene00010355","V",15340136,15341446,1310
"8285","WBGene00010356","X",15209289,15213259,3970
"8286","WBGene00010357","X",15225869,15230645,4776
"8287","WBGene00010358","X",15053883,15054652,769
"8288","WBGene00010359","X",15067476,15069342,1866
"8289","WBGene00010360","X",15058509,15060399,1890
"8290","WBGene00010361","X",15055500,15056822,1322
"8291","WBGene00010362","III",10436609,10438089,1480
"8292","WBGene00010363","III",10439339,10442405,3066
"8293","WBGene00010364","III",10443090,10445136,2046
"8294","WBGene00010365","III",10445805,10451112,5307
"8295","WBGene00010366","I",7972473,7977078,4605
"8296","WBGene00010367","I",7984889,7993159,8270
"8297","WBGene00010368","X",13507564,13510094,2530
"8298","WBGene00010369","I",7009139,7015212,6073
"8299","WBGene00010370","I",7005443,7009190,3747
"8300","WBGene00010371","I",7002870,7003481,611
"8301","WBGene00010372","X",15642938,15644336,1398
"8302","WBGene00010373","IV",13834286,13836390,2104
"8303","WBGene00010374","IV",13827886,13844997,17111
"8304","WBGene00010375","V",10612926,10615511,2585
"8305","WBGene00010378","V",14887685,14888477,792
"8306","WBGene00010380","V",14891450,14893435,1985
"8307","WBGene00010381","V",14894053,14894798,745
"8308","WBGene00010382","V",14897340,14897831,491
"8309","WBGene00010383","V",14895647,14899013,3366
"8310","WBGene00010385","V",14901567,14909478,7911
"8311","WBGene00010386","V",14899791,14911929,12138
"8312","WBGene00010387","V",14915906,14917682,1776
"8313","WBGene00010388","IV",14129391,14131061,1670
"8314","WBGene00010389","IV",14137363,14140294,2931
"8315","WBGene00010390","IV",14142081,14143873,1792
"8316","WBGene00010391","IV",14145665,14148869,3204
"8317","WBGene00010392","IV",14150331,14153361,3030
"8318","WBGene00010394","IV",14132070,14134330,2260
"8319","WBGene00010395","IV",14154294,14154912,618
"8320","WBGene00010396","X",15488106,15491987,3881
"8321","WBGene00010397","X",15497555,15500279,2724
"8322","WBGene00010401","I",12638730,12640485,1755
"8323","WBGene00010402","I",12641603,12642187,584
"8324","WBGene00010403","X",12266912,12270941,4029
"8325","WBGene00010404","X",12273638,12274691,1053
"8326","WBGene00010405","V",11110063,11113103,3040
"8327","WBGene00010406","V",11113914,11118818,4904
"8328","WBGene00010407","V",11118721,11119730,1009
"8329","WBGene00010408","V",11119813,11122579,2766
"8330","WBGene00010409","IV",11480846,11482437,1591
"8331","WBGene00010410","IV",9284893,9286446,1553
"8332","WBGene00010411","IV",16202374,16205321,2947
"8333","WBGene00010412","IV",16210723,16211013,290
"8334","WBGene00010413","IV",16226047,16227122,1075
"8335","WBGene00010414","IV",16230452,16233128,2676
"8336","WBGene00010415","IV",16233148,16236555,3407
"8337","WBGene00010416","I",11311516,11323110,11594
"8338","WBGene00010418","V",10602458,10605568,3110
"8339","WBGene00010419","I",12652277,12654646,2369
"8340","WBGene00010420","I",12647376,12652087,4711
"8341","WBGene00010421","I",9149474,9153252,3778
"8342","WBGene00010422","I",9154228,9154789,561
"8343","WBGene00010423","X",12647117,12651487,4370
"8344","WBGene00010424","X",12652591,12653520,929
"8345","WBGene00010425","V",13650262,13654129,3867
"8346","WBGene00010426","V",13629798,13634220,4422
"8347","WBGene00010427","I",7140278,7147230,6952
"8348","WBGene00010428","III",4313927,4317608,3681
"8349","WBGene00010429","III",4322969,4323466,497
"8350","WBGene00010430","X",12938182,12938253,71
"8351","WBGene00010431","X",12942458,12942539,81
"8352","WBGene00010432","V",14110361,14112027,1666
"8353","WBGene00010433","X",15080779,15084086,3307
"8354","WBGene00010434","X",15069743,15076480,6737
"8355","WBGene00010435","IV",13232943,13236585,3642
"8356","WBGene00010436","IV",13243673,13244296,623
"8357","WBGene00010437","IV",13244324,13247160,2836
"8358","WBGene00010439","IV",13247261,13250699,3438
"8359","WBGene00010440","IV",13250648,13252311,1663
"8360","WBGene00010442","IV",13256051,13259076,3025
"8361","WBGene00010444","IV",11715039,11729276,14237
"8362","WBGene00010446","IV",11739095,11740284,1189
"8363","WBGene00010447","IV",11742706,11743789,1083
"8364","WBGene00010448","IV",11735325,11742305,6980
"8365","WBGene00010449","III",3428080,3431366,3286
"8366","WBGene00010450","III",3425736,3428094,2358
"8367","WBGene00010451","III",3447140,3452613,5473
"8368","WBGene00010453","III",9281785,9296668,14883
"8369","WBGene00010454","III",9300219,9303928,3709
"8370","WBGene00010455","III",9296627,9297394,767
"8371","WBGene00010456","II",8264661,8267360,2699
"8372","WBGene00010457","II",8267253,8269914,2661
"8373","WBGene00010458","II",8277531,8278515,984
"8374","WBGene00010459","II",8276298,8277611,1313
"8375","WBGene00010460","II",8278686,8281035,2349
"8376","WBGene00010461","V",12377556,12378832,1276
"8377","WBGene00010463","V",12381254,12385623,4369
"8378","WBGene00010464","V",12397845,12398783,938
"8379","WBGene00010465","V",12398759,12400859,2100
"8380","WBGene00010466","V",12401151,12401894,743
"8381","WBGene00010467","V",12402655,12403234,579
"8382","WBGene00010468","V",12403942,12404651,709
"8383","WBGene00010469","V",12406229,12407017,788
"8384","WBGene00010470","V",12407428,12408592,1164
"8385","WBGene00010471","V",12412506,12413698,1192
"8386","WBGene00010472","V",12410879,12412091,1212
"8387","WBGene00010473","V",12409369,12410513,1144
"8388","WBGene00010474","V",12386286,12386765,479
"8389","WBGene00010475","III",8870099,8877128,7029
"8390","WBGene00010476","III",10755624,10757640,2016
"8391","WBGene00010477","III",10750466,10751930,1464
"8392","WBGene00010478","III",10748429,10750080,1651
"8393","WBGene00010479","III",10740280,10740772,492
"8394","WBGene00010480","III",10759290,10763006,3716
"8395","WBGene00010481","III",10757641,10758522,881
"8396","WBGene00010483","IV",14193430,14195989,2559
"8397","WBGene00010484","IV",9707148,9707764,616
"8398","WBGene00010485","IV",9708170,9709305,1135
"8399","WBGene00010486","IV",9713082,9714886,1804
"8400","WBGene00010487","I",9744242,9745990,1748
"8401","WBGene00010488","I",9745967,9747923,1956
"8402","WBGene00010491","II",14694192,14695299,1107
"8403","WBGene00010492","X",13927036,13929634,2598
"8404","WBGene00010493","X",13922663,13926129,3466
"8405","WBGene00010494","X",13930898,13932033,1135
"8406","WBGene00010495","I",8511600,8512505,905
"8407","WBGene00010496","I",8509041,8511412,2371
"8408","WBGene00010497","I",8513919,8517535,3616
"8409","WBGene00010498","I",8517481,8526621,9140
"8410","WBGene00010499","I",8518902,8519510,608
"8411","WBGene00010500","I",8526758,8529271,2513
"8412","WBGene00010501","II",8075760,8076836,1076
"8413","WBGene00010502","II",8080789,8086849,6060
"8414","WBGene00010503","II",8078457,8080847,2390
"8415","WBGene00010504","X",13706928,13708002,1074
"8416","WBGene00010505","X",13708619,13711964,3345
"8417","WBGene00010506","V",20351500,20354905,3405
"8418","WBGene00010507","V",20380561,20382036,1475
"8419","WBGene00010508","V",20384769,20391009,6240
"8420","WBGene00010509","V",20365708,20366939,1231
"8421","WBGene00010510","V",14232281,14236076,3795
"8422","WBGene00010511","V",14244204,14246104,1900
"8423","WBGene00010512","V",14246276,14246909,633
"8424","WBGene00010513","V",14247476,14248137,661
"8425","WBGene00010514","V",14252361,14253273,912
"8426","WBGene00010515","V",14249054,14251510,2456
"8427","WBGene00010516","V",14253488,14254321,833
"8428","WBGene00010517","V",14239523,14239841,318
"8429","WBGene00010518","V",14248854,14250523,1669
"8430","WBGene00010519","X",13051796,13055395,3599
"8431","WBGene00010520","X",13067279,13068239,960
"8432","WBGene00010521","X",13078172,13082045,3873
"8433","WBGene00010522","X",13064168,13066936,2768
"8434","WBGene00010523","V",11394786,11395124,338
"8435","WBGene00010524","V",11407523,11409543,2020
"8436","WBGene00010525","V",11409467,11411019,1552
"8437","WBGene00010526","V",11390273,11390494,221
"8438","WBGene00010527","IV",16329459,16331059,1600
"8439","WBGene00010528","IV",16328135,16328614,479
"8440","WBGene00010529","IV",16326718,16327965,1247
"8441","WBGene00010530","IV",16321166,16323195,2029
"8442","WBGene00010531","IV",16320139,16320506,367
"8443","WBGene00010534","V",17492077,17493832,1755
"8444","WBGene00010535","V",17489502,17490900,1398
"8445","WBGene00010536","V",17487346,17487805,459
"8446","WBGene00010537","I",14118753,14127199,8446
"8447","WBGene00010538","III",9925630,9926740,1110
"8448","WBGene00010539","III",9927732,9929004,1272
"8449","WBGene00010540","III",9932398,9939712,7314
"8450","WBGene00010541","III",9929058,9930413,1355
"8451","WBGene00010542","III",9947405,9948172,767
"8452","WBGene00010543","III",9945395,9946663,1268
"8453","WBGene00010544","III",9940771,9941464,693
"8454","WBGene00010545","III",9923174,9925443,2269
"8455","WBGene00010546","III",9950381,9951964,1583
"8456","WBGene00010547","III",9941624,9942345,721
"8457","WBGene00010550","II",14434419,14438977,4558
"8458","WBGene00010551","II",14441409,14447219,5810
"8459","WBGene00010552","X",14238695,14241350,2655
"8460","WBGene00010553","X",14241572,14243395,1823
"8461","WBGene00010554","X",14245650,14246623,973
"8462","WBGene00010555","X",14248053,14249846,1793
"8463","WBGene00010556","IV",10176680,10178099,1419
"8464","WBGene00010557","IV",10177968,10180304,2336
"8465","WBGene00010558","IV",10183851,10194424,10573
"8466","WBGene00010559","IV",10204185,10206073,1888
"8467","WBGene00010560","I",8026606,8028752,2146
"8468","WBGene00010562","I",8032863,8035696,2833
"8469","WBGene00010563","I",8035798,8037141,1343
"8470","WBGene00010564","I",8036944,8039752,2808
"8471","WBGene00010565","I",8040799,8043277,2478
"8472","WBGene00010566","I",8047345,8049351,2006
"8473","WBGene00010567","I",8055459,8057029,1570
"8474","WBGene00010568","I",8059782,8060558,776
"8475","WBGene00010569","I",8039879,8040526,647
"8476","WBGene00010570","X",14335498,14336657,1159
"8477","WBGene00010571","X",14345338,14347574,2236
"8478","WBGene00010572","X",14350140,14352366,2226
"8479","WBGene00010573","III",9347714,9355480,7766
"8480","WBGene00010574","III",9360269,9361333,1064
"8481","WBGene00010575","III",9361528,9365380,3852
"8482","WBGene00010576","I",14251061,14252362,1301
"8483","WBGene00010577","I",14252957,14255510,2553
"8484","WBGene00010578","I",14255684,14256970,1286
"8485","WBGene00010579","I",14720588,14721979,1391
"8486","WBGene00010580","I",14748538,14753138,4600
"8487","WBGene00010581","I",14735236,14736945,1709
"8488","WBGene00010582","I",14742765,14747789,5024
"8489","WBGene00010583","I",14737702,14738796,1094
"8490","WBGene00010584","I",14732426,14733549,1123
"8491","WBGene00010585","I",14726804,14730719,3915
"8492","WBGene00010586","I",14725296,14726131,835
"8493","WBGene00010587","I",14721763,14724739,2976
"8494","WBGene00010588","V",16183657,16184723,1066
"8495","WBGene00010589","V",16173743,16175857,2114
"8496","WBGene00010590","V",16182410,16183540,1130
"8497","WBGene00010591","V",16170315,16171821,1506
"8498","WBGene00010592","V",9484206,9489033,4827
"8499","WBGene00010593","V",9497042,9499372,2330
"8500","WBGene00010594","V",9501401,9504580,3179
"8501","WBGene00010595","V",9505603,9507049,1446
"8502","WBGene00010596","V",9480472,9480923,451
"8503","WBGene00010597","V",9490028,9491715,1687
"8504","WBGene00010598","V",15672758,15673181,423
"8505","WBGene00010599","V",15669170,15670091,921
"8506","WBGene00010600","V",15686090,15687590,1500
"8507","WBGene00010601","V",15690204,15691606,1402
"8508","WBGene00010602","V",15687960,15689759,1799
"8509","WBGene00010603","V",15693994,15696217,2223
"8510","WBGene00010604","V",15698528,15699899,1371
"8511","WBGene00010605","X",14214939,14219089,4150
"8512","WBGene00010606","X",14225573,14228768,3195
"8513","WBGene00010607","X",14219568,14223256,3688
"8514","WBGene00010608","I",9582682,9583533,851
"8515","WBGene00010609","I",9585317,9587206,1889
"8516","WBGene00010610","I",9587169,9588132,963
"8517","WBGene00010611","I",9588710,9589931,1221
"8518","WBGene00010612","I",9590506,9591821,1315
"8519","WBGene00010613","I",9591939,9593103,1164
"8520","WBGene00010614","I",9595276,9598363,3087
"8521","WBGene00010615","I",9611815,9615082,3267
"8522","WBGene00010616","I",9615195,9616474,1279
"8523","WBGene00010617","I",9583869,9584817,948
"8524","WBGene00010618","I",9604810,9605179,369
"8525","WBGene00010619","I",9608926,9609705,779
"8526","WBGene00010620","I",8666595,8669792,3197
"8527","WBGene00010621","I",8676666,8681325,4659
"8528","WBGene00010622","I",8687634,8690937,3303
"8529","WBGene00010623","I",8693451,8695159,1708
"8530","WBGene00010624","I",8691039,8692622,1583
"8531","WBGene00010625","V",10339500,10340971,1471
"8532","WBGene00010626","V",10343032,10345489,2457
"8533","WBGene00010627","V",10350471,10352978,2507
"8534","WBGene00010628","V",10356285,10357903,1618
"8535","WBGene00010629","V",10353584,10355837,2253
"8536","WBGene00010630","V",10358544,10361430,2886
"8537","WBGene00010631","V",10362261,10366014,3753
"8538","WBGene00010632","V",10346662,10350154,3492
"8539","WBGene00010633","IV",9844014,9844344,330
"8540","WBGene00010634","IV",9844989,9846674,1685
"8541","WBGene00010636","IV",9848491,9849796,1305
"8542","WBGene00010637","IV",9856012,9858067,2055
"8543","WBGene00010638","IV",9862221,9864076,1855
"8544","WBGene00010639","IV",9865738,9866086,348
"8545","WBGene00010640","IV",9864179,9864954,775
"8546","WBGene00010641","I",7152463,7156868,4405
"8547","WBGene00010642","I",7161016,7166518,5502
"8548","WBGene00010643","I",7166932,7168783,1851
"8549","WBGene00010644","I",7169997,7172189,2192
"8550","WBGene00010645","I",7149937,7151887,1950
"8551","WBGene00010646","IV",10656874,10660774,3900
"8552","WBGene00010647","IV",10679383,10680475,1092
"8553","WBGene00010648","IV",10684432,10685894,1462
"8554","WBGene00010649","IV",10664412,10665685,1273
"8555","WBGene00010650","I",11484778,11486598,1820
"8556","WBGene00010651","I",11486895,11488471,1576
"8557","WBGene00010652","I",11483392,11484571,1179
"8558","WBGene00010653","I",11498914,11499655,741
"8559","WBGene00010654","I",11495521,11496245,724
"8560","WBGene00010655","IV",12892513,12893283,770
"8561","WBGene00010656","IV",12903117,12903644,527
"8562","WBGene00010657","IV",12903785,12906659,2874
"8563","WBGene00010658","IV",12907469,12909998,2529
"8564","WBGene00010659","IV",12910647,12912145,1498
"8565","WBGene00010660","IV",12887102,12890508,3406
"8566","WBGene00010661","III",13744222,13747287,3065
"8567","WBGene00010662","III",13747472,13748686,1214
"8568","WBGene00010663","III",13755896,13759434,3538
"8569","WBGene00010664","III",13759444,13762069,2625
"8570","WBGene00010665","III",13764030,13768092,4062
"8571","WBGene00010666","IV",12055670,12056656,986
"8572","WBGene00010667","IV",12057626,12059951,2325
"8573","WBGene00010669","IV",12068890,12074914,6024
"8574","WBGene00010670","IV",12077107,12078162,1055
"8575","WBGene00010671","IV",12563775,12566111,2336
"8576","WBGene00010672","IV",12570706,12571147,441
"8577","WBGene00010673","IV",12573370,12578870,5500
"8578","WBGene00010674","IV",12579055,12581128,2073
"8579","WBGene00010675","IV",12585192,12586216,1024
"8580","WBGene00010676","IV",10122120,10126675,4555
"8581","WBGene00010677","IV",10126749,10128956,2207
"8582","WBGene00010678","IV",10129257,10130244,987
"8583","WBGene00010679","IV",10134932,10135887,955
"8584","WBGene00010680","IV",10138124,10139104,980
"8585","WBGene00010681","II",8743725,8747234,3509
"8586","WBGene00010682","II",8767185,8769307,2122
"8587","WBGene00010683","II",8754113,8755248,1135
"8588","WBGene00010684","V",15137273,15139888,2615
"8589","WBGene00010685","V",15134188,15136801,2613
"8590","WBGene00010686","V",15140547,15143923,3376
"8591","WBGene00010687","V",15144019,15146435,2416
"8592","WBGene00010688","V",15861452,15862699,1247
"8593","WBGene00010689","X",13234099,13234957,858
"8594","WBGene00010690","X",13237389,13238476,1087
"8595","WBGene00010691","X",13238651,13240003,1352
"8596","WBGene00010692","X",13241109,13242278,1169
"8597","WBGene00010693","X",13247263,13248426,1163
"8598","WBGene00010694","X",13228669,13232328,3659
"8599","WBGene00010697","V",10004755,10007482,2727
"8600","WBGene00010698","V",9993732,9995883,2151
"8601","WBGene00010699","V",9991812,9992792,980
"8602","WBGene00010700","X",15607969,15610631,2662
"8603","WBGene00010701","X",15601067,15603763,2696
"8604","WBGene00010702","X",15591368,15595387,4019
"8605","WBGene00010703","X",15577470,15586803,9333
"8606","WBGene00010704","X",13262495,13264589,2094
"8607","WBGene00010705","X",13265041,13267338,2297
"8608","WBGene00010706","X",13267562,13269697,2135
"8609","WBGene00010707","X",13271877,13274218,2341
"8610","WBGene00010708","X",13275315,13278976,3661
"8611","WBGene00010709","IV",13422500,13429379,6879
"8612","WBGene00010711","IV",13429466,13430102,636
"8613","WBGene00010712","IV",13431288,13434068,2780
"8614","WBGene00010713","IV",13445819,13454954,9135
"8615","WBGene00010714","IV",13434188,13445375,11187
"8616","WBGene00010715","X",10959568,10960937,1369
"8617","WBGene00010716","X",10966551,10969898,3347
"8618","WBGene00010717","X",10950708,10951393,685
"8619","WBGene00010718","X",10970963,10972107,1144
"8620","WBGene00010719","II",14137838,14140069,2231
"8621","WBGene00010720","II",14127687,14132833,5146
"8622","WBGene00010721","II",14123945,14126941,2996
"8623","WBGene00010722","II",14114213,14122165,7952
"8624","WBGene00010723","II",14108016,14109635,1619
"8625","WBGene00010724","X",15620489,15626629,6140
"8626","WBGene00010725","X",15613805,15616519,2714
"8627","WBGene00010726","X",15611824,15613791,1967
"8628","WBGene00010727","V",9583545,9590523,6978
"8629","WBGene00010728","V",9590617,9591255,638
"8630","WBGene00010730","I",9850020,9851791,1771
"8631","WBGene00010731","I",9853658,9863492,9834
"8632","WBGene00010732","I",9863588,9869055,5467
"8633","WBGene00010733","V",15479985,15480056,71
"8634","WBGene00010734","V",12692486,12695255,2769
"8635","WBGene00010735","V",12680107,12692364,12257
"8636","WBGene00010736","V",12697794,12704273,6479
"8637","WBGene00010737","V",12696225,12696877,652
"8638","WBGene00010738","I",7134738,7139973,5235
"8639","WBGene00010740","I",7116092,7116889,797
"8640","WBGene00010741","V",11191283,11193638,2355
"8641","WBGene00010742","V",11193733,11196010,2277
"8642","WBGene00010743","V",11200665,11201392,727
"8643","WBGene00010744","V",11201905,11216774,14869
"8644","WBGene00010745","IV",12976231,12978343,2112
"8645","WBGene00010746","IV",12979017,12981940,2923
"8646","WBGene00010747","IV",12982119,12986088,3969
"8647","WBGene00010748","IV",12992157,12994462,2305
"8648","WBGene00010749","IV",12989685,12991843,2158
"8649","WBGene00010750","IV",12986726,12989455,2729
"8650","WBGene00010752","V",17264066,17264955,889
"8651","WBGene00010753","V",17278367,17285169,6802
"8652","WBGene00010754","V",17298341,17301475,3134
"8653","WBGene00010755","III",10295137,10298687,3550
"8654","WBGene00010756","III",10285923,10288621,2698
"8655","WBGene00010757","III",10279127,10281476,2349
"8656","WBGene00010758","II",14489802,14492901,3099
"8657","WBGene00010759","II",14492826,14494514,1688
"8658","WBGene00010760","II",14500422,14501663,1241
"8659","WBGene00010761","II",14501747,14502543,796
"8660","WBGene00010762","II",14503297,14504919,1622
"8661","WBGene00010763","II",14507092,14507663,571
"8662","WBGene00010764","II",14513191,14515117,1926
"8663","WBGene00010765","II",14508068,14510162,2094
"8664","WBGene00010766","I",14794899,14797166,2267
"8665","WBGene00010767","I",14797660,14798705,1045
"8666","WBGene00010768","I",12497467,12505010,7543
"8667","WBGene00010769","I",12505028,12508064,3036
"8668","WBGene00010770","I",12518787,12527906,9119
"8669","WBGene00010771","I",12513516,12518694,5178
"8670","WBGene00010772","III",10796711,10802212,5501
"8671","WBGene00010773","X",13714157,13716298,2141
"8672","WBGene00010774","X",13717584,13719217,1633
"8673","WBGene00010775","X",13719207,13722917,3710
"8674","WBGene00010776","X",13727298,13734404,7106
"8675","WBGene00010777","V",15480694,15480777,83
"8676","WBGene00010778","III",9854077,9859183,5106
"8677","WBGene00010779","III",9846393,9847521,1128
"8678","WBGene00010780","III",9851854,9854102,2248
"8679","WBGene00010781","III",9832953,9834473,1520
"8680","WBGene00010782","III",9843782,9845733,1951
"8681","WBGene00010783","III",9847626,9848116,490
"8682","WBGene00010784","III",9860730,9863302,2572
"8683","WBGene00010785","II",11875145,11880588,5443
"8684","WBGene00010786","II",11863525,11865506,1981
"8685","WBGene00010787","II",11861029,11863420,2391
"8686","WBGene00010788","V",11875360,11879141,3781
"8687","WBGene00010789","V",11880032,11883160,3128
"8688","WBGene00010790","V",11888236,11889634,1398
"8689","WBGene00010791","V",11889719,11891194,1475
"8690","WBGene00010792","V",11894331,11895808,1477
"8691","WBGene00010793","IV",14456900,14464098,7198
"8692","WBGene00010794","IV",14464517,14469136,4619
"8693","WBGene00010795","III",9257259,9260222,2963
"8694","WBGene00010796","III",9260191,9269062,8871
"8695","WBGene00010797","V",15253829,15254805,976
"8696","WBGene00010798","V",15252382,15253291,909
"8697","WBGene00010799","V",15241584,15243943,2359
"8698","WBGene00010800","V",15257581,15259149,1568
"8699","WBGene00010801","V",15260238,15260786,548
"8700","WBGene00010802","V",15255132,15256769,1637
"8701","WBGene00010803","V",15260890,15262244,1354
"8702","WBGene00010804","I",13274111,13276464,2353
"8703","WBGene00010805","I",13277061,13280175,3114
"8704","WBGene00010806","I",13280892,13286497,5605
"8705","WBGene00010807","I",13287551,13289542,1991
"8706","WBGene00010808","I",13298209,13300716,2507
"8707","WBGene00010809","III",3503710,3505355,1645
"8708","WBGene00010810","III",3505649,3510033,4384
"8709","WBGene00010811","III",3510964,3519607,8643
"8710","WBGene00010812","III",3510237,3511011,774
"8711","WBGene00010813","III",3521133,3529838,8705
"8712","WBGene00010814","III",3499375,3502547,3172
"8713","WBGene00010815","III",3493811,3499057,5246
"8714","WBGene00010817","I",12132553,12133639,1086
"8715","WBGene00010818","I",12126455,12128965,2510
"8716","WBGene00010819","I",12130070,12131381,1311
"8717","WBGene00010820","I",12117997,12122282,4285
"8718","WBGene00010821","I",12114064,12116304,2240
"8719","WBGene00010822","I",12109096,12112505,3409
"8720","WBGene00010823","I",12119111,12119586,475
"8721","WBGene00010825","I",12106912,12108503,1591
"8722","WBGene00010827","IV",12845696,12848428,2732
"8723","WBGene00010828","IV",12836510,12840674,4164
"8724","WBGene00010829","IV",12823819,12825312,1493
"8725","WBGene00010830","II",10326041,10335807,9766
"8726","WBGene00010831","II",10321460,10324850,3390
"8727","WBGene00010832","II",10318228,10319970,1742
"8728","WBGene00010833","X",13841610,13843108,1498
"8729","WBGene00010834","X",13852906,13857324,4418
"8730","WBGene00010835","X",13861277,13864292,3015
"8731","WBGene00010836","X",13858841,13861066,2225
"8732","WBGene00010837","X",13844288,13844660,372
"8733","WBGene00010838","III",10393389,10396081,2692
"8734","WBGene00010839","III",10399174,10405240,6066
"8735","WBGene00010840","III",10405070,10415150,10080
"8736","WBGene00010842","III",10416069,10421785,5716
"8737","WBGene00010843","III",10421781,10424006,2225
"8738","WBGene00010844","III",10424112,10427982,3870
"8739","WBGene00010845","III",10428334,10435988,7654
"8740","WBGene00010846","IV",11528052,11530715,2663
"8741","WBGene00010847","IV",11518422,11521031,2609
"8742","WBGene00010848","IV",11509726,11510764,1038
"8743","WBGene00010849","IV",11530650,11548586,17936
"8744","WBGene00010850","V",19437899,19445605,7706
"8745","WBGene00010851","V",19445873,19448901,3028
"8746","WBGene00010854","I",8546063,8546725,662
"8747","WBGene00010855","I",8540025,8544415,4390
"8748","WBGene00010856","I",9350274,9352700,2426
"8749","WBGene00010857","I",9344724,9349558,4834
"8750","WBGene00010858","I",9352882,9354541,1659
"8751","WBGene00010859","I",9355072,9357079,2007
"8752","WBGene00010862","III",10029991,10030600,609
"8753","WBGene00010863","III",10032344,10033313,969
"8754","WBGene00010864","III",10036004,10036796,792
"8755","WBGene00010865","III",10037450,10038247,797
"8756","WBGene00010866","III",10034181,10035102,921
"8757","WBGene00010867","V",13370083,13380262,10179
"8758","WBGene00010868","V",13386065,13391393,5328
"8759","WBGene00010869","I",7177953,7179430,1477
"8760","WBGene00010870","I",7172463,7174156,1693
"8761","WBGene00010871","I",7185695,7188298,2603
"8762","WBGene00010872","I",7188465,7190581,2116
"8763","WBGene00010873","I",7183053,7185709,2656
"8764","WBGene00010874","II",8473819,8475568,1749
"8765","WBGene00010875","II",8468109,8470162,2053
"8766","WBGene00010876","II",8475772,8477943,2171
"8767","WBGene00010877","II",8478010,8480478,2468
"8768","WBGene00010878","II",8480457,8482216,1759
"8769","WBGene00010879","II",8482376,8483872,1496
"8770","WBGene00010880","II",8470079,8471217,1138
"8771","WBGene00010881","II",8494271,8495713,1442
"8772","WBGene00010882","IV",11078677,11081055,2378
"8773","WBGene00010883","IV",11089797,11091856,2059
"8774","WBGene00010884","IV",11093843,11095085,1242
"8775","WBGene00010885","IV",11100631,11101478,847
"8776","WBGene00010886","IV",11101962,11102695,733
"8777","WBGene00010887","IV",11096724,11097982,1258
"8778","WBGene00010888","IV",12110586,12111577,991
"8779","WBGene00010889","IV",12105858,12108388,2530
"8780","WBGene00010890","IV",12114810,12121183,6373
"8781","WBGene00010891","IV",12121266,12122881,1615
"8782","WBGene00010892","IV",12124952,12126785,1833
"8783","WBGene00010893","II",10622265,10625943,3678
"8784","WBGene00010894","II",10633476,10639112,5636
"8785","WBGene00010895","II",10643703,10646978,3275
"8786","WBGene00010896","II",10658027,10658626,599
"8787","WBGene00010897","II",10652353,10657841,5488
"8788","WBGene00010898","II",10648938,10652256,3318
"8789","WBGene00010899","II",10628263,10633216,4953
"8790","WBGene00010900","II",10639410,10643536,4126
"8791","WBGene00010901","II",10647480,10648676,1196
"8792","WBGene00010902","X",10626518,10628807,2289
"8793","WBGene00010904","III",4537277,4540644,3367
"8794","WBGene00010905","III",4541326,4542452,1126
"8795","WBGene00010906","III",4543587,4545001,1414
"8796","WBGene00010907","III",4549063,4551567,2504
"8797","WBGene00010908","III",4553618,4560350,6732
"8798","WBGene00010909","III",4542881,4546025,3144
"8799","WBGene00010910","II",10844313,10855554,11241
"8800","WBGene00010911","II",10857473,10860909,3436
"8801","WBGene00010912","II",10863682,10868714,5032
"8802","WBGene00010913","II",8214575,8216616,2041
"8803","WBGene00010915","II",8232789,8237202,4413
"8804","WBGene00010916","II",8208000,8209444,1444
"8805","WBGene00010917","II",8231239,8232769,1530
"8806","WBGene00010918","IV",11814247,11819612,5365
"8807","WBGene00010919","IV",11823516,11823938,422
"8808","WBGene00010920","IV",11830799,11833556,2757
"8809","WBGene00010921","IV",11828973,11830446,1473
"8810","WBGene00010922","III",10931208,10932226,1018
"8811","WBGene00010923","III",10936246,10946834,10588
"8812","WBGene00010924","X",12146832,12148768,1936
"8813","WBGene00010925","X",12151359,12154105,2746
"8814","WBGene00010926","X",12142869,12143819,950
"8815","WBGene00010927","V",19790043,19791250,1207
"8816","WBGene00010928","V",19788704,19789281,577
"8817","WBGene00010929","V",19784129,19785961,1832
"8818","WBGene00010930","V",19780123,19782314,2191
"8819","WBGene00010931","V",19761051,19766763,5712
"8820","WBGene00010932","V",19787038,19787793,755
"8821","WBGene00010933","V",19792566,19795031,2465
"8822","WBGene00010934","V",19776080,19777174,1094
"8823","WBGene00010935","X",14502487,14503862,1375
"8824","WBGene00010936","X",14496085,14499434,3349
"8825","WBGene00010937","X",14474038,14476510,2472
"8826","WBGene00010938","X",14462857,14464400,1543
"8827","WBGene00010939","X",14464809,14465703,894
"8828","WBGene00010940","X",14485127,14485955,828
"8829","WBGene00010941","II",9414559,9416431,1872
"8830","WBGene00010942","II",9417013,9418316,1303
"8831","WBGene00010943","II",9420178,9422196,2018
"8832","WBGene00010944","II",9426229,9427744,1515
"8833","WBGene00010945","II",9436649,9438327,1678
"8834","WBGene00010946","II",9423331,9426173,2842
"8835","WBGene00010947","II",9422269,9423296,1027
"8836","WBGene00010948","II",8359712,8363196,3484
"8837","WBGene00010949","II",8376611,8377357,746
"8838","WBGene00010950","IV",15103629,15106483,2854
"8839","WBGene00010951","IV",15108775,15110915,2140
"8840","WBGene00010952","IV",15115569,15117823,2254
"8841","WBGene00010953","IV",15124931,15126122,1191
"8842","WBGene00010954","IV",15120837,15122548,1711
"8843","WBGene00010955","IV",15123182,15124393,1211
"8844","WBGene00010956","IV",15133835,15133999,164
"8845","WBGene00010957","MtDNA",113,549,436
"8846","WBGene00010958","MtDNA",549,783,234
"8847","WBGene00010959","MtDNA",1763,2635,872
"8848","WBGene00010960","MtDNA",2634,3235,601
"8849","WBGene00010961","MtDNA",3389,4269,880
"8850","WBGene00010962","MtDNA",5678,6449,771
"8851","WBGene00010963","MtDNA",6506,7808,1302
"8852","WBGene00010964","MtDNA",7827,9428,1601
"8853","WBGene00010965","MtDNA",9649,10348,699
"8854","WBGene00010966","MtDNA",11356,11691,335
"8855","WBGene00010967","MtDNA",11691,13272,1581
"8856","WBGene00010968","X",13565486,13566536,1050
"8857","WBGene00010969","X",13537051,13538042,991
"8858","WBGene00010970","X",13552549,13556166,3617
"8859","WBGene00010971","X",13567441,13569954,2513
"8860","WBGene00010972","III",10254800,10257221,2421
"8861","WBGene00010973","III",10257181,10258736,1555
"8862","WBGene00010974","III",10258856,10261679,2823
"8863","WBGene00010975","III",10261799,10267381,5582
"8864","WBGene00010976","V",14508249,14509655,1406
"8865","WBGene00010977","V",14483160,14484346,1186
"8866","WBGene00010978","V",14484332,14484682,350
"8867","WBGene00010979","V",14511706,14518086,6380
"8868","WBGene00010980","V",14480387,14481357,970
"8869","WBGene00010981","X",15429925,15431198,1273
"8870","WBGene00010982","X",15433787,15434972,1185
"8871","WBGene00010983","X",15435665,15440794,5129
"8872","WBGene00010984","X",15441731,15443641,1910
"8873","WBGene00010985","X",15446724,15450362,3638
"8874","WBGene00010986","X",15461843,15470758,8915
"8875","WBGene00010987","II",14907508,14910405,2897
"8876","WBGene00010988","II",10926561,10931075,4514
"8877","WBGene00010989","II",10932741,10935140,2399
"8878","WBGene00010990","II",10943390,10945660,2270
"8879","WBGene00010991","II",10947610,10949184,1574
"8880","WBGene00010992","II",10953594,10956878,3284
"8881","WBGene00010993","X",14163099,14164506,1407
"8882","WBGene00010994","X",14158870,14161734,2864
"8883","WBGene00010995","X",14155115,14157013,1898
"8884","WBGene00010996","X",13084573,13087646,3073
"8885","WBGene00010998","X",13091131,13094424,3293
"8886","WBGene00010999","X",13101306,13104205,2899
"8887","WBGene00011000","X",13094558,13100445,5887
"8888","WBGene00011001","V",10077905,10078344,439
"8889","WBGene00011002","V",10080119,10081739,1620
"8890","WBGene00011003","V",10087480,10088998,1518
"8891","WBGene00011004","V",10085281,10087313,2032
"8892","WBGene00011005","V",10089157,10090561,1404
"8893","WBGene00011006","V",10096305,10098597,2292
"8894","WBGene00011007","V",10098904,10099205,301
"8895","WBGene00011008","V",10090688,10091252,564
"8896","WBGene00011009","X",13282096,13284204,2108
"8897","WBGene00011010","X",13285122,13286633,1511
"8898","WBGene00011011","X",13288917,13290631,1714
"8899","WBGene00011012","X",13287779,13288815,1036
"8900","WBGene00011013","X",13307282,13308845,1563
"8901","WBGene00011014","V",12308849,12310342,1493
"8902","WBGene00011015","V",12318385,12320229,1844
"8903","WBGene00011016","V",12314919,12317180,2261
"8904","WBGene00011017","V",12317278,12318019,741
"8905","WBGene00011018","IV",14182377,14190632,8255
"8906","WBGene00011019","IV",14177200,14178940,1740
"8907","WBGene00011020","IV",14173642,14176473,2831
"8908","WBGene00011021","IV",14172481,14173216,735
"8909","WBGene00011022","IV",14168906,14170838,1932
"8910","WBGene00011023","IV",14165776,14168487,2711
"8911","WBGene00011024","IV",14160354,14162872,2518
"8912","WBGene00011025","IV",14155270,14158048,2778
"8913","WBGene00011026","I",12162399,12163703,1304
"8914","WBGene00011027","I",12165729,12168022,2293
"8915","WBGene00011028","I",12168238,12177782,9544
"8916","WBGene00011029","I",12181046,12183297,2251
"8917","WBGene00011030","I",12183688,12189007,5319
"8918","WBGene00011032","I",8598658,8600923,2265
"8919","WBGene00011033","I",8592092,8592926,834
"8920","WBGene00011034","I",8596333,8598552,2219
"8921","WBGene00011035","I",8601339,8602034,695
"8922","WBGene00011036","I",8602125,8605165,3040
"8923","WBGene00011037","I",8593027,8596225,3198
"8924","WBGene00011038","II",10197625,10198324,699
"8925","WBGene00011039","II",10198309,10199768,1459
"8926","WBGene00011040","II",10199810,10200819,1009
"8927","WBGene00011041","II",10192529,10193451,922
"8928","WBGene00011042","II",14852430,14853594,1164
"8929","WBGene00011043","II",14857259,14866636,9377
"8930","WBGene00011044","II",14869944,14883054,13110
"8931","WBGene00011045","II",14866716,14869577,2861
"8932","WBGene00011046","II",14855529,14857010,1481
"8933","WBGene00011047","II",14362019,14365177,3158
"8934","WBGene00011049","II",14381772,14383376,1604
"8935","WBGene00011050","II",14350719,14358113,7394
"8936","WBGene00011051","II",14358366,14361701,3335
"8937","WBGene00011052","II",13763427,13765552,2125
"8938","WBGene00011053","II",13766318,13768322,2004
"8939","WBGene00011054","II",13758408,13761233,2825
"8940","WBGene00011055","II",13752316,13756267,3951
"8941","WBGene00011056","II",13736349,13736933,584
"8942","WBGene00011058","I",11917834,11923915,6081
"8943","WBGene00011059","I",11930704,11931757,1053
"8944","WBGene00011060","I",11947001,11953126,6125
"8945","WBGene00011061","I",7235371,7238790,3419
"8946","WBGene00011062","I",7233645,7234501,856
"8947","WBGene00011063","I",7244937,7246295,1358
"8948","WBGene00011064","I",7246849,7248741,1892
"8949","WBGene00011065","I",7246075,7246811,736
"8950","WBGene00011066","I",7255380,7258700,3320
"8951","WBGene00011067","II",10788106,10793493,5387
"8952","WBGene00011068","II",10793575,10796294,2719
"8953","WBGene00011069","II",10805739,10808523,2784
"8954","WBGene00011070","II",10811016,10812188,1172
"8955","WBGene00011071","II",10812949,10819978,7029
"8956","WBGene00011072","II",10787312,10787914,602
"8957","WBGene00011073","X",10744356,10746488,2132
"8958","WBGene00011074","X",10754917,10758140,3223
"8959","WBGene00011075","X",10751666,10757708,6042
"8960","WBGene00011076","X",9858339,9861735,3396
"8961","WBGene00011077","X",9864069,9866531,2462
"8962","WBGene00011078","X",9866660,9869574,2914
"8963","WBGene00011079","X",9869120,9869574,454
"8964","WBGene00011081","X",9877417,9881501,4084
"8965","WBGene00011082","X",9856918,9858083,1165
"8966","WBGene00011083","X",9872884,9882212,9328
"8967","WBGene00011084","V",9837979,9839588,1609
"8968","WBGene00011087","V",12056575,12059747,3172
"8969","WBGene00011088","V",12065960,12067957,1997
"8970","WBGene00011089","V",12068725,12070519,1794
"8971","WBGene00011090","V",12072862,12074986,2124
"8972","WBGene00011092","V",12081089,12084316,3227
"8973","WBGene00011093","V",12078044,12080374,2330
"8974","WBGene00011094","V",12084186,12086460,2274
"8975","WBGene00011095","V",12087234,12088931,1697
"8976","WBGene00011096","V",12089073,12091812,2739
"8977","WBGene00011097","V",12092006,12093862,1856
"8978","WBGene00011098","V",12096234,12097845,1611
"8979","WBGene00011099","V",12094374,12095947,1573
"8980","WBGene00011100","V",12098149,12100111,1962
"8981","WBGene00011101","X",15109951,15116618,6667
"8982","WBGene00011102","X",10339225,10341161,1936
"8983","WBGene00011103","X",10336441,10337208,767
"8984","WBGene00011104","X",10333861,10338200,4339
"8985","WBGene00011105","X",10330547,10331900,1353
"8986","WBGene00011106","X",10324183,10327642,3459
"8987","WBGene00011107","X",10317722,10321857,4135
"8988","WBGene00011108","X",10341732,10344080,2348
"8989","WBGene00011109","III",4408551,4412149,3598
"8990","WBGene00011110","III",4407444,4408437,993
"8991","WBGene00011111","III",4404786,4406285,1499
"8992","WBGene00011112","III",4394796,4396617,1821
"8993","WBGene00011113","III",4397415,4398576,1161
"8994","WBGene00011114","III",4398763,4400942,2179
"8995","WBGene00011115","III",4418343,4419167,824
"8996","WBGene00011116","III",4415520,4417812,2292
"8997","WBGene00011117","III",4414732,4415235,503
"8998","WBGene00011119","III",4413457,4414748,1291
"8999","WBGene00011120","III",4401442,4402505,1063
"9000","WBGene00011121","III",4402595,4404436,1841
"9001","WBGene00011122","IV",11179645,11183001,3356
"9002","WBGene00011123","IV",11184243,11186000,1757
"9003","WBGene00011124","IV",11187012,11188264,1252
"9004","WBGene00011127","IV",11188891,11189613,722
"9005","WBGene00011128","IV",11209309,11210831,1522
"9006","WBGene00011129","IV",11207528,11209359,1831
"9007","WBGene00011130","IV",11213651,11218137,4486
"9008","WBGene00011131","IV",11202768,11205790,3022
"9009","WBGene00011132","V",14718601,14719591,990
"9010","WBGene00011133","V",14714207,14715720,1513
"9011","WBGene00011134","V",14711313,14711736,423
"9012","WBGene00011135","V",14716499,14717425,926
"9013","WBGene00011136","V",14712663,14714072,1409
"9014","WBGene00011137","V",14723324,14724766,1442
"9015","WBGene00011139","X",11118959,11121005,2046
"9016","WBGene00011140","X",11107376,11109316,1940
"9017","WBGene00011141","X",11116107,11116823,716
"9018","WBGene00011142","III",8966022,8967727,1705
"9019","WBGene00011143","III",8967917,8969658,1741
"9020","WBGene00011144","III",8971892,8973672,1780
"9021","WBGene00011145","III",8974126,8975061,935
"9022","WBGene00011146","III",8975070,8981897,6827
"9023","WBGene00011147","III",8992205,8994827,2622
"9024","WBGene00011149","V",15370867,15372950,2083
"9025","WBGene00011150","V",15368470,15369807,1337
"9026","WBGene00011151","V",15373676,15374801,1125
"9027","WBGene00011152","X",12612727,12617880,5153
"9028","WBGene00011153","X",12619472,12623531,4059
"9029","WBGene00011154","X",12638461,12640559,2098
"9030","WBGene00011155","I",11909366,11910104,738
"9031","WBGene00011156","I",11910328,11911021,693
"9032","WBGene00011157","II",9442168,9443629,1461
"9033","WBGene00011158","II",9440441,9441959,1518
"9034","WBGene00011159","II",9438609,9440160,1551
"9035","WBGene00011160","II",9446090,9447705,1615
"9036","WBGene00011161","II",9448273,9449726,1453
"9037","WBGene00011162","II",9452701,9454404,1703
"9038","WBGene00011163","II",9455417,9456617,1200
"9039","WBGene00011164","II",9460128,9462260,2132
"9040","WBGene00011165","II",9462537,9464093,1556
"9041","WBGene00011166","II",9464470,9466195,1725
"9042","WBGene00011167","II",9466960,9468477,1517
"9043","WBGene00011168","II",9450028,9452263,2235
"9044","WBGene00011169","II",9443827,9445468,1641
"9045","WBGene00011170","II",9459021,9459562,541
"9046","WBGene00011171","IV",10319351,10321170,1819
"9047","WBGene00011172","IV",10317558,10318293,735
"9048","WBGene00011173","IV",10310772,10313670,2898
"9049","WBGene00011174","IV",10304845,10307880,3035
"9050","WBGene00011175","IV",10296046,10302310,6264
"9051","WBGene00011176","IV",10292928,10294130,1202
"9052","WBGene00011177","IV",10310116,10310429,313
"9053","WBGene00011178","IV",10314989,10317377,2388
"9054","WBGene00011179","IV",10600314,10601852,1538
"9055","WBGene00011180","IV",10602944,10606894,3950
"9056","WBGene00011181","IV",10606902,10608861,1959
"9057","WBGene00011182","IV",10621684,10628861,7177
"9058","WBGene00011183","IV",10608575,10609744,1169
"9059","WBGene00011184","IV",10621111,10621832,721
"9060","WBGene00011185","V",13932575,13934645,2070
"9061","WBGene00011186","V",13946969,13948799,1830
"9062","WBGene00011187","V",13949319,13949640,321
"9063","WBGene00011188","V",13950066,13950394,328
"9064","WBGene00011189","V",13950733,13953291,2558
"9065","WBGene00011190","V",13954277,13956176,1899
"9066","WBGene00011191","V",13956161,13958347,2186
"9067","WBGene00011192","V",13958746,13961016,2270
"9068","WBGene00011193","V",13961265,13961977,712
"9069","WBGene00011194","V",13962417,13963840,1423
"9070","WBGene00011195","V",13963734,13965797,2063
"9071","WBGene00011196","V",13967866,13974887,7021
"9072","WBGene00011197","V",13937223,13939602,2379
"9073","WBGene00011198","III",4269743,4272506,2763
"9074","WBGene00011200","III",4285861,4287472,1611
"9075","WBGene00011201","III",4291543,4293413,1870
"9076","WBGene00011202","III",4293408,4295142,1734
"9077","WBGene00011203","III",4295224,4296599,1375
"9078","WBGene00011205","III",4301620,4302393,773
"9079","WBGene00011206","III",4297239,4301039,3800
"9080","WBGene00011207","V",18242339,18252416,10077
"9081","WBGene00011208","V",18253794,18254405,611
"9082","WBGene00011209","V",18234530,18236757,2227
"9083","WBGene00011210","V",18246808,18249463,2655
"9084","WBGene00011211","V",18254783,18257067,2284
"9085","WBGene00011212","V",18259270,18266370,7100
"9086","WBGene00011213","V",18238122,18240736,2614
"9087","WBGene00011214","III",3962731,3964158,1427
"9088","WBGene00011215","III",3960258,3961825,1567
"9089","WBGene00011216","III",9776532,9778850,2318
"9090","WBGene00011217","III",9785957,9789657,3700
"9091","WBGene00011218","III",9783325,9786038,2713
"9092","WBGene00011219","III",9795271,9796548,1277
"9093","WBGene00011220","III",9792548,9793642,1094
"9094","WBGene00011221","III",9963121,9973865,10744
"9095","WBGene00011222","IV",10388483,10393294,4811
"9096","WBGene00011223","IV",10394591,10394958,367
"9097","WBGene00011224","IV",10408703,10409477,774
"9098","WBGene00011225","IV",10409985,10413928,3943
"9099","WBGene00011226","X",16189856,16195007,5151
"9100","WBGene00011227","X",16184370,16185419,1049
"9101","WBGene00011228","X",16196911,16199932,3021
"9102","WBGene00011229","X",16210303,16210651,348
"9103","WBGene00011230","I",7857823,7859417,1594
"9104","WBGene00011231","I",7862736,7863553,817
"9105","WBGene00011232","I",7866136,7872080,5944
"9106","WBGene00011234","I",7867577,7867918,341
"9107","WBGene00011235","I",7872057,7875554,3497
"9108","WBGene00011236","IV",10355046,10357170,2124
"9109","WBGene00011237","IV",10358141,10360219,2078
"9110","WBGene00011238","IV",10360800,10363331,2531
"9111","WBGene00011239","IV",10366333,10367790,1457
"9112","WBGene00011240","IV",10374905,10387318,12413
"9113","WBGene00011241","IV",10372638,10373821,1183
"9114","WBGene00011242","V",12704382,12707761,3379
"9115","WBGene00011243","V",12708678,12710700,2022
"9116","WBGene00011244","V",12711293,12712109,816
"9117","WBGene00011245","V",12713035,12714220,1185
"9118","WBGene00011246","V",12720058,12722727,2669
"9119","WBGene00011247","V",12728631,12729416,785
"9120","WBGene00011248","V",12729520,12731801,2281
"9121","WBGene00011249","V",13511905,13515215,3310
"9122","WBGene00011250","V",14597939,14600092,2153
"9123","WBGene00011251","V",14600272,14606535,6263
"9124","WBGene00011252","V",14609943,14610705,762
"9125","WBGene00011253","V",14610734,14612222,1488
"9126","WBGene00011254","V",17747966,17749243,1277
"9127","WBGene00011255","X",13217101,13219019,1918
"9128","WBGene00011257","IV",10826028,10828021,1993
"9129","WBGene00011258","IV",10829549,10832248,2699
"9130","WBGene00011259","IV",10812409,10825953,13544
"9131","WBGene00011260","III",3826378,3829205,2827
"9132","WBGene00011261","V",11831203,11843625,12422
"9133","WBGene00011262","V",11833629,11835708,2079
"9134","WBGene00011263","V",11860675,11862289,1614
"9135","WBGene00011264","V",11863117,11864913,1796
"9136","WBGene00011265","V",11866438,11868234,1796
"9137","WBGene00011266","V",11839520,11840302,782
"9138","WBGene00011267","III",10847619,10848670,1051
"9139","WBGene00011268","III",10840023,10845020,4997
"9140","WBGene00011269","III",10832936,10839451,6515
"9141","WBGene00011270","V",11917564,11924654,7090
"9142","WBGene00011271","II",9944026,9947121,3095
"9143","WBGene00011272","II",9962966,9967132,4166
"9144","WBGene00011273","II",9967277,9968049,772
"9145","WBGene00011274","II",9969620,9970515,895
"9146","WBGene00011275","II",9968659,9969631,972
"9147","WBGene00011276","II",9971035,9975125,4090
"9148","WBGene00011277","II",9976705,9977877,1172
"9149","WBGene00011278","III",4188160,4189285,1125
"9150","WBGene00011279","III",4197285,4202289,5004
"9151","WBGene00011280","III",4202253,4204269,2016
"9152","WBGene00011281","III",4204429,4205814,1385
"9153","WBGene00011282","III",4206253,4208265,2012
"9154","WBGene00011283","V",12891523,12895872,4349
"9155","WBGene00011284","V",12903551,12904160,609
"9156","WBGene00011285","V",12904213,12905168,955
"9157","WBGene00011286","V",12906131,12906746,615
"9158","WBGene00011287","V",12882078,12885960,3882
"9159","WBGene00011288","IV",10686550,10687045,495
"9160","WBGene00011289","IV",10687592,10688135,543
"9161","WBGene00011290","IV",10690444,10691789,1345
"9162","WBGene00011291","IV",10691991,10695303,3312
"9163","WBGene00011292","IV",10695309,10697071,1762
"9164","WBGene00011293","IV",10699316,10706114,6798
"9165","WBGene00011294","IV",10702999,10704982,1983
"9166","WBGene00011295","IV",10689601,10690195,594
"9167","WBGene00011296","IV",10710057,10711794,1737
"9168","WBGene00011297","IV",10705463,10707313,1850
"9169","WBGene00011298","III",9043886,9045938,2052
"9170","WBGene00011299","III",9046055,9050693,4638
"9171","WBGene00011300","III",9051592,9053793,2201
"9172","WBGene00011302","II",10534332,10537671,3339
"9173","WBGene00011303","II",10537799,10539332,1533
"9174","WBGene00011304","II",10542428,10555044,12616
"9175","WBGene00011305","V",12961474,12963336,1862
"9176","WBGene00011306","V",12966000,12967210,1210
"9177","WBGene00011307","V",12955203,12961149,5946
"9178","WBGene00011308","V",12971110,12973282,2172
"9179","WBGene00011309","V",12967309,12967982,673
"9180","WBGene00011310","X",16315356,16317729,2373
"9181","WBGene00011311","II",8716834,8721691,4857
"9182","WBGene00011312","II",8722474,8725522,3048
"9183","WBGene00011313","II",8736726,8737556,830
"9184","WBGene00011314","II",8725533,8729777,4244
"9185","WBGene00011315","X",10719554,10722054,2500
"9186","WBGene00011317","X",10716318,10717173,855
"9187","WBGene00011318","V",14987556,14991024,3468
"9188","WBGene00011319","V",14991168,14991649,481
"9189","WBGene00011320","V",14991707,14992677,970
"9190","WBGene00011321","V",14993838,14995201,1363
"9191","WBGene00011322","V",14996536,14998121,1585
"9192","WBGene00011323","V",15002543,15005055,2512
"9193","WBGene00011324","V",15005100,15006400,1300
"9194","WBGene00011325","V",14998991,15000029,1038
"9195","WBGene00011326","V",13689892,13703330,13438
"9196","WBGene00011327","V",13705975,13707360,1385
"9197","WBGene00011328","V",13704929,13711085,6156
"9198","WBGene00011329","V",13712854,13716624,3770
"9199","WBGene00011330","V",13716824,13720402,3578
"9200","WBGene00011331","II",10206715,10209391,2676
"9201","WBGene00011333","II",10242595,10247638,5043
"9202","WBGene00011334","II",10240277,10242490,2213
"9203","WBGene00011335","II",10231272,10236014,4742
"9204","WBGene00011336","II",10233833,10234498,665
"9205","WBGene00011337","IV",11354412,11355403,991
"9206","WBGene00011338","IV",11365605,11371836,6231
"9207","WBGene00011339","V",15116844,15119617,2773
"9208","WBGene00011340","V",15121729,15125228,3499
"9209","WBGene00011341","V",15113781,15114092,311
"9210","WBGene00011342","V",15111960,15113628,1668
"9211","WBGene00011344","I",8275611,8288124,12513
"9212","WBGene00011345","I",8281969,8284460,2491
"9213","WBGene00011348","II",7874242,7878097,3855
"9214","WBGene00011349","II",7870881,7873893,3012
"9215","WBGene00011350","II",7880812,7882767,1955
"9216","WBGene00011351","II",7879720,7880464,744
"9217","WBGene00011352","I",8573855,8580157,6302
"9218","WBGene00011353","I",8571557,8573749,2192
"9219","WBGene00011354","X",12109135,12111185,2050
"9220","WBGene00011355","X",12111513,12113475,1962
"9221","WBGene00011356","X",12114324,12115923,1599
"9222","WBGene00011357","X",12116615,12117763,1148
"9223","WBGene00011358","X",12118640,12120661,2021
"9224","WBGene00011359","X",12121585,12125048,3463
"9225","WBGene00011360","X",12125608,12128000,2392
"9226","WBGene00011361","X",12128144,12141151,13007
"9227","WBGene00011362","V",14163260,14166730,3470
"9228","WBGene00011363","V",14167228,14167729,501
"9229","WBGene00011364","V",14157663,14160862,3199
"9230","WBGene00011365","III",9247422,9248618,1196
"9231","WBGene00011366","III",9251029,9253126,2097
"9232","WBGene00011367","III",4020037,4021867,1830
"9233","WBGene00011368","III",4022166,4025658,3492
"9234","WBGene00011369","III",4041224,4042811,1587
"9235","WBGene00011371","IV",17399776,17402336,2560
"9236","WBGene00011372","IV",17408231,17417794,9563
"9237","WBGene00011373","IV",17406901,17407125,224
"9238","WBGene00011374","IV",17386763,17387492,729
"9239","WBGene00011375","I",8219998,8223009,3011
"9240","WBGene00011376","I",8214382,8217998,3616
"9241","WBGene00011378","I",8210931,8212411,1480
"9242","WBGene00011379","I",8208712,8210703,1991
"9243","WBGene00011380","I",8235747,8237498,1751
"9244","WBGene00011381","V",11349310,11352993,3683
"9245","WBGene00011382","V",11362453,11366221,3768
"9246","WBGene00011383","V",11342233,11344773,2540
"9247","WBGene00011384","I",11797032,11797947,915
"9248","WBGene00011385","I",11800433,11804991,4558
"9249","WBGene00011386","I",11813779,11814451,672
"9250","WBGene00011387","I",11809132,11811266,2134
"9251","WBGene00011388","I",11815910,11819277,3367
"9252","WBGene00011389","I",11819539,11820051,512
"9253","WBGene00011390","I",11827549,11828619,1070
"9254","WBGene00011391","V",20838080,20838768,688
"9255","WBGene00011392","V",20827715,20828939,1224
"9256","WBGene00011393","V",20816576,20820330,3754
"9257","WBGene00011394","V",20816142,20816553,411
"9258","WBGene00011395","V",16581037,16583175,2138
"9259","WBGene00011396","V",16578459,16580524,2065
"9260","WBGene00011397","V",16600567,16603369,2802
"9261","WBGene00011398","III",13393910,13394979,1069
"9262","WBGene00011399","III",13389399,13390857,1458
"9263","WBGene00011400","III",13386150,13388353,2203
"9264","WBGene00011401","III",13378441,13380409,1968
"9265","WBGene00011402","V",11296696,11298732,2036
"9266","WBGene00011403","V",11294693,11296562,1869
"9267","WBGene00011404","V",11311456,11313445,1989
"9268","WBGene00011405","III",4682774,4685533,2759
"9269","WBGene00011407","III",4689280,4692166,2886
"9270","WBGene00011408","III",4692098,4693303,1205
"9271","WBGene00011409","III",4695361,4698010,2649
"9272","WBGene00011410","III",4694003,4695270,1267
"9273","WBGene00011411","III",4699407,4700224,817
"9274","WBGene00011412","III",4704404,4705404,1000
"9275","WBGene00011414","III",4706978,4708382,1404
"9276","WBGene00011415","III",4712572,4715188,2616
"9277","WBGene00011420","IV",12484910,12486537,1627
"9278","WBGene00011421","IV",10041130,10042432,1302
"9279","WBGene00011422","IV",10047408,10050554,3146
"9280","WBGene00011423","IV",10056591,10062849,6258
"9281","WBGene00011424","IV",10039773,10040903,1130
"9282","WBGene00011425","IV",10054036,10056250,2214
"9283","WBGene00011426","X",14812361,14814380,2019
"9284","WBGene00011427","V",11058649,11059264,615
"9285","WBGene00011428","V",11064954,11065634,680
"9286","WBGene00011429","V",11054127,11055142,1015
"9287","WBGene00011430","V",11068069,11069358,1289
"9288","WBGene00011431","I",13302759,13304311,1552
"9289","WBGene00011432","I",13307031,13308787,1756
"9290","WBGene00011433","I",13310915,13318704,7789
"9291","WBGene00011434","I",13329175,13330998,1823
"9292","WBGene00011435","I",13309994,13310715,721
"9293","WBGene00011436","V",11740065,11754109,14044
"9294","WBGene00011437","V",11757668,11758598,930
"9295","WBGene00011438","V",11758935,11760570,1635
"9296","WBGene00011439","V",11761893,11763152,1259
"9297","WBGene00011440","X",11659510,11661660,2150
"9298","WBGene00011441","X",11653570,11656569,2999
"9299","WBGene00011442","X",11658440,11659692,1252
"9300","WBGene00011443","X",11648358,11650918,2560
"9301","WBGene00011444","X",11667127,11672309,5182
"9302","WBGene00011445","X",11677515,11680980,3465
"9303","WBGene00011446","X",11647423,11648196,773
"9304","WBGene00011447","X",11674416,11677090,2674
"9305","WBGene00011448","V",12236895,12238599,1704
"9306","WBGene00011449","V",12241962,12245059,3097
"9307","WBGene00011450","V",12241409,12241945,536
"9308","WBGene00011451","V",12251341,12252407,1066
"9309","WBGene00011452","V",12256703,12258804,2101
"9310","WBGene00011453","V",12258982,12261205,2223
"9311","WBGene00011454","IV",9560787,9566605,5818
"9312","WBGene00011456","IV",9546286,9560428,14142
"9313","WBGene00011458","II",7820333,7822554,2221
"9314","WBGene00011459","II",7822749,7825196,2447
"9315","WBGene00011460","X",10787503,10789700,2197
"9316","WBGene00011462","X",10789628,10792535,2907
"9317","WBGene00011463","X",10792903,10794734,1831
"9318","WBGene00011464","II",11260087,11261256,1169
"9319","WBGene00011465","II",11255836,11258506,2670
"9320","WBGene00011466","II",8173680,8174866,1186
"9321","WBGene00011467","II",8172229,8173562,1333
"9322","WBGene00011468","II",8177578,8180381,2803
"9323","WBGene00011469","II",8181737,8182309,572
"9324","WBGene00011470","V",18372881,18372953,72
"9325","WBGene00011471","II",8187607,8190528,2921
"9326","WBGene00011472","II",8191773,8193329,1556
"9327","WBGene00011473","II",8168682,8170358,1676
"9328","WBGene00011474","III",13563346,13564990,1644
"9329","WBGene00011475","III",13561729,13563082,1353
"9330","WBGene00011476","III",13566874,13570447,3573
"9331","WBGene00011478","III",13580850,13583589,2739
"9332","WBGene00011479","IV",11112999,11116754,3755
"9333","WBGene00011480","IV",11119298,11123155,3857
"9334","WBGene00011481","IV",11116732,11118887,2155
"9335","WBGene00011482","IV",11108494,11110017,1523
"9336","WBGene00011483","IV",11103255,11104262,1007
"9337","WBGene00011484","IV",11104743,11105820,1077
"9338","WBGene00011485","V",17070527,17071678,1151
"9339","WBGene00011486","V",17076874,17077989,1115
"9340","WBGene00011487","V",17085002,17090023,5021
"9341","WBGene00011488","I",9620233,9622370,2137
"9342","WBGene00011489","I",9622522,9624724,2202
"9343","WBGene00011490","I",9631388,9632402,1014
"9344","WBGene00011491","I",9633183,9635945,2762
"9345","WBGene00011492","I",9638886,9641736,2850
"9346","WBGene00011493","I",9642344,9643804,1460
"9347","WBGene00011494","I",9645699,9647676,1977
"9348","WBGene00011495","I",9653021,9657040,4019
"9349","WBGene00011497","I",9650499,9652946,2447
"9350","WBGene00011498","III",9739094,9743339,4245
"9351","WBGene00011499","III",9748863,9749673,810
"9352","WBGene00011500","III",9749584,9751432,1848
"9353","WBGene00011501","III",9758927,9760389,1462
"9354","WBGene00011502","III",9753672,9757514,3842
"9355","WBGene00011503","III",9757616,9762143,4527
"9356","WBGene00011505","V",15926425,15928425,2000
"9357","WBGene00011507","II",8042589,8047452,4863
"9358","WBGene00011508","II",8049049,8050564,1515
"9359","WBGene00011509","II",8053137,8054965,1828
"9360","WBGene00011510","II",8066111,8068184,2073
"9361","WBGene00011511","II",8067990,8073372,5382
"9362","WBGene00011512","II",8059069,8061464,2395
"9363","WBGene00011513","V",15867683,15869051,1368
"9364","WBGene00011514","V",15869311,15870636,1325
"9365","WBGene00011515","V",15881994,15884839,2845
"9366","WBGene00011516","V",15885662,15886059,397
"9367","WBGene00011517","V",15886719,15888851,2132
"9368","WBGene00011518","V",15892996,15894160,1164
"9369","WBGene00011519","V",15892061,15892520,459
"9370","WBGene00011520","V",15894454,15896765,2311
"9371","WBGene00011521","V",15899996,15900900,904
"9372","WBGene00011522","II",11203221,11220642,17421
"9373","WBGene00011523","II",11226679,11232835,6156
"9374","WBGene00011524","II",11222305,11226548,4243
"9375","WBGene00011526","II",11232756,11234952,2196
"9376","WBGene00011527","II",11235053,11236450,1397
"9377","WBGene00011528","II",11236624,11237323,699
"9378","WBGene00011529","II",11239407,11240988,1581
"9379","WBGene00011530","II",11240932,11247514,6582
"9380","WBGene00011531","I",9070247,9075077,4830
"9381","WBGene00011532","I",9077565,9080024,2459
"9382","WBGene00011533","V",9631244,9632256,1012
"9383","WBGene00011534","V",9626404,9628143,1739
"9384","WBGene00011535","V",9622105,9622934,829
"9385","WBGene00011536","V",9620150,9621036,886
"9386","WBGene00011537","V",9618233,9619019,786
"9387","WBGene00011538","V",15393108,15394957,1849
"9388","WBGene00011539","V",15402277,15404385,2108
"9389","WBGene00011540","V",15418131,15419395,1264
"9390","WBGene00011541","V",15411433,15412725,1292
"9391","WBGene00011542","V",15421673,15423658,1985
"9392","WBGene00011543","V",10028150,10031094,2944
"9393","WBGene00011544","V",10035746,10036413,667
"9394","WBGene00011545","I",12708863,12711596,2733
"9395","WBGene00011546","I",12712158,12714722,2564
"9396","WBGene00011547","I",12715648,12716583,935
"9397","WBGene00011548","I",12718296,12719795,1499
"9398","WBGene00011549","I",12724751,12726206,1455
"9399","WBGene00011550","I",12707513,12708691,1178
"9400","WBGene00011551","I",12722045,12722883,838
"9401","WBGene00011552","X",10129588,10130267,679
"9402","WBGene00011553","X",10122671,10123412,741
"9403","WBGene00011554","III",10303368,10306188,2820
"9404","WBGene00011556","III",10300293,10303423,3130
"9405","WBGene00011557","III",10299164,10299949,785
"9406","WBGene00011558","III",10318296,10318563,267
"9407","WBGene00011559","III",10355799,10357761,1962
"9408","WBGene00011560","III",10352157,10355117,2960
"9409","WBGene00011561","III",10337840,10339440,1600
"9410","WBGene00011562","III",10321019,10325675,4656
"9411","WBGene00011563","III",10332526,10334083,1557
"9412","WBGene00011564","X",12691573,12695652,4079
"9413","WBGene00011565","X",12703330,12704821,1491
"9414","WBGene00011566","X",12700393,12702063,1670
"9415","WBGene00011567","X",12698948,12700450,1502
"9416","WBGene00011568","X",12695589,12699921,4332
"9417","WBGene00011570","V",9944393,9945895,1502
"9418","WBGene00011571","V",9951233,9952182,949
"9419","WBGene00011572","V",9952699,9956883,4184
"9420","WBGene00011573","V",9956879,9958331,1452
"9421","WBGene00011574","V",9959997,9960337,340
"9422","WBGene00011575","V",9960747,9962494,1747
"9423","WBGene00011576","V",9927782,9930775,2993
"9424","WBGene00011577","V",9943339,9943612,273
"9425","WBGene00011578","II",8860913,8865173,4260
"9426","WBGene00011579","II",8869549,8874020,4471
"9427","WBGene00011580","II",8884901,8889673,4772
"9428","WBGene00011581","I",12603772,12606248,2476
"9429","WBGene00011582","I",12621171,12623084,1913
"9430","WBGene00011583","I",12626742,12628997,2255
"9431","WBGene00011586","I",12624235,12625238,1003
"9432","WBGene00011587","V",12859381,12863833,4452
"9433","WBGene00011589","V",12868026,12870035,2009
"9434","WBGene00011590","V",12872053,12882108,10055
"9435","WBGene00011591","V",12865915,12866547,632
"9436","WBGene00011592","V",12863786,12867917,4131
"9437","WBGene00011593","IV",10530709,10532915,2206
"9438","WBGene00011594","IV",10533943,10536442,2499
"9439","WBGene00011595","IV",10536736,10538684,1948
"9440","WBGene00011596","IV",10541495,10545091,3596
"9441","WBGene00011597","IV",10547088,10555442,8354
"9442","WBGene00011599","IV",10553349,10553935,586
"9443","WBGene00011600","IV",10555247,10558221,2974
"9444","WBGene00011601","IV",10558721,10561130,2409
"9445","WBGene00011604","III",4248155,4263048,14893
"9446","WBGene00011605","III",4263785,4269270,5485
"9447","WBGene00011606","X",162529,163134,605
"9448","WBGene00011607","X",164036,171839,7803
"9449","WBGene00011608","X",173180,177000,3820
"9450","WBGene00011609","X",177396,177856,460
"9451","WBGene00011610","X",178242,179376,1134
"9452","WBGene00011611","X",179786,182169,2383
"9453","WBGene00011612","X",182691,191193,8502
"9454","WBGene00011613","X",192834,197901,5067
"9455","WBGene00011614","X",11944313,11946834,2521
"9456","WBGene00011615","X",11948843,11951893,3050
"9457","WBGene00011616","X",11955425,11956495,1070
"9458","WBGene00011617","V",16439667,16442450,2783
"9459","WBGene00011618","V",16445976,16447165,1189
"9460","WBGene00011619","V",16462438,16466359,3921
"9461","WBGene00011620","V",16478698,16479375,677
"9462","WBGene00011621","V",16448035,16449344,1309
"9463","WBGene00011622","V",14018766,14020332,1566
"9464","WBGene00011623","V",14024838,14025656,818
"9465","WBGene00011624","V",14026336,14027484,1148
"9466","WBGene00011625","V",14034323,14038372,4049
"9467","WBGene00011629","I",8905644,8916805,11161
"9468","WBGene00011630","I",8921190,8925327,4137
"9469","WBGene00011631","I",8902747,8905534,2787
"9470","WBGene00011633","II",7846186,7847666,1480
"9471","WBGene00011634","II",7852821,7853779,958
"9472","WBGene00011635","II",7855135,7855719,584
"9473","WBGene00011636","II",7855814,7857600,1786
"9474","WBGene00011637","II",7858401,7859781,1380
"9475","WBGene00011638","II",7864074,7866256,2182
"9476","WBGene00011639","II",7866256,7870162,3906
"9477","WBGene00011640","II",7832391,7832668,277
"9478","WBGene00011641","II",7857811,7858334,523
"9479","WBGene00011642","X",9757271,9759306,2035
"9480","WBGene00011643","X",9761483,9764922,3439
"9481","WBGene00011644","X",9759297,9761281,1984
"9482","WBGene00011645","X",9771697,9774352,2655
"9483","WBGene00011646","X",9777831,9780251,2420
"9484","WBGene00011647","V",13152894,13176111,23217
"9485","WBGene00011648","V",13180330,13181534,1204
"9486","WBGene00011649","V",13181580,13184237,2657
"9487","WBGene00011650","I",12337968,12339239,1271
"9488","WBGene00011651","I",12341145,12342826,1681
"9489","WBGene00011652","I",12369189,12370607,1418
"9490","WBGene00011653","I",12359942,12363416,3474
"9491","WBGene00011654","I",12356942,12359341,2399
"9492","WBGene00011655","I",12366335,12368619,2284
"9493","WBGene00011656","I",12353506,12356337,2831
"9494","WBGene00011657","I",12350692,12352724,2032
"9495","WBGene00011658","I",12347700,12349819,2119
"9496","WBGene00011659","I",12345819,12347265,1446
"9497","WBGene00011660","I",12344167,12345702,1535
"9498","WBGene00011661","II",10385333,10388133,2800
"9499","WBGene00011662","II",10391154,10393614,2460
"9500","WBGene00011663","II",10395707,10396756,1049
"9501","WBGene00011664","II",10396878,10399320,2442
"9502","WBGene00011665","V",15149046,15150733,1687
"9503","WBGene00011666","V",15150961,15151638,677
"9504","WBGene00011668","V",15175673,15176324,651
"9505","WBGene00011669","V",15180057,15181785,1728
"9506","WBGene00011670","V",15182440,15184125,1685
"9507","WBGene00011671","II",9795848,9797740,1892
"9508","WBGene00011672","II",9798277,9800363,2086
"9509","WBGene00011673","II",9800761,9802721,1960
"9510","WBGene00011674","II",9805627,9807532,1905
"9511","WBGene00011675","II",9788801,9793284,4483
"9512","WBGene00011676","II",9783403,9787419,4016
"9513","WBGene00011677","II",9779182,9781950,2768
"9514","WBGene00011678","II",9775146,9775883,737
"9515","WBGene00011679","X",15173904,15178145,4241
"9516","WBGene00011680","X",15178096,15181501,3405
"9517","WBGene00011681","X",15190100,15193066,2966
"9518","WBGene00011682","X",15195922,15199136,3214
"9519","WBGene00011683","X",15193086,15194324,1238
"9520","WBGene00011684","X",15161283,15166222,4939
"9521","WBGene00011685","X",15164408,15164859,451
"9522","WBGene00011686","V",16012537,16014226,1689
"9523","WBGene00011687","V",16023351,16024185,834
"9524","WBGene00011688","V",16024326,16027454,3128
"9525","WBGene00011689","V",16027449,16031713,4264
"9526","WBGene00011690","V",16034211,16035381,1170
"9527","WBGene00011691","V",16036413,16038293,1880
"9528","WBGene00011692","V",13469066,13473679,4613
"9529","WBGene00011693","V",13477384,13479858,2474
"9530","WBGene00011694","V",13487026,13489626,2600
"9531","WBGene00011695","V",13482075,13484435,2360
"9532","WBGene00011696","V",13491068,13497372,6304
"9533","WBGene00011697","V",15270147,15272363,2216
"9534","WBGene00011698","V",15285605,15287925,2320
"9535","WBGene00011699","V",15288924,15291107,2183
"9536","WBGene00011701","V",9866628,9868411,1783
"9537","WBGene00011702","V",9869887,9871439,1552
"9538","WBGene00011703","V",9874009,9875899,1890
"9539","WBGene00011704","V",9880114,9881181,1067
"9540","WBGene00011705","V",9882034,9885960,3926
"9541","WBGene00011706","IV",8840725,8842805,2080
"9542","WBGene00011707","IV",8843621,8844491,870
"9543","WBGene00011708","IV",8855296,8856063,767
"9544","WBGene00011709","V",11459580,11461547,1967
"9545","WBGene00011710","V",11475938,11476906,968
"9546","WBGene00011712","V",11487152,11488275,1123
"9547","WBGene00011713","V",11493556,11496379,2823
"9548","WBGene00011714","V",11482355,11482653,298
"9549","WBGene00011715","V",11480697,11480834,137
"9550","WBGene00011716","V",11491829,11492590,761
"9551","WBGene00011717","IV",10855485,10858559,3074
"9552","WBGene00011718","IV",10852669,10855366,2697
"9553","WBGene00011719","IV",10849749,10851933,2184
"9554","WBGene00011720","IV",10835827,10842761,6934
"9555","WBGene00011721","IV",10844594,10845620,1026
"9556","WBGene00011722","IV",10861402,10864232,2830
"9557","WBGene00011723","IV",11756381,11761064,4683
"9558","WBGene00011724","IV",11752987,11754387,1400
"9559","WBGene00011725","IV",11768639,11773742,5103
"9560","WBGene00011726","IV",11779216,11786969,7753
"9561","WBGene00011727","IV",11749154,11751074,1920
"9562","WBGene00011728","IV",11751450,11752945,1495
"9563","WBGene00011729","III",13643916,13656637,12721
"9564","WBGene00011730","III",13642420,13643570,1150
"9565","WBGene00011731","III",13639893,13641688,1795
"9566","WBGene00011732","III",13626994,13630808,3814
"9567","WBGene00011733","III",13625968,13626750,782
"9568","WBGene00011734","III",13623279,13624172,893
"9569","WBGene00011735","III",13614699,13622489,7790
"9570","WBGene00011736","III",13617104,13621439,4335
"9571","WBGene00011737","IV",12034252,12037051,2799
"9572","WBGene00011738","IV",12038985,12046967,7982
"9573","WBGene00011739","IV",12048256,12049943,1687
"9574","WBGene00011740","IV",12031314,12032154,840
"9575","WBGene00011741","IV",12030047,12031271,1224
"9576","WBGene00011742","IV",12026882,12029174,2292
"9577","WBGene00011743","IV",9796688,9797354,666
"9578","WBGene00011744","IV",9789808,9791917,2109
"9579","WBGene00011745","IV",9781043,9784686,3643
"9580","WBGene00011746","IV",9778288,9781203,2915
"9581","WBGene00011747","IV",9774563,9777634,3071
"9582","WBGene00011748","IV",9768057,9768984,927
"9583","WBGene00011749","IV",9765669,9766436,767
"9584","WBGene00011750","V",16258442,16260686,2244
"9585","WBGene00011751","V",16265097,16265607,510
"9586","WBGene00011752","V",16266792,16269567,2775
"9587","WBGene00011753","V",16270216,16271223,1007
"9588","WBGene00011754","V",16272686,16275410,2724
"9589","WBGene00011755","II",8487571,8509055,21484
"9590","WBGene00011756","II",8514118,8516891,2773
"9591","WBGene00011757","II",8520905,8523490,2585
"9592","WBGene00011758","II",8523494,8525396,1902
"9593","WBGene00011759","II",8525685,8526804,1119
"9594","WBGene00011760","II",8526799,8531222,4423
"9595","WBGene00011761","II",8518510,8520700,2190
"9596","WBGene00011762","IV",9964245,9966630,2385
"9597","WBGene00011763","X",9664499,9668755,4256
"9598","WBGene00011765","X",14406117,14411181,5064
"9599","WBGene00011767","II",8845598,8848902,3304
"9600","WBGene00011768","II",8848843,8852096,3253
"9601","WBGene00011770","X",12858019,12859541,1522
"9602","WBGene00011771","X",12861237,12870025,8788
"9603","WBGene00011772","X",12862039,12863896,1857
"9604","WBGene00011773","IV",10158038,10159243,1205
"9605","WBGene00011774","IV",10155775,10156771,996
"9606","WBGene00011775","IV",10151949,10155636,3687
"9607","WBGene00011776","IV",10147031,10149038,2007
"9608","WBGene00011777","IV",10146226,10147105,879
"9609","WBGene00011778","I",12371350,12372647,1297
"9610","WBGene00011779","I",12374205,12376649,2444
"9611","WBGene00011780","I",12381808,12383259,1451
"9612","WBGene00011781","I",12385766,12388791,3025
"9613","WBGene00011782","I",12389760,12391004,1244
"9614","WBGene00011783","I",12392009,12393585,1576
"9615","WBGene00011784","I",12394120,12396322,2202
"9616","WBGene00011785","I",12396644,12398267,1623
"9617","WBGene00011786","I",12399323,12401206,1883
"9618","WBGene00011788","II",9615800,9617125,1325
"9619","WBGene00011789","II",9611873,9613403,1530
"9620","WBGene00011790","II",9610678,9611372,694
"9621","WBGene00011791","II",9607533,9609396,1863
"9622","WBGene00011793","V",14205776,14209010,3234
"9623","WBGene00011794","V",14215343,14226414,11071
"9624","WBGene00011795","V",14213552,14215100,1548
"9625","WBGene00011796","V",12929478,12932966,3488
"9626","WBGene00011797","V",12942365,12944329,1964
"9627","WBGene00011798","V",12940148,12941847,1699
"9628","WBGene00011799","V",12937654,12939506,1852
"9629","WBGene00011800","V",12935538,12937263,1725
"9630","WBGene00011801","V",12932941,12935112,2171
"9631","WBGene00011802","V",12946815,12950658,3843
"9632","WBGene00011803","III",10040191,10049857,9666
"9633","WBGene00011804","III",10052051,10054302,2251
"9634","WBGene00011805","III",10057822,10058684,862
"9635","WBGene00011806","III",10064337,10069201,4864
"9636","WBGene00011807","III",10069564,10075995,6431
"9637","WBGene00011808","III",10038458,10040113,1655
"9638","WBGene00011809","III",10059302,10061982,2680
"9639","WBGene00011810","III",10076387,10078707,2320
"9640","WBGene00011811","III",10083462,10085328,1866
"9641","WBGene00011812","III",10086303,10087171,868
"9642","WBGene00011813","III",10081443,10083286,1843
"9643","WBGene00011814","III",10088757,10090800,2043
"9644","WBGene00011815","III",10090862,10098081,7219
"9645","WBGene00011816","III",10104841,10106490,1649
"9646","WBGene00011817","III",10109423,10112108,2685
"9647","WBGene00011818","III",10102012,10104328,2316
"9648","WBGene00011819","III",10087223,10088673,1450
"9649","WBGene00011820","X",12454745,12457934,3189
"9650","WBGene00011821","X",12464640,12466917,2277
"9651","WBGene00011822","X",12463815,12464378,563
"9652","WBGene00011823","X",12449896,12451360,1464
"9653","WBGene00011824","X",12434154,12443915,9761
"9654","WBGene00011826","X",12451356,12454328,2972
"9655","WBGene00011827","I",8377601,8392768,15167
"9656","WBGene00011828","I",8398918,8400472,1554
"9657","WBGene00011829","I",8401389,8403939,2550
"9658","WBGene00011830","V",11217583,11219902,2319
"9659","WBGene00011831","V",11221302,11222834,1532
"9660","WBGene00011832","V",11222772,11226018,3246
"9661","WBGene00011833","V",11234650,11237428,2778
"9662","WBGene00011834","V",11237438,11239331,1893
"9663","WBGene00011835","V",11241879,11244726,2847
"9664","WBGene00011836","V",11248146,11250866,2720
"9665","WBGene00011837","V",11251415,11252529,1114
"9666","WBGene00011838","V",11149705,11151309,1604
"9667","WBGene00011839","V",11172215,11174452,2237
"9668","WBGene00011840","V",17217990,17219004,1014
"9669","WBGene00011841","V",17226959,17227961,1002
"9670","WBGene00011842","V",17229555,17229990,435
"9671","WBGene00011844","V",17239097,17240656,1559
"9672","WBGene00011846","II",9472691,9474467,1776
"9673","WBGene00011847","II",9475055,9476375,1320
"9674","WBGene00011848","II",9477867,9479536,1669
"9675","WBGene00011849","II",9486377,9488260,1883
"9676","WBGene00011850","V",16815567,16820712,5145
"9677","WBGene00011851","V",16841459,16842863,1404
"9678","WBGene00011852","V",16848611,16850130,1519
"9679","WBGene00011853","V",16839145,16841061,1916
"9680","WBGene00011854","V",16820629,16821320,691
"9681","WBGene00011855","IV",9328010,9328745,735
"9682","WBGene00011856","IV",9328973,9330855,1882
"9683","WBGene00011857","IV",9333342,9335525,2183
"9684","WBGene00011858","IV",9337044,9338567,1523
"9685","WBGene00011859","IV",9338587,9339305,718
"9686","WBGene00011860","IV",9341964,9343152,1188
"9687","WBGene00011864","I",10298140,10300598,2458
"9688","WBGene00011867","III",10203821,10209704,5883
"9689","WBGene00011868","III",10212396,10214825,2429
"9690","WBGene00011869","III",10197716,10198352,636
"9691","WBGene00011870","III",10199337,10199859,522
"9692","WBGene00011871","III",10209840,10211093,1253
"9693","WBGene00011872","III",10211041,10211946,905
"9694","WBGene00011873","III",10201623,10202528,905
"9695","WBGene00011874","III",10199894,10201326,1432
"9696","WBGene00011875","III",10218943,10222465,3522
"9697","WBGene00011876","II",12492251,12493623,1372
"9698","WBGene00011877","II",12495487,12496387,900
"9699","WBGene00011878","II",12497217,12502878,5661
"9700","WBGene00011879","X",10938197,10941355,3158
"9701","WBGene00011880","X",10945160,10948970,3810
"9702","WBGene00011882","X",10916765,10920013,3248
"9703","WBGene00011883","II",8929841,8930937,1096
"9704","WBGene00011884","II",8930985,8933833,2848
"9705","WBGene00011885","II",8934382,8939038,4656
"9706","WBGene00011886","II",8940894,8942718,1824
"9707","WBGene00011887","II",8939204,8940488,1284
"9708","WBGene00011888","II",8942674,8947688,5014
"9709","WBGene00011890","V",10576513,10578322,1809
"9710","WBGene00011891","V",10572920,10575449,2529
"9711","WBGene00011892","V",10578428,10579141,713
"9712","WBGene00011893","V",10581887,10587164,5277
"9713","WBGene00011894","V",10589092,10589898,806
"9714","WBGene00011895","V",10590548,10592653,2105
"9715","WBGene00011896","V",10593936,10594906,970
"9716","WBGene00011897","V",10599105,10602147,3042
"9717","WBGene00011898","V",10597266,10598666,1400
"9718","WBGene00011899","III",10538081,10539163,1082
"9719","WBGene00011900","III",10553005,10558009,5004
"9720","WBGene00011902","X",10880842,10881437,595
"9721","WBGene00011903","X",10886278,10887052,774
"9722","WBGene00011904","X",13865038,13882693,17655
"9723","WBGene00011906","I",10581538,10582609,1071
"9724","WBGene00011908","I",10598673,10606620,7947
"9725","WBGene00011909","I",10595545,10598490,2945
"9726","WBGene00011910","IV",11704246,11708264,4018
"9727","WBGene00011911","IV",11703185,11704016,831
"9728","WBGene00011912","I",7936223,7938328,2105
"9729","WBGene00011913","I",7937672,7938486,814
"9730","WBGene00011914","I",7938560,7940388,1828
"9731","WBGene00011915","I",7940134,7940790,656
"9732","WBGene00011916","I",7940893,7941994,1101
"9733","WBGene00011917","I",7942719,7945588,2869
"9734","WBGene00011918","I",7955977,7958505,2528
"9735","WBGene00011919","I",7958647,7960158,1511
"9736","WBGene00011920","I",7966914,7968689,1775
"9737","WBGene00011921","I",7960388,7961460,1072
"9738","WBGene00011922","II",8612770,8614426,1656
"9739","WBGene00011923","II",8614546,8617603,3057
"9740","WBGene00011924","II",8620397,8621978,1581
"9741","WBGene00011925","II",8622447,8624254,1807
"9742","WBGene00011926","II",8625728,8627620,1892
"9743","WBGene00011927","II",8627573,8630239,2666
"9744","WBGene00011928","II",8630710,8634464,3754
"9745","WBGene00011929","V",13876837,13877949,1112
"9746","WBGene00011930","V",13880908,13883937,3029
"9747","WBGene00011931","V",13887658,13889458,1800
"9748","WBGene00011932","V",13893325,13896405,3080
"9749","WBGene00011933","I",11703718,11706612,2894
"9750","WBGene00011934","I",11694722,11694997,275
"9751","WBGene00011935","I",11688680,11690830,2150
"9752","WBGene00011936","I",11701631,11703698,2067
"9753","WBGene00011937","X",12767463,12769797,2334
"9754","WBGene00011938","X",12782396,12787146,4750
"9755","WBGene00011939","IV",12677398,12684378,6980
"9756","WBGene00011940","IV",12688655,12703991,15336
"9757","WBGene00011941","IV",12675207,12676000,793
"9758","WBGene00011942","V",15732863,15733668,805
"9759","WBGene00011943","V",15747480,15748443,963
"9760","WBGene00011944","I",9973377,9976315,2938
"9761","WBGene00011945","I",9989802,9993975,4173
"9762","WBGene00011947","V",15456066,15457445,1379
"9763","WBGene00011948","V",15459413,15464425,5012
"9764","WBGene00011949","IV",12719960,12720997,1037
"9765","WBGene00011950","IV",12721356,12723015,1659
"9766","WBGene00011951","IV",12723103,12724651,1548
"9767","WBGene00011952","IV",12735187,12741523,6336
"9768","WBGene00011953","III",4648591,4653929,5338
"9769","WBGene00011954","III",4654311,4655502,1191
"9770","WBGene00011955","III",4658739,4662697,3958
"9771","WBGene00011956","III",4663185,4665368,2183
"9772","WBGene00011957","III",4646507,4647854,1347
"9773","WBGene00011958","IV",13688324,13689131,807
"9774","WBGene00011959","IV",13685076,13687016,1940
"9775","WBGene00011960","IV",13673804,13677823,4019
"9776","WBGene00011961","IV",13678951,13680333,1382
"9777","WBGene00011962","III",9231421,9236322,4901
"9778","WBGene00011963","III",9229235,9231210,1975
"9779","WBGene00011964","III",9240337,9242514,2177
"9780","WBGene00011965","II",9167933,9172991,5058
"9781","WBGene00011966","II",9165929,9167830,1901
"9782","WBGene00011967","II",9177300,9178585,1285
"9783","WBGene00011968","I",7701365,7702053,688
"9784","WBGene00011969","I",7694325,7695233,908
"9785","WBGene00011970","I",7683341,7694210,10869
"9786","WBGene00011971","I",7684882,7689403,4521
"9787","WBGene00011972","I",7679454,7683041,3587
"9788","WBGene00011973","I",7698301,7699037,736
"9789","WBGene00011974","III",3802452,3804438,1986
"9790","WBGene00011975","I",7676668,7679061,2393
"9791","WBGene00011976","II",9054972,9056504,1532
"9792","WBGene00011977","II",9059389,9061138,1749
"9793","WBGene00011978","II",9063687,9070904,7217
"9794","WBGene00011979","II",9082626,9083146,520
"9795","WBGene00011980","II",9042180,9053824,11644
"9796","WBGene00011981","X",14545855,14546720,865
"9797","WBGene00011982","X",14543557,14544643,1086
"9798","WBGene00011983","X",14540686,14542058,1372
"9799","WBGene00011984","X",14537897,14539522,1625
"9800","WBGene00011985","I",9953409,9955873,2464
"9801","WBGene00011986","I",9958782,9960155,1373
"9802","WBGene00011988","I",9956150,9958357,2207
"9803","WBGene00011989","X",12574069,12577209,3140
"9804","WBGene00011990","X",12583799,12586439,2640
"9805","WBGene00011991","X",12580074,12583213,3139
"9806","WBGene00011992","X",12597168,12597437,269
"9807","WBGene00011993","X",12598031,12599297,1266
"9808","WBGene00011994","II",11302891,11305683,2792
"9809","WBGene00011995","II",11306399,11311940,5541
"9810","WBGene00011996","II",11313331,11314265,934
"9811","WBGene00011997","II",11319241,11319691,450
"9812","WBGene00011999","II",11312460,11313346,886
"9813","WBGene00012000","II",9099371,9100639,1268
"9814","WBGene00012002","II",9109534,9111240,1706
"9815","WBGene00012003","II",9101098,9105451,4353
"9816","WBGene00012004","II",9106515,9107145,630
"9817","WBGene00012005","II",9113219,9132213,18994
"9818","WBGene00012007","IV",10748385,10750141,1756
"9819","WBGene00012008","IV",10750512,10751762,1250
"9820","WBGene00012009","IV",10744779,10748275,3496
"9821","WBGene00012010","IV",10755760,10757716,1956
"9822","WBGene00012011","IV",10752398,10754785,2387
"9823","WBGene00012012","IV",10758126,10760795,2669
"9824","WBGene00012013","IV",10761597,10764496,2899
"9825","WBGene00012014","IV",10766481,10768429,1948
"9826","WBGene00012015","IV",10769653,10777755,8102
"9827","WBGene00012016","IV",10770227,10773747,3520
"9828","WBGene00012017","III",13608072,13614704,6632
"9829","WBGene00012018","X",11491087,11499999,8912
"9830","WBGene00012019","V",16747559,16788435,40876
"9831","WBGene00012020","V",16745080,16746258,1178
"9832","WBGene00012021","V",16742423,16744881,2458
"9833","WBGene00012022","V",16739268,16741588,2320
"9834","WBGene00012023","V",16735765,16737404,1639
"9835","WBGene00012024","V",16737673,16739200,1527
"9836","WBGene00012025","V",16733901,16735594,1693
"9837","WBGene00012026","V",16731900,16733147,1247
"9838","WBGene00012027","V",16728731,16729960,1229
"9839","WBGene00012028","V",16730261,16731464,1203
"9840","WBGene00012029","I",7552975,7554553,1578
"9841","WBGene00012030","I",7559839,7562349,2510
"9842","WBGene00012031","I",7564584,7567719,3135
"9843","WBGene00012032","II",9233223,9236202,2979
"9844","WBGene00012033","II",9236583,9249123,12540
"9845","WBGene00012034","II",9249048,9250522,1474
"9846","WBGene00012035","II",9245905,9246811,906
"9847","WBGene00012036","I",12683238,12684359,1121
"9848","WBGene00012037","I",12665067,12668893,3826
"9849","WBGene00012038","I",12662938,12663833,895
"9850","WBGene00012039","I",12661254,12661729,475
"9851","WBGene00012040","I",12655449,12655970,521
"9852","WBGene00012041","I",12657762,12659446,1684
"9853","WBGene00012042","I",12681883,12682681,798
"9854","WBGene00012043","V",15779693,15781082,1389
"9855","WBGene00012044","V",15781401,15782011,610
"9856","WBGene00012045","V",15782794,15784470,1676
"9857","WBGene00012046","V",15790476,15792583,2107
"9858","WBGene00012047","V",15786872,15788834,1962
"9859","WBGene00012048","V",15784929,15786597,1668
"9860","WBGene00012049","V",15793570,15795194,1624
"9861","WBGene00012050","V",15796387,15797534,1147
"9862","WBGene00012051","V",15799212,15802723,3511
"9863","WBGene00012052","V",15797879,15798208,329
"9864","WBGene00012053","V",15804843,15805750,907
"9865","WBGene00012054","V",15805910,15807520,1610
"9866","WBGene00012055","V",15808119,15810036,1917
"9867","WBGene00012056","V",15777718,15779247,1529
"9868","WBGene00012058","V",13981568,13982971,1403
"9869","WBGene00012059","III",9404484,9406641,2157
"9870","WBGene00012060","III",9412854,9413440,586
"9871","WBGene00012061","III",9420531,9421574,1043
"9872","WBGene00012062","III",9425536,9426674,1138
"9873","WBGene00012063","V",19240354,19241624,1270
"9874","WBGene00012064","V",19238421,19239849,1428
"9875","WBGene00012065","V",19236091,19237298,1207
"9876","WBGene00012066","V",19233937,19235585,1648
"9877","WBGene00012067","V",19230765,19232020,1255
"9878","WBGene00012068","V",19217975,19222908,4933
"9879","WBGene00012069","V",15447640,15448138,498
"9880","WBGene00012070","V",15427305,15432722,5417
"9881","WBGene00012072","V",15305802,15306845,1043
"9882","WBGene00012073","X",16049844,16054623,4779
"9883","WBGene00012074","X",16057719,16058934,1215
"9884","WBGene00012075","X",16062685,16063290,605
"9885","WBGene00012076","X",16067069,16067463,394
"9886","WBGene00012077","X",16063860,16066877,3017
"9887","WBGene00012078","V",17406306,17407503,1197
"9888","WBGene00012079","V",17412602,17413098,496
"9889","WBGene00012080","V",17413929,17414751,822
"9890","WBGene00012081","V",17417133,17418391,1258
"9891","WBGene00012083","V",17429701,17430166,465
"9892","WBGene00012084","III",3683253,3685808,2555
"9893","WBGene00012085","II",11842617,11846026,3409
"9894","WBGene00012086","II",11831062,11832575,1513
"9895","WBGene00012087","IV",14519759,14520999,1240
"9896","WBGene00012088","IV",14529018,14530809,1791
"9897","WBGene00012089","IV",14533518,14535067,1549
"9898","WBGene00012090","IV",14537163,14538325,1162
"9899","WBGene00012091","IV",14539762,14542602,2840
"9900","WBGene00012093","IV",14546933,14549386,2453
"9901","WBGene00012094","III",13462239,13462594,355
"9902","WBGene00012095","III",13471804,13475385,3581
"9903","WBGene00012096","III",13475406,13476107,701
"9904","WBGene00012097","III",13457687,13462238,4551
"9905","WBGene00012098","III",13478561,13479629,1068
"9906","WBGene00012099","III",13480665,13484155,3490
"9907","WBGene00012100","V",11631434,11637291,5857
"9908","WBGene00012101","V",11650079,11650774,695
"9909","WBGene00012102","I",12470620,12473404,2784
"9910","WBGene00012103","I",12476685,12478588,1903
"9911","WBGene00012104","I",12483809,12486235,2426
"9912","WBGene00012105","I",12490976,12494530,3554
"9913","WBGene00012106","I",12494826,12497354,2528
"9914","WBGene00012107","I",12497438,12499817,2379
"9915","WBGene00012108","III",13493892,13495671,1779
"9916","WBGene00012109","III",13506018,13508650,2632
"9917","WBGene00012110","III",13503679,13505536,1857
"9918","WBGene00012111","III",13501609,13502715,1106
"9919","WBGene00012112","III",13499199,13501510,2311
"9920","WBGene00012113","I",8133891,8135051,1160
"9921","WBGene00012114","I",8151985,8159732,7747
"9922","WBGene00012115","I",8160512,8168643,8131
"9923","WBGene00012116","I",8139468,8142537,3069
"9924","WBGene00012117","V",10712165,10732507,20342
"9925","WBGene00012118","IV",8816335,8818525,2190
"9926","WBGene00012119","IV",8820356,8821265,909
"9927","WBGene00012120","IV",8821447,8822874,1427
"9928","WBGene00012121","IV",8827802,8840682,12880
"9929","WBGene00012122","IV",8829549,8830727,1178
"9930","WBGene00012123","III",11366618,11368435,1817
"9931","WBGene00012124","III",11360456,11366214,5758
"9932","WBGene00012125","III",11334611,11342237,7626
"9933","WBGene00012126","III",11326654,11343108,16454
"9934","WBGene00012127","III",11344255,11346789,2534
"9935","WBGene00012128","IV",17281456,17284199,2743
"9936","WBGene00012130","IV",17288171,17291733,3562
"9937","WBGene00012131","IV",17294793,17300629,5836
"9938","WBGene00012132","IV",17300809,17302033,1224
"9939","WBGene00012133","IV",17302242,17304370,2128
"9940","WBGene00012134","IV",17305115,17307414,2299
"9941","WBGene00012135","IV",17308525,17311695,3170
"9942","WBGene00012136","I",7472611,7476946,4335
"9943","WBGene00012137","I",7480108,7483392,3284
"9944","WBGene00012138","I",7484159,7486302,2143
"9945","WBGene00012139","I",7486564,7494700,8136
"9946","WBGene00012140","I",7491816,7492934,1118
"9947","WBGene00012142","V",12503801,12505146,1345
"9948","WBGene00012143","V",12510645,12512201,1556
"9949","WBGene00012144","V",12512986,12514941,1955
"9950","WBGene00012145","V",12505244,12506260,1016
"9951","WBGene00012147","V",12165470,12166662,1192
"9952","WBGene00012148","II",11698317,11700300,1983
"9953","WBGene00012149","II",11705989,11713610,7621
"9954","WBGene00012150","I",8644460,8646304,1844
"9955","WBGene00012151","I",7781178,7782548,1370
"9956","WBGene00012152","V",11183224,11183643,419
"9957","WBGene00012155","II",11439177,11439762,585
"9958","WBGene00012156","II",11442693,11444009,1316
"9959","WBGene00012157","II",11444162,11445255,1093
"9960","WBGene00012158","X",11968034,12021212,53178
"9961","WBGene00012159","IV",16469580,16470881,1301
"9962","WBGene00012162","X",10031088,10033283,2195
"9963","WBGene00012163","IV",11912005,11913245,1240
"9964","WBGene00012164","I",7053773,7056875,3102
"9965","WBGene00012165","I",7065263,7067899,2636
"9966","WBGene00012166","I",7068106,7069186,1080
"9967","WBGene00012167","I",7069440,7070728,1288
"9968","WBGene00012168","I",7070649,7074733,4084
"9969","WBGene00012169","IV",10073404,10075166,1762
"9970","WBGene00012170","IV",10070270,10072626,2356
"9971","WBGene00012171","IV",10075414,10075775,361
"9972","WBGene00012172","IV",10076325,10078705,2380
"9973","WBGene00012173","IV",10081155,10082610,1455
"9974","WBGene00012174","IV",10083491,10084440,949
"9975","WBGene00012175","II",8533095,8534363,1268
"9976","WBGene00012176","II",8536133,8538603,2470
"9977","WBGene00012177","II",8545652,8546854,1202
"9978","WBGene00012178","II",8547339,8556258,8919
"9979","WBGene00012179","II",14815518,14816212,694
"9980","WBGene00012180","II",14800918,14804309,3391
"9981","WBGene00012181","II",14805986,14808087,2101
"9982","WBGene00012182","II",14812182,14814889,2707
"9983","WBGene00012183","II",14808922,14809204,282
"9984","WBGene00012184","V",20654652,20659742,5090
"9985","WBGene00012185","V",20660325,20662031,1706
"9986","WBGene00012186","V",20667209,20678513,11304
"9987","WBGene00012187","II",14060061,14060624,563
"9988","WBGene00012188","II",14060739,14062960,2221
"9989","WBGene00012189","IV",13339724,13342333,2609
"9990","WBGene00012190","IV",13342858,13346189,3331
"9991","WBGene00012191","IV",13356113,13358601,2488
"9992","WBGene00012192","I",12730011,12732753,2742
"9993","WBGene00012193","I",12733287,12741275,7988
"9994","WBGene00012194","I",12738087,12741141,3054
"9995","WBGene00012195","I",12749890,12752087,2197
"9996","WBGene00012196","I",12758433,12759572,1139
"9997","WBGene00012197","II",13898366,13902114,3748
"9998","WBGene00012198","II",13908921,13915254,6333
"9999","WBGene00012199","II",13916340,13919838,3498
"10000","WBGene00012200","II",13920555,13924724,4169
"10001","WBGene00012201","II",11448965,11451445,2480
"10002","WBGene00012202","II",11455759,11459356,3597
"10003","WBGene00012203","II",11464892,11468653,3761
"10004","WBGene00012204","II",11470010,11472033,2023
"10005","WBGene00012205","II",11472135,11473571,1436
"10006","WBGene00012206","II",11473861,11476019,2158
"10007","WBGene00012207","II",11476757,11479176,2419
"10008","WBGene00012208","I",12532669,12534400,1731
"10009","WBGene00012209","I",12535312,12537671,2359
"10010","WBGene00012210","I",12537903,12538986,1083
"10011","WBGene00012211","I",12561040,12561560,520
"10012","WBGene00012212","I",12560292,12560714,422
"10013","WBGene00012213","I",12559245,12559674,429
"10014","WBGene00012214","I",12558547,12558944,397
"10015","WBGene00012215","I",12557164,12557563,399
"10016","WBGene00012216","I",12551537,12552375,838
"10017","WBGene00012217","X",11102587,11105460,2873
"10018","WBGene00012218","X",11096158,11096935,777
"10019","WBGene00012219","II",11960989,11962128,1139
"10020","WBGene00012220","II",11962111,11965258,3147
"10021","WBGene00012221","II",11967048,11967533,485
"10022","WBGene00012222","II",11953239,11960743,7504
"10023","WBGene00012223","II",11948727,11949474,747
"10024","WBGene00012224","X",12106407,12108617,2210
"10025","WBGene00012225","X",12100196,12103812,3616
"10026","WBGene00012226","X",12076553,12093083,16530
"10027","WBGene00012227","II",14147342,14150131,2789
"10028","WBGene00012228","II",14142949,14143874,925
"10029","WBGene00012230","II",14133397,14142289,8892
"10030","WBGene00012231","I",13682137,13684417,2280
"10031","WBGene00012232","I",13680415,13681366,951
"10032","WBGene00012233","I",13676255,13677792,1537
"10033","WBGene00012234","I",13663462,13674997,11535
"10034","WBGene00012235","I",13685303,13687582,2279
"10035","WBGene00012236","I",13835292,13840047,4755
"10036","WBGene00012237","I",13840706,13841846,1140
"10037","WBGene00012238","I",13844729,13846957,2228
"10038","WBGene00012239","I",13841895,13843480,1585
"10039","WBGene00012240","I",13849599,13850893,1294
"10040","WBGene00012241","I",13854632,13859699,5067
"10041","WBGene00012242","V",12484885,12486068,1183
"10042","WBGene00012243","V",12494728,12497755,3027
"10043","WBGene00012244","V",12493239,12494622,1383
"10044","WBGene00012245","V",12498213,12503738,5525
"10045","WBGene00012246","V",19738417,19739393,976
"10046","WBGene00012247","V",19739559,19741117,1558
"10047","WBGene00012248","V",19741951,19742312,361
"10048","WBGene00012249","V",19743634,19745753,2119
"10049","WBGene00012250","V",19746152,19748540,2388
"10050","WBGene00012251","V",19748987,19751212,2225
"10051","WBGene00012252","V",19735077,19737607,2530
"10052","WBGene00012253","V",19752400,19755368,2968
"10053","WBGene00012254","V",19756553,19758552,1999
"10054","WBGene00012255","X",11059994,11061868,1874
"10055","WBGene00012256","X",11062132,11064539,2407
"10056","WBGene00012257","X",11065133,11066811,1678
"10057","WBGene00012258","X",11073658,11076043,2385
"10058","WBGene00012259","X",11080678,11087474,6796
"10059","WBGene00012260","X",11084018,11085274,1256
"10060","WBGene00012261","X",11057401,11059794,2393
"10061","WBGene00012264","I",11629641,11629932,291
"10062","WBGene00012265","I",11630064,11632879,2815
"10063","WBGene00012266","I",11634613,11636910,2297
"10064","WBGene00012267","I",11652789,11654254,1465
"10065","WBGene00012268","I",11649982,11651912,1930
"10066","WBGene00012269","I",11642625,11645420,2795
"10067","WBGene00012270","I",11638482,11640414,1932
"10068","WBGene00012271","III",10960243,10966996,6753
"10069","WBGene00012272","III",10969944,10991912,21968
"10070","WBGene00012274","I",13033483,13045555,12072
"10071","WBGene00012275","I",13050445,13057435,6990
"10072","WBGene00012276","V",12659704,12660330,626
"10073","WBGene00012277","V",12658668,12659687,1019
"10074","WBGene00012278","V",12661304,12661659,355
"10075","WBGene00012279","V",12668226,12669689,1463
"10076","WBGene00012280","V",11689413,11691691,2278
"10077","WBGene00012281","V",11687426,11689174,1748
"10078","WBGene00012282","V",11693188,11695697,2509
"10079","WBGene00012283","II",12443119,12444779,1660
"10080","WBGene00012285","II",12445332,12447769,2437
"10081","WBGene00012286","II",12451593,12452854,1261
"10082","WBGene00012287","II",12453302,12454693,1391
"10083","WBGene00012288","II",12454954,12456733,1779
"10084","WBGene00012289","I",13418458,13423379,4921
"10085","WBGene00012290","I",13411594,13412879,1285
"10086","WBGene00012291","V",14821853,14824453,2600
"10087","WBGene00012292","X",9622824,9622895,71
"10088","WBGene00012293","V",14824664,14829533,4869
"10089","WBGene00012294","V",14826866,14827098,232
"10090","WBGene00012295","X",12014250,12016190,1940
"10091","WBGene00012296","I",9056293,9057822,1529
"10092","WBGene00012297","I",9058852,9060473,1621
"10093","WBGene00012298","I",9060493,9063160,2667
"10094","WBGene00012299","X",12293767,12295311,1544
"10095","WBGene00012300","X",12296047,12296644,597
"10096","WBGene00012301","X",12298683,12300022,1339
"10097","WBGene00012302","X",12301488,12302817,1329
"10098","WBGene00012303","X",12300134,12301282,1148
"10099","WBGene00012304","V",17733568,17739899,6331
"10100","WBGene00012305","V",17706114,17706875,761
"10101","WBGene00012306","III",13726641,13731679,5038
"10102","WBGene00012307","III",13735071,13736541,1470
"10103","WBGene00012308","V",16624008,16627970,3962
"10104","WBGene00012309","V",16629291,16629648,357
"10105","WBGene00012310","V",16638966,16641637,2671
"10106","WBGene00012311","V",16645997,16646481,484
"10107","WBGene00012312","V",16646791,16647193,402
"10108","WBGene00012313","V",16649031,16649300,269
"10109","WBGene00012315","V",16789267,16792771,3504
"10110","WBGene00012316","V",16794878,16802004,7126
"10111","WBGene00012317","I",11206922,11211842,4920
"10112","WBGene00012318","V",20732087,20733206,1119
"10113","WBGene00012319","V",20717872,20729271,11399
"10114","WBGene00012320","V",20733389,20734460,1071
"10115","WBGene00012321","V",20734983,20736149,1166
"10116","WBGene00012322","II",9146261,9152311,6050
"10117","WBGene00012323","II",9158108,9159874,1766
"10118","WBGene00012324","II",9161379,9163448,2069
"10119","WBGene00012325","II",9163368,9165800,2432
"10120","WBGene00012326","X",10084627,10104252,19625
"10121","WBGene00012328","II",13937995,13939631,1636
"10122","WBGene00012329","II",13949590,13951869,2279
"10123","WBGene00012330","II",13951906,13957543,5637
"10124","WBGene00012332","II",13959239,13962417,3178
"10125","WBGene00012333","II",13966534,13969079,2545
"10126","WBGene00012334","II",13964891,13966333,1442
"10127","WBGene00012335","V",13033529,13034164,635
"10128","WBGene00012336","V",13034895,13036581,1686
"10129","WBGene00012337","V",13036996,13041879,4883
"10130","WBGene00012339","V",13047980,13049238,1258
"10131","WBGene00012340","IV",9806416,9810733,4317
"10132","WBGene00012341","IV",9817412,9824632,7220
"10133","WBGene00012342","IV",9825694,9830620,4926
"10134","WBGene00012343","I",13333380,13336146,2766
"10135","WBGene00012344","I",13340327,13343940,3613
"10136","WBGene00012345","I",13337460,13338921,1461
"10137","WBGene00012346","V",16347060,16349833,2773
"10138","WBGene00012347","V",16367681,16372097,4416
"10139","WBGene00012348","V",16357521,16367574,10053
"10140","WBGene00012349","V",16344375,16346506,2131
"10141","WBGene00012350","X",15146562,15146634,72
"10142","WBGene00012351","I",13626522,13628447,1925
"10143","WBGene00012352","I",13640297,13648405,8108
"10144","WBGene00012353","I",13654009,13658167,4158
"10145","WBGene00012354","I",13658171,13659128,957
"10146","WBGene00012355","I",13659431,13661765,2334
"10147","WBGene00012356","III",11068858,11072981,4123
"10148","WBGene00012357","III",11079745,11080413,668
"10149","WBGene00012358","III",11088487,11091616,3129
"10150","WBGene00012359","III",10736893,10739824,2931
"10151","WBGene00012360","III",10722148,10730705,8557
"10152","WBGene00012361","III",10707761,10708518,757
"10153","WBGene00012362","III",10711724,10716191,4467
"10154","WBGene00012363","III",10708484,10711527,3043
"10155","WBGene00012364","V",14917735,14921609,3874
"10156","WBGene00012365","I",13828102,13832146,4044
"10157","WBGene00012368","I",13829662,13831607,1945
"10158","WBGene00012369","I",13814756,13827988,13232
"10159","WBGene00012370","I",13797345,13802259,4914
"10160","WBGene00012371","I",13812136,13814355,2219
"10161","WBGene00012372","II",13175857,13181561,5704
"10162","WBGene00012373","II",13184429,13185023,594
"10163","WBGene00012374","II",13185092,13185914,822
"10164","WBGene00012375","II",13185987,13187351,1364
"10165","WBGene00012376","I",9108173,9110918,2745
"10166","WBGene00012378","X",16245194,16245559,365
"10167","WBGene00012379","III",3985565,3986809,1244
"10168","WBGene00012380","III",3984367,3984670,303
"10169","WBGene00012381","V",13445745,13448815,3070
"10170","WBGene00012382","IV",11063512,11064152,640
"10171","WBGene00012383","IV",11066018,11067072,1054
"10172","WBGene00012384","IV",11069387,11070950,1563
"10173","WBGene00012385","IV",11076085,11078582,2497
"10174","WBGene00012386","I",13603885,13626225,22340
"10175","WBGene00012387","I",13692929,13702954,10025
"10176","WBGene00012388","I",13709779,13719528,9749
"10177","WBGene00012389","I",13756730,13771773,15043
"10178","WBGene00012390","I",13751234,13756354,5120
"10179","WBGene00012391","I",13746673,13750483,3810
"10180","WBGene00012393","I",13734958,13751124,16166
"10181","WBGene00012394","I",13720125,13724453,4328
"10182","WBGene00012395","II",11821315,11823616,2301
"10183","WBGene00012396","II",11818248,11819924,1676
"10184","WBGene00012397","V",15709578,15710501,923
"10185","WBGene00012398","V",15712248,15715644,3396
"10186","WBGene00012399","V",15716419,15718660,2241
"10187","WBGene00012400","V",15719870,15721292,1422
"10188","WBGene00012401","V",15724849,15726702,1853
"10189","WBGene00012402","V",15726841,15728353,1512
"10190","WBGene00012403","V",17592387,17594243,1856
"10191","WBGene00012404","V",17594349,17598971,4622
"10192","WBGene00012405","V",17601820,17602954,1134
"10193","WBGene00012406","V",17608097,17609597,1500
"10194","WBGene00012407","X",15767437,15771509,4072
"10195","WBGene00012408","X",15771707,15772735,1028
"10196","WBGene00012409","X",15781625,15784670,3045
"10197","WBGene00012411","X",15786529,15786826,297
"10198","WBGene00012412","X",15797332,15799695,2363
"10199","WBGene00012413","X",15801310,15804172,2862
"10200","WBGene00012414","X",15822552,15823055,503
"10201","WBGene00012415","X",15827149,15827893,744
"10202","WBGene00012416","IV",16197048,16201417,4369
"10203","WBGene00012418","IV",16294154,16298479,4325
"10204","WBGene00012419","IV",16289558,16290835,1277
"10205","WBGene00012420","IV",16381378,16382235,857
"10206","WBGene00012421","II",9139651,9145352,5701
"10207","WBGene00012423","IV",16424637,16429895,5258
"10208","WBGene00012424","IV",16432231,16437953,5722
"10209","WBGene00012425","IV",16443263,16446683,3420
"10210","WBGene00012426","IV",9228277,9231051,2774
"10211","WBGene00012428","IV",9233028,9241387,8359
"10212","WBGene00012429","IV",9244520,9245523,1003
"10213","WBGene00012431","IV",9249523,9250459,936
"10214","WBGene00012432","IV",9251379,9253913,2534
"10215","WBGene00012433","IV",9253979,9256117,2138
"10216","WBGene00012434","IV",9258913,9259764,851
"10217","WBGene00012435","IV",9261808,9264265,2457
"10218","WBGene00012436","IV",9270096,9271935,1839
"10219","WBGene00012437","IV",9274416,9283113,8697
"10220","WBGene00012439","X",13619938,13621728,1790
"10221","WBGene00012440","X",13618874,13619930,1056
"10222","WBGene00012441","X",15314874,15317223,2349
"10223","WBGene00012442","X",15322249,15325809,3560
"10224","WBGene00012443","X",15330964,15333960,2996
"10225","WBGene00012444","X",15343154,15344146,992
"10226","WBGene00012445","X",14761966,14771885,9919
"10227","WBGene00012446","V",18846817,18852729,5912
"10228","WBGene00012448","V",18832327,18837214,4887
"10229","WBGene00012449","V",18790958,18794781,3823
"10230","WBGene00012450","V",18787806,18789617,1811
"10231","WBGene00012451","V",18784954,18786788,1834
"10232","WBGene00012452","V",18776198,18780216,4018
"10233","WBGene00012453","V",18775226,18776195,969
"10234","WBGene00012454","V",18771690,18772639,949
"10235","WBGene00012455","V",18706570,18708363,1793
"10236","WBGene00012456","V",18716075,18719944,3869
"10237","WBGene00012457","II",11972310,11973732,1422
"10238","WBGene00012458","II",11979838,11989017,9179
"10239","WBGene00012459","II",11989024,11992823,3799
"10240","WBGene00012460","II",11993001,11998009,5008
"10241","WBGene00012461","II",12009077,12023825,14748
"10242","WBGene00012462","II",12025887,12027747,1860
"10243","WBGene00012463","II",12049583,12059866,10283
"10244","WBGene00012464","II",12060228,12062621,2393
"10245","WBGene00012465","II",12023861,12025932,2071
"10246","WBGene00012466","II",12042910,12049260,6350
"10247","WBGene00012467","II",12065085,12067568,2483
"10248","WBGene00012468","II",12092422,12099989,7567
"10249","WBGene00012469","II",12103331,12107857,4526
"10250","WBGene00012470","II",12108273,12112552,4279
"10251","WBGene00012471","II",11977784,11979859,2075
"10252","WBGene00012472","II",11975190,11977659,2469
"10253","WBGene00012473","II",12068099,12070675,2576
"10254","WBGene00012474","I",12787944,12806581,18637
"10255","WBGene00012475","I",12807586,12809682,2096
"10256","WBGene00012476","I",12809999,12815641,5642
"10257","WBGene00012477","I",12815904,12816428,524
"10258","WBGene00012478","I",12844269,12853105,8836
"10259","WBGene00012479","I",12853088,12858272,5184
"10260","WBGene00012480","I",12859499,12861197,1698
"10261","WBGene00012481","I",12861951,12863544,1593
"10262","WBGene00012482","I",12866120,12866896,776
"10263","WBGene00012483","I",12903059,12904072,1013
"10264","WBGene00012484","I",12904470,12906212,1742
"10265","WBGene00012485","I",12906462,12907754,1292
"10266","WBGene00012486","I",12929372,12931069,1697
"10267","WBGene00012487","I",12866991,12869556,2565
"10268","WBGene00012488","I",12864230,12865568,1338
"10269","WBGene00012489","II",10922672,10922974,302
"10270","WBGene00012490","II",10923716,10924595,879
"10271","WBGene00012491","V",17371544,17376745,5201
"10272","WBGene00012492","V",17377406,17379226,1820
"10273","WBGene00012493","V",17382090,17383373,1283
"10274","WBGene00012494","V",10256360,10258654,2294
"10275","WBGene00012496","IV",11605254,11607457,2203
"10276","WBGene00012497","IV",11603613,11604927,1314
"10277","WBGene00012498","IV",11608900,11610910,2010
"10278","WBGene00012499","IV",11616121,11617984,1863
"10279","WBGene00012500","I",13066924,13069038,2114
"10280","WBGene00012501","I",13072229,13072958,729
"10281","WBGene00012502","I",13069529,13071190,1661
"10282","WBGene00012503","I",13076270,13077020,750
"10283","WBGene00012504","I",13081448,13082166,718
"10284","WBGene00012505","I",13083321,13085505,2184
"10285","WBGene00012509","I",13082681,13082966,285
"10286","WBGene00012512","X",13914806,13917171,2365
"10287","WBGene00012513","X",13910937,13912978,2041
"10288","WBGene00012514","X",13908414,13909950,1536
"10289","WBGene00012515","V",17692502,17695902,3400
"10290","WBGene00012516","V",16488472,16489104,632
"10291","WBGene00012517","V",16489531,16490520,989
"10292","WBGene00012518","V",16493655,16494449,794
"10293","WBGene00012519","V",16494730,16495227,497
"10294","WBGene00012520","V",16486978,16487574,596
"10295","WBGene00012521","V",16537001,16537771,770
"10296","WBGene00012522","V",16538396,16549854,11458
"10297","WBGene00012523","V",16550980,16552282,1302
"10298","WBGene00012524","V",16553327,16563504,10177
"10299","WBGene00012525","V",16606619,16608194,1575
"10300","WBGene00012526","V",16612792,16615128,2336
"10301","WBGene00012527","V",10436912,10441149,4237
"10302","WBGene00012528","V",10441979,10446459,4480
"10303","WBGene00012529","V",10428726,10433604,4878
"10304","WBGene00012530","V",10446534,10453781,7247
"10305","WBGene00012531","V",10480949,10484740,3791
"10306","WBGene00012532","V",10478566,10480963,2397
"10307","WBGene00012533","V",15423746,15425498,1752
"10308","WBGene00012535","IV",13905991,13912297,6306
"10309","WBGene00012536","IV",13897817,13902874,5057
"10310","WBGene00012537","IV",14059551,14060712,1161
"10311","WBGene00012538","IV",14051200,14056676,5476
"10312","WBGene00012540","IV",14042595,14043780,1185
"10313","WBGene00012541","IV",14020198,14024628,4430
"10314","WBGene00012542","IV",14016099,14019983,3884
"10315","WBGene00012543","IV",14107721,14116034,8313
"10316","WBGene00012544","III",12820141,12825651,5510
"10317","WBGene00012545","III",12829368,12837274,7906
"10318","WBGene00012546","III",12837189,12838959,1770
"10319","WBGene00012547","III",12854051,12855315,1264
"10320","WBGene00012548","III",12856833,12857911,1078
"10321","WBGene00012549","III",12864948,12867591,2643
"10322","WBGene00012550","III",12875007,12875831,824
"10323","WBGene00012551","III",12875771,12877577,1806
"10324","WBGene00012552","III",12878515,12880699,2184
"10325","WBGene00012553","III",12905491,12906619,1128
"10326","WBGene00012554","III",12915118,12918675,3557
"10327","WBGene00012555","III",12921282,12925997,4715
"10328","WBGene00012556","III",12926557,12927886,1329
"10329","WBGene00012557","III",12929873,12931435,1562
"10330","WBGene00012558","III",12928370,12931867,3497
"10331","WBGene00012559","III",12934717,12941069,6352
"10332","WBGene00012560","III",12818658,12820252,1594
"10333","WBGene00012561","III",12855844,12856728,884
"10334","WBGene00012562","V",18108269,18114755,6486
"10335","WBGene00012564","V",18123939,18125245,1306
"10336","WBGene00012565","V",18125375,18127205,1830
"10337","WBGene00012566","V",18127519,18128885,1366
"10338","WBGene00012567","V",18133300,18134478,1178
"10339","WBGene00012568","V",18134722,18136022,1300
"10340","WBGene00012569","V",18136704,18137714,1010
"10341","WBGene00012570","V",18138995,18140687,1692
"10342","WBGene00012571","V",18141461,18142577,1116
"10343","WBGene00012572","V",18227037,18231455,4418
"10344","WBGene00012573","V",18272889,18277694,4805
"10345","WBGene00012574","V",18267292,18268844,1552
"10346","WBGene00012575","V",18270703,18272256,1553
"10347","WBGene00012576","I",13773067,13778782,5715
"10348","WBGene00012577","I",13779781,13781402,1621
"10349","WBGene00012578","I",13778899,13792165,13266
"10350","WBGene00012579","II",12570198,12570623,425
"10351","WBGene00012580","II",12571572,12573529,1957
"10352","WBGene00012581","II",12573940,12574768,828
"10353","WBGene00012582","II",12575691,12577748,2057
"10354","WBGene00012583","II",12578356,12581098,2742
"10355","WBGene00012584","II",12582179,12603680,21501
"10356","WBGene00012585","II",12605968,12607027,1059
"10357","WBGene00012586","II",12607200,12608788,1588
"10358","WBGene00012587","II",12608953,12609630,677
"10359","WBGene00012588","II",12610313,12612357,2044
"10360","WBGene00012589","II",12613564,12613939,375
"10361","WBGene00012590","II",12617886,12618209,323
"10362","WBGene00012591","II",12620548,12620888,340
"10363","WBGene00012592","II",12623215,12624506,1291
"10364","WBGene00012593","II",12627187,12627570,383
"10365","WBGene00012594","II",12628936,12629380,444
"10366","WBGene00012595","II",12632593,12634799,2206
"10367","WBGene00012596","II",12636699,12638448,1749
"10368","WBGene00012597","II",12640670,12642740,2070
"10369","WBGene00012598","II",12654747,12663836,9089
"10370","WBGene00012600","II",12673166,12677803,4637
"10371","WBGene00012602","II",12679035,12679413,378
"10372","WBGene00012603","II",12615897,12616166,269
"10373","WBGene00012604","II",12619079,12619408,329
"10374","WBGene00012605","II",12952490,12954832,2342
"10375","WBGene00012606","II",12954962,12958018,3056
"10376","WBGene00012607","II",12966872,12969215,2343
"10377","WBGene00012608","II",12994358,12996571,2213
"10378","WBGene00012609","II",12996921,12997804,883
"10379","WBGene00012610","II",12997986,13000853,2867
"10380","WBGene00012612","V",20325728,20328056,2328
"10381","WBGene00012614","V",20345203,20348127,2924
"10382","WBGene00012615","V",20497922,20499103,1181
"10383","WBGene00012616","V",20499899,20500494,595
"10384","WBGene00012617","V",20504875,20505097,222
"10385","WBGene00012618","V",20506503,20509510,3007
"10386","WBGene00012620","V",20513736,20513892,156
"10387","WBGene00012621","V",20514637,20515706,1069
"10388","WBGene00012622","V",20520250,20522270,2020
"10389","WBGene00012623","V",20516298,20518036,1738
"10390","WBGene00012624","V",20522621,20524512,1891
"10391","WBGene00012625","V",20527793,20529260,1467
"10392","WBGene00012626","V",20529953,20534169,4216
"10393","WBGene00012627","V",20534774,20536308,1534
"10394","WBGene00012628","V",20536430,20538155,1725
"10395","WBGene00012629","V",20540395,20544192,3797
"10396","WBGene00012630","V",20546626,20547148,522
"10397","WBGene00012631","V",20552294,20553071,777
"10398","WBGene00012632","V",20547261,20551164,3903
"10399","WBGene00012633","V",20554060,20555267,1207
"10400","WBGene00012634","V",20555629,20556360,731
"10401","WBGene00012635","IV",13483465,13485515,2050
"10402","WBGene00012636","IV",13474432,13476225,1793
"10403","WBGene00012637","IV",13472497,13474005,1508
"10404","WBGene00012638","IV",13470566,13472369,1803
"10405","WBGene00012639","IV",13466139,13469402,3263
"10406","WBGene00012640","IV",13455500,13456346,846
"10407","WBGene00012641","III",10596615,10600184,3569
"10408","WBGene00012642","III",10601905,10603566,1661
"10409","WBGene00012643","III",10595258,10596487,1229
"10410","WBGene00012644","III",10605349,10613294,7945
"10411","WBGene00012645","III",10615466,10617862,2396
"10412","WBGene00012646","III",10617863,10621369,3506
"10413","WBGene00012647","III",10625934,10629143,3209
"10414","WBGene00012648","III",10630070,10633501,3431
"10415","WBGene00012649","III",10632728,10633084,356
"10416","WBGene00012650","III",10643002,10646107,3105
"10417","WBGene00012651","III",10646170,10648861,2691
"10418","WBGene00012652","III",10649519,10650908,1389
"10419","WBGene00012654","III",10679474,10682212,2738
"10420","WBGene00012655","III",10687127,10691101,3974
"10421","WBGene00012656","III",10692221,10694391,2170
"10422","WBGene00012657","III",10699216,10700560,1344
"10423","WBGene00012658","III",10700652,10707024,6372
"10424","WBGene00012659","III",10703329,10707024,3695
"10425","WBGene00012660","III",10613567,10614931,1364
"10426","WBGene00012661","III",10794349,10796369,2020
"10427","WBGene00012662","III",10856776,10858186,1410
"10428","WBGene00012663","III",10849222,10854561,5339
"10429","WBGene00012664","V",19201013,19203607,2594
"10430","WBGene00012665","V",19190547,19199080,8533
"10431","WBGene00012666","V",19189246,19190035,789
"10432","WBGene00012668","V",19157659,19158877,1218
"10433","WBGene00012669","V",19145778,19149147,3369
"10434","WBGene00012670","V",19140795,19145542,4747
"10435","WBGene00012671","V",19136509,19138986,2477
"10436","WBGene00012672","V",19131531,19133603,2072
"10437","WBGene00012673","V",19127530,19130938,3408
"10438","WBGene00012674","V",19119527,19124915,5388
"10439","WBGene00012675","V",19118505,19119425,920
"10440","WBGene00012676","V",19101961,19118412,16451
"10441","WBGene00012678","V",19099085,19101108,2023
"10442","WBGene00012679","V",19068619,19074173,5554
"10443","WBGene00012680","V",19047047,19048669,1622
"10444","WBGene00012681","V",19043215,19044853,1638
"10445","WBGene00012682","V",19039058,19042605,3547
"10446","WBGene00012683","V",19035753,19037320,1567
"10447","WBGene00012684","V",19026463,19031590,5127
"10448","WBGene00012686","V",19031742,19035255,3513
"10449","WBGene00012688","V",19020487,19024765,4278
"10450","WBGene00012689","V",19014573,19020001,5428
"10451","WBGene00012690","V",19008635,19013833,5198
"10452","WBGene00012692","V",19001956,19006711,4755
"10453","WBGene00012693","V",19001018,19001856,838
"10454","WBGene00012694","V",18993940,18998200,4260
"10455","WBGene00012695","V",18990850,18993799,2949
"10456","WBGene00012696","V",18986498,18990421,3923
"10457","WBGene00012697","V",18981306,18985870,4564
"10458","WBGene00012698","V",18979336,18981193,1857
"10459","WBGene00012699","V",18970500,18977976,7476
"10460","WBGene00012700","V",18968021,18969640,1619
"10461","WBGene00012701","V",18960969,18967842,6873
"10462","WBGene00012702","V",18958240,18960172,1932
"10463","WBGene00012703","V",19087723,19092668,4945
"10464","WBGene00012704","IV",12222872,12227112,4240
"10465","WBGene00012705","IV",12227910,12229779,1869
"10466","WBGene00012706","IV",12232489,12233408,919
"10467","WBGene00012707","IV",12234139,12236111,1972
"10468","WBGene00012708","IV",12237175,12238951,1776
"10469","WBGene00012709","IV",12241363,12244806,3443
"10470","WBGene00012710","IV",12257637,12259192,1555
"10471","WBGene00012711","III",12951429,12952342,913
"10472","WBGene00012712","III",12952969,12966995,14026
"10473","WBGene00012713","III",12967898,12972498,4600
"10474","WBGene00012714","III",13153817,13160284,6467
"10475","WBGene00012715","III",13165659,13169520,3861
"10476","WBGene00012716","III",13169916,13173106,3190
"10477","WBGene00012717","III",13070756,13074697,3941
"10478","WBGene00012718","III",13107607,13119042,11435
"10479","WBGene00012719","III",13143373,13152858,9485
"10480","WBGene00012720","III",13204982,13207393,2411
"10481","WBGene00012721","III",13091112,13093659,2547
"10482","WBGene00012722","II",13970584,13972970,2386
"10483","WBGene00012723","II",13973690,13976221,2531
"10484","WBGene00012724","II",13977164,13979883,2719
"10485","WBGene00012725","II",13983397,13984651,1254
"10486","WBGene00012726","II",13987616,13991838,4222
"10487","WBGene00012727","II",13994411,13995045,634
"10488","WBGene00012728","II",13981330,13981785,455
"10489","WBGene00012729","II",13982048,13983115,1067
"10490","WBGene00012730","II",14068907,14089119,20212
"10491","WBGene00012731","II",14095447,14097390,1943
"10492","WBGene00012732","I",13344044,13346966,2922
"10493","WBGene00012733","I",13347068,13349259,2191
"10494","WBGene00012734","I",13349410,13358674,9264
"10495","WBGene00012735","I",13360401,13366888,6487
"10496","WBGene00012738","I",13435489,13437965,2476
"10497","WBGene00012739","I",13426454,13428471,2017
"10498","WBGene00012740","I",13428913,13434717,5804
"10499","WBGene00012741","V",14583306,14585451,2145
"10500","WBGene00012743","IV",15161157,15164907,3750
"10501","WBGene00012744","IV",15167800,15175536,7736
"10502","WBGene00012745","IV",15198065,15199539,1474
"10503","WBGene00012746","IV",15207497,15207894,397
"10504","WBGene00012747","IV",15210123,15215626,5503
"10505","WBGene00012748","IV",15219686,15220346,660
"10506","WBGene00012749","III",11647769,11649893,2124
"10507","WBGene00012750","III",11650471,11656185,5714
"10508","WBGene00012753","III",11696599,11698306,1707
"10509","WBGene00012754","III",11698869,11700087,1218
"10510","WBGene00012755","III",11706969,11708820,1851
"10511","WBGene00012756","III",11710827,11718741,7914
"10512","WBGene00012757","III",11719834,11721077,1243
"10513","WBGene00012758","III",11724038,11726690,2652
"10514","WBGene00012759","III",11733346,11737627,4281
"10515","WBGene00012760","III",11641461,11641861,400
"10516","WBGene00012761","III",11730612,11731305,693
"10517","WBGene00012762","IV",14954206,14958914,4708
"10518","WBGene00012763","IV",14981609,14996306,14697
"10519","WBGene00012764","IV",15006247,15007193,946
"10520","WBGene00012765","IV",15014042,15025513,11471
"10521","WBGene00012766","IV",15028358,15029136,778
"10522","WBGene00012767","IV",15025710,15037036,11326
"10523","WBGene00012768","IV",15037321,15039551,2230
"10524","WBGene00012769","IV",15039619,15049273,9654
"10525","WBGene00012770","IV",15049411,15053371,3960
"10526","WBGene00012771","IV",15058294,15058694,400
"10527","WBGene00012772","IV",15092881,15098376,5495
"10528","WBGene00012773","IV",15065866,15068918,3052
"10529","WBGene00012775","IV",15074692,15088581,13889
"10530","WBGene00012776","V",11088154,11097970,9816
"10531","WBGene00012777","V",11091016,11093619,2603
"10532","WBGene00012778","V",11095446,11095973,527
"10533","WBGene00012779","V",11098950,11107288,8338
"10534","WBGene00012780","V",11107535,11109747,2212
"10535","WBGene00012781","IV",10268882,10269228,346
"10536","WBGene00012782","IV",10269883,10272691,2808
"10537","WBGene00012783","IV",10274036,10275411,1375
"10538","WBGene00012784","IV",10277989,10279501,1512
"10539","WBGene00012785","IV",10351445,10352343,898
"10540","WBGene00012786","IV",10353167,10355120,1953
"10541","WBGene00012787","IV",16743830,16744197,367
"10542","WBGene00012788","IV",16744866,16755720,10854
"10543","WBGene00012789","IV",16766598,16768320,1722
"10544","WBGene00012791","IV",16775827,16785172,9345
"10545","WBGene00012792","IV",16787327,16788510,1183
"10546","WBGene00012793","IV",16765693,16766643,950
"10547","WBGene00012794","IV",10982068,10985030,2962
"10548","WBGene00012795","IV",10987906,10989182,1276
"10549","WBGene00012796","III",13223072,13229465,6393
"10550","WBGene00012798","III",13240008,13240890,882
"10551","WBGene00012799","III",13245583,13245958,375
"10552","WBGene00012802","III",13283892,13293088,9196
"10553","WBGene00012803","III",13299378,13302760,3382
"10554","WBGene00012804","III",13307502,13313389,5887
"10555","WBGene00012806","III",13315088,13318597,3509
"10556","WBGene00012807","III",13314011,13314721,710
"10557","WBGene00012808","V",19370602,19371331,729
"10558","WBGene00012809","V",19371553,19376247,4694
"10559","WBGene00012810","V",19377444,19381031,3587
"10560","WBGene00012811","V",19384887,19390120,5233
"10561","WBGene00012812","V",19534880,19546200,11320
"10562","WBGene00012813","V",19519925,19533110,13185
"10563","WBGene00012814","V",19503108,19519950,16842
"10564","WBGene00012815","V",19512185,19513656,1471
"10565","WBGene00012816","V",19494762,19495687,925
"10566","WBGene00012817","V",19493885,19494657,772
"10567","WBGene00012818","V",19490761,19491231,470
"10568","WBGene00012819","V",19479203,19480459,1256
"10569","WBGene00012820","V",19474464,19476942,2478
"10570","WBGene00012821","V",19470694,19472501,1807
"10571","WBGene00012822","V",19468383,19469554,1171
"10572","WBGene00012823","V",19456017,19457300,1283
"10573","WBGene00012824","V",19452183,19455031,2848
"10574","WBGene00012825","V",19614558,19622551,7993
"10575","WBGene00012826","V",19625062,19630753,5691
"10576","WBGene00012827","V",19631371,19632662,1291
"10577","WBGene00012828","V",19633062,19640908,7846
"10578","WBGene00012829","V",19641292,19644083,2791
"10579","WBGene00012830","V",19644239,19645758,1519
"10580","WBGene00012831","V",19646088,19647338,1250
"10581","WBGene00012832","V",19650438,19655251,4813
"10582","WBGene00012833","V",19670259,19671411,1152
"10583","WBGene00012834","V",19693896,19697398,3502
"10584","WBGene00012835","V",19697560,19705212,7652
"10585","WBGene00012836","V",19709775,19710614,839
"10586","WBGene00012837","V",19714213,19715519,1306
"10587","WBGene00012838","V",19716147,19717103,956
"10588","WBGene00012839","V",19705873,19706289,416
"10589","WBGene00012840","V",19609494,19612099,2605
"10590","WBGene00012845","II",12114971,12130968,15997
"10591","WBGene00012846","V",20639594,20641049,1455
"10592","WBGene00012847","V",20642289,20644356,2067
"10593","WBGene00012848","V",20636864,20638444,1580
"10594","WBGene00012849","V",20635943,20636576,633
"10595","WBGene00012850","V",20713920,20716872,2952
"10596","WBGene00012851","V",20722234,20723732,1498
"10597","WBGene00012852","V",20787416,20787623,207
"10598","WBGene00012853","V",20789471,20790784,1313
"10599","WBGene00012854","V",20790768,20792413,1645
"10600","WBGene00012855","V",20801184,20803006,1822
"10601","WBGene00012856","V",20807338,20812303,4965
"10602","WBGene00012857","V",20915486,20922738,7252
"10603","WBGene00012858","III",4244858,4247671,2813
"10604","WBGene00012859","III",10558189,10561948,3759
"10605","WBGene00012860","III",10566181,10571606,5425
"10606","WBGene00012861","III",10572475,10575420,2945
"10607","WBGene00012862","III",10585848,10586343,495
"10608","WBGene00012863","III",10589865,10592801,2936
"10609","WBGene00012864","III",10592754,10595166,2412
"10610","WBGene00012866","IV",13509224,13513426,4202
"10611","WBGene00012867","IV",13506079,13509225,3146
"10612","WBGene00012868","IV",13476935,13502852,25917
"10613","WBGene00012869","IV",13492571,13497141,4570
"10614","WBGene00012870","IV",13594517,13596279,1762
"10615","WBGene00012871","IV",13593539,13593878,339
"10616","WBGene00012872","IV",13577333,13578274,941
"10617","WBGene00012873","IV",13596972,13597913,941
"10618","WBGene00012874","IV",13587475,13588237,762
"10619","WBGene00012875","IV",13549605,13561729,12124
"10620","WBGene00012876","IV",13603549,13604197,648
"10621","WBGene00012877","IV",13656413,13659547,3134
"10622","WBGene00012878","IV",13662116,13662671,555
"10623","WBGene00012879","IV",13665345,13666909,1564
"10624","WBGene00012880","IV",13663398,13664190,792
"10625","WBGene00012883","IV",13773548,13774678,1130
"10626","WBGene00012885","IV",13783962,13784680,718
"10627","WBGene00012886","IV",13796255,13797904,1649
"10628","WBGene00012887","IV",13788936,13796224,7288
"10629","WBGene00012888","IV",13786945,13788727,1782
"10630","WBGene00012889","IV",13785743,13786961,1218
"10631","WBGene00012890","IV",13782385,13785646,3261
"10632","WBGene00012891","IV",13750334,13770495,20161
"10633","WBGene00012892","IV",13804206,13807777,3571
"10634","WBGene00012893","IV",13817487,13820962,3475
"10635","WBGene00012894","II",12694412,12725483,31071
"10636","WBGene00012895","II",12679954,12686713,6759
"10637","WBGene00012896","II",12726963,12736910,9947
"10638","WBGene00012897","II",12737032,12738334,1302
"10639","WBGene00012898","II",12744707,12746834,2127
"10640","WBGene00012899","II",12755170,12756218,1048
"10641","WBGene00012900","II",12756353,12757677,1324
"10642","WBGene00012901","II",12760797,12767232,6435
"10643","WBGene00012903","II",12767221,12768217,996
"10644","WBGene00012904","II",12768686,12773903,5217
"10645","WBGene00012905","II",12774646,12775544,898
"10646","WBGene00012906","II",12782751,12785412,2661
"10647","WBGene00012907","II",12788252,12796452,8200
"10648","WBGene00012908","II",12800449,12805383,4934
"10649","WBGene00012909","II",12804862,12810872,6010
"10650","WBGene00012910","II",12811009,12811934,925
"10651","WBGene00012911","II",12811802,12816462,4660
"10652","WBGene00012912","II",12816820,12818588,1768
"10653","WBGene00012913","II",12828553,12828963,410
"10654","WBGene00012914","II",12830707,12832720,2013
"10655","WBGene00012915","II",12836548,12840157,3609
"10656","WBGene00012916","II",12850429,12851902,1473
"10657","WBGene00012917","II",12856200,12862058,5858
"10658","WBGene00012919","II",12774646,12781705,7059
"10659","WBGene00012920","II",12786322,12788153,1831
"10660","WBGene00012921","II",12823649,12824177,528
"10661","WBGene00012922","III",11139241,11141825,2584
"10662","WBGene00012923","III",11136802,11138905,2103
"10663","WBGene00012924","III",11168923,11170865,1942
"10664","WBGene00012925","III",11218797,11222666,3869
"10665","WBGene00012926","III",11223439,11224106,667
"10666","WBGene00012927","III",11235581,11236868,1287
"10667","WBGene00012928","III",11237149,11238252,1103
"10668","WBGene00012929","III",11245120,11252281,7161
"10669","WBGene00012930","III",11257307,11270875,13568
"10670","WBGene00012931","III",11274901,11276032,1131
"10671","WBGene00012932","III",11276292,11278917,2625
"10672","WBGene00012933","III",11286335,11290748,4413
"10673","WBGene00012934","III",11279021,11290580,11559
"10674","WBGene00012935","III",11317570,11326664,9094
"10675","WBGene00012936","III",11142448,11154287,11839
"10676","WBGene00012937","III",11156511,11157244,733
"10677","WBGene00012938","III",11252391,11256646,4255
"10678","WBGene00012939","III",11382222,11388669,6447
"10679","WBGene00012940","III",11397813,11401886,4073
"10680","WBGene00012941","III",11405361,11409425,4064
"10681","WBGene00012942","III",11427135,11428414,1279
"10682","WBGene00012943","III",11463665,11470805,7140
"10683","WBGene00012946","I",11744172,11747451,3279
"10684","WBGene00012947","I",11830985,11833166,2181
"10685","WBGene00012948","I",11836460,11849251,12791
"10686","WBGene00012950","I",11891549,11893727,2178
"10687","WBGene00012951","I",11893881,11896284,2403
"10688","WBGene00012952","I",11898789,11901476,2687
"10689","WBGene00012953","I",11901608,11903305,1697
"10690","WBGene00012954","I",11903734,11905148,1414
"10691","WBGene00012955","I",11896674,11896982,308
"10692","WBGene00012956","I",11897407,11898521,1114
"10693","WBGene00012958","I",12084721,12087830,3109
"10694","WBGene00012959","I",12088120,12089969,1849
"10695","WBGene00012960","I",12091571,12094740,3169
"10696","WBGene00012961","I",12095777,12097987,2210
"10697","WBGene00012962","III",10992129,10995237,3108
"10698","WBGene00012964","III",11008222,11008934,712
"10699","WBGene00012965","III",11007415,11007620,205
"10700","WBGene00012966","III",11009043,11010595,1552
"10701","WBGene00012967","III",11012566,11025292,12726
"10702","WBGene00012968","III",11025234,11026566,1332
"10703","WBGene00012969","III",11027250,11029437,2187
"10704","WBGene00012970","III",11033172,11036080,2908
"10705","WBGene00012972","III",11063479,11068753,5274
"10706","WBGene00012973","III",11036943,11063027,26084
"10707","WBGene00012974","III",11101268,11107206,5938
"10708","WBGene00012975","III",11108097,11116222,8125
"10709","WBGene00012976","III",11116994,11119222,2228
"10710","WBGene00012977","III",11119803,11126890,7087
"10711","WBGene00012978","II",14151040,14154373,3333
"10712","WBGene00012979","II",14172833,14175174,2341
"10713","WBGene00012980","II",14178814,14189917,11103
"10714","WBGene00012981","II",14214409,14217139,2730
"10715","WBGene00012982","II",14234972,14243603,8631
"10716","WBGene00012983","II",14226377,14234120,7743
"10717","WBGene00012984","II",14220938,14226287,5349
"10718","WBGene00012985","II",13260495,13261201,706
"10719","WBGene00012987","II",13309290,13311488,2198
"10720","WBGene00012988","II",13279780,13285829,6049
"10721","WBGene00012989","II",13272634,13304229,31595
"10722","WBGene00012990","II",13321954,13330825,8871
"10723","WBGene00012992","II",13338281,13339961,1680
"10724","WBGene00012993","II",13340644,13347884,7240
"10725","WBGene00012994","II",13376412,13388879,12467
"10726","WBGene00012995","II",13389761,13401992,12231
"10727","WBGene00012996","II",13402980,13404629,1649
"10728","WBGene00012997","II",13412635,13414906,2271
"10729","WBGene00012998","II",13369607,13375290,5683
"10730","WBGene00012999","II",13670633,13694787,24154
"10731","WBGene00013000","II",13542007,13547645,5638
"10732","WBGene00013001","II",13533486,13541056,7570
"10733","WBGene00013002","II",13547739,13567999,20260
"10734","WBGene00013004","II",13568077,13575068,6991
"10735","WBGene00013006","II",13575925,13584732,8807
"10736","WBGene00013007","II",13585705,13589033,3328
"10737","WBGene00013008","II",13590640,13593797,3157
"10738","WBGene00013009","II",13595006,13596551,1545
"10739","WBGene00013011","II",13522919,13531218,8299
"10740","WBGene00013013","II",13589036,13590552,1516
"10741","WBGene00013014","II",13415024,13424446,9422
"10742","WBGene00013015","II",13424506,13428970,4464
"10743","WBGene00013017","II",13433880,13436825,2945
"10744","WBGene00013018","I",13489552,13491226,1674
"10745","WBGene00013019","I",13477214,13487404,10190
"10746","WBGene00013020","I",13471683,13474185,2502
"10747","WBGene00013021","I",13455356,13470439,15083
"10748","WBGene00013023","I",13451463,13452841,1378
"10749","WBGene00013024","V",14347731,14350776,3045
"10750","WBGene00013025","V",14351207,14354421,3214
"10751","WBGene00013026","V",14354410,14355754,1344
"10752","WBGene00013027","V",14356900,14358390,1490
"10753","WBGene00013028","X",10358476,10360550,2074
"10754","WBGene00013029","III",12372583,12373857,1274
"10755","WBGene00013030","III",12378724,12380647,1923
"10756","WBGene00013031","III",12377731,12378829,1098
"10757","WBGene00013032","III",12391090,12395354,4264
"10758","WBGene00013033","III",12395465,12398983,3518
"10759","WBGene00013034","III",12398901,12421570,22669
"10760","WBGene00013035","III",12430430,12433892,3462
"10761","WBGene00013036","III",12436552,12441056,4504
"10762","WBGene00013037","III",12442630,12446145,3515
"10763","WBGene00013038","III",12446353,12453202,6849
"10764","WBGene00013039","III",12453588,12456850,3262
"10765","WBGene00013040","III",12457599,12465821,8222
"10766","WBGene00013041","III",12466610,12468277,1667
"10767","WBGene00013042","III",12472868,12484651,11783
"10768","WBGene00013043","III",12484732,12488339,3607
"10769","WBGene00013044","III",12488679,12492084,3405
"10770","WBGene00013045","III",12434411,12435223,812
"10771","WBGene00013046","V",14726907,14727328,421
"10772","WBGene00013047","V",14728441,14728854,413
"10773","WBGene00013048","V",14734660,14736169,1509
"10774","WBGene00013049","V",14738542,14741326,2784
"10775","WBGene00013050","V",14745684,14748708,3024
"10776","WBGene00013051","V",14757618,14758295,677
"10777","WBGene00013052","V",14778336,14779714,1378
"10778","WBGene00013053","V",14779996,14781078,1082
"10779","WBGene00013054","V",14781493,14782209,716
"10780","WBGene00013055","V",14782658,14784065,1407
"10781","WBGene00013056","V",14758785,14765831,7046
"10782","WBGene00013058","V",18282897,18290590,7693
"10783","WBGene00013059","V",18289558,18289838,280
"10784","WBGene00013060","V",18290942,18291348,406
"10785","WBGene00013061","V",18298806,18300713,1907
"10786","WBGene00013062","V",18302714,18303506,792
"10787","WBGene00013066","V",18374494,18376755,2261
"10788","WBGene00013067","V",18380620,18382690,2070
"10789","WBGene00013068","V",18386252,18389146,2894
"10790","WBGene00013069","V",18389280,18391337,2057
"10791","WBGene00013070","V",18392007,18394303,2296
"10792","WBGene00013071","V",18379119,18379289,170
"10793","WBGene00013072","V",18508873,18512632,3759
"10794","WBGene00013073","V",18516789,18523875,7086
"10795","WBGene00013074","V",18524760,18529156,4396
"10796","WBGene00013075","V",18533924,18549129,15205
"10797","WBGene00013076","V",18550022,18553867,3845
"10798","WBGene00013077","V",18555387,18556643,1256
"10799","WBGene00013078","V",18556714,18558099,1385
"10800","WBGene00013079","V",18558748,18560308,1560
"10801","WBGene00013080","V",18573056,18579784,6728
"10802","WBGene00013081","V",18582658,18582963,305
"10803","WBGene00013082","V",18592754,18614101,21347
"10804","WBGene00013083","V",18481131,18487258,6127
"10805","WBGene00013085","II",9405539,9407114,1575
"10806","WBGene00013086","II",9407769,9409017,1248
"10807","WBGene00013087","II",9404146,9404779,633
"10808","WBGene00013088","II",9400717,9403187,2470
"10809","WBGene00013089","II",9400053,9400567,514
"10810","WBGene00013090","II",9398866,9399828,962
"10811","WBGene00013091","II",9395493,9397596,2103
"10812","WBGene00013093","II",13855788,13872315,16527
"10813","WBGene00013094","II",13872869,13875423,2554
"10814","WBGene00013095","II",13876034,13882585,6551
"10815","WBGene00013096","II",13888583,13898394,9811
"10816","WBGene00013098","IV",16474044,16477192,3148
"10817","WBGene00013100","IV",16503249,16505682,2433
"10818","WBGene00013101","IV",16522529,16526132,3603
"10819","WBGene00013103","IV",16535730,16542894,7164
"10820","WBGene00013104","IV",16575102,16578549,3447
"10821","WBGene00013105","IV",16626228,16626458,230
"10822","WBGene00013106","IV",16646791,16655883,9092
"10823","WBGene00013107","IV",16641702,16646373,4671
"10824","WBGene00013109","IV",16656613,16657359,746
"10825","WBGene00013111","IV",16664320,16671467,7147
"10826","WBGene00013112","IV",16672657,16673040,383
"10827","WBGene00013116","IV",16720715,16722736,2021
"10828","WBGene00013117","IV",16722916,16723892,976
"10829","WBGene00013118","IV",16737177,16739778,2601
"10830","WBGene00013119","IV",16736329,16743178,6849
"10831","WBGene00013120","IV",16627976,16628441,465
"10832","WBGene00013121","I",10964473,10966348,1875
"10833","WBGene00013122","I",10966394,10970166,3772
"10834","WBGene00013123","I",10970493,10980111,9618
"10835","WBGene00013124","I",10979607,11004283,24676
"10836","WBGene00013125","I",11015486,11017497,2011
"10837","WBGene00013126","I",11018571,11025653,7082
"10838","WBGene00013127","I",11032339,11034055,1716
"10839","WBGene00013128","I",11034057,11038857,4800
"10840","WBGene00013129","I",11039056,11052494,13438
"10841","WBGene00013130","I",11123740,11124094,354
"10842","WBGene00013131","I",11163811,11168736,4925
"10843","WBGene00013132","III",10947446,10951169,3723
"10844","WBGene00013134","I",11968022,11969847,1825
"10845","WBGene00013135","I",11979401,11985612,6211
"10846","WBGene00013136","I",11998781,12002643,3862
"10847","WBGene00013137","I",12002552,12004997,2445
"10848","WBGene00013138","I",12020756,12028313,7557
"10849","WBGene00013139","II",9704882,9706240,1358
"10850","WBGene00013140","II",9701402,9703732,2330
"10851","WBGene00013141","II",9717478,9717775,297
"10852","WBGene00013142","II",9700543,9701839,1296
"10853","WBGene00013143","II",9742982,9746074,3092
"10854","WBGene00013144","II",9738982,9742884,3902
"10855","WBGene00013145","II",9721828,9724526,2698
"10856","WBGene00013146","II",9750442,9752317,1875
"10857","WBGene00013147","II",9826513,9827926,1413
"10858","WBGene00013148","II",14876147,14877164,1017
"10859","WBGene00013149","II",14954278,14958189,3911
"10860","WBGene00013150","II",14968633,14969354,721
"10861","WBGene00013151","II",14969617,14977005,7388
"10862","WBGene00013152","II",14982592,14984009,1417
"10863","WBGene00013153","II",14985806,14987225,1419
"10864","WBGene00013154","II",14992898,14993403,505
"10865","WBGene00013155","II",14994197,14997444,3247
"10866","WBGene00013156","II",15004869,15010416,5547
"10867","WBGene00013157","II",15001896,15003510,1614
"10868","WBGene00013158","II",15010748,15013408,2660
"10869","WBGene00013159","II",15019223,15025768,6545
"10870","WBGene00013160","II",15026137,15037807,11670
"10871","WBGene00013161","II",15037991,15039297,1306
"10872","WBGene00013162","II",15052085,15055718,3633
"10873","WBGene00013163","II",15058227,15062057,3830
"10874","WBGene00013164","II",15064267,15071671,7404
"10875","WBGene00013165","II",15077218,15079475,2257
"10876","WBGene00013166","II",15084476,15089626,5150
"10877","WBGene00013167","II",15090172,15109042,18870
"10878","WBGene00013168","II",15120301,15123345,3044
"10879","WBGene00013169","II",15124504,15126365,1861
"10880","WBGene00013170","II",15131566,15134424,2858
"10881","WBGene00013171","II",15136186,15145370,9184
"10882","WBGene00013172","II",15140476,15140981,505
"10883","WBGene00013173","II",15145894,15151934,6040
"10884","WBGene00013175","II",15175943,15177271,1328
"10885","WBGene00013176","II",15110144,15116306,6162
"10886","WBGene00013177","I",11216118,11221995,5877
"10887","WBGene00013178","I",11222326,11224400,2074
"10888","WBGene00013179","I",11234302,11235176,874
"10889","WBGene00013180","I",11294593,11297206,2613
"10890","WBGene00013181","I",11292662,11294197,1535
"10891","WBGene00013182","I",11300743,11301662,919
"10892","WBGene00013184","I",11302286,11305218,2932
"10893","WBGene00013186","I",11417844,11421236,3392
"10894","WBGene00013187","II",14734410,14739243,4833
"10895","WBGene00013188","II",14746890,14752489,5599
"10896","WBGene00013189","II",14754622,14778149,23527
"10897","WBGene00013190","II",14755979,14757811,1832
"10898","WBGene00013192","II",14771872,14773006,1134
"10899","WBGene00013193","II",14778345,14782723,4378
"10900","WBGene00013194","II",14785184,14785995,811
"10901","WBGene00013195","II",14791101,14792554,1453
"10902","WBGene00013196","II",14798472,14800971,2499
"10903","WBGene00013197","I",14688639,14691736,3097
"10904","WBGene00013198","I",14694154,14700392,6238
"10905","WBGene00013200","I",14707059,14707875,816
"10906","WBGene00013201","I",14708195,14710961,2766
"10907","WBGene00013202","I",14711081,14715030,3949
"10908","WBGene00013203","I",14716528,14719027,2499
"10909","WBGene00013204","I",14815706,14820222,4516
"10910","WBGene00013207","II",13712921,13715893,2972
"10911","WBGene00013208","II",13722964,13725037,2073
"10912","WBGene00013209","II",13726062,13729610,3548
"10913","WBGene00013210","II",13724978,13725805,827
"10914","WBGene00013211","II",13729716,13731543,1827
"10915","WBGene00013212","II",14257573,14269192,11619
"10916","WBGene00013213","II",14252357,14255705,3348
"10917","WBGene00013214","II",14276621,14283973,7352
"10918","WBGene00013215","II",14292824,14296055,3231
"10919","WBGene00013216","II",14297305,14299633,2328
"10920","WBGene00013217","II",14340068,14344454,4386
"10921","WBGene00013218","II",14344545,14346438,1893
"10922","WBGene00013219","II",14349783,14350795,1012
"10923","WBGene00013220","II",14307854,14310779,2925
"10924","WBGene00013221","II",14318158,14320917,2759
"10925","WBGene00013222","II",14455632,14464911,9279
"10926","WBGene00013223","IV",12605700,12614723,9023
"10927","WBGene00013224","IV",12601126,12605425,4299
"10928","WBGene00013225","III",11849951,11862249,12298
"10929","WBGene00013226","III",11886485,11891435,4950
"10930","WBGene00013227","III",11871252,11878889,7637
"10931","WBGene00013228","III",11934002,11947017,13015
"10932","WBGene00013230","III",11882594,11883562,968
"10933","WBGene00013231","III",11894784,11898269,3485
"10934","WBGene00013232","III",11899337,11907387,8050
"10935","WBGene00013233","III",11907477,11908474,997
"10936","WBGene00013234","III",11908968,11909889,921
"10937","WBGene00013235","III",11911001,11914317,3316
"10938","WBGene00013236","III",11917836,11918719,883
"10939","WBGene00013237","III",11915151,11915712,561
"10940","WBGene00013238","III",11920716,11921590,874
"10941","WBGene00013239","III",11921692,11923825,2133
"10942","WBGene00013240","III",11961470,11971367,9897
"10943","WBGene00013241","III",11971461,11974092,2631
"10944","WBGene00013242","III",11974077,11979065,4988
"10945","WBGene00013243","III",11974477,11989885,15408
"10946","WBGene00013244","III",11999497,12002950,3453
"10947","WBGene00013246","II",12133535,12147134,13599
"10948","WBGene00013247","II",12147633,12150216,2583
"10949","WBGene00013248","II",12150892,12151877,985
"10950","WBGene00013249","II",12151968,12154336,2368
"10951","WBGene00013250","II",12154486,12156812,2326
"10952","WBGene00013251","II",12156940,12159252,2312
"10953","WBGene00013252","II",12159472,12162671,3199
"10954","WBGene00013253","II",12164839,12170762,5923
"10955","WBGene00013254","II",12248125,12249135,1010
"10956","WBGene00013255","II",12256950,12269706,12756
"10957","WBGene00013256","II",12176880,12184875,7995
"10958","WBGene00013257","II",12186007,12189265,3258
"10959","WBGene00013258","II",12189795,12199959,10164
"10960","WBGene00013259","II",12200607,12202381,1774
"10961","WBGene00013260","II",12225356,12227265,1909
"10962","WBGene00013261","II",12228305,12237051,8746
"10963","WBGene00013263","II",12240388,12242567,2179
"10964","WBGene00013264","II",12242946,12247611,4665
"10965","WBGene00013265","II",12251667,12256628,4961
"10966","WBGene00013266","II",12264166,12266105,1939
"10967","WBGene00013267","II",12269815,12275044,5229
"10968","WBGene00013268","II",12275936,12279383,3447
"10969","WBGene00013269","II",12279561,12280595,1034
"10970","WBGene00013270","II",12289385,12300573,11188
"10971","WBGene00013272","II",12203309,12209160,5851
"10972","WBGene00013273","II",12358756,12367023,8267
"10973","WBGene00013274","II",12373522,12379511,5989
"10974","WBGene00013275","II",12383463,12384692,1229
"10975","WBGene00013276","II",12384593,12386881,2288
"10976","WBGene00013277","II",12388293,12389839,1546
"10977","WBGene00013278","II",12390083,12392662,2579
"10978","WBGene00013279","II",12392701,12393743,1042
"10979","WBGene00013280","II",12411622,12412517,895
"10980","WBGene00013281","II",12415527,12417527,2000
"10981","WBGene00013282","II",12419133,12420586,1453
"10982","WBGene00013283","II",12421204,12422623,1419
"10983","WBGene00013284","II",12423514,12425694,2180
"10984","WBGene00013285","II",12430788,12432311,1523
"10985","WBGene00013286","II",12427986,12429946,1960
"10986","WBGene00013287","II",12433608,12435846,2238
"10987","WBGene00013288","II",12440132,12441264,1132
"10988","WBGene00013289","IV",14487086,14505166,18080
"10989","WBGene00013290","IV",14517022,14519539,2517
"10990","WBGene00013292","IV",14482334,14486439,4105
"10991","WBGene00013293","IV",14511884,14512505,621
"10992","WBGene00013294","IV",14549827,14551957,2130
"10993","WBGene00013295","IV",14565330,14567331,2001
"10994","WBGene00013296","IV",14573499,14574339,840
"10995","WBGene00013297","IV",14574819,14576580,1761
"10996","WBGene00013298","IV",14553598,14554883,1285
"10997","WBGene00013299","IV",14579242,14581052,1810
"10998","WBGene00013300","IV",14709586,14714738,5152
"10999","WBGene00013301","IV",14768155,14769282,1127
"11000","WBGene00013302","IV",14765629,14766665,1036
"11001","WBGene00013303","IV",14761818,14765434,3616
"11002","WBGene00013304","IV",14758362,14760945,2583
"11003","WBGene00013306","IV",14781837,14782731,894
"11004","WBGene00013307","IV",14787168,14790843,3675
"11005","WBGene00013308","IV",14796421,14797544,1123
"11006","WBGene00013310","IV",14799311,14801063,1752
"11007","WBGene00013311","IV",14822540,14825264,2724
"11008","WBGene00013312","IV",14826449,14829115,2666
"11009","WBGene00013313","IV",14840310,14843289,2979
"11010","WBGene00013315","IV",14843362,14845311,1949
"11011","WBGene00013316","IV",14846385,14847095,710
"11012","WBGene00013317","IV",14837112,14853662,16550
"11013","WBGene00013318","IV",14855331,14861791,6460
"11014","WBGene00013319","IV",14919610,14920421,811
"11015","WBGene00013320","IV",14921093,14922787,1694
"11016","WBGene00013321","IV",14683043,14687405,4362
"11017","WBGene00013322","IV",14643025,14653376,10351
"11018","WBGene00013323","IV",14657081,14658165,1084
"11019","WBGene00013324","IV",14766773,14767730,957
"11020","WBGene00013325","IV",14771419,14773535,2116
"11021","WBGene00013326","IV",14658319,14675141,16822
"11022","WBGene00013327","IV",14862447,14869951,7504
"11023","WBGene00013328","IV",14637751,14641229,3478
"11024","WBGene00013329","IV",14703209,14704255,1046
"11025","WBGene00013330","IV",14705536,14706402,866
"11026","WBGene00013331","IV",14728534,14745676,17142
"11027","WBGene00013332","IV",14769441,14770719,1278
"11028","WBGene00013333","IV",14770654,14771425,771
"11029","WBGene00013334","IV",14783341,14784252,911
"11030","WBGene00013335","IV",14813141,14816388,3247
"11031","WBGene00013336","IV",14904994,14909686,4692
"11032","WBGene00013337","IV",14942286,14944334,2048
"11033","WBGene00013338","IV",14715800,14720440,4640
"11034","WBGene00013339","V",17871401,17879913,8512
"11035","WBGene00013340","V",17845739,17855989,10250
"11036","WBGene00013341","V",17837360,17838119,759
"11037","WBGene00013343","V",18022479,18042353,19874
"11038","WBGene00013344","V",18043571,18052323,8752
"11039","WBGene00013345","V",18062035,18066307,4272
"11040","WBGene00013347","V",18070021,18081957,11936
"11041","WBGene00013348","V",18082406,18085127,2721
"11042","WBGene00013349","V",18085630,18086225,595
"11043","WBGene00013350","V",18087123,18097996,10873
"11044","WBGene00013351","V",18007230,18007816,586
"11045","WBGene00013352","V",17995347,18001368,6021
"11046","WBGene00013353","V",17986260,17994546,8286
"11047","WBGene00013354","V",17968510,17980082,11572
"11048","WBGene00013355","V",17954054,17966847,12793
"11049","WBGene00013356","V",17951949,17952149,200
"11050","WBGene00013357","V",19982994,19986313,3319
"11051","WBGene00013358","V",19955453,19958912,3459
"11052","WBGene00013359","V",19949982,19955122,5140
"11053","WBGene00013360","V",19946691,19949093,2402
"11054","WBGene00013361","V",19897977,19907434,9457
"11055","WBGene00013362","V",19927782,19934323,6541
"11056","WBGene00013363","V",19925408,19926120,712
"11057","WBGene00013364","V",19921697,19922600,903
"11058","WBGene00013365","V",19916557,19919996,3439
"11059","WBGene00013366","V",20011959,20015077,3118
"11060","WBGene00013367","V",20007770,20009195,1425
"11061","WBGene00013368","X",14392867,14395367,2500
"11062","WBGene00013369","X",14381289,14381891,602
"11063","WBGene00013370","X",14383251,14383901,650
"11064","WBGene00013371","X",14376955,14377330,375
"11065","WBGene00013372","V",17305782,17307735,1953
"11066","WBGene00013373","IV",13370709,13371073,364
"11067","WBGene00013374","IV",13359471,13360285,814
"11068","WBGene00013375","IV",13365169,13368435,3266
"11069","WBGene00013376","IV",13371999,13377383,5384
"11070","WBGene00013378","IV",13380387,13381923,1536
"11071","WBGene00013379","IV",13389146,13398799,9653
"11072","WBGene00013380","IV",13399068,13400506,1438
"11073","WBGene00013381","IV",13401306,13403831,2525
"11074","WBGene00013382","IV",13408606,13412895,4289
"11075","WBGene00013383","IV",13413560,13415954,2394
"11076","WBGene00013385","IV",13403769,13408306,4537
"11077","WBGene00013387","II",11535165,11538841,3676
"11078","WBGene00013388","II",11521599,11523196,1597
"11079","WBGene00013389","X",11875654,11877242,1588
"11080","WBGene00013390","X",11877418,11878196,778
"11081","WBGene00013391","X",11879110,11879971,861
"11082","WBGene00013392","X",11880124,11881264,1140
"11083","WBGene00013393","X",11882144,11882917,773
"11084","WBGene00013394","X",11883127,11884043,916
"11085","WBGene00013395","X",11884330,11886438,2108
"11086","WBGene00013396","X",11891259,11892422,1163
"11087","WBGene00013397","X",11895585,11898140,2555
"11088","WBGene00013398","X",11901147,11902749,1602
"11089","WBGene00013399","X",11904924,11907022,2098
"11090","WBGene00013400","X",11914124,11915558,1434
"11091","WBGene00013401","X",11917005,11920158,3153
"11092","WBGene00013402","X",11921252,11923138,1886
"11093","WBGene00013403","I",14090738,14096346,5608
"11094","WBGene00013404","I",14088094,14089858,1764
"11095","WBGene00013405","I",14097492,14101090,3598
"11096","WBGene00013406","I",14113636,14114085,449
"11097","WBGene00013407","I",14114194,14118650,4456
"11098","WBGene00013408","I",14083048,14084214,1166
"11099","WBGene00013409","I",14084523,14087351,2828
"11100","WBGene00013410","I",14085688,14086685,997
"11101","WBGene00013411","IV",14234341,14239076,4735
"11102","WBGene00013412","IV",14242798,14244416,1618
"11103","WBGene00013415","IV",14276466,14285523,9057
"11104","WBGene00013416","IV",14291901,14319564,27663
"11105","WBGene00013417","IV",14245439,14250213,4774
"11106","WBGene00013418","IV",16398839,16399875,1036
"11107","WBGene00013419","IV",16412020,16416808,4788
"11108","WBGene00013421","III",11482603,11484244,1641
"11109","WBGene00013422","III",11485474,11487345,1871
"11110","WBGene00013424","III",11612607,11615707,3100
"11111","WBGene00013425","III",11616758,11623991,7233
"11112","WBGene00013426","III",11628386,11631014,2628
"11113","WBGene00013427","III",11608170,11609082,912
"11114","WBGene00013429","III",11589211,11592837,3626
"11115","WBGene00013431","III",11581600,11589133,7533
"11116","WBGene00013432","III",11580694,11581402,708
"11117","WBGene00013433","III",11579265,11580478,1213
"11118","WBGene00013434","III",11574221,11578752,4531
"11119","WBGene00013435","III",11568137,11573343,5206
"11120","WBGene00013436","III",11565833,11568007,2174
"11121","WBGene00013437","III",11563467,11565536,2069
"11122","WBGene00013438","III",11561152,11562655,1503
"11123","WBGene00013439","III",11548377,11552398,4021
"11124","WBGene00013440","III",11534674,11546669,11995
"11125","WBGene00013441","III",11526372,11534595,8223
"11126","WBGene00013442","III",11524322,11526564,2242
"11127","WBGene00013443","III",11512860,11523759,10899
"11128","WBGene00013445","III",11509081,11511467,2386
"11129","WBGene00013446","III",11502963,11505291,2328
"11130","WBGene00013447","III",11488355,11500747,12392
"11131","WBGene00013448","III",11496829,11500717,3888
"11132","WBGene00013449","I",9829827,9830599,772
"11133","WBGene00013450","IV",14345435,14350751,5316
"11134","WBGene00013451","IV",14338057,14339279,1222
"11135","WBGene00013452","IV",14328995,14334459,5464
"11136","WBGene00013453","IV",14323244,14325665,2421
"11137","WBGene00013454","IV",14319834,14321755,1921
"11138","WBGene00013455","IV",14361255,14368259,7004
"11139","WBGene00013456","IV",14374114,14379643,5529
"11140","WBGene00013457","IV",14379953,14383701,3748
"11141","WBGene00013458","IV",14394138,14400368,6230
"11142","WBGene00013459","IV",14342660,14343856,1196
"11143","WBGene00013460","IV",13273911,13282878,8967
"11144","WBGene00013461","IV",13289776,13297869,8093
"11145","WBGene00013462","IV",13297926,13300066,2140
"11146","WBGene00013463","IV",13300179,13300720,541
"11147","WBGene00013464","IV",13303746,13310818,7072
"11148","WBGene00013465","IV",13283002,13289536,6534
"11149","WBGene00013466","V",17190831,17192339,1508
"11150","WBGene00013467","V",17193031,17199003,5972
"11151","WBGene00013468","V",17199418,17201736,2318
"11152","WBGene00013469","V",17202147,17205340,3193
"11153","WBGene00013470","V",17247325,17249015,1690
"11154","WBGene00013471","V",17243767,17245506,1739
"11155","WBGene00013472","V",17241708,17242652,944
"11156","WBGene00013473","IV",10947228,10948897,1669
"11157","WBGene00013474","IV",10949767,10951133,1366
"11158","WBGene00013475","IV",10952359,10954689,2330
"11159","WBGene00013476","IV",10955255,10956642,1387
"11160","WBGene00013477","IV",10956863,10957698,835
"11161","WBGene00013478","IV",10966590,10968166,1576
"11162","WBGene00013479","V",18620057,18623093,3036
"11163","WBGene00013480","V",18628680,18636348,7668
"11164","WBGene00013481","V",18656094,18664116,8022
"11165","WBGene00013482","V",18689989,18696069,6080
"11166","WBGene00013483","V",18699451,18700992,1541
"11167","WBGene00013484","V",18701540,18706098,4558
"11168","WBGene00013485","V",18670315,18684360,14045
"11169","WBGene00013486","V",18640337,18648392,8055
"11170","WBGene00013487","V",18650343,18656165,5822
"11171","WBGene00013489","V",18638484,18639591,1107
"11172","WBGene00013490","V",16621396,16623211,1815
"11173","WBGene00013491","V",16662114,16662960,846
"11174","WBGene00013492","V",16700199,16704409,4210
"11175","WBGene00013493","V",16705082,16706647,1565
"11176","WBGene00013494","V",16713447,16715195,1748
"11177","WBGene00013495","V",16718418,16721993,3575
"11178","WBGene00013496","X",14918836,14923942,5106
"11179","WBGene00013497","X",14901881,14905261,3380
"11180","WBGene00013498","III",10228164,10234079,5915
"11181","WBGene00013499","III",10238672,10244810,6138
"11182","WBGene00013501","I",13893133,13894476,1343
"11183","WBGene00013502","I",13915664,13917809,2145
"11184","WBGene00013503","I",13919375,13922122,2747
"11185","WBGene00013505","I",13938185,13942016,3831
"11186","WBGene00013506","I",13943079,13951628,8549
"11187","WBGene00013507","I",13957199,13960440,3241
"11188","WBGene00013508","I",13978430,13980144,1714
"11189","WBGene00013509","I",14004412,14008484,4072
"11190","WBGene00013510","I",13961011,13969571,8560
"11191","WBGene00013511","I",13992582,13996221,3639
"11192","WBGene00013512","I",14041627,14043478,1851
"11193","WBGene00013513","I",14046234,14048017,1783
"11194","WBGene00013514","IV",9043938,9045369,1431
"11195","WBGene00013515","IV",9042387,9043347,960
"11196","WBGene00013516","IV",9039575,9040504,929
"11197","WBGene00013517","IV",15236251,15243675,7424
"11198","WBGene00013518","IV",15259879,15269045,9166
"11199","WBGene00013519","IV",15294340,15295297,957
"11200","WBGene00013520","IV",15302421,15309408,6987
"11201","WBGene00013521","IV",15311234,15311676,442
"11202","WBGene00013522","IV",15312247,15313982,1735
"11203","WBGene00013523","IV",15318552,15319082,530
"11204","WBGene00013524","IV",15321579,15322183,604
"11205","WBGene00013525","IV",15337078,15339821,2743
"11206","WBGene00013526","IV",15378460,15381686,3226
"11207","WBGene00013527","IV",15439190,15441408,2218
"11208","WBGene00013528","IV",15442960,15444581,1621
"11209","WBGene00013529","IV",15445368,15453187,7819
"11210","WBGene00013530","IV",15455137,15471488,16351
"11211","WBGene00013531","IV",15473660,15477512,3852
"11212","WBGene00013532","IV",15472809,15473682,873
"11213","WBGene00013534","IV",15497567,15510980,13413
"11214","WBGene00013535","IV",15513786,15514464,678
"11215","WBGene00013536","IV",15514537,15521258,6721
"11216","WBGene00013537","IV",15515495,15520934,5439
"11217","WBGene00013538","IV",15524094,15528670,4576
"11218","WBGene00013539","IV",15533167,15539959,6792
"11219","WBGene00013540","III",12101810,12106597,4787
"11220","WBGene00013541","III",12107774,12113471,5697
"11221","WBGene00013542","III",12114577,12118470,3893
"11222","WBGene00013543","III",12123881,12130352,6471
"11223","WBGene00013544","III",12152899,12160100,7201
"11224","WBGene00013545","III",12160758,12171356,10598
"11225","WBGene00013547","III",12180960,12183013,2053
"11226","WBGene00013548","III",12186411,12190116,3705
"11227","WBGene00013549","III",12203822,12215686,11864
"11228","WBGene00013550","III",12216779,12218634,1855
"11229","WBGene00013551","III",12218990,12223934,4944
"11230","WBGene00013552","III",12224487,12225331,844
"11231","WBGene00013553","III",12225638,12226267,629
"11232","WBGene00013554","III",12226632,12232241,5609
"11233","WBGene00013555","III",12236184,12238951,2767
"11234","WBGene00013556","III",12250602,12251009,407
"11235","WBGene00013557","III",12251492,12273692,22200
"11236","WBGene00013558","III",12274040,12282221,8181
"11237","WBGene00013559","III",12319108,12323771,4663
"11238","WBGene00013560","III",12327667,12332274,4607
"11239","WBGene00013561","III",12351642,12354925,3283
"11240","WBGene00013562","III",12354944,12358561,3617
"11241","WBGene00013563","III",12361859,12367373,5514
"11242","WBGene00013564","III",12359565,12361248,1683
"11243","WBGene00013565","III",12315479,12315857,378
"11244","WBGene00013566","V",15109577,15110345,768
"11245","WBGene00013567","V",15184706,15185878,1172
"11246","WBGene00013568","V",15185891,15186300,409
"11247","WBGene00013569","V",15187989,15189588,1599
"11248","WBGene00013570","V",15201474,15202384,910
"11249","WBGene00013572","V",15200068,15201221,1153
"11250","WBGene00013573","V",15191296,15191836,540
"11251","WBGene00013574","III",13527438,13539971,12533
"11252","WBGene00013575","III",13540139,13543534,3395
"11253","WBGene00013576","III",13545245,13546777,1532
"11254","WBGene00013577","III",13546889,13549020,2131
"11255","WBGene00013578","III",13550699,13555334,4635
"11256","WBGene00013579","III",12028969,12030769,1800
"11257","WBGene00013580","III",12031516,12052303,20787
"11258","WBGene00013581","III",12041299,12042091,792
"11259","WBGene00013583","V",18874133,18876169,2036
"11260","WBGene00013584","V",18895317,18900532,5215
"11261","WBGene00013585","V",18912038,18918109,6071
"11262","WBGene00013586","V",18940641,18946905,6264
"11263","WBGene00013587","V",18953118,18957317,4199
"11264","WBGene00013588","V",18903772,18906201,2429
"11265","WBGene00013589","V",18933092,18933824,732
"11266","WBGene00013590","II",13082413,13083828,1415
"11267","WBGene00013591","II",13083989,13091483,7494
"11268","WBGene00013592","II",13091587,13094241,2654
"11269","WBGene00013593","I",13514550,13526254,11704
"11270","WBGene00013594","I",13534718,13537014,2296
"11271","WBGene00013595","I",13536892,13542703,5811
"11272","WBGene00013596","I",13572379,13575805,3426
"11273","WBGene00013597","I",13576148,13581585,5437
"11274","WBGene00013598","I",13586037,13588831,2794
"11275","WBGene00013599","I",13589099,13598505,9406
"11276","WBGene00013601","I",13598618,13603393,4775
"11277","WBGene00013602","I",13560447,13563465,3018
"11278","WBGene00013603","I",13491425,13493317,1892
"11279","WBGene00013604","I",13512313,13514320,2007
"11280","WBGene00013605","I",10944210,10945690,1480
"11281","WBGene00013606","V",16802874,16814563,11689
"11282","WBGene00013607","V",16854646,16856152,1506
"11283","WBGene00013608","V",16852291,16854053,1762
"11284","WBGene00013609","V",16850394,16852095,1701
"11285","WBGene00013610","V",16917196,16918478,1282
"11286","WBGene00013611","V",16918782,16919784,1002
"11287","WBGene00013612","V",16919780,16921323,1543
"11288","WBGene00013613","V",16922252,16924258,2006
"11289","WBGene00013614","V",16932006,16933555,1549
"11290","WBGene00013615","V",16936203,16938484,2281
"11291","WBGene00013616","V",16939031,16940049,1018
"11292","WBGene00013619","V",16947158,16948111,953
"11293","WBGene00013620","V",16948659,16949674,1015
"11294","WBGene00013621","V",16956529,16957991,1462
"11295","WBGene00013622","V",16951804,16953507,1703
"11296","WBGene00013623","V",16966814,16968586,1772
"11297","WBGene00013624","V",16969039,16970965,1926
"11298","WBGene00013625","V",16977191,16978408,1217
"11299","WBGene00013627","V",16984044,16985395,1351
"11300","WBGene00013628","V",16988240,16988714,474
"11301","WBGene00013629","V",16992034,16993910,1876
"11302","WBGene00013631","X",11781463,11784330,2867
"11303","WBGene00013632","IV",15550854,15554721,3867
"11304","WBGene00013633","IV",15612768,15617087,4319
"11305","WBGene00013634","IV",15631517,15633399,1882
"11306","WBGene00013635","IV",15635762,15635947,185
"11307","WBGene00013636","IV",15641476,15641799,323
"11308","WBGene00013637","IV",15641215,15643828,2613
"11309","WBGene00013638","IV",15646970,15648298,1328
"11310","WBGene00013639","IV",15689201,15722267,33066
"11311","WBGene00013640","IV",15723478,15727041,3563
"11312","WBGene00013642","IV",15820059,15825617,5558
"11313","WBGene00013643","IV",15849875,15852905,3030
"11314","WBGene00013644","IV",15860221,15861442,1221
"11315","WBGene00013645","IV",15870643,15872221,1578
"11316","WBGene00013646","IV",15884222,15888419,4197
"11317","WBGene00013647","IV",15899935,15901225,1290
"11318","WBGene00013648","IV",15914997,15919234,4237
"11319","WBGene00013649","IV",15922727,15926839,4112
"11320","WBGene00013650","IV",15930581,15931813,1232
"11321","WBGene00013651","IV",15937112,15941491,4379
"11322","WBGene00013652","IV",15942535,15944430,1895
"11323","WBGene00013653","IV",15949725,15950861,1136
"11324","WBGene00013654","IV",15951909,15954836,2927
"11325","WBGene00013655","IV",15956571,15962712,6141
"11326","WBGene00013656","IV",15963124,15964425,1301
"11327","WBGene00013657","IV",15964640,15965679,1039
"11328","WBGene00013658","IV",15981575,15983970,2395
"11329","WBGene00013659","IV",15993454,15994605,1151
"11330","WBGene00013661","IV",16057283,16061358,4075
"11331","WBGene00013662","IV",16142544,16147155,4611
"11332","WBGene00013665","IV",16132464,16134179,1715
"11333","WBGene00013666","I",14341571,14343815,2244
"11334","WBGene00013667","I",14347514,14358326,10812
"11335","WBGene00013668","I",14358502,14367594,9092
"11336","WBGene00013669","I",14400679,14405649,4970
"11337","WBGene00013670","I",14418197,14431806,13609
"11338","WBGene00013671","I",14432793,14433841,1048
"11339","WBGene00013672","I",14436810,14451880,15070
"11340","WBGene00013673","I",14461038,14465145,4107
"11341","WBGene00013674","I",14465380,14468214,2834
"11342","WBGene00013676","I",14469506,14476790,7284
"11343","WBGene00013677","I",14476674,14486767,10093
"11344","WBGene00013678","I",14486878,14496560,9682
"11345","WBGene00013679","I",14499727,14510552,10825
"11346","WBGene00013680","I",14552030,14565853,13823
"11347","WBGene00013682","I",14567169,14616524,49355
"11348","WBGene00013683","I",14529531,14546634,17103
"11349","WBGene00013684","I",14441515,14444332,2817
"11350","WBGene00013685","I",14496909,14498291,1382
"11351","WBGene00013687","I",14634456,14642653,8197
"11352","WBGene00013688","I",14652116,14657275,5159
"11353","WBGene00013689","I",14647782,14651456,3674
"11354","WBGene00013690","I",14657355,14661414,4059
"11355","WBGene00013691","I",14662524,14662873,349
"11356","WBGene00013692","I",14642714,14646600,3886
"11357","WBGene00013693","I",14675600,14682566,6966
"11358","WBGene00013694","I",9936125,9938378,2253
"11359","WBGene00013695","I",9931870,9934290,2420
"11360","WBGene00013696","I",9930972,9931882,910
"11361","WBGene00013697","I",9934639,9936022,1383
"11362","WBGene00013698","I",10107393,10109000,1607
"11363","WBGene00013699","I",10110982,10111916,934
"11364","WBGene00013700","I",10112088,10114256,2168
"11365","WBGene00013701","I",10114759,10116583,1824
"11366","WBGene00013702","I",10118081,10119436,1355
"11367","WBGene00013703","I",10122459,10130215,7756
"11368","WBGene00013704","I",10117061,10118134,1073
"11369","WBGene00013705","I",10198286,10200440,2154
"11370","WBGene00013706","I",10200768,10201808,1040
"11371","WBGene00013707","I",10220455,10221252,797
"11372","WBGene00013708","I",10221635,10222778,1143
"11373","WBGene00013709","I",10227210,10231214,4004
"11374","WBGene00013710","I",10328984,10330370,1386
"11375","WBGene00013711","I",10300573,10327870,27297
"11376","WBGene00013712","I",10323511,10324145,634
"11377","WBGene00013713","I",10321711,10323398,1687
"11378","WBGene00013716","I",10429629,10432336,2707
"11379","WBGene00013717","I",10436895,10437708,813
"11380","WBGene00013718","I",10438075,10443563,5488
"11381","WBGene00013719","I",10443668,10446133,2465
"11382","WBGene00013720","I",10452178,10452895,717
"11383","WBGene00013721","I",10454414,10455632,1218
"11384","WBGene00013722","I",10457828,10459047,1219
"11385","WBGene00013723","I",10471185,10471960,775
"11386","WBGene00013724","I",10472196,10473389,1193
"11387","WBGene00013725","I",10473513,10474449,936
"11388","WBGene00013726","I",10474835,10475525,690
"11389","WBGene00013727","III",12492793,12495640,2847
"11390","WBGene00013728","III",12496086,12496449,363
"11391","WBGene00013729","III",12496538,12499352,2814
"11392","WBGene00013730","III",12499557,12527924,28367
"11393","WBGene00013732","III",12538664,12575401,36737
"11394","WBGene00013734","III",12595994,12598604,2610
"11395","WBGene00013735","III",12609289,12623740,14451
"11396","WBGene00013736","III",12624766,12625890,1124
"11397","WBGene00013737","III",12652344,12662286,9942
"11398","WBGene00013738","III",12673633,12686230,12597
"11399","WBGene00013739","III",12688318,12698436,10118
"11400","WBGene00013740","III",12711506,12713874,2368
"11401","WBGene00013741","III",12746450,12747621,1171
"11402","WBGene00013742","III",12699494,12710888,11394
"11403","WBGene00013744","III",12530374,12532291,1917
"11404","WBGene00013746","V",20023046,20036667,13621
"11405","WBGene00013747","V",20040927,20047398,6471
"11406","WBGene00013748","V",20128416,20133142,4726
"11407","WBGene00013749","V",20144247,20146805,2558
"11408","WBGene00013750","V",20148195,20150357,2162
"11409","WBGene00013751","V",20135864,20138449,2585
"11410","WBGene00013752","V",20094344,20095008,664
"11411","WBGene00013753","V",20037587,20039419,1832
"11412","WBGene00013754","V",20187710,20188882,1172
"11413","WBGene00013755","V",20190535,20192152,1617
"11414","WBGene00013756","V",20196971,20198242,1271
"11415","WBGene00013757","V",20203422,20204503,1081
"11416","WBGene00013758","V",20201616,20202874,1258
"11417","WBGene00013759","V",20204528,20206180,1652
"11418","WBGene00013760","V",20206318,20207907,1589
"11419","WBGene00013761","V",20213821,20215297,1476
"11420","WBGene00013762","V",20208685,20212451,3766
"11421","WBGene00013763","V",20226835,20228829,1994
"11422","WBGene00013764","V",20228966,20233843,4877
"11423","WBGene00013765","V",20270107,20275732,5625
"11424","WBGene00013766","V",20267377,20269711,2334
"11425","WBGene00013768","V",20234807,20237743,2936
"11426","WBGene00013770","V",20224856,20225458,602
"11427","WBGene00013771","V",20317742,20324024,6282
"11428","WBGene00013773","IV",16813368,16813924,556
"11429","WBGene00013774","IV",16805027,16806460,1433
"11430","WBGene00013775","IV",16822869,16824493,1624
"11431","WBGene00013776","IV",16826324,16828020,1696
"11432","WBGene00013777","IV",16830208,16830790,582
"11433","WBGene00013778","IV",16831666,16832984,1318
"11434","WBGene00013779","IV",17216333,17217368,1035
"11435","WBGene00013781","IV",17223774,17225019,1245
"11436","WBGene00013782","IV",17226014,17231056,5042
"11437","WBGene00013783","IV",16900250,16902520,2270
"11438","WBGene00013784","IV",16916051,16917511,1460
"11439","WBGene00013785","IV",16920341,16924071,3730
"11440","WBGene00013786","IV",16924392,16927162,2770
"11441","WBGene00013788","IV",16931990,16933113,1123
"11442","WBGene00013789","IV",16939804,16946910,7106
"11443","WBGene00013790","IV",16934266,16939111,4845
"11444","WBGene00013791","IV",16988828,16989771,943
"11445","WBGene00013792","IV",16950065,16962868,12803
"11446","WBGene00013794","IV",17024318,17025132,814
"11447","WBGene00013795","IV",17028931,17030594,1663
"11448","WBGene00013796","IV",17038923,17039667,744
"11449","WBGene00013797","IV",17040913,17041523,610
"11450","WBGene00013798","IV",17044739,17045791,1052
"11451","WBGene00013799","IV",17046470,17048357,1887
"11452","WBGene00013800","IV",17053594,17055513,1919
"11453","WBGene00013801","IV",17068795,17070903,2108
"11454","WBGene00013802","IV",17074190,17078750,4560
"11455","WBGene00013803","IV",17079606,17087438,7832
"11456","WBGene00013804","IV",17090630,17096286,5656
"11457","WBGene00013805","IV",17096386,17100246,3860
"11458","WBGene00013806","IV",17094031,17095311,1280
"11459","WBGene00013807","IV",17100225,17103715,3490
"11460","WBGene00013808","IV",17104179,17110982,6803
"11461","WBGene00013809","IV",17112117,17115465,3348
"11462","WBGene00013810","IV",17130066,17131075,1009
"11463","WBGene00013811","IV",17131545,17133657,2112
"11464","WBGene00013812","IV",17144355,17150971,6616
"11465","WBGene00013814","IV",17088851,17090646,1795
"11466","WBGene00013815","IV",17057912,17058136,224
"11467","WBGene00013816","V",19730588,19732165,1577
"11468","WBGene00013817","V",19729038,19729590,552
"11469","WBGene00013819","V",19727481,19727964,483
"11470","WBGene00013820","V",19797999,19801133,3134
"11471","WBGene00013821","V",19839403,19841472,2069
"11472","WBGene00013822","V",19842632,19845977,3345
"11473","WBGene00013823","V",19848314,19855250,6936
"11474","WBGene00013824","V",19857623,19860982,3359
"11475","WBGene00013825","V",19855174,19867983,12809
"11476","WBGene00013826","V",19870506,19873931,3425
"11477","WBGene00013827","V",19878221,19880028,1807
"11478","WBGene00013828","V",19883216,19885854,2638
"11479","WBGene00013829","V",19899467,19900291,824
"11480","WBGene00013830","V",20306103,20308919,2816
"11481","WBGene00013831","V",20311819,20315628,3809
"11482","WBGene00013832","V",20303588,20304908,1320
"11483","WBGene00013833","V",20297950,20299524,1574
"11484","WBGene00013834","V",20289939,20294488,4549
"11485","WBGene00013835","V",20281391,20289417,8026
"11486","WBGene00013836","III",1272474,1273676,1202
"11487","WBGene00013837","III",1274514,1275588,1074
"11488","WBGene00013838","III",1269558,1271451,1893
"11489","WBGene00013839","III",1267338,1269256,1918
"11490","WBGene00013840","III",1265673,1266855,1182
"11491","WBGene00013841","III",1279627,1281725,2098
"11492","WBGene00013842","III",1282401,1284144,1743
"11493","WBGene00013843","III",1289747,1290938,1191
"11494","WBGene00013844","III",1287299,1288523,1224
"11495","WBGene00013845","III",1285016,1287119,2103
"11496","WBGene00013846","III",9199450,9206285,6835
"11497","WBGene00013847","III",9186556,9191127,4571
"11498","WBGene00013848","III",9208288,9215440,7152
"11499","WBGene00013849","III",9192983,9199507,6524
"11500","WBGene00013850","III",9186077,9192951,6874
"11501","WBGene00013852","II",14678457,14681145,2688
"11502","WBGene00013853","V",12609826,12610857,1031
"11503","WBGene00013854","V",12611682,12612260,578
"11504","WBGene00013855","V",12611329,12628738,17409
"11505","WBGene00013856","IV",10728572,10729003,431
"11506","WBGene00013857","IV",10732832,10734632,1800
"11507","WBGene00013858","IV",10738204,10738658,454
"11508","WBGene00013859","I",10264314,10279234,14920
"11509","WBGene00013860","I",10255632,10262250,6618
"11510","WBGene00013862","V",10737116,10739350,2234
"11511","WBGene00013863","V",10739276,10741457,2181
"11512","WBGene00013865","I",14009871,14011521,1650
"11513","WBGene00013866","X",10054281,10057524,3243
"11514","WBGene00013867","X",10057925,10058437,512
"11515","WBGene00013868","X",10060525,10061681,1156
"11516","WBGene00013869","X",10062451,10069783,7332
"11517","WBGene00013870","X",10072507,10074391,1884
"11518","WBGene00013871","X",10049460,10052481,3021
"11519","WBGene00013872","X",10034836,10047417,12581
"11520","WBGene00013873","V",14175517,14182960,7443
"11521","WBGene00013874","V",14171645,14175355,3710
"11522","WBGene00013875","V",14168362,14171481,3119
"11523","WBGene00013876","V",14178079,14179628,1549
"11524","WBGene00013877","V",14185691,14192156,6465
"11525","WBGene00013878","V",14193685,14197695,4010
"11526","WBGene00013879","V",14180247,14181535,1288
"11527","WBGene00013880","IV",9074673,9076571,1898
"11528","WBGene00013881","IV",9076501,9078807,2306
"11529","WBGene00013882","IV",9088594,9092193,3599
"11530","WBGene00013883","V",14852826,14858596,5770
"11531","WBGene00013884","V",14868645,14871547,2902
"11532","WBGene00013886","V",14874198,14875470,1272
"11533","WBGene00013887","V",14878324,14878502,178
"11534","WBGene00013891","I",10334661,10335739,1078
"11535","WBGene00013892","I",10331945,10333082,1137
"11536","WBGene00013893","I",10345736,10348061,2325
"11537","WBGene00013894","I",10348055,10349379,1324
"11538","WBGene00013895","I",10356251,10360890,4639
"11539","WBGene00013896","V",12808422,12810080,1658
"11540","WBGene00013897","V",12810289,12811158,869
"11541","WBGene00013898","V",12812258,12814122,1864
"11542","WBGene00013899","V",12816912,12819545,2633
"11543","WBGene00013900","V",12820265,12822758,2493
"11544","WBGene00013901","V",12825024,12827432,2408
"11545","WBGene00013902","V",12773522,12783063,9541
"11546","WBGene00013903","V",12798327,12800193,1866
"11547","WBGene00013904","V",12795484,12798154,2670
"11548","WBGene00013905","V",12793020,12795336,2316
"11549","WBGene00013906","V",12790698,12792965,2267
"11550","WBGene00013907","V",12783222,12784864,1642
"11551","WBGene00013908","V",12789197,12790518,1321
"11552","WBGene00013909","V",12787269,12788551,1282
"11553","WBGene00013910","V",12803574,12804550,976
"11554","WBGene00013911","III",12747899,12750927,3028
"11555","WBGene00013912","III",12760684,12764341,3657
"11556","WBGene00013913","III",12764553,12769048,4495
"11557","WBGene00013914","III",12785154,12793128,7974
"11558","WBGene00013915","III",12751109,12753634,2525
"11559","WBGene00013916","X",10407150,10409774,2624
"11560","WBGene00013917","X",10416639,10419764,3125
"11561","WBGene00013919","X",9958899,9964747,5848
"11562","WBGene00013920","X",9965495,9968584,3089
"11563","WBGene00013921","IV",12349946,12355724,5778
"11564","WBGene00013923","II",11646747,11649139,2392
"11565","WBGene00013924","II",11651261,11652906,1645
"11566","WBGene00013925","II",11649096,11651213,2117
"11567","WBGene00013926","II",11654214,11657172,2958
"11568","WBGene00013927","I",11148973,11150295,1322
"11569","WBGene00013928","I",11146448,11148309,1861
"11570","WBGene00013929","I",11142113,11144090,1977
"11571","WBGene00013930","I",11151241,11151972,731
"11572","WBGene00013931","I",11152704,11154329,1625
"11573","WBGene00013932","I",11154213,11155369,1156
"11574","WBGene00013933","I",11156745,11158831,2086
"11575","WBGene00013934","II",13792229,13817398,25169
"11576","WBGene00013935","V",17092570,17093420,850
"11577","WBGene00013937","V",17097927,17098766,839
"11578","WBGene00013938","V",17099347,17100364,1017
"11579","WBGene00013939","V",17101132,17102017,885
"11580","WBGene00013940","V",17103410,17104627,1217
"11581","WBGene00013941","V",17105783,17106656,873
"11582","WBGene00013942","V",17116336,17117034,698
"11583","WBGene00013943","V",17107530,17108418,888
"11584","WBGene00013944","V",18444418,18447019,2601
"11585","WBGene00013946","V",18458238,18461231,2993
"11586","WBGene00013947","V",18462804,18465320,2516
"11587","WBGene00013949","V",18410758,18412987,2229
"11588","WBGene00013950","V",18414351,18416861,2510
"11589","WBGene00013951","V",18423883,18424207,324
"11590","WBGene00013953","V",18438381,18440195,1814
"11591","WBGene00013954","V",18440578,18441340,762
"11592","WBGene00013955","I",8226509,8240637,14128
"11593","WBGene00013956","I",8242104,8243572,1468
"11594","WBGene00013957","I",8256360,8258939,2579
"11595","WBGene00013958","I",8255348,8256312,964
"11596","WBGene00013959","I",8262039,8268990,6951
"11597","WBGene00013960","I",8270304,8275701,5397
"11598","WBGene00013961","V",16046873,16047446,573
"11599","WBGene00013962","V",9666700,9670050,3350
"11600","WBGene00013963","V",9670028,9673630,3602
"11601","WBGene00013964","V",9678277,9679302,1025
"11602","WBGene00013965","V",9680173,9685715,5542
"11603","WBGene00013966","V",9691039,9692159,1120
"11604","WBGene00013967","V",9692899,9694785,1886
"11605","WBGene00013968","V",9679357,9680215,858
"11606","WBGene00013969","I",14993821,15001682,7861
"11607","WBGene00013970","I",14975419,14980586,5167
"11608","WBGene00013971","V",18731991,18732772,781
"11609","WBGene00013972","V",18732802,18734466,1664
"11610","WBGene00013973","V",18730174,18731679,1505
"11611","WBGene00013974","X",11328591,11332072,3481
"11612","WBGene00013975","X",11324517,11326901,2384
"11613","WBGene00013976","X",11318278,11321085,2807
"11614","WBGene00013978","III",9099681,9101258,1577
"11615","WBGene00013979","III",9101367,9103095,1728
"11616","WBGene00013980","III",9103943,9106805,2862
"11617","WBGene00013982","III",9115082,9117270,2188
"11618","WBGene00013983","III",9141789,9144794,3005
"11619","WBGene00013984","III",9145325,9145976,651
"11620","WBGene00013985","III",9125641,9130807,5166
"11621","WBGene00013986","III",9138052,9138701,649
"11622","WBGene00013987","III",9146031,9147411,1380
"11623","WBGene00013988","III",9130844,9131360,516
"11624","WBGene00013989","III",9144214,9144682,468
"11625","WBGene00013994","I",7460858,7466424,5566
"11626","WBGene00013995","IV",17239941,17243212,3271
"11627","WBGene00013996","IV",17245584,17249750,4166
"11628","WBGene00013997","IV",17250131,17254964,4833
"11629","WBGene00013998","IV",17255301,17257562,2261
"11630","WBGene00013999","IV",17257504,17259410,1906
"11631","WBGene00014000","IV",17260307,17262485,2178
"11632","WBGene00014001","IV",10909915,10913078,3163
"11633","WBGene00014002","IV",10913361,10914582,1221
"11634","WBGene00014003","IV",10916597,10917718,1121
"11635","WBGene00014004","IV",10937454,10939935,2481
"11636","WBGene00014005","IV",10940959,10942869,1910
"11637","WBGene00014006","IV",10900370,10901386,1016
"11638","WBGene00014007","IV",10908131,10909306,1175
"11639","WBGene00014008","IV",10901913,10904382,2469
"11640","WBGene00014009","IV",12014189,12015686,1497
"11641","WBGene00014011","III",9799107,9802333,3226
"11642","WBGene00014012","III",9802354,9805093,2739
"11643","WBGene00014013","III",9805515,9807454,1939
"11644","WBGene00014014","III",9808544,9812639,4095
"11645","WBGene00014015","III",9819294,9823120,3826
"11646","WBGene00014016","III",9824877,9825445,568
"11647","WBGene00014017","III",9826130,9827178,1048
"11648","WBGene00014018","III",9827915,9829719,1804
"11649","WBGene00014019","III",9830792,9832430,1638
"11650","WBGene00014020","III",9813446,9814424,978
"11651","WBGene00014021","III",8882707,8885482,2775
"11652","WBGene00014022","III",8887751,8890143,2392
"11653","WBGene00014023","III",8890231,8894208,3977
"11654","WBGene00014024","III",8894209,8894691,482
"11655","WBGene00014025","III",8895082,8896654,1572
"11656","WBGene00014027","III",8912144,8913632,1488
"11657","WBGene00014028","III",8913769,8916450,2681
"11658","WBGene00014029","III",8922292,8925302,3010
"11659","WBGene00014030","III",8922395,8923290,895
"11660","WBGene00014031","III",8888198,8889156,958
"11661","WBGene00014032","III",8920110,8921159,1049
"11662","WBGene00014033","III",8930036,8936682,6646
"11663","WBGene00014034","III",8956459,8957731,1272
"11664","WBGene00014035","III",8944686,8952953,8267
"11665","WBGene00014036","III",8952886,8956216,3330
"11666","WBGene00014037","III",8957704,8960693,2989
"11667","WBGene00014038","III",8925607,8926529,922
"11668","WBGene00014039","X",15696700,15698062,1362
"11669","WBGene00014040","X",15721270,15723776,2506
"11670","WBGene00014041","II",10470934,10471347,413
"11671","WBGene00014042","II",10471696,10471890,194
"11672","WBGene00014043","II",10474221,10476139,1918
"11673","WBGene00014044","II",10477259,10477693,434
"11674","WBGene00014045","II",10478022,10479448,1426
"11675","WBGene00014046","II",10480152,10481846,1694
"11676","WBGene00014047","II",10488747,10490514,1767
"11677","WBGene00014048","II",10491662,10493134,1472
"11678","WBGene00014049","II",10482585,10484473,1888
"11679","WBGene00014050","II",10496212,10496703,491
"11680","WBGene00014051","II",7912093,7928694,16601
"11681","WBGene00014052","II",7936592,7938583,1991
"11682","WBGene00014053","II",7941151,7942610,1459
"11683","WBGene00014054","II",7942463,7945206,2743
"11684","WBGene00014055","II",7945501,7946894,1393
"11685","WBGene00014057","II",10443327,10445233,1906
"11686","WBGene00014058","II",10448266,10450222,1956
"11687","WBGene00014060","II",10452920,10455200,2280
"11688","WBGene00014061","II",10461507,10461947,440
"11689","WBGene00014062","II",10462870,10464330,1460
"11690","WBGene00014063","II",10468351,10470297,1946
"11691","WBGene00014064","II",10464870,10465298,428
"11692","WBGene00014065","II",10457786,10462672,4886
"11693","WBGene00014066","II",7900647,7904636,3989
"11694","WBGene00014067","II",7911323,7912113,790
"11695","WBGene00014068","X",15742610,15744298,1688
"11696","WBGene00014069","X",15748483,15749206,723
"11697","WBGene00014070","X",15747005,15752138,5133
"11698","WBGene00014073","III",9868594,9871124,2530
"11699","WBGene00014074","III",9874142,9877476,3334
"11700","WBGene00014075","III",9863251,9867786,4535
"11701","WBGene00014076","IV",11659800,11665203,5403
"11702","WBGene00014077","IV",11678440,11682005,3565
"11703","WBGene00014078","IV",11684975,11688118,3143
"11704","WBGene00014079","IV",11694359,11696464,2105
"11705","WBGene00014080","IV",11668024,11671505,3481
"11706","WBGene00014081","IV",12548129,12554681,6552
"11707","WBGene00014082","IV",12557072,12558975,1903
"11708","WBGene00014083","IV",12559365,12560719,1354
"11709","WBGene00014084","IV",12560749,12561201,452
"11710","WBGene00014085","IV",11642102,11643722,1620
"11711","WBGene00014086","IV",11652403,11653461,1058
"11712","WBGene00014087","IV",11656730,11659425,2695
"11713","WBGene00014088","IV",11645597,11648893,3296
"11714","WBGene00014089","IV",11918110,11922128,4018
"11715","WBGene00014090","IV",11922358,11923174,816
"11716","WBGene00014091","IV",11926023,11928415,2392
"11717","WBGene00014092","IV",11937384,11940604,3220
"11718","WBGene00014093","IV",11940603,11942385,1782
"11719","WBGene00014094","IV",11943314,11945721,2407
"11720","WBGene00014095","IV",11953249,11955541,2292
"11721","WBGene00014096","IV",11959823,11961535,1712
"11722","WBGene00014097","IV",11970534,11972789,2255
"11723","WBGene00014098","V",12194457,12205494,11037
"11724","WBGene00014099","V",12194565,12195944,1379
"11725","WBGene00014100","I",14182787,14185717,2930
"11726","WBGene00014101","I",14185647,14196295,10648
"11727","WBGene00014102","I",14205717,14208581,2864
"11728","WBGene00014103","I",14200020,14204687,4667
"11729","WBGene00014104","I",14198612,14199099,487
"11730","WBGene00014105","V",10183284,10184446,1162
"11731","WBGene00014106","V",10186012,10190366,4354
"11732","WBGene00014107","V",10198704,10199942,1238
"11733","WBGene00014108","V",10201856,10202610,754
"11734","WBGene00014109","V",10202538,10203485,947
"11735","WBGene00014111","V",10205683,10206602,919
"11736","WBGene00014112","V",10203772,10205587,1815
"11737","WBGene00014113","V",10212929,10216305,3376
"11738","WBGene00014114","V",10206619,10210344,3725
"11739","WBGene00014115","I",9118115,9122398,4283
"11740","WBGene00014116","I",9123182,9124509,1327
"11741","WBGene00014117","I",9126140,9127101,961
"11742","WBGene00014118","I",9135764,9138361,2597
"11743","WBGene00014119","I",9138267,9145632,7365
"11744","WBGene00014120","I",9141971,9144376,2405
"11745","WBGene00014121","I",9124664,9126155,1491
"11746","WBGene00014122","V",12168222,12170208,1986
"11747","WBGene00014123","V",12179503,12181410,1907
"11748","WBGene00014124","V",12181501,12184194,2693
"11749","WBGene00014125","V",12186335,12187496,1161
"11750","WBGene00014127","II",10001846,10003987,2141
"11751","WBGene00014128","II",10006642,10008089,1447
"11752","WBGene00014129","II",10008217,10009401,1184
"11753","WBGene00014130","II",9978765,9980076,1311
"11754","WBGene00014131","II",9980886,9981752,866
"11755","WBGene00014132","IV",12872829,12875360,2531
"11756","WBGene00014134","IV",12883505,12886127,2622
"11757","WBGene00014135","IV",12880634,12883146,2512
"11758","WBGene00014136","IV",12876965,12879667,2702
"11759","WBGene00014137","IV",12869270,12871513,2243
"11760","WBGene00014138","IV",12866109,12869080,2971
"11761","WBGene00014139","IV",12855549,12859928,4379
"11762","WBGene00014140","X",9446664,9447612,948
"11763","WBGene00014141","X",9450225,9451994,1769
"11764","WBGene00014142","X",9453959,9454660,701
"11765","WBGene00014143","X",9459911,9460934,1023
"11766","WBGene00014144","X",9463356,9464725,1369
"11767","WBGene00014145","X",9447861,9449399,1538
"11768","WBGene00014148","I",14953490,14955492,2002
"11769","WBGene00014149","I",14955647,14957097,1450
"11770","WBGene00014150","I",14967301,14968540,1239
"11771","WBGene00014151","II",11908714,11915852,7138
"11772","WBGene00014152","II",11890992,11893423,2431
"11773","WBGene00014153","II",11897365,11901210,3845
"11774","WBGene00014154","II",11906517,11908601,2084
"11775","WBGene00014155","II",11882614,11883685,1071
"11776","WBGene00014156","II",11885588,11886601,1013
"11777","WBGene00014157","II",11914566,11915362,796
"11778","WBGene00014158","II",9829408,9830753,1345
"11779","WBGene00014159","II",9837089,9838305,1216
"11780","WBGene00014160","II",9831648,9834364,2716
"11781","WBGene00014161","II",9835221,9836925,1704
"11782","WBGene00014162","II",9843380,9847006,3626
"11783","WBGene00014163","II",9841067,9842036,969
"11784","WBGene00014164","II",10094873,10098785,3912
"11785","WBGene00014165","II",10100310,10103059,2749
"11786","WBGene00014166","II",10102975,10105704,2729
"11787","WBGene00014168","II",10106080,10106970,890
"11788","WBGene00014169","II",10107473,10108477,1004
"11789","WBGene00014170","II",10108702,10109081,379
"11790","WBGene00014171","II",10283466,10300132,16666
"11791","WBGene00014172","II",10300789,10302859,2070
"11792","WBGene00014173","II",10312293,10312943,650
"11793","WBGene00014174","II",10309418,10310068,650
"11794","WBGene00014175","II",10278732,10280459,1727
"11795","WBGene00014176","III",12975068,12977862,2794
"11796","WBGene00014177","III",12979162,12980163,1001
"11797","WBGene00014178","III",12981070,12984423,3353
"11798","WBGene00014179","III",12984493,12987542,3049
"11799","WBGene00014180","III",12987672,12991110,3438
"11800","WBGene00014181","III",12995738,13000670,4932
"11801","WBGene00014183","I",11460780,11463074,2294
"11802","WBGene00014184","I",11456467,11459953,3486
"11803","WBGene00014186","I",11454780,11455450,670
"11804","WBGene00014188","I",11469462,11471584,2122
"11805","WBGene00014189","I",11477744,11480071,2327
"11806","WBGene00014190","V",15311080,15312536,1456
"11807","WBGene00014191","V",15314668,15315927,1259
"11808","WBGene00014192","V",15316497,15318425,1928
"11809","WBGene00014193","V",15323853,15325351,1498
"11810","WBGene00014194","V",15325822,15327795,1973
"11811","WBGene00014195","V",15307562,15309063,1501
"11812","WBGene00014196","I",13227995,13229751,1756
"11813","WBGene00014197","I",13232121,13234686,2565
"11814","WBGene00014198","I",13246853,13249789,2936
"11815","WBGene00014199","I",13241645,13244797,3152
"11816","WBGene00014200","I",13235367,13236662,1295
"11817","WBGene00014201","I",13238540,13240726,2186
"11818","WBGene00014202","III",3903114,3907687,4573
"11819","WBGene00014203","III",3918871,3920700,1829
"11820","WBGene00014204","III",3916933,3918809,1876
"11821","WBGene00014205","III",3920626,3921711,1085
"11822","WBGene00014206","III",3922207,3923869,1662
"11823","WBGene00014207","III",3923792,3926238,2446
"11824","WBGene00014208","II",9213658,9222798,9140
"11825","WBGene00014209","II",9223269,9225176,1907
"11826","WBGene00014210","II",9210376,9213100,2724
"11827","WBGene00014213","X",16123942,16128865,4923
"11828","WBGene00014214","X",16103643,16123903,20260
"11829","WBGene00014215","X",13798222,13809857,11635
"11830","WBGene00014216","X",13792305,13793625,1320
"11831","WBGene00014217","X",13790832,13792258,1426
"11832","WBGene00014218","III",9522075,9525437,3362
"11833","WBGene00014219","III",9529166,9531888,2722
"11834","WBGene00014220","III",9532427,9538700,6273
"11835","WBGene00014221","III",9543069,9544404,1335
"11836","WBGene00014222","III",9525552,9527068,1516
"11837","WBGene00014223","III",9527151,9528689,1538
"11838","WBGene00014224","III",9523113,9523708,595
"11839","WBGene00014225","III",9544451,9545078,627
"11840","WBGene00014226","III",9556507,9557454,947
"11841","WBGene00014227","III",10113146,10114826,1680
"11842","WBGene00014228","III",10115042,10116760,1718
"11843","WBGene00014229","III",10116967,10118918,1951
"11844","WBGene00014230","III",10118961,10120148,1187
"11845","WBGene00014232","III",10124183,10132411,8228
"11846","WBGene00014233","III",10136982,10139241,2259
"11847","WBGene00014234","III",10112100,10113046,946
"11848","WBGene00014235","I",13205664,13207759,2095
"11849","WBGene00014236","I",13208441,13210462,2021
"11850","WBGene00014238","I",13214095,13216230,2135
"11851","WBGene00014239","I",13216605,13218867,2262
"11852","WBGene00014240","IV",9682984,9683533,549
"11853","WBGene00014241","IV",9683617,9684473,856
"11854","WBGene00014242","IV",9690932,9691465,533
"11855","WBGene00014243","IV",9696989,9706723,9734
"11856","WBGene00014244","II",9654345,9655616,1271
"11857","WBGene00014245","II",9653109,9653952,843
"11858","WBGene00014246","II",9652308,9653019,711
"11859","WBGene00014247","II",9650959,9651800,841
"11860","WBGene00014248","II",9636628,9640170,3542
"11861","WBGene00014249","II",9624590,9626641,2051
"11862","WBGene00014250","II",9649491,9650959,1468
"11863","WBGene00014251","II",9656689,9657719,1030
"11864","WBGene00014252","II",9657876,9659002,1126
"11865","WBGene00014253","II",9659246,9660442,1196
"11866","WBGene00014254","II",9660839,9663007,2168
"11867","WBGene00014255","II",9663616,9665664,2048
"11868","WBGene00014256","II",9671608,9673263,1655
"11869","WBGene00014258","II",9684088,9686713,2625
"11870","WBGene00014259","II",9667624,9668555,931
"11871","WBGene00014260","II",9754030,9754967,937
"11872","WBGene00014261","II",9758234,9768265,10031
"11873","WBGene00014262","II",9770759,9774292,3533
"11874","WBGene00014263","V",17542446,17542529,83
"11875","WBGene00014273","X",13415120,13415193,73
"11876","WBGene00014276","X",11806588,11806660,72
"11877","WBGene00014278","IV",16338507,16338628,121
"11878","WBGene00014279","I",9558792,9558874,82
"11879","WBGene00014280","I",9562353,9562437,84
"11880","WBGene00014281","I",9563843,9563927,84
"11881","WBGene00014287","V",14689532,14689615,83
"11882","WBGene00014289","X",11993521,11993592,71
"11883","WBGene00014290","V",12303708,12303783,75
"11884","WBGene00014291","V",11980118,11980261,143
"11885","WBGene00014292","X",12843688,12843760,72
"11886","WBGene00014294","X",13042182,13046220,4038
"11887","WBGene00014298","IV",9000804,9000875,71
"11888","WBGene00014300","V",11789550,11800544,10994
"11889","WBGene00014301","I",8781154,8781238,84
"11890","WBGene00014307","II",8784535,8785513,978
"11891","WBGene00014308","II",8786457,8787119,662
"11892","WBGene00014309","II",8787770,8789716,1946
"11893","WBGene00014312","II",13852787,13852972,185
"11894","WBGene00014317","V",14468569,14468733,164
"11895","WBGene00014319","X",10148649,10148721,72
"11896","WBGene00014322","V",16225701,16225887,186
"11897","WBGene00014327","I",12229309,12229380,71
"11898","WBGene00014328","I",12225426,12225497,71
"11899","WBGene00014338","X",12337998,12338070,72
"11900","WBGene00014340","X",12367642,12367713,71
"11901","WBGene00014341","V",15517401,15517468,67
"11902","WBGene00014343","I",7279355,7279427,72
"11903","WBGene00014348","X",14437873,14437944,71
"11904","WBGene00014349","I",7718882,7718958,76
"11905","WBGene00014350","V",15550612,15550693,81
"11906","WBGene00014358","X",14136939,14137010,71
"11907","WBGene00014362","V",17317879,17317962,83
"11908","WBGene00014363","I",11505551,11505622,71
"11909","WBGene00014370","V",14267543,14267707,164
"11910","WBGene00014371","V",14277574,14277738,164
"11911","WBGene00014372","X",14804877,14804948,71
"11912","WBGene00014373","X",12348007,12348126,119
"11913","WBGene00014375","IV",10037452,10039043,1591
"11914","WBGene00014377","X",9829667,9829751,84
"11915","WBGene00014379","II",12542634,12542705,71
"11916","WBGene00014382","X",9561088,9561160,72
"11917","WBGene00014391","X",13597231,13597340,109
"11918","WBGene00014392","III",9445911,9446012,101
"11919","WBGene00014394","III",9449569,9449670,101
"11920","WBGene00014397","V",11782992,11783082,90
"11921","WBGene00014402","III",4470886,4470958,72
"11922","WBGene00014403","I",12286588,12286774,186
"11923","WBGene00014405","I",12285746,12285932,186
"11924","WBGene00014411","I",12065865,12065937,72
"11925","WBGene00014414","IV",11721149,11721236,87
"11926","WBGene00014420","V",14231364,14231435,71
"11927","WBGene00014421","V",11391071,11391214,143
"11928","WBGene00014428","X",13261203,13261274,71
"11929","WBGene00014435","IV",13443745,13443846,101
"11930","WBGene00014439","X",13716493,13716565,72
"11931","WBGene00014440","X",13717195,13717267,72
"11932","WBGene00014447","II",10840317,10840391,74
"11933","WBGene00014448","X",14486211,14486283,72
"11934","WBGene00014451","MtDNA",58,111,53
"11935","WBGene00014452","MtDNA",785,840,55
"11936","WBGene00014454","MtDNA",898,1593,695
"11937","WBGene00014455","MtDNA",1595,1646,51
"11938","WBGene00014456","MtDNA",1648,1702,54
"11939","WBGene00014457","MtDNA",1707,1761,54
"11940","WBGene00014459","MtDNA",3307,3360,53
"11941","WBGene00014460","MtDNA",3362,3416,54
"11942","WBGene00014461","MtDNA",4269,4328,59
"11943","WBGene00014462","MtDNA",4330,4383,53
"11944","WBGene00014463","MtDNA",4385,4438,53
"11945","WBGene00014464","MtDNA",4447,4502,55
"11946","WBGene00014465","MtDNA",5621,5676,55
"11947","WBGene00014466","MtDNA",6450,6504,54
"11948","WBGene00014467","MtDNA",9422,9476,54
"11949","WBGene00014470","MtDNA",9593,9647,54
"11950","WBGene00014471","MtDNA",10348,10401,53
"11951","WBGene00014472","MtDNA",10403,11354,951
"11952","WBGene00014473","MtDNA",13275,13327,52
"11953","WBGene00014478","X",13307034,13307106,72
"11954","WBGene00014482","V",12331965,12332037,72
"11955","WBGene00014484","III",4414185,4414286,101
"11956","WBGene00014486","X",16209769,16209852,83
"11957","WBGene00014489","X",16208263,16208346,83
"11958","WBGene00014492","II",10542425,10544215,1790
"11959","WBGene00014500","I",13324995,13325066,71
"11960","WBGene00014501","I",13331147,13331218,71
"11961","WBGene00014505","IV",11106418,11107579,1161
"11962","WBGene00014506","II",11224182,11224258,76
"11963","WBGene00014507","X",10124498,10124579,81
"11964","WBGene00014510","I",12601778,12601845,67
"11965","WBGene00014512","V",15156682,15156754,72
"11966","WBGene00014513","II",9773654,9773728,74
"11967","WBGene00014517","V",11478148,11478291,143
"11968","WBGene00014518","V",11488291,11488434,143
"11969","WBGene00014519","X",12854840,12854911,71
"11970","WBGene00014520","X",12458176,12458247,71
"11971","WBGene00014522","IV",9334629,9334721,92
"11972","WBGene00014523","IV",9334706,9334802,96
"11973","WBGene00014529","I",7960837,7960921,84
"11974","WBGene00014534","II",11833536,11833645,109
"11975","WBGene00014535","III",11353029,11353101,72
"11976","WBGene00014536","III",11353628,11353700,72
"11977","WBGene00014542","I",11649503,11649687,184
"11978","WBGene00014543","III",10989679,10989780,101
"11979","WBGene00014544","III",10961850,10961917,67
"11980","WBGene00014551","V",13027028,13027100,72
"11981","WBGene00014562","V",18780490,18782605,2115
"11982","WBGene00014569","II",14101263,14102961,1698
"11983","WBGene00014576","II",12131530,12132894,1364
"11984","WBGene00014580","IV",16577306,16577387,81
"11985","WBGene00014582","IV",16684383,16684454,71
"11986","WBGene00014583","IV",16670866,16670937,71
"11987","WBGene00014591","II",12435580,12435651,71
"11988","WBGene00014594","IV",14889022,14889093,71
"11989","WBGene00014596","IV",16398384,16398455,71
"11990","WBGene00014597","IV",16399184,16399255,71
"11991","WBGene00014599","IV",16400896,16400967,71
"11992","WBGene00014602","IV",15235388,15235460,72
"11993","WBGene00014613","III",12528287,12536848,8561
"11994","WBGene00014614","V",20219301,20219370,69
"11995","WBGene00014615","V",19733411,19735075,1664
"11996","WBGene00014620","I",11158627,11158697,70
"11997","WBGene00014624","III",9104207,9104279,72
"11998","WBGene00014627","X",15748031,15748101,70
"11999","WBGene00014630","IV",11928478,11928596,118
"12000","WBGene00014633","IV",12787138,12787259,121
"12001","WBGene00014641","III",4350825,4352165,1340
"12002","WBGene00014643","V",15595055,15596466,1411
"12003","WBGene00014644","V",19577390,19577461,71
"12004","WBGene00014645","V",19579706,19579778,72
"12005","WBGene00014646","V",19581713,19581784,71
"12006","WBGene00014647","V",19582002,19582073,71
"12007","WBGene00014648","V",19584825,19584897,72
"12008","WBGene00014649","V",19595866,19595936,70
"12009","WBGene00014650","V",19595587,19595660,73
"12010","WBGene00014651","V",19594805,19594875,70
"12011","WBGene00014652","V",19594505,19594576,71
"12012","WBGene00014653","V",19594041,19594112,71
"12013","WBGene00014654","V",19587264,19587335,71
"12014","WBGene00014655","V",19578770,19578842,72
"12015","WBGene00014656","V",19578465,19578537,72
"12016","WBGene00014657","V",19559029,19559101,72
"12017","WBGene00014658","V",19557947,19558020,73
"12018","WBGene00014659","V",19557639,19557711,72
"12019","WBGene00014660","II",8909008,8909994,986
"12020","WBGene00014663","II",9289506,9291539,2033
"12021","WBGene00014665","IV",10093061,10093511,450
"12022","WBGene00014666","II",11424830,11430607,5777
"12023","WBGene00014667","II",10574842,10578193,3351
"12024","WBGene00014668","II",9376455,9378242,1787
"12025","WBGene00014669","IV",10799614,10802250,2636
"12026","WBGene00014670","V",18367139,18367210,71
"12027","WBGene00014672","IV",13636560,13636975,415
"12028","WBGene00014673","II",9864646,9866399,1753
"12029","WBGene00014674","V",10230258,10230671,413
"12030","WBGene00014675","V",10227753,10227935,182
"12031","WBGene00014676","V",10240265,10240363,98
"12032","WBGene00014677","V",19347582,19347654,72
"12033","WBGene00014678","III",9652313,9653641,1328
"12034","WBGene00014679","V",17540595,17542272,1677
"12035","WBGene00014681","V",15034380,15035420,1040
"12036","WBGene00014682","V",19396989,19397061,72
"12037","WBGene00014683","V",19396695,19396767,72
"12038","WBGene00014685","V",19398588,19398658,70
"12039","WBGene00014686","V",19431291,19431363,72
"12040","WBGene00014689","IV",9748815,9749925,1110
"12041","WBGene00014691","X",15368675,15368746,71
"12042","WBGene00014692","IV",9495620,9495710,90
"12043","WBGene00014693","IV",9492576,9493220,644
"12044","WBGene00014694","X",10491694,10493217,1523
"12045","WBGene00014697","III",3837551,3839477,1926
"12046","WBGene00014698","I",14154769,14155249,480
"12047","WBGene00014699","I",14151868,14152182,314
"12048","WBGene00014700","I",14150731,14151041,310
"12049","WBGene00014701","V",19327328,19329076,1748
"12050","WBGene00014702","V",19324105,19325882,1777
"12051","WBGene00014703","IV",13744155,13744988,833
"12052","WBGene00014704","V",17783161,17783230,69
"12053","WBGene00014705","V",17786886,17786956,70
"12054","WBGene00014706","V",17785714,17785785,71
"12055","WBGene00014707","V",17784515,17784585,70
"12056","WBGene00014710","V",13326339,13327634,1295
"12057","WBGene00014711","V",9521676,9523036,1360
"12058","WBGene00014714","I",12458028,12458996,968
"12059","WBGene00014715","V",18825382,18825452,70
"12060","WBGene00014716","V",18825987,18826057,70
"12061","WBGene00014717","V",18829048,18829118,70
"12062","WBGene00014720","V",18804710,18804782,72
"12063","WBGene00014721","V",18801975,18802045,70
"12064","WBGene00014722","V",15620022,15621232,1210
"12065","WBGene00014723","V",15630204,15631509,1305
"12066","WBGene00014724","IV",8927200,8927273,73
"12067","WBGene00014728","III",4043117,4047631,4514
"12068","WBGene00014729","I",12427388,12429094,1706
"12069","WBGene00014730","II",14000380,14001035,655
"12070","WBGene00014731","I",8433182,8434072,890
"12071","WBGene00014732","V",13869888,13872529,2641
"12072","WBGene00014733","V",16147039,16148327,1288
"12073","WBGene00014734","V",9512506,9513466,960
"12074","WBGene00014735","V",16063551,16064108,557
"12075","WBGene00014738","II",14617081,14617150,69
"12076","WBGene00014740","V",16239333,16240447,1114
"12077","WBGene00014741","V",16077979,16079234,1255
"12078","WBGene00014744","V",13451197,13452968,1771
"12079","WBGene00014745","V",16414068,16415247,1179
"12080","WBGene00014746","I",7722084,7723116,1032
"12081","WBGene00014748","I",7842914,7842988,74
"12082","WBGene00014751","V",15959808,15961915,2107
"12083","WBGene00014752","IV",9473680,9475365,1685
"12084","WBGene00014753","V",17146825,17153266,6441
"12085","WBGene00014754","V",9718462,9719724,1262
"12086","WBGene00014755","III",9921200,9921892,692
"12087","WBGene00014757","V",16112237,16112968,731
"12088","WBGene00014759","I",11250139,11251602,1463
"12089","WBGene00014760","I",11245823,11246765,942
"12090","WBGene00014761","I",11248270,11249952,1682
"12091","WBGene00014764","V",17369715,17371468,1753
"12092","WBGene00014766","IV",13043692,13043764,72
"12093","WBGene00014768","V",17027255,17028374,1119
"12094","WBGene00014769","IV",12513169,12515541,2372
"12095","WBGene00014770","V",12917450,12918902,1452
"12096","WBGene00014771","IV",12970270,12971974,1704
"12097","WBGene00014772","IV",9402576,9404038,1462
"12098","WBGene00014773","IV",9414473,9418454,3981
"12099","WBGene00014775","X",12166220,12166292,72
"12100","WBGene00014777","III",9601324,9602441,1117
"12101","WBGene00014778","V",14050295,14053709,3414
"12102","WBGene00014779","V",17678358,17680208,1850
"12103","WBGene00014781","V",17660883,17660956,73
"12104","WBGene00014782","V",17662171,17662243,72
"12105","WBGene00014787","V",17668360,17668432,72
"12106","WBGene00014788","V",17660778,17660849,71
"12107","WBGene00014789","I",10530339,10531547,1208
"12108","WBGene00014790","X",15064015,15067184,3169
"12109","WBGene00014793","X",15076696,15077607,911
"12110","WBGene00014794","V",20377128,20379410,2282
"12111","WBGene00014796","V",17499044,17505021,5977
"12112","WBGene00014798","V",16178532,16179966,1434
"12113","WBGene00014799","V",16176287,16177491,1204
"12114","WBGene00014800","V",15691999,15693161,1162
"12115","WBGene00014801","III",10141573,10146801,5228
"12116","WBGene00014803","V",15858838,15859227,389
"12117","WBGene00014805","V",9997094,9998481,1387
"12118","WBGene00014806","I",12113017,12113596,579
"12119","WBGene00014807","I",11334223,11337431,3208
"12120","WBGene00014809","III",10927093,10928909,1816
"12121","WBGene00014811","V",19773401,19774975,1574
"12122","WBGene00014813","II",9409341,9411597,2256
"12123","WBGene00014814","II",10935726,10942198,6472
"12124","WBGene00014817","V",9829068,9830444,1376
"12125","WBGene00014818","V",9830978,9831908,930
"12126","WBGene00014819","V",14711949,14712296,347
"12127","WBGene00014820","I",11905957,11907484,1527
"12128","WBGene00014821","V",18231635,18237223,5588
"12129","WBGene00014822","V",14591474,14593642,2168
"12130","WBGene00014825","IV",10834363,10835130,767
"12131","WBGene00014826","V",11836320,11838020,1700
"12132","WBGene00014827","II",8711589,8712035,446
"12133","WBGene00014828","IV",11362125,11362197,72
"12134","WBGene00014829","IV",11363194,11363266,72
"12135","WBGene00014832","V",15901142,15902166,1024
"12136","WBGene00014833","V",9937804,9940885,3081
"12137","WBGene00014834","V",14030184,14032584,2400
"12138","WBGene00014835","V",15161003,15162433,1430
"12139","WBGene00014836","V",15164743,15166318,1575
"12140","WBGene00014837","V",15173635,15174856,1221
"12141","WBGene00014838","II",9793754,9795541,1787
"12142","WBGene00014839","V",15284242,15285551,1309
"12143","WBGene00014841","V",11165853,11167640,1787
"12144","WBGene00014842","V",16844582,16845915,1333
"12145","WBGene00014843","X",13886369,13886441,72
"12146","WBGene00014844","V",15737020,15739659,2639
"12147","WBGene00014845","V",15453489,15454135,646
"12148","WBGene00014846","V",15438798,15440332,1534
"12149","WBGene00014848","II",10827716,10829556,1840
"12150","WBGene00014849","II",11441190,11441264,74
"12151","WBGene00014851","II",14031402,14032644,1242
"12152","WBGene00014852","I",12754091,12755126,1035
"12153","WBGene00014853","I",12731658,12731729,71
"12154","WBGene00014854","III",10967779,10969472,1693
"12155","WBGene00014857","IV",9832488,9832631,143
"12156","WBGene00014858","I",13635042,13635958,916
"12157","WBGene00014861","I",13714298,13716916,2618
"12158","WBGene00014862","IV",16303614,16306235,2621
"12159","WBGene00014863","IV",9247156,9248088,932
"12160","WBGene00014864","I",12932037,12933751,1714
"12161","WBGene00014866","V",17694094,17694165,71
"12162","WBGene00014867","V",17693799,17693871,72
"12163","WBGene00014870","I",13795277,13795867,590
"12164","WBGene00014871","I",13796060,13796675,615
"12165","WBGene00014872","II",12669995,12670067,72
"12166","WBGene00014873","II",12666159,12666230,71
"12167","WBGene00014874","V",20348247,20349925,1678
"12168","WBGene00014875","V",19057505,19057576,71
"12169","WBGene00014876","V",19058292,19058363,71
"12170","WBGene00014877","V",19059002,19059074,72
"12171","WBGene00014878","V",19059286,19059357,71
"12172","WBGene00014880","V",19060509,19060580,71
"12173","WBGene00014881","V",19082942,19083013,71
"12174","WBGene00014882","V",19084605,19084676,71
"12175","WBGene00014883","IV",12224335,12225071,736
"12176","WBGene00014884","III",13162475,13164864,2389
"12177","WBGene00014886","IV",15007803,15008173,370
"12178","WBGene00014888","V",19483637,19483895,258
"12179","WBGene00014889","V",19596966,19597038,72
"12180","WBGene00014890","V",19599515,19599588,73
"12181","WBGene00014894","V",19665948,19666020,72
"12182","WBGene00014897","V",19598599,19598667,68
"12183","WBGene00014898","III",10586407,10587706,1299
"12184","WBGene00014902","III",12382535,12383744,1209
"12185","WBGene00014903","III",12389885,12390556,671
"12186","WBGene00014904","III",12387891,12388985,1094
"12187","WBGene00014905","V",18287305,18288392,1087
"12188","WBGene00014906","V",18309386,18310203,817
"12189","WBGene00014907","V",18310924,18311985,1061
"12190","WBGene00014909","II",9407270,9407547,277
"12191","WBGene00014910","II",9404358,9404432,74
"12192","WBGene00014911","IV",16552220,16552292,72
"12193","WBGene00014914","I",11067699,11069996,2297
"12194","WBGene00014915","I",11966271,11967591,1320
"12195","WBGene00014916","I",12005177,12006296,1119
"12196","WBGene00014917","I",12006911,12008040,1129
"12197","WBGene00014918","I",12008625,12009625,1000
"12198","WBGene00014920","II",15118282,15118951,669
"12199","WBGene00014921","I",14824493,14825952,1459
"12200","WBGene00014922","IV",14575075,14575821,746
"12201","WBGene00014923","IV",14924444,14926046,1602
"12202","WBGene00014924","IV",14929721,14931931,2210
"12203","WBGene00014925","IV",14927059,14928623,1564
"12204","WBGene00014926","IV",14938896,14941898,3002
"12205","WBGene00014927","V",17834642,17835851,1209
"12206","WBGene00014928","V",17930351,17930421,70
"12207","WBGene00014929","V",17930794,17930865,71
"12208","WBGene00014930","V",17931694,17931764,70
"12209","WBGene00014931","V",17932761,17932831,70
"12210","WBGene00014932","V",17933330,17933401,71
"12211","WBGene00014933","V",19936526,19938905,2379
"12212","WBGene00014934","V",19922931,19924049,1118
"12213","WBGene00014937","V",17250270,17251293,1023
"12214","WBGene00014938","IV",13386674,13387346,672
"12215","WBGene00014939","III",11474462,11474534,72
"12216","WBGene00014941","IV",13320158,13321831,1673
"12217","WBGene00014943","V",17215066,17216751,1685
"12218","WBGene00014944","V",17209065,17209955,890
"12219","WBGene00014946","III",10223524,10224162,638
"12220","WBGene00014947","I",13969844,13970877,1033
"12221","WBGene00014948","IV",15255690,15257628,1938
"12222","WBGene00014949","V",15107837,15108897,1060
"12223","WBGene00014951","III",13523340,13523414,74
"12224","WBGene00014952","V",18906296,18906367,71
"12225","WBGene00014954","V",16928328,16928999,671
"12226","WBGene00014955","V",16929167,16930063,896
"12227","WBGene00014956","V",16943191,16943836,645
"12228","WBGene00014957","V",17003980,17005066,1086
"12229","WBGene00014958","IV",15556037,15558079,2042
"12230","WBGene00014963","IV",15782395,15783286,891
"12231","WBGene00014964","I",14678996,14679710,714
"12232","WBGene00014965","I",10119209,10122171,2962
"12233","WBGene00014966","I",10133601,10133671,70
"12234","WBGene00014967","V",20041693,20044405,2712
"12235","WBGene00014974","V",20214865,20214945,80
"12236","WBGene00014975","IV",16846025,16847457,1432
"12237","WBGene00014976","IV",16928334,16929067,733
"12238","WBGene00014977","V",20302135,20303443,1308
"12239","WBGene00014978","III",1277960,1278991,1031
"12240","WBGene00014979","III",1276249,1277360,1111
"12241","WBGene00014980","III",9206966,9207854,888
"12242","WBGene00014981","V",17114540,17114887,347
"12243","WBGene00014983","V",18461827,18461898,71
"12244","WBGene00014984","V",18406896,18408138,1242
"12245","WBGene00014987","III",8898622,8899530,908
"12246","WBGene00014989","II",7904639,7907589,2950
"12247","WBGene00014991","IV",11962538,11963855,1317
"12248","WBGene00014992","I",11443452,11446644,3192
"12249","WBGene00014993","V",15312982,15314230,1248
"12250","WBGene00014994","I",13224430,13225473,1043
"12251","WBGene00014996","IV",9687049,9688392,1343
"12252","WBGene00014997","IV",5111839,5112917,1078
"12253","WBGene00014998","X",2243602,2247008,3406
"12254","WBGene00014999","X",2259150,2260526,1376
"12255","WBGene00015000","X",2271025,2274337,3312
"12256","WBGene00015001","I",6027194,6028370,1176
"12257","WBGene00015002","II",5970105,5972658,2553
"12258","WBGene00015003","II",5944196,5944368,172
"12259","WBGene00015004","II",5968079,5969058,979
"12260","WBGene00015005","II",5972856,5974966,2110
"12261","WBGene00015006","I",4664499,4665331,832
"12262","WBGene00015007","I",4653471,4660151,6680
"12263","WBGene00015008","I",4644677,4645657,980
"12264","WBGene00015009","I",4648272,4650770,2498
"12265","WBGene00015010","I",4652145,4652906,761
"12266","WBGene00015011","I",4647280,4648275,995
"12267","WBGene00015012","II",2040368,2041629,1261
"12268","WBGene00015013","II",2043089,2044087,998
"12269","WBGene00015014","II",2044619,2045601,982
"12270","WBGene00015015","II",2045963,2046656,693
"12271","WBGene00015016","II",2048061,2049175,1114
"12272","WBGene00015017","I",10713505,10718201,4696
"12273","WBGene00015018","I",10724161,10726136,1975
"12274","WBGene00015019","I",10741368,10744445,3077
"12275","WBGene00015020","I",10740218,10740590,372
"12276","WBGene00015021","I",10736697,10739911,3214
"12277","WBGene00015022","I",10728959,10730287,1328
"12278","WBGene00015023","I",10720813,10723496,2683
"12279","WBGene00015024","I",10708363,10710376,2013
"12280","WBGene00015025","I",10732543,10733686,1143
"12281","WBGene00015026","I",5965062,5967211,2149
"12282","WBGene00015027","I",5955031,5956883,1852
"12283","WBGene00015028","I",5919055,5935416,16361
"12284","WBGene00015029","I",5935370,5936957,1587
"12285","WBGene00015030","I",5945581,5947620,2039
"12286","WBGene00015031","I",5951136,5951742,606
"12287","WBGene00015032","I",5957461,5958457,996
"12288","WBGene00015033","I",5959008,5959526,518
"12289","WBGene00015034","I",5962953,5964183,1230
"12290","WBGene00015035","IV",3568979,3577630,8651
"12291","WBGene00015036","IV",3565201,3567814,2613
"12292","WBGene00015037","IV",3540136,3543603,3467
"12293","WBGene00015038","IV",3543628,3547600,3972
"12294","WBGene00015040","V",3955766,3957715,1949
"12295","WBGene00015041","V",3958160,3961358,3198
"12296","WBGene00015042","V",3961760,3963815,2055
"12297","WBGene00015043","V",3964779,3967880,3101
"12298","WBGene00015044","V",3968134,3970514,2380
"12299","WBGene00015045","V",3970712,3973001,2289
"12300","WBGene00015046","V",3978836,3979134,298
"12301","WBGene00015047","IV",8159358,8162042,2684
"12302","WBGene00015048","IV",8152445,8154857,2412
"12303","WBGene00015049","IV",8155211,8156587,1376
"12304","WBGene00015050","IV",8161967,8163795,1828
"12305","WBGene00015051","IV",8164590,8166050,1460
"12306","WBGene00015052","IV",8167164,8168813,1649
"12307","WBGene00015053","V",9134255,9135347,1092
"12308","WBGene00015054","V",9135656,9137718,2062
"12309","WBGene00015055","V",9138946,9141397,2451
"12310","WBGene00015056","V",9152321,9154872,2551
"12311","WBGene00015057","V",9168393,9173024,4631
"12312","WBGene00015058","V",9158416,9159540,1124
"12313","WBGene00015059","II",7755997,7756907,910
"12314","WBGene00015061","II",7724903,7752715,27812
"12315","WBGene00015062","II",7752637,7753607,970
"12316","WBGene00015063","II",7754147,7755156,1009
"12317","WBGene00015064","II",7757190,7758922,1732
"12318","WBGene00015065","II",7759710,7761540,1830
"12319","WBGene00015066","II",7762062,7763669,1607
"12320","WBGene00015067","V",5240768,5243136,2368
"12321","WBGene00015068","V",5250604,5252116,1512
"12322","WBGene00015069","V",5256142,5257458,1316
"12323","WBGene00015070","V",5258036,5259548,1512
"12324","WBGene00015071","V",5260332,5263099,2767
"12325","WBGene00015072","V",5263951,5265776,1825
"12326","WBGene00015073","V",5275554,5278101,2547
"12327","WBGene00015074","V",5274074,5275615,1541
"12328","WBGene00015075","V",5269485,5270744,1259
"12329","WBGene00015076","V",5267822,5268823,1001
"12330","WBGene00015077","V",5243815,5248021,4206
"12331","WBGene00015078","V",5249037,5249873,836
"12332","WBGene00015079","III",5747485,5751637,4152
"12333","WBGene00015080","III",5744870,5747195,2325
"12334","WBGene00015081","III",5738008,5740471,2463
"12335","WBGene00015082","III",5731501,5733177,1676
"12336","WBGene00015083","III",5728180,5730159,1979
"12337","WBGene00015084","III",5730118,5731030,912
"12338","WBGene00015085","III",5735193,5737481,2288
"12339","WBGene00015086","III",5767882,5768665,783
"12340","WBGene00015087","II",6919680,6923665,3985
"12341","WBGene00015088","II",6902853,6907757,4904
"12342","WBGene00015089","II",6917032,6918922,1890
"12343","WBGene00015091","I",5263694,5268380,4686
"12344","WBGene00015092","I",5244283,5245402,1119
"12345","WBGene00015093","I",5249772,5250618,846
"12346","WBGene00015094","I",5255447,5256945,1498
"12347","WBGene00015095","I",5269545,5270941,1396
"12348","WBGene00015096","I",5271265,5272037,772
"12349","WBGene00015097","IV",5493992,5495252,1260
"12350","WBGene00015098","IV",5484046,5486258,2212
"12351","WBGene00015099","III",7133766,7136460,2694
"12352","WBGene00015100","III",7124664,7128382,3718
"12353","WBGene00015101","III",7123128,7124329,1201
"12354","WBGene00015102","III",7102086,7103990,1904
"12355","WBGene00015103","III",7110302,7111893,1591
"12356","WBGene00015104","III",7120905,7122895,1990
"12357","WBGene00015105","III",7131880,7133678,1798
"12358","WBGene00015106","III",7136510,7138278,1768
"12359","WBGene00015107","III",7128901,7132051,3150
"12360","WBGene00015108","II",2313067,2314927,1860
"12361","WBGene00015110","II",2307041,2308361,1320
"12362","WBGene00015111","II",2297847,2298793,946
"12363","WBGene00015112","II",2299854,2300946,1092
"12364","WBGene00015113","II",2301308,2302229,921
"12365","WBGene00015114","II",2311490,2312847,1357
"12366","WBGene00015115","II",4375504,4386343,10839
"12367","WBGene00015116","II",4369625,4372597,2972
"12368","WBGene00015117","X",1896662,1897343,681
"12369","WBGene00015118","X",1892187,1893272,1085
"12370","WBGene00015119","X",17178539,17178992,453
"12371","WBGene00015121","X",17176490,17176777,287
"12372","WBGene00015122","X",17193300,17195137,1837
"12373","WBGene00015124","III",8684808,8686481,1673
"12374","WBGene00015125","III",8686118,8688457,2339
"12375","WBGene00015126","III",8689850,8693473,3623
"12376","WBGene00015128","III",8693638,8699497,5859
"12377","WBGene00015129","III",8699481,8700333,852
"12378","WBGene00015130","III",8700927,8703341,2414
"12379","WBGene00015131","III",8703300,8710410,7110
"12380","WBGene00015132","III",8713993,8716184,2191
"12381","WBGene00015133","III",8717644,8718567,923
"12382","WBGene00015134","II",4523622,4524589,967
"12383","WBGene00015135","II",4512211,4516115,3904
"12384","WBGene00015136","II",4522465,4523222,757
"12385","WBGene00015137","X",493211,497510,4299
"12386","WBGene00015138","X",501965,506943,4978
"12387","WBGene00015139","X",510818,520880,10062
"12388","WBGene00015141","X",525929,530289,4360
"12389","WBGene00015142","X",530551,531009,458
"12390","WBGene00015143","III",5711548,5714846,3298
"12391","WBGene00015145","III",5692896,5693938,1042
"12392","WBGene00015146","III",5690107,5692740,2633
"12393","WBGene00015147","III",5694735,5697366,2631
"12394","WBGene00015148","III",5706718,5709324,2606
"12395","WBGene00015149","III",5710062,5710509,447
"12396","WBGene00015150","III",5694036,5694784,748
"12397","WBGene00015151","V",48922,49619,697
"12398","WBGene00015152","V",45310,46916,1606
"12399","WBGene00015153","V",1663,6632,4969
"12400","WBGene00015155","III",557518,576447,18929
"12401","WBGene00015156","III",7293632,7308364,14732
"12402","WBGene00015157","III",7281377,7283959,2582
"12403","WBGene00015158","III",7259012,7268263,9251
"12404","WBGene00015159","III",7268414,7275396,6982
"12405","WBGene00015160","III",7275502,7277274,1772
"12406","WBGene00015161","III",7283915,7285883,1968
"12407","WBGene00015162","III",7287848,7290562,2714
"12408","WBGene00015163","III",7298348,7299600,1252
"12409","WBGene00015164","III",7285983,7287603,1620
"12410","WBGene00015165","III",7277604,7281217,3613
"12411","WBGene00015167","X",7061203,7063330,2127
"12412","WBGene00015168","X",7066345,7068563,2218
"12413","WBGene00015169","X",7057731,7061190,3459
"12414","WBGene00015170","X",2894573,2895244,671
"12415","WBGene00015171","X",2885863,2890625,4762
"12416","WBGene00015172","X",2890612,2891491,879
"12417","WBGene00015173","III",795136,809439,14303
"12418","WBGene00015175","I",5801872,5803266,1394
"12419","WBGene00015176","I",5803959,5807291,3332
"12420","WBGene00015177","X",9303724,9310439,6715
"12421","WBGene00015178","X",9299147,9300131,984
"12422","WBGene00015179","X",9291651,9293366,1715
"12423","WBGene00015180","X",9278953,9279947,994
"12424","WBGene00015181","X",9268626,9270855,2229
"12425","WBGene00015182","X",9296947,9297934,987
"12426","WBGene00015183","II",297399,299735,2336
"12427","WBGene00015184","II",290582,291861,1279
"12428","WBGene00015185","II",288939,290391,1452
"12429","WBGene00015186","II",286625,288850,2225
"12430","WBGene00015188","II",266301,273966,7665
"12431","WBGene00015189","II",276212,278736,2524
"12432","WBGene00015190","II",282576,283694,1118
"12433","WBGene00015191","II",283887,286275,2388
"12434","WBGene00015192","II",293864,294706,842
"12435","WBGene00015193","II",296291,297010,719
"12436","WBGene00015194","II",278621,282576,3955
"12437","WBGene00015196","II",3038859,3040822,1963
"12438","WBGene00015197","II",3032780,3036122,3342
"12439","WBGene00015198","II",3020561,3023431,2870
"12440","WBGene00015199","II",3040943,3043406,2463
"12441","WBGene00015200","II",3052597,3054348,1751
"12442","WBGene00015202","IV",6963716,6964654,938
"12443","WBGene00015203","II",7699254,7702012,2758
"12444","WBGene00015204","II",7695935,7698506,2571
"12445","WBGene00015205","II",7698613,7699046,433
"12446","WBGene00015206","II",7701948,7705276,3328
"12447","WBGene00015207","II",7705536,7707483,1947
"12448","WBGene00015208","II",7707586,7708725,1139
"12449","WBGene00015210","IV",7446390,7447466,1076
"12450","WBGene00015211","IV",7447856,7449169,1313
"12451","WBGene00015214","IV",7420958,7422671,1713
"12452","WBGene00015215","IV",7419118,7419971,853
"12453","WBGene00015216","IV",7444639,7445432,793
"12454","WBGene00015217","IV",7449067,7451445,2378
"12455","WBGene00015218","V",8776570,8779318,2748
"12456","WBGene00015219","V",8774332,8776630,2298
"12457","WBGene00015220","V",8768909,8770876,1967
"12458","WBGene00015221","V",8754970,8755759,789
"12459","WBGene00015222","V",8753695,8754873,1178
"12460","WBGene00015223","V",8746158,8750177,4019
"12461","WBGene00015224","V",8757489,8758718,1229
"12462","WBGene00015225","V",8760687,8763194,2507
"12463","WBGene00015226","V",8764888,8766038,1150
"12464","WBGene00015227","V",8758820,8760516,1696
"12465","WBGene00015228","I",10651030,10653043,2013
"12466","WBGene00015229","I",10646762,10647777,1015
"12467","WBGene00015230","I",10644245,10645617,1372
"12468","WBGene00015231","I",10628712,10631674,2962
"12469","WBGene00015232","I",10625388,10628387,2999
"12470","WBGene00015233","I",10631665,10633150,1485
"12471","WBGene00015235","I",10639079,10640230,1151
"12472","WBGene00015236","I",10648606,10654179,5573
"12473","WBGene00015237","I",10654298,10666933,12635
"12474","WBGene00015238","I",10634572,10636028,1456
"12475","WBGene00015241","III",1894057,1899856,5799
"12476","WBGene00015242","III",1887558,1889691,2133
"12477","WBGene00015243","III",1883607,1886218,2611
"12478","WBGene00015244","III",1891383,1893842,2459
"12479","WBGene00015245","III",1901835,1905640,3805
"12480","WBGene00015246","IV",86890,90082,3192
"12481","WBGene00015247","IV",108971,112054,3083
"12482","WBGene00015248","IV",3385903,3386904,1001
"12483","WBGene00015249","IV",3373387,3378130,4743
"12484","WBGene00015250","IV",3379020,3382841,3821
"12485","WBGene00015251","IV",3382949,3384147,1198
"12486","WBGene00015252","IV",3388050,3390087,2037
"12487","WBGene00015253","IV",5646002,5646233,231
"12488","WBGene00015254","V",438401,438674,273
"12489","WBGene00015255","V",434198,436726,2528
"12490","WBGene00015257","V",429144,433574,4430
"12491","WBGene00015258","V",424440,426560,2120
"12492","WBGene00015259","V",422498,424064,1566
"12493","WBGene00015260","V",437576,441023,3447
"12494","WBGene00015261","X",9171562,9172204,642
"12495","WBGene00015262","X",9146174,9147526,1352
"12496","WBGene00015263","X",9137927,9145656,7729
"12497","WBGene00015264","X",9152493,9154184,1691
"12498","WBGene00015265","X",9173685,9174490,805
"12499","WBGene00015266","III",1037492,1046261,8769
"12500","WBGene00015267","III",1031324,1037212,5888
"12501","WBGene00015268","III",1045809,1053246,7437
"12502","WBGene00015273","V",2483004,2494791,11787
"12503","WBGene00015278","IV",6619468,6621352,1884
"12504","WBGene00015279","IV",6628366,6631745,3379
"12505","WBGene00015280","IV",6640161,6645352,5191
"12506","WBGene00015281","IV",6638556,6639271,715
"12507","WBGene00015282","IV",6635039,6638155,3116
"12508","WBGene00015283","IV",6632222,6634986,2764
"12509","WBGene00015284","IV",6624528,6627992,3464
"12510","WBGene00015285","II",19538,22169,2631
"12511","WBGene00015286","II",12985,16001,3016
"12512","WBGene00015287","II",6664,9486,2822
"12513","WBGene00015288","II",9485,11846,2361
"12514","WBGene00015291","II",24666,25446,780
"12515","WBGene00015292","X",3716314,3718566,2252
"12516","WBGene00015293","X",3706551,3713382,6831
"12517","WBGene00015294","X",7435602,7438000,2398
"12518","WBGene00015295","X",7439396,7442577,3181
"12519","WBGene00015296","II",4301607,4305287,3680
"12520","WBGene00015297","II",4299653,4300919,1266
"12521","WBGene00015298","II",4295101,4299006,3905
"12522","WBGene00015299","II",4276209,4279268,3059
"12523","WBGene00015300","II",4279424,4281967,2543
"12524","WBGene00015301","II",4282321,4288211,5890
"12525","WBGene00015303","I",4850682,4867825,17143
"12526","WBGene00015305","IV",6536179,6537671,1492
"12527","WBGene00015306","IV",6531750,6535677,3927
"12528","WBGene00015307","IV",6524610,6526524,1914
"12529","WBGene00015308","IV",6522874,6524568,1694
"12530","WBGene00015309","IV",6518174,6519502,1328
"12531","WBGene00015310","IV",6548818,6552511,3693
"12532","WBGene00015311","IV",6519926,6522242,2316
"12533","WBGene00015312","I",5272846,5274339,1493
"12534","WBGene00015313","I",5298755,5300331,1576
"12535","WBGene00015315","V",3469445,3470882,1437
"12536","WBGene00015316","V",3478031,3480446,2415
"12537","WBGene00015317","V",3485549,3486957,1408
"12538","WBGene00015318","V",3489228,3490535,1307
"12539","WBGene00015320","X",8147710,8148588,878
"12540","WBGene00015321","X",8143806,8145027,1221
"12541","WBGene00015322","X",8139446,8140243,797
"12542","WBGene00015323","X",8124072,8129643,5571
"12543","WBGene00015324","X",8133155,8136326,3171
"12544","WBGene00015325","X",8137721,8137879,158
"12545","WBGene00015326","IV",5086839,5088883,2044
"12546","WBGene00015327","IV",5090243,5091043,800
"12547","WBGene00015328","IV",5092823,5103279,10456
"12548","WBGene00015329","IV",5091586,5092807,1221
"12549","WBGene00015330","IV",5083303,5086887,3584
"12550","WBGene00015331","IV",5070854,5072263,1409
"12551","WBGene00015332","III",7873781,7877194,3413
"12552","WBGene00015333","III",7862583,7865306,2723
"12553","WBGene00015334","III",7877176,7878839,1663
"12554","WBGene00015335","III",8561136,8563026,1890
"12555","WBGene00015336","III",8557335,8559194,1859
"12556","WBGene00015337","III",8554772,8555821,1049
"12557","WBGene00015338","V",4934706,4939085,4379
"12558","WBGene00015339","V",4919207,4919586,379
"12559","WBGene00015340","V",4918154,4918585,431
"12560","WBGene00015341","V",4920342,4920790,448
"12561","WBGene00015342","V",4932506,4933027,521
"12562","WBGene00015344","V",1042692,1048580,5888
"12563","WBGene00015345","III",8249619,8250193,574
"12564","WBGene00015346","III",8245891,8247258,1367
"12565","WBGene00015347","III",8244445,8245794,1349
"12566","WBGene00015348","III",8236126,8236908,782
"12567","WBGene00015349","III",8232651,8234591,1940
"12568","WBGene00015350","III",8227362,8232660,5298
"12569","WBGene00015351","III",8248685,8249512,827
"12570","WBGene00015352","III",8240872,8243029,2157
"12571","WBGene00015353","III",8247351,8248814,1463
"12572","WBGene00015354","X",3668100,3668942,842
"12573","WBGene00015355","X",3670374,3672098,1724
"12574","WBGene00015356","X",3684212,3689205,4993
"12575","WBGene00015357","X",3690143,3693238,3095
"12576","WBGene00015358","X",3696903,3700807,3904
"12577","WBGene00015359","V",5876370,5879849,3479
"12578","WBGene00015360","V",5872084,5874914,2830
"12579","WBGene00015361","V",7388390,7389871,1481
"12580","WBGene00015362","V",7390529,7392111,1582
"12581","WBGene00015364","X",731160,735672,4512
"12582","WBGene00015366","V",5181912,5183717,1805
"12583","WBGene00015367","V",5168275,5169686,1411
"12584","WBGene00015368","V",5170914,5172933,2019
"12585","WBGene00015369","V",5175026,5177271,2245
"12586","WBGene00015371","V",5178338,5192531,14193
"12587","WBGene00015372","X",6374751,6375592,841
"12588","WBGene00015373","X",6367614,6373157,5543
"12589","WBGene00015374","X",6366013,6366831,818
"12590","WBGene00015375","X",6364496,6365717,1221
"12591","WBGene00015376","X",6355585,6357689,2104
"12592","WBGene00015377","X",6350187,6351876,1689
"12593","WBGene00015378","X",6341835,6345842,4007
"12594","WBGene00015379","X",6346359,6347113,754
"12595","WBGene00015380","X",6357747,6357872,125
"12596","WBGene00015381","X",6335279,6338035,2756
"12597","WBGene00015382","X",6359383,6360758,1375
"12598","WBGene00015385","III",7716166,7716446,280
"12599","WBGene00015386","III",7712309,7717314,5005
"12600","WBGene00015387","X",5386248,5394330,8082
"12601","WBGene00015388","X",5394508,5397400,2892
"12602","WBGene00015389","X",5397676,5400626,2950
"12603","WBGene00015390","X",5401437,5406443,5006
"12604","WBGene00015391","X",8542867,8546021,3154
"12605","WBGene00015392","X",8541862,8542284,422
"12606","WBGene00015393","V",7365251,7366204,953
"12607","WBGene00015394","V",7357451,7358882,1431
"12608","WBGene00015395","V",7346301,7348135,1834
"12609","WBGene00015396","V",7342156,7343838,1682
"12610","WBGene00015397","V",7348211,7349664,1453
"12611","WBGene00015398","V",7354445,7355510,1065
"12612","WBGene00015399","V",7359935,7361773,1838
"12613","WBGene00015400","V",7362319,7364204,1885
"12614","WBGene00015401","V",7377897,7379484,1587
"12615","WBGene00015402","V",7379745,7381069,1324
"12616","WBGene00015403","II",402580,404235,1655
"12617","WBGene00015404","II",388833,392732,3899
"12618","WBGene00015405","II",386134,387949,1815
"12619","WBGene00015406","II",375250,375835,585
"12620","WBGene00015407","II",382309,385358,3049
"12621","WBGene00015408","II",396644,399421,2777
"12622","WBGene00015409","II",380573,382257,1684
"12623","WBGene00015410","II",6848060,6851531,3471
"12624","WBGene00015411","IV",3428900,3430060,1160
"12625","WBGene00015412","IV",3415683,3419234,3551
"12626","WBGene00015413","IV",3399672,3403904,4232
"12627","WBGene00015414","IV",3394366,3394527,161
"12628","WBGene00015416","IV",3419813,3422607,2794
"12629","WBGene00015417","IV",3432872,3433487,615
"12630","WBGene00015418","III",8493878,8518879,25001
"12631","WBGene00015419","V",5922545,5924297,1752
"12632","WBGene00015421","V",5907408,5909620,2212
"12633","WBGene00015422","V",5902133,5904831,2698
"12634","WBGene00015423","V",5893312,5895208,1896
"12635","WBGene00015424","V",5882665,5883835,1170
"12636","WBGene00015425","V",5914097,5917891,3794
"12637","WBGene00015426","V",5918062,5919835,1773
"12638","WBGene00015427","V",5912726,5913757,1031
"12639","WBGene00015428","X",358092,360198,2106
"12640","WBGene00015429","X",353619,357939,4320
"12641","WBGene00015430","X",334801,347194,12393
"12642","WBGene00015432","V",3383924,3385145,1221
"12643","WBGene00015433","V",3369081,3369920,839
"12644","WBGene00015434","V",3362775,3368340,5565
"12645","WBGene00015435","V",3358567,3361093,2526
"12646","WBGene00015436","V",3354667,3355513,846
"12647","WBGene00015437","V",3355848,3357193,1345
"12648","WBGene00015438","V",3374362,3377073,2711
"12649","WBGene00015439","V",3377536,3382850,5314
"12650","WBGene00015440","V",3385695,3388156,2461
"12651","WBGene00015441","V",3389330,3390952,1622
"12652","WBGene00015442","I",5726308,5729310,3002
"12653","WBGene00015444","V",5093715,5096277,2562
"12654","WBGene00015446","V",5100098,5102117,2019
"12655","WBGene00015447","V",5103042,5105034,1992
"12656","WBGene00015448","V",5105764,5107916,2152
"12657","WBGene00015449","V",5108180,5110791,2611
"12658","WBGene00015450","V",5111518,5113754,2236
"12659","WBGene00015451","V",5114749,5119209,4460
"12660","WBGene00015453","II",5093214,5094263,1049
"12661","WBGene00015454","II",5081490,5083441,1951
"12662","WBGene00015455","II",5085785,5086121,336
"12663","WBGene00015456","II",5098770,5100242,1472
"12664","WBGene00015457","II",5100412,5101801,1389
"12665","WBGene00015458","II",5101984,5102647,663
"12666","WBGene00015459","II",5103341,5103834,493
"12667","WBGene00015460","V",7239771,7241366,1595
"12668","WBGene00015461","V",7231190,7232749,1559
"12669","WBGene00015462","V",7232434,7234826,2392
"12670","WBGene00015463","V",7234922,7237130,2208
"12671","WBGene00015464","V",7242907,7247321,4414
"12672","WBGene00015465","V",7252325,7255157,2832
"12673","WBGene00015466","V",7237381,7239658,2277
"12674","WBGene00015467","III",5614972,5617257,2285
"12675","WBGene00015468","III",5600393,5603656,3263
"12676","WBGene00015469","III",5607509,5610346,2837
"12677","WBGene00015470","III",5597947,5600058,2111
"12678","WBGene00015471","X",1125170,1128288,3118
"12679","WBGene00015472","X",1111903,1116794,4891
"12680","WBGene00015473","X",1107969,1110110,2141
"12681","WBGene00015474","X",1117192,1119405,2213
"12682","WBGene00015476","X",1122422,1124308,1886
"12683","WBGene00015477","III",6080563,6084748,4185
"12684","WBGene00015478","III",6067857,6072076,4219
"12685","WBGene00015479","III",6084665,6087755,3090
"12686","WBGene00015480","III",6088684,6102862,14178
"12687","WBGene00015481","III",6436608,6439959,3351
"12688","WBGene00015483","III",6410033,6412014,1981
"12689","WBGene00015484","III",6415774,6421885,6111
"12690","WBGene00015485","III",6422459,6427305,4846
"12691","WBGene00015486","III",6427529,6430934,3405
"12692","WBGene00015487","III",6431153,6431792,639
"12693","WBGene00015488","III",6443044,6444079,1035
"12694","WBGene00015489","V",742120,743273,1153
"12695","WBGene00015491","V",761626,761978,352
"12696","WBGene00015492","X",4588768,4590446,1678
"12697","WBGene00015493","X",4586917,4587993,1076
"12698","WBGene00015494","X",4578249,4581724,3475
"12699","WBGene00015495","X",4562163,4562880,717
"12700","WBGene00015496","X",4581586,4585679,4093
"12701","WBGene00015497","IV",627537,633954,6417
"12702","WBGene00015499","I",6011977,6022516,10539
"12703","WBGene00015500","I",6006264,6007295,1031
"12704","WBGene00015501","I",5986443,5990581,4138
"12705","WBGene00015504","I",5981778,5985869,4091
"12706","WBGene00015505","I",6008105,6009606,1501
"12707","WBGene00015507","IV",7846630,7854224,7594
"12708","WBGene00015508","IV",7830525,7832401,1876
"12709","WBGene00015509","IV",7826334,7829301,2967
"12710","WBGene00015510","IV",7832344,7834675,2331
"12711","WBGene00015511","IV",7837350,7838548,1198
"12712","WBGene00015512","II",7773880,7777827,3947
"12713","WBGene00015513","II",7779297,7781301,2004
"12714","WBGene00015514","II",7790560,7791375,815
"12715","WBGene00015515","II",7781566,7783354,1788
"12716","WBGene00015516","II",7772499,7773914,1415
"12717","WBGene00015517","II",7765545,7772017,6472
"12718","WBGene00015518","III",8605832,8606622,790
"12719","WBGene00015519","III",8581102,8583928,2826
"12720","WBGene00015520","III",8589336,8589488,152
"12721","WBGene00015521","III",8590833,8590982,149
"12722","WBGene00015522","III",8591239,8593720,2481
"12723","WBGene00015523","III",8595339,8597870,2531
"12724","WBGene00015524","III",8606504,8609783,3279
"12725","WBGene00015525","III",8609882,8614569,4687
"12726","WBGene00015526","III",8614762,8616381,1619
"12727","WBGene00015527","X",8872933,8874848,1915
"12728","WBGene00015528","X",8879649,8880406,757
"12729","WBGene00015529","X",8857056,8857954,898
"12730","WBGene00015530","IV",7283257,7283871,614
"12731","WBGene00015531","IV",7276961,7283086,6125
"12732","WBGene00015532","IV",7260875,7262132,1257
"12733","WBGene00015533","IV",7258653,7259622,969
"12734","WBGene00015534","IV",7254990,7255909,919
"12735","WBGene00015535","IV",7257217,7258248,1031
"12736","WBGene00015536","IV",7262237,7263237,1000
"12737","WBGene00015537","IV",7284219,7285873,1654
"12738","WBGene00015538","IV",5848657,5850845,2188
"12739","WBGene00015539","IV",5839387,5844004,4617
"12740","WBGene00015540","IV",5843890,5846398,2508
"12741","WBGene00015541","IV",5850826,5859976,9150
"12742","WBGene00015544","III",7002301,7005450,3149
"12743","WBGene00015545","X",16633363,16637633,4270
"12744","WBGene00015546","X",16621807,16622739,932
"12745","WBGene00015547","X",16613451,16617675,4224
"12746","WBGene00015549","IV",7036129,7036447,318
"12747","WBGene00015550","IV",7028173,7030967,2794
"12748","WBGene00015551","IV",7024211,7028144,3933
"12749","WBGene00015552","IV",7017626,7020210,2584
"12750","WBGene00015553","IV",7011960,7016542,4582
"12751","WBGene00015554","IV",7031298,7032559,1261
"12752","WBGene00015555","IV",7032716,7036982,4266
"12753","WBGene00015557","III",7987121,7990613,3492
"12754","WBGene00015558","III",7977216,7977803,587
"12755","WBGene00015559","III",7990789,7996438,5649
"12756","WBGene00015560","X",4544876,4545418,542
"12757","WBGene00015561","X",4517748,4521069,3321
"12758","WBGene00015562","X",7362082,7363663,1581
"12759","WBGene00015564","X",7344047,7344551,504
"12760","WBGene00015565","X",7341509,7342780,1271
"12761","WBGene00015566","II",7399012,7400540,1528
"12762","WBGene00015567","II",7394765,7397351,2586
"12763","WBGene00015568","II",7387162,7389142,1980
"12764","WBGene00015569","II",7381561,7383499,1938
"12765","WBGene00015570","I",420922,423713,2791
"12766","WBGene00015572","IV",8209158,8210400,1242
"12767","WBGene00015573","IV",8210954,8211828,874
"12768","WBGene00015574","V",3523587,3524575,988
"12769","WBGene00015575","V",3491361,3492598,1237
"12770","WBGene00015576","V",3498122,3501763,3641
"12771","WBGene00015577","V",3503130,3506352,3222
"12772","WBGene00015578","V",3502307,3503077,770
"12773","WBGene00015579","III",7521004,7521438,434
"12774","WBGene00015580","III",7508178,7515285,7107
"12775","WBGene00015581","III",7499677,7503241,3564
"12776","WBGene00015582","III",7498819,7499447,628
"12777","WBGene00015583","X",17087882,17093299,5417
"12778","WBGene00015586","X",17094288,17096537,2249
"12779","WBGene00015587","X",17099112,17100752,1640
"12780","WBGene00015588","X",17102843,17104871,2028
"12781","WBGene00015589","X",17106790,17108244,1454
"12782","WBGene00015590","III",7774778,7776039,1261
"12783","WBGene00015591","III",7793446,7795409,1963
"12784","WBGene00015592","V",8345759,8349909,4150
"12785","WBGene00015593","II",1633806,1634089,283
"12786","WBGene00015594","II",1611331,1612510,1179
"12787","WBGene00015595","II",1604666,1606143,1477
"12788","WBGene00015596","II",1606595,1607603,1008
"12789","WBGene00015597","II",1607869,1609014,1145
"12790","WBGene00015598","II",1609256,1610715,1459
"12791","WBGene00015599","II",1612788,1614059,1271
"12792","WBGene00015600","II",1614793,1616463,1670
"12793","WBGene00015601","II",1616912,1619004,2092
"12794","WBGene00015602","II",1619894,1621261,1367
"12795","WBGene00015603","II",1622651,1622847,196
"12796","WBGene00015604","II",1623907,1624672,765
"12797","WBGene00015605","II",1631995,1633850,1855
"12798","WBGene00015606","II",1797852,1801377,3525
"12799","WBGene00015607","II",1789181,1790217,1036
"12800","WBGene00015608","II",1772085,1778526,6441
"12801","WBGene00015609","II",1778772,1782409,3637
"12802","WBGene00015610","II",1787222,1788187,965
"12803","WBGene00015611","II",1807407,1808317,910
"12804","WBGene00015613","II",1785270,1786309,1039
"12805","WBGene00015614","II",734607,738666,4059
"12806","WBGene00015615","II",739598,740852,1254
"12807","WBGene00015616","II",741595,745128,3533
"12808","WBGene00015618","II",770553,772117,1564
"12809","WBGene00015619","IV",7658734,7664166,5432
"12810","WBGene00015620","IV",7664157,7672972,8815
"12811","WBGene00015621","X",2668127,2670590,2463
"12812","WBGene00015622","X",6006969,6010633,3664
"12813","WBGene00015623","X",6018442,6019936,1494
"12814","WBGene00015624","X",6020866,6022569,1703
"12815","WBGene00015625","X",6015492,6017584,2092
"12816","WBGene00015626","IV",5037815,5040495,2680
"12817","WBGene00015627","IV",5029250,5031046,1796
"12818","WBGene00015628","IV",5026523,5029078,2555
"12819","WBGene00015629","IV",5031596,5033395,1799
"12820","WBGene00015630","IV",5056973,5061012,4039
"12821","WBGene00015631","I",4071799,4073088,1289
"12822","WBGene00015632","I",5497679,5505447,7768
"12823","WBGene00015633","I",5491424,5493263,1839
"12824","WBGene00015634","I",5488309,5490626,2317
"12825","WBGene00015635","I",5479550,5484643,5093
"12826","WBGene00015636","I",5486487,5487150,663
"12827","WBGene00015637","III",6532560,6533819,1259
"12828","WBGene00015638","III",6534467,6536995,2528
"12829","WBGene00015639","III",6538101,6541312,3211
"12830","WBGene00015640","III",6541550,6546425,4875
"12831","WBGene00015641","III",6546723,6551242,4519
"12832","WBGene00015642","III",6553575,6558575,5000
"12833","WBGene00015644","II",556485,564215,7730
"12834","WBGene00015645","II",553086,554789,1703
"12835","WBGene00015646","II",546705,552031,5326
"12836","WBGene00015647","III",658709,662732,4023
"12837","WBGene00015648","III",646754,654463,7709
"12838","WBGene00015649","III",662847,666265,3418
"12839","WBGene00015650","IV",8520894,8538182,17288
"12840","WBGene00015651","IV",3498218,3503912,5694
"12841","WBGene00015652","IV",3493610,3495179,1569
"12842","WBGene00015653","IV",3491777,3493216,1439
"12843","WBGene00015654","IV",3487524,3489089,1565
"12844","WBGene00015655","IV",3479335,3479730,395
"12845","WBGene00015656","IV",3477392,3479011,1619
"12846","WBGene00015658","IV",3510046,3514572,4526
"12847","WBGene00015660","V",8076012,8079914,3902
"12848","WBGene00015661","V",8084120,8085241,1121
"12849","WBGene00015662","X",7415839,7418627,2788
"12850","WBGene00015663","X",7410235,7412749,2514
"12851","WBGene00015664","X",7407456,7408703,1247
"12852","WBGene00015665","X",7402131,7403609,1478
"12853","WBGene00015666","X",7393467,7395987,2520
"12854","WBGene00015667","X",7390574,7392276,1702
"12855","WBGene00015668","X",7413611,7415520,1909
"12856","WBGene00015670","V",8581261,8583576,2315
"12857","WBGene00015671","V",8583553,8584554,1001
"12858","WBGene00015672","X",16763153,16766656,3503
"12859","WBGene00015673","X",16745753,16748208,2455
"12860","WBGene00015674","X",16749755,16751110,1355
"12861","WBGene00015675","X",16751864,16753673,1809
"12862","WBGene00015676","X",16767422,16770498,3076
"12863","WBGene00015677","V",5996323,5999344,3021
"12864","WBGene00015678","V",5961813,5969175,7362
"12865","WBGene00015679","V",5985440,5986855,1415
"12866","WBGene00015680","IV",5820370,5830199,9829
"12867","WBGene00015681","V",5314404,5315589,1185
"12868","WBGene00015682","V",5312887,5314289,1402
"12869","WBGene00015683","V",5311935,5312349,414
"12870","WBGene00015684","V",5324806,5328470,3664
"12871","WBGene00015685","I",6307303,6308636,1333
"12872","WBGene00015686","I",6289433,6293855,4422
"12873","WBGene00015687","I",6284973,6289340,4367
"12874","WBGene00015688","I",6271866,6273780,1914
"12875","WBGene00015689","I",6274575,6275291,716
"12876","WBGene00015690","I",6304916,6306363,1447
"12877","WBGene00015691","I",4747490,4759601,12111
"12878","WBGene00015692","I",4731603,4735276,3673
"12879","WBGene00015693","I",4727280,4730366,3086
"12880","WBGene00015694","I",4724065,4726779,2714
"12881","WBGene00015695","I",4721131,4723960,2829
"12882","WBGene00015696","I",4719789,4721098,1309
"12883","WBGene00015697","I",4735471,4738100,2629
"12884","WBGene00015698","I",4759820,4761321,1501
"12885","WBGene00015700","IV",6185888,6189205,3317
"12886","WBGene00015701","IV",6152437,6154623,2186
"12887","WBGene00015702","IV",6155492,6156960,1468
"12888","WBGene00015703","IV",6154558,6155396,838
"12889","WBGene00015704","I",4409689,4426137,16448
"12890","WBGene00015705","V",7686350,7688228,1878
"12891","WBGene00015706","V",7676204,7676965,761
"12892","WBGene00015707","V",7672112,7673253,1141
"12893","WBGene00015708","V",7668240,7669000,760
"12894","WBGene00015709","V",7679314,7681615,2301
"12895","WBGene00015710","V",7688237,7689988,1751
"12896","WBGene00015711","V",7692071,7693488,1417
"12897","WBGene00015712","V",7681820,7683957,2137
"12898","WBGene00015713","X",3499253,3505251,5998
"12899","WBGene00015714","X",3489293,3491155,1862
"12900","WBGene00015715","X",3486309,3486838,529
"12901","WBGene00015716","X",3505286,3511529,6243
"12902","WBGene00015718","V",7289027,7291831,2804
"12903","WBGene00015719","V",7286185,7287800,1615
"12904","WBGene00015720","V",7282337,7284667,2330
"12905","WBGene00015721","V",7279310,7280530,1220
"12906","WBGene00015722","V",7275791,7278472,2681
"12907","WBGene00015723","V",7269731,7272787,3056
"12908","WBGene00015724","V",7266353,7268806,2453
"12909","WBGene00015725","V",7262565,7264148,1583
"12910","WBGene00015726","V",7273831,7275087,1256
"12911","WBGene00015727","V",7280948,7281591,643
"12912","WBGene00015728","II",1350720,1355641,4921
"12913","WBGene00015729","II",1357177,1358005,828
"12914","WBGene00015733","III",6620254,6622265,2011
"12915","WBGene00015734","III",6622676,6624972,2296
"12916","WBGene00015735","III",6632841,6652083,19242
"12917","WBGene00015736","V",4977934,4979160,1226
"12918","WBGene00015737","V",4979947,4980973,1026
"12919","WBGene00015738","V",4981809,4983191,1382
"12920","WBGene00015739","V",4997048,5000558,3510
"12921","WBGene00015740","X",8893129,8898517,5388
"12922","WBGene00015741","V",7224078,7225204,1126
"12923","WBGene00015742","V",7221473,7222156,683
"12924","WBGene00015743","V",7205626,7214903,9277
"12925","WBGene00015744","V",7215010,7219088,4078
"12926","WBGene00015745","V",7219054,7221039,1985
"12927","WBGene00015746","V",7222049,7223279,1230
"12928","WBGene00015747","III",8616781,8626917,10136
"12929","WBGene00015748","X",2803112,2804830,1718
"12930","WBGene00015750","X",2805075,2807528,2453
"12931","WBGene00015751","X",2810484,2814125,3641
"12932","WBGene00015752","III",8133665,8136649,2984
"12933","WBGene00015753","III",8108703,8111245,2542
"12934","WBGene00015754","III",8139610,8144629,5019
"12935","WBGene00015755","III",8130852,8132436,1584
"12936","WBGene00015756","V",563134,564446,1312
"12937","WBGene00015757","V",543469,545359,1890
"12938","WBGene00015758","V",539460,541485,2025
"12939","WBGene00015759","V",536628,537418,790
"12940","WBGene00015760","V",545844,548080,2236
"12941","WBGene00015761","V",548713,550619,1906
"12942","WBGene00015762","V",551279,553167,1888
"12943","WBGene00015763","V",570571,571205,634
"12944","WBGene00015764","V",572031,574739,2708
"12945","WBGene00015765","V",5663591,5665264,1673
"12946","WBGene00015766","V",5660928,5663473,2545
"12947","WBGene00015767","V",5654449,5658699,4250
"12948","WBGene00015768","V",5647564,5651040,3476
"12949","WBGene00015769","V",5665242,5666082,840
"12950","WBGene00015770","X",1826466,1827354,888
"12951","WBGene00015771","X",1806833,1807767,934
"12952","WBGene00015772","X",1810686,1811536,850
"12953","WBGene00015773","X",1818865,1821324,2459
"12954","WBGene00015774","X",1823616,1825340,1724
"12955","WBGene00015775","X",1827738,1828487,749
"12956","WBGene00015776","X",7954355,7956211,1856
"12957","WBGene00015777","X",7956196,7958303,2107
"12958","WBGene00015778","X",6240955,6242709,1754
"12959","WBGene00015779","X",6208761,6213911,5150
"12960","WBGene00015780","X",6230920,6233048,2128
"12961","WBGene00015781","X",6238021,6239115,1094
"12962","WBGene00015782","X",6208161,6208563,402
"12963","WBGene00015783","X",6476738,6479086,2348
"12964","WBGene00015784","X",6463412,6465861,2449
"12965","WBGene00015785","X",6467284,6467562,278
"12966","WBGene00015786","X",6470366,6473748,3382
"12967","WBGene00015787","X",6496823,6499836,3013
"12968","WBGene00015788","X",6474274,6476645,2371
"12969","WBGene00015789","X",3164525,3165650,1125
"12970","WBGene00015790","X",3145565,3147652,2087
"12971","WBGene00015791","X",3151148,3152461,1313
"12972","WBGene00015792","X",3167570,3170556,2986
"12973","WBGene00015793","X",3165796,3167579,1783
"12974","WBGene00015794","II",6989880,6991797,1917
"12975","WBGene00015795","II",6979953,6988629,8676
"12976","WBGene00015796","II",6967900,6970615,2715
"12977","WBGene00015797","II",6976031,6977790,1759
"12978","WBGene00015798","X",6118776,6120436,1660
"12979","WBGene00015799","X",6115804,6118051,2247
"12980","WBGene00015800","X",6101158,6105526,4368
"12981","WBGene00015801","X",6093286,6097574,4288
"12982","WBGene00015802","X",6106926,6109338,2412
"12983","WBGene00015803","X",6127457,6128326,869
"12984","WBGene00015805","X",6102881,6103432,551
"12985","WBGene00015806","III",6390946,6393843,2897
"12986","WBGene00015807","III",6389833,6390841,1008
"12987","WBGene00015809","III",6381634,6383024,1390
"12988","WBGene00015810","III",6380695,6381517,822
"12989","WBGene00015811","III",6379449,6380671,1222
"12990","WBGene00015813","III",6368042,6373904,5862
"12991","WBGene00015814","III",6394223,6396182,1959
"12992","WBGene00015815","II",4238159,4244830,6671
"12993","WBGene00015816","II",4229551,4230686,1135
"12994","WBGene00015817","II",4227046,4229157,2111
"12995","WBGene00015818","II",4223309,4226330,3021
"12996","WBGene00015819","II",4236504,4237751,1247
"12997","WBGene00015820","II",4255848,4256989,1141
"12998","WBGene00015821","II",4257092,4258781,1689
"12999","WBGene00015822","X",3961930,3966432,4502
"13000","WBGene00015823","X",3968036,3968637,601
"13001","WBGene00015824","X",3970389,3973634,3245
"13002","WBGene00015825","II",1894212,1894438,226
"13003","WBGene00015826","II",1890851,1891699,848
"13004","WBGene00015828","II",1869410,1870803,1393
"13005","WBGene00015829","II",1866386,1867894,1508
"13006","WBGene00015830","II",1862634,1863782,1148
"13007","WBGene00015832","II",1877579,1878763,1184
"13008","WBGene00015833","II",1879590,1880708,1118
"13009","WBGene00015834","II",1881611,1882805,1194
"13010","WBGene00015835","II",1883596,1884735,1139
"13011","WBGene00015836","II",1885439,1886479,1040
"13012","WBGene00015837","II",1887209,1889171,1962
"13013","WBGene00015838","II",1889909,1890782,873
"13014","WBGene00015839","II",1871548,1873261,1713
"13015","WBGene00015840","II",1873480,1875106,1626
"13016","WBGene00015841","II",3431286,3436512,5226
"13017","WBGene00015842","II",3443488,3444380,892
"13018","WBGene00015843","II",3444689,3445381,692
"13019","WBGene00015845","II",3459619,3460146,527
"13020","WBGene00015846","II",3461112,3461681,569
"13021","WBGene00015847","II",3462570,3463194,624
"13022","WBGene00015848","II",3464155,3464680,525
"13023","WBGene00015849","II",3453708,3454688,980
"13024","WBGene00015850","II",3452721,3453602,881
"13025","WBGene00015851","II",3451421,3452409,988
"13026","WBGene00015852","II",3449562,3450994,1432
"13027","WBGene00015853","II",3445760,3446719,959
"13028","WBGene00015854","II",3440827,3442445,1618
"13029","WBGene00015855","II",3429406,3431303,1897
"13030","WBGene00015856","II",3458501,3459023,522
"13031","WBGene00015857","V",8259316,8261315,1999
"13032","WBGene00015858","V",8238959,8240021,1062
"13033","WBGene00015859","V",8240928,8242898,1970
"13034","WBGene00015860","V",8243709,8245400,1691
"13035","WBGene00015861","V",8248123,8250289,2166
"13036","WBGene00015862","V",8256829,8258076,1247
"13037","WBGene00015863","V",8261390,8263566,2176
"13038","WBGene00015864","V",8264241,8264663,422
"13039","WBGene00015865","X",6940253,6943713,3460
"13040","WBGene00015866","X",6935732,6939041,3309
"13041","WBGene00015867","X",17617827,17619458,1631
"13042","WBGene00015868","X",17601607,17610048,8441
"13043","WBGene00015869","II",3852954,3854615,1661
"13044","WBGene00015871","II",3843609,3845509,1900
"13045","WBGene00015872","II",3839862,3841272,1410
"13046","WBGene00015873","II",3833250,3836015,2765
"13047","WBGene00015874","II",3837338,3838948,1610
"13048","WBGene00015875","II",3841914,3843405,1491
"13049","WBGene00015876","V",3348630,3349401,771
"13050","WBGene00015877","V",3342804,3343865,1061
"13051","WBGene00015878","V",3339348,3340092,744
"13052","WBGene00015879","V",3333635,3339070,5435
"13053","WBGene00015882","V",3320720,3324279,3559
"13054","WBGene00015883","V",3330915,3332113,1198
"13055","WBGene00015884","V",3340179,3342006,1827
"13056","WBGene00015885","V",3345307,3346484,1177
"13057","WBGene00015886","V",3353263,3353921,658
"13058","WBGene00015887","II",5570572,5574943,4371
"13059","WBGene00015889","II",5561763,5563523,1760
"13060","WBGene00015890","II",5551833,5552335,502
"13061","WBGene00015891","II",5550046,5550530,484
"13062","WBGene00015892","II",5531313,5532259,946
"13063","WBGene00015893","II",5537835,5539004,1169
"13064","WBGene00015894","II",5544781,5547490,2709
"13065","WBGene00015896","II",5571074,5571969,895
"13066","WBGene00015897","V",3906141,3908435,2294
"13067","WBGene00015898","V",3894961,3898208,3247
"13068","WBGene00015899","V",3892856,3894573,1717
"13069","WBGene00015900","V",3866556,3869005,2449
"13070","WBGene00015901","V",3871174,3873216,2042
"13071","WBGene00015902","V",3875245,3878382,3137
"13072","WBGene00015903","V",3889287,3890861,1574
"13073","WBGene00015904","V",3898800,3900202,1402
"13074","WBGene00015905","V",3890968,3892026,1058
"13075","WBGene00015906","V",3887750,3889286,1536
"13076","WBGene00015907","I",6669184,6669592,408
"13077","WBGene00015908","I",6682333,6683697,1364
"13078","WBGene00015909","II",3249723,3250836,1113
"13079","WBGene00015910","II",3248623,3249386,763
"13080","WBGene00015911","II",3240545,3241726,1181
"13081","WBGene00015912","II",3246316,3248174,1858
"13082","WBGene00015913","II",3245087,3246015,928
"13083","WBGene00015914","II",3230817,3234813,3996
"13084","WBGene00015915","II",5596547,5598449,1902
"13085","WBGene00015916","II",5594714,5596463,1749
"13086","WBGene00015917","II",5583036,5584752,1716
"13087","WBGene00015918","II",5599930,5603294,3364
"13088","WBGene00015919","II",5606542,5607856,1314
"13089","WBGene00015920","II",5619590,5622483,2893
"13090","WBGene00015921","X",8173910,8180865,6955
"13091","WBGene00015922","X",8169930,8172913,2983
"13092","WBGene00015924","X",8181031,8181640,609
"13093","WBGene00015925","X",8183008,8185133,2125
"13094","WBGene00015926","X",8185175,8203784,18609
"13095","WBGene00015927","IV",6779848,6784340,4492
"13096","WBGene00015928","IV",6786858,6789644,2786
"13097","WBGene00015929","IV",6793912,6795629,1717
"13098","WBGene00015930","IV",6798921,6802337,3416
"13099","WBGene00015931","IV",6815912,6817654,1742
"13100","WBGene00015932","IV",6821077,6822506,1429
"13101","WBGene00015933","IV",6818606,6820643,2037
"13102","WBGene00015934","IV",6812108,6815607,3499
"13103","WBGene00015935","IV",6806810,6809630,2820
"13104","WBGene00015936","IV",6804728,6805625,897
"13105","WBGene00015937","IV",6795913,6798789,2876
"13106","WBGene00015938","IV",6770810,6779859,9049
"13107","WBGene00015939","II",5720148,5721791,1643
"13108","WBGene00015940","II",5718129,5720052,1923
"13109","WBGene00015941","II",5716307,5718038,1731
"13110","WBGene00015942","II",5707691,5712351,4660
"13111","WBGene00015943","II",5712351,5714823,2472
"13112","WBGene00015944","II",5729597,5730443,846
"13113","WBGene00015945","II",5714924,5716250,1326
"13114","WBGene00015946","II",5715153,5715796,643
"13115","WBGene00015947","X",8069328,8070289,961
"13116","WBGene00015948","X",8067568,8068095,527
"13117","WBGene00015949","X",8061123,8065688,4565
"13118","WBGene00015950","X",8045552,8047416,1864
"13119","WBGene00015952","X",3628316,3630884,2568
"13120","WBGene00015953","X",3623522,3628359,4837
"13121","WBGene00015954","X",3601800,3604360,2560
"13122","WBGene00015955","X",3604291,3605741,1450
"13123","WBGene00015956","X",3606668,3611092,4424
"13124","WBGene00015957","X",3613353,3617318,3965
"13125","WBGene00015958","V",7493880,7495289,1409
"13126","WBGene00015959","V",7491875,7493024,1149
"13127","WBGene00015960","V",7489134,7490440,1306
"13128","WBGene00015961","V",7486131,7487618,1487
"13129","WBGene00015962","V",7483316,7485100,1784
"13130","WBGene00015963","V",7479217,7481049,1832
"13131","WBGene00015964","V",5558890,5564298,5408
"13132","WBGene00015965","V",5545669,5548073,2404
"13133","WBGene00015968","V",5550315,5567221,16906
"13134","WBGene00015969","V",5568209,5570533,2324
"13135","WBGene00015970","I",4212708,4214317,1609
"13136","WBGene00015971","I",4210979,4212667,1688
"13137","WBGene00015972","I",4203458,4208537,5079
"13138","WBGene00015973","I",4202417,4203040,623
"13139","WBGene00015974","I",4193241,4203303,10062
"13140","WBGene00015975","I",4190142,4193129,2987
"13141","WBGene00015976","I",4214294,4215768,1474
"13142","WBGene00015977","III",6273160,6276016,2856
"13143","WBGene00015978","III",6276048,6278351,2303
"13144","WBGene00015979","III",6271561,6272959,1398
"13145","WBGene00015980","V",4777960,4780019,2059
"13146","WBGene00015981","V",4770670,4773091,2421
"13147","WBGene00015982","V",4760974,4764179,3205
"13148","WBGene00015984","V",4750580,4753808,3228
"13149","WBGene00015985","V",4745569,4748089,2520
"13150","WBGene00015986","V",4764266,4766601,2335
"13151","WBGene00015987","V",4767886,4769753,1867
"13152","WBGene00015988","III",7662428,7672153,9725
"13153","WBGene00015989","III",7679293,7682292,2999
"13154","WBGene00015990","III",7684357,7688917,4560
"13155","WBGene00015991","III",7694554,7700381,5827
"13156","WBGene00015992","III",7689356,7694398,5042
"13157","WBGene00015993","IV",615544,620925,5381
"13158","WBGene00015994","IV",593329,595233,1904
"13159","WBGene00015996","IV",589030,592485,3455
"13160","WBGene00015997","IV",595722,596419,697
"13161","WBGene00015998","IV",599449,601695,2246
"13162","WBGene00015999","IV",602991,603643,652
"13163","WBGene00016000","II",6699084,6700482,1398
"13164","WBGene00016002","II",6684236,6692280,8044
"13165","WBGene00016003","II",6692748,6695566,2818
"13166","WBGene00016004","II",6700660,6701625,965
"13167","WBGene00016005","II",6680130,6682971,2841
"13168","WBGene00016006","X",9397701,9427246,29545
"13169","WBGene00016008","X",9391645,9394702,3057
"13170","WBGene00016009","X",9387341,9389189,1848
"13171","WBGene00016010","III",6209284,6212904,3620
"13172","WBGene00016011","III",6208064,6209140,1076
"13173","WBGene00016012","III",6191110,6192081,971
"13174","WBGene00016013","III",6192116,6194580,2464
"13175","WBGene00016014","III",6195984,6198414,2430
"13176","WBGene00016015","III",6202619,6206211,3592
"13177","WBGene00016016","III",6213112,6213923,811
"13178","WBGene00016017","III",6215164,6215576,412
"13179","WBGene00016018","II",61302,64340,3038
"13180","WBGene00016019","II",57670,60040,2370
"13181","WBGene00016020","II",51072,57576,6504
"13182","WBGene00016021","II",47580,50303,2723
"13183","WBGene00016022","II",71672,79266,7594
"13184","WBGene00016023","IV",2130965,2133025,2060
"13185","WBGene00016024","IV",2122797,2126038,3241
"13186","WBGene00016025","IV",2114626,2115625,999
"13187","WBGene00016027","IV",2111894,2113422,1528
"13188","WBGene00016028","III",725022,726155,1133
"13189","WBGene00016029","III",688739,715823,27084
"13190","WBGene00016030","III",692538,696456,3918
"13191","WBGene00016032","X",9001239,9006053,4814
"13192","WBGene00016033","X",8997479,8998909,1430
"13193","WBGene00016034","X",8992406,8994763,2357
"13194","WBGene00016037","X",4320863,4327331,6468
"13195","WBGene00016038","X",4333150,4336034,2884
"13196","WBGene00016039","X",4328400,4328916,516
"13197","WBGene00016040","I",5401757,5402896,1139
"13198","WBGene00016041","I",5380160,5383029,2869
"13199","WBGene00016042","I",5384639,5385737,1098
"13200","WBGene00016043","I",5396269,5396503,234
"13201","WBGene00016044","V",9191617,9195877,4260
"13202","WBGene00016045","V",9175798,9177997,2199
"13203","WBGene00016046","V",9195821,9197326,1505
"13204","WBGene00016047","V",2715274,2717002,1728
"13205","WBGene00016048","V",2706781,2711599,4818
"13206","WBGene00016049","V",2712034,2713632,1598
"13207","WBGene00016050","V",2717395,2719135,1740
"13208","WBGene00016051","V",2719696,2720863,1167
"13209","WBGene00016052","V",2730594,2731098,504
"13210","WBGene00016053","IV",5166330,5168427,2097
"13211","WBGene00016054","IV",5163293,5164351,1058
"13212","WBGene00016055","IV",5160522,5161388,866
"13213","WBGene00016056","IV",5150093,5151213,1120
"13214","WBGene00016057","IV",5159427,5160248,821
"13215","WBGene00016058","IV",5162743,5163074,331
"13216","WBGene00016059","V",5523727,5530733,7006
"13217","WBGene00016060","V",5514348,5520458,6110
"13218","WBGene00016061","V",5509934,5513830,3896
"13219","WBGene00016062","V",5534131,5535837,1706
"13220","WBGene00016063","I",4109407,4112385,2978
"13221","WBGene00016064","I",4103713,4108045,4332
"13222","WBGene00016066","I",4094179,4098330,4151
"13223","WBGene00016067","X",5072019,5074425,2406
"13224","WBGene00016068","X",5064602,5066663,2061
"13225","WBGene00016069","X",5061056,5062209,1153
"13226","WBGene00016070","X",5058367,5058733,366
"13227","WBGene00016071","II",441402,443674,2272
"13228","WBGene00016072","II",436867,438748,1881
"13229","WBGene00016073","II",411222,416620,5398
"13230","WBGene00016074","II",406141,410961,4820
"13231","WBGene00016075","II",417349,418882,1533
"13232","WBGene00016076","II",419178,420568,1390
"13233","WBGene00016077","II",422319,423142,823
"13234","WBGene00016078","II",423624,427019,3395
"13235","WBGene00016080","II",427603,429152,1549
"13236","WBGene00016081","V",5408528,5410071,1543
"13237","WBGene00016082","IV",7011135,7011248,113
"13238","WBGene00016083","IV",7009841,7010744,903
"13239","WBGene00016084","IV",7003623,7009268,5645
"13240","WBGene00016085","IV",6999557,7001493,1936
"13241","WBGene00016087","X",9114368,9116891,2523
"13242","WBGene00016088","X",6617393,6622915,5522
"13243","WBGene00016089","X",6631927,6635273,3346
"13244","WBGene00016090","X",6628041,6631537,3496
"13245","WBGene00016091","V",9045171,9046967,1796
"13246","WBGene00016092","V",9041330,9043677,2347
"13247","WBGene00016093","V",9036236,9040289,4053
"13248","WBGene00016094","V",9033567,9035605,2038
"13249","WBGene00016095","V",9030548,9032593,2045
"13250","WBGene00016096","V",9050102,9051191,1089
"13251","WBGene00016097","V",9053322,9053995,673
"13252","WBGene00016099","V",9055326,9056392,1066
"13253","WBGene00016100","V",9057543,9058332,789
"13254","WBGene00016101","V",9060494,9062441,1947
"13255","WBGene00016102","X",5486487,5488102,1615
"13256","WBGene00016103","X",5467870,5472684,4814
"13257","WBGene00016104","X",5461256,5466310,5054
"13258","WBGene00016105","X",5450008,5450823,815
"13259","WBGene00016106","X",5445163,5448085,2922
"13260","WBGene00016107","X",1270898,1272561,1663
"13261","WBGene00016108","X",1233093,1238903,5810
"13262","WBGene00016109","X",1247833,1249838,2005
"13263","WBGene00016110","X",1251998,1255629,3631
"13264","WBGene00016111","II",5700170,5701408,1238
"13265","WBGene00016112","II",5694195,5695237,1042
"13266","WBGene00016113","II",5691662,5693939,2277
"13267","WBGene00016114","II",5680980,5682667,1687
"13268","WBGene00016115","II",5661167,5665243,4076
"13269","WBGene00016116","II",5666756,5668930,2174
"13270","WBGene00016118","II",5690137,5691355,1218
"13271","WBGene00016119","II",5696585,5698969,2384
"13272","WBGene00016120","II",5669788,5689030,19242
"13273","WBGene00016121","II",5659937,5660786,849
"13274","WBGene00016123","II",5695383,5696358,975
"13275","WBGene00016124","IV",8018130,8019808,1678
"13276","WBGene00016125","IV",8021146,8022122,976
"13277","WBGene00016126","IV",8045045,8047363,2318
"13278","WBGene00016128","IV",8016994,8018221,1227
"13279","WBGene00016129","IV",8016153,8016882,729
"13280","WBGene00016130","IV",8014149,8015722,1573
"13281","WBGene00016131","X",5344520,5348411,3891
"13282","WBGene00016132","X",5340189,5342202,2013
"13283","WBGene00016133","X",5338273,5340182,1909
"13284","WBGene00016134","X",5329455,5332339,2884
"13285","WBGene00016135","X",5332969,5335468,2499
"13286","WBGene00016136","X",5342307,5342841,534
"13287","WBGene00016137","III",4956891,4957539,648
"13288","WBGene00016138","III",4952124,4955171,3047
"13289","WBGene00016139","III",4944513,4947317,2804
"13290","WBGene00016140","III",4939567,4944404,4837
"13291","WBGene00016142","III",4935578,4937223,1645
"13292","WBGene00016143","III",4932450,4934945,2495
"13293","WBGene00016144","III",4920442,4921747,1305
"13294","WBGene00016145","III",4930602,4932253,1651
"13295","WBGene00016146","V",7785417,7787712,2295
"13296","WBGene00016147","V",7781811,7784595,2784
"13297","WBGene00016148","V",7777300,7778985,1685
"13298","WBGene00016149","V",7771328,7773273,1945
"13299","WBGene00016150","V",7760474,7761633,1159
"13300","WBGene00016151","II",5062129,5067116,4987
"13301","WBGene00016152","II",5058849,5060762,1913
"13302","WBGene00016153","II",5068648,5069625,977
"13303","WBGene00016154","I",6041672,6046018,4346
"13304","WBGene00016155","I",6035452,6037745,2293
"13305","WBGene00016156","I",6053785,6055821,2036
"13306","WBGene00016157","I",6055947,6058424,2477
"13307","WBGene00016158","I",6058546,6061033,2487
"13308","WBGene00016159","I",6061752,6068040,6288
"13309","WBGene00016160","II",5172751,5177440,4689
"13310","WBGene00016161","II",5173710,5174470,760
"13311","WBGene00016162","II",5179034,5187569,8535
"13312","WBGene00016163","II",4753413,4755595,2182
"13313","WBGene00016164","II",4755589,4756851,1262
"13314","WBGene00016165","III",4987209,4991450,4241
"13315","WBGene00016166","III",4958329,4960305,1976
"13316","WBGene00016167","III",4960390,4961715,1325
"13317","WBGene00016168","III",4979796,4980418,622
"13318","WBGene00016169","III",4980644,4984474,3830
"13319","WBGene00016170","III",4991439,4998161,6722
"13320","WBGene00016171","III",4985019,4986931,1912
"13321","WBGene00016172","II",7155581,7160950,5369
"13322","WBGene00016173","II",7152566,7155474,2908
"13323","WBGene00016174","II",7162444,7165841,3397
"13324","WBGene00016175","II",7185277,7187210,1933
"13325","WBGene00016177","IV",8501479,8502983,1504
"13326","WBGene00016178","IV",8499310,8500076,766
"13327","WBGene00016179","IV",8490221,8490857,636
"13328","WBGene00016180","IV",8487497,8488481,984
"13329","WBGene00016181","IV",8474056,8475278,1222
"13330","WBGene00016182","IV",8494550,8496363,1813
"13331","WBGene00016183","II",7505351,7506595,1244
"13332","WBGene00016184","II",7507319,7519231,11912
"13333","WBGene00016185","II",7519860,7523368,3508
"13334","WBGene00016187","X",8836644,8837661,1017
"13335","WBGene00016188","X",8831739,8835715,3976
"13336","WBGene00016189","X",8849137,8853621,4484
"13337","WBGene00016190","X",8826627,8828540,1913
"13338","WBGene00016191","X",8829920,8831262,1342
"13339","WBGene00016192","III",5926086,5926987,901
"13340","WBGene00016193","III",5923187,5924431,1244
"13341","WBGene00016194","III",5908700,5914734,6034
"13342","WBGene00016195","III",5907044,5908457,1413
"13343","WBGene00016196","III",5884307,5885848,1541
"13344","WBGene00016197","III",5889721,5896013,6292
"13345","WBGene00016198","III",5885847,5886956,1109
"13346","WBGene00016199","III",5887104,5888775,1671
"13347","WBGene00016200","III",5903576,5906122,2546
"13348","WBGene00016201","III",5917628,5920086,2458
"13349","WBGene00016202","III",7941717,7945593,3876
"13350","WBGene00016203","III",7917987,7924917,6930
"13351","WBGene00016204","III",7945544,7947018,1474
"13352","WBGene00016206","III",7955828,7956712,884
"13353","WBGene00016207","III",7937827,7940931,3104
"13354","WBGene00016209","III",7941057,7941614,557
"13355","WBGene00016210","II",6303424,6306283,2859
"13356","WBGene00016211","II",6299502,6301398,1896
"13357","WBGene00016212","II",6290652,6292524,1872
"13358","WBGene00016213","II",6298085,6298675,590
"13359","WBGene00016215","II",6308114,6309298,1184
"13360","WBGene00016216","III",132418,134401,1983
"13361","WBGene00016217","III",130947,131751,804
"13362","WBGene00016218","III",124778,126527,1749
"13363","WBGene00016219","III",120492,124641,4149
"13364","WBGene00016220","III",117556,118767,1211
"13365","WBGene00016221","III",114903,116619,1716
"13366","WBGene00016222","III",95394,97726,2332
"13367","WBGene00016224","III",106824,107899,1075
"13368","WBGene00016225","III",109322,110185,863
"13369","WBGene00016226","III",121735,122020,285
"13370","WBGene00016227","III",130180,130750,570
"13371","WBGene00016230","V",2590393,2591758,1365
"13372","WBGene00016231","V",2580898,2582939,2041
"13373","WBGene00016232","V",2577903,2579816,1913
"13374","WBGene00016233","V",2574181,2575410,1229
"13375","WBGene00016234","V",2582867,2585908,3041
"13376","WBGene00016235","II",6123809,6125438,1629
"13377","WBGene00016236","II",6110452,6113194,2742
"13378","WBGene00016237","II",6114423,6118263,3840
"13379","WBGene00016238","III",8225097,8226386,1289
"13380","WBGene00016239","III",8222226,8223792,1566
"13381","WBGene00016242","III",8205124,8209945,4821
"13382","WBGene00016244","II",6197180,6198308,1128
"13383","WBGene00016245","II",6195813,6196959,1146
"13384","WBGene00016246","II",6203292,6208218,4926
"13385","WBGene00016247","II",6219526,6222658,3132
"13386","WBGene00016248","II",6224892,6227095,2203
"13387","WBGene00016249","III",8449757,8450519,762
"13388","WBGene00016250","III",8443917,8446920,3003
"13389","WBGene00016251","X",16926964,16928023,1059
"13390","WBGene00016252","X",16925954,16926821,867
"13391","WBGene00016253","X",16923936,16925917,1981
"13392","WBGene00016254","X",16921853,16922861,1008
"13393","WBGene00016255","X",16913906,16916800,2894
"13394","WBGene00016257","X",16916812,16919319,2507
"13395","WBGene00016258","I",5079911,5082279,2368
"13396","WBGene00016259","I",5096601,5100579,3978
"13397","WBGene00016260","I",6954414,6961139,6725
"13398","WBGene00016261","I",6967670,6970190,2520
"13399","WBGene00016262","I",6970367,6971879,1512
"13400","WBGene00016263","I",6972157,6973789,1632
"13401","WBGene00016264","I",6991951,6999706,7755
"13402","WBGene00016265","I",6989067,6992106,3039
"13403","WBGene00016266","I",6974558,6977100,2542
"13404","WBGene00016268","X",17044115,17045497,1382
"13405","WBGene00016269","X",17056925,17072188,15263
"13406","WBGene00016271","X",17073810,17080685,6875
"13407","WBGene00016273","II",7299514,7301632,2118
"13408","WBGene00016274","II",7290373,7291882,1509
"13409","WBGene00016276","II",7262154,7263654,1500
"13410","WBGene00016277","II",7292192,7296015,3823
"13411","WBGene00016278","I",5416649,5420731,4082
"13412","WBGene00016279","V",2931552,2932988,1436
"13413","WBGene00016280","V",2916523,2918034,1511
"13414","WBGene00016281","V",2896637,2898434,1797
"13415","WBGene00016282","V",2900448,2903355,2907
"13416","WBGene00016283","V",2905767,2909698,3931
"13417","WBGene00016284","V",2911082,2913001,1919
"13418","WBGene00016285","V",2925193,2927722,2529
"13419","WBGene00016286","IV",5797453,5800233,2780
"13420","WBGene00016287","IV",5791296,5793457,2161
"13421","WBGene00016288","IV",5794932,5796825,1893
"13422","WBGene00016289","IV",5800336,5807093,6757
"13423","WBGene00016291","IV",5811583,5814142,2559
"13424","WBGene00016292","X",5138991,5146742,7751
"13425","WBGene00016293","X",5151547,5154399,2852
"13426","WBGene00016294","X",5155093,5159667,4574
"13427","WBGene00016295","II",986003,988666,2663
"13428","WBGene00016296","II",981282,982435,1153
"13429","WBGene00016297","II",979423,980825,1402
"13430","WBGene00016298","II",974290,975511,1221
"13431","WBGene00016299","II",968406,970523,2117
"13432","WBGene00016300","II",960528,964260,3732
"13433","WBGene00016301","II",956674,957961,1287
"13434","WBGene00016302","II",954953,956337,1384
"13435","WBGene00016303","II",946485,948191,1706
"13436","WBGene00016304","II",948432,950507,2075
"13437","WBGene00016305","II",950842,952843,2001
"13438","WBGene00016306","II",961352,962121,769
"13439","WBGene00016307","II",965576,967062,1486
"13440","WBGene00016308","II",970645,972950,2305
"13441","WBGene00016309","II",958918,960179,1261
"13442","WBGene00016310","II",6344122,6345519,1397
"13443","WBGene00016311","II",6318087,6321159,3072
"13444","WBGene00016312","II",6321340,6323079,1739
"13445","WBGene00016313","II",6329850,6331341,1491
"13446","WBGene00016314","II",6331899,6333987,2088
"13447","WBGene00016315","II",6336345,6339557,3212
"13448","WBGene00016316","II",6343058,6345925,2867
"13449","WBGene00016317","II",6349207,6351987,2780
"13450","WBGene00016318","II",6352542,6355911,3369
"13451","WBGene00016319","II",6356416,6359005,2589
"13452","WBGene00016320","I",3796153,3796696,543
"13453","WBGene00016321","I",3786588,3787494,906
"13454","WBGene00016322","I",3783835,3784435,600
"13455","WBGene00016323","I",3782118,3783294,1176
"13456","WBGene00016324","I",3774706,3777468,2762
"13457","WBGene00016325","I",3794556,3798069,3513
"13458","WBGene00016326","I",3807458,3816809,9351
"13459","WBGene00016327","I",5232576,5235222,2646
"13460","WBGene00016328","I",5196078,5200102,4024
"13461","WBGene00016329","I",5200258,5203504,3246
"13462","WBGene00016330","I",5230549,5242607,12058
"13463","WBGene00016331","I",5829072,5834640,5568
"13464","WBGene00016332","I",5808421,5810002,1581
"13465","WBGene00016333","I",5822841,5826148,3307
"13466","WBGene00016334","II",2197846,2198675,829
"13467","WBGene00016335","II",2176741,2181990,5249
"13468","WBGene00016336","II",2165440,2166498,1058
"13469","WBGene00016337","II",2167756,2168759,1003
"13470","WBGene00016338","II",2170325,2173219,2894
"13471","WBGene00016339","II",2174586,2175289,703
"13472","WBGene00016340","II",2182503,2186434,3931
"13473","WBGene00016341","II",2187149,2189457,2308
"13474","WBGene00016342","II",2192339,2194114,1775
"13475","WBGene00016343","X",3036427,3045806,9379
"13476","WBGene00016344","X",3055257,3059385,4128
"13477","WBGene00016345","X",17305325,17306164,839
"13478","WBGene00016346","X",17302719,17303994,1275
"13479","WBGene00016347","X",17272934,17280038,7104
"13480","WBGene00016349","X",17293094,17294828,1734
"13481","WBGene00016350","X",17301374,17301923,549
"13482","WBGene00016351","II",4835023,4835717,694
"13483","WBGene00016352","II",4828560,4832469,3909
"13484","WBGene00016353","II",4795761,4797216,1455
"13485","WBGene00016354","II",4798154,4812136,13982
"13486","WBGene00016355","II",4818662,4821564,2902
"13487","WBGene00016356","II",4823381,4825196,1815
"13488","WBGene00016357","II",4834145,4834834,689
"13489","WBGene00016358","II",4836304,4837759,1455
"13490","WBGene00016359","II",4826507,4827884,1377
"13491","WBGene00016360","V",7009761,7012244,2483
"13492","WBGene00016361","V",7007612,7008299,687
"13493","WBGene00016362","V",7006264,7006818,554
"13494","WBGene00016363","V",7004150,7005825,1675
"13495","WBGene00016364","V",6980595,6982913,2318
"13496","WBGene00016365","V",6986141,6987773,1632
"13497","WBGene00016366","V",6987864,6989676,1812
"13498","WBGene00016367","V",6990148,6991863,1715
"13499","WBGene00016368","V",6983411,6986043,2632
"13500","WBGene00016369","V",7014462,7015972,1510
"13501","WBGene00016370","IV",7808912,7810681,1769
"13502","WBGene00016371","IV",7805040,7807948,2908
"13503","WBGene00016373","IV",7776025,7778022,1997
"13504","WBGene00016374","IV",7774411,7775956,1545
"13505","WBGene00016375","IV",7777939,7778965,1026
"13506","WBGene00016376","IV",7779379,7782499,3120
"13507","WBGene00016378","IV",7786000,7789613,3613
"13508","WBGene00016379","IV",7791704,7792263,559
"13509","WBGene00016380","IV",7792349,7794809,2460
"13510","WBGene00016381","IV",7794871,7796376,1505
"13511","WBGene00016382","IV",7801916,7803350,1434
"13512","WBGene00016383","IV",7811157,7812809,1652
"13513","WBGene00016384","IV",7812770,7815733,2963
"13514","WBGene00016386","I",10688332,10690790,2458
"13515","WBGene00016387","I",10687363,10688068,705
"13516","WBGene00016388","I",10672737,10674864,2127
"13517","WBGene00016389","I",10671460,10672589,1129
"13518","WBGene00016390","I",10675167,10676811,1644
"13519","WBGene00016391","I",10676922,10682374,5452
"13520","WBGene00016392","I",10683270,10685664,2394
"13521","WBGene00016393","I",10685825,10687058,1233
"13522","WBGene00016394","I",10699562,10703801,4239
"13523","WBGene00016395","I",10682472,10683155,683
"13524","WBGene00016396","I",10691345,10696783,5438
"13525","WBGene00016397","IV",7156900,7160109,3209
"13526","WBGene00016398","IV",7154656,7156010,1354
"13527","WBGene00016399","IV",7153623,7154193,570
"13528","WBGene00016400","IV",7149361,7150692,1331
"13529","WBGene00016402","IV",7119918,7121413,1495
"13530","WBGene00016403","IV",7130701,7131928,1227
"13531","WBGene00016404","IV",7133448,7134083,635
"13532","WBGene00016405","IV",7134347,7144898,10551
"13533","WBGene00016406","X",8029479,8031614,2135
"13534","WBGene00016407","X",8014983,8026858,11875
"13535","WBGene00016408","III",5230555,5234530,3975
"13536","WBGene00016409","III",5249075,5254187,5112
"13537","WBGene00016410","III",5262714,5263399,685
"13538","WBGene00016411","III",5226818,5227884,1066
"13539","WBGene00016412","III",5234617,5236364,1747
"13540","WBGene00016413","II",5212932,5213932,1000
"13541","WBGene00016414","II",5212270,5212789,519
"13542","WBGene00016415","II",5203322,5209799,6477
"13543","WBGene00016416","II",5195804,5199257,3453
"13544","WBGene00016417","II",5209780,5210978,1198
"13545","WBGene00016418","I",5906662,5918229,11567
"13546","WBGene00016419","I",5898303,5902112,3809
"13547","WBGene00016420","I",5896618,5897405,787
"13548","WBGene00016421","I",5872174,5874343,2169
"13549","WBGene00016422","I",5874422,5878954,4532
"13550","WBGene00016423","X",6142546,6150545,7999
"13551","WBGene00016424","IV",1555579,1557560,1981
"13552","WBGene00016425","IV",1553752,1555567,1815
"13553","WBGene00016427","IV",1545296,1566192,20896
"13554","WBGene00016428","V",5405358,5408386,3028
"13555","WBGene00016429","V",5386110,5389409,3299
"13556","WBGene00016430","V",5372418,5375354,2936
"13557","WBGene00016431","V",5389480,5393148,3668
"13558","WBGene00016432","IV",4086212,4102907,16695
"13559","WBGene00016433","IV",4081136,4081348,212
"13560","WBGene00016434","IV",4079804,4080207,403
"13561","WBGene00016435","IV",4083603,4084209,606
"13562","WBGene00016436","IV",4109067,4110471,1404
"13563","WBGene00016437","IV",4077671,4078953,1282
"13564","WBGene00016438","X",9213953,9216856,2903
"13565","WBGene00016439","III",4879745,4881497,1752
"13566","WBGene00016440","III",4870762,4872046,1284
"13567","WBGene00016441","III",4868921,4870106,1185
"13568","WBGene00016442","III",4862351,4863426,1075
"13569","WBGene00016443","III",4859339,4860772,1433
"13570","WBGene00016444","III",4856193,4859240,3047
"13571","WBGene00016445","III",4855250,4856101,851
"13572","WBGene00016446","III",4860669,4861794,1125
"13573","WBGene00016447","III",4868333,4868769,436
"13574","WBGene00016448","III",4872501,4874751,2250
"13575","WBGene00016449","III",4877526,4878311,785
"13576","WBGene00016450","III",4881909,4883606,1697
"13577","WBGene00016451","III",4885697,4887442,1745
"13578","WBGene00016452","III",4867062,4867469,407
"13579","WBGene00016453","I",10846777,10850103,3326
"13580","WBGene00016454","I",10841114,10844647,3533
"13581","WBGene00016455","I",10836985,10838877,1892
"13582","WBGene00016456","I",10831881,10834812,2931
"13583","WBGene00016457","I",10823363,10828454,5091
"13584","WBGene00016458","I",10817352,10819963,2611
"13585","WBGene00016459","I",10813815,10814904,1089
"13586","WBGene00016460","I",10808590,10810497,1907
"13587","WBGene00016461","I",10806922,10808238,1316
"13588","WBGene00016462","I",10810648,10812923,2275
"13589","WBGene00016463","I",10844772,10845922,1150
"13590","WBGene00016464","X",7112889,7114863,1974
"13591","WBGene00016465","X",7106407,7108436,2029
"13592","WBGene00016466","X",7101777,7102136,359
"13593","WBGene00016467","X",7083417,7086008,2591
"13594","WBGene00016468","X",7089228,7096449,7221
"13595","WBGene00016469","X",7097434,7100338,2904
"13596","WBGene00016470","V",3179527,3181064,1537
"13597","WBGene00016471","V",3176461,3177978,1517
"13598","WBGene00016472","V",3170138,3171408,1270
"13599","WBGene00016473","V",3166560,3167268,708
"13600","WBGene00016474","V",3157077,3157870,793
"13601","WBGene00016475","V",3139931,3141290,1359
"13602","WBGene00016476","V",3143094,3144597,1503
"13603","WBGene00016477","V",3145203,3147032,1829
"13604","WBGene00016478","V",3148215,3149489,1274
"13605","WBGene00016479","V",3150488,3151962,1474
"13606","WBGene00016480","V",3153485,3155172,1687
"13607","WBGene00016481","V",3158406,3159165,759
"13608","WBGene00016483","V",3164675,3165515,840
"13609","WBGene00016484","V",3167968,3168750,782
"13610","WBGene00016485","X",1682954,1686419,3465
"13611","WBGene00016486","X",1676205,1678121,1916
"13612","WBGene00016487","X",1693883,1696979,3096
"13613","WBGene00016488","X",1699788,1703938,4150
"13614","WBGene00016489","X",17434445,17438080,3635
"13615","WBGene00016490","X",17452392,17455861,3469
"13616","WBGene00016491","I",6784854,6787139,2285
"13617","WBGene00016492","I",6788032,6789002,970
"13618","WBGene00016493","I",6789039,6789738,699
"13619","WBGene00016494","I",6798232,6799674,1442
"13620","WBGene00016495","V",7857963,7859909,1946
"13621","WBGene00016496","V",7855954,7857925,1971
"13622","WBGene00016497","V",7849984,7851031,1047
"13623","WBGene00016499","V",7835369,7837070,1701
"13624","WBGene00016500","V",7844343,7847164,2821
"13625","WBGene00016501","V",7852286,7853975,1689
"13626","WBGene00016502","V",7862275,7863070,795
"13627","WBGene00016503","V",7863458,7864731,1273
"13628","WBGene00016504","V",7838588,7839585,997
"13629","WBGene00016505","V",7836935,7837935,1000
"13630","WBGene00016506","V",4847653,4849838,2185
"13631","WBGene00016507","V",4844685,4846984,2299
"13632","WBGene00016508","V",4827360,4836025,8665
"13633","WBGene00016509","V",4818701,4823344,4643
"13634","WBGene00016511","V",4857149,4862965,5816
"13635","WBGene00016512","V",1495634,1497985,2351
"13636","WBGene00016513","V",1482042,1484015,1973
"13637","WBGene00016514","V",1484828,1491604,6776
"13638","WBGene00016516","V",1501420,1505310,3890
"13639","WBGene00016517","V",1510024,1511630,1606
"13640","WBGene00016518","X",5559021,5561330,2309
"13641","WBGene00016519","III",2240771,2243843,3072
"13642","WBGene00016520","III",2233888,2236987,3099
"13643","WBGene00016521","III",2227707,2229228,1521
"13644","WBGene00016522","III",2224672,2227198,2526
"13645","WBGene00016523","III",2208257,2211242,2985
"13646","WBGene00016524","III",2198006,2206882,8876
"13647","WBGene00016525","III",2219797,2222365,2568
"13648","WBGene00016526","III",2217173,2219494,2321
"13649","WBGene00016527","III",2229992,2232460,2468
"13650","WBGene00016528","III",2238967,2240172,1205
"13651","WBGene00016530","X",7889215,7889765,550
"13652","WBGene00016531","X",7884288,7887479,3191
"13653","WBGene00016532","X",7890410,7892396,1986
"13654","WBGene00016533","X",7896221,7897773,1552
"13655","WBGene00016534","X",7907955,7913930,5975
"13656","WBGene00016535","X",7879771,7880948,1177
"13657","WBGene00016537","X",4754678,4755160,482
"13658","WBGene00016538","V",1260465,1262616,2151
"13659","WBGene00016539","V",1223901,1235445,11544
"13660","WBGene00016540","V",1264773,1270160,5387
"13661","WBGene00016541","IV",5631895,5633379,1484
"13662","WBGene00016542","IV",5611950,5614608,2658
"13663","WBGene00016543","IV",5624855,5627156,2301
"13664","WBGene00016544","II",2154008,2155220,1212
"13665","WBGene00016545","II",2146950,2148775,1825
"13666","WBGene00016546","II",2141118,2142957,1839
"13667","WBGene00016547","II",2137422,2138951,1529
"13668","WBGene00016548","II",2133666,2135704,2038
"13669","WBGene00016549","II",2144292,2145666,1374
"13670","WBGene00016550","II",2148732,2150363,1631
"13671","WBGene00016551","II",2150552,2151290,738
"13672","WBGene00016553","II",2136822,2136909,87
"13673","WBGene00016554","II",1998861,1999621,760
"13674","WBGene00016555","II",1996537,1998531,1994
"13675","WBGene00016556","II",1994047,1995701,1654
"13676","WBGene00016557","II",1999743,2000820,1077
"13677","WBGene00016558","X",5413810,5441958,28148
"13678","WBGene00016559","X",5406562,5414350,7788
"13679","WBGene00016561","I",4457383,4469458,12075
"13680","WBGene00016562","I",4428467,4444342,15875
"13681","WBGene00016564","I",4449879,4450927,1048
"13682","WBGene00016565","I",4460146,4462704,2558
"13683","WBGene00016566","I",4451200,4456805,5605
"13684","WBGene00016567","I",4448576,4449774,1198
"13685","WBGene00016568","X",5717538,5720268,2730
"13686","WBGene00016570","X",5738761,5743307,4546
"13687","WBGene00016571","II",3016068,3017471,1403
"13688","WBGene00016572","II",3014835,3015961,1126
"13689","WBGene00016573","II",3005799,3007506,1707
"13690","WBGene00016574","II",3003969,3005573,1604
"13691","WBGene00016575","II",3002513,3003827,1314
"13692","WBGene00016576","II",3000768,3002411,1643
"13693","WBGene00016577","II",3017482,3019907,2425
"13694","WBGene00016578","II",3008700,3009889,1189
"13695","WBGene00016579","IV",12259797,12261449,1652
"13696","WBGene00016580","IV",12265526,12268306,2780
"13697","WBGene00016581","IV",12269594,12270492,898
"13698","WBGene00016582","IV",12270490,12275992,5502
"13699","WBGene00016583","IV",12276083,12278059,1976
"13700","WBGene00016585","IV",12293234,12301280,8046
"13701","WBGene00016586","IV",12291046,12293317,2271
"13702","WBGene00016587","IV",12289449,12290994,1545
"13703","WBGene00016588","IV",12283174,12285122,1948
"13704","WBGene00016589","IV",12279659,12281917,2258
"13705","WBGene00016590","IV",12281672,12282207,535
"13706","WBGene00016591","IV",12278729,12279546,817
"13707","WBGene00016592","IV",12287928,12289392,1464
"13708","WBGene00016594","IV",7189191,7190331,1140
"13709","WBGene00016595","IV",7180535,7182993,2458
"13710","WBGene00016596","IV",7179239,7180484,1245
"13711","WBGene00016597","IV",7183412,7184697,1285
"13712","WBGene00016598","IV",7187189,7188130,941
"13713","WBGene00016599","X",5109504,5112452,2948
"13714","WBGene00016600","X",5079773,5084489,4716
"13715","WBGene00016601","I",4270697,4273332,2635
"13716","WBGene00016602","I",4265109,4267238,2129
"13717","WBGene00016603","I",4254380,4264699,10319
"13718","WBGene00016605","I",4236954,4238617,1663
"13719","WBGene00016606","I",4242821,4247582,4761
"13720","WBGene00016607","I",4267199,4267967,768
"13721","WBGene00016608","I",4249482,4253170,3688
"13722","WBGene00016609","I",4253242,4254139,897
"13723","WBGene00016610","IV",6552479,6555920,3441
"13724","WBGene00016611","IV",6565384,6572338,6954
"13725","WBGene00016612","IV",6578197,6579402,1205
"13726","WBGene00016613","IV",6560736,6565261,4525
"13727","WBGene00016614","X",2409570,2412966,3396
"13728","WBGene00016616","X",2407467,2409567,2100
"13729","WBGene00016617","X",2404024,2407364,3340
"13730","WBGene00016619","X",2395505,2398826,3321
"13731","WBGene00016620","X",2398812,2402057,3245
"13732","WBGene00016621","I",10624464,10625387,923
"13733","WBGene00016622","I",10622952,10624361,1409
"13734","WBGene00016623","II",6902095,6902937,842
"13735","WBGene00016624","II",6898736,6901792,3056
"13736","WBGene00016625","II",6860582,6863752,3170
"13737","WBGene00016626","II",6868946,6871039,2093
"13738","WBGene00016627","II",6871376,6872593,1217
"13739","WBGene00016628","II",6872829,6877089,4260
"13740","WBGene00016629","II",6879185,6880180,995
"13741","WBGene00016630","II",6888553,6890418,1865
"13742","WBGene00016631","II",6894179,6897540,3361
"13743","WBGene00016632","II",6891709,6893639,1930
"13744","WBGene00016633","III",3155268,3158393,3125
"13745","WBGene00016634","III",3142198,3143757,1559
"13746","WBGene00016635","III",3152722,3153471,749
"13747","WBGene00016636","IV",1126790,1128848,2058
"13748","WBGene00016637","IV",1104773,1105086,313
"13749","WBGene00016638","IV",1121457,1125107,3650
"13750","WBGene00016639","IV",1128964,1136947,7983
"13751","WBGene00016641","X",980776,983030,2254
"13752","WBGene00016642","X",957881,960568,2687
"13753","WBGene00016643","X",970583,974816,4233
"13754","WBGene00016644","X",975525,978445,2920
"13755","WBGene00016645","X",969074,970270,1196
"13756","WBGene00016650","I",4610147,4633377,23230
"13757","WBGene00016652","I",4637432,4640882,3450
"13758","WBGene00016653","I",4634103,4635620,1517
"13759","WBGene00016654","I",4605655,4610202,4547
"13760","WBGene00016655","I",4635722,4637328,1606
"13761","WBGene00016657","X",7596927,7599824,2897
"13762","WBGene00016658","X",6086124,6086567,443
"13763","WBGene00016659","X",6084739,6085189,450
"13764","WBGene00016660","X",6082960,6083333,373
"13765","WBGene00016661","X",6053058,6057177,4119
"13766","WBGene00016662","X",6087985,6088391,406
"13767","WBGene00016663","I",3115036,3117628,2592
"13768","WBGene00016664","IV",5744336,5747110,2774
"13769","WBGene00016665","IV",5741345,5742980,1635
"13770","WBGene00016666","IV",5739577,5740841,1264
"13771","WBGene00016667","IV",5735019,5737106,2087
"13772","WBGene00016668","IV",2470414,2471449,1035
"13773","WBGene00016669","IV",2467681,2468810,1129
"13774","WBGene00016670","IV",2464456,2465401,945
"13775","WBGene00016671","IV",2432993,2436472,3479
"13776","WBGene00016673","III",5074698,5075968,1270
"13777","WBGene00016674","III",5069001,5070418,1417
"13778","WBGene00016675","III",5062706,5063862,1156
"13779","WBGene00016676","III",5048117,5050158,2041
"13780","WBGene00016677","III",5036381,5040413,4032
"13781","WBGene00016678","III",5046170,5047161,991
"13782","WBGene00016679","III",5052529,5053341,812
"13783","WBGene00016680","III",5054603,5055857,1254
"13784","WBGene00016681","III",5056847,5061888,5041
"13785","WBGene00016682","III",5063993,5068725,4732
"13786","WBGene00016683","III",5070431,5071597,1166
"13787","WBGene00016684","III",5042412,5044672,2260
"13788","WBGene00016685","V",2182038,2183191,1153
"13789","WBGene00016686","V",2179586,2181759,2173
"13790","WBGene00016687","V",2177714,2179116,1402
"13791","WBGene00016688","V",2169306,2170668,1362
"13792","WBGene00016689","V",2155532,2156635,1103
"13793","WBGene00016690","V",2157130,2158274,1144
"13794","WBGene00016691","V",2153574,2155112,1538
"13795","WBGene00016692","V",2151762,2153010,1248
"13796","WBGene00016693","V",2147095,2148626,1531
"13797","WBGene00016694","V",2150091,2150976,885
"13798","WBGene00016695","V",2158674,2159427,753
"13799","WBGene00016696","V",2164826,2166779,1953
"13800","WBGene00016697","V",2183521,2186535,3014
"13801","WBGene00016698","IV",7763931,7767094,3163
"13802","WBGene00016699","IV",7760417,7762856,2439
"13803","WBGene00016700","IV",7748157,7757358,9201
"13804","WBGene00016701","IV",7757513,7759627,2114
"13805","WBGene00016702","IV",7760000,7763848,3848
"13806","WBGene00016703","IV",7768395,7770025,1630
"13807","WBGene00016704","X",4637242,4643695,6453
"13808","WBGene00016705","X",4632348,4635784,3436
"13809","WBGene00016706","X",4629039,4631838,2799
"13810","WBGene00016707","II",3724225,3725909,1684
"13811","WBGene00016708","II",3723378,3723896,518
"13812","WBGene00016709","II",3721316,3723084,1768
"13813","WBGene00016710","II",3717138,3719768,2630
"13814","WBGene00016711","II",3711293,3713048,1755
"13815","WBGene00016712","II",3725906,3728134,2228
"13816","WBGene00016713","II",3727690,3729835,2145
"13817","WBGene00016714","X",8078063,8080256,2193
"13818","WBGene00016716","X",5937506,5944510,7004
"13819","WBGene00016717","II",1905429,1907775,2346
"13820","WBGene00016718","II",1902281,1904446,2165
"13821","WBGene00016719","II",1900238,1901921,1683
"13822","WBGene00016720","II",1896062,1897758,1696
"13823","WBGene00016721","IV",6018003,6019713,1710
"13824","WBGene00016722","IV",6015195,6017803,2608
"13825","WBGene00016724","X",1209411,1210683,1272
"13826","WBGene00016725","X",1211760,1230758,18998
"13827","WBGene00016727","I",5055686,5056039,353
"13828","WBGene00016728","I",5050040,5052523,2483
"13829","WBGene00016729","I",5041492,5042055,563
"13830","WBGene00016730","I",5020748,5023210,2462
"13831","WBGene00016731","I",5042102,5043453,1351
"13832","WBGene00016732","I",5044201,5045720,1519
"13833","WBGene00016733","I",5046394,5048018,1624
"13834","WBGene00016734","I",5052529,5054960,2431
"13835","WBGene00016735","I",5058251,5068829,10578
"13836","WBGene00016736","X",7754046,7754284,238
"13837","WBGene00016737","X",7756701,7758154,1453
"13838","WBGene00016738","X",8215050,8215668,618
"13839","WBGene00016739","IV",7393221,7397555,4334
"13840","WBGene00016740","I",6916766,6917560,794
"13841","WBGene00016741","I",6915049,6916609,1560
"13842","WBGene00016742","I",6889254,6891501,2247
"13843","WBGene00016743","I",6897755,6900619,2864
"13844","WBGene00016744","I",6917750,6922955,5205
"13845","WBGene00016745","I",6924288,6925463,1175
"13846","WBGene00016746","I",6923076,6923688,612
"13847","WBGene00016747","X",8980976,8985063,4087
"13848","WBGene00016748","X",8957616,8961170,3554
"13849","WBGene00016749","I",6260249,6264540,4291
"13850","WBGene00016750","I",6255035,6257791,2756
"13851","WBGene00016751","I",6236134,6249762,13628
"13852","WBGene00016752","I",6234708,6235391,683
"13853","WBGene00016753","I",6265691,6269073,3382
"13854","WBGene00016754","I",6252986,6253584,598
"13855","WBGene00016755","IV",6228203,6230025,1822
"13856","WBGene00016756","IV",6225443,6228046,2603
"13857","WBGene00016757","IV",6222089,6225009,2920
"13858","WBGene00016758","IV",6219604,6222346,2742
"13859","WBGene00016759","IV",6213822,6216371,2549
"13860","WBGene00016760","IV",6210936,6213181,2245
"13861","WBGene00016761","IV",6202080,6205703,3623
"13862","WBGene00016762","IV",6206843,6209527,2684
"13863","WBGene00016763","IV",6217349,6219449,2100
"13864","WBGene00016764","IV",6205793,6206344,551
"13865","WBGene00016765","IV",8654604,8656829,2225
"13866","WBGene00016766","IV",8651090,8651840,750
"13867","WBGene00016767","IV",8644732,8645345,613
"13868","WBGene00016768","IV",8645521,8648429,2908
"13869","WBGene00016769","IV",8648596,8653677,5081
"13870","WBGene00016770","IV",8657455,8658184,729
"13871","WBGene00016772","II",3880245,3882182,1937
"13872","WBGene00016773","II",3869901,3873010,3109
"13873","WBGene00016776","II",3858142,3860926,2784
"13874","WBGene00016777","II",3863084,3864752,1668
"13875","WBGene00016778","II",3873541,3877227,3686
"13876","WBGene00016779","II",3877249,3877974,725
"13877","WBGene00016781","V",4046405,4047433,1028
"13878","WBGene00016782","V",4043916,4044951,1035
"13879","WBGene00016783","V",4042404,4043599,1195
"13880","WBGene00016785","V",4034476,4035957,1481
"13881","WBGene00016786","V",4031619,4033446,1827
"13882","WBGene00016788","V",4040409,4042004,1595
"13883","WBGene00016789","V",4054191,4055109,918
"13884","WBGene00016790","IV",7924350,7924968,618
"13885","WBGene00016791","IV",7915291,7916711,1420
"13886","WBGene00016792","IV",7903740,7907083,3343
"13887","WBGene00016793","IV",7900200,7902271,2071
"13888","WBGene00016794","IV",7907093,7909474,2381
"13889","WBGene00016795","IV",7926748,7927315,567
"13890","WBGene00016796","IV",1170672,1177776,7104
"13891","WBGene00016797","IV",1145681,1158028,12347
"13892","WBGene00016798","IV",1159637,1160484,847
"13893","WBGene00016799","III",8191817,8193847,2030
"13894","WBGene00016800","III",8181881,8189372,7491
"13895","WBGene00016801","III",8179224,8180549,1325
"13896","WBGene00016803","III",8161449,8163383,1934
"13897","WBGene00016804","III",8176484,8177243,759
"13898","WBGene00016805","II",111621,114454,2833
"13899","WBGene00016806","II",109165,111429,2264
"13900","WBGene00016807","II",106189,107521,1332
"13901","WBGene00016808","II",98404,98961,557
"13902","WBGene00016809","II",84434,87823,3389
"13903","WBGene00016810","II",92169,95277,3108
"13904","WBGene00016811","II",96127,98027,1900
"13905","WBGene00016812","II",88221,91519,3298
"13906","WBGene00016813","V",7610370,7611905,1535
"13907","WBGene00016815","V",7605158,7607211,2053
"13908","WBGene00016816","V",7587996,7594740,6744
"13909","WBGene00016817","V",7588530,7590554,2024
"13910","WBGene00016818","V",7594753,7598369,3616
"13911","WBGene00016820","V",7598994,7600249,1255
"13912","WBGene00016821","V",7600609,7601543,934
"13913","WBGene00016822","V",7602213,7603486,1273
"13914","WBGene00016823","V",7620504,7622061,1557
"13915","WBGene00016824","V",7622335,7624252,1917
"13916","WBGene00016825","II",12301077,12302429,1352
"13917","WBGene00016826","II",12305543,12309714,4171
"13918","WBGene00016827","II",12321193,12323405,2212
"13919","WBGene00016828","II",12335730,12338093,2363
"13920","WBGene00016829","II",12332924,12335044,2120
"13921","WBGene00016830","II",12329294,12331122,1828
"13922","WBGene00016831","II",12325544,12327514,1970
"13923","WBGene00016832","II",12318841,12321070,2229
"13924","WBGene00016833","II",12311860,12313660,1800
"13925","WBGene00016834","II",12303525,12305132,1607
"13926","WBGene00016835","I",3892332,3895271,2939
"13927","WBGene00016836","I",3881816,3888313,6497
"13928","WBGene00016837","I",3877063,3880747,3684
"13929","WBGene00016838","I",3888331,3891598,3267
"13930","WBGene00016839","I",3895764,3897478,1714
"13931","WBGene00016840","I",3900407,3901437,1030
"13932","WBGene00016841","I",3901432,3905208,3776
"13933","WBGene00016842","IV",7743906,7746074,2168
"13934","WBGene00016843","IV",7732329,7734210,1881
"13935","WBGene00016844","IV",7728913,7730645,1732
"13936","WBGene00016845","IV",7726718,7727951,1233
"13937","WBGene00016846","IV",7720566,7723199,2633
"13938","WBGene00016847","IV",7730669,7732060,1391
"13939","WBGene00016848","IV",7745979,7748225,2246
"13940","WBGene00016849","V",3089074,3091351,2277
"13941","WBGene00016850","V",3086560,3087986,1426
"13942","WBGene00016851","V",3083645,3085127,1482
"13943","WBGene00016852","V",3081771,3083027,1256
"13944","WBGene00016853","V",3078072,3079300,1228
"13945","WBGene00016854","V",3075407,3077173,1766
"13946","WBGene00016855","V",3054554,3055667,1113
"13947","WBGene00016856","V",3059640,3062178,2538
"13948","WBGene00016857","V",3063160,3064518,1358
"13949","WBGene00016858","V",3069898,3071648,1750
"13950","WBGene00016859","V",3079449,3080892,1443
"13951","WBGene00016860","V",3091815,3094501,2686
"13952","WBGene00016861","V",3097130,3098688,1558
"13953","WBGene00016862","V",5230475,5233891,3416
"13954","WBGene00016863","V",5234796,5237169,2373
"13955","WBGene00016864","V",5237417,5239440,2023
"13956","WBGene00016865","X",4280980,4284176,3196
"13957","WBGene00016866","X",4265851,4270486,4635
"13958","WBGene00016867","X",4260652,4264591,3939
"13959","WBGene00016868","X",4307851,4311766,3915
"13960","WBGene00016869","X",4273914,4274750,836
"13961","WBGene00016870","X",4284189,4284901,712
"13962","WBGene00016871","X",1300149,1309504,9355
"13963","WBGene00016872","X",1295278,1298823,3545
"13964","WBGene00016873","X",1285209,1285863,654
"13965","WBGene00016874","X",1272788,1275416,2628
"13966","WBGene00016877","IV",17176477,17189805,13328
"13967","WBGene00016879","IV",17197905,17206845,8940
"13968","WBGene00016880","II",1854394,1855360,966
"13969","WBGene00016881","II",1852803,1853092,289
"13970","WBGene00016882","II",1851244,1852657,1413
"13971","WBGene00016883","II",1843165,1846234,3069
"13972","WBGene00016884","II",1840975,1842942,1967
"13973","WBGene00016885","II",1846990,1848154,1164
"13974","WBGene00016886","II",1849430,1850403,973
"13975","WBGene00016888","II",7025802,7030152,4350
"13976","WBGene00016889","II",7012787,7022509,9722
"13977","WBGene00016890","II",7022913,7024930,2017
"13978","WBGene00016891","V",5758792,5760232,1440
"13979","WBGene00016892","V",5762494,5763846,1352
"13980","WBGene00016893","X",6846233,6847547,1314
"13981","WBGene00016894","X",6844755,6845976,1221
"13982","WBGene00016895","X",6868632,6868769,137
"13983","WBGene00016896","X",6860946,6863414,2468
"13984","WBGene00016898","X",7686646,7689219,2573
"13985","WBGene00016899","X",17339907,17342220,2313
"13986","WBGene00016900","X",17337279,17338632,1353
"13987","WBGene00016901","X",17310908,17311213,305
"13988","WBGene00016902","I",291215,305468,14253
"13989","WBGene00016903","I",280120,286115,5995
"13990","WBGene00016904","I",280120,280445,325
"13991","WBGene00016905","I",286088,289185,3097
"13992","WBGene00016906","I",305811,311130,5319
"13993","WBGene00016907","I",1832897,1834764,1867
"13994","WBGene00016909","II",5251121,5255529,4408
"13995","WBGene00016910","II",5261009,5261322,313
"13996","WBGene00016911","II",5270406,5271845,1439
"13997","WBGene00016912","X",7139875,7140566,691
"13998","WBGene00016913","X",7143918,7151235,7317
"13999","WBGene00016914","X",7153889,7156035,2146
"14000","WBGene00016915","X",7842632,7845438,2806
"14001","WBGene00016916","X",7838899,7839381,482
"14002","WBGene00016917","IV",2175606,2177579,1973
"14003","WBGene00016918","IV",2136895,2146461,9566
"14004","WBGene00016919","IV",2161252,2168626,7374
"14005","WBGene00016920","IV",2146672,2149297,2625
"14006","WBGene00016921","V",7533247,7535074,1827
"14007","WBGene00016922","V",7530140,7531463,1323
"14008","WBGene00016923","V",7529116,7529450,334
"14009","WBGene00016924","V",7523692,7524092,400
"14010","WBGene00016925","V",7515245,7517307,2062
"14011","WBGene00016926","V",7511765,7513684,1919
"14012","WBGene00016927","V",7508994,7510602,1608
"14013","WBGene00016928","V",7517685,7520177,2492
"14014","WBGene00016929","V",7536919,7537909,990
"14015","WBGene00016930","I",1011371,1014455,3084
"14016","WBGene00016931","I",1006177,1010765,4588
"14017","WBGene00016932","I",996045,1005066,9021
"14018","WBGene00016933","X",5543951,5545529,1578
"14019","WBGene00016934","X",5519876,5522819,2943
"14020","WBGene00016935","X",5545684,5552756,7072
"14021","WBGene00016937","X",5760281,5763392,3111
"14022","WBGene00016938","X",5766482,5770793,4311
"14023","WBGene00016939","X",7200364,7204044,3680
"14024","WBGene00016940","X",7187355,7188482,1127
"14025","WBGene00016941","X",7204742,7205295,553
"14026","WBGene00016942","I",6499537,6501410,1873
"14027","WBGene00016943","I",6497436,6499560,2124
"14028","WBGene00016944","I",6494216,6496109,1893
"14029","WBGene00016945","I",6482451,6485857,3406
"14030","WBGene00016946","I",6502167,6503920,1753
"14031","WBGene00016947","I",6511612,6513843,2231
"14032","WBGene00016948","I",2568872,2570746,1874
"14033","WBGene00016949","I",2560396,2561820,1424
"14034","WBGene00016950","I",2558300,2560110,1810
"14035","WBGene00016951","IV",5709096,5714336,5240
"14036","WBGene00016953","IV",5685287,5688273,2986
"14037","WBGene00016954","IV",5676212,5678144,1932
"14038","WBGene00016955","IV",5695777,5703468,7691
"14039","WBGene00016956","IV",5683184,5684672,1488
"14040","WBGene00016957","IV",7882028,7900247,18219
"14041","WBGene00016958","IV",7895629,7897543,1914
"14042","WBGene00016959","V",6850649,6852485,1836
"14043","WBGene00016960","II",6601216,6603449,2233
"14044","WBGene00016961","II",6589290,6591081,1791
"14045","WBGene00016962","II",6583039,6584514,1475
"14046","WBGene00016963","II",6579702,6581336,1634
"14047","WBGene00016964","II",6584409,6587569,3160
"14048","WBGene00016965","II",6591048,6592351,1303
"14049","WBGene00016966","II",6592440,6594251,1811
"14050","WBGene00016967","II",6598349,6601119,2770
"14051","WBGene00016968","II",6603441,6609356,5915
"14052","WBGene00016970","II",6503360,6526333,22973
"14053","WBGene00016971","II",6517188,6519845,2657
"14054","WBGene00016972","II",6526372,6528801,2429
"14055","WBGene00016973","II",6528933,6531610,2677
"14056","WBGene00016974","II",6540217,6544896,4679
"14057","WBGene00016975","X",6655547,6659966,4419
"14058","WBGene00016976","X",6645654,6651753,6099
"14059","WBGene00016977","III",6346285,6366660,20375
"14060","WBGene00016978","III",6346285,6348121,1836
"14061","WBGene00016979","III",6331732,6335829,4097
"14062","WBGene00016980","III",6321176,6324239,3063
"14063","WBGene00016981","III",6340115,6341925,1810
"14064","WBGene00016982","III",6342481,6343287,806
"14065","WBGene00016983","III",6366582,6367899,1317
"14066","WBGene00016984","X",7377302,7388400,11098
"14067","WBGene00016985","X",7365567,7366298,731
"14068","WBGene00016987","IV",3645166,3648684,3518
"14069","WBGene00016988","V",5606555,5609368,2813
"14070","WBGene00016989","V",5593706,5594499,793
"14071","WBGene00016990","V",5592685,5593612,927
"14072","WBGene00016992","V",5595653,5596551,898
"14073","WBGene00016993","V",5599145,5601329,2184
"14074","WBGene00016995","X",1479542,1484398,4856
"14075","WBGene00016996","X",1459047,1462793,3746
"14076","WBGene00016997","X",1452695,1454000,1305
"14077","WBGene00016998","X",1484853,1485818,965
"14078","WBGene00016999","X",1470998,1472919,1921
"14079","WBGene00017000","X",1463110,1464799,1689
"14080","WBGene00017001","I",4575782,4577204,1422
"14081","WBGene00017002","I",4579964,4580601,637
"14082","WBGene00017003","I",4580692,4583810,3118
"14083","WBGene00017004","I",4597914,4602666,4752
"14084","WBGene00017005","I",4604175,4605385,1210
"14085","WBGene00017006","I",4590430,4591587,1157
"14086","WBGene00017007","I",4586273,4589463,3190
"14087","WBGene00017009","I",4566495,4568385,1890
"14088","WBGene00017010","I",4557653,4563757,6104
"14089","WBGene00017011","I",4603217,4604196,979
"14090","WBGene00017012","X",8931241,8939263,8022
"14091","WBGene00017013","X",8908050,8910837,2787
"14092","WBGene00017014","X",8939389,8940143,754
"14093","WBGene00017015","V",8143905,8145650,1745
"14094","WBGene00017016","V",8130388,8133329,2941
"14095","WBGene00017017","V",8133432,8134985,1553
"14096","WBGene00017018","V",8123684,8126710,3026
"14097","WBGene00017019","V",8121168,8123470,2302
"14098","WBGene00017020","V",8118264,8120351,2087
"14099","WBGene00017021","II",7459531,7460076,545
"14100","WBGene00017022","II",7455192,7456284,1092
"14101","WBGene00017023","II",7456242,7457380,1138
"14102","WBGene00017024","II",7457667,7458806,1139
"14103","WBGene00017025","I",3684783,3690192,5409
"14104","WBGene00017026","I",3690181,3694021,3840
"14105","WBGene00017027","III",5544304,5546287,1983
"14106","WBGene00017028","III",5526071,5535481,9410
"14107","WBGene00017029","III",5521719,5522030,311
"14108","WBGene00017030","III",5524181,5524439,258
"14109","WBGene00017031","III",5535660,5543218,7558
"14110","WBGene00017032","III",5507050,5508738,1688
"14111","WBGene00017033","III",5512927,5517523,4596
"14112","WBGene00017034","V",4073755,4077548,3793
"14113","WBGene00017035","V",4056165,4062184,6019
"14114","WBGene00017036","II",340539,341803,1264
"14115","WBGene00017037","II",341982,347891,5909
"14116","WBGene00017038","II",348266,357024,8758
"14117","WBGene00017039","X",8941139,8950978,9839
"14118","WBGene00017040","X",4403159,4409133,5974
"14119","WBGene00017041","III",8155470,8155989,519
"14120","WBGene00017042","III",8148967,8154619,5652
"14121","WBGene00017044","III",8145015,8145974,959
"14122","WBGene00017045","III",8155928,8158245,2317
"14123","WBGene00017046","X",8557151,8563235,6084
"14124","WBGene00017048","X",8546451,8549056,2605
"14125","WBGene00017050","IV",7247543,7249437,1894
"14126","WBGene00017051","IV",7244208,7245502,1294
"14127","WBGene00017052","IV",7231235,7232822,1587
"14128","WBGene00017053","IV",7227274,7228306,1032
"14129","WBGene00017054","IV",7240445,7242270,1825
"14130","WBGene00017055","II",2631473,2633054,1581
"14131","WBGene00017056","II",2623402,2624530,1128
"14132","WBGene00017057","II",2622780,2623767,987
"14133","WBGene00017058","II",2619419,2619789,370
"14134","WBGene00017059","II",2616905,2617374,469
"14135","WBGene00017060","V",4327121,4328736,1615
"14136","WBGene00017061","V",4329039,4332550,3511
"14137","WBGene00017062","V",4338854,4341308,2454
"14138","WBGene00017063","I",6629717,6637429,7712
"14139","WBGene00017064","I",6625066,6626788,1722
"14140","WBGene00017065","I",6612188,6615990,3802
"14141","WBGene00017066","I",6598981,6607520,8539
"14142","WBGene00017068","I",6620665,6621292,627
"14143","WBGene00017069","IV",8396493,8397950,1457
"14144","WBGene00017070","IV",8379984,8381925,1941
"14145","WBGene00017071","IV",8366539,8375371,8832
"14146","WBGene00017072","IV",8359165,8359716,551
"14147","WBGene00017073","IV",8368344,8369235,891
"14148","WBGene00017074","IV",8375720,8377698,1978
"14149","WBGene00017075","IV",8377703,8379319,1616
"14150","WBGene00017076","IV",8381922,8382814,892
"14151","WBGene00017077","IV",8387626,8389239,1613
"14152","WBGene00017078","IV",8389147,8392863,3716
"14153","WBGene00017079","IV",8363463,8366376,2913
"14154","WBGene00017080","V",204382,209758,5376
"14155","WBGene00017082","V",210148,212787,2639
"14156","WBGene00017083","V",228858,234672,5814
"14157","WBGene00017084","I",4139514,4142367,2853
"14158","WBGene00017085","I",4132500,4135239,2739
"14159","WBGene00017087","I",4135239,4137074,1835
"14160","WBGene00017088","I",4137134,4140634,3500
"14161","WBGene00017089","I",4142282,4144583,2301
"14162","WBGene00017090","I",4147273,4148278,1005
"14163","WBGene00017091","V",9354512,9355471,959
"14164","WBGene00017092","V",9369549,9371086,1537
"14165","WBGene00017093","V",9371620,9373613,1993
"14166","WBGene00017094","V",9373954,9375478,1524
"14167","WBGene00017095","V",9376812,9378404,1592
"14168","WBGene00017096","V",9379435,9379908,473
"14169","WBGene00017097","V",9380068,9382336,2268
"14170","WBGene00017098","I",6800386,6804860,4474
"14171","WBGene00017099","III",2468486,2469443,957
"14172","WBGene00017100","III",2465474,2466800,1326
"14173","WBGene00017101","III",2461911,2465079,3168
"14174","WBGene00017102","III",2456180,2457764,1584
"14175","WBGene00017103","III",2446223,2448696,2473
"14176","WBGene00017104","III",2436105,2442328,6223
"14177","WBGene00017105","III",2445228,2446142,914
"14178","WBGene00017106","III",2467347,2468302,955
"14179","WBGene00017107","V",4240952,4242531,1579
"14180","WBGene00017108","X",5714279,5717601,3322
"14181","WBGene00017110","IV",4984046,4985375,1329
"14182","WBGene00017111","IV",4982596,4983892,1296
"14183","WBGene00017112","IV",4977201,4978084,883
"14184","WBGene00017113","IV",4979789,4981127,1338
"14185","WBGene00017114","IV",4987702,4988642,940
"14186","WBGene00017115","IV",4990255,4991433,1178
"14187","WBGene00017116","IV",4737558,4738734,1176
"14188","WBGene00017117","IV",4734305,4735876,1571
"14189","WBGene00017118","IV",4730636,4732750,2114
"14190","WBGene00017119","IV",4744377,4745492,1115
"14191","WBGene00017120","IV",4745825,4747832,2007
"14192","WBGene00017121","IV",4747901,4749113,1212
"14193","WBGene00017122","II",7200611,7201880,1269
"14194","WBGene00017123","II",7196276,7197495,1219
"14195","WBGene00017124","II",7189420,7192507,3087
"14196","WBGene00017125","II",7192436,7194815,2379
"14197","WBGene00017126","II",7197415,7199565,2150
"14198","WBGene00017127","II",7210731,7211380,649
"14199","WBGene00017128","II",7211625,7212159,534
"14200","WBGene00017129","II",7214055,7216957,2902
"14201","WBGene00017130","II",7217076,7217478,402
"14202","WBGene00017131","II",7208773,7210287,1514
"14203","WBGene00017132","II",5421248,5422737,1489
"14204","WBGene00017133","II",5416714,5418377,1663
"14205","WBGene00017134","II",5414207,5415580,1373
"14206","WBGene00017135","II",5410467,5411235,768
"14207","WBGene00017136","II",5384137,5387317,3180
"14208","WBGene00017137","II",5393293,5395694,2401
"14209","WBGene00017138","II",5395889,5398902,3013
"14210","WBGene00017139","II",5405819,5407634,1815
"14211","WBGene00017140","II",5408260,5409024,764
"14212","WBGene00017141","II",5411542,5412174,632
"14213","WBGene00017142","II",5412722,5414052,1330
"14214","WBGene00017143","II",5419233,5421093,1860
"14215","WBGene00017144","II",5390233,5393190,2957
"14216","WBGene00017146","III",5935749,5937220,1471
"14217","WBGene00017147","II",5231424,5233273,1849
"14218","WBGene00017148","II",5230081,5230501,420
"14219","WBGene00017149","X",8726798,8727406,608
"14220","WBGene00017150","X",5163055,5163439,384
"14221","WBGene00017151","V",6578185,6580182,1997
"14222","WBGene00017152","V",8876035,8878804,2769
"14223","WBGene00017153","III",1028339,1030896,2557
"14224","WBGene00017154","X",6991727,6994162,2435
"14225","WBGene00017156","X",6967369,6974864,7495
"14226","WBGene00017157","X",6996873,7005575,8702
"14227","WBGene00017158","III",5879489,5882428,2939
"14228","WBGene00017159","III",5878521,5879415,894
"14229","WBGene00017160","III",5873025,5874680,1655
"14230","WBGene00017161","III",5864500,5866541,2041
"14231","WBGene00017162","III",5848838,5853269,4431
"14232","WBGene00017163","III",5861855,5863708,1853
"14233","WBGene00017164","III",5866495,5868501,2006
"14234","WBGene00017165","III",5869685,5872396,2711
"14235","WBGene00017166","III",5874672,5876625,1953
"14236","WBGene00017168","III",5882319,5882923,604
"14237","WBGene00017169","III",5868587,5869620,1033
"14238","WBGene00017170","X",16395076,16396949,1873
"14239","WBGene00017172","V",3138703,3139090,387
"14240","WBGene00017173","V",3133705,3137382,3677
"14241","WBGene00017174","V",3129125,3133406,4281
"14242","WBGene00017175","V",3137431,3138588,1157
"14243","WBGene00017176","X",4466518,4469005,2487
"14244","WBGene00017177","X",4454120,4457304,3184
"14245","WBGene00017178","X",4459603,4462609,3006
"14246","WBGene00017179","II",3278987,3281686,2699
"14247","WBGene00017180","II",3262829,3264382,1553
"14248","WBGene00017181","II",3272349,3275023,2674
"14249","WBGene00017182","II",3276256,3277305,1049
"14250","WBGene00017183","II",3283667,3284657,990
"14251","WBGene00017184","X",692978,703036,10058
"14252","WBGene00017189","V",8846203,8846835,632
"14253","WBGene00017190","V",8854993,8862049,7056
"14254","WBGene00017192","V",8866653,8867297,644
"14255","WBGene00017193","V",9226094,9227523,1429
"14256","WBGene00017194","V",9227710,9232396,4686
"14257","WBGene00017195","V",9234610,9243221,8611
"14258","WBGene00017197","V",9254219,9254632,413
"14259","WBGene00017198","V",9258181,9261124,2943
"14260","WBGene00017199","V",7638105,7638622,517
"14261","WBGene00017200","V",7626850,7627780,930
"14262","WBGene00017201","V",7624952,7626453,1501
"14263","WBGene00017202","V",7637277,7637792,515
"14264","WBGene00017203","V",7638944,7639869,925
"14265","WBGene00017204","V",7642558,7643516,958
"14266","WBGene00017205","V",7647836,7649817,1981
"14267","WBGene00017207","II",2064462,2065870,1408
"14268","WBGene00017208","II",2051669,2052745,1076
"14269","WBGene00017209","II",2050023,2051679,1656
"14270","WBGene00017210","II",2053919,2059072,5153
"14271","WBGene00017211","II",2059869,2061852,1983
"14272","WBGene00017212","II",2070593,2071516,923
"14273","WBGene00017213","II",2072221,2075830,3609
"14274","WBGene00017214","II",2076291,2080526,4235
"14275","WBGene00017215","II",5437891,5440256,2365
"14276","WBGene00017216","II",5430238,5431422,1184
"14277","WBGene00017217","II",5425750,5429572,3822
"14278","WBGene00017218","II",5435724,5436933,1209
"14279","WBGene00017219","II",5422735,5423858,1123
"14280","WBGene00017220","II",5424141,5425733,1592
"14281","WBGene00017221","X",1729858,1731819,1961
"14282","WBGene00017222","X",1727356,1729154,1798
"14283","WBGene00017223","X",1723092,1724888,1796
"14284","WBGene00017224","X",1706370,1706638,268
"14285","WBGene00017225","X",1710293,1711212,919
"14286","WBGene00017226","X",1716442,1718568,2126
"14287","WBGene00017227","X",1720093,1720428,335
"14288","WBGene00017228","V",7307389,7309556,2167
"14289","WBGene00017229","V",7304806,7305795,989
"14290","WBGene00017230","V",7298771,7301472,2701
"14291","WBGene00017231","V",7292754,7295381,2627
"14292","WBGene00017232","V",7303081,7304029,948
"14293","WBGene00017233","V",7314136,7321009,6873
"14294","WBGene00017235","IV",8666252,8667177,925
"14295","WBGene00017236","IV",8678695,8679325,630
"14296","WBGene00017237","IV",8682239,8686610,4371
"14297","WBGene00017238","IV",8686756,8687810,1054
"14298","WBGene00017239","I",6760416,6761435,1019
"14299","WBGene00017240","I",6758181,6760179,1998
"14300","WBGene00017241","X",7572110,7581059,8949
"14301","WBGene00017243","X",7560024,7562093,2069
"14302","WBGene00017244","X",7568137,7569722,1585
"14303","WBGene00017245","II",2787481,2793471,5990
"14304","WBGene00017246","II",2781628,2783083,1455
"14305","WBGene00017247","II",2779544,2780838,1294
"14306","WBGene00017248","II",2778146,2779282,1136
"14307","WBGene00017249","II",2764964,2767230,2266
"14308","WBGene00017250","II",2767250,2769121,1871
"14309","WBGene00017251","II",2769670,2770888,1218
"14310","WBGene00017252","II",2771082,2772266,1184
"14311","WBGene00017253","II",2772389,2773634,1245
"14312","WBGene00017254","II",2773954,2775042,1088
"14313","WBGene00017255","II",2783102,2787089,3987
"14314","WBGene00017257","X",8428842,8430520,1678
"14315","WBGene00017258","X",8411698,8414195,2497
"14316","WBGene00017259","X",8409968,8410494,526
"14317","WBGene00017260","V",5446138,5448721,2583
"14318","WBGene00017261","V",5433392,5437066,3674
"14319","WBGene00017262","V",5410955,5413001,2046
"14320","WBGene00017263","V",5418044,5420067,2023
"14321","WBGene00017264","V",5431512,5432599,1087
"14322","WBGene00017265","V",5437084,5439161,2077
"14323","WBGene00017266","V",5413320,5415073,1753
"14324","WBGene00017268","III",7359498,7362132,2634
"14325","WBGene00017269","III",7357663,7359183,1520
"14326","WBGene00017271","III",7343675,7345855,2180
"14327","WBGene00017272","III",7345861,7347149,1288
"14328","WBGene00017273","III",7347237,7349175,1938
"14329","WBGene00017274","III",7349291,7354090,4799
"14330","WBGene00017275","III",7354159,7357395,3236
"14331","WBGene00017277","II",5110029,5112232,2203
"14332","WBGene00017278","II",5116033,5118276,2243
"14333","WBGene00017279","II",5112382,5114153,1771
"14334","WBGene00017280","II",2565275,2575930,10655
"14335","WBGene00017281","IV",3442303,3444201,1898
"14336","WBGene00017282","II",5375267,5377111,1844
"14337","WBGene00017283","II",5373997,5375177,1180
"14338","WBGene00017284","II",5359552,5372122,12570
"14339","WBGene00017285","II",5352087,5353759,1672
"14340","WBGene00017286","II",5350669,5351993,1324
"14341","WBGene00017287","II",5346607,5347013,406
"14342","WBGene00017288","II",5348096,5350546,2450
"14343","WBGene00017289","II",5357308,5358187,879
"14344","WBGene00017290","II",5367942,5369102,1160
"14345","WBGene00017291","II",5342663,5344875,2212
"14346","WBGene00017292","II",5364492,5365745,1253
"14347","WBGene00017293","II",5358695,5359469,774
"14348","WBGene00017294","X",1502860,1503278,418
"14349","WBGene00017295","X",1489672,1494356,4684
"14350","WBGene00017296","X",1495074,1497681,2607
"14351","WBGene00017297","X",1500180,1501852,1672
"14352","WBGene00017298","X",1510480,1521487,11007
"14353","WBGene00017299","III",5573994,5576684,2690
"14354","WBGene00017300","III",5557344,5564837,7493
"14355","WBGene00017301","III",5555404,5557318,1914
"14356","WBGene00017302","III",5546987,5551231,4244
"14357","WBGene00017303","III",5551232,5552131,899
"14358","WBGene00017304","III",5553489,5554934,1445
"14359","WBGene00017305","III",5568213,5568779,566
"14360","WBGene00017306","X",4115330,4117027,1697
"14361","WBGene00017307","X",4110442,4111474,1032
"14362","WBGene00017308","X",4119652,4121016,1364
"14363","WBGene00017309","X",4121786,4128431,6645
"14364","WBGene00017310","V",7200224,7205632,5408
"14365","WBGene00017311","V",7196916,7198437,1521
"14366","WBGene00017312","V",7184910,7188483,3573
"14367","WBGene00017313","V",7179172,7182853,3681
"14368","WBGene00017314","V",7175501,7178783,3282
"14369","WBGene00017315","V",7167009,7169281,2272
"14370","WBGene00017316","V",7188332,7193662,5330
"14371","WBGene00017317","V",7193766,7196137,2371
"14372","WBGene00017319","III",8266062,8267841,1779
"14373","WBGene00017320","III",8254975,8257638,2663
"14374","WBGene00017321","III",8267921,8268355,434
"14375","WBGene00017322","III",8272960,8275971,3011
"14376","WBGene00017324","II",5774229,5774420,191
"14377","WBGene00017325","II",5756891,5757729,838
"14378","WBGene00017326","II",5772065,5774220,2155
"14379","WBGene00017327","II",5754468,5756684,2216
"14380","WBGene00017328","III",472301,475349,3048
"14381","WBGene00017329","V",7157142,7159190,2048
"14382","WBGene00017330","V",7132548,7133856,1308
"14383","WBGene00017331","V",7139477,7141964,2487
"14384","WBGene00017332","V",7141942,7145318,3376
"14385","WBGene00017333","V",7145656,7147470,1814
"14386","WBGene00017334","V",7148688,7150692,2004
"14387","WBGene00017335","V",7154503,7156224,1721
"14388","WBGene00017336","V",7161068,7163595,2527
"14389","WBGene00017338","X",17359755,17362763,3008
"14390","WBGene00017339","X",17364646,17368642,3996
"14391","WBGene00017340","X",17372318,17374877,2559
"14392","WBGene00017341","X",17380668,17382005,1337
"14393","WBGene00017342","X",17383125,17391615,8490
"14394","WBGene00017343","II",7126757,7129015,2258
"14395","WBGene00017344","II",7122242,7124386,2144
"14396","WBGene00017345","II",7124644,7125929,1285
"14397","WBGene00017347","II",7111978,7112982,1004
"14398","WBGene00017348","II",7113080,7113732,652
"14399","WBGene00017349","II",7101218,7105030,3812
"14400","WBGene00017350","II",7106412,7110056,3644
"14401","WBGene00017351","II",7113683,7115906,2223
"14402","WBGene00017352","II",7120589,7121782,1193
"14403","WBGene00017353","III",8323187,8324502,1315
"14404","WBGene00017354","III",8312719,8314286,1567
"14405","WBGene00017355","III",8311007,8312585,1578
"14406","WBGene00017356","III",8308538,8309806,1268
"14407","WBGene00017357","III",8307592,8308448,856
"14408","WBGene00017358","III",8305733,8326818,21085
"14409","WBGene00017359","III",8319610,8320283,673
"14410","WBGene00017360","III",8318683,8319260,577
"14411","WBGene00017361","III",8324637,8325609,972
"14412","WBGene00017362","V",7332562,7333424,862
"14413","WBGene00017363","V",7331168,7331779,611
"14414","WBGene00017364","V",7328392,7330001,1609
"14415","WBGene00017365","V",7327135,7327755,620
"14416","WBGene00017366","V",7335965,7337168,1203
"14417","WBGene00017367","V",7340436,7341484,1048
"14418","WBGene00017369","II",4693414,4696408,2994
"14419","WBGene00017370","II",4691227,4693075,1848
"14420","WBGene00017371","II",4687241,4689392,2151
"14421","WBGene00017372","II",4703254,4706498,3244
"14422","WBGene00017373","II",4713674,4726264,12590
"14423","WBGene00017374","II",4727326,4727869,543
"14424","WBGene00017375","X",17429042,17433103,4061
"14425","WBGene00017376","X",17396814,17397798,984
"14426","WBGene00017378","X",17401571,17402581,1010
"14427","WBGene00017379","X",17398593,17399357,764
"14428","WBGene00017380","X",3333130,3347302,14172
"14429","WBGene00017381","X",3315321,3324229,8908
"14430","WBGene00017382","X",3302070,3303927,1857
"14431","WBGene00017383","X",3325166,3326275,1109
"14432","WBGene00017384","II",4860594,4861696,1102
"14433","WBGene00017385","II",4857923,4859185,1262
"14434","WBGene00017386","II",4860064,4860411,347
"14435","WBGene00017387","II",4862318,4863457,1139
"14436","WBGene00017388","II",4875280,4875666,386
"14437","WBGene00017389","III",7009136,7019574,10438
"14438","WBGene00017390","II",5496540,5497062,522
"14439","WBGene00017391","II",5494703,5495682,979
"14440","WBGene00017392","II",5491111,5493192,2081
"14441","WBGene00017393","II",5488151,5490606,2455
"14442","WBGene00017394","II",5480591,5482041,1450
"14443","WBGene00017395","II",5494085,5494505,420
"14444","WBGene00017396","II",5497285,5498256,971
"14445","WBGene00017397","II",5498851,5501409,2558
"14446","WBGene00017398","I",2250131,2254901,4770
"14447","WBGene00017399","I",2242230,2247223,4993
"14448","WBGene00017400","X",8639389,8643431,4042
"14449","WBGene00017401","X",8646606,8647097,491
"14450","WBGene00017402","II",3741884,3742509,625
"14451","WBGene00017403","II",3737965,3740837,2872
"14452","WBGene00017404","II",3737334,3738471,1137
"14453","WBGene00017405","II",3731973,3733203,1230
"14454","WBGene00017406","II",3730152,3731548,1396
"14455","WBGene00017407","II",3735929,3736943,1014
"14456","WBGene00017408","II",3751261,3752284,1023
"14457","WBGene00017410","V",4381794,4382382,588
"14458","WBGene00017411","V",4382916,4385242,2326
"14459","WBGene00017412","V",4393540,4396357,2817
"14460","WBGene00017413","V",4398635,4400218,1583
"14461","WBGene00017414","V",4401298,4401940,642
"14462","WBGene00017415","V",4402749,4404530,1781
"14463","WBGene00017416","IV",7456525,7458214,1689
"14464","WBGene00017417","IV",7458836,7460424,1588
"14465","WBGene00017418","IV",7461966,7465957,3991
"14466","WBGene00017419","X",8287261,8294514,7253
"14467","WBGene00017420","X",8285683,8286785,1102
"14468","WBGene00017421","X",8262421,8271021,8600
"14469","WBGene00017422","X",602172,604922,2750
"14470","WBGene00017423","X",593960,596289,2329
"14471","WBGene00017424","X",596314,599553,3239
"14472","WBGene00017426","X",604872,608492,3620
"14473","WBGene00017427","X",5829376,5832027,2651
"14474","WBGene00017428","X",5804379,5805922,1543
"14475","WBGene00017429","X",5831918,5834858,2940
"14476","WBGene00017430","V",6356025,6362997,6972
"14477","WBGene00017431","V",6363408,6365671,2263
"14478","WBGene00017432","V",6366433,6368533,2100
"14479","WBGene00017433","V",6372114,6374933,2819
"14480","WBGene00017434","II",6283386,6284724,1338
"14481","WBGene00017435","II",6270370,6274005,3635
"14482","WBGene00017436","II",6264050,6265502,1452
"14483","WBGene00017437","II",6260857,6262524,1667
"14484","WBGene00017438","II",6252774,6256124,3350
"14485","WBGene00017439","II",6284817,6286869,2052
"14486","WBGene00017440","II",6288413,6290097,1684
"14487","WBGene00017441","II",6265612,6268083,2471
"14488","WBGene00017442","II",6279676,6281102,1426
"14489","WBGene00017443","II",6257628,6260021,2393
"14490","WBGene00017444","II",6262522,6263325,803
"14491","WBGene00017445","X",6904721,6905849,1128
"14492","WBGene00017446","X",6898650,6899948,1298
"14493","WBGene00017447","X",6924804,6928704,3900
"14494","WBGene00017448","X",6929262,6932359,3097
"14495","WBGene00017449","X",6921646,6924764,3118
"14496","WBGene00017450","II",3360221,3361354,1133
"14497","WBGene00017451","II",3359139,3360255,1116
"14498","WBGene00017452","II",3350252,3358981,8729
"14499","WBGene00017453","II",3340556,3341260,704
"14500","WBGene00017454","II",3329786,3331806,2020
"14501","WBGene00017455","II",3337968,3338656,688
"14502","WBGene00017456","II",3347574,3349870,2296
"14503","WBGene00017459","II",3341268,3342104,836
"14504","WBGene00017460","II",3345218,3346378,1160
"14505","WBGene00017461","II",3343710,3344967,1257
"14506","WBGene00017462","II",3346745,3347519,774
"14507","WBGene00017463","X",5603766,5609133,5367
"14508","WBGene00017464","X",5595778,5599330,3552
"14509","WBGene00017465","V",5144831,5145781,950
"14510","WBGene00017466","V",5138195,5141488,3293
"14511","WBGene00017467","V",5132741,5137100,4359
"14512","WBGene00017468","V",5127055,5130076,3021
"14513","WBGene00017469","V",5146179,5146490,311
"14514","WBGene00017470","X",4350498,4352744,2246
"14515","WBGene00017471","X",4344215,4345644,1429
"14516","WBGene00017472","X",4339634,4343702,4068
"14517","WBGene00017473","X",4357015,4357567,552
"14518","WBGene00017474","X",4361927,4362283,356
"14519","WBGene00017475","X",4363607,4365069,1462
"14520","WBGene00017476","X",4440941,4441726,785
"14521","WBGene00017478","X",4430929,4437512,6583
"14522","WBGene00017480","IV",6604001,6606188,2187
"14523","WBGene00017481","IV",6602680,6603966,1286
"14524","WBGene00017482","IV",4307896,4317140,9244
"14525","WBGene00017483","IV",4301308,4304437,3129
"14526","WBGene00017484","IV",4294877,4295687,810
"14527","WBGene00017485","IV",4291467,4291872,405
"14528","WBGene00017486","IV",4289567,4290061,494
"14529","WBGene00017487","IV",4278825,4284120,5295
"14530","WBGene00017488","IV",4290189,4290703,514
"14531","WBGene00017489","IV",4293620,4299083,5463
"14532","WBGene00017490","V",2329444,2329954,510
"14533","WBGene00017491","V",2334489,2336251,1762
"14534","WBGene00017492","V",2336678,2338638,1960
"14535","WBGene00017493","V",2339567,2341408,1841
"14536","WBGene00017494","V",2342016,2344508,2492
"14537","WBGene00017496","V",2345676,2348123,2447
"14538","WBGene00017497","V",2331916,2336196,4280
"14539","WBGene00017498","V",2326678,2327262,584
"14540","WBGene00017499","V",2330429,2330930,501
"14541","WBGene00017500","V",2323014,2323524,510
"14542","WBGene00017501","V",2324510,2326827,2317
"14543","WBGene00017502","V",1315105,1315524,419
"14544","WBGene00017503","V",1610263,1612747,2484
"14545","WBGene00017504","V",1601038,1603916,2878
"14546","WBGene00017505","V",1596144,1598689,2545
"14547","WBGene00017506","V",1594019,1594665,646
"14548","WBGene00017507","V",1588548,1591727,3179
"14549","WBGene00017508","V",1587206,1587936,730
"14550","WBGene00017509","V",1585722,1586028,306
"14551","WBGene00017510","V",1603934,1607846,3912
"14552","WBGene00017511","V",1612803,1614826,2023
"14553","WBGene00017512","V",1615723,1618072,2349
"14554","WBGene00017513","X",8440192,8450417,10225
"14555","WBGene00017514","X",8457614,8459734,2120
"14556","WBGene00017515","X",8459821,8463360,3539
"14557","WBGene00017516","II",2404284,2404659,375
"14558","WBGene00017517","II",2375273,2376411,1138
"14559","WBGene00017518","II",2372390,2374340,1950
"14560","WBGene00017519","II",2369256,2370089,833
"14561","WBGene00017520","II",2367528,2368708,1180
"14562","WBGene00017521","II",2377199,2377851,652
"14563","WBGene00017522","II",2379579,2380274,695
"14564","WBGene00017523","II",2381949,2383434,1485
"14565","WBGene00017524","II",2384186,2385595,1409
"14566","WBGene00017525","II",2389582,2390994,1412
"14567","WBGene00017526","II",2391645,2393921,2276
"14568","WBGene00017527","II",2394916,2395964,1048
"14569","WBGene00017528","II",2397334,2398984,1650
"14570","WBGene00017529","II",2405176,2407681,2505
"14571","WBGene00017530","X",4668071,4673234,5163
"14572","WBGene00017532","X",4647526,4649197,1671
"14573","WBGene00017533","V",6116521,6117849,1328
"14574","WBGene00017534","V",6107828,6114856,7028
"14575","WBGene00017535","V",6105607,6107530,1923
"14576","WBGene00017536","V",6108964,6110722,1758
"14577","WBGene00017537","V",6111196,6112997,1801
"14578","WBGene00017538","V",6118332,6120206,1874
"14579","WBGene00017539","IV",8355892,8356503,611
"14580","WBGene00017540","IV",8354874,8355433,559
"14581","WBGene00017541","IV",8348373,8349169,796
"14582","WBGene00017542","IV",8345818,8346546,728
"14583","WBGene00017543","IV",8342685,8344485,1800
"14584","WBGene00017544","IV",8339936,8342112,2176
"14585","WBGene00017545","II",7684889,7689689,4800
"14586","WBGene00017546","II",7664582,7667110,2528
"14587","WBGene00017547","II",7658324,7662522,4198
"14588","WBGene00017548","II",7662706,7663754,1048
"14589","WBGene00017549","II",7689710,7690572,862
"14590","WBGene00017550","II",3416838,3420671,3833
"14591","WBGene00017551","II",3415005,3416250,1245
"14592","WBGene00017552","II",3406951,3409774,2823
"14593","WBGene00017553","II",3403835,3406838,3003
"14594","WBGene00017554","II",3395821,3399303,3482
"14595","WBGene00017555","II",3399754,3402925,3171
"14596","WBGene00017556","II",3411425,3414469,3044
"14597","WBGene00017557","II",3420653,3425533,4880
"14598","WBGene00017559","II",6563796,6565154,1358
"14599","WBGene00017560","II",6565477,6566728,1251
"14600","WBGene00017562","II",6567134,6567870,736
"14601","WBGene00017563","II",6559258,6561583,2325
"14602","WBGene00017564","V",7420462,7421713,1251
"14603","WBGene00017565","V",7433401,7435650,2249
"14604","WBGene00017567","V",7413437,7413840,403
"14605","WBGene00017568","X",8601535,8602366,831
"14606","WBGene00017569","X",8586147,8590290,4143
"14607","WBGene00017570","X",8580656,8583537,2881
"14608","WBGene00017571","X",8571049,8575451,4402
"14609","WBGene00017573","X",8595152,8597747,2595
"14610","WBGene00017574","IV",334809,337178,2369
"14611","WBGene00017576","IV",339629,358976,19347
"14612","WBGene00017577","IV",330823,334385,3562
"14613","WBGene00017578","IV",325063,330631,5568
"14614","WBGene00017579","X",9259852,9261066,1214
"14615","WBGene00017580","X",9235103,9242223,7120
"14616","WBGene00017581","X",9256008,9257456,1448
"14617","WBGene00017582","X",9262027,9264331,2304
"14618","WBGene00017583","II",3683177,3684996,1819
"14619","WBGene00017584","II",3675624,3676733,1109
"14620","WBGene00017585","II",3664770,3665120,350
"14621","WBGene00017586","II",3660084,3661809,1725
"14622","WBGene00017587","II",3655678,3657732,2054
"14623","WBGene00017588","II",3663509,3663896,387
"14624","WBGene00017589","II",3677535,3681415,3880
"14625","WBGene00017590","II",3651256,3654276,3020
"14626","WBGene00017591","IV",4605786,4608216,2430
"14627","WBGene00017592","IV",4599954,4602778,2824
"14628","WBGene00017593","IV",4597195,4599002,1807
"14629","WBGene00017594","IV",4602865,4605671,2806
"14630","WBGene00017597","IV",4610576,4638095,27519
"14631","WBGene00017598","V",7562738,7564245,1507
"14632","WBGene00017599","V",7552121,7552708,587
"14633","WBGene00017600","V",7552756,7553923,1167
"14634","WBGene00017601","V",7557541,7558783,1242
"14635","WBGene00017602","V",7560252,7561615,1363
"14636","WBGene00017603","V",7566232,7570390,4158
"14637","WBGene00017605","V",7571950,7575715,3765
"14638","WBGene00017606","V",7577531,7580541,3010
"14639","WBGene00017607","V",7581473,7587698,6225
"14640","WBGene00017608","V",7575750,7581532,5782
"14641","WBGene00017609","X",1431007,1431486,479
"14642","WBGene00017610","X",1427774,1430871,3097
"14643","WBGene00017611","X",1425727,1426164,437
"14644","WBGene00017612","X",1417304,1417477,173
"14645","WBGene00017613","V",7051679,7052179,500
"14646","WBGene00017614","V",7046312,7049250,2938
"14647","WBGene00017615","V",7017359,7018851,1492
"14648","WBGene00017616","V",7018901,7021803,2902
"14649","WBGene00017618","V",7024632,7027083,2451
"14650","WBGene00017619","V",7047127,7047604,477
"14651","WBGene00017620","V",7049434,7051311,1877
"14652","WBGene00017621","V",7052717,7053200,483
"14653","WBGene00017625","X",17695232,17701744,6512
"14654","WBGene00017627","X",4200351,4201550,1199
"14655","WBGene00017628","X",4194019,4194785,766
"14656","WBGene00017629","X",4198791,4199929,1138
"14657","WBGene00017630","X",4201650,4202214,564
"14658","WBGene00017631","X",4206830,4207477,647
"14659","WBGene00017632","X",4204602,4206444,1842
"14660","WBGene00017633","V",8190699,8192050,1351
"14661","WBGene00017634","V",8186039,8187319,1280
"14662","WBGene00017635","V",8161944,8165448,3504
"14663","WBGene00017636","V",8159929,8161643,1714
"14664","WBGene00017637","V",8164749,8168269,3520
"14665","WBGene00017638","V",8177093,8177449,356
"14666","WBGene00017639","V",8192060,8195937,3877
"14667","WBGene00017640","V",8196774,8199094,2320
"14668","WBGene00017641","IV",7957580,7962129,4549
"14669","WBGene00017642","IV",7948643,7953548,4905
"14670","WBGene00017643","IV",7943617,7946819,3202
"14671","WBGene00017644","IV",7939812,7941064,1252
"14672","WBGene00017645","IV",7937959,7938934,975
"14673","WBGene00017646","III",6589377,6592175,2798
"14674","WBGene00017647","III",6608622,6610455,1833
"14675","WBGene00017648","III",6587864,6589398,1534
"14676","WBGene00017650","I",3711018,3713134,2116
"14677","WBGene00017651","I",3706030,3709435,3405
"14678","WBGene00017652","V",9132384,9133275,891
"14679","WBGene00017653","V",9128710,9130671,1961
"14680","WBGene00017654","V",9126679,9127593,914
"14681","WBGene00017655","V",9125645,9126006,361
"14682","WBGene00017656","V",9124480,9125292,812
"14683","WBGene00017657","V",9112767,9122180,9413
"14684","WBGene00017658","V",9097121,9098696,1575
"14685","WBGene00017659","V",9096007,9097233,1226
"14686","WBGene00017660","V",9123489,9123809,320
"14687","WBGene00017661","V",9099638,9101133,1495
"14688","WBGene00017662","II",7317768,7319319,1551
"14689","WBGene00017663","II",7319910,7323200,3290
"14690","WBGene00017664","II",7328736,7331324,2588
"14691","WBGene00017666","X",1328143,1329947,1804
"14692","WBGene00017667","X",1335363,1336915,1552
"14693","WBGene00017668","X",1343837,1344410,573
"14694","WBGene00017670","X",1350553,1356482,5929
"14695","WBGene00017671","I",4906786,4911829,5043
"14696","WBGene00017672","I",4903437,4905138,1701
"14697","WBGene00017673","I",4901918,4903264,1346
"14698","WBGene00017674","I",4896003,4897541,1538
"14699","WBGene00017675","I",4911805,4914047,2242
"14700","WBGene00017676","I",4918372,4920770,2398
"14701","WBGene00017677","V",8274353,8275757,1404
"14702","WBGene00017678","V",8269254,8272058,2804
"14703","WBGene00017679","V",8265202,8266385,1183
"14704","WBGene00017680","V",8265804,8267371,1567
"14705","WBGene00017681","V",8282333,8284900,2567
"14706","WBGene00017683","II",6097830,6099663,1833
"14707","WBGene00017684","II",6087670,6088672,1002
"14708","WBGene00017685","II",6082912,6083506,594
"14709","WBGene00017686","II",6092766,6097597,4831
"14710","WBGene00017687","X",6518883,6522656,3773
"14711","WBGene00017688","X",6512285,6512956,671
"14712","WBGene00017690","X",6522596,6530148,7552
"14713","WBGene00017691","X",6533493,6536840,3347
"14714","WBGene00017692","III",8665338,8666880,1542
"14715","WBGene00017693","III",8650764,8652190,1426
"14716","WBGene00017694","III",8648889,8649477,588
"14717","WBGene00017695","III",8639791,8640093,302
"14718","WBGene00017696","III",8626291,8628571,2280
"14719","WBGene00017698","III",8652578,8653925,1347
"14720","WBGene00017699","II",6928770,6947899,19129
"14721","WBGene00017700","II",6924115,6925951,1836
"14722","WBGene00017701","II",6938585,6938869,284
"14723","WBGene00017702","II",6947855,6951300,3445
"14724","WBGene00017703","II",2673908,2677588,3680
"14725","WBGene00017704","II",2665389,2666252,863
"14726","WBGene00017705","II",2649870,2650715,845
"14727","WBGene00017706","II",2642090,2642884,794
"14728","WBGene00017707","II",2640081,2641897,1816
"14729","WBGene00017708","II",2638392,2639353,961
"14730","WBGene00017709","II",2643685,2645703,2018
"14731","WBGene00017710","II",2646328,2646843,515
"14732","WBGene00017711","II",2647637,2649639,2002
"14733","WBGene00017712","II",2678041,2679162,1121
"14734","WBGene00017713","II",2672632,2673634,1002
"14735","WBGene00017714","X",8149563,8150716,1153
"14736","WBGene00017715","X",8161839,8163073,1234
"14737","WBGene00017716","X",6004482,6007071,2589
"14738","WBGene00017717","X",5999610,6001532,1922
"14739","WBGene00017718","X",5992099,5992859,760
"14740","WBGene00017719","V",2127535,2130100,2565
"14741","WBGene00017720","V",2122866,2127299,4433
"14742","WBGene00017721","V",2110704,2114488,3784
"14743","WBGene00017722","V",2103658,2106076,2418
"14744","WBGene00017723","V",2115490,2118644,3154
"14745","WBGene00017724","V",2131476,2140042,8566
"14746","WBGene00017725","X",16702442,16703440,998
"14747","WBGene00017726","X",16678488,16679823,1335
"14748","WBGene00017727","X",16677340,16677738,398
"14749","WBGene00017729","X",16684414,16687196,2782
"14750","WBGene00017730","X",16689366,16690860,1494
"14751","WBGene00017731","I",2446740,2448369,1629
"14752","WBGene00017732","I",2438767,2442948,4181
"14753","WBGene00017733","I",2434004,2435708,1704
"14754","WBGene00017734","I",2418450,2420801,2351
"14755","WBGene00017735","I",2420803,2421816,1013
"14756","WBGene00017736","I",2422334,2425185,2851
"14757","WBGene00017737","I",2429675,2432601,2926
"14758","WBGene00017738","I",2432570,2433755,1185
"14759","WBGene00017739","I",2449414,2451366,1952
"14760","WBGene00017741","I",2415133,2418521,3388
"14761","WBGene00017742","II",43854,44981,1127
"14762","WBGene00017743","II",34204,35262,1058
"14763","WBGene00017744","II",31768,33610,1842
"14764","WBGene00017745","II",25382,28423,3041
"14765","WBGene00017746","II",30061,31584,1523
"14766","WBGene00017747","II",35202,37313,2111
"14767","WBGene00017748","II",38558,39537,979
"14768","WBGene00017749","II",45040,47479,2439
"14769","WBGene00017750","II",41471,41982,511
"14770","WBGene00017751","III",6500514,6507717,7203
"14771","WBGene00017752","III",6498476,6500023,1547
"14772","WBGene00017754","III",6483218,6488875,5657
"14773","WBGene00017755","III",6478961,6481226,2265
"14774","WBGene00017756","III",6508132,6509499,1367
"14775","WBGene00017757","III",911261,912243,982
"14776","WBGene00017758","III",895786,900158,4372
"14777","WBGene00017759","III",900138,901444,1306
"14778","WBGene00017760","III",902151,907539,5388
"14779","WBGene00017761","III",913248,916997,3749
"14780","WBGene00017762","III",917088,919422,2334
"14781","WBGene00017763","III",908328,909902,1574
"14782","WBGene00017764","V",1179604,1181548,1944
"14783","WBGene00017765","V",5712818,5714756,1938
"14784","WBGene00017766","V",5709418,5712335,2917
"14785","WBGene00017767","V",5684875,5685728,853
"14786","WBGene00017768","V",5678600,5682630,4030
"14787","WBGene00017769","V",5682721,5684589,1868
"14788","WBGene00017770","V",5685726,5687381,1655
"14789","WBGene00017771","V",5690103,5691715,1612
"14790","WBGene00017772","V",5700010,5701080,1070
"14791","WBGene00017773","III",5966413,5971510,5097
"14792","WBGene00017774","III",5958722,5962322,3600
"14793","WBGene00017775","III",5948890,5953534,4644
"14794","WBGene00017776","III",5943833,5946124,2291
"14795","WBGene00017777","III",5946217,5948711,2494
"14796","WBGene00017778","III",5953526,5958246,4720
"14797","WBGene00017779","X",802796,804264,1468
"14798","WBGene00017780","X",806993,810794,3801
"14799","WBGene00017781","X",811173,813163,1990
"14800","WBGene00017782","V",7465889,7471223,5334
"14801","WBGene00017783","V",7455819,7457597,1778
"14802","WBGene00017784","V",7451721,7452899,1178
"14803","WBGene00017785","V",7449353,7451149,1796
"14804","WBGene00017786","V",7447273,7448884,1611
"14805","WBGene00017787","V",7445065,7446712,1647
"14806","WBGene00017788","V",7440107,7441483,1376
"14807","WBGene00017789","V",7435413,7436962,1549
"14808","WBGene00017790","V",7437506,7437919,413
"14809","WBGene00017791","V",7452946,7454318,1372
"14810","WBGene00017792","V",7438285,7439933,1648
"14811","WBGene00017794","X",4442152,4448383,6231
"14812","WBGene00017795","I",4884903,4895495,10592
"14813","WBGene00017796","V",8576084,8579940,3856
"14814","WBGene00017797","V",8570311,8581397,11086
"14815","WBGene00017798","V",8539728,8545566,5838
"14816","WBGene00017799","V",8564303,8565175,872
"14817","WBGene00017800","V",8565275,8570077,4802
"14818","WBGene00017801","III",4850507,4851910,1403
"14819","WBGene00017802","III",4826906,4828970,2064
"14820","WBGene00017803","III",4818042,4819073,1031
"14821","WBGene00017804","III",4816040,4817078,1038
"14822","WBGene00017805","III",4819328,4819943,615
"14823","WBGene00017806","III",4820670,4822226,1556
"14824","WBGene00017807","III",4825345,4829509,4164
"14825","WBGene00017808","III",4830010,4830349,339
"14826","WBGene00017809","III",4841039,4842273,1234
"14827","WBGene00017810","III",4843493,4844410,917
"14828","WBGene00017811","III",4847009,4849907,2898
"14829","WBGene00017813","X",7627651,7628233,582
"14830","WBGene00017814","X",7630905,7637172,6267
"14831","WBGene00017815","I",6326875,6327972,1097
"14832","WBGene00017816","I",6317701,6320365,2664
"14833","WBGene00017817","I",6309114,6310781,1667
"14834","WBGene00017818","V",7981545,7982662,1117
"14835","WBGene00017819","V",7959270,7960958,1688
"14836","WBGene00017821","V",7947229,7948615,1386
"14837","WBGene00017822","V",7951625,7952955,1330
"14838","WBGene00017823","V",7955404,7956497,1093
"14839","WBGene00017824","V",7957277,7958840,1563
"14840","WBGene00017825","III",4912207,4914133,1926
"14841","WBGene00017826","III",4900073,4903143,3070
"14842","WBGene00017827","III",4887921,4891252,3331
"14843","WBGene00017828","III",4891609,4893409,1800
"14844","WBGene00017829","III",4910475,4912521,2046
"14845","WBGene00017830","III",4917104,4918008,904
"14846","WBGene00017831","III",4908960,4910038,1078
"14847","WBGene00017832","III",4903177,4903884,707
"14848","WBGene00017833","V",5837572,5838613,1041
"14849","WBGene00017834","V",5838960,5845739,6779
"14850","WBGene00017835","V",5866134,5867952,1818
"14851","WBGene00017836","V",5864211,5865149,938
"14852","WBGene00017837","II",4791620,4795643,4023
"14853","WBGene00017838","II",4763081,4764174,1093
"14854","WBGene00017839","II",4758762,4759289,527
"14855","WBGene00017840","II",4764159,4766384,2225
"14856","WBGene00017841","II",4770534,4771382,848
"14857","WBGene00017842","II",4775295,4781347,6052
"14858","WBGene00017843","V",4975485,4977502,2017
"14859","WBGene00017845","V",4971770,4973043,1273
"14860","WBGene00017848","III",6577827,6578584,757
"14861","WBGene00017849","III",6559097,6563666,4569
"14862","WBGene00017850","V",7072585,7075835,3250
"14863","WBGene00017851","I",5434805,5435785,980
"14864","WBGene00017852","I",5430164,5431449,1285
"14865","WBGene00017853","I",5426273,5427316,1043
"14866","WBGene00017854","I",5422783,5423264,481
"14867","WBGene00017855","I",5421313,5428457,7144
"14868","WBGene00017858","I",5433907,5443026,9119
"14869","WBGene00017860","I",5443878,5446855,2977
"14870","WBGene00017861","X",7672993,7676312,3319
"14871","WBGene00017862","X",7651132,7651548,416
"14872","WBGene00017863","X",7653135,7654425,1290
"14873","WBGene00017864","X",7657538,7687738,30200
"14874","WBGene00017865","X",7667339,7670714,3375
"14875","WBGene00017866","X",7676511,7680629,4118
"14876","WBGene00017867","V",3463814,3466150,2336
"14877","WBGene00017868","V",3459740,3463071,3331
"14878","WBGene00017869","II",825848,827500,1652
"14879","WBGene00017870","II",827891,830267,2376
"14880","WBGene00017871","II",840567,841113,546
"14881","WBGene00017872","II",844274,845085,811
"14882","WBGene00017873","II",849678,850654,976
"14883","WBGene00017874","II",846864,848603,1739
"14884","WBGene00017875","II",845288,845686,398
"14885","WBGene00017876","II",837719,838470,751
"14886","WBGene00017877","II",833607,835270,1663
"14887","WBGene00017878","II",831069,831871,802
"14888","WBGene00017879","V",8638237,8640585,2348
"14889","WBGene00017880","V",8640596,8641344,748
"14890","WBGene00017881","V",8641491,8643225,1734
"14891","WBGene00017885","I",4934259,4949332,15073
"14892","WBGene00017886","I",4926592,4928840,2248
"14893","WBGene00017887","I",4950583,4951550,967
"14894","WBGene00017888","I",4928654,4932147,3493
"14895","WBGene00017889","I",4949327,4950410,1083
"14896","WBGene00017890","X",3205078,3205835,757
"14897","WBGene00017891","X",3210470,3220367,9897
"14898","WBGene00017892","X",3227489,3235408,7919
"14899","WBGene00017893","X",3206818,3209644,2826
"14900","WBGene00017894","II",5942927,5943995,1068
"14901","WBGene00017895","II",5921967,5924838,2871
"14902","WBGene00017896","X",543107,544256,1149
"14903","WBGene00017898","X",531841,535834,3993
"14904","WBGene00017899","X",537303,538910,1607
"14905","WBGene00017900","IV",4568841,4590297,21456
"14906","WBGene00017901","IV",4562654,4565674,3020
"14907","WBGene00017902","IV",4566018,4567443,1425
"14908","WBGene00017904","III",6802788,6816132,13344
"14909","WBGene00017905","III",6817316,6819372,2056
"14910","WBGene00017906","IV",3839720,3841628,1908
"14911","WBGene00017907","IV",3826872,3835895,9023
"14912","WBGene00017908","I",3995709,3996950,1241
"14913","WBGene00017909","I",3974063,3977351,3288
"14914","WBGene00017910","I",3978493,3979538,1045
"14915","WBGene00017911","II",2762417,2763477,1060
"14916","WBGene00017912","II",2758625,2761856,3231
"14917","WBGene00017913","II",2753299,2754379,1080
"14918","WBGene00017914","II",2748588,2751573,2985
"14919","WBGene00017915","II",2747393,2747728,335
"14920","WBGene00017916","II",2751741,2752611,870
"14921","WBGene00017917","II",2756021,2757018,997
"14922","WBGene00017918","II",2757147,2758054,907
"14923","WBGene00017919","IV",4665251,4667293,2042
"14924","WBGene00017920","IV",4660991,4665204,4213
"14925","WBGene00017921","IV",4652459,4653159,700
"14926","WBGene00017922","IV",4649744,4650654,910
"14927","WBGene00017923","IV",4647202,4649743,2541
"14928","WBGene00017924","IV",4659049,4659517,468
"14929","WBGene00017925","IV",4659521,4660203,682
"14930","WBGene00017926","IV",126731,127640,909
"14931","WBGene00017927","IV",111465,111862,397
"14932","WBGene00017928","IV",119272,121707,2435
"14933","WBGene00017929","IV",121797,126225,4428
"14934","WBGene00017930","V",6039094,6040582,1488
"14935","WBGene00017931","V",6018994,6026337,7343
"14936","WBGene00017933","V",6035397,6036683,1286
"14937","WBGene00017934","IV",4205975,4218259,12284
"14938","WBGene00017935","IV",4226858,4228017,1159
"14939","WBGene00017936","IV",4229195,4231861,2666
"14940","WBGene00017937","III",505241,512217,6976
"14941","WBGene00017938","X",17532976,17534064,1088
"14942","WBGene00017939","X",17554946,17561464,6518
"14943","WBGene00017941","X",1794816,1795673,857
"14944","WBGene00017942","X",1779388,1780527,1139
"14945","WBGene00017944","II",4219379,4221769,2390
"14946","WBGene00017945","II",4215605,4218243,2638
"14947","WBGene00017947","II",4188978,4194458,5480
"14948","WBGene00017948","II",4194945,4204147,9202
"14949","WBGene00017949","II",4209738,4210066,328
"14950","WBGene00017950","III",6974338,6978025,3687
"14951","WBGene00017951","III",6963620,6968130,4510
"14952","WBGene00017952","III",6982437,6983062,625
"14953","WBGene00017954","II",6799114,6800154,1040
"14954","WBGene00017955","II",6805022,6807262,2240
"14955","WBGene00017956","II",6817750,6819328,1578
"14956","WBGene00017957","V",684060,686289,2229
"14957","WBGene00017959","V",647188,649741,2553
"14958","WBGene00017960","V",662479,664443,1964
"14959","WBGene00017961","V",665919,667494,1575
"14960","WBGene00017962","V",674911,676754,1843
"14961","WBGene00017963","V",658476,660310,1834
"14962","WBGene00017964","V",6276439,6278160,1721
"14963","WBGene00017965","V",6270852,6274911,4059
"14964","WBGene00017967","II",7252259,7255735,3476
"14965","WBGene00017968","II",7245876,7250181,4305
"14966","WBGene00017969","II",7232853,7235920,3067
"14967","WBGene00017970","II",7228784,7230616,1832
"14968","WBGene00017971","II",7256112,7258112,2000
"14969","WBGene00017973","X",5298561,5306328,7767
"14970","WBGene00017974","X",5283831,5289726,5895
"14971","WBGene00017975","I",2700420,2702158,1738
"14972","WBGene00017976","I",2697399,2699955,2556
"14973","WBGene00017977","I",2692757,2694084,1327
"14974","WBGene00017978","I",2692074,2692467,393
"14975","WBGene00017979","I",2668160,2672434,4274
"14976","WBGene00017980","I",2672940,2682797,9857
"14977","WBGene00017981","V",4341443,4346050,4607
"14978","WBGene00017982","V",4346089,4346425,336
"14979","WBGene00017983","V",4349774,4361552,11778
"14980","WBGene00017984","V",4369351,4371383,2032
"14981","WBGene00017985","V",4373760,4374874,1114
"14982","WBGene00017986","V",4374974,4376173,1199
"14983","WBGene00017987","V",4376619,4377722,1103
"14984","WBGene00017988","V",4371807,4373811,2004
"14985","WBGene00017989","IV",7580597,7583726,3129
"14986","WBGene00017990","IV",7575622,7577325,1703
"14987","WBGene00017991","IV",7568893,7573761,4868
"14988","WBGene00017992","IV",7574355,7578381,4026
"14989","WBGene00017993","IV",7578501,7580269,1768
"14990","WBGene00017995","IV",7567607,7568507,900
"14991","WBGene00017996","IV",7703873,7706905,3032
"14992","WBGene00017997","IV",7707575,7709084,1509
"14993","WBGene00017998","IV",7714164,7718009,3845
"14994","WBGene00017999","IV",7709192,7709736,544
"14995","WBGene00018000","I",5852045,5852962,917
"14996","WBGene00018001","I",5847477,5849391,1914
"14997","WBGene00018002","I",5834644,5837392,2748
"14998","WBGene00018003","I",5844836,5846466,1630
"14999","WBGene00018004","I",5850038,5851828,1790
"15000","WBGene00018005","I",5854261,5855047,786
"15001","WBGene00018006","I",5857548,5862557,5009
"15002","WBGene00018007","I",5866514,5868139,1625
"15003","WBGene00018008","I",5868266,5869954,1688
"15004","WBGene00018009","I",5862644,5866431,3787
"15005","WBGene00018010","V",297949,300005,2056
"15006","WBGene00018011","V",300015,304713,4698
"15007","WBGene00018013","V",305457,311565,6108
"15008","WBGene00018014","II",5029942,5031712,1770
"15009","WBGene00018015","II",5031757,5034035,2278
"15010","WBGene00018016","II",5034142,5036439,2297
"15011","WBGene00018017","II",5036561,5040196,3635
"15012","WBGene00018018","II",5049915,5053966,4051
"15013","WBGene00018019","II",2600553,2601779,1226
"15014","WBGene00018020","II",2594052,2598903,4851
"15015","WBGene00018021","II",2679163,2681218,2055
"15016","WBGene00018022","II",2683329,2684308,979
"15017","WBGene00018023","II",2690472,2694311,3839
"15018","WBGene00018024","X",3807460,3816429,8969
"15019","WBGene00018025","X",3805084,3805749,665
"15020","WBGene00018026","X",3789757,3792815,3058
"15021","WBGene00018027","X",3793912,3795395,1483
"15022","WBGene00018028","X",17015297,17017814,2517
"15023","WBGene00018030","X",17013462,17014028,566
"15024","WBGene00018031","X",17019616,17020958,1342
"15025","WBGene00018033","X",17035206,17042985,7779
"15026","WBGene00018034","X",5377607,5379353,1746
"15027","WBGene00018035","X",5375070,5376911,1841
"15028","WBGene00018036","X",5365808,5367619,1811
"15029","WBGene00018037","X",5355638,5364322,8684
"15030","WBGene00018038","X",5369316,5372639,3323
"15031","WBGene00018039","II",7575930,7577582,1652
"15032","WBGene00018040","II",7574431,7575830,1399
"15033","WBGene00018041","II",7570605,7572444,1839
"15034","WBGene00018042","II",7580270,7583557,3287
"15035","WBGene00018043","II",4626906,4627805,899
"15036","WBGene00018044","II",4608372,4612082,3710
"15037","WBGene00018045","II",4603406,4604161,755
"15038","WBGene00018046","II",4601355,4602633,1278
"15039","WBGene00018047","II",4615635,4616543,908
"15040","WBGene00018048","II",4617152,4618090,938
"15041","WBGene00018049","II",4618882,4619800,918
"15042","WBGene00018050","II",4619988,4621741,1753
"15043","WBGene00018051","II",4627811,4638384,10573
"15044","WBGene00018052","V",3316307,3317851,1544
"15045","WBGene00018053","V",3308469,3309689,1220
"15046","WBGene00018054","V",3289798,3295069,5271
"15047","WBGene00018055","V",3284929,3285792,863
"15048","WBGene00018056","V",3287995,3289385,1390
"15049","WBGene00018057","V",3286432,3287460,1028
"15050","WBGene00018058","V",3298885,3301998,3113
"15051","WBGene00018059","V",3302415,3307363,4948
"15052","WBGene00018060","V",3310123,3312117,1994
"15053","WBGene00018061","V",3313286,3315516,2230
"15054","WBGene00018062","V",3318174,3319062,888
"15055","WBGene00018063","V",3319466,3320105,639
"15056","WBGene00018064","IV",4042575,4047786,5211
"15057","WBGene00018065","IV",4040308,4041532,1224
"15058","WBGene00018066","IV",4038071,4038515,444
"15059","WBGene00018067","X",9315436,9319180,3744
"15060","WBGene00018068","IV",8329205,8329956,751
"15061","WBGene00018069","IV",8325967,8327062,1095
"15062","WBGene00018070","IV",8300755,8301165,410
"15063","WBGene00018071","IV",8299936,8300647,711
"15064","WBGene00018072","IV",8297197,8299843,2646
"15065","WBGene00018073","IV",8307294,8312946,5652
"15066","WBGene00018074","X",933774,937807,4033
"15067","WBGene00018075","X",924964,932255,7291
"15068","WBGene00018076","X",920200,924511,4311
"15069","WBGene00018077","X",918353,920193,1840
"15070","WBGene00018078","X",913290,914853,1563
"15071","WBGene00018080","IV",4272473,4272899,426
"15072","WBGene00018081","IV",4271215,4271820,605
"15073","WBGene00018082","IV",4269608,4270186,578
"15074","WBGene00018083","IV",4267582,4268236,654
"15075","WBGene00018084","IV",4265524,4266598,1074
"15076","WBGene00018085","IV",4246760,4247486,726
"15077","WBGene00018087","V",9417056,9419298,2242
"15078","WBGene00018088","V",9400327,9401855,1528
"15079","WBGene00018089","V",9401805,9414518,12713
"15080","WBGene00018090","V",9419292,9425762,6470
"15081","WBGene00018091","V",9426852,9427325,473
"15082","WBGene00018092","V",2100062,2103218,3156
"15083","WBGene00018093","V",2091753,2095282,3529
"15084","WBGene00018094","V",2086279,2089819,3540
"15085","WBGene00018096","V",2096072,2097257,1185
"15086","WBGene00018097","V",2097953,2099153,1200
"15087","WBGene00018098","V",2099349,2100051,702
"15088","WBGene00018099","V",2090669,2091735,1066
"15089","WBGene00018100","II",1771647,1774955,3308
"15090","WBGene00018101","II",1767802,1777394,9592
"15091","WBGene00018102","II",1763372,1766555,3183
"15092","WBGene00018103","II",1761839,1762906,1067
"15093","WBGene00018104","II",1758326,1760667,2341
"15094","WBGene00018105","II",1744483,1745859,1376
"15095","WBGene00018106","II",1749825,1750686,861
"15096","WBGene00018107","II",1752749,1753090,341
"15097","WBGene00018108","II",1756820,1757761,941
"15098","WBGene00018109","II",1753526,1754439,913
"15099","WBGene00018110","V",1794518,1797451,2933
"15100","WBGene00018111","V",1788511,1793250,4739
"15101","WBGene00018112","V",1778325,1779196,871
"15102","WBGene00018113","V",1779657,1782022,2365
"15103","WBGene00018114","V",1799726,1803143,3417
"15104","WBGene00018115","V",1773826,1774918,1092
"15105","WBGene00018117","IV",5290847,5293689,2842
"15106","WBGene00018118","IV",5274503,5276115,1612
"15107","WBGene00018119","IV",5272818,5274156,1338
"15108","WBGene00018120","IV",5269090,5269626,536
"15109","WBGene00018121","IV",5266774,5267603,829
"15110","WBGene00018122","IV",5258685,5259985,1300
"15111","WBGene00018123","IV",5257020,5258352,1332
"15112","WBGene00018124","IV",5253407,5254817,1410
"15113","WBGene00018125","IV",5255912,5256792,880
"15114","WBGene00018127","IV",5262786,5264433,1647
"15115","WBGene00018130","IV",5268049,5278070,10021
"15116","WBGene00018131","III",6723389,6725711,2322
"15117","WBGene00018132","III",6722454,6723284,830
"15118","WBGene00018133","III",6718570,6720487,1917
"15119","WBGene00018134","III",6713583,6718022,4439
"15120","WBGene00018135","III",6711869,6713191,1322
"15121","WBGene00018136","III",6705815,6707198,1383
"15122","WBGene00018137","III",6720415,6722258,1843
"15123","WBGene00018138","V",2872465,2875600,3135
"15124","WBGene00018139","V",2884711,2886425,1714
"15125","WBGene00018140","V",2875734,2877609,1875
"15126","WBGene00018141","IV",3889263,3892563,3300
"15127","WBGene00018142","IV",3885665,3888836,3171
"15128","WBGene00018143","IV",3881852,3884683,2831
"15129","WBGene00018144","IV",3867147,3871842,4695
"15130","WBGene00018145","IV",3871829,3874416,2587
"15131","WBGene00018146","IV",3875410,3878372,2962
"15132","WBGene00018148","IV",3878547,3881187,2640
"15133","WBGene00018149","III",7184348,7187868,3520
"15134","WBGene00018150","III",7181970,7184049,2079
"15135","WBGene00018151","III",7180730,7181925,1195
"15136","WBGene00018152","III",7167838,7170990,3152
"15137","WBGene00018153","III",7187841,7188430,589
"15138","WBGene00018154","III",7196225,7232172,35947
"15139","WBGene00018155","III",7185037,7185573,536
"15140","WBGene00018156","I",6421978,6425794,3816
"15141","WBGene00018157","I",6425793,6428942,3149
"15142","WBGene00018158","I",6429525,6431586,2061
"15143","WBGene00018159","I",1442048,1443942,1894
"15144","WBGene00018160","IV",6579840,6582676,2836
"15145","WBGene00018161","IV",6582703,6585571,2868
"15146","WBGene00018162","IV",6594655,6594954,299
"15147","WBGene00018163","IV",6596108,6597398,1290
"15148","WBGene00018164","IV",6601678,6602443,765
"15149","WBGene00018165","IV",6599882,6600491,609
"15150","WBGene00018166","IV",6599198,6599492,294
"15151","WBGene00018167","IV",6598234,6598531,297
"15152","WBGene00018168","IV",6592666,6594529,1863
"15153","WBGene00018169","IV",6591679,6592081,402
"15154","WBGene00018170","IV",6590734,6591126,392
"15155","WBGene00018172","X",6698533,6700826,2293
"15156","WBGene00018173","X",6693735,6695662,1927
"15157","WBGene00018174","X",6674869,6679848,4979
"15158","WBGene00018175","X",6684440,6690085,5645
"15159","WBGene00018176","X",6695820,6698337,2517
"15160","WBGene00018178","V",8376117,8377944,1827
"15161","WBGene00018179","V",8360092,8361986,1894
"15162","WBGene00018180","V",8351671,8353085,1414
"15163","WBGene00018181","V",8358203,8359163,960
"15164","WBGene00018182","V",8374027,8375474,1447
"15165","WBGene00018184","X",16471058,16474819,3761
"15166","WBGene00018186","X",16451942,16452559,617
"15167","WBGene00018187","X",16446197,16451336,5139
"15168","WBGene00018188","X",16437745,16440501,2756
"15169","WBGene00018189","V",4095040,4100541,5501
"15170","WBGene00018190","V",4081228,4083052,1824
"15171","WBGene00018191","X",17567643,17571923,4280
"15172","WBGene00018192","X",17578692,17579111,419
"15173","WBGene00018193","X",4834881,4853065,18184
"15174","WBGene00018194","II",3318302,3320358,2056
"15175","WBGene00018195","II",3296908,3298027,1119
"15176","WBGene00018196","II",3282653,3287158,4505
"15177","WBGene00018198","II",3311926,3312547,621
"15178","WBGene00018199","II",3306144,3307505,1361
"15179","WBGene00018200","II",3295414,3296582,1168
"15180","WBGene00018201","II",3298395,3299589,1194
"15181","WBGene00018202","X",16894884,16895916,1032
"15182","WBGene00018203","X",16891991,16893148,1157
"15183","WBGene00018204","X",16902391,16904332,1941
"15184","WBGene00018205","X",16913031,16913769,738
"15185","WBGene00018206","V",4742427,4745373,2946
"15186","WBGene00018207","V",4737834,4741169,3335
"15187","WBGene00018208","V",4731911,4734723,2812
"15188","WBGene00018209","V",4724753,4726726,1973
"15189","WBGene00018210","V",4722618,4724621,2003
"15190","WBGene00018211","V",4710764,4714911,4147
"15191","WBGene00018212","X",834778,837758,2980
"15192","WBGene00018213","X",830258,833760,3502
"15193","WBGene00018214","X",838144,841493,3349
"15194","WBGene00018215","X",845731,851516,5785
"15195","WBGene00018216","V",7891530,7895518,3988
"15196","WBGene00018217","V",7878914,7881403,2489
"15197","WBGene00018218","V",7877490,7878514,1024
"15198","WBGene00018219","V",7875756,7876789,1033
"15199","WBGene00018221","V",7892112,7893862,1750
"15200","WBGene00018222","V",7895465,7899861,4396
"15201","WBGene00018223","II",2520965,2522044,1079
"15202","WBGene00018224","II",2522628,2524475,1847
"15203","WBGene00018225","X",8375288,8377304,2016
"15204","WBGene00018226","X",8368534,8371609,3075
"15205","WBGene00018227","X",8372206,8374474,2268
"15206","WBGene00018228","V",3572713,3574157,1444
"15207","WBGene00018230","I",2642724,2643778,1054
"15208","WBGene00018231","I",2638649,2639419,770
"15209","WBGene00018232","I",2645273,2657241,11968
"15210","WBGene00018233","I",2650737,2651711,974
"15211","WBGene00018234","II",3617812,3618621,809
"15212","WBGene00018235","II",3610823,3615352,4529
"15213","WBGene00018236","X",3262900,3264161,1261
"15214","WBGene00018237","X",3235768,3243624,7856
"15215","WBGene00018238","X",3243886,3245980,2094
"15216","WBGene00018239","III",192104,194349,2245
"15217","WBGene00018240","III",190986,191981,995
"15218","WBGene00018241","III",183231,184915,1684
"15219","WBGene00018242","III",179542,180140,598
"15220","WBGene00018243","III",165690,166285,595
"15221","WBGene00018244","III",163598,164875,1277
"15222","WBGene00018245","III",170337,171727,1390
"15223","WBGene00018246","III",174609,175833,1224
"15224","WBGene00018247","III",171887,172734,847
"15225","WBGene00018248","III",176111,177815,1704
"15226","WBGene00018249","II",6179867,6184684,4817
"15227","WBGene00018250","II",6173568,6174863,1295
"15228","WBGene00018251","II",6171507,6173159,1652
"15229","WBGene00018252","II",6187010,6187722,712
"15230","WBGene00018253","III",6057055,6058444,1389
"15231","WBGene00018254","III",6040334,6045125,4791
"15232","WBGene00018255","III",6049316,6055448,6132
"15233","WBGene00018256","IV",684497,688336,3839
"15234","WBGene00018257","X",6823890,6825862,1972
"15235","WBGene00018258","X",6831251,6835266,4015
"15236","WBGene00018259","X",6835487,6836115,628
"15237","WBGene00018260","V",2250545,2252553,2008
"15238","WBGene00018261","V",2245015,2247015,2000
"15239","WBGene00018262","V",2242778,2244871,2093
"15240","WBGene00018264","V",2247472,2249335,1863
"15241","WBGene00018265","V",2257420,2259913,2493
"15242","WBGene00018266","V",2262489,2264634,2145
"15243","WBGene00018267","II",4752388,4752942,554
"15244","WBGene00018268","II",4749968,4751822,1854
"15245","WBGene00018269","II",4742128,4745280,3152
"15246","WBGene00018270","II",4740412,4741616,1204
"15247","WBGene00018271","II",4737617,4739906,2289
"15248","WBGene00018272","II",4735113,4736850,1737
"15249","WBGene00018273","II",4730060,4731268,1208
"15250","WBGene00018274","II",4716047,4718536,2489
"15251","WBGene00018275","II",4731178,4733949,2771
"15252","WBGene00018277","X",6870566,6871087,521
"15253","WBGene00018278","X",6873359,6874823,1464
"15254","WBGene00018279","X",6880909,6881571,662
"15255","WBGene00018280","X",6882493,6885277,2784
"15256","WBGene00018281","X",8378557,8382700,4143
"15257","WBGene00018282","X",8382706,8384945,2239
"15258","WBGene00018283","X",8403539,8408367,4828
"15259","WBGene00018284","V",8622614,8623563,949
"15260","WBGene00018285","V",8607800,8615841,8041
"15261","WBGene00018286","V",8603480,8605469,1989
"15262","WBGene00018288","V",8597851,8599292,1441
"15263","WBGene00018289","V",8600547,8601520,973
"15264","WBGene00018290","V",8605088,8606141,1053
"15265","WBGene00018291","V",8610870,8611268,398
"15266","WBGene00018292","V",8619925,8621348,1423
"15267","WBGene00018293","V",8626900,8629129,2229
"15268","WBGene00018294","V",8629223,8631325,2102
"15269","WBGene00018295","V",8631871,8635675,3804
"15270","WBGene00018296","V",4654555,4655105,550
"15271","WBGene00018297","V",4647665,4648241,576
"15272","WBGene00018298","II",6765034,6765888,854
"15273","WBGene00018299","II",6758885,6760385,1500
"15274","WBGene00018300","II",6756532,6758934,2402
"15275","WBGene00018301","II",6746704,6748586,1882
"15276","WBGene00018302","II",6742914,6744267,1353
"15277","WBGene00018303","II",6748632,6749522,890
"15278","WBGene00018304","II",6760684,6775176,14492
"15279","WBGene00018305","II",6741663,6742819,1156
"15280","WBGene00018307","X",16841105,16842975,1870
"15281","WBGene00018309","X",16829493,16832740,3247
"15282","WBGene00018310","X",16833588,16836404,2816
"15283","WBGene00018311","X",16843355,16845024,1669
"15284","WBGene00018312","V",833668,835463,1795
"15285","WBGene00018313","V",826411,828761,2350
"15286","WBGene00018314","IV",5382909,5383930,1021
"15287","WBGene00018315","IV",5381634,5382470,836
"15288","WBGene00018316","IV",5369797,5374673,4876
"15289","WBGene00018317","IV",5364559,5366751,2192
"15290","WBGene00018318","IV",5360891,5362161,1270
"15291","WBGene00018319","IV",5356538,5364306,7768
"15292","WBGene00018321","IV",5366867,5368866,1999
"15293","WBGene00018322","IV",5385320,5386080,760
"15294","WBGene00018323","IV",3355057,3357551,2494
"15295","WBGene00018324","IV",3341470,3341939,469
"15296","WBGene00018325","IV",3320013,3324950,4937
"15297","WBGene00018326","IV",3327481,3329645,2164
"15298","WBGene00018327","IV",3330826,3331791,965
"15299","WBGene00018328","IV",3334042,3336868,2826
"15300","WBGene00018329","IV",3339792,3340953,1161
"15301","WBGene00018330","IV",3342519,3350027,7508
"15302","WBGene00018332","IV",8617285,8618153,868
"15303","WBGene00018333","IV",8615022,8615871,849
"15304","WBGene00018334","IV",8612363,8614683,2320
"15305","WBGene00018335","IV",8609239,8611595,2356
"15306","WBGene00018336","IV",8616006,8617147,1141
"15307","WBGene00018337","IV",8618244,8618788,544
"15308","WBGene00018338","IV",8637387,8638861,1474
"15309","WBGene00018339","III",6173305,6176171,2866
"15310","WBGene00018340","III",6154844,6157758,2914
"15311","WBGene00018341","III",6171147,6172800,1653
"15312","WBGene00018342","III",6176148,6176861,713
"15313","WBGene00018343","III",6177916,6178686,770
"15314","WBGene00018344","IV",7305628,7308350,2722
"15315","WBGene00018345","IV",7286182,7287526,1344
"15316","WBGene00018346","IV",7288074,7292127,4053
"15317","WBGene00018347","IV",7292536,7294221,1685
"15318","WBGene00018348","IV",7308486,7309057,571
"15319","WBGene00018349","IV",7314371,7317163,2792
"15320","WBGene00018350","IV",7320734,7326663,5929
"15321","WBGene00018351","II",2422207,2425837,3630
"15322","WBGene00018352","II",2419472,2420794,1322
"15323","WBGene00018353","II",2409643,2412741,3098
"15324","WBGene00018354","II",2416101,2417971,1870
"15325","WBGene00018355","II",2426372,2429944,3572
"15326","WBGene00018356","IV",8136325,8139087,2762
"15327","WBGene00018357","IV",8130561,8132213,1652
"15328","WBGene00018358","IV",8123105,8127214,4109
"15329","WBGene00018359","IV",8119090,8121340,2250
"15330","WBGene00018360","IV",8115762,8118445,2683
"15331","WBGene00018361","IV",8128940,8130256,1316
"15332","WBGene00018362","III",783714,786092,2378
"15333","WBGene00018363","III",761779,762392,613
"15334","WBGene00018364","III",778253,783303,5050
"15335","WBGene00018365","III",771577,772819,1242
"15336","WBGene00018366","III",8490624,8491097,473
"15337","WBGene00018367","III",8484153,8488365,4212
"15338","WBGene00018369","III",8467035,8478377,11342
"15339","WBGene00018370","III",8478382,8480455,2073
"15340","WBGene00018371","III",8488344,8490347,2003
"15341","WBGene00018373","X",16638226,16662823,24597
"15342","WBGene00018374","X",16665116,16674732,9616
"15343","WBGene00018375","X",4793266,4796158,2892
"15344","WBGene00018376","X",4783780,4790323,6543
"15345","WBGene00018377","X",4777512,4782297,4785
"15346","WBGene00018378","II",2357095,2358278,1183
"15347","WBGene00018379","II",2354776,2355972,1196
"15348","WBGene00018380","II",2353312,2354373,1061
"15349","WBGene00018381","II",2347015,2350030,3015
"15350","WBGene00018382","II",2345118,2346028,910
"15351","WBGene00018383","II",2342433,2343925,1492
"15352","WBGene00018384","II",2335933,2337696,1763
"15353","WBGene00018385","II",2332520,2334338,1818
"15354","WBGene00018386","II",2337897,2340746,2849
"15355","WBGene00018387","II",2350216,2351657,1441
"15356","WBGene00018388","II",2358801,2363773,4972
"15357","WBGene00018389","II",2365573,2366720,1147
"15358","WBGene00018390","II",7375280,7377580,2300
"15359","WBGene00018391","II",7374501,7375237,736
"15360","WBGene00018392","II",7358893,7363247,4354
"15361","WBGene00018393","II",7363216,7364107,891
"15362","WBGene00018394","II",7366591,7369049,2458
"15363","WBGene00018395","II",7372594,7374172,1578
"15364","WBGene00018397","II",7369251,7370309,1058
"15365","WBGene00018398","V",8017947,8021715,3768
"15366","WBGene00018399","V",8023195,8024940,1745
"15367","WBGene00018400","V",8026691,8028789,2098
"15368","WBGene00018402","V",9318311,9320995,2684
"15369","WBGene00018403","V",9305416,9310926,5510
"15370","WBGene00018404","V",9303326,9304622,1296
"15371","WBGene00018405","V",9297632,9302158,4526
"15372","WBGene00018406","V",9321503,9322905,1402
"15373","WBGene00018407","III",8022463,8025195,2732
"15374","WBGene00018408","III",8013753,8016538,2785
"15375","WBGene00018409","III",8028133,8029649,1516
"15376","WBGene00018410","III",8029858,8031063,1205
"15377","WBGene00018411","III",8031413,8033727,2314
"15378","WBGene00018412","V",6622268,6624694,2426
"15379","WBGene00018413","V",2236162,2237937,1775
"15380","WBGene00018414","V",2215724,2218091,2367
"15381","WBGene00018415","V",2212899,2214460,1561
"15382","WBGene00018417","III",8827358,8829305,1947
"15383","WBGene00018418","III",8832479,8838424,5945
"15384","WBGene00018419","III",8844494,8845214,720
"15385","WBGene00018420","III",8845856,8848486,2630
"15386","WBGene00018421","III",8848582,8849877,1295
"15387","WBGene00018422","III",8849994,8850532,538
"15388","WBGene00018423","III",8829493,8831109,1616
"15389","WBGene00018424","V",5770456,5771767,1311
"15390","WBGene00018425","V",5771945,5772497,552
"15391","WBGene00018426","V",5772831,5777034,4203
"15392","WBGene00018427","V",5778818,5780947,2129
"15393","WBGene00018428","V",5781317,5782787,1470
"15394","WBGene00018429","V",5782893,5785471,2578
"15395","WBGene00018430","V",5785959,5790507,4548
"15396","WBGene00018431","V",5791230,5792122,892
"15397","WBGene00018432","II",1739076,1741013,1937
"15398","WBGene00018433","II",1732276,1733291,1015
"15399","WBGene00018434","II",1730403,1732046,1643
"15400","WBGene00018435","II",1728506,1730065,1559
"15401","WBGene00018436","II",1724614,1725692,1078
"15402","WBGene00018437","II",1722770,1724186,1416
"15403","WBGene00018438","II",1715162,1716497,1335
"15404","WBGene00018439","II",1710259,1711417,1158
"15405","WBGene00018440","II",1708432,1709696,1264
"15406","WBGene00018441","II",1706709,1707720,1011
"15407","WBGene00018442","II",1704904,1706476,1572
"15408","WBGene00018443","II",1713238,1714397,1159
"15409","WBGene00018444","II",1718175,1719253,1078
"15410","WBGene00018445","II",1721323,1722423,1100
"15411","WBGene00018446","II",1733718,1736533,2815
"15412","WBGene00018447","II",1736866,1738944,2078
"15413","WBGene00018448","II",1021505,1023528,2023
"15414","WBGene00018452","II",1001703,1002437,734
"15415","WBGene00018454","II",993293,994189,896
"15416","WBGene00018455","II",991600,993638,2038
"15417","WBGene00018456","II",988737,991074,2337
"15418","WBGene00018457","II",999162,999607,445
"15419","WBGene00018458","II",1000437,1001449,1012
"15420","WBGene00018459","II",1004616,1006475,1859
"15421","WBGene00018462","X",8003819,8009400,5581
"15422","WBGene00018463","X",8003733,8004077,344
"15423","WBGene00018465","X",7985979,7988981,3002
"15424","WBGene00018466","X",7976700,7980657,3957
"15425","WBGene00018467","X",7988931,7998229,9298
"15426","WBGene00018468","IV",7588931,7628234,39303
"15427","WBGene00018470","IV",7628206,7629042,836
"15428","WBGene00018471","IV",7630718,7632672,1954
"15429","WBGene00018472","IV",7635655,7641925,6270
"15430","WBGene00018473","IV",7651442,7654295,2853
"15431","WBGene00018474","II",7310348,7313787,3439
"15432","WBGene00018475","II",7308702,7310115,1413
"15433","WBGene00018476","II",7313774,7314181,407
"15434","WBGene00018477","V",8537331,8539614,2283
"15435","WBGene00018478","V",8529519,8532465,2946
"15436","WBGene00018479","V",8525908,8528580,2672
"15437","WBGene00018480","V",8521503,8524555,3052
"15438","WBGene00018481","V",8512689,8513463,774
"15439","WBGene00018482","V",8513577,8518764,5187
"15440","WBGene00018483","V",8519346,8520896,1550
"15441","WBGene00018484","X",7548458,7551218,2760
"15442","WBGene00018485","X",7525571,7527433,1862
"15443","WBGene00018486","X",7537844,7540129,2285
"15444","WBGene00018487","X",7551204,7554426,3222
"15445","WBGene00018488","V",6524989,6532089,7100
"15446","WBGene00018489","V",6520435,6521099,664
"15447","WBGene00018490","V",6518297,6519138,841
"15448","WBGene00018491","V",6515276,6516526,1250
"15449","WBGene00018492","V",6532071,6533074,1003
"15450","WBGene00018493","II",790758,791636,878
"15451","WBGene00018494","II",796274,798412,2138
"15452","WBGene00018495","II",805028,806438,1410
"15453","WBGene00018496","II",812141,813708,1567
"15454","WBGene00018497","II",814452,814866,414
"15455","WBGene00018498","II",818578,820683,2105
"15456","WBGene00018499","II",821408,821614,206
"15457","WBGene00018500","II",822449,822860,411
"15458","WBGene00018501","II",823829,825245,1416
"15459","WBGene00018502","II",808757,811887,3130
"15460","WBGene00018503","II",807372,808070,698
"15461","WBGene00018504","II",803309,803717,408
"15462","WBGene00018505","II",800000,801454,1454
"15463","WBGene00018506","II",788378,789175,797
"15464","WBGene00018507","II",787312,787994,682
"15465","WBGene00018508","I",5627819,5637622,9803
"15466","WBGene00018509","I",5616593,5618682,2089
"15467","WBGene00018510","I",5620751,5623035,2284
"15468","WBGene00018511","I",5624558,5626288,1730
"15469","WBGene00018512","I",5610375,5616402,6027
"15470","WBGene00018513","I",5623019,5624475,1456
"15471","WBGene00018514","X",5791703,5797328,5625
"15472","WBGene00018515","X",5788096,5790345,2249
"15473","WBGene00018516","X",5783405,5786406,3001
"15474","WBGene00018517","X",5797313,5798790,1477
"15475","WBGene00018518","X",7265652,7267893,2241
"15476","WBGene00018519","X",7230330,7238662,8332
"15477","WBGene00018520","X",7245057,7254792,9735
"15478","WBGene00018521","X",7255927,7256978,1051
"15479","WBGene00018522","X",7238666,7242983,4317
"15480","WBGene00018523","X",7258116,7260377,2261
"15481","WBGene00018525","I",3972162,3973703,1541
"15482","WBGene00018528","I",3960968,3962249,1281
"15483","WBGene00018530","I",3965738,3967279,1541
"15484","WBGene00018531","I",3968118,3970474,2356
"15485","WBGene00018532","X",3788026,3788532,506
"15486","WBGene00018533","X",3772763,3778080,5317
"15487","WBGene00018534","X",3763057,3764395,1338
"15488","WBGene00018535","X",3765324,3766626,1302
"15489","WBGene00018536","X",3767795,3768817,1022
"15490","WBGene00018537","X",3769731,3770643,912
"15491","WBGene00018538","X",3778091,3781118,3027
"15492","WBGene00018539","V",3844645,3847151,2506
"15493","WBGene00018540","V",3850127,3851796,1669
"15494","WBGene00018541","V",3852286,3854947,2661
"15495","WBGene00018542","V",3861089,3862933,1844
"15496","WBGene00018543","V",3841859,3844007,2148
"15497","WBGene00018544","V",3856329,3857861,1532
"15498","WBGene00018545","V",3858461,3860243,1782
"15499","WBGene00018547","IV",3989102,4014195,25093
"15500","WBGene00018548","IV",3973349,3975721,2372
"15501","WBGene00018549","IV",3991650,3992240,590
"15502","WBGene00018550","IV",3994902,3995484,582
"15503","WBGene00018551","IV",3998053,3998529,476
"15504","WBGene00018552","V",4285037,4287203,2166
"15505","WBGene00018553","V",4272033,4273329,1296
"15506","WBGene00018554","V",4257957,4260190,2233
"15507","WBGene00018555","V",4261485,4264616,3131
"15508","WBGene00018556","V",4266375,4268313,1938
"15509","WBGene00018557","V",4269486,4271358,1872
"15510","WBGene00018558","V",4276034,4278691,2657
"15511","WBGene00018559","V",4279848,4281799,1951
"15512","WBGene00018560","III",6298461,6299338,877
"15513","WBGene00018561","III",6282444,6286231,3787
"15514","WBGene00018562","III",6286629,6287293,664
"15515","WBGene00018563","III",6293247,6296022,2775
"15516","WBGene00018564","III",6299331,6303217,3886
"15517","WBGene00018565","X",9073800,9077724,3924
"15518","WBGene00018566","X",9057652,9061860,4208
"15519","WBGene00018567","X",9046213,9054885,8672
"15520","WBGene00018568","X",9062834,9066591,3757
"15521","WBGene00018569","X",3879782,3893309,13527
"15522","WBGene00018570","X",3885440,3887559,2119
"15523","WBGene00018571","X",3893964,3895677,1713
"15524","WBGene00018572","II",1233236,1252359,19123
"15525","WBGene00018573","II",1262987,1266890,3903
"15526","WBGene00018575","II",1255937,1258353,2416
"15527","WBGene00018576","X",2385765,2392695,6930
"15528","WBGene00018577","X",2382691,2384764,2073
"15529","WBGene00018578","X",2375997,2379060,3063
"15530","WBGene00018579","I",1471227,1479920,8693
"15531","WBGene00018580","I",1465597,1469587,3990
"15532","WBGene00018582","I",6592469,6598928,6459
"15533","WBGene00018585","II",213169,216621,3452
"15534","WBGene00018586","II",217049,220667,3618
"15535","WBGene00018587","X",2180888,2185854,4966
"15536","WBGene00018589","X",2165109,2173849,8740
"15537","WBGene00018590","X",2163384,2164069,685
"15538","WBGene00018591","X",2147614,2149252,1638
"15539","WBGene00018593","X",2173890,2176411,2521
"15540","WBGene00018594","I",5324511,5330222,5711
"15541","WBGene00018595","I",5319720,5321117,1397
"15542","WBGene00018596","I",5314333,5314606,273
"15543","WBGene00018598","I",5317491,5318124,633
"15544","WBGene00018599","I",5318225,5319301,1076
"15545","WBGene00018600","I",5335192,5338646,3454
"15546","WBGene00018601","I",5332249,5332780,531
"15547","WBGene00018602","X",4246554,4247212,658
"15548","WBGene00018603","X",7490408,7493120,2712
"15549","WBGene00018604","X",7495684,7500982,5298
"15550","WBGene00018605","X",7493724,7495591,1867
"15551","WBGene00018606","X",7501236,7502674,1438
"15552","WBGene00018607","X",7507885,7517694,9809
"15553","WBGene00018608","X",7481326,7485038,3712
"15554","WBGene00018609","III",5464381,5467992,3611
"15555","WBGene00018610","III",5461379,5464382,3003
"15556","WBGene00018611","III",5453590,5459516,5926
"15557","WBGene00018612","III",5443167,5446506,3339
"15558","WBGene00018613","III",5446510,5448419,1909
"15559","WBGene00018614","V",636587,637501,914
"15560","WBGene00018615","V",619434,621679,2245
"15561","WBGene00018616","V",622170,622951,781
"15562","WBGene00018617","V",623298,625022,1724
"15563","WBGene00018618","V",625752,626390,638
"15564","WBGene00018619","V",627095,627650,555
"15565","WBGene00018620","V",628059,628623,564
"15566","WBGene00018621","V",634142,634893,751
"15567","WBGene00018622","V",640799,642893,2094
"15568","WBGene00018623","V",643762,646199,2437
"15569","WBGene00018624","V",615576,616728,1152
"15570","WBGene00018625","I",10936819,10940521,3702
"15571","WBGene00018626","I",10921416,10923484,2068
"15572","WBGene00018627","I",10917064,10919095,2031
"15573","WBGene00018628","I",10912913,10915796,2883
"15574","WBGene00018630","I",10906812,10912203,5391
"15575","WBGene00018631","I",10923574,10923944,370
"15576","WBGene00018632","I",10933810,10935553,1743
"15577","WBGene00018634","X",1095547,1097013,1466
"15578","WBGene00018635","IV",7557209,7558749,1540
"15579","WBGene00018636","IV",7548417,7551511,3094
"15580","WBGene00018637","IV",7553532,7554488,956
"15581","WBGene00018639","X",5897342,5902152,4810
"15582","WBGene00018640","X",5890380,5894757,4377
"15583","WBGene00018641","X",5875898,5881716,5818
"15584","WBGene00018643","IV",4117732,4119179,1447
"15585","WBGene00018644","IV",4114833,4114991,158
"15586","WBGene00018645","IV",4119460,4120399,939
"15587","WBGene00018646","IV",4121342,4123166,1824
"15588","WBGene00018647","IV",4123525,4125757,2232
"15589","WBGene00018648","IV",4130503,4134631,4128
"15590","WBGene00018649","IV",4136848,4137567,719
"15591","WBGene00018650","IV",4138408,4139122,714
"15592","WBGene00018651","IV",4140659,4141407,748
"15593","WBGene00018652","IV",4141734,4143019,1285
"15594","WBGene00018653","X",2086057,2086730,673
"15595","WBGene00018654","X",2084375,2085057,682
"15596","WBGene00018655","X",2079836,2081487,1651
"15597","WBGene00018656","X",2074448,2075944,1496
"15598","WBGene00018657","X",2066554,2070441,3887
"15599","WBGene00018658","II",1927879,1928734,855
"15600","WBGene00018659","II",1926462,1927347,885
"15601","WBGene00018660","II",1924759,1925752,993
"15602","WBGene00018661","II",1923140,1923827,687
"15603","WBGene00018662","II",1908161,1909735,1574
"15604","WBGene00018663","II",1912450,1912841,391
"15605","WBGene00018664","II",1913605,1916376,2771
"15606","WBGene00018665","II",1916713,1917958,1245
"15607","WBGene00018666","II",1918319,1919439,1120
"15608","WBGene00018667","II",1919926,1921111,1185
"15609","WBGene00018668","II",1921452,1922744,1292
"15610","WBGene00018669","II",1929149,1930086,937
"15611","WBGene00018670","II",1930190,1930747,557
"15612","WBGene00018671","II",1930991,1934507,3516
"15613","WBGene00018672","III",5326623,5333620,6997
"15614","WBGene00018674","III",5321885,5326345,4460
"15615","WBGene00018675","III",5302218,5306324,4106
"15616","WBGene00018678","IV",1959854,1963240,3386
"15617","WBGene00018679","IV",1953579,1956704,3125
"15618","WBGene00018680","IV",1948191,1953322,5131
"15619","WBGene00018681","IV",1923939,1948040,24101
"15620","WBGene00018682","X",460651,466912,6261
"15621","WBGene00018683","X",446356,450212,3856
"15622","WBGene00018684","X",1949161,1950728,1567
"15623","WBGene00018687","X",1973796,1974523,727
"15624","WBGene00018688","X",1976115,1976701,586
"15625","WBGene00018689","X",1962573,1966188,3615
"15626","WBGene00018690","X",1983714,1984833,1119
"15627","WBGene00018691","X",1955550,1956824,1274
"15628","WBGene00018692","V",8410595,8411831,1236
"15629","WBGene00018693","V",8394800,8396269,1469
"15630","WBGene00018694","V",8379474,8383747,4273
"15631","WBGene00018696","V",8392357,8394383,2026
"15632","WBGene00018697","V",8398145,8402669,4524
"15633","WBGene00018698","V",8411775,8413513,1738
"15634","WBGene00018699","V",8380782,8382950,2168
"15635","WBGene00018700","V",8415687,8444773,29086
"15636","WBGene00018701","X",3089496,3092457,2961
"15637","WBGene00018702","X",3085829,3087345,1516
"15638","WBGene00018703","X",3095434,3099837,4403
"15639","WBGene00018704","X",3100166,3102279,2113
"15640","WBGene00018706","V",1548143,1550701,2558
"15641","WBGene00018707","V",1538364,1541824,3460
"15642","WBGene00018708","V",1542517,1545791,3274
"15643","WBGene00018709","V",1551044,1553102,2058
"15644","WBGene00018710","X",16963869,16972808,8939
"15645","WBGene00018711","X",16944877,16948026,3149
"15646","WBGene00018712","X",16948355,16952113,3758
"15647","WBGene00018713","X",16973227,16976130,2903
"15648","WBGene00018714","X",2572863,2576697,3834
"15649","WBGene00018715","X",2540066,2541053,987
"15650","WBGene00018716","X",2543391,2548028,4637
"15651","WBGene00018717","X",2557976,2559638,1662
"15652","WBGene00018718","X",2559727,2564147,4420
"15653","WBGene00018719","X",2566557,2572653,6096
"15654","WBGene00018720","III",1939546,1943653,4107
"15655","WBGene00018721","III",1945058,1950270,5212
"15656","WBGene00018723","III",1951526,1952032,506
"15657","WBGene00018724","X",8711590,8711911,321
"15658","WBGene00018725","X",8709764,8710137,373
"15659","WBGene00018726","X",8708365,8709370,1005
"15660","WBGene00018727","X",8704309,8707197,2888
"15661","WBGene00018728","X",8697817,8702822,5005
"15662","WBGene00018729","X",8713461,8713952,491
"15663","WBGene00018730","X",8716532,8716929,397
"15664","WBGene00018731","X",8718567,8718905,338
"15665","WBGene00018732","X",8720226,8720758,532
"15666","WBGene00018734","II",1197374,1230782,33408
"15667","WBGene00018735","X",2108982,2111441,2459
"15668","WBGene00018736","X",2105629,2107170,1541
"15669","WBGene00018737","X",2111397,2113103,1706
"15670","WBGene00018738","X",2114629,2118257,3628
"15671","WBGene00018739","X",2123413,2130241,6828
"15672","WBGene00018740","X",2853678,2857603,3925
"15673","WBGene00018741","X",2858022,2862472,4450
"15674","WBGene00018742","X",2865960,2871060,5100
"15675","WBGene00018743","X",2872739,2879619,6880
"15676","WBGene00018744","X",2864211,2865683,1472
"15677","WBGene00018745","II",3912003,3913385,1382
"15678","WBGene00018746","II",3907140,3908478,1338
"15679","WBGene00018747","II",3902860,3904794,1934
"15680","WBGene00018748","II",3900788,3902773,1985
"15681","WBGene00018749","II",3899840,3900783,943
"15682","WBGene00018750","II",3898142,3899663,1521
"15683","WBGene00018751","II",3894841,3896239,1398
"15684","WBGene00018752","II",3891424,3893574,2150
"15685","WBGene00018754","II",3904816,3906620,1804
"15686","WBGene00018755","II",3908491,3910837,2346
"15687","WBGene00018756","II",3919794,3927982,8188
"15688","WBGene00018757","V",1467744,1471105,3361
"15689","WBGene00018758","V",2615790,2618554,2764
"15690","WBGene00018759","V",2607899,2607961,62
"15691","WBGene00018760","V",2592487,2595062,2575
"15692","WBGene00018761","V",2596020,2598930,2910
"15693","WBGene00018762","V",2602153,2603063,910
"15694","WBGene00018763","I",3834115,3837807,3692
"15695","WBGene00018764","I",3830562,3834124,3562
"15696","WBGene00018765","I",3827219,3828143,924
"15697","WBGene00018766","II",2488754,2496641,7887
"15698","WBGene00018767","II",2481921,2483891,1970
"15699","WBGene00018768","II",2480399,2481312,913
"15700","WBGene00018769","II",2473524,2478643,5119
"15701","WBGene00018771","I",137845,144565,6720
"15702","WBGene00018772","I",134337,137282,2945
"15703","WBGene00018773","I",113807,114704,897
"15704","WBGene00018774","I",112285,113721,1436
"15705","WBGene00018776","IV",1297222,1309652,12430
"15706","WBGene00018777","IV",1329162,1339376,10214
"15707","WBGene00018778","IV",1310166,1328241,18075
"15708","WBGene00018779","X",938516,942608,4092
"15709","WBGene00018781","II",2243642,2254323,10681
"15710","WBGene00018782","II",2233540,2243539,9999
"15711","WBGene00018783","II",2220464,2223567,3103
"15712","WBGene00018784","II",2224359,2225708,1349
"15713","WBGene00018785","II",2225817,2232470,6653
"15714","WBGene00018786","I",989671,992181,2510
"15715","WBGene00018787","I",963700,969426,5726
"15716","WBGene00018788","I",969089,976550,7461
"15717","WBGene00018789","I",5008770,5013581,4811
"15718","WBGene00018791","I",5014351,5016260,1909
"15719","WBGene00018792","I",5004924,5006057,1133
"15720","WBGene00018793","III",87559,89243,1684
"15721","WBGene00018794","III",70442,86384,15942
"15722","WBGene00018795","III",86677,87381,704
"15723","WBGene00018797","I",4805607,4809674,4067
"15724","WBGene00018798","I",4800043,4804268,4225
"15725","WBGene00018802","III",5102991,5106955,3964
"15726","WBGene00018803","II",3816686,3818238,1552
"15727","WBGene00018804","II",3812284,3813426,1142
"15728","WBGene00018805","II",3805493,3807053,1560
"15729","WBGene00018806","II",3807096,3808223,1127
"15730","WBGene00018807","II",3814376,3815458,1082
"15731","WBGene00018808","II",3820152,3821312,1160
"15732","WBGene00018809","II",3825661,3827879,2218
"15733","WBGene00018810","II",3829584,3831914,2330
"15734","WBGene00018811","V",4628580,4635263,6683
"15735","WBGene00018812","V",4617938,4628510,10572
"15736","WBGene00018813","V",4635400,4637145,1745
"15737","WBGene00018814","V",4616156,4617766,1610
"15738","WBGene00018815","II",1400405,1401371,966
"15739","WBGene00018816","II",1398761,1400030,1269
"15740","WBGene00018817","II",1368090,1368299,209
"15741","WBGene00018819","II",1368103,1374988,6885
"15742","WBGene00018820","II",1381807,1385380,3573
"15743","WBGene00018821","II",1395004,1398038,3034
"15744","WBGene00018822","II",1380944,1381713,769
"15745","WBGene00018823","V",2810398,2812017,1619
"15746","WBGene00018824","V",2796298,2797010,712
"15747","WBGene00018825","V",2814252,2816056,1804
"15748","WBGene00018826","V",2816883,2818217,1334
"15749","WBGene00018827","III",5680433,5682326,1893
"15750","WBGene00018828","III",5654984,5656994,2010
"15751","WBGene00018829","III",5659889,5661085,1196
"15752","WBGene00018830","III",5677953,5679038,1085
"15753","WBGene00018831","III",5676612,5677890,1278
"15754","WBGene00018833","III",8787092,8792346,5254
"15755","WBGene00018834","III",8800486,8800701,215
"15756","WBGene00018835","III",8806231,8807346,1115
"15757","WBGene00018836","III",8825243,8827228,1985
"15758","WBGene00018837","X",2621274,2664373,43099
"15759","WBGene00018838","X",2634664,2637800,3136
"15760","WBGene00018839","II",6627484,6629270,1786
"15761","WBGene00018840","II",6622189,6623500,1311
"15762","WBGene00018841","II",6625949,6627282,1333
"15763","WBGene00018842","III",7964581,7965840,1259
"15764","WBGene00018844","III",7961596,7962741,1145
"15765","WBGene00018845","III",7970263,7972161,1898
"15766","WBGene00018846","III",7972382,7973386,1004
"15767","WBGene00018847","I",10799623,10806901,7278
"15768","WBGene00018848","I",10793161,10798059,4898
"15769","WBGene00018849","I",10789130,10793152,4022
"15770","WBGene00018850","I",10781442,10782890,1448
"15771","WBGene00018851","I",10784187,10784884,697
"15772","WBGene00018852","I",10785128,10787863,2735
"15773","WBGene00018853","X",1035548,1037046,1498
"15774","WBGene00018854","X",1012715,1017567,4852
"15775","WBGene00018855","X",1023477,1023780,303
"15776","WBGene00018856","X",1024646,1025838,1192
"15777","WBGene00018857","X",1027673,1035286,7613
"15778","WBGene00018859","X",1037023,1038447,1424
"15779","WBGene00018860","X",1038514,1046206,7692
"15780","WBGene00018861","X",1004337,1009412,5075
"15781","WBGene00018862","I",5368478,5372643,4165
"15782","WBGene00018863","I",5365265,5366875,1610
"15783","WBGene00018864","I",5345927,5349657,3730
"15784","WBGene00018865","I",5338922,5342012,3090
"15785","WBGene00018866","I",5349646,5353767,4121
"15786","WBGene00018867","I",5366944,5367829,885
"15787","WBGene00018868","I",4005435,4006019,584
"15788","WBGene00018869","II",5884552,5892664,8112
"15789","WBGene00018870","II",5876811,5877449,638
"15790","WBGene00018871","II",5857080,5858422,1342
"15791","WBGene00018872","II",5867268,5873614,6346
"15792","WBGene00018873","II",5874507,5876101,1594
"15793","WBGene00018874","II",5864182,5865549,1367
"15794","WBGene00018875","X",5489838,5490113,275
"15795","WBGene00018876","X",5488777,5489111,334
"15796","WBGene00018877","X",4732964,4738592,5628
"15797","WBGene00018878","X",4712279,4715080,2801
"15798","WBGene00018879","X",4716244,4720640,4396
"15799","WBGene00018880","X",4722877,4727481,4604
"15800","WBGene00018881","X",8341975,8342286,311
"15801","WBGene00018882","X",8340693,8340986,293
"15802","WBGene00018883","X",8327559,8327900,341
"15803","WBGene00018884","X",8333247,8337948,4701
"15804","WBGene00018885","X",8344700,8346408,1708
"15805","WBGene00018886","X",8348537,8351059,2522
"15806","WBGene00018888","X",2769588,2770060,472
"15807","WBGene00018890","I",5646369,5649656,3287
"15808","WBGene00018891","I",5649756,5653648,3892
"15809","WBGene00018892","I",5653804,5655857,2053
"15810","WBGene00018893","I",5655950,5658118,2168
"15811","WBGene00018894","I",5657980,5658723,743
"15812","WBGene00018895","I",5659450,5661272,1822
"15813","WBGene00018896","I",5667069,5668837,1768
"15814","WBGene00018897","I",5669950,5673352,3402
"15815","WBGene00018898","IV",4360837,4386533,25696
"15816","WBGene00018899","IV",7491771,7493764,1993
"15817","WBGene00018900","IV",7478171,7485523,7352
"15818","WBGene00018901","IV",7475041,7476215,1174
"15819","WBGene00018902","IV",7473517,7474953,1436
"15820","WBGene00018903","IV",7466702,7469832,3130
"15821","WBGene00018904","IV",7476171,7477344,1173
"15822","WBGene00018906","IV",7493843,7497850,4007
"15823","WBGene00018907","IV",7498129,7501437,3308
"15824","WBGene00018908","I",5190142,5195243,5101
"15825","WBGene00018909","I",5182736,5186234,3498
"15826","WBGene00018911","V",2453414,2456147,2733
"15827","WBGene00018918","V",2461320,2464579,3259
"15828","WBGene00018921","I",618160,621490,3330
"15829","WBGene00018923","I",614651,629444,14793
"15830","WBGene00018924","IV",548302,553231,4929
"15831","WBGene00018925","IV",568372,570875,2503
"15832","WBGene00018926","IV",580283,582230,1947
"15833","WBGene00018928","IV",764078,768584,4506
"15834","WBGene00018929","IV",770596,772944,2348
"15835","WBGene00018930","IV",788055,790835,2780
"15836","WBGene00018931","IV",778784,784182,5398
"15837","WBGene00018932","IV",773228,776655,3427
"15838","WBGene00018933","IV",771361,772889,1528
"15839","WBGene00018934","IV",795755,796567,812
"15840","WBGene00018935","IV",794632,795689,1057
"15841","WBGene00018937","X",3531841,3532811,970
"15842","WBGene00018938","X",1386248,1388160,1912
"15843","WBGene00018939","X",1372012,1374630,2618
"15844","WBGene00018940","X",1357771,1358532,761
"15845","WBGene00018941","X",1359720,1362036,2316
"15846","WBGene00018942","X",1362816,1363997,1181
"15847","WBGene00018943","X",1365474,1367516,2042
"15848","WBGene00018944","X",1370543,1370786,243
"15849","WBGene00018945","X",1384318,1384638,320
"15850","WBGene00018946","X",1391800,1393991,2191
"15851","WBGene00018948","III",7311290,7313195,1905
"15852","WBGene00018949","III",7308354,7308975,621
"15853","WBGene00018950","III",7308998,7310773,1775
"15854","WBGene00018951","III",7313149,7314977,1828
"15855","WBGene00018952","III",7315903,7319595,3692
"15856","WBGene00018953","III",7329714,7335316,5602
"15857","WBGene00018954","III",7324940,7329649,4709
"15858","WBGene00018955","I",182079,182772,693
"15859","WBGene00018957","I",178538,182161,3623
"15860","WBGene00018958","I",171340,175989,4649
"15861","WBGene00018959","II",5478618,5480490,1872
"15862","WBGene00018960","II",5475409,5478524,3115
"15863","WBGene00018961","II",5474373,5475475,1102
"15864","WBGene00018963","III",5592135,5594785,2650
"15865","WBGene00018964","III",5587263,5589095,1832
"15866","WBGene00018965","III",5584947,5587110,2163
"15867","WBGene00018966","III",5578435,5581343,2908
"15868","WBGene00018967","III",5589036,5591718,2682
"15869","WBGene00018968","III",5581582,5582411,829
"15870","WBGene00018969","II",4142816,4149678,6862
"15871","WBGene00018970","IV",3926417,3929024,2607
"15872","WBGene00018971","IV",3922165,3925045,2880
"15873","WBGene00018972","IV",3919806,3921613,1807
"15874","WBGene00018973","IV",3915610,3916901,1291
"15875","WBGene00018974","II",1310518,1320437,9919
"15876","WBGene00018975","V",104826,118188,13362
"15877","WBGene00018976","V",64564,83831,19267
"15878","WBGene00018978","I",6148142,6148836,694
"15879","WBGene00018979","I",6145455,6146477,1022
"15880","WBGene00018980","I",6141469,6144386,2917
"15881","WBGene00018981","I",6137994,6138955,961
"15882","WBGene00018982","I",6139216,6140444,1228
"15883","WBGene00018984","X",872517,875948,3431
"15884","WBGene00018985","X",859948,862459,2511
"15885","WBGene00018986","X",862268,863851,1583
"15886","WBGene00018987","X",864925,871089,6164
"15887","WBGene00018988","III",2891762,2892613,851
"15888","WBGene00018989","III",2882304,2884967,2663
"15889","WBGene00018990","III",2874818,2880705,5887
"15890","WBGene00018991","III",2855554,2865497,9943
"15891","WBGene00018992","III",2849066,2855419,6353
"15892","WBGene00018993","I",5735550,5739421,3871
"15893","WBGene00018994","I",5729793,5735842,6049
"15894","WBGene00018995","I",5754312,5760803,6491
"15895","WBGene00018996","III",6962090,6963319,1229
"15896","WBGene00018997","III",6939888,6941736,1848
"15897","WBGene00018998","III",6924097,6928817,4720
"15898","WBGene00018999","III",6933661,6935334,1673
"15899","WBGene00019001","I",6569494,6572598,3104
"15900","WBGene00019002","I",6566173,6568905,2732
"15901","WBGene00019003","I",6562699,6563660,961
"15902","WBGene00019004","I",6558696,6562346,3650
"15903","WBGene00019005","I",6548644,6550447,1803
"15904","WBGene00019006","I",6550536,6552665,2129
"15905","WBGene00019007","I",6552834,6553379,545
"15906","WBGene00019008","I",4848425,4850717,2292
"15907","WBGene00019009","I",4845013,4847336,2323
"15908","WBGene00019010","I",4836187,4844966,8779
"15909","WBGene00019011","I",4830135,4835619,5484
"15910","WBGene00019012","I",4821933,4824811,2878
"15911","WBGene00019013","I",4824921,4826633,1712
"15912","WBGene00019014","X",549363,551392,2029
"15913","WBGene00019015","V",6390463,6392523,2060
"15914","WBGene00019016","V",6389039,6389734,695
"15915","WBGene00019017","V",6401369,6408783,7414
"15916","WBGene00019018","II",6132895,6157176,24281
"15917","WBGene00019019","IV",7970525,7973363,2838
"15918","WBGene00019020","IV",7967363,7969600,2237
"15919","WBGene00019021","IV",7975430,7976406,976
"15920","WBGene00019022","II",5142343,5144021,1678
"15921","WBGene00019023","II",5136717,5138568,1851
"15922","WBGene00019024","II",5146967,5148465,1498
"15923","WBGene00019025","II",5148530,5150853,2323
"15924","WBGene00019026","II",5158566,5158988,422
"15925","WBGene00019027","II",5153119,5154638,1519
"15926","WBGene00019028","II",5155436,5157625,2189
"15927","WBGene00019029","III",1112279,1116374,4095
"15928","WBGene00019030","III",1103224,1111923,8699
"15929","WBGene00019032","V",5927647,5930417,2770
"15930","WBGene00019034","II",1684048,1685091,1043
"15931","WBGene00019035","II",1682518,1683655,1137
"15932","WBGene00019036","II",1679381,1682134,2753
"15933","WBGene00019037","II",1676388,1677439,1051
"15934","WBGene00019038","II",1677449,1679252,1803
"15935","WBGene00019039","II",1686834,1687795,961
"15936","WBGene00019040","II",1688235,1689172,937
"15937","WBGene00019041","II",1689696,1691077,1381
"15938","WBGene00019042","II",1691557,1692907,1350
"15939","WBGene00019043","II",1693296,1694615,1319
"15940","WBGene00019044","II",1694815,1695827,1012
"15941","WBGene00019045","II",1702384,1703463,1079
"15942","WBGene00019046","IV",3470042,3470711,669
"15943","WBGene00019047","IV",3467430,3469828,2398
"15944","WBGene00019048","IV",3463567,3466276,2709
"15945","WBGene00019049","IV",3444914,3446528,1614
"15946","WBGene00019050","IV",3455893,3457113,1220
"15947","WBGene00019051","IV",3453608,3454788,1180
"15948","WBGene00019053","IV",1343679,1344798,1119
"15949","WBGene00019054","IV",1341215,1342860,1645
"15950","WBGene00019055","IV",6249874,6253083,3209
"15951","WBGene00019057","IV",6233246,6235666,2420
"15952","WBGene00019058","IV",6231023,6232607,1584
"15953","WBGene00019059","IV",6235977,6237543,1566
"15954","WBGene00019060","IV",6245341,6248492,3151
"15955","WBGene00019061","II",6383645,6384692,1047
"15956","WBGene00019062","II",6387525,6388242,717
"15957","WBGene00019063","II",6389275,6391295,2020
"15958","WBGene00019064","V",8108970,8118131,9161
"15959","WBGene00019065","V",8104773,8105612,839
"15960","WBGene00019066","V",8099621,8100484,863
"15961","WBGene00019067","IV",930492,935699,5207
"15962","WBGene00019068","IV",940017,945653,5636
"15963","WBGene00019069","IV",924936,939667,14731
"15964","WBGene00019070","IV",919990,920808,818
"15965","WBGene00019072","IV",909415,911196,1781
"15966","WBGene00019074","I",5520389,5529763,9374
"15967","WBGene00019075","I",5512048,5514557,2509
"15968","WBGene00019076","I",5505377,5507023,1646
"15969","WBGene00019077","I",5507123,5509288,2165
"15970","WBGene00019079","I",5509473,5511705,2232
"15971","WBGene00019080","I",5517347,5518563,1216
"15972","WBGene00019081","I",5522396,5525340,2944
"15973","WBGene00019082","I",5530618,5533710,3092
"15974","WBGene00019083","I",5542630,5543334,704
"15975","WBGene00019084","II",5014699,5015324,625
"15976","WBGene00019085","II",5008341,5011179,2838
"15977","WBGene00019086","II",5005081,5008068,2987
"15978","WBGene00019087","II",4999520,5003806,4286
"15979","WBGene00019089","V",2000418,2004329,3911
"15980","WBGene00019090","V",2015836,2016541,705
"15981","WBGene00019091","V",2024703,2027887,3184
"15982","WBGene00019092","V",2022674,2024710,2036
"15983","WBGene00019094","V",2012206,2013333,1127
"15984","WBGene00019095","V",2008609,2011620,3011
"15985","WBGene00019096","V",2005057,2006804,1747
"15986","WBGene00019097","V",3633341,3634683,1342
"15987","WBGene00019098","V",3624445,3627044,2599
"15988","WBGene00019099","V",3629473,3631691,2218
"15989","WBGene00019100","V",3641858,3644243,2385
"15990","WBGene00019101","V",3644745,3647954,3209
"15991","WBGene00019102","X",16603364,16609524,6160
"15992","WBGene00019103","V",3045144,3052149,7005
"15993","WBGene00019104","V",3028294,3029583,1289
"15994","WBGene00019105","V",3024520,3027931,3411
"15995","WBGene00019106","V",3029655,3032443,2788
"15996","WBGene00019107","V",3035130,3037689,2559
"15997","WBGene00019108","V",3037812,3039382,1570
"15998","WBGene00019109","V",9001475,9003100,1625
"15999","WBGene00019111","V",8995101,8996664,1563
"16000","WBGene00019112","V",8991789,8993142,1353
"16001","WBGene00019113","V",8990244,8991664,1420
"16002","WBGene00019114","V",8968737,8970552,1815
"16003","WBGene00019115","V",8970744,8972364,1620
"16004","WBGene00019116","V",8973182,8974943,1761
"16005","WBGene00019117","V",8975698,8977465,1767
"16006","WBGene00019118","II",5654515,5657371,2856
"16007","WBGene00019119","II",5638381,5639752,1371
"16008","WBGene00019120","II",5631357,5633284,1927
"16009","WBGene00019121","II",5622895,5624866,1971
"16010","WBGene00019122","II",5627244,5630048,2804
"16011","WBGene00019123","II",5634528,5636926,2398
"16012","WBGene00019124","II",5640063,5647042,6979
"16013","WBGene00019125","II",5647154,5647884,730
"16014","WBGene00019126","II",5648000,5649074,1074
"16015","WBGene00019127","II",5911324,5916910,5586
"16016","WBGene00019128","II",5896170,5904588,8418
"16017","WBGene00019129","II",5906545,5907613,1068
"16018","WBGene00019130","II",2504878,2514846,9968
"16019","WBGene00019131","II",2514977,2516097,1120
"16020","WBGene00019132","II",2035702,2039388,3686
"16021","WBGene00019133","II",2019654,2022596,2942
"16022","WBGene00019134","II",2017450,2018292,842
"16023","WBGene00019135","II",2010205,2011449,1244
"16024","WBGene00019136","II",2003377,2008250,4873
"16025","WBGene00019137","II",2011485,2012838,1353
"16026","WBGene00019138","II",2025642,2026610,968
"16027","WBGene00019139","II",2027612,2028812,1200
"16028","WBGene00019140","II",2029232,2030467,1235
"16029","WBGene00019141","II",2030750,2031952,1202
"16030","WBGene00019142","II",2032569,2033243,674
"16031","WBGene00019143","X",2578211,2580574,2363
"16032","WBGene00019144","X",2584539,2585739,1200
"16033","WBGene00019145","X",1573220,1574010,790
"16034","WBGene00019146","X",1568678,1572854,4176
"16035","WBGene00019148","X",8507876,8514126,6250
"16036","WBGene00019149","X",8514088,8517830,3742
"16037","WBGene00019150","III",2366884,2372655,5771
"16038","WBGene00019151","IV",5896623,5899112,2489
"16039","WBGene00019152","IV",5895490,5895888,398
"16040","WBGene00019153","IV",5891565,5893329,1764
"16041","WBGene00019154","IV",5885835,5889821,3986
"16042","WBGene00019155","IV",5882707,5884529,1822
"16043","WBGene00019156","IV",5899586,5903355,3769
"16044","WBGene00019157","III",2947091,2960574,13483
"16045","WBGene00019158","III",2962170,2965634,3464
"16046","WBGene00019159","III",2967048,2968932,1884
"16047","WBGene00019160","X",5904627,5905346,719
"16048","WBGene00019162","IV",4810934,4811983,1049
"16049","WBGene00019163","IV",4807430,4809487,2057
"16050","WBGene00019164","IV",4817388,4821131,3743
"16051","WBGene00019165","IV",4825488,4827281,1793
"16052","WBGene00019166","IV",4827853,4846893,19040
"16053","WBGene00019167","III",3091850,3100468,8618
"16054","WBGene00019168","III",3070523,3085268,14745
"16055","WBGene00019169","III",3052916,3057550,4634
"16056","WBGene00019170","III",3061192,3064328,3136
"16057","WBGene00019171","III",3059598,3059943,345
"16058","WBGene00019174","III",3226352,3230652,4300
"16059","WBGene00019176","IV",6143183,6149923,6740
"16060","WBGene00019177","V",3815226,3816543,1317
"16061","WBGene00019178","V",3812596,3813363,767
"16062","WBGene00019179","V",3810786,3811634,848
"16063","WBGene00019180","V",3813737,3831659,17922
"16064","WBGene00019181","V",3839149,3841527,2378
"16065","WBGene00019182","III",15720,17332,1612
"16066","WBGene00019183","III",3321,11940,8619
"16067","WBGene00019184","III",17316,19675,2359
"16068","WBGene00019185","III",20531,23962,3431
"16069","WBGene00019187","X",1621481,1625247,3766
"16070","WBGene00019188","X",1604906,1619115,14209
"16071","WBGene00019189","X",17710286,17711674,1388
"16072","WBGene00019190","II",6061977,6067166,5189
"16073","WBGene00019192","II",6071386,6073251,1865
"16074","WBGene00019193","II",6077700,6078230,530
"16075","WBGene00019194","II",6077904,6078235,331
"16076","WBGene00019196","III",7463797,7465238,1441
"16077","WBGene00019197","III",7467574,7468676,1102
"16078","WBGene00019198","III",2402070,2406332,4262
"16079","WBGene00019199","III",2376193,2384840,8647
"16080","WBGene00019200","III",2384892,2386579,1687
"16081","WBGene00019202","V",8932618,8934265,1647
"16082","WBGene00019203","V",8923088,8923936,848
"16083","WBGene00019204","V",8923900,8928978,5078
"16084","WBGene00019205","IV",6040976,6074507,33531
"16085","WBGene00019207","II",1504566,1509831,5265
"16086","WBGene00019208","II",1484094,1485764,1670
"16087","WBGene00019209","II",1489930,1500330,10400
"16088","WBGene00019211","X",17622778,17640743,17965
"16089","WBGene00019212","III",2636405,2642848,6443
"16090","WBGene00019213","IV",6830145,6833464,3319
"16091","WBGene00019214","IV",6827777,6829490,1713
"16092","WBGene00019215","IV",6824894,6826763,1869
"16093","WBGene00019216","II",4355633,4358844,3211
"16094","WBGene00019217","II",4340151,4350984,10833
"16095","WBGene00019218","II",4335707,4338424,2717
"16096","WBGene00019219","II",4329023,4334484,5461
"16097","WBGene00019220","II",4326720,4328284,1564
"16098","WBGene00019221","II",4323256,4324187,931
"16099","WBGene00019222","II",4353221,4355317,2096
"16100","WBGene00019224","V",4451049,4454734,3685
"16101","WBGene00019225","X",6784411,6787296,2885
"16102","WBGene00019226","X",6783157,6784197,1040
"16103","WBGene00019227","X",6787256,6789578,2322
"16104","WBGene00019228","IV",8718453,8719248,795
"16105","WBGene00019229","IV",8715247,8717881,2634
"16106","WBGene00019230","IV",8697736,8702699,4963
"16107","WBGene00019231","IV",8703043,8705606,2563
"16108","WBGene00019232","V",4908868,4911399,2531
"16109","WBGene00019233","V",4906253,4908258,2005
"16110","WBGene00019234","V",4903930,4905918,1988
"16111","WBGene00019235","V",4901374,4903010,1636
"16112","WBGene00019236","V",4911712,4912381,669
"16113","WBGene00019237","V",9444050,9460639,16589
"16114","WBGene00019239","V",917817,925945,8128
"16115","WBGene00019240","V",911776,916315,4539
"16116","WBGene00019241","V",904950,911214,6264
"16117","WBGene00019242","V",715833,719831,3998
"16118","WBGene00019243","V",722695,723827,1132
"16119","WBGene00019244","V",687684,690004,2320
"16120","WBGene00019245","I",6851372,6854140,2768
"16121","WBGene00019246","I",6850409,6851356,947
"16122","WBGene00019247","I",6847511,6849923,2412
"16123","WBGene00019248","I",6845175,6846952,1777
"16124","WBGene00019249","X",5216363,5219095,2732
"16125","WBGene00019250","X",5205760,5216230,10470
"16126","WBGene00019251","X",5220406,5222042,1636
"16127","WBGene00019253","I",4123481,4124723,1242
"16128","WBGene00019254","I",4116851,4118163,1312
"16129","WBGene00019255","IV",5934346,5937497,3151
"16130","WBGene00019257","IV",5917326,5921446,4120
"16131","WBGene00019259","IV",6757311,6762609,5298
"16132","WBGene00019260","III",2847016,2848582,1566
"16133","WBGene00019261","III",2842044,2845197,3153
"16134","WBGene00019262","V",6804512,6806440,1928
"16135","WBGene00019263","IV",5725600,5729727,4127
"16136","WBGene00019264","IV",5729658,5731738,2080
"16137","WBGene00019265","X",8607174,8607753,579
"16138","WBGene00019266","X",8604061,8605058,997
"16139","WBGene00019267","X",1396353,1396551,198
"16140","WBGene00019268","II",5854422,5857172,2750
"16141","WBGene00019269","II",5850362,5852038,1676
"16142","WBGene00019270","II",5845777,5850308,4531
"16143","WBGene00019272","X",1311605,1316634,5029
"16144","WBGene00019273","II",6674268,6679363,5095
"16145","WBGene00019274","V",4204721,4209303,4582
"16146","WBGene00019275","V",4199485,4203696,4211
"16147","WBGene00019276","V",4195577,4199399,3822
"16148","WBGene00019277","II",326262,328224,1962
"16149","WBGene00019278","II",314125,315786,1661
"16150","WBGene00019279","II",307545,313969,6424
"16151","WBGene00019280","II",302405,303659,1254
"16152","WBGene00019281","II",299984,300767,783
"16153","WBGene00019282","II",309479,312210,2731
"16154","WBGene00019284","II",321442,323098,1656
"16155","WBGene00019285","II",328564,332513,3949
"16156","WBGene00019286","X",8618418,8619756,1338
"16157","WBGene00019287","X",8620570,8625240,4670
"16158","WBGene00019288","II",7435258,7435785,527
"16159","WBGene00019289","II",7425939,7434282,8343
"16160","WBGene00019290","II",7411075,7412030,955
"16161","WBGene00019292","X",8219728,8220064,336
"16162","WBGene00019293","X",8224391,8224902,511
"16163","WBGene00019294","X",8228068,8231934,3866
"16164","WBGene00019295","IV",5941926,5943998,2072
"16165","WBGene00019296","IV",5937445,5939230,1785
"16166","WBGene00019297","IV",5961690,5962269,579
"16167","WBGene00019298","IV",292429,298280,5851
"16168","WBGene00019299","IV",311512,313697,2185
"16169","WBGene00019300","IV",307505,311232,3727
"16170","WBGene00019301","III",8769502,8776141,6639
"16171","WBGene00019302","III",8770756,8771225,469
"16172","WBGene00019303","III",8771334,8771951,617
"16173","WBGene00019304","III",8777890,8780012,2122
"16174","WBGene00019305","III",8776183,8777895,1712
"16175","WBGene00019306","II",1083159,1083929,770
"16176","WBGene00019309","II",1072406,1074012,1606
"16177","WBGene00019310","II",1062024,1063208,1184
"16178","WBGene00019311","II",1057212,1059280,2068
"16179","WBGene00019312","II",1055024,1055760,736
"16180","WBGene00019313","II",1059664,1060802,1138
"16181","WBGene00019314","II",1065566,1066998,1432
"16182","WBGene00019315","II",1074751,1075505,754
"16183","WBGene00019316","II",1070640,1071490,850
"16184","WBGene00019317","X",2496180,2501001,4821
"16185","WBGene00019318","X",2483263,2488296,5033
"16186","WBGene00019319","X",2477107,2478765,1658
"16187","WBGene00019320","X",2480755,2482911,2156
"16188","WBGene00019321","X",2501003,2508549,7546
"16189","WBGene00019322","I",6836375,6838140,1765
"16190","WBGene00019323","I",6814511,6834687,20176
"16191","WBGene00019324","I",6804788,6810451,5663
"16192","WBGene00019326","III",845842,850586,4744
"16193","WBGene00019327","III",833858,835808,1950
"16194","WBGene00019328","III",823222,826408,3186
"16195","WBGene00019329","III",828590,832277,3687
"16196","WBGene00019331","III",835815,839591,3776
"16197","WBGene00019332","III",840460,841366,906
"16198","WBGene00019333","III",851328,852396,1068
"16199","WBGene00019334","III",856560,860090,3530
"16200","WBGene00019335","II",2553962,2556313,2351
"16201","WBGene00019337","II",2546225,2553572,7347
"16202","WBGene00019338","II",2538494,2543920,5426
"16203","WBGene00019339","II",2535417,2536292,875
"16204","WBGene00019340","II",2530817,2531476,659
"16205","WBGene00019341","II",2525220,2529255,4035
"16206","WBGene00019342","II",2533445,2534278,833
"16207","WBGene00019343","II",2557781,2563677,5896
"16208","WBGene00019344","X",4707188,4709812,2624
"16209","WBGene00019345","X",4673706,4677283,3577
"16210","WBGene00019346","X",4687763,4691316,3553
"16211","WBGene00019347","X",16986629,17008462,21833
"16212","WBGene00019348","V",1528824,1531259,2435
"16213","WBGene00019349","V",1533892,1534415,523
"16214","WBGene00019350","V",1535224,1537079,1855
"16215","WBGene00019351","X",7292138,7296035,3897
"16216","WBGene00019352","X",7296098,7298751,2653
"16217","WBGene00019353","V",4689330,4691611,2281
"16218","WBGene00019354","V",4687974,4689231,1257
"16219","WBGene00019355","V",4681975,4685110,3135
"16220","WBGene00019356","V",4675638,4676192,554
"16221","WBGene00019357","V",4691605,4692433,828
"16222","WBGene00019359","X",3828739,3829300,561
"16223","WBGene00019360","I",3427177,3433207,6030
"16224","WBGene00019361","I",3419600,3424211,4611
"16225","WBGene00019362","I",3410012,3415238,5226
"16226","WBGene00019364","X",1066789,1069033,2244
"16227","WBGene00019365","X",1084214,1088148,3934
"16228","WBGene00019367","IV",1523718,1526599,2881
"16229","WBGene00019368","IV",1510546,1515251,4705
"16230","WBGene00019369","IV",1517969,1521324,3355
"16231","WBGene00019370","IV",1527221,1536398,9177
"16232","WBGene00019371","II",6431072,6432413,1341
"16233","WBGene00019372","II",6423112,6424925,1813
"16234","WBGene00019373","V",6566336,6568747,2411
"16235","WBGene00019374","V",6562048,6564183,2135
"16236","WBGene00019376","V",6550171,6551817,1646
"16237","WBGene00019379","V",6568952,6570882,1930
"16238","WBGene00019380","III",6889749,6895089,5340
"16239","WBGene00019381","III",6873048,6873729,681
"16240","WBGene00019382","III",6890991,6891812,821
"16241","WBGene00019383","X",6462029,6463228,1199
"16242","WBGene00019384","V",1658072,1659636,1564
"16243","WBGene00019385","V",1670973,1673439,2466
"16244","WBGene00019386","V",1668516,1670630,2114
"16245","WBGene00019387","V",1667204,1667813,609
"16246","WBGene00019388","V",1664650,1665950,1300
"16247","WBGene00019389","V",1662570,1664503,1933
"16248","WBGene00019390","V",1660297,1662150,1853
"16249","WBGene00019391","V",1655090,1657364,2274
"16250","WBGene00019392","V",1651345,1654444,3099
"16251","WBGene00019393","V",1648300,1651143,2843
"16252","WBGene00019394","I",6364886,6366224,1338
"16253","WBGene00019395","I",6360844,6364172,3328
"16254","WBGene00019396","I",6358585,6360457,1872
"16255","WBGene00019399","I",6366331,6368078,1747
"16256","WBGene00019400","III",7162694,7165261,2567
"16257","WBGene00019401","III",7156032,7158809,2777
"16258","WBGene00019402","III",7161157,7162115,958
"16259","WBGene00019403","X",4907290,4912323,5033
"16260","WBGene00019404","X",4919019,4920988,1969
"16261","WBGene00019405","II",5801382,5803680,2298
"16262","WBGene00019406","II",5794495,5796185,1690
"16263","WBGene00019407","II",5790726,5794402,3676
"16264","WBGene00019408","II",5782524,5787658,5134
"16265","WBGene00019409","II",5799321,5799642,321
"16266","WBGene00019410","II",5800067,5801175,1108
"16267","WBGene00019411","II",5803675,5805473,1798
"16268","WBGene00019412","II",1568520,1569563,1043
"16269","WBGene00019413","II",1556444,1557478,1034
"16270","WBGene00019414","II",1550712,1551804,1092
"16271","WBGene00019415","II",1543482,1545415,1933
"16272","WBGene00019416","II",1538891,1539901,1010
"16273","WBGene00019417","II",1548966,1550631,1665
"16274","WBGene00019418","II",1555257,1556335,1078
"16275","WBGene00019419","II",1567324,1567746,422
"16276","WBGene00019420","II",1570065,1571134,1069
"16277","WBGene00019421","II",1574557,1576115,1558
"16278","WBGene00019422","X",16501332,16501943,611
"16279","WBGene00019423","X",16494930,16499875,4945
"16280","WBGene00019424","II",6454974,6456440,1466
"16281","WBGene00019425","II",6444010,6446134,2124
"16282","WBGene00019426","II",6441428,6443921,2493
"16283","WBGene00019427","II",6450889,6453391,2502
"16284","WBGene00019428","II",6456522,6471111,14589
"16285","WBGene00019429","I",6473207,6476756,3549
"16286","WBGene00019430","I",6468113,6469392,1279
"16287","WBGene00019431","I",6466752,6467515,763
"16288","WBGene00019432","I",6460433,6464286,3853
"16289","WBGene00019433","I",6464197,6466941,2744
"16290","WBGene00019434","I",6474183,6489030,14847
"16291","WBGene00019435","X",1547505,1560124,12619
"16292","WBGene00019436","X",1536366,1540287,3921
"16293","WBGene00019437","X",1534420,1536013,1593
"16294","WBGene00019438","IV",4197467,4198365,898
"16295","WBGene00019439","IV",4188673,4195894,7221
"16296","WBGene00019441","IV",4189939,4192931,2992
"16297","WBGene00019444","V",8907280,8909442,2162
"16298","WBGene00019445","V",8903044,8905392,2348
"16299","WBGene00019448","V",8899276,8902221,2945
"16300","WBGene00019449","V",588135,589646,1511
"16301","WBGene00019450","V",585848,587250,1402
"16302","WBGene00019451","V",581916,583431,1515
"16303","WBGene00019452","V",579277,581372,2095
"16304","WBGene00019453","V",576370,578428,2058
"16305","WBGene00019454","V",583801,585308,1507
"16306","WBGene00019455","III",8099327,8100638,1311
"16307","WBGene00019456","III",8093570,8096311,2741
"16308","WBGene00019457","III",8088482,8091730,3248
"16309","WBGene00019458","III",8083692,8085538,1846
"16310","WBGene00019459","III",8096736,8098216,1480
"16311","WBGene00019460","III",8091708,8093042,1334
"16312","WBGene00019461","I",2599979,2602627,2648
"16313","WBGene00019462","IV",1834628,1847336,12708
"16314","WBGene00019464","V",9328970,9331527,2557
"16315","WBGene00019465","V",9327145,9333062,5917
"16316","WBGene00019466","V",9338859,9344218,5359
"16317","WBGene00019467","V",9345022,9346962,1940
"16318","WBGene00019469","V",3947365,3948952,1587
"16319","WBGene00019470","V",3945353,3947044,1691
"16320","WBGene00019471","V",3942215,3944457,2242
"16321","WBGene00019472","V",3939032,3941235,2203
"16322","WBGene00019473","V",3936326,3938496,2170
"16323","WBGene00019476","V",8207235,8208013,778
"16324","WBGene00019477","V",8203379,8205986,2607
"16325","WBGene00019478","V",8201808,8202546,738
"16326","WBGene00019479","V",8207930,8213968,6038
"16327","WBGene00019480","V",8215534,8217884,2350
"16328","WBGene00019481","V",8218279,8221316,3037
"16329","WBGene00019482","V",8226061,8226852,791
"16330","WBGene00019483","II",4044771,4047247,2476
"16331","WBGene00019484","II",4031214,4032387,1173
"16332","WBGene00019485","II",4020482,4025562,5080
"16333","WBGene00019486","II",4016827,4018701,1874
"16334","WBGene00019487","II",4004885,4016072,11187
"16335","WBGene00019488","II",4028577,4029985,1408
"16336","WBGene00019489","II",4550894,4552177,1283
"16337","WBGene00019490","X",8110449,8114762,4313
"16338","WBGene00019491","X",8104305,8107557,3252
"16339","WBGene00019492","X",8080869,8084018,3149
"16340","WBGene00019493","X",8089826,8098863,9037
"16341","WBGene00019494","II",667755,668444,689
"16342","WBGene00019495","II",658669,659867,1198
"16343","WBGene00019496","II",650964,654062,3098
"16344","WBGene00019497","II",637346,639488,2142
"16345","WBGene00019498","II",641010,650367,9357
"16346","WBGene00019501","III",6737271,6737783,512
"16347","WBGene00019502","II",1741548,1742189,641
"16348","WBGene00019503","IV",8294690,8297283,2593
"16349","WBGene00019504","IV",8291515,8294596,3081
"16350","WBGene00019506","IV",8271054,8272524,1470
"16351","WBGene00019507","IV",8259248,8259979,731
"16352","WBGene00019508","IV",8266752,8268412,1660
"16353","WBGene00019509","IV",8285175,8286566,1391
"16354","WBGene00019510","IV",8286587,8289531,2944
"16355","WBGene00019511","II",2997021,3000653,3632
"16356","WBGene00019512","II",2991613,2994313,2700
"16357","WBGene00019513","II",2988307,2991238,2931
"16358","WBGene00019514","IV",6075301,6076157,856
"16359","WBGene00019515","IV",6076692,6079945,3253
"16360","WBGene00019516","IV",6080907,6083592,2685
"16361","WBGene00019517","IV",6086350,6089404,3054
"16362","WBGene00019518","X",16558444,16562549,4105
"16363","WBGene00019519","X",16551166,16553887,2721
"16364","WBGene00019520","V",6259391,6260780,1389
"16365","WBGene00019521","V",6249172,6252453,3281
"16366","WBGene00019522","V",6235176,6237807,2631
"16367","WBGene00019524","V",3227796,3230128,2332
"16368","WBGene00019525","V",3198548,3200616,2068
"16369","WBGene00019526","V",3223612,3227058,3446
"16370","WBGene00019527","V",3231398,3234987,3589
"16371","WBGene00019529","IV",4168038,4169891,1853
"16372","WBGene00019530","IV",4164692,4166230,1538
"16373","WBGene00019531","IV",4162517,4164481,1964
"16374","WBGene00019532","IV",4157634,4161789,4155
"16375","WBGene00019533","IV",4154040,4154774,734
"16376","WBGene00019534","IV",4185550,4186199,649
"16377","WBGene00019535","IV",4178463,4179531,1068
"16378","WBGene00019536","IV",1711279,1714179,2900
"16379","WBGene00019537","IV",1710265,1711127,862
"16380","WBGene00019538","IV",1707296,1708691,1395
"16381","WBGene00019540","IV",1720790,1723067,2277
"16382","WBGene00019541","IV",4724862,4725332,470
"16383","WBGene00019543","IV",4706777,4710755,3978
"16384","WBGene00019544","IV",4712825,4715807,2982
"16385","WBGene00019545","IV",3794767,3796267,1500
"16386","WBGene00019546","IV",3784358,3794044,9686
"16387","WBGene00019547","X",3298832,3301637,2805
"16388","WBGene00019548","X",3296482,3297993,1511
"16389","WBGene00019549","X",3289485,3292412,2927
"16390","WBGene00019550","X",3282602,3285721,3119
"16391","WBGene00019551","X",3274757,3275768,1011
"16392","WBGene00019552","X",3272730,3273155,425
"16393","WBGene00019553","X",3271353,3271773,420
"16394","WBGene00019554","X",3276020,3280230,4210
"16395","WBGene00019556","V",856849,862061,5212
"16396","WBGene00019557","V",852484,853126,642
"16397","WBGene00019558","V",849499,851332,1833
"16398","WBGene00019559","V",847821,848858,1037
"16399","WBGene00019560","V",844686,845321,635
"16400","WBGene00019561","V",835773,839099,3326
"16401","WBGene00019562","V",840236,843218,2982
"16402","WBGene00019563","V",853436,855082,1646
"16403","WBGene00019564","V",4025091,4026212,1121
"16404","WBGene00019565","V",4022609,4024475,1866
"16405","WBGene00019566","V",4019488,4020601,1113
"16406","WBGene00019567","V",3992655,3994180,1525
"16407","WBGene00019568","V",3997124,4001465,4341
"16408","WBGene00019569","V",4002327,4004309,1982
"16409","WBGene00019570","X",8681910,8686146,4236
"16410","WBGene00019571","X",8673060,8681653,8593
"16411","WBGene00019572","X",8676624,8677933,1309
"16412","WBGene00019574","X",17117659,17117988,329
"16413","WBGene00019575","X",17119294,17120907,1613
"16414","WBGene00019576","X",17109282,17110655,1373
"16415","WBGene00019577","X",17113164,17115189,2025
"16416","WBGene00019578","X",17131348,17134527,3179
"16417","WBGene00019579","IV",12304462,12307820,3358
"16418","WBGene00019580","IV",12308293,12311606,3313
"16419","WBGene00019582","X",7739653,7741094,1441
"16420","WBGene00019583","X",7710170,7710716,546
"16421","WBGene00019584","X",7733334,7736271,2937
"16422","WBGene00019586","II",2255172,2261142,5970
"16423","WBGene00019587","II",2262128,2265768,3640
"16424","WBGene00019588","II",2272062,2273384,1322
"16425","WBGene00019589","II",2276738,2279155,2417
"16426","WBGene00019590","II",2290896,2292184,1288
"16427","WBGene00019591","II",2294693,2296265,1572
"16428","WBGene00019592","II",2280678,2283395,2717
"16429","WBGene00019593","II",2287030,2290226,3196
"16430","WBGene00019594","I",3152835,3155568,2733
"16431","WBGene00019595","I",3147996,3150349,2353
"16432","WBGene00019597","I",3141704,3143197,1493
"16433","WBGene00019598","I",3150409,3152003,1594
"16434","WBGene00019599","V",5747723,5752033,4310
"16435","WBGene00019600","V",5717885,5722089,4204
"16436","WBGene00019601","V",5723079,5726545,3466
"16437","WBGene00019603","V",5734844,5735984,1140
"16438","WBGene00019605","II",6366990,6369210,2220
"16439","WBGene00019606","II",6365722,6367002,1280
"16440","WBGene00019607","II",6360331,6360959,628
"16441","WBGene00019608","II",6361159,6365367,4208
"16442","WBGene00019609","X",3135486,3136663,1177
"16443","WBGene00019611","X",3103250,3106279,3029
"16444","WBGene00019612","X",3106543,3110630,4087
"16445","WBGene00019613","II",135466,139999,4533
"16446","WBGene00019614","II",117216,118691,1475
"16447","WBGene00019615","II",114429,121222,6793
"16448","WBGene00019616","II",123270,125004,1734
"16449","WBGene00019617","X",6421036,6430610,9574
"16450","WBGene00019618","X",6430695,6433788,3093
"16451","WBGene00019619","X",6444189,6446664,2475
"16452","WBGene00019620","X",6446649,6448999,2350
"16453","WBGene00019621","X",6451363,6451859,496
"16454","WBGene00019622","X",6443055,6443473,418
"16455","WBGene00019623","V",1075200,1079597,4397
"16456","WBGene00019624","V",1061595,1067908,6313
"16457","WBGene00019625","V",1050126,1053014,2888
"16458","WBGene00019626","V",1065682,1067672,1990
"16459","WBGene00019627","III",5191131,5196028,4897
"16460","WBGene00019628","III",5185920,5188646,2726
"16461","WBGene00019629","III",5173922,5180507,6585
"16462","WBGene00019630","III",5173439,5173809,370
"16463","WBGene00019631","III",5172720,5173338,618
"16464","WBGene00019633","III",5196027,5196709,682
"16465","WBGene00019636","III",378004,381298,3294
"16466","WBGene00019638","III",398730,399392,662
"16467","WBGene00019639","III",381900,382570,670
"16468","WBGene00019640","II",3976246,3977969,1723
"16469","WBGene00019641","II",3972820,3974968,2148
"16470","WBGene00019642","V",6896999,6898497,1498
"16471","WBGene00019643","V",6895078,6896922,1844
"16472","WBGene00019644","V",5023706,5027723,4017
"16473","WBGene00019645","V",5029324,5030811,1487
"16474","WBGene00019646","V",5034528,5035169,641
"16475","WBGene00019647","V",5035252,5036464,1212
"16476","WBGene00019648","V",5039669,5041003,1334
"16477","WBGene00019649","V",5042408,5046203,3795
"16478","WBGene00019650","V",5036572,5038658,2086
"16479","WBGene00019651","V",5052261,5053490,1229
"16480","WBGene00019652","V",6676799,6679072,2273
"16481","WBGene00019653","V",6674267,6676426,2159
"16482","WBGene00019654","V",6669823,6672036,2213
"16483","WBGene00019655","V",6685807,6688492,2685
"16484","WBGene00019656","X",6723500,6725668,2168
"16485","WBGene00019657","X",6725781,6729748,3967
"16486","WBGene00019658","IV",652130,653421,1291
"16487","WBGene00019659","IV",671634,673480,1846
"16488","WBGene00019660","IV",674036,675883,1847
"16489","WBGene00019661","IV",677616,679171,1555
"16490","WBGene00019662","IV",667291,668556,1265
"16491","WBGene00019663","IV",665525,666917,1392
"16492","WBGene00019664","IV",655353,658604,3251
"16493","WBGene00019665","IV",649665,651994,2329
"16494","WBGene00019666","V",6303771,6308337,4566
"16495","WBGene00019667","V",6281359,6284863,3504
"16496","WBGene00019668","V",6279005,6280146,1141
"16497","WBGene00019669","V",6280380,6281136,756
"16498","WBGene00019672","V",6308811,6312001,3190
"16499","WBGene00019673","I",1341218,1344692,3474
"16500","WBGene00019674","I",1335321,1336867,1546
"16501","WBGene00019675","V",3014485,3016034,1549
"16502","WBGene00019676","V",3021674,3024066,2392
"16503","WBGene00019677","III",8047712,8048461,749
"16504","WBGene00019678","III",8046034,8047612,1578
"16505","WBGene00019679","III",8045017,8045931,914
"16506","WBGene00019680","III",8044481,8044916,435
"16507","WBGene00019681","III",8042577,8042875,298
"16508","WBGene00019682","III",8048424,8051155,2731
"16509","WBGene00019683","II",2812872,2815544,2672
"16510","WBGene00019684","II",2823707,2824269,562
"16511","WBGene00019685","II",2825662,2826598,936
"16512","WBGene00019686","II",2828594,2831233,2639
"16513","WBGene00019687","II",2834953,2836780,1827
"16514","WBGene00019688","II",2827897,2828603,706
"16515","WBGene00019689","II",2824414,2824946,532
"16516","WBGene00019690","II",2816976,2819123,2147
"16517","WBGene00019691","II",2808167,2812860,4693
"16518","WBGene00019692","I",5563827,5566265,2438
"16519","WBGene00019693","I",5549137,5550505,1368
"16520","WBGene00019697","I",3070973,3084874,13901
"16521","WBGene00019698","I",3085011,3096285,11274
"16522","WBGene00019699","II",1028987,1033664,4677
"16523","WBGene00019700","II",1023693,1024784,1091
"16524","WBGene00019702","II",1039697,1040564,867
"16525","WBGene00019703","II",1041321,1042327,1006
"16526","WBGene00019704","II",1048863,1049949,1086
"16527","WBGene00019705","II",1042969,1044025,1056
"16528","WBGene00019706","I",1856459,1860578,4119
"16529","WBGene00019709","III",2053872,2054449,577
"16530","WBGene00019710","I",5582005,5583471,1466
"16531","WBGene00019711","I",5579666,5581979,2313
"16532","WBGene00019712","I",5573214,5576749,3535
"16533","WBGene00019713","I",5566343,5570081,3738
"16534","WBGene00019714","III",6664960,6665374,414
"16535","WBGene00019715","III",1496401,1509308,12907
"16536","WBGene00019716","III",1468643,1517993,49350
"16537","WBGene00019717","IV",4487028,4489000,1972
"16538","WBGene00019718","IV",4460179,4462061,1882
"16539","WBGene00019719","IV",4468505,4477059,8554
"16540","WBGene00019720","IV",4480116,4482764,2648
"16541","WBGene00019721","IV",4465484,4468509,3025
"16542","WBGene00019722","X",706817,707540,723
"16543","WBGene00019723","IV",3805485,3806711,1226
"16544","WBGene00019724","IV",3803581,3804949,1368
"16545","WBGene00019725","IV",3801864,3803426,1562
"16546","WBGene00019726","IV",3807870,3819328,11458
"16547","WBGene00019727","X",8763907,8766280,2373
"16548","WBGene00019728","X",8739048,8740171,1123
"16549","WBGene00019729","X",8732958,8737015,4057
"16550","WBGene00019730","X",8748434,8750969,2535
"16551","WBGene00019731","X",8754576,8761580,7004
"16552","WBGene00019732","X",8731310,8731922,612
"16553","WBGene00019733","X",326113,334600,8487
"16554","WBGene00019734","X",308762,311323,2561
"16555","WBGene00019735","X",3027253,3030762,3509
"16556","WBGene00019736","X",3033325,3034303,978
"16557","WBGene00019738","X",3031723,3033203,1480
"16558","WBGene00019739","X",3029388,3030406,1018
"16559","WBGene00019740","V",472889,474631,1742
"16560","WBGene00019741","V",465757,467491,1734
"16561","WBGene00019742","V",462600,464963,2363
"16562","WBGene00019743","V",459734,461899,2165
"16563","WBGene00019744","V",449915,450438,523
"16564","WBGene00019745","V",467567,468560,993
"16565","WBGene00019746","II",4557787,4559573,1786
"16566","WBGene00019747","II",4590952,4601354,10402
"16567","WBGene00019748","X",6809104,6817266,8162
"16568","WBGene00019749","X",6800688,6803700,3012
"16569","WBGene00019750","IV",6110651,6112391,1740
"16570","WBGene00019751","IV",6121773,6127302,5529
"16571","WBGene00019753","V",5623642,5624637,995
"16572","WBGene00019754","V",5617601,5618319,718
"16573","WBGene00019755","V",5615024,5616181,1157
"16574","WBGene00019756","V",5609414,5613219,3805
"16575","WBGene00019757","V",5618291,5620140,1849
"16576","WBGene00019758","X",4957329,4958067,738
"16577","WBGene00019759","X",4964413,4969459,5046
"16578","WBGene00019760","X",4969537,4972281,2744
"16579","WBGene00019761","V",5951433,5953872,2439
"16580","WBGene00019762","V",5940024,5943362,3338
"16581","WBGene00019763","V",5930847,5933435,2588
"16582","WBGene00019764","V",5933662,5936791,3129
"16583","WBGene00019765","V",5953831,5954840,1009
"16584","WBGene00019766","IV",3213764,3219825,6061
"16585","WBGene00019767","I",4769694,4771358,1664
"16586","WBGene00019768","I",4765754,4767515,1761
"16587","WBGene00019769","I",4763220,4765313,2093
"16588","WBGene00019770","I",4771348,4773673,2325
"16589","WBGene00019771","I",4773818,4788358,14540
"16590","WBGene00019772","IV",455784,457099,1315
"16591","WBGene00019773","IV",458032,461029,2997
"16592","WBGene00019774","IV",461292,481167,19875
"16593","WBGene00019776","X",629188,632868,3680
"16594","WBGene00019777","IV",3533641,3539046,5405
"16595","WBGene00019778","IV",3527354,3532521,5167
"16596","WBGene00019779","X",8242056,8247869,5813
"16597","WBGene00019780","X",8232254,8236316,4062
"16598","WBGene00019781","X",8248207,8252458,4251
"16599","WBGene00019782","X",8258149,8261175,3026
"16600","WBGene00019783","IV",2245874,2252370,6496
"16601","WBGene00019784","IV",2243060,2243699,639
"16602","WBGene00019785","IV",2237663,2242449,4786
"16603","WBGene00019786","IV",2253004,2263704,10700
"16604","WBGene00019787","IV",2264309,2275622,11313
"16605","WBGene00019789","IV",8398923,8399762,839
"16606","WBGene00019791","IV",8405022,8406611,1589
"16607","WBGene00019792","IV",8414293,8421061,6768
"16608","WBGene00019793","II",3641500,3644082,2582
"16609","WBGene00019794","II",3631110,3633875,2765
"16610","WBGene00019795","II",3627172,3629266,2094
"16611","WBGene00019796","II",3624198,3626950,2752
"16612","WBGene00019797","II",3637811,3639338,1527
"16613","WBGene00019798","II",3645427,3646982,1555
"16614","WBGene00019799","II",3622314,3624058,1744
"16615","WBGene00019800","III",8768311,8769252,941
"16616","WBGene00019801","III",8756995,8761101,4106
"16617","WBGene00019803","X",7556788,7559085,2297
"16618","WBGene00019804","V",6041196,6041475,279
"16619","WBGene00019806","V",6045640,6047908,2268
"16620","WBGene00019807","V",6047922,6051259,3337
"16621","WBGene00019808","V",6051377,6053375,1998
"16622","WBGene00019809","III",7062880,7063194,314
"16623","WBGene00019810","III",7056541,7058526,1985
"16624","WBGene00019811","III",7058516,7060597,2081
"16625","WBGene00019812","III",7061111,7064275,3164
"16626","WBGene00019813","III",7065439,7067477,2038
"16627","WBGene00019814","V",236750,238192,1442
"16628","WBGene00019815","V",244469,245846,1377
"16629","WBGene00019816","V",254912,257992,3080
"16630","WBGene00019817","V",238963,240362,1399
"16631","WBGene00019818","V",241326,242618,1292
"16632","WBGene00019819","IV",245114,251925,6811
"16633","WBGene00019820","IV",240451,244129,3678
"16634","WBGene00019821","IV",225439,231773,6334
"16635","WBGene00019822","IV",232473,237450,4977
"16636","WBGene00019823","IV",237591,240307,2716
"16637","WBGene00019824","IV",253571,255429,1858
"16638","WBGene00019825","IV",255966,257199,1233
"16639","WBGene00019826","X",4103447,4104521,1074
"16640","WBGene00019827","X",4012219,4021956,9737
"16641","WBGene00019828","X",4005314,4007634,2320
"16642","WBGene00019829","X",3997340,3999341,2001
"16643","WBGene00019830","X",4008058,4016185,8127
"16644","WBGene00019831","III",5501861,5506392,4531
"16645","WBGene00019832","III",5487642,5498943,11301
"16646","WBGene00019833","III",5484200,5486005,1805
"16647","WBGene00019834","III",5479318,5480278,960
"16648","WBGene00019835","III",5478682,5478924,242
"16649","WBGene00019836","III",5480262,5483784,3522
"16650","WBGene00019837","III",5492925,5495268,2343
"16651","WBGene00019838","III",5499190,5499976,786
"16652","WBGene00019839","V",4801094,4802626,1532
"16653","WBGene00019840","V",4794599,4796996,2397
"16654","WBGene00019841","V",4802647,4805947,3300
"16655","WBGene00019842","V",4810865,4818663,7798
"16656","WBGene00019843","X",6729997,6733315,3318
"16657","WBGene00019844","X",6747296,6761738,14442
"16658","WBGene00019845","X",7800445,7805676,5231
"16659","WBGene00019846","X",7798955,7799780,825
"16660","WBGene00019847","X",7805629,7809134,3505
"16661","WBGene00019849","V",9016864,9019318,2454
"16662","WBGene00019850","V",9014408,9015640,1232
"16663","WBGene00019851","V",9019595,9022178,2583
"16664","WBGene00019853","V",9025513,9026540,1027
"16665","WBGene00019854","II",4180248,4182119,1871
"16666","WBGene00019855","II",4155773,4167368,11595
"16667","WBGene00019856","II",4167555,4168500,945
"16668","WBGene00019857","II",4169723,4170608,885
"16669","WBGene00019858","II",4171294,4173875,2581
"16670","WBGene00019859","II",4177267,4178927,1660
"16671","WBGene00019861","X",404897,405357,460
"16672","WBGene00019862","X",372235,376900,4665
"16673","WBGene00019863","X",377133,380605,3472
"16674","WBGene00019864","X",384382,388797,4415
"16675","WBGene00019865","X",397567,400687,3120
"16676","WBGene00019866","X",2467347,2471308,3961
"16677","WBGene00019867","X",2471540,2473718,2178
"16678","WBGene00019868","X",2473758,2476030,2272
"16679","WBGene00019869","X",8812143,8816805,4662
"16680","WBGene00019870","X",8796545,8797835,1290
"16681","WBGene00019871","X",8801624,8806113,4489
"16682","WBGene00019872","X",8806174,8811142,4968
"16683","WBGene00019873","IV",2066200,2071741,5541
"16684","WBGene00019874","IV",2057878,2059111,1233
"16685","WBGene00019875","IV",2084034,2091931,7897
"16686","WBGene00019877","III",8372255,8375175,2920
"16687","WBGene00019878","III",8364078,8366538,2460
"16688","WBGene00019879","III",8349121,8349938,817
"16689","WBGene00019881","III",8356887,8358844,1957
"16690","WBGene00019882","III",8362408,8368848,6440
"16691","WBGene00019883","III",8375300,8380833,5533
"16692","WBGene00019884","III",8380943,8387529,6586
"16693","WBGene00019885","V",2761825,2763208,1383
"16694","WBGene00019886","V",2766271,2767503,1232
"16695","WBGene00019887","V",2779384,2780845,1461
"16696","WBGene00019888","II",4905008,4911835,6827
"16697","WBGene00019890","II",4889437,4891427,1990
"16698","WBGene00019891","II",4886276,4888211,1935
"16699","WBGene00019892","II",4899859,4902100,2241
"16700","WBGene00019893","II",4902288,4903796,1508
"16701","WBGene00019894","II",4911765,4914218,2453
"16702","WBGene00019895","II",4914494,4925248,10754
"16703","WBGene00019896","IV",7539577,7541896,2319
"16704","WBGene00019898","IV",7513233,7514459,1226
"16705","WBGene00019899","IV",7508514,7509475,961
"16706","WBGene00019900","IV",7506425,7507891,1466
"16707","WBGene00019901","IV",7514366,7516267,1901
"16708","WBGene00019902","IV",7517445,7542535,25090
"16709","WBGene00019903","II",6503168,6503399,231
"16710","WBGene00019904","II",6493720,6498633,4913
"16711","WBGene00019905","II",6500397,6501520,1123
"16712","WBGene00019906","II",6509498,6514011,4513
"16713","WBGene00019907","III",6795626,6797774,2148
"16714","WBGene00019908","III",6798299,6800489,2190
"16715","WBGene00019909","I",1077522,1088473,10951
"16716","WBGene00019911","I",1089666,1095796,6130
"16717","WBGene00019912","III",966654,972269,5615
"16718","WBGene00019913","III",973311,980451,7140
"16719","WBGene00019914","III",1002707,1006298,3591
"16720","WBGene00019915","III",977386,988446,11060
"16721","WBGene00019916","III",1001145,1001411,266
"16722","WBGene00019917","II",944066,946157,2091
"16723","WBGene00019918","II",940983,943162,2179
"16724","WBGene00019919","II",938849,940683,1834
"16725","WBGene00019920","II",933018,936989,3971
"16726","WBGene00019921","II",931171,932327,1156
"16727","WBGene00019922","II",923821,925192,1371
"16728","WBGene00019923","II",916051,917464,1413
"16729","WBGene00019924","II",913680,915219,1539
"16730","WBGene00019925","II",912003,913030,1027
"16731","WBGene00019926","II",909884,911592,1708
"16732","WBGene00019927","II",907535,909631,2096
"16733","WBGene00019928","II",920859,922702,1843
"16734","WBGene00019929","II",926496,927431,935
"16735","WBGene00019930","II",929485,930529,1044
"16736","WBGene00019931","IV",4152547,4154029,1482
"16737","WBGene00019932","IV",4148141,4150055,1914
"16738","WBGene00019933","IV",4145084,4147064,1980
"16739","WBGene00019934","IV",4150572,4152251,1679
"16740","WBGene00019935","X",5959115,5970158,11043
"16741","WBGene00019937","X",5953450,5953815,365
"16742","WBGene00019938","X",5949529,5953174,3645
"16743","WBGene00019939","II",7608253,7610986,2733
"16744","WBGene00019940","II",7599657,7608014,8357
"16745","WBGene00019941","II",7597545,7598752,1207
"16746","WBGene00019943","II",7610986,7613730,2744
"16747","WBGene00019944","II",7618238,7620513,2275
"16748","WBGene00019945","IV",4451876,4452019,143
"16749","WBGene00019946","IV",4447299,4449897,2598
"16750","WBGene00019947","IV",4445990,4446997,1007
"16751","WBGene00019948","IV",4435127,4437318,2191
"16752","WBGene00019949","IV",4430229,4432165,1936
"16753","WBGene00019950","IV",4422339,4426566,4227
"16754","WBGene00019951","IV",4433049,4434541,1492
"16755","WBGene00019952","IV",4437786,4439290,1504
"16756","WBGene00019953","IV",4442399,4445876,3477
"16757","WBGene00019954","IV",4454773,4454937,164
"16758","WBGene00019955","IV",4450000,4460027,10027
"16759","WBGene00019956","IV",4439816,4441177,1361
"16760","WBGene00019957","X",4822661,4834905,12244
"16761","WBGene00019959","X",4818599,4821708,3109
"16762","WBGene00019960","X",4805998,4811536,5538
"16763","WBGene00019961","V",3769801,3771518,1717
"16764","WBGene00019962","V",3774533,3776136,1603
"16765","WBGene00019963","V",3772021,3775546,3525
"16766","WBGene00019964","V",3768570,3769776,1206
"16767","WBGene00019965","V",3777553,3784213,6660
"16768","WBGene00019966","V",3798605,3800478,1873
"16769","WBGene00019967","V",3800782,3803531,2749
"16770","WBGene00019968","V",3803845,3805531,1686
"16771","WBGene00019969","V",3794733,3798587,3854
"16772","WBGene00019970","V",3790133,3793766,3633
"16773","WBGene00019971","V",1008803,1018350,9547
"16774","WBGene00019972","V",1018337,1023144,4807
"16775","WBGene00019973","V",1023782,1027073,3291
"16776","WBGene00019975","V",1027904,1033385,5481
"16777","WBGene00019976","V",1434339,1435804,1465
"16778","WBGene00019977","V",1462063,1464699,2636
"16779","WBGene00019978","V",1460369,1461613,1244
"16780","WBGene00019979","V",1439179,1441871,2692
"16781","WBGene00019980","V",1455062,1456646,1584
"16782","WBGene00019981","V",778639,780223,1584
"16783","WBGene00019982","V",774995,777272,2277
"16784","WBGene00019983","V",773518,774854,1336
"16785","WBGene00019986","X",8323592,8325046,1454
"16786","WBGene00019987","X",8294625,8296675,2050
"16787","WBGene00019988","X",8306225,8307700,1475
"16788","WBGene00019989","X",8325099,8326451,1352
"16789","WBGene00019991","X",1667019,1668848,1829
"16790","WBGene00019993","I",6420660,6421985,1325
"16791","WBGene00019994","III",2910910,2935740,24830
"16792","WBGene00019995","III",2920074,2922167,2093
"16793","WBGene00019996","III",2923662,2924758,1096
"16794","WBGene00019997","III",2937103,2944044,6941
"16795","WBGene00019998","II",7494460,7496174,1714
"16796","WBGene00019999","II",7497286,7499475,2189
"16797","WBGene00020003","IV",4789503,4791983,2480
"16798","WBGene00020004","IV",4772092,4775133,3041
"16799","WBGene00020006","IV",4776833,4780083,3250
"16800","WBGene00020007","II",4091837,4094349,2512
"16801","WBGene00020008","II",4083065,4086226,3161
"16802","WBGene00020009","II",4070009,4072920,2911
"16803","WBGene00020010","X",3659492,3666879,7387
"16804","WBGene00020011","X",3652017,3655419,3402
"16805","WBGene00020012","X",3639189,3644896,5707
"16806","WBGene00020013","V",530799,531819,1020
"16807","WBGene00020014","V",505491,506068,577
"16808","WBGene00020015","V",517851,519601,1750
"16809","WBGene00020016","V",521702,524218,2516
"16810","WBGene00020017","V",1422796,1425794,2998
"16811","WBGene00020018","III",5807052,5809206,2154
"16812","WBGene00020019","III",5805563,5806975,1412
"16813","WBGene00020020","III",5834022,5834998,976
"16814","WBGene00020021","III",5815045,5815513,468
"16815","WBGene00020022","II",6050332,6054307,3975
"16816","WBGene00020023","II",6029514,6031206,1692
"16817","WBGene00020024","II",6039344,6039650,306
"16818","WBGene00020025","II",6044145,6045218,1073
"16819","WBGene00020026","II",6046286,6047867,1581
"16820","WBGene00020027","II",6055039,6056388,1349
"16821","WBGene00020028","II",6057379,6061520,4141
"16822","WBGene00020029","II",6023323,6025035,1712
"16823","WBGene00020030","I",4182221,4184992,2771
"16824","WBGene00020031","I",4178812,4182158,3346
"16825","WBGene00020032","I",4151099,4151761,662
"16826","WBGene00020033","I",4153957,4154550,593
"16827","WBGene00020034","I",4155542,4158733,3191
"16828","WBGene00020035","I",4168984,4171589,2605
"16829","WBGene00020036","I",4172433,4173739,1306
"16830","WBGene00020037","I",4173743,4174774,1031
"16831","WBGene00020038","I",4177305,4178447,1142
"16832","WBGene00020039","I",4149981,4150634,653
"16833","WBGene00020040","I",4148832,4149429,597
"16834","WBGene00020041","IV",7220104,7220607,503
"16835","WBGene00020042","IV",7203996,7205259,1263
"16836","WBGene00020043","IV",7191076,7191841,765
"16837","WBGene00020045","IV",7218049,7219485,1436
"16838","WBGene00020046","IV",7193520,7195834,2314
"16839","WBGene00020047","III",7566411,7567486,1075
"16840","WBGene00020048","III",7562172,7564529,2357
"16841","WBGene00020049","III",7564500,7565347,847
"16842","WBGene00020050","III",7567475,7570133,2658
"16843","WBGene00020051","III",7575274,7579411,4137
"16844","WBGene00020052","III",7582033,7582999,966
"16845","WBGene00020053","III",7591570,7593337,1767
"16846","WBGene00020054","V",7409899,7411253,1354
"16847","WBGene00020055","V",7407547,7408814,1267
"16848","WBGene00020056","V",817482,818733,1251
"16849","WBGene00020057","V",815016,816873,1857
"16850","WBGene00020058","V",810793,814726,3933
"16851","WBGene00020059","V",787431,789888,2457
"16852","WBGene00020060","V",782732,784763,2031
"16853","WBGene00020062","V",802550,804741,2191
"16854","WBGene00020063","V",812812,813194,382
"16855","WBGene00020064","III",6869634,6870298,664
"16856","WBGene00020065","III",6859863,6860786,923
"16857","WBGene00020066","III",6847390,6849055,1665
"16858","WBGene00020067","III",6858793,6859571,778
"16859","WBGene00020068","III",6865207,6869460,4253
"16860","WBGene00020069","IV",6846129,6859370,13241
"16861","WBGene00020070","IV",5068845,5069861,1016
"16862","WBGene00020071","IV",5065746,5066987,1241
"16863","WBGene00020072","IV",5067320,5068652,1332
"16864","WBGene00020073","II",2131070,2132475,1405
"16865","WBGene00020075","II",2104524,2106866,2342
"16866","WBGene00020076","II",2107197,2108395,1198
"16867","WBGene00020077","II",2108787,2110043,1256
"16868","WBGene00020078","II",2111227,2113048,1821
"16869","WBGene00020080","II",2117276,2122181,4905
"16870","WBGene00020081","II",2123687,2129281,5594
"16871","WBGene00020082","X",301832,308298,6466
"16872","WBGene00020083","X",297234,299287,2053
"16873","WBGene00020084","IV",4633693,4634480,787
"16874","WBGene00020086","X",17483012,17486831,3819
"16875","WBGene00020087","I",357240,363901,6661
"16876","WBGene00020088","I",368370,373445,5075
"16877","WBGene00020089","I",373571,379073,5502
"16878","WBGene00020090","I",388470,394415,5945
"16879","WBGene00020091","I",364510,368319,3809
"16880","WBGene00020092","III",5024966,5029540,4574
"16881","WBGene00020093","III",5022047,5023200,1153
"16882","WBGene00020094","III",5018645,5021118,2473
"16883","WBGene00020095","III",4999379,5001336,1957
"16884","WBGene00020096","III",5003197,5004721,1524
"16885","WBGene00020097","III",5008933,5017860,8927
"16886","WBGene00020098","III",5001297,5002331,1034
"16887","WBGene00020099","III",5007100,5008830,1730
"16888","WBGene00020100","III",3186700,3192206,5506
"16889","WBGene00020101","III",3183677,3185237,1560
"16890","WBGene00020102","III",3175339,3183498,8159
"16891","WBGene00020103","III",3171592,3174845,3253
"16892","WBGene00020104","III",3166285,3171198,4913
"16893","WBGene00020105","III",3195561,3198407,2846
"16894","WBGene00020106","III",7216526,7221186,4660
"16895","WBGene00020107","III",7209967,7215226,5259
"16896","WBGene00020109","III",7221741,7223129,1388
"16897","WBGene00020110","III",7223233,7226924,3691
"16898","WBGene00020111","III",7226820,7229787,2967
"16899","WBGene00020112","III",7198151,7198884,733
"16900","WBGene00020113","III",7230055,7230941,886
"16901","WBGene00020114","II",7627250,7651295,24045
"16902","WBGene00020115","III",1952014,1961945,9931
"16903","WBGene00020116","III",1963566,1969902,6336
"16904","WBGene00020117","III",1971182,1975709,4527
"16905","WBGene00020118","III",1977315,1980462,3147
"16906","WBGene00020119","X",4376595,4376850,255
"16907","WBGene00020120","X",4365305,4366332,1027
"16908","WBGene00020121","X",4368543,4368850,307
"16909","WBGene00020122","X",4370014,4370856,842
"16910","WBGene00020123","X",4371036,4373211,2175
"16911","WBGene00020125","X",7030225,7036084,5859
"16912","WBGene00020126","X",7029136,7029638,502
"16913","WBGene00020127","X",1154948,1155613,665
"16914","WBGene00020128","X",1132993,1148585,15592
"16915","WBGene00020129","X",1151547,1153545,1998
"16916","WBGene00020130","X",6379484,6384845,5361
"16917","WBGene00020131","I",4481203,4508930,27727
"16918","WBGene00020134","X",2335684,2348635,12951
"16919","WBGene00020135","X",2314896,2319333,4437
"16920","WBGene00020136","X",2337656,2338306,650
"16921","WBGene00020137","X",8495322,8498062,2740
"16922","WBGene00020138","IV",8447204,8449048,1844
"16923","WBGene00020139","IV",8449353,8451771,2418
"16924","WBGene00020140","IV",8459178,8460327,1149
"16925","WBGene00020141","V",7123658,7128890,5232
"16926","WBGene00020142","X",16796087,16803357,7270
"16927","WBGene00020143","X",16786438,16787620,1182
"16928","WBGene00020144","X",16780994,16782894,1900
"16929","WBGene00020145","X",16787632,16790412,2780
"16930","WBGene00020146","X",16791347,16793137,1790
"16931","WBGene00020148","II",174401,175642,1241
"16932","WBGene00020149","II",176997,179093,2096
"16933","WBGene00020150","II",187371,189202,1831
"16934","WBGene00020151","V",497839,498943,1104
"16935","WBGene00020152","V",486990,489104,2114
"16936","WBGene00020153","V",484901,486895,1994
"16937","WBGene00020154","V",502142,503223,1081
"16938","WBGene00020155","V",865074,866829,1755
"16939","WBGene00020156","V",869481,871129,1648
"16940","WBGene00020157","V",884881,889274,4393
"16941","WBGene00020158","X",2694908,2698273,3365
"16942","WBGene00020160","X",2698257,2705859,7602
"16943","WBGene00020163","II",7094159,7099348,5189
"16944","WBGene00020164","II",7082102,7084083,1981
"16945","WBGene00020166","II",7075614,7077188,1574
"16946","WBGene00020167","II",7078765,7081718,2953
"16947","WBGene00020168","II",7096349,7098593,2244
"16948","WBGene00020169","II",7099587,7101163,1576
"16949","WBGene00020170","II",7089674,7093102,3428
"16950","WBGene00020171","II",709381,723699,14318
"16951","WBGene00020172","II",702107,708608,6501
"16952","WBGene00020173","II",691881,693456,1575
"16953","WBGene00020174","II",690049,691084,1035
"16954","WBGene00020175","II",685234,689014,3780
"16955","WBGene00020176","II",683767,684116,349
"16956","WBGene00020177","II",682626,683320,694
"16957","WBGene00020178","II",680832,681516,684
"16958","WBGene00020179","II",679025,679714,689
"16959","WBGene00020180","II",679777,680712,935
"16960","WBGene00020181","II",700482,701125,643
"16961","WBGene00020182","V",2849343,2852031,2688
"16962","WBGene00020183","V",2823806,2826831,3025
"16963","WBGene00020184","I",3874037,3875995,1958
"16964","WBGene00020185","I",3867541,3869109,1568
"16965","WBGene00020187","I",3838237,3839899,1662
"16966","WBGene00020188","I",3839809,3841558,1749
"16967","WBGene00020189","I",3854169,3859292,5123
"16968","WBGene00020190","I",3859376,3862729,3353
"16969","WBGene00020191","I",3871474,3873428,1954
"16970","WBGene00020192","I",3853810,3854233,423
"16971","WBGene00020193","I",3875974,3876711,737
"16972","WBGene00020194","X",2608228,2609989,1761
"16973","WBGene00020195","X",2610826,2615726,4900
"16974","WBGene00020196","X",5174369,5177506,3137
"16975","WBGene00020197","X",5165395,5168778,3383
"16976","WBGene00020199","X",5177519,5179210,1691
"16977","WBGene00020200","III",7616528,7617590,1062
"16978","WBGene00020201","III",7614862,7615699,837
"16979","WBGene00020202","III",7605949,7608290,2341
"16980","WBGene00020203","II",634284,637303,3019
"16981","WBGene00020204","II",630075,631980,1905
"16982","WBGene00020205","II",627506,628662,1156
"16983","WBGene00020207","II",614767,624543,9776
"16984","WBGene00020208","IV",2222828,2235795,12967
"16985","WBGene00020209","III",5993219,6006360,13141
"16986","WBGene00020210","III",5991880,5992230,350
"16987","WBGene00020211","III",5985640,5985858,218
"16988","WBGene00020212","I",4679671,4682755,3084
"16989","WBGene00020214","X",788353,796142,7789
"16990","WBGene00020215","X",772353,775371,3018
"16991","WBGene00020216","X",767023,768069,1046
"16992","WBGene00020217","X",780528,785624,5096
"16993","WBGene00020218","X",770833,771882,1049
"16994","WBGene00020219","II",4678026,4679638,1612
"16995","WBGene00020220","II",4674420,4675729,1309
"16996","WBGene00020221","II",4675779,4676250,471
"16997","WBGene00020222","II",4653189,4655934,2745
"16998","WBGene00020223","II",4668644,4671774,3130
"16999","WBGene00020224","II",4679667,4681324,1657
"17000","WBGene00020225","II",4681764,4683728,1964
"17001","WBGene00020227","II",2708438,2710096,1658
"17002","WBGene00020228","II",2709942,2711019,1077
"17003","WBGene00020229","II",2714647,2717435,2788
"17004","WBGene00020230","II",2717522,2725541,8019
"17005","WBGene00020231","II",2731319,2735250,3931
"17006","WBGene00020232","II",2738523,2739642,1119
"17007","WBGene00020233","II",2740403,2742341,1938
"17008","WBGene00020234","IV",6883576,6887662,4086
"17009","WBGene00020235","IV",6887948,6897777,9829
"17010","WBGene00020236","V",4135028,4138825,3797
"17011","WBGene00020237","V",4129904,4130909,1005
"17012","WBGene00020238","V",4127868,4129602,1734
"17013","WBGene00020239","V",4115192,4116149,957
"17014","WBGene00020240","V",4117585,4118432,847
"17015","WBGene00020241","V",4119890,4120729,839
"17016","WBGene00020242","V",4121489,4122517,1028
"17017","WBGene00020243","V",4123329,4124862,1533
"17018","WBGene00020244","V",4126319,4127535,1216
"17019","WBGene00020245","V",7748863,7751368,2505
"17020","WBGene00020246","V",7733624,7734911,1287
"17021","WBGene00020247","V",7751901,7753817,1916
"17022","WBGene00020248","II",4478613,4480948,2335
"17023","WBGene00020249","II",4481025,4482114,1089
"17024","WBGene00020250","II",4487694,4489388,1694
"17025","WBGene00020251","II",4491152,4505147,13995
"17026","WBGene00020252","II",4490408,4490865,457
"17027","WBGene00020254","V",5493747,5503010,9263
"17028","WBGene00020256","V",5490370,5493646,3276
"17029","WBGene00020258","I",6203897,6206927,3030
"17030","WBGene00020259","I",6188157,6192632,4475
"17031","WBGene00020260","I",6192552,6194897,2345
"17032","WBGene00020261","I",6200798,6202076,1278
"17033","WBGene00020262","I",5455730,5459550,3820
"17034","WBGene00020263","I",5472321,5479438,7117
"17035","WBGene00020264","V",6450870,6452929,2059
"17036","WBGene00020265","V",6448656,6450217,1561
"17037","WBGene00020266","V",6442337,6447556,5219
"17038","WBGene00020267","V",6438913,6440036,1123
"17039","WBGene00020268","V",6436578,6437884,1306
"17040","WBGene00020269","V",6434130,6436401,2271
"17041","WBGene00020270","V",6414993,6417494,2501
"17042","WBGene00020271","V",6417748,6418309,561
"17043","WBGene00020273","V",6417495,6424155,6660
"17044","WBGene00020274","V",6424252,6425952,1700
"17045","WBGene00020275","V",6426193,6427112,919
"17046","WBGene00020276","V",6440202,6441711,1509
"17047","WBGene00020277","V",1923116,1925565,2449
"17048","WBGene00020279","V",1944955,1953349,8394
"17049","WBGene00020280","V",1927223,1931413,4190
"17050","WBGene00020281","I",770892,776369,5477
"17051","WBGene00020282","I",760848,761849,1001
"17052","WBGene00020283","I",763597,770720,7123
"17053","WBGene00020284","IV",16855044,16863443,8399
"17054","WBGene00020285","IV",16895739,16895961,222
"17055","WBGene00020286","IV",16865838,16866504,666
"17056","WBGene00020287","IV",16862396,16865479,3083
"17057","WBGene00020288","IV",7879317,7881034,1717
"17058","WBGene00020289","IV",7870865,7873034,2169
"17059","WBGene00020290","II",3381836,3384017,2181
"17060","WBGene00020291","II",3384826,3385895,1069
"17061","WBGene00020292","II",3388280,3391586,3306
"17062","WBGene00020293","II",3392036,3395533,3497
"17063","WBGene00020294","X",4056835,4071493,14658
"17064","WBGene00020295","IV",383699,384936,1237
"17065","WBGene00020296","IV",396545,399095,2550
"17066","WBGene00020297","IV",393880,396554,2674
"17067","WBGene00020298","IV",390512,393158,2646
"17068","WBGene00020299","IV",410831,415615,4784
"17069","WBGene00020300","IV",388084,388733,649
"17070","WBGene00020301","X",2429862,2439158,9296
"17071","WBGene00020302","X",2442970,2443404,434
"17072","WBGene00020304","II",904425,906039,1614
"17073","WBGene00020305","II",901932,903476,1544
"17074","WBGene00020306","II",893863,897379,3516
"17075","WBGene00020307","II",881576,890710,9134
"17076","WBGene00020308","II",884577,886149,1572
"17077","WBGene00020309","II",880522,883994,3472
"17078","WBGene00020311","II",898043,901164,3121
"17079","WBGene00020313","III",6907441,6908012,571
"17080","WBGene00020314","III",6903895,6905170,1275
"17081","WBGene00020315","III",6898016,6900605,2589
"17082","WBGene00020316","III",6900568,6903106,2538
"17083","WBGene00020317","III",6909438,6912481,3043
"17084","WBGene00020318","II",7149248,7151760,2512
"17085","WBGene00020319","II",7144607,7147253,2646
"17086","WBGene00020320","II",7130525,7132055,1530
"17087","WBGene00020321","X",4894055,4896615,2560
"17088","WBGene00020322","X",4890221,4892328,2107
"17089","WBGene00020323","X",4885951,4889575,3624
"17090","WBGene00020324","X",4896602,4900801,4199
"17091","WBGene00020325","II",1598029,1599488,1459
"17092","WBGene00020326","II",1577471,1579986,2515
"17093","WBGene00020327","II",1582876,1584240,1364
"17094","WBGene00020328","II",1593480,1595237,1757
"17095","WBGene00020329","II",1599471,1600714,1243
"17096","WBGene00020330","X",6300138,6305211,5073
"17097","WBGene00020333","V",6977754,6979116,1362
"17098","WBGene00020334","X",7334714,7340224,5510
"17099","WBGene00020335","X",7331189,7331903,714
"17100","WBGene00020338","X",7312175,7313976,1801
"17101","WBGene00020339","X",7329818,7330669,851
"17102","WBGene00020340","V",1982631,1987045,4414
"17103","WBGene00020341","V",1979435,1982664,3229
"17104","WBGene00020342","V",1975418,1977261,1843
"17105","WBGene00020343","V",1969528,1974514,4986
"17106","WBGene00020345","I",6225096,6225964,868
"17107","WBGene00020346","I",6215669,6219911,4242
"17108","WBGene00020347","I",6206955,6211155,4200
"17109","WBGene00020348","I",6211270,6211885,615
"17110","WBGene00020349","I",6221245,6223116,1871
"17111","WBGene00020350","I",6231496,6232129,633
"17112","WBGene00020351","IV",4886885,4887358,473
"17113","WBGene00020352","IV",4894370,4897043,2673
"17114","WBGene00020353","IV",4905658,4908498,2840
"17115","WBGene00020354","IV",4889918,4890672,754
"17116","WBGene00020356","IV",4890843,4894085,3242
"17117","WBGene00020357","II",1836504,1840292,3788
"17118","WBGene00020358","II",1832343,1833518,1175
"17119","WBGene00020359","II",1830632,1831789,1157
"17120","WBGene00020360","II",1824629,1830195,5566
"17121","WBGene00020361","II",1821026,1823034,2008
"17122","WBGene00020362","II",1817281,1818400,1119
"17123","WBGene00020363","II",1818889,1820094,1205
"17124","WBGene00020364","II",1833627,1835783,2156
"17125","WBGene00020365","X",17205243,17209365,4122
"17126","WBGene00020366","X",17213144,17214929,1785
"17127","WBGene00020368","II",4127848,4134867,7019
"17128","WBGene00020369","V",4483459,4486543,3084
"17129","WBGene00020370","V",4471365,4473602,2237
"17130","WBGene00020371","V",4481100,4481546,446
"17131","WBGene00020372","IV",8244412,8246521,2109
"17132","WBGene00020373","IV",8222202,8223459,1257
"17133","WBGene00020374","IV",8225674,8226366,692
"17134","WBGene00020375","I",6185462,6188121,2659
"17135","WBGene00020376","I",6184072,6185368,1296
"17136","WBGene00020377","I",6176252,6178057,1805
"17137","WBGene00020378","I",6167940,6168642,702
"17138","WBGene00020379","I",6154075,6157438,3363
"17139","WBGene00020380","I",6157473,6159264,1791
"17140","WBGene00020381","I",6160054,6161665,1611
"17141","WBGene00020382","I",6164719,6166539,1820
"17142","WBGene00020383","I",6177983,6180840,2857
"17143","WBGene00020384","V",5346494,5349571,3077
"17144","WBGene00020385","V",5354053,5358872,4819
"17145","WBGene00020386","V",3950027,3952097,2070
"17146","WBGene00020388","V",1848073,1851445,3372
"17147","WBGene00020389","V",1864181,1868571,4390
"17148","WBGene00020390","V",1870421,1871789,1368
"17149","WBGene00020391","V",1872246,1875526,3280
"17150","WBGene00020392","V",1869213,1870558,1345
"17151","WBGene00020393","V",1846201,1848015,1814
"17152","WBGene00020394","V",1842044,1844807,2763
"17153","WBGene00020396","V",1852449,1856276,3827
"17154","WBGene00020397","I",6951135,6951982,847
"17155","WBGene00020398","I",6931138,6936928,5790
"17156","WBGene00020399","I",6926262,6929664,3402
"17157","WBGene00020400","I",6937504,6939618,2114
"17158","WBGene00020401","I",6940249,6941950,1701
"17159","WBGene00020402","I",6943176,6945358,2182
"17160","WBGene00020403","I",6945596,6950499,4903
"17161","WBGene00020404","I",6951900,6954252,2352
"17162","WBGene00020406","II",3150140,3152575,2435
"17163","WBGene00020407","II",3129179,3131288,2109
"17164","WBGene00020408","II",3119332,3123192,3860
"17165","WBGene00020409","II",3117771,3118451,680
"17166","WBGene00020411","I",6545110,6546593,1483
"17167","WBGene00020412","I",6542090,6544966,2876
"17168","WBGene00020413","I",6534072,6539193,5121
"17169","WBGene00020414","I",6525045,6528689,3644
"17170","WBGene00020415","I",6521829,6523442,1613
"17171","WBGene00020416","I",6529158,6530099,941
"17172","WBGene00020417","I",6530131,6531963,1832
"17173","WBGene00020418","I",6539129,6541084,1955
"17174","WBGene00020419","I",6546615,6548675,2060
"17175","WBGene00020420","X",6311715,6314588,2873
"17176","WBGene00020421","X",6314529,6322819,8290
"17177","WBGene00020422","III",5163766,5165311,1545
"17178","WBGene00020423","III",5169933,5172045,2112
"17179","WBGene00020424","V",6649617,6652050,2433
"17180","WBGene00020425","V",6653613,6655449,1836
"17181","WBGene00020426","X",2294750,2298193,3443
"17182","WBGene00020427","X",2283998,2287188,3190
"17183","WBGene00020428","II",2956065,2958191,2126
"17184","WBGene00020430","II",2944176,2946533,2357
"17185","WBGene00020431","II",2940996,2944077,3081
"17186","WBGene00020432","II",2952957,2956040,3083
"17187","WBGene00020433","IV",5479589,5480644,1055
"17188","WBGene00020434","IV",5477214,5478708,1494
"17189","WBGene00020435","IV",5474162,5476568,2406
"17190","WBGene00020436","III",6251811,6271282,19471
"17191","WBGene00020437","III",6248317,6251607,3290
"17192","WBGene00020438","III",6240775,6241581,806
"17193","WBGene00020439","III",6233718,6239336,5618
"17194","WBGene00020440","III",6241850,6244383,2533
"17195","WBGene00020441","III",6244672,6246039,1367
"17196","WBGene00020442","III",6245932,6248234,2302
"17197","WBGene00020443","III",6224491,6229403,4912
"17198","WBGene00020444","IV",7382415,7384752,2337
"17199","WBGene00020445","IV",7376811,7378906,2095
"17200","WBGene00020446","IV",7375147,7376635,1488
"17201","WBGene00020447","IV",7384756,7388943,4187
"17202","WBGene00020448","III",962304,963679,1375
"17203","WBGene00020449","III",956334,957947,1613
"17204","WBGene00020450","III",952419,953803,1384
"17205","WBGene00020451","III",950869,952264,1395
"17206","WBGene00020452","III",938869,939437,568
"17207","WBGene00020453","III",933585,936067,2482
"17208","WBGene00020454","III",937302,938061,759
"17209","WBGene00020455","III",940879,943469,2590
"17210","WBGene00020456","III",944795,946298,1503
"17211","WBGene00020457","III",949300,950670,1370
"17212","WBGene00020458","III",960268,961347,1079
"17213","WBGene00020459","III",947848,949092,1244
"17214","WBGene00020460","II",4435300,4436995,1695
"17215","WBGene00020461","II",4458263,4460404,2141
"17216","WBGene00020462","IV",5551134,5558820,7686
"17217","WBGene00020463","IV",5544860,5548459,3599
"17218","WBGene00020464","IV",5541607,5544765,3158
"17219","WBGene00020465","IV",5567020,5574133,7113
"17220","WBGene00020466","I",3741456,3742646,1190
"17221","WBGene00020467","I",3731352,3732940,1588
"17222","WBGene00020468","IV",6276256,6277023,767
"17223","WBGene00020469","IV",6253300,6253785,485
"17224","WBGene00020471","II",1097926,1100819,2893
"17225","WBGene00020472","II",1108841,1110992,2151
"17226","WBGene00020473","II",1112189,1114226,2037
"17227","WBGene00020474","II",1115641,1118033,2392
"17228","WBGene00020475","II",1121018,1123259,2241
"17229","WBGene00020476","II",1101371,1104509,3138
"17230","WBGene00020478","II",6792191,6799265,7074
"17231","WBGene00020479","II",6789248,6791782,2534
"17232","WBGene00020480","II",6777076,6777889,813
"17233","WBGene00020481","II",6783427,6788255,4828
"17234","WBGene00020482","II",6779464,6781686,2222
"17235","WBGene00020483","X",6185009,6186770,1761
"17236","WBGene00020484","X",6179241,6180140,899
"17237","WBGene00020485","X",6191590,6194241,2651
"17238","WBGene00020486","X",6206581,6207626,1045
"17239","WBGene00020487","X",6180650,6181425,775
"17240","WBGene00020488","X",1193148,1193858,710
"17241","WBGene00020489","X",1180284,1187932,7648
"17242","WBGene00020490","X",1163153,1177172,14019
"17243","WBGene00020491","X",1188453,1190752,2299
"17244","WBGene00020492","X",1195108,1198481,3373
"17245","WBGene00020494","X",1202606,1203763,1157
"17246","WBGene00020496","X",4596016,4605928,9912
"17247","WBGene00020497","IV",7821673,7822700,1027
"17248","WBGene00020498","II",6736904,6741482,4578
"17249","WBGene00020499","II",6736203,6736793,590
"17250","WBGene00020500","II",6734907,6736110,1203
"17251","WBGene00020501","II",6716863,6717868,1005
"17252","WBGene00020502","II",6720177,6729302,9125
"17253","WBGene00020503","II",6730207,6733795,3588
"17254","WBGene00020504","X",6553288,6564207,10919
"17255","WBGene00020505","X",6542992,6543983,991
"17256","WBGene00020506","X",6564175,6569518,5343
"17257","WBGene00020507","X",2237911,2240255,2344
"17258","WBGene00020508","X",2234321,2236706,2385
"17259","WBGene00020509","X",2221150,2226620,5470
"17260","WBGene00020510","X",2688945,2692022,3077
"17261","WBGene00020511","X",2682754,2687184,4430
"17262","WBGene00020515","X",3758699,3759445,746
"17263","WBGene00020516","V",6842737,6846652,3915
"17264","WBGene00020517","V",6839256,6840254,998
"17265","WBGene00020520","V",6821809,6826872,5063
"17266","WBGene00020522","V",6810421,6814961,4540
"17267","WBGene00020523","V",6815666,6817284,1618
"17268","WBGene00020524","V",6817890,6819912,2022
"17269","WBGene00020525","V",6827071,6828886,1815
"17270","WBGene00020526","V",6832290,6835342,3052
"17271","WBGene00020527","V",6836725,6838630,1905
"17272","WBGene00020528","V",6840217,6846590,6373
"17273","WBGene00020530","III",5288180,5298361,10181
"17274","WBGene00020531","III",5300008,5301886,1878
"17275","WBGene00020532","II",2098871,2104149,5278
"17276","WBGene00020533","II",2095304,2098671,3367
"17277","WBGene00020534","II",2084129,2084891,762
"17278","WBGene00020535","II",2081557,2082016,459
"17279","WBGene00020536","II",2083595,2083826,231
"17280","WBGene00020537","II",2092681,2093876,1195
"17281","WBGene00020539","II",5241233,5241660,427
"17282","WBGene00020540","III",134494,137975,3481
"17283","WBGene00020541","III",140134,141209,1075
"17284","WBGene00020542","III",142121,143217,1096
"17285","WBGene00020543","III",143631,144792,1161
"17286","WBGene00020544","III",145360,146491,1131
"17287","WBGene00020545","III",152572,153418,846
"17288","WBGene00020546","III",154475,156674,2199
"17289","WBGene00020547","III",150481,151805,1324
"17290","WBGene00020548","III",144994,145299,305
"17291","WBGene00020549","III",6114482,6116331,1849
"17292","WBGene00020550","III",740613,742974,2361
"17293","WBGene00020551","III",755298,758080,2782
"17294","WBGene00020553","V",8957045,8961935,4890
"17295","WBGene00020554","V",8939592,8944063,4471
"17296","WBGene00020555","V",8964711,8968406,3695
"17297","WBGene00020556","I",5702156,5706838,4682
"17298","WBGene00020557","I",5678638,5679862,1224
"17299","WBGene00020558","I",5674304,5676609,2305
"17300","WBGene00020559","III",607045,609973,2928
"17301","WBGene00020560","III",614707,617447,2740
"17302","WBGene00020561","III",610881,614547,3666
"17303","WBGene00020562","III",618246,620254,2008
"17304","WBGene00020563","III",624607,627938,3331
"17305","WBGene00020564","III",628175,630987,2812
"17306","WBGene00020565","III",634893,636167,1274
"17307","WBGene00020566","III",606004,606994,990
"17308","WBGene00020567","X",3931631,3937897,6266
"17309","WBGene00020568","X",3939401,3940092,691
"17310","WBGene00020569","X",673027,676484,3457
"17311","WBGene00020571","X",656188,658511,2323
"17312","WBGene00020572","X",658477,661777,3300
"17313","WBGene00020573","X",664714,666300,1586
"17314","WBGene00020574","X",669684,670800,1116
"17315","WBGene00020575","X",676435,680419,3984
"17316","WBGene00020576","II",6666898,6673752,6854
"17317","WBGene00020577","II",6661335,6665206,3871
"17318","WBGene00020578","II",6660274,6660994,720
"17319","WBGene00020579","II",6631105,6637099,5994
"17320","WBGene00020580","II",6634902,6636163,1261
"17321","WBGene00020581","II",6637093,6643117,6024
"17322","WBGene00020582","II",6647166,6649126,1960
"17323","WBGene00020583","II",6652339,6654384,2045
"17324","WBGene00020584","II",6655096,6658866,3770
"17325","WBGene00020585","IV",5653949,5655004,1055
"17326","WBGene00020586","V",6870304,6873809,3505
"17327","WBGene00020587","V",4896028,4897969,1941
"17328","WBGene00020588","V",4890429,4891422,993
"17329","WBGene00020589","V",4885672,4886809,1137
"17330","WBGene00020590","V",4874923,4877685,2762
"17331","WBGene00020591","V",4882178,4884319,2141
"17332","WBGene00020592","V",4887187,4889629,2442
"17333","WBGene00020593","V",4892588,4895071,2483
"17334","WBGene00020594","V",4898217,4900082,1865
"17335","WBGene00020595","X",9331133,9336632,5499
"17336","WBGene00020596","X",9343333,9347430,4097
"17337","WBGene00020597","III",2897711,2898802,1091
"17338","WBGene00020598","III",2893433,2897183,3750
"17339","WBGene00020599","III",2899441,2900402,961
"17340","WBGene00020600","III",7386229,7391135,4906
"17341","WBGene00020601","III",7382115,7383906,1791
"17342","WBGene00020602","III",7367710,7369538,1828
"17343","WBGene00020603","III",7366717,7367112,395
"17344","WBGene00020604","III",7377854,7379045,1191
"17345","WBGene00020605","III",7391482,7395454,3972
"17346","WBGene00020607","V",3428999,3430408,1409
"17347","WBGene00020608","V",3426376,3427733,1357
"17348","WBGene00020609","V",3418263,3422733,4470
"17349","WBGene00020611","V",3413344,3417770,4426
"17350","WBGene00020612","V",3410520,3412858,2338
"17351","WBGene00020613","V",3408912,3409519,607
"17352","WBGene00020614","V",3405709,3407893,2184
"17353","WBGene00020615","V",3402631,3405161,2530
"17354","WBGene00020616","V",3400252,3401063,811
"17355","WBGene00020617","V",3398690,3399640,950
"17356","WBGene00020618","V",3397065,3397800,735
"17357","WBGene00020619","V",3392111,3393296,1185
"17358","WBGene00020620","V",3393544,3394744,1200
"17359","WBGene00020622","V",3395275,3395966,691
"17360","WBGene00020623","V",3422949,3424441,1492
"17361","WBGene00020624","V",3430669,3431446,777
"17362","WBGene00020625","I",3909629,3910544,915
"17363","WBGene00020626","I",3912635,3915458,2823
"17364","WBGene00020627","I",3917911,3920172,2261
"17365","WBGene00020628","I",3920177,3925162,4985
"17366","WBGene00020629","I",3925434,3927887,2453
"17367","WBGene00020630","X",16872926,16878351,5425
"17368","WBGene00020631","X",16860396,16861387,991
"17369","WBGene00020632","X",16845374,16862005,16631
"17370","WBGene00020633","X",16866069,16869031,2962
"17371","WBGene00020634","X",16878148,16880526,2378
"17372","WBGene00020635","III",7241365,7242950,1585
"17373","WBGene00020636","III",7232926,7234202,1276
"17374","WBGene00020637","III",2249932,2251448,1516
"17375","WBGene00020638","III",2257554,2258941,1387
"17376","WBGene00020639","III",2255949,2256949,1000
"17377","WBGene00020640","III",2253449,2254783,1334
"17378","WBGene00020641","III",2251957,2252989,1032
"17379","WBGene00020642","III",2246016,2249404,3388
"17380","WBGene00020645","X",2095370,2096058,688
"17381","WBGene00020646","III",7245703,7247937,2234
"17382","WBGene00020647","IV",259970,261683,1713
"17383","WBGene00020648","IV",288803,291456,2653
"17384","WBGene00020649","IV",274570,279940,5370
"17385","WBGene00020650","IV",269407,272099,2692
"17386","WBGene00020651","IV",266448,268322,1874
"17387","WBGene00020652","I",3932210,3934813,2603
"17388","WBGene00020653","I",3930830,3931552,722
"17389","WBGene00020655","I",4401956,4404585,2629
"17390","WBGene00020656","I",4412295,4413221,926
"17391","WBGene00020657","X",16711681,16720658,8977
"17392","WBGene00020658","X",5630248,5631824,1576
"17393","WBGene00020659","I",6874304,6876928,2624
"17394","WBGene00020660","I",6870415,6871911,1496
"17395","WBGene00020661","I",6872597,6873755,1158
"17396","WBGene00020662","V",1176724,1178864,2140
"17397","WBGene00020663","V",1141770,1146498,4728
"17398","WBGene00020664","V",1158251,1164293,6042
"17399","WBGene00020665","X",3926081,3929576,3495
"17400","WBGene00020666","X",3921068,3923233,2165
"17401","WBGene00020667","X",3917301,3919835,2534
"17402","WBGene00020669","X",3908144,3911380,3236
"17403","WBGene00020670","X",3914765,3915848,1083
"17404","WBGene00020672","X",5647378,5650213,2835
"17405","WBGene00020673","X",5638582,5641363,2781
"17406","WBGene00020674","X",5651869,5653925,2056
"17407","WBGene00020675","IV",4692793,4696826,4033
"17408","WBGene00020678","IV",4679018,4685168,6150
"17409","WBGene00020679","IV",4696982,4704011,7029
"17410","WBGene00020680","IV",6923370,6925407,2037
"17411","WBGene00020682","IV",6913536,6917110,3574
"17412","WBGene00020683","IV",6910683,6912865,2182
"17413","WBGene00020684","IV",6903950,6905546,1596
"17414","WBGene00020686","IV",6900326,6903624,3298
"17415","WBGene00020687","IV",6917111,6919454,2343
"17416","WBGene00020688","IV",6926140,6928517,2377
"17417","WBGene00020689","IV",6928942,6937713,8771
"17418","WBGene00020690","X",6412886,6413488,602
"17419","WBGene00020691","X",6385280,6387863,2583
"17420","WBGene00020692","X",6414148,6416400,2252
"17421","WBGene00020693","I",5768919,5773627,4708
"17422","WBGene00020694","I",5764030,5768190,4160
"17423","WBGene00020695","V",3586639,3589015,2376
"17424","WBGene00020696","V",3579023,3585042,6019
"17425","WBGene00020697","V",3597753,3601021,3268
"17426","WBGene00020698","V",3602052,3605425,3373
"17427","WBGene00020699","V",3606818,3610927,4109
"17428","WBGene00020700","V",3612173,3614551,2378
"17429","WBGene00020701","III",542066,546537,4471
"17430","WBGene00020702","III",518356,524044,5688
"17431","WBGene00020703","III",525234,526924,1690
"17432","WBGene00020704","III",513720,516614,2894
"17433","WBGene00020705","V",359766,363705,3939
"17434","WBGene00020706","V",349374,359016,9642
"17435","WBGene00020707","V",343428,347623,4195
"17436","WBGene00020708","V",334646,336861,2215
"17437","WBGene00020709","I",6717819,6719430,1611
"17438","WBGene00020710","I",6715949,6717090,1141
"17439","WBGene00020711","I",6711512,6712327,815
"17440","WBGene00020712","I",6687349,6691662,4313
"17441","WBGene00020713","I",6705546,6706422,876
"17442","WBGene00020714","I",6706766,6708919,2153
"17443","WBGene00020715","II",4842560,4842998,438
"17444","WBGene00020716","V",8469040,8470072,1032
"17445","WBGene00020717","V",8467265,8468943,1678
"17446","WBGene00020718","V",8465617,8467159,1542
"17447","WBGene00020719","V",8462327,8465569,3242
"17448","WBGene00020720","V",8446608,8448009,1401
"17449","WBGene00020721","V",8457616,8460419,2803
"17450","WBGene00020722","V",8470013,8471244,1231
"17451","WBGene00020725","X",17135975,17138110,2135
"17452","WBGene00020726","X",17147531,17149927,2396
"17453","WBGene00020727","X",17155088,17157957,2869
"17454","WBGene00020728","IV",3151361,3155987,4626
"17455","WBGene00020729","IV",3139833,3146723,6890
"17456","WBGene00020730","IV",3146894,3148882,1988
"17457","WBGene00020732","X",17671029,17680793,9764
"17458","WBGene00020735","X",5496122,5505248,9126
"17459","WBGene00020736","X",5511997,5512327,330
"17460","WBGene00020737","X",5514798,5515080,282
"17461","WBGene00020738","X",5516454,5517162,708
"17462","WBGene00020739","II",1166490,1169168,2678
"17463","WBGene00020740","II",1163575,1165488,1913
"17464","WBGene00020741","II",1169546,1172130,2584
"17465","WBGene00020742","I",6441637,6446465,4828
"17466","WBGene00020743","I",6453875,6456984,3109
"17467","WBGene00020744","V",3559075,3559695,620
"17468","WBGene00020746","V",3530703,3532380,1677
"17469","WBGene00020747","V",3525274,3526178,904
"17470","WBGene00020748","V",3533003,3535235,2232
"17471","WBGene00020749","V",3538929,3540329,1400
"17472","WBGene00020750","V",3541586,3543444,1858
"17473","WBGene00020751","V",3544081,3544969,888
"17474","WBGene00020752","V",3545677,3546617,940
"17475","WBGene00020753","V",3561460,3562919,1459
"17476","WBGene00020755","V",3557206,3557778,572
"17477","WBGene00020756","V",3553134,3554568,1434
"17478","WBGene00020757","III",879860,881506,1646
"17479","WBGene00020758","III",867512,869987,2475
"17480","WBGene00020759","III",871783,872385,602
"17481","WBGene00020760","III",872622,873531,909
"17482","WBGene00020761","III",877435,879734,2299
"17483","WBGene00020762","III",881443,886789,5346
"17484","WBGene00020763","III",889955,895634,5679
"17485","WBGene00020764","X",2199145,2201153,2008
"17486","WBGene00020765","X",2196525,2203961,7436
"17487","WBGene00020766","X",2204050,2205063,1013
"17488","WBGene00020767","X",2360097,2364818,4721
"17489","WBGene00020769","X",2365700,2365942,242
"17490","WBGene00020770","X",16398958,16417063,18105
"17491","WBGene00020771","II",3785557,3786666,1109
"17492","WBGene00020772","II",3782950,3784156,1206
"17493","WBGene00020773","II",3776019,3777459,1440
"17494","WBGene00020774","II",3753921,3757428,3507
"17495","WBGene00020775","II",3760300,3761699,1399
"17496","WBGene00020777","II",3765087,3773191,8104
"17497","WBGene00020778","II",3778406,3779563,1157
"17498","WBGene00020779","III",5440862,5442761,1899
"17499","WBGene00020781","II",6247311,6250841,3530
"17500","WBGene00020782","II",6246354,6247334,980
"17501","WBGene00020783","II",6245748,6246257,509
"17502","WBGene00020784","II",6234483,6244287,9804
"17503","WBGene00020785","X",6173956,6175413,1457
"17504","WBGene00020786","X",6169305,6173748,4443
"17505","WBGene00020787","X",9040416,9041058,642
"17506","WBGene00020788","X",9034554,9038547,3993
"17507","WBGene00020789","X",9027604,9028285,681
"17508","WBGene00020790","X",9015773,9016799,1026
"17509","WBGene00020791","X",9020588,9021755,1167
"17510","WBGene00020792","X",9021922,9022833,911
"17511","WBGene00020793","X",16519483,16522295,2812
"17512","WBGene00020794","X",16515565,16519175,3610
"17513","WBGene00020795","X",16505248,16507411,2163
"17514","WBGene00020796","II",154875,156043,1168
"17515","WBGene00020797","II",152525,154936,2411
"17516","WBGene00020798","II",147241,152825,5584
"17517","WBGene00020799","II",6403401,6405040,1639
"17518","WBGene00020800","II",6398706,6400940,2234
"17519","WBGene00020801","II",6407537,6410281,2744
"17520","WBGene00020802","II",6401949,6403102,1153
"17521","WBGene00020803","II",5578318,5579965,1647
"17522","WBGene00020804","II",5580125,5582409,2284
"17523","WBGene00020805","V",6768429,6768788,359
"17524","WBGene00020806","V",6745039,6748613,3574
"17525","WBGene00020807","V",6760442,6762461,2019
"17526","WBGene00020808","V",6765560,6768732,3172
"17527","WBGene00020809","X",17247378,17250082,2704
"17528","WBGene00020811","X",17231790,17234790,3000
"17529","WBGene00020812","X",17215018,17217105,2087
"17530","WBGene00020813","X",17225197,17230208,5011
"17531","WBGene00020817","X",17236933,17237855,922
"17532","WBGene00020819","III",6467382,6471510,4128
"17533","WBGene00020820","III",6460120,6462222,2102
"17534","WBGene00020821","III",6454483,6460014,5531
"17535","WBGene00020822","III",6448075,6450696,2621
"17536","WBGene00020823","III",6462216,6462856,640
"17537","WBGene00020824","IV",8433038,8438004,4966
"17538","WBGene00020825","IV",8424278,8428512,4234
"17539","WBGene00020826","IV",8425132,8426199,1067
"17540","WBGene00020827","IV",8428961,8431493,2532
"17541","WBGene00020828","X",1836337,1837368,1031
"17542","WBGene00020829","X",1834445,1839024,4579
"17543","WBGene00020830","X",1840554,1845565,5011
"17544","WBGene00020831","IV",3258910,3263489,4579
"17545","WBGene00020832","IV",3263851,3265372,1521
"17546","WBGene00020833","IV",3269527,3273397,3870
"17547","WBGene00020834","II",530848,536860,6012
"17548","WBGene00020835","II",535578,546944,11366
"17549","WBGene00020836","II",526574,530374,3800
"17550","WBGene00020837","II",522594,525983,3389
"17551","WBGene00020838","I",6122590,6126851,4261
"17552","WBGene00020839","I",6110134,6114537,4403
"17553","WBGene00020840","I",6098927,6099731,804
"17554","WBGene00020841","I",6100261,6101789,1528
"17555","WBGene00020842","I",6105863,6107715,1852
"17556","WBGene00020843","I",6107809,6109679,1870
"17557","WBGene00020844","X",3585911,3586835,924
"17558","WBGene00020845","X",3573051,3573562,511
"17559","WBGene00020846","X",3588858,3596497,7639
"17560","WBGene00020847","X",3597276,3600475,3199
"17561","WBGene00020849","V",2288328,2290468,2140
"17562","WBGene00020850","V",2294822,2296967,2145
"17563","WBGene00020851","V",2285432,2287520,2088
"17564","WBGene00020852","V",2281828,2284963,3135
"17565","WBGene00020853","V",2278826,2281387,2561
"17566","WBGene00020854","V",3712779,3715969,3190
"17567","WBGene00020855","V",3727482,3739398,11916
"17568","WBGene00020856","I",10904370,10906527,2157
"17569","WBGene00020857","I",10899110,10902024,2914
"17570","WBGene00020858","I",10881553,10892189,10636
"17571","WBGene00020859","I",10876209,10877695,1486
"17572","WBGene00020860","I",10878047,10878378,331
"17573","WBGene00020861","V",9092345,9094345,2000
"17574","WBGene00020862","V",9067976,9068390,414
"17575","WBGene00020863","V",9068368,9069694,1326
"17576","WBGene00020864","V",9069865,9073528,3663
"17577","WBGene00020865","V",9074784,9076322,1538
"17578","WBGene00020866","II",4994002,4995607,1605
"17579","WBGene00020867","II",4969186,4988934,19748
"17580","WBGene00020868","II",4990831,4993580,2749
"17581","WBGene00020869","V",3280379,3281169,790
"17582","WBGene00020870","V",3275333,3276110,777
"17583","WBGene00020871","V",3274054,3274374,320
"17584","WBGene00020872","V",3270553,3271242,689
"17585","WBGene00020873","V",3262571,3263235,664
"17586","WBGene00020874","V",3260375,3262082,1707
"17587","WBGene00020875","V",3249743,3250205,462
"17588","WBGene00020877","V",3254602,3256151,1549
"17589","WBGene00020878","V",3258372,3259218,846
"17590","WBGene00020879","V",3263482,3266289,2807
"17591","WBGene00020880","V",3266828,3268050,1222
"17592","WBGene00020881","V",3268809,3269510,701
"17593","WBGene00020882","V",3271395,3273256,1861
"17594","WBGene00020883","V",3276956,3278147,1191
"17595","WBGene00020884","X",6587898,6596135,8237
"17596","WBGene00020885","X",6582004,6585237,3233
"17597","WBGene00020886","X",6596425,6597121,696
"17598","WBGene00020887","X",6597918,6598866,948
"17599","WBGene00020888","V",6331907,6334008,2101
"17600","WBGene00020889","V",6329197,6331074,1877
"17601","WBGene00020890","V",6327223,6328865,1642
"17602","WBGene00020891","V",6316932,6326390,9458
"17603","WBGene00020892","V",6314176,6316467,2291
"17604","WBGene00020893","V",6334014,6336119,2105
"17605","WBGene00020894","II",6492402,6493778,1376
"17606","WBGene00020895","II",6485677,6488861,3184
"17607","WBGene00020896","II",6476953,6478073,1120
"17608","WBGene00020897","II",6474338,6482125,7787
"17609","WBGene00020898","II",6483953,6484967,1014
"17610","WBGene00020899","II",6491469,6491993,524
"17611","WBGene00020900","I",3639648,3641347,1699
"17612","WBGene00020901","I",3637353,3638819,1466
"17613","WBGene00020902","I",3631086,3636485,5399
"17614","WBGene00020903","I",3655413,3662183,6770
"17615","WBGene00020904","V",4513033,4516947,3914
"17616","WBGene00020905","IV",5015276,5016281,1005
"17617","WBGene00020906","IV",5017989,5020654,2665
"17618","WBGene00020908","V",7085916,7088854,2938
"17619","WBGene00020909","V",6499224,6502428,3204
"17620","WBGene00020910","V",6497110,6498484,1374
"17621","WBGene00020911","V",6490068,6493921,3853
"17622","WBGene00020912","V",6504538,6505500,962
"17623","WBGene00020913","I",3299606,3300490,884
"17624","WBGene00020914","I",3287336,3293127,5791
"17625","WBGene00020915","I",3267094,3269116,2022
"17626","WBGene00020917","I",3293142,3294356,1214
"17627","WBGene00020918","X",5692399,5694426,2027
"17628","WBGene00020919","X",5675246,5680225,4979
"17629","WBGene00020920","X",5680349,5684741,4392
"17630","WBGene00020921","X",5694475,5697308,2833
"17631","WBGene00020922","X",4218279,4218458,179
"17632","WBGene00020923","III",668098,668433,335
"17633","WBGene00020924","III",680634,683418,2784
"17634","WBGene00020927","III",686237,692033,5796
"17635","WBGene00020929","IV",4005477,4007848,2371
"17636","WBGene00020930","IV",4014799,4034784,19985
"17637","WBGene00020931","I",6741274,6741877,603
"17638","WBGene00020932","I",6736680,6741175,4495
"17639","WBGene00020933","I",6719368,6723059,3691
"17640","WBGene00020935","I",6745991,6753031,7040
"17641","WBGene00020936","I",6753219,6756348,3129
"17642","WBGene00020937","I",6741984,6742358,374
"17643","WBGene00020938","V",8307942,8310766,2824
"17644","WBGene00020939","V",8293809,8294900,1091
"17645","WBGene00020940","V",8296558,8297604,1046
"17646","WBGene00020941","V",8297700,8299244,1544
"17647","WBGene00020942","V",8299753,8301507,1754
"17648","WBGene00020943","V",8305120,8306460,1340
"17649","WBGene00020944","V",8326285,8326699,414
"17650","WBGene00020945","V",8318435,8322863,4428
"17651","WBGene00020946","V",8302887,8304469,1582
"17652","WBGene00020947","V",6695147,6697652,2505
"17653","WBGene00020948","V",6703057,6704573,1516
"17654","WBGene00020949","V",6704551,6706932,2381
"17655","WBGene00020950","V",6707058,6709101,2043
"17656","WBGene00020951","V",6709579,6710679,1100
"17657","WBGene00020952","V",2671464,2688500,17036
"17658","WBGene00020953","V",2672986,2674026,1040
"17659","WBGene00020954","V",2666866,2670234,3368
"17660","WBGene00020955","V",2653079,2662655,9576
"17661","WBGene00020957","V",2639335,2646594,7259
"17662","WBGene00020961","V",2622052,2625460,3408
"17663","WBGene00020962","V",2647037,2652712,5675
"17664","WBGene00020964","III",5791171,5803042,11871
"17665","WBGene00020966","III",5407888,5413177,5289
"17666","WBGene00020967","III",5406102,5407968,1866
"17667","WBGene00020970","III",5431407,5440634,9227
"17668","WBGene00020971","IV",4334253,4334988,735
"17669","WBGene00020972","IV",4326656,4332018,5362
"17670","WBGene00020973","IV",4332692,4335372,2680
"17671","WBGene00020976","IV",4336834,4341304,4470
"17672","WBGene00020977","IV",4342357,4346558,4201
"17673","WBGene00020978","IV",4352618,4356979,4361
"17674","WBGene00020979","IV",4068780,4069548,768
"17675","WBGene00020981","IV",4056586,4058243,1657
"17676","WBGene00020982","IV",4062567,4063673,1106
"17677","WBGene00020983","IV",4073303,4074694,1391
"17678","WBGene00020984","I",2788768,2790343,1575
"17679","WBGene00020985","I",2798175,2800878,2703
"17680","WBGene00020986","I",2820869,2822300,1431
"17681","WBGene00020987","I",2816415,2817646,1231
"17682","WBGene00020988","I",2796130,2797238,1108
"17683","WBGene00020989","I",2791687,2794976,3289
"17684","WBGene00020990","I",2784620,2786077,1457
"17685","WBGene00020991","I",2786332,2787514,1182
"17686","WBGene00020992","IV",5190444,5192546,2102
"17687","WBGene00020993","IV",5185333,5189096,3763
"17688","WBGene00020994","IV",5184123,5185240,1117
"17689","WBGene00020995","IV",5185523,5186580,1057
"17690","WBGene00020997","IV",5189042,5195627,6585
"17691","WBGene00020999","V",124010,126758,2748
"17692","WBGene00021000","V",127000,128034,1034
"17693","WBGene00021001","V",132450,134993,2543
"17694","WBGene00021002","V",147538,152104,4566
"17695","WBGene00021003","V",138892,140225,1333
"17696","WBGene00021004","V",128237,131754,3517
"17697","WBGene00021005","I",2219471,2222313,2842
"17698","WBGene00021006","I",2233744,2234957,1213
"17699","WBGene00021007","I",2235617,2241210,5593
"17700","WBGene00021008","I",2216100,2219479,3379
"17701","WBGene00021009","I",2160042,2209629,49587
"17702","WBGene00021010","IV",524652,526479,1827
"17703","WBGene00021011","IV",505069,506600,1531
"17704","WBGene00021012","IV",506737,519457,12720
"17705","WBGene00021013","IV",527998,528951,953
"17706","WBGene00021014","I",4962451,4964745,2294
"17707","WBGene00021015","I",4959396,4961525,2129
"17708","WBGene00021016","I",4968007,4970245,2238
"17709","WBGene00021017","I",4986954,4989454,2500
"17710","WBGene00021018","III",2428204,2429430,1226
"17711","WBGene00021019","III",2424355,2427738,3383
"17712","WBGene00021020","III",2418345,2423912,5567
"17713","WBGene00021021","III",2406308,2410985,4677
"17714","WBGene00021022","III",2411090,2418205,7115
"17715","WBGene00021023","III",2433550,2435227,1677
"17716","WBGene00021024","I",488607,489905,1298
"17717","WBGene00021025","I",477582,481954,4372
"17718","WBGene00021026","I",461995,462651,656
"17719","WBGene00021027","I",462657,467131,4474
"17720","WBGene00021028","I",484126,487990,3864
"17721","WBGene00021029","III",5836926,5837183,257
"17722","WBGene00021030","II",609071,609332,261
"17723","WBGene00021031","II",605584,605995,411
"17724","WBGene00021032","II",609769,612461,2692
"17725","WBGene00021033","IV",3436319,3437878,1559
"17726","WBGene00021034","I",3364027,3365857,1830
"17727","WBGene00021035","I",3367640,3368550,910
"17728","WBGene00021036","I",3374776,3407189,32413
"17729","WBGene00021037","I",3371769,3373834,2065
"17730","WBGene00021038","I",3368785,3371444,2659
"17731","WBGene00021039","I",3352415,3359487,7072
"17732","WBGene00021040","III",57702,58682,980
"17733","WBGene00021041","III",35454,39462,4008
"17734","WBGene00021042","III",59869,61166,1297
"17735","WBGene00021043","III",62888,66261,3373
"17736","WBGene00021044","X",1450768,1452306,1538
"17737","WBGene00021045","X",1435098,1435916,818
"17738","WBGene00021046","X",1439261,1440261,1000
"17739","WBGene00021047","X",1440366,1446643,6277
"17740","WBGene00021048","X",6272089,6273768,1679
"17741","WBGene00021049","X",6267043,6271087,4044
"17742","WBGene00021050","X",6252274,6253785,1511
"17743","WBGene00021051","X",6263648,6266913,3265
"17744","WBGene00021052","II",4067558,4069771,2213
"17745","WBGene00021053","II",4058956,4061698,2742
"17746","WBGene00021054","II",4063008,4064057,1049
"17747","WBGene00021055","II",4055939,4057707,1768
"17748","WBGene00021056","II",4471595,4473591,1996
"17749","WBGene00021057","II",4468169,4471038,2869
"17750","WBGene00021058","II",4461130,4467895,6765
"17751","WBGene00021059","X",5849104,5851971,2867
"17752","WBGene00021060","X",5838039,5839778,1739
"17753","WBGene00021061","III",642059,645613,3554
"17754","WBGene00021063","III",636479,638419,1940
"17755","WBGene00021066","V",6206755,6208551,1796
"17756","WBGene00021067","V",6204875,6206134,1259
"17757","WBGene00021068","V",6221249,6227047,5798
"17758","WBGene00021070","V",1134485,1139172,4687
"17759","WBGene00021072","V",1130088,1131942,1854
"17760","WBGene00021073","II",471247,475940,4693
"17761","WBGene00021074","II",480722,484386,3664
"17762","WBGene00021075","II",495424,498659,3235
"17763","WBGene00021076","II",476222,478063,1841
"17764","WBGene00021078","V",3687110,3701864,14754
"17765","WBGene00021079","V",3684664,3685830,1166
"17766","WBGene00021080","V",3682853,3686474,3621
"17767","WBGene00021081","V",3673380,3676632,3252
"17768","WBGene00021082","IV",3311276,3313180,1904
"17769","WBGene00021083","IV",3305898,3306541,643
"17770","WBGene00021084","IV",3303980,3304567,587
"17771","WBGene00021085","IV",3302358,3302973,615
"17772","WBGene00021086","IV",3300792,3301300,508
"17773","WBGene00021087","IV",3298629,3299687,1058
"17774","WBGene00021088","IV",3295135,3297225,2090
"17775","WBGene00021089","IV",3292120,3294633,2513
"17776","WBGene00021090","IV",3306664,3307563,899
"17777","WBGene00021091","II",593521,593860,339
"17778","WBGene00021092","II",587910,588926,1016
"17779","WBGene00021093","II",580602,582014,1412
"17780","WBGene00021094","II",567666,568876,1210
"17781","WBGene00021095","II",569236,572110,2874
"17782","WBGene00021096","II",574872,577732,2860
"17783","WBGene00021097","II",577839,580593,2754
"17784","WBGene00021099","II",590578,591210,632
"17785","WBGene00021100","II",592489,593104,615
"17786","WBGene00021101","II",582111,584403,2292
"17787","WBGene00021103","II",1123534,1127791,4257
"17788","WBGene00021104","II",1132302,1134240,1938
"17789","WBGene00021105","II",1139277,1142360,3083
"17790","WBGene00021108","V",8824559,8825203,644
"17791","WBGene00021109","I",4717623,4719575,1952
"17792","WBGene00021110","I",4711414,4713572,2158
"17793","WBGene00021111","I",4706682,4708762,2080
"17794","WBGene00021112","I",4704598,4705881,1283
"17795","WBGene00021113","I",4709262,4710712,1450
"17796","WBGene00021114","I",4714320,4715485,1165
"17797","WBGene00021115","I",4716059,4717441,1382
"17798","WBGene00021116","II",3525172,3528516,3344
"17799","WBGene00021117","II",3519494,3520421,927
"17800","WBGene00021118","II",3516008,3518898,2890
"17801","WBGene00021120","IV",1231897,1232812,915
"17802","WBGene00021121","IV",1229080,1230789,1709
"17803","WBGene00021122","IV",1226182,1227668,1486
"17804","WBGene00021123","IV",1216590,1218527,1937
"17805","WBGene00021124","III",201279,207092,5813
"17806","WBGene00021125","I",2845859,2849792,3933
"17807","WBGene00021126","I",2832872,2833253,381
"17808","WBGene00021127","I",2851963,2853903,1940
"17809","WBGene00021128","I",2853975,2855732,1757
"17810","WBGene00021129","II",455146,456138,992
"17811","WBGene00021130","II",448346,453156,4810
"17812","WBGene00021131","II",458766,460325,1559
"17813","WBGene00021132","II",461667,467365,5698
"17814","WBGene00021133","II",468374,470475,2101
"17815","WBGene00021134","II",3559651,3560692,1041
"17816","WBGene00021135","II",3560862,3561661,799
"17817","WBGene00021136","II",3561749,3562570,821
"17818","WBGene00021137","II",3562760,3563360,600
"17819","WBGene00021138","II",3568117,3569218,1101
"17820","WBGene00021139","II",3569430,3571027,1597
"17821","WBGene00021140","II",3574699,3576201,1502
"17822","WBGene00021141","II",3580083,3581433,1350
"17823","WBGene00021142","II",3578421,3579031,610
"17824","WBGene00021143","II",3577045,3578110,1065
"17825","WBGene00021144","II",3573556,3574652,1096
"17826","WBGene00021145","II",3571491,3572883,1392
"17827","WBGene00021146","II",3557474,3567490,10016
"17828","WBGene00021148","II",3550651,3553437,2786
"17829","WBGene00021149","II",3553724,3554618,894
"17830","WBGene00021151","IV",5458767,5460735,1968
"17831","WBGene00021152","IV",5423576,5450802,27226
"17832","WBGene00021153","IV",5450993,5452455,1462
"17833","WBGene00021154","IV",5452967,5453640,673
"17834","WBGene00021155","IV",5354488,5356539,2051
"17835","WBGene00021156","IV",5340890,5344204,3314
"17836","WBGene00021157","IV",5332478,5336827,4349
"17837","WBGene00021158","IV",5326444,5329640,3196
"17838","WBGene00021159","IV",5319253,5325033,5780
"17839","WBGene00021160","IV",5344592,5350947,6355
"17840","WBGene00021161","IV",5351420,5353464,2044
"17841","WBGene00021162","V",2271175,2271861,686
"17842","WBGene00021163","V",2264909,2267058,2149
"17843","WBGene00021164","V",2207180,2210209,3029
"17844","WBGene00021165","V",2188280,2189062,782
"17845","WBGene00021166","V",2189586,2191222,1636
"17846","WBGene00021167","V",2198059,2201415,3356
"17847","WBGene00021168","V",2201581,2204397,2816
"17848","WBGene00021169","V",2205030,2206281,1251
"17849","WBGene00021170","III",862306,865399,3093
"17850","WBGene00021171","II",3795623,3800608,4985
"17851","WBGene00021172","II",3791534,3792102,568
"17852","WBGene00021173","II",3790750,3791395,645
"17853","WBGene00021174","II",3792524,3793425,901
"17854","WBGene00021175","I",3745589,3748220,2631
"17855","WBGene00021176","IV",4963883,4965369,1486
"17856","WBGene00021177","IV",4941981,4944588,2607
"17857","WBGene00021178","IV",4930365,4932217,1852
"17858","WBGene00021179","IV",4936655,4938011,1356
"17859","WBGene00021180","IV",4966097,4969540,3443
"17860","WBGene00021181","IV",4969840,4971145,1305
"17861","WBGene00021182","IV",4971669,4973203,1534
"17862","WBGene00021183","IV",4973622,4976089,2467
"17863","WBGene00021184","IV",4911318,4912780,1462
"17864","WBGene00021185","X",681129,682780,1651
"17865","WBGene00021186","II",7446499,7448542,2043
"17866","WBGene00021187","II",7450511,7453093,2582
"17867","WBGene00021188","X",16883673,16884541,868
"17868","WBGene00021190","II",3993210,3993887,677
"17869","WBGene00021191","II",3934451,3936008,1557
"17870","WBGene00021192","II",3932178,3933740,1562
"17871","WBGene00021193","II",1987285,1990667,3382
"17872","WBGene00021195","IV",4854394,4856287,1893
"17873","WBGene00021196","IV",4856891,4858673,1782
"17874","WBGene00021197","IV",4860373,4861494,1121
"17875","WBGene00021198","IV",4764748,4767839,3091
"17876","WBGene00021199","IV",4764182,4764602,420
"17877","WBGene00021200","IV",4761049,4762856,1807
"17878","WBGene00021201","IV",4752119,4753163,1044
"17879","WBGene00021202","IV",4750240,4751491,1251
"17880","WBGene00021204","IV",4754199,4756157,1958
"17881","WBGene00021205","IV",4757179,4758840,1661
"17882","WBGene00021207","I",688286,691267,2981
"17883","WBGene00021208","I",694982,698322,3340
"17884","WBGene00021209","I",700274,715874,15600
"17885","WBGene00021210","I",692026,694948,2922
"17886","WBGene00021212","I",758756,760429,1673
"17887","WBGene00021213","I",748228,757010,8782
"17888","WBGene00021214","I",682876,686599,3723
"17889","WBGene00021215","I",680408,683472,3064
"17890","WBGene00021227","V",2375043,2379505,4462
"17891","WBGene00021230","V",2311291,2313809,2518
"17892","WBGene00021232","V",2301743,2303868,2125
"17893","WBGene00021233","V",2304355,2309159,4804
"17894","WBGene00021234","V",2313962,2318163,4201
"17895","WBGene00021235","V",2318525,2321052,2527
"17896","WBGene00021236","V",2322038,2322566,528
"17897","WBGene00021237","I",2026277,2033966,7689
"17898","WBGene00021238","I",1988246,2010525,22279
"17899","WBGene00021239","I",2034383,2043805,9422
"17900","WBGene00021241","III",1650302,1652669,2367
"17901","WBGene00021243","III",1641463,1641735,272
"17902","WBGene00021244","III",1626632,1637561,10929
"17903","WBGene00021245","III",1604955,1606850,1895
"17904","WBGene00021246","III",1576751,1580857,4106
"17905","WBGene00021247","III",1606829,1614033,7204
"17906","WBGene00021248","III",1617151,1618954,1803
"17907","WBGene00021249","III",1630792,1634451,3659
"17908","WBGene00021250","III",1642649,1644563,1914
"17909","WBGene00021251","III",1648621,1648806,185
"17910","WBGene00021252","III",1653731,1657480,3749
"17911","WBGene00021253","III",1658207,1659863,1656
"17912","WBGene00021254","III",1662104,1665152,3048
"17913","WBGene00021256","III",1705946,1713729,7783
"17914","WBGene00021257","III",1665493,1665793,300
"17915","WBGene00021259","III",1665913,1668634,2721
"17916","WBGene00021260","III",1672517,1676721,4204
"17917","WBGene00021261","III",1683630,1688099,4469
"17918","WBGene00021262","III",1697221,1698986,1765
"17919","WBGene00021263","III",1701714,1702437,723
"17920","WBGene00021264","III",1703500,1705899,2399
"17921","WBGene00021265","III",1716527,1722605,6078
"17922","WBGene00021266","III",1688144,1691770,3626
"17923","WBGene00021267","X",5916135,5917384,1249
"17924","WBGene00021268","X",5919656,5920494,838
"17925","WBGene00021269","I",2621957,2623186,1229
"17926","WBGene00021270","I",2620654,2621859,1205
"17927","WBGene00021271","I",2617560,2620425,2865
"17928","WBGene00021272","I",2552987,2555398,2411
"17929","WBGene00021273","I",2549296,2550543,1247
"17930","WBGene00021274","I",2544749,2546163,1414
"17931","WBGene00021275","I",2533268,2542114,8846
"17932","WBGene00021276","I",2498134,2506259,8125
"17933","WBGene00021277","I",2489976,2497371,7395
"17934","WBGene00021278","I",2506891,2513710,6819
"17935","WBGene00021279","I",2546897,2548358,1461
"17936","WBGene00021281","IV",4394410,4415622,21212
"17937","WBGene00021282","IV",4390848,4393403,2555
"17938","WBGene00021284","IV",4399879,4400400,521
"17939","WBGene00021285","IV",4404938,4405171,233
"17940","WBGene00021286","IV",4386630,4388878,2248
"17941","WBGene00021287","IV",4317358,4321912,4554
"17942","WBGene00021288","II",3114234,3116758,2524
"17943","WBGene00021289","II",3112613,3113337,724
"17944","WBGene00021290","II",3106065,3108032,1967
"17945","WBGene00021291","II",3102318,3104736,2418
"17946","WBGene00021292","II",3078796,3087682,8886
"17947","WBGene00021293","II",3061082,3062112,1030
"17948","WBGene00021294","II",3062542,3071381,8839
"17949","WBGene00021295","II",3071164,3076953,5789
"17950","WBGene00021296","II",3109368,3111247,1879
"17951","WBGene00021297","II",3168767,3170189,1422
"17952","WBGene00021298","II",3180479,3182676,2197
"17953","WBGene00021299","II",3183763,3184630,867
"17954","WBGene00021300","II",3191213,3191644,431
"17955","WBGene00021301","V",1918539,1921029,2490
"17956","WBGene00021302","V",1911402,1913572,2170
"17957","WBGene00021303","V",1907654,1908528,874
"17958","WBGene00021304","V",1895797,1906560,10763
"17959","WBGene00021305","V",1875478,1882265,6787
"17960","WBGene00021309","V",1823077,1830073,6996
"17961","WBGene00021310","III",5362209,5364372,2163
"17962","WBGene00021311","III",5345982,5349401,3419
"17963","WBGene00021312","III",5368967,5371274,2307
"17964","WBGene00021313","III",5375698,5379929,4231
"17965","WBGene00021314","III",5380906,5382173,1267
"17966","WBGene00021315","III",5382288,5385415,3127
"17967","WBGene00021316","III",5385617,5406037,20420
"17968","WBGene00021319","X",5279497,5283719,4222
"17969","WBGene00021320","X",5264330,5271799,7469
"17970","WBGene00021321","X",5257213,5258384,1171
"17971","WBGene00021322","X",5253001,5255068,2067
"17972","WBGene00021323","X",5244317,5246927,2610
"17973","WBGene00021324","X",5271780,5279774,7994
"17974","WBGene00021325","X",5255194,5256855,1661
"17975","WBGene00021326","X",5249851,5252787,2936
"17976","WBGene00021327","I",1019827,1029910,10083
"17977","WBGene00021328","I",1062293,1065269,2976
"17978","WBGene00021329","I",1034443,1040868,6425
"17979","WBGene00021331","I",1049596,1050727,1131
"17980","WBGene00021332","I",1041474,1048329,6855
"17981","WBGene00021333","I",1050921,1053826,2905
"17982","WBGene00021334","I",1053894,1066899,13005
"17983","WBGene00021335","I",1018835,1019229,394
"17984","WBGene00021336","III",1020954,1021876,922
"17985","WBGene00021337","III",1010535,1011385,850
"17986","WBGene00021338","III",1015680,1016136,456
"17987","WBGene00021339","III",1023221,1024561,1340
"17988","WBGene00021340","III",1026916,1031065,4149
"17989","WBGene00021342","X",16541,34439,17898
"17990","WBGene00021343","III",5770185,5774703,4518
"17991","WBGene00021344","III",5774679,5790707,16028
"17992","WBGene00021345","III",5784414,5785134,720
"17993","WBGene00021346","I",2061667,2064077,2410
"17994","WBGene00021347","I",2064293,2064686,393
"17995","WBGene00021348","I",2064909,2065481,572
"17996","WBGene00021349","I",2065727,2069049,3322
"17997","WBGene00021350","I",2069681,2070607,926
"17998","WBGene00021351","I",2072680,2076906,4226
"17999","WBGene00021352","I",2078959,2085662,6703
"18000","WBGene00021353","I",2085673,2093822,8149
"18001","WBGene00021354","I",2113614,2118550,4936
"18002","WBGene00021355","I",2128590,2145971,17381
"18003","WBGene00021357","IV",3709515,3715381,5866
"18004","WBGene00021358","IV",3698501,3699722,1221
"18005","WBGene00021359","IV",3694905,3698436,3531
"18006","WBGene00021360","IV",3663636,3664410,774
"18007","WBGene00021362","IV",3658877,3668703,9826
"18008","WBGene00021363","IV",3687565,3694837,7272
"18009","WBGene00021364","IV",3699804,3700654,850
"18010","WBGene00021365","IV",3726112,3735495,9383
"18011","WBGene00021366","IV",3722886,3725461,2575
"18012","WBGene00021367","IV",3715789,3719157,3368
"18013","WBGene00021368","IV",3756242,3759910,3668
"18014","WBGene00021369","IV",3744048,3747655,3607
"18015","WBGene00021370","IV",3735845,3738917,3072
"18016","WBGene00021371","IV",3739524,3740876,1352
"18017","WBGene00021372","IV",3748210,3751101,2891
"18018","WBGene00021373","IV",3752612,3755419,2807
"18019","WBGene00021374","IV",3578937,3581020,2083
"18020","WBGene00021375","IV",3578415,3579531,1116
"18021","WBGene00021376","IV",3580970,3582909,1939
"18022","WBGene00021377","IV",3593960,3598552,4592
"18023","WBGene00021378","IV",3598656,3599299,643
"18024","WBGene00021379","IV",3599497,3600164,667
"18025","WBGene00021380","IV",3601735,3603401,1666
"18026","WBGene00021381","IV",3603550,3606466,2916
"18027","WBGene00021382","I",10859534,10860769,1235
"18028","WBGene00021383","I",10855935,10857620,1685
"18029","WBGene00021384","I",10850433,10851233,800
"18030","WBGene00021385","I",10855509,10855799,290
"18031","WBGene00021386","I",10861215,10863453,2238
"18032","WBGene00021387","I",10870023,10875046,5023
"18033","WBGene00021388","I",10863880,10866495,2615
"18034","WBGene00021389","V",6057366,6063430,6064
"18035","WBGene00021390","V",6067811,6070068,2257
"18036","WBGene00021391","V",6097105,6099083,1978
"18037","WBGene00021392","V",6096197,6097093,896
"18038","WBGene00021394","IV",208189,217399,9210
"18039","WBGene00021395","IV",184554,192151,7597
"18040","WBGene00021396","IV",165077,169980,4903
"18041","WBGene00021397","IV",162830,164814,1984
"18042","WBGene00021398","IV",158962,159836,874
"18043","WBGene00021400","IV",156071,157901,1830
"18044","WBGene00021401","IV",218551,220854,2303
"18045","WBGene00021402","IV",192256,194745,2489
"18046","WBGene00021403","IV",36809,39114,2305
"18047","WBGene00021404","IV",26982,32380,5398
"18048","WBGene00021405","IV",21493,23198,1705
"18049","WBGene00021406","IV",695,14926,14231
"18050","WBGene00021407","IV",8765,11070,2305
"18051","WBGene00021408","IV",15499,20899,5400
"18052","WBGene00021410","IV",1802026,1803982,1956
"18053","WBGene00021412","V",59239,63509,4270
"18054","WBGene00021413","V",49956,56046,6090
"18055","WBGene00021414","V",63726,64503,777
"18056","WBGene00021415","IV",2324058,2326739,2681
"18057","WBGene00021416","IV",2304446,2306540,2094
"18058","WBGene00021417","IV",2327126,2329640,2514
"18059","WBGene00021418","IV",2330193,2331009,816
"18060","WBGene00021419","IV",2390821,2396263,5442
"18061","WBGene00021420","IV",2389445,2390386,941
"18062","WBGene00021421","IV",2384013,2388089,4076
"18063","WBGene00021423","IV",2349271,2382171,32900
"18064","WBGene00021425","IV",2333837,2348912,15075
"18065","WBGene00021427","IV",2388195,2388675,480
"18066","WBGene00021428","IV",2396257,2399420,3163
"18067","WBGene00021430","IV",2399515,2412410,12895
"18068","WBGene00021433","III",2056730,2057670,940
"18069","WBGene00021434","III",2066640,2068350,1710
"18070","WBGene00021435","III",2073009,2076520,3511
"18071","WBGene00021436","III",2006029,2009196,3167
"18072","WBGene00021437","III",1997841,2002438,4597
"18073","WBGene00021438","III",1985109,1987466,2357
"18074","WBGene00021439","III",2009302,2021589,12287
"18075","WBGene00021440","III",1834513,1846758,12245
"18076","WBGene00021441","III",1777802,1778309,507
"18077","WBGene00021442","III",1772531,1778069,5538
"18078","WBGene00021443","III",1824919,1834347,9428
"18079","WBGene00021444","III",1860429,1877514,17085
"18080","WBGene00021446","III",1855392,1859592,4200
"18081","WBGene00021447","III",1881158,1883017,1859
"18082","WBGene00021448","V",419435,421839,2404
"18083","WBGene00021449","V",370333,373800,3467
"18084","WBGene00021450","V",364950,369088,4138
"18085","WBGene00021451","V",374408,380286,5878
"18086","WBGene00021452","II",775333,776780,1447
"18087","WBGene00021453","II",780716,781321,605
"18088","WBGene00021454","II",781884,783001,1117
"18089","WBGene00021456","II",723788,732513,8725
"18090","WBGene00021457","II",675603,678347,2744
"18091","WBGene00021458","I",2279835,2281516,1681
"18092","WBGene00021460","I",2402232,2409987,7755
"18093","WBGene00021461","I",2357883,2372964,15081
"18094","WBGene00021463","I",2342216,2350468,8252
"18095","WBGene00021464","I",2333312,2338693,5381
"18096","WBGene00021465","I",2316307,2318305,1998
"18097","WBGene00021466","I",2313271,2316003,2732
"18098","WBGene00021467","I",2306985,2308975,1990
"18099","WBGene00021468","I",2300086,2302823,2737
"18100","WBGene00021469","I",2293132,2297312,4180
"18101","WBGene00021470","I",2297280,2304393,7113
"18102","WBGene00021471","I",2323916,2327329,3413
"18103","WBGene00021472","I",2330895,2332652,1757
"18104","WBGene00021473","I",2377089,2381851,4762
"18105","WBGene00021474","I",2382953,2401492,18539
"18106","WBGene00021475","I",2312496,2313008,512
"18107","WBGene00021476","I",2308976,2312129,3153
"18108","WBGene00021477","I",2327989,2330162,2173
"18109","WBGene00021478","V",3767204,3767734,530
"18110","WBGene00021479","V",3761139,3766306,5167
"18111","WBGene00021482","V",3749494,3757074,7580
"18112","WBGene00021483","X",2001030,2002631,1601
"18113","WBGene00021484","X",1990734,1992649,1915
"18114","WBGene00021485","X",1995731,1998112,2381
"18115","WBGene00021486","V",2068449,2069143,694
"18116","WBGene00021487","V",2057537,2061129,3592
"18117","WBGene00021488","V",2033792,2035645,1853
"18118","WBGene00021489","V",2038193,2042359,4166
"18119","WBGene00021490","V",2043352,2046253,2901
"18120","WBGene00021491","V",2049223,2050172,949
"18121","WBGene00021492","V",2052231,2053600,1369
"18122","WBGene00021493","V",2069207,2072896,3689
"18123","WBGene00021494","V",1960137,1961403,1266
"18124","WBGene00021495","IV",7327110,7329108,1998
"18125","WBGene00021496","IV",7333638,7346851,13213
"18126","WBGene00021497","IV",7349283,7365111,15828
"18127","WBGene00021500","X",17256235,17256780,545
"18128","WBGene00021502","III",6615414,6620051,4637
"18129","WBGene00021503","III",6612516,6615134,2618
"18130","WBGene00021504","IV",1772144,1774695,2551
"18131","WBGene00021505","IV",1753824,1755750,1926
"18132","WBGene00021506","IV",1745875,1751633,5758
"18133","WBGene00021507","IV",1727438,1737884,10446
"18134","WBGene00021508","IV",1740921,1745587,4666
"18135","WBGene00021509","IV",1752270,1761647,9377
"18136","WBGene00021510","IV",1775277,1781562,6285
"18137","WBGene00021511","IV",1672706,1676209,3503
"18138","WBGene00021512","IV",1660112,1669707,9595
"18139","WBGene00021513","IV",1633772,1637367,3595
"18140","WBGene00021514","IV",1605712,1608901,3189
"18141","WBGene00021515","IV",1602985,1605609,2624
"18142","WBGene00021516","IV",1577087,1578889,1802
"18143","WBGene00021517","IV",1564081,1567716,3635
"18144","WBGene00021518","IV",1562184,1564076,1892
"18145","WBGene00021519","IV",1560104,1561811,1707
"18146","WBGene00021520","IV",1558053,1559633,1580
"18147","WBGene00021521","IV",1617462,1619178,1716
"18148","WBGene00021522","IV",1637954,1645290,7336
"18149","WBGene00021524","IV",1676720,1682159,5439
"18150","WBGene00021525","IV",1631951,1633257,1306
"18151","WBGene00021526","X",2982056,2984125,2069
"18152","WBGene00021527","X",2976457,2981008,4551
"18153","WBGene00021528","X",2957934,2968167,10233
"18154","WBGene00021529","X",2946667,2949025,2358
"18155","WBGene00021530","X",2998303,3003803,5500
"18156","WBGene00021531","III",6149961,6154933,4972
"18157","WBGene00021532","III",6148145,6149047,902
"18158","WBGene00021533","III",6146214,6148066,1852
"18159","WBGene00021534","III",6124184,6136276,12092
"18160","WBGene00021535","III",6142123,6149590,7467
"18161","WBGene00021536","IV",8113384,8115670,2286
"18162","WBGene00021537","IV",8099918,8101424,1506
"18163","WBGene00021538","IV",8104287,8107600,3313
"18164","WBGene00021539","IV",8107766,8112241,4475
"18165","WBGene00021540","IV",8102501,8104323,1822
"18166","WBGene00021541","IV",8011031,8012430,1399
"18167","WBGene00021542","IV",7065322,7068035,2713
"18168","WBGene00021543","IV",7081514,7082266,752
"18169","WBGene00021544","IV",7082220,7083716,1496
"18170","WBGene00021545","II",222700,232739,10039
"18171","WBGene00021546","II",232852,237821,4969
"18172","WBGene00021547","I",3338367,3340219,1852
"18173","WBGene00021548","I",3317978,3318584,606
"18174","WBGene00021549","I",3319540,3330673,11133
"18175","WBGene00021551","I",3340231,3349907,9676
"18176","WBGene00021552","I",3264237,3266762,2525
"18177","WBGene00021553","I",3259871,3264254,4383
"18178","WBGene00021554","V",4144505,4147571,3066
"18179","WBGene00021555","V",4175882,4181357,5475
"18180","WBGene00021556","V",4164554,4166825,2271
"18181","WBGene00021557","V",4160383,4160889,506
"18182","WBGene00021558","V",4147550,4152296,4746
"18183","WBGene00021559","V",4166796,4169837,3041
"18184","WBGene00021560","V",4170120,4175640,5520
"18185","WBGene00021561","V",4181332,4191515,10183
"18186","WBGene00021562","V",2698972,2707024,8052
"18187","WBGene00021563","V",2694768,2698864,4096
"18188","WBGene00021564","V",2688461,2694430,5969
"18189","WBGene00021565","V",2565683,2568878,3195
"18190","WBGene00021567","V",2546200,2548150,1950
"18191","WBGene00021576","II",868814,871699,2885
"18192","WBGene00021577","II",851656,856210,4554
"18193","WBGene00021578","II",862927,866901,3974
"18194","WBGene00021579","IV",3953935,3956210,2275
"18195","WBGene00021580","IV",3940259,3941702,1443
"18196","WBGene00021581","IV",3932733,3936238,3505
"18197","WBGene00021582","IV",3937464,3939924,2460
"18198","WBGene00021583","IV",3944816,3947364,2548
"18199","WBGene00021585","IV",3957005,3960139,3134
"18200","WBGene00021586","IV",3960734,3962846,2112
"18201","WBGene00021587","IV",3965246,3969025,3779
"18202","WBGene00021589","II",3324021,3326431,2410
"18203","WBGene00021590","II",3321060,3323279,2219
"18204","WBGene00021591","II",3326492,3327197,705
"18205","WBGene00021592","III",1758721,1759783,1062
"18206","WBGene00021593","III",1752183,1754942,2759
"18207","WBGene00021594","II",15244855,15251774,6919
"18208","WBGene00021595","II",15233153,15244931,11778
"18209","WBGene00021596","II",15230343,15232803,2460
"18210","WBGene00021597","II",15207443,15229725,22282
"18211","WBGene00021598","II",15196214,15198075,1861
"18212","WBGene00021599","V",1807450,1809468,2018
"18213","WBGene00021600","V",1809560,1811135,1575
"18214","WBGene00021601","V",1811423,1814116,2693
"18215","WBGene00021602","V",1760861,1765305,4444
"18216","WBGene00021603","V",1757186,1760299,3113
"18217","WBGene00021604","V",1687495,1689687,2192
"18218","WBGene00021605","V",1691029,1692052,1023
"18219","WBGene00021606","V",1697889,1701617,3728
"18220","WBGene00021607","V",1692026,1694042,2016
"18221","WBGene00021608","V",1642499,1643121,622
"18222","WBGene00021609","V",1632017,1635883,3866
"18223","WBGene00021610","V",1625225,1626818,1593
"18224","WBGene00021611","V",1628106,1629432,1326
"18225","WBGene00021612","V",1630309,1631248,939
"18226","WBGene00021613","V",5204481,5213468,8987
"18227","WBGene00021614","V",5195926,5198340,2414
"18228","WBGene00021616","V",4420275,4420746,471
"18229","WBGene00021617","V",4410943,4412401,1458
"18230","WBGene00021619","V",4417761,4418225,464
"18231","WBGene00021620","V",4419454,4419867,413
"18232","WBGene00021621","V",4423609,4423968,359
"18233","WBGene00021622","V",4426157,4426477,320
"18234","WBGene00021623","V",4427769,4428302,533
"18235","WBGene00021624","V",4428950,4429676,726
"18236","WBGene00021625","V",4434883,4435928,1045
"18237","WBGene00021626","V",4443110,4450555,7445
"18238","WBGene00021627","V",4431791,4433185,1394
"18239","WBGene00021628","I",4303930,4308244,4314
"18240","WBGene00021629","I",4298184,4302243,4059
"18241","WBGene00021630","I",4275888,4276947,1059
"18242","WBGene00021631","I",4273896,4274742,846
"18243","WBGene00021632","I",4277684,4279622,1938
"18244","WBGene00021633","I",3601291,3602908,1617
"18245","WBGene00021634","I",3547071,3552005,4934
"18246","WBGene00021635","I",3533885,3539196,5311
"18247","WBGene00021636","I",3516450,3523387,6937
"18248","WBGene00021637","I",3502738,3508421,5683
"18249","WBGene00021638","I",3479329,3481439,2110
"18250","WBGene00021639","I",3439370,3442188,2818
"18251","WBGene00021640","I",3462270,3468187,5917
"18252","WBGene00021641","I",3472965,3476311,3346
"18253","WBGene00021643","I",3487812,3499706,11894
"18254","WBGene00021644","I",3508397,3512735,4338
"18255","WBGene00021645","I",3523313,3529956,6643
"18256","WBGene00021646","I",3551949,3559807,7858
"18257","WBGene00021647","I",3559923,3562851,2928
"18258","WBGene00021648","I",3604520,3605763,1243
"18259","WBGene00021649","I",3606411,3608345,1934
"18260","WBGene00021650","I",3618889,3619697,808
"18261","WBGene00021651","I",3555581,3557402,1821
"18262","WBGene00021653","I",3523972,3524590,618
"18263","WBGene00021654","II",2705996,2707982,1986
"18264","WBGene00021655","IV",1965481,1969650,4169
"18265","WBGene00021656","X",3009499,3010175,676
"18266","WBGene00021657","I",348460,357193,8733
"18267","WBGene00021658","I",347469,348357,888
"18268","WBGene00021660","I",323788,330987,7199
"18269","WBGene00021661","I",343069,348424,5355
"18270","WBGene00021662","I",216028,216996,968
"18271","WBGene00021664","I",219735,221575,1840
"18272","WBGene00021666","I",209281,211732,2451
"18273","WBGene00021667","I",252118,254277,2159
"18274","WBGene00021668","I",240491,245414,4923
"18275","WBGene00021671","I",231692,238252,6560
"18276","WBGene00021672","I",238616,239021,405
"18277","WBGene00021673","I",248624,251580,2956
"18278","WBGene00021675","I",254277,259157,4880
"18279","WBGene00021676","I",93024,94884,1860
"18280","WBGene00021677","I",49919,54426,4507
"18281","WBGene00021678","I",55293,64066,8773
"18282","WBGene00021679","I",84991,86293,1302
"18283","WBGene00021681","I",96544,108223,11679
"18284","WBGene00021682","I",91380,92877,1497
"18285","WBGene00021683","I",81193,91020,9827
"18286","WBGene00021685","I",1211485,1254669,43184
"18287","WBGene00021686","I",1193158,1211434,18276
"18288","WBGene00021687","I",1157571,1162939,5368
"18289","WBGene00021689","I",1136371,1154386,18015
"18290","WBGene00021690","I",1218435,1219002,567
"18291","WBGene00021691","I",1223957,1229282,5325
"18292","WBGene00021692","I",1254770,1258258,3488
"18293","WBGene00021693","I",1282101,1285435,3334
"18294","WBGene00021694","I",1287304,1287959,655
"18295","WBGene00021697","III",2151968,2197908,45940
"18296","WBGene00021698","III",2124137,2151550,27413
"18297","WBGene00021700","III",2117842,2119091,1249
"18298","WBGene00021701","III",2111802,2112427,625
"18299","WBGene00021702","III",2092709,2099881,7172
"18300","WBGene00021703","III",2082819,2088248,5429
"18301","WBGene00021704","III",2112416,2116897,4481
"18302","WBGene00021705","III",2158622,2160342,1720
"18303","WBGene00021706","V",709108,710566,1458
"18304","WBGene00021707","V",707218,708453,1235
"18305","WBGene00021708","V",702560,703745,1185
"18306","WBGene00021709","V",696523,699614,3091
"18307","WBGene00021710","V",710642,712921,2279
"18308","WBGene00021711","II",3603387,3607384,3997
"18309","WBGene00021713","II",3607937,3609862,1925
"18310","WBGene00021714","II",3505017,3509956,4939
"18311","WBGene00021715","II",3502968,3504910,1942
"18312","WBGene00021716","II",3491179,3492881,1702
"18313","WBGene00021717","II",3474050,3474729,679
"18314","WBGene00021718","II",3473122,3473407,285
"18315","WBGene00021719","II",3475644,3477271,1627
"18316","WBGene00021720","II",3479473,3481685,2212
"18317","WBGene00021721","II",3493934,3499426,5492
"18318","WBGene00021722","II",3512690,3514731,2041
"18319","WBGene00021723","II",3380288,3381403,1115
"18320","WBGene00021724","II",3378575,3379551,976
"18321","WBGene00021725","II",3377111,3378726,1615
"18322","WBGene00021726","II",3375079,3376714,1635
"18323","WBGene00021727","II",3371310,3372145,835
"18324","WBGene00021728","II",3361899,3365961,4062
"18325","WBGene00021729","II",3367258,3368197,939
"18326","WBGene00021730","II",3369175,3370111,936
"18327","WBGene00021731","V",5286407,5287360,953
"18328","WBGene00021732","V",5223423,5230471,7048
"18329","WBGene00021733","I",398891,412915,14024
"18330","WBGene00021734","I",412911,418660,5749
"18331","WBGene00021735","V",1207889,1219874,11985
"18332","WBGene00021736","V",1196072,1207792,11720
"18333","WBGene00021737","V",1182806,1184644,1838
"18334","WBGene00021738","V",1184876,1196146,11270
"18335","WBGene00021739","V",1207307,1207792,485
"18336","WBGene00021740","V",1112933,1129360,16427
"18337","WBGene00021741","V",1101186,1104046,2860
"18338","WBGene00021743","V",1092657,1098951,6294
"18339","WBGene00021744","V",1088283,1089891,1608
"18340","WBGene00021745","V",1084316,1087272,2956
"18341","WBGene00021746","V",1082523,1084203,1680
"18342","WBGene00021747","V",936464,939228,2764
"18343","WBGene00021748","V",939391,945244,5853
"18344","WBGene00021749","V",998289,1003753,5464
"18345","WBGene00021750","V",946732,949860,3128
"18346","WBGene00021751","III",292640,314266,21626
"18347","WBGene00021752","III",265090,283009,17919
"18348","WBGene00021753","III",254535,264636,10101
"18349","WBGene00021754","III",235844,254067,18223
"18350","WBGene00021755","III",230429,235121,4692
"18351","WBGene00021756","III",335956,343241,7285
"18352","WBGene00021757","III",284117,289444,5327
"18353","WBGene00021758","III",315460,321721,6261
"18354","WBGene00021763","I",1977993,1983436,5443
"18355","WBGene00021764","I",1967772,1973882,6110
"18356","WBGene00021765","I",1932352,1945212,12860
"18357","WBGene00021766","I",1924300,1932260,7960
"18358","WBGene00021768","I",1911684,1913966,2282
"18359","WBGene00021771","I",1950594,1958527,7933
"18360","WBGene00021772","II",1510288,1517454,7166
"18361","WBGene00021773","II",1537621,1538666,1045
"18362","WBGene00021774","II",1536231,1537275,1044
"18363","WBGene00021776","II",1529359,1535208,5849
"18364","WBGene00021778","II",1523565,1525598,2033
"18365","WBGene00021779","II",1467727,1469604,1877
"18366","WBGene00021780","II",1445225,1446108,883
"18367","WBGene00021781","II",1438490,1439697,1207
"18368","WBGene00021783","II",1412409,1420150,7741
"18369","WBGene00021784","II",1403611,1409118,5507
"18370","WBGene00021785","II",1402569,1403215,646
"18371","WBGene00021786","II",1401774,1402134,360
"18372","WBGene00021787","II",1409184,1411472,2288
"18373","WBGene00021788","II",1420422,1423668,3246
"18374","WBGene00021789","II",1425758,1437499,11741
"18375","WBGene00021790","II",1440066,1446746,6680
"18376","WBGene00021791","II",1463268,1466546,3278
"18377","WBGene00021792","IV",5467393,5469134,1741
"18378","WBGene00021793","IV",5462501,5464448,1947
"18379","WBGene00021794","II",4321663,4322616,953
"18380","WBGene00021795","II",4320836,4321654,818
"18381","WBGene00021796","II",4305262,4307004,1742
"18382","WBGene00021797","II",4309725,4312215,2490
"18383","WBGene00021798","II",4316629,4319969,3340
"18384","WBGene00021799","III",3233102,3241263,8161
"18385","WBGene00021800","III",3241717,3248575,6858
"18386","WBGene00021801","III",3251461,3253143,1682
"18387","WBGene00021803","III",3271822,3272043,221
"18388","WBGene00021804","III",3253969,3255619,1650
"18389","WBGene00021805","III",3256730,3258395,1665
"18390","WBGene00021806","III",3259331,3260882,1551
"18391","WBGene00021807","III",3263682,3266608,2926
"18392","WBGene00021808","III",3267178,3278710,11532
"18393","WBGene00021809","III",3333036,3333957,921
"18394","WBGene00021810","III",3322962,3331727,8765
"18395","WBGene00021811","III",3311423,3317713,6290
"18396","WBGene00021812","III",3297454,3302151,4697
"18397","WBGene00021813","III",3294743,3297115,2372
"18398","WBGene00021814","III",3282308,3290215,7907
"18399","WBGene00021815","III",3290117,3294330,4213
"18400","WBGene00021816","III",3317737,3321245,3508
"18401","WBGene00021817","III",3129277,3131399,2122
"18402","WBGene00021818","III",3101267,3103955,2688
"18403","WBGene00021819","III",3105668,3111828,6160
"18404","WBGene00021820","III",3112428,3127124,14696
"18405","WBGene00021821","V",9439160,9439549,389
"18406","WBGene00021826","I",3229431,3233294,3863
"18407","WBGene00021827","I",3167908,3171230,3322
"18408","WBGene00021828","I",3163688,3167925,4237
"18409","WBGene00021829","I",3162803,3163649,846
"18410","WBGene00021830","I",3173243,3176319,3076
"18411","WBGene00021831","I",3176419,3192857,16438
"18412","WBGene00021832","I",3193528,3198838,5310
"18413","WBGene00021833","I",3199540,3203229,3689
"18414","WBGene00021834","I",3244151,3246073,1922
"18415","WBGene00021835","I",3206730,3210226,3496
"18416","WBGene00021837","I",3012111,3012440,329
"18417","WBGene00021838","I",3004049,3005941,1892
"18418","WBGene00021839","I",3001360,3002847,1487
"18419","WBGene00021840","I",3059151,3069393,10242
"18420","WBGene00021841","I",3032935,3034761,1826
"18421","WBGene00021842","I",3021651,3028396,6745
"18422","WBGene00021843","I",3015742,3021531,5789
"18423","WBGene00021844","I",3028307,3031092,2785
"18424","WBGene00021845","I",3031212,3032938,1726
"18425","WBGene00021846","I",3052018,3059185,7167
"18426","WBGene00021847","III",2487769,2494340,6571
"18427","WBGene00021848","III",2561710,2566589,4879
"18428","WBGene00021849","III",2529063,2530502,1439
"18429","WBGene00021850","III",2508848,2511802,2954
"18430","WBGene00021852","III",2503448,2507972,4524
"18431","WBGene00021853","III",2562982,2563983,1001
"18432","WBGene00021854","III",2572031,2575723,3692
"18433","WBGene00021855","III",2567404,2571547,4143
"18434","WBGene00021856","III",2331572,2342184,10612
"18435","WBGene00021857","III",2314436,2326901,12465
"18436","WBGene00021858","III",2277279,2289967,12688
"18437","WBGene00021859","III",2272453,2276965,4512
"18438","WBGene00021860","III",2266651,2268300,1649
"18439","WBGene00021861","III",2263242,2264139,897
"18440","WBGene00021862","III",2266980,2272175,5195
"18441","WBGene00021863","III",2295344,2304920,9576
"18442","WBGene00021864","III",2305942,2308008,2066
"18443","WBGene00021865","III",2309924,2314073,4149
"18444","WBGene00021866","III",2326921,2329644,2723
"18445","WBGene00021867","III",2329577,2331183,1606
"18446","WBGene00021868","IV",2788692,2796805,8113
"18447","WBGene00021869","IV",3012587,3014440,1853
"18448","WBGene00021870","IV",2931403,2936843,5440
"18449","WBGene00021871","IV",2887025,2889021,1996
"18450","WBGene00021872","IV",2854339,2855456,1117
"18451","WBGene00021873","IV",2835664,2838583,2919
"18452","WBGene00021875","IV",2799689,2801039,1350
"18453","WBGene00021876","IV",2765719,2771790,6071
"18454","WBGene00021877","IV",2777232,2782843,5611
"18455","WBGene00021878","IV",2814568,2819733,5165
"18456","WBGene00021879","IV",2839375,2841434,2059
"18457","WBGene00021880","IV",2843224,2844007,783
"18458","WBGene00021881","IV",2855607,2864843,9236
"18459","WBGene00021882","IV",2872050,2890449,18399
"18460","WBGene00021883","IV",2891560,2892495,935
"18461","WBGene00021884","IV",2893819,2894730,911
"18462","WBGene00021885","IV",2896968,2900638,3670
"18463","WBGene00021886","IV",2902436,2914816,12380
"18464","WBGene00021887","IV",2919826,2922251,2425
"18465","WBGene00021888","IV",2927515,2928421,906
"18466","WBGene00021889","IV",2937990,2939862,1872
"18467","WBGene00021890","IV",2986104,2995573,9469
"18468","WBGene00021891","IV",2998877,2999485,608
"18469","WBGene00021892","IV",3009639,3012421,2782
"18470","WBGene00021893","IV",3023403,3028942,5539
"18471","WBGene00021894","IV",2803589,2804916,1327
"18472","WBGene00021895","IV",2842474,2845604,3130
"18473","WBGene00021897","IV",2960123,2964395,4272
"18474","WBGene00021898","IV",2897694,2901648,3954
"18475","WBGene00021899","III",5153406,5155465,2059
"18476","WBGene00021900","III",5137252,5149578,12326
"18477","WBGene00021901","III",5151907,5153229,1322
"18478","WBGene00021902","III",5155472,5158774,3302
"18479","WBGene00021904","III",576956,577567,611
"18480","WBGene00021905","III",577684,587105,9421
"18481","WBGene00021906","III",587244,598117,10873
"18482","WBGene00021907","III",602708,603822,1114
"18483","WBGene00021908","III",604003,605515,1512
"18484","WBGene00021909","III",402384,405589,3205
"18485","WBGene00021910","III",408094,418738,10644
"18486","WBGene00021911","III",440267,443494,3227
"18487","WBGene00021912","III",434891,440142,5251
"18488","WBGene00021913","III",429300,431750,2450
"18489","WBGene00021914","III",464715,471702,6987
"18490","WBGene00021915","III",2982414,2988150,5736
"18491","WBGene00021916","III",2968966,2969877,911
"18492","WBGene00021917","III",2970677,2975785,5108
"18493","WBGene00021918","III",2988081,2990057,1976
"18494","WBGene00021919","III",3042726,3047125,4399
"18495","WBGene00021920","IV",1056890,1057620,730
"18496","WBGene00021921","IV",1012624,1019558,6934
"18497","WBGene00021922","IV",1010054,1012502,2448
"18498","WBGene00021923","IV",999214,1003639,4425
"18499","WBGene00021925","IV",1003600,1005864,2264
"18500","WBGene00021926","IV",1006083,1009734,3651
"18501","WBGene00021927","IV",1027787,1030024,2237
"18502","WBGene00021928","IV",1038671,1041008,2337
"18503","WBGene00021929","IV",1052524,1054794,2270
"18504","WBGene00021930","IV",1055023,1056313,1290
"18505","WBGene00021931","IV",1058695,1067525,8830
"18506","WBGene00021932","IV",1097453,1102980,5527
"18507","WBGene00021933","IV",1094545,1096723,2178
"18508","WBGene00021934","IV",1087095,1093920,6825
"18509","WBGene00021935","IV",800818,804547,3729
"18510","WBGene00021936","IV",807439,824954,17515
"18511","WBGene00021938","IV",874791,881910,7119
"18512","WBGene00021939","IV",857327,874724,17397
"18513","WBGene00021941","IV",845881,848850,2969
"18514","WBGene00021942","IV",830359,831896,1537
"18515","WBGene00021943","IV",835033,842126,7093
"18516","WBGene00021945","IV",849269,854780,5511
"18517","WBGene00021947","IV",756721,759084,2363
"18518","WBGene00021948","IV",736675,753316,16641
"18519","WBGene00021949","IV",716626,717700,1074
"18520","WBGene00021950","IV",698761,707719,8958
"18521","WBGene00021951","IV",728500,731037,2537
"18522","WBGene00021952","IV",3369197,3373467,4270
"18523","WBGene00021953","IV",3363553,3366079,2526
"18524","WBGene00021956","V",7060811,7062695,1884
"18525","WBGene00021957","V",7058095,7058507,412
"18526","WBGene00021958","V",7054898,7055275,377
"18527","WBGene00021959","V",7059698,7060470,772
"18528","WBGene00021960","V",7063174,7063718,544
"18529","WBGene00021961","V",6948543,6948831,288
"18530","WBGene00021963","V",6931539,6934306,2767
"18531","WBGene00021964","V",6945711,6947547,1836
"18532","WBGene00021965","II",1298469,1299716,1247
"18533","WBGene00021966","II",1296078,1296746,668
"18534","WBGene00021967","II",1285797,1286371,574
"18535","WBGene00021968","II",1273169,1275539,2370
"18536","WBGene00021969","II",1281974,1285614,3640
"18537","WBGene00021970","II",1288735,1293257,4522
"18538","WBGene00021971","II",1290700,1292028,1328
"18539","WBGene00021972","II",1300064,1301641,1577
"18540","WBGene00021973","II",1302497,1306136,3639
"18541","WBGene00021974","II",1275752,1276872,1120
"18542","WBGene00021975","V",5067637,5069665,2028
"18543","WBGene00021976","V",5071695,5072231,536
"18544","WBGene00021977","V",5077849,5080903,3054
"18545","WBGene00021978","V",5082002,5085007,3005
"18546","WBGene00021979","V",5085886,5086969,1083
"18547","WBGene00021980","V",5087601,5089484,1883
"18548","WBGene00021981","V",268238,271419,3181
"18549","WBGene00021983","V",276989,281716,4727
"18550","WBGene00021984","II",2208112,2212863,4751
"18551","WBGene00021985","II",2199143,2204139,4996
"18552","WBGene00021986","II",2215476,2219921,4445
"18553","WBGene00021987","X",1937947,1942199,4252
"18554","WBGene00021990","X",1871399,1880492,9093
"18555","WBGene00021992","IV",5228919,5230083,1164
"18556","WBGene00021993","IV",5218832,5220169,1337
"18557","WBGene00021994","IV",5210914,5215192,4278
"18558","WBGene00021995","IV",5221284,5222133,849
"18559","WBGene00021996","IV",5224899,5225772,873
"18560","WBGene00021997","IV",5249428,5249820,392
"18561","WBGene00021998","IV",5242205,5244988,2783
"18562","WBGene00021999","IV",5230830,5232479,1649
"18563","WBGene00022002","IV",5241364,5241794,430
"18564","WBGene00022004","IV",8559434,8563159,3725
"18565","WBGene00022005","IV",8571438,8571821,383
"18566","WBGene00022007","IV",8563604,8564597,993
"18567","WBGene00022008","IV",8569144,8570353,1209
"18568","WBGene00022010","IV",8585516,8594613,9097
"18569","WBGene00022011","IV",8594871,8595417,546
"18570","WBGene00022012","IV",8598739,8600742,2003
"18571","WBGene00022013","V",4783613,4784386,773
"18572","WBGene00022014","V",4585309,4602021,16712
"18573","WBGene00022015","V",4571135,4585168,14033
"18574","WBGene00022016","V",4560842,4561683,841
"18575","WBGene00022017","V",4556055,4557114,1059
"18576","WBGene00022018","V",4558318,4559801,1483
"18577","WBGene00022019","V",4562215,4570043,7828
"18578","WBGene00022020","V",4573133,4573924,791
"18579","WBGene00022021","V",4607039,4615817,8778
"18580","WBGene00022022","V",4605004,4606926,1922
"18581","WBGene00022023","X",5057273,5057581,308
"18582","WBGene00022024","X",5043976,5044746,770
"18583","WBGene00022025","I",654090,658810,4720
"18584","WBGene00022026","I",638129,653986,15857
"18585","WBGene00022027","I",636804,637852,1048
"18586","WBGene00022028","I",621708,622187,479
"18587","WBGene00022029","I",629492,636350,6858
"18588","WBGene00022030","I",645626,647242,1616
"18589","WBGene00022031","I",659557,663686,4129
"18590","WBGene00022032","I",664426,666900,2474
"18591","WBGene00022033","I",530969,531998,1029
"18592","WBGene00022034","I",506469,509056,2587
"18593","WBGene00022035","I",496144,502042,5898
"18594","WBGene00022036","I",502932,506250,3318
"18595","WBGene00022037","I",511052,519800,8748
"18596","WBGene00022038","I",520109,521554,1445
"18597","WBGene00022039","I",508850,511051,2201
"18598","WBGene00022040","I",562736,565181,2445
"18599","WBGene00022042","I",535791,536670,879
"18600","WBGene00022043","I",534455,535344,889
"18601","WBGene00022044","IV",445677,448439,2762
"18602","WBGene00022045","IV",443985,444783,798
"18603","WBGene00022046","IV",425972,427204,1232
"18604","WBGene00022047","IV",428070,429133,1063
"18605","WBGene00022048","IV",359204,376062,16858
"18606","WBGene00022051","III",1570306,1576638,6332
"18607","WBGene00022052","III",1558800,1570129,11329
"18608","WBGene00022053","III",1540493,1543445,2952
"18609","WBGene00022054","III",1533774,1538198,4424
"18610","WBGene00022055","III",1538472,1540244,1772
"18611","WBGene00022056","III",1544938,1554447,9509
"18612","WBGene00022057","III",1555395,1558529,3134
"18613","WBGene00022059","IV",3222440,3252601,30161
"18614","WBGene00022060","IV",3253263,3254543,1280
"18615","WBGene00022061","IV",3169946,3172610,2664
"18616","WBGene00022062","IV",3186080,3191562,5482
"18617","WBGene00022063","IV",3173550,3176115,2565
"18618","WBGene00022064","IV",3202333,3203861,1528
"18619","WBGene00022066","IV",3072297,3073916,1619
"18620","WBGene00022067","IV",3053730,3062053,8323
"18621","WBGene00022069","IV",3032578,3050102,17524
"18622","WBGene00022070","IV",3062524,3063366,842
"18623","WBGene00022071","IV",3065568,3066934,1366
"18624","WBGene00022072","IV",3067848,3069876,2028
"18625","WBGene00022073","IV",3077466,3086923,9457
"18626","WBGene00022074","IV",2667050,2672202,5152
"18627","WBGene00022075","IV",2641310,2642113,803
"18628","WBGene00022076","IV",2614200,2617135,2935
"18629","WBGene00022077","IV",2608051,2610200,2149
"18630","WBGene00022078","IV",2601141,2607571,6430
"18631","WBGene00022079","IV",2592395,2596786,4391
"18632","WBGene00022082","IV",2584777,2587690,2913
"18633","WBGene00022083","IV",2568614,2572056,3442
"18634","WBGene00022085","IV",2551872,2557106,5234
"18635","WBGene00022086","IV",2542326,2548719,6393
"18636","WBGene00022087","IV",2497801,2530296,32495
"18637","WBGene00022089","IV",2495735,2497683,1948
"18638","WBGene00022090","IV",2488820,2494135,5315
"18639","WBGene00022092","IV",2494513,2495174,661
"18640","WBGene00022093","IV",2504638,2507924,3286
"18641","WBGene00022094","IV",2549926,2551697,1771
"18642","WBGene00022095","IV",2563778,2564069,291
"18643","WBGene00022096","IV",2565820,2568367,2547
"18644","WBGene00022097","IV",2578932,2581583,2651
"18645","WBGene00022099","IV",2612432,2613061,629
"18646","WBGene00022100","IV",2650384,2664003,13619
"18647","WBGene00022101","IV",2610408,2612435,2027
"18648","WBGene00022102","III",7456734,7458544,1810
"18649","WBGene00022103","III",1152044,1181137,29093
"18650","WBGene00022104","III",1116424,1142927,26503
"18651","WBGene00022106","III",1125243,1136025,10782
"18652","WBGene00022107","I",2925212,2928134,2922
"18653","WBGene00022108","I",2915176,2918806,3630
"18654","WBGene00022110","I",2903596,2907751,4155
"18655","WBGene00022111","I",2890446,2891261,815
"18656","WBGene00022112","I",2887800,2889434,1634
"18657","WBGene00022113","I",2878578,2880929,2351
"18658","WBGene00022114","I",2876932,2878523,1591
"18659","WBGene00022115","I",2866508,2870167,3659
"18660","WBGene00022116","I",2862403,2864446,2043
"18661","WBGene00022117","I",2870608,2875289,4681
"18662","WBGene00022119","I",2895329,2900860,5531
"18663","WBGene00022121","I",2931461,2947152,15691
"18664","WBGene00022122","I",2928395,2929687,1292
"18665","WBGene00022123","I",2983213,2985167,1954
"18666","WBGene00022124","I",2986104,2995914,9810
"18667","WBGene00022125","I",2774912,2775421,509
"18668","WBGene00022126","I",2731562,2735371,3809
"18669","WBGene00022127","I",2730004,2731453,1449
"18670","WBGene00022128","I",2721879,2726724,4845
"18671","WBGene00022129","I",2735345,2742508,7163
"18672","WBGene00022130","I",2759023,2761044,2021
"18673","WBGene00022131","I",2776370,2778726,2356
"18674","WBGene00022133","I",2780850,2784276,3426
"18675","WBGene00022134","IV",2177900,2198871,20971
"18676","WBGene00022138","I",1895161,1923088,27927
"18677","WBGene00022139","I",1874033,1883639,9606
"18678","WBGene00022140","I",1885205,1894905,9700
"18679","WBGene00022141","I",1823447,1825967,2520
"18680","WBGene00022142","I",1816150,1818496,2346
"18681","WBGene00022143","I",1812892,1813581,689
"18682","WBGene00022144","I",1808091,1811835,3744
"18683","WBGene00022145","I",1799717,1806986,7269
"18684","WBGene00022146","I",1793254,1796424,3170
"18685","WBGene00022148","I",1767887,1790157,22270
"18686","WBGene00022149","I",1755329,1766400,11071
"18687","WBGene00022150","I",1751481,1754410,2929
"18688","WBGene00022152","I",1709587,1715568,5981
"18689","WBGene00022153","I",1702105,1708008,5903
"18690","WBGene00022154","I",1680450,1685063,4613
"18691","WBGene00022155","I",1667501,1669792,2291
"18692","WBGene00022156","I",1652901,1655399,2498
"18693","WBGene00022157","I",1663412,1667414,4002
"18694","WBGene00022158","I",1670036,1672742,2706
"18695","WBGene00022159","I",1740647,1751055,10408
"18696","WBGene00022160","I",1771388,1775933,4545
"18697","WBGene00022161","I",1779766,1782594,2828
"18698","WBGene00022162","I",1797435,1798722,1287
"18699","WBGene00022163","I",1828079,1831929,3850
"18700","WBGene00022165","III",2686890,2688997,2107
"18701","WBGene00022166","III",2827070,2833008,5938
"18702","WBGene00022167","III",2819280,2826153,6873
"18703","WBGene00022168","III",2805430,2811096,5666
"18704","WBGene00022169","III",2786854,2788028,1174
"18705","WBGene00022170","III",2786117,2786859,742
"18706","WBGene00022171","III",2781039,2782817,1778
"18707","WBGene00022172","III",2726080,2731670,5590
"18708","WBGene00022173","III",2700937,2707818,6881
"18709","WBGene00022174","III",2690160,2698817,8657
"18710","WBGene00022175","III",2707737,2716447,8710
"18711","WBGene00022176","III",2718158,2725092,6934
"18712","WBGene00022177","III",2731346,2734091,2745
"18713","WBGene00022178","III",2734080,2739531,5451
"18714","WBGene00022179","III",2743719,2746653,2934
"18715","WBGene00022180","III",2747130,2756512,9382
"18716","WBGene00022181","III",2757087,2760816,3729
"18717","WBGene00022182","III",2764037,2768675,4638
"18718","WBGene00022185","III",2782733,2785993,3260
"18719","WBGene00022188","III",2834663,2836261,1598
"18720","WBGene00022189","III",2838763,2840927,2164
"18721","WBGene00022190","III",2836639,2838453,1814
"18722","WBGene00022191","III",2629013,2631439,2426
"18723","WBGene00022192","III",2623170,2627771,4601
"18724","WBGene00022193","III",2619936,2622709,2773
"18725","WBGene00022194","III",2618963,2619375,412
"18726","WBGene00022195","III",2608017,2618856,10839
"18727","WBGene00022196","III",2586465,2589316,2851
"18728","WBGene00022197","III",2579314,2580664,1350
"18729","WBGene00022198","III",2604236,2606541,2305
"18730","WBGene00022199","X",2940872,2945481,4609
"18731","WBGene00022200","X",2933361,2937740,4379
"18732","WBGene00022201","X",2834222,2840292,6070
"18733","WBGene00022202","X",6129535,6138332,8797
"18734","WBGene00022203","X",42728,46924,4196
"18735","WBGene00022204","X",61165,63375,2210
"18736","WBGene00022205","X",84041,94978,10937
"18737","WBGene00022206","X",95959,104777,8818
"18738","WBGene00022207","X",106971,109378,2407
"18739","WBGene00022209","X",135793,138075,2282
"18740","WBGene00022210","X",140434,140683,249
"18741","WBGene00022211","X",150363,157246,6883
"18742","WBGene00022213","X",146463,148812,2349
"18743","WBGene00022214","X",138880,139626,746
"18744","WBGene00022215","X",131022,132689,1667
"18745","WBGene00022216","X",119663,120460,797
"18746","WBGene00022217","X",114700,116814,2114
"18747","WBGene00022218","X",78429,80400,1971
"18748","WBGene00022219","X",48483,60774,12291
"18749","WBGene00022221","X",47766,48733,967
"18750","WBGene00022222","X",34798,41883,7085
"18751","WBGene00022223","X",209108,211241,2133
"18752","WBGene00022224","X",214697,215575,878
"18753","WBGene00022225","X",211441,211676,235
"18754","WBGene00022227","X",199262,207723,8461
"18755","WBGene00022228","IV",6661234,6668054,6820
"18756","WBGene00022229","IV",6732980,6736110,3130
"18757","WBGene00022230","IV",6738727,6740374,1647
"18758","WBGene00022231","IV",6480521,6486971,6450
"18759","WBGene00022232","IV",6415478,6417457,1979
"18760","WBGene00022233","IV",6337653,6340098,2445
"18761","WBGene00022235","IV",6323979,6326421,2442
"18762","WBGene00022236","IV",6316918,6317473,555
"18763","WBGene00022237","IV",6342471,6342976,505
"18764","WBGene00022240","IV",6378594,6384070,5476
"18765","WBGene00022242","IV",6396582,6402458,5876
"18766","WBGene00022243","IV",6416145,6416653,508
"18767","WBGene00022244","IV",6417696,6419078,1382
"18768","WBGene00022245","IV",6424600,6426139,1539
"18769","WBGene00022246","IV",6428305,6431707,3402
"18770","WBGene00022247","IV",6446573,6457543,10970
"18771","WBGene00022248","IV",6472155,6473235,1080
"18772","WBGene00022249","IV",6483208,6483626,418
"18773","WBGene00022250","IV",6321948,6323562,1614
"18774","WBGene00022251","IV",6334215,6335168,953
"18775","WBGene00022252","IV",6442229,6446532,4303
"18776","WBGene00022253","IV",6373162,6376523,3361
"18777","WBGene00022254","IV",6409557,6413566,4009
"18778","WBGene00022255","IV",6469955,6471384,1429
"18779","WBGene00022256","IV",6487347,6489090,1743
"18780","WBGene00022257","IV",6421589,6423489,1900
"18781","WBGene00022258","V",3195408,3196882,1474
"18782","WBGene00022259","V",3193394,3195002,1608
"18783","WBGene00022260","V",3191302,3193233,1931
"18784","WBGene00022261","V",3118377,3120323,1946
"18785","WBGene00022262","V",3115303,3118128,2825
"18786","WBGene00022263","V",3100012,3102149,2137
"18787","WBGene00022264","V",3107792,3109835,2043
"18788","WBGene00022265","V",3110089,3113851,3762
"18789","WBGene00022266","V",3120282,3121843,1561
"18790","WBGene00022267","V",3125566,3127770,2204
"18791","WBGene00022268","I",1629003,1633498,4495
"18792","WBGene00022269","I",1601838,1606926,5088
"18793","WBGene00022270","I",1581394,1593668,12274
"18794","WBGene00022271","I",1594659,1596184,1525
"18795","WBGene00022272","I",1600624,1601457,833
"18796","WBGene00022273","I",1607658,1610041,2383
"18797","WBGene00022274","I",1634613,1644107,9494
"18798","WBGene00022275","I",43733,44677,944
"18799","WBGene00022276","I",11495,16837,5342
"18800","WBGene00022277","I",4116,10230,6114
"18801","WBGene00022278","I",17487,26781,9294
"18802","WBGene00022279","I",27591,32544,4953
"18803","WBGene00022280","I",2468787,2471972,3185
"18804","WBGene00022281","I",2472066,2485391,13325
"18805","WBGene00022282","I",2483203,2483705,502
"18806","WBGene00022283","II",4649085,4653280,4195
"18807","WBGene00022284","V",1352126,1356587,4461
"18808","WBGene00022285","V",1332275,1358164,25889
"18809","WBGene00022286","V",1373120,1383254,10134
"18810","WBGene00022287","V",1391163,1392103,940
"18811","WBGene00022288","V",1270911,1273043,2132
"18812","WBGene00022289","V",1274210,1276006,1796
"18813","WBGene00022291","X",1742848,1743523,675
"18814","WBGene00022292","X",1745096,1746217,1121
"18815","WBGene00022295","IV",2037191,2043191,6000
"18816","WBGene00022296","IV",1993089,2008993,15904
"18817","WBGene00022297","IV",1973702,1975677,1975
"18818","WBGene00022298","IV",1970734,1972977,2243
"18819","WBGene00022300","IV",1981406,1992966,11560
"18820","WBGene00022301","IV",2009038,2032998,23960
"18821","WBGene00022302","IV",1979988,1980363,375
"18822","WBGene00022303","IV",2034982,2035986,1004
"18823","WBGene00022306","IV",1497630,1509965,12335
"18824","WBGene00022307","IV",1457075,1459521,2446
"18825","WBGene00022308","IV",1447594,1448318,724
"18826","WBGene00022309","IV",1408582,1410041,1459
"18827","WBGene00022310","IV",1410872,1419847,8975
"18828","WBGene00022311","IV",1423095,1425062,1967
"18829","WBGene00022312","IV",1425482,1426887,1405
"18830","WBGene00022313","IV",1461899,1475109,13210
"18831","WBGene00022314","IV",1406542,1408131,1589
"18832","WBGene00022315","X",9192444,9194382,1938
"18833","WBGene00022316","X",9184163,9190717,6554
"18834","WBGene00022317","X",9182440,9182947,507
"18835","WBGene00022318","III",1354997,1355420,423
"18836","WBGene00022319","III",1351216,1353371,2155
"18837","WBGene00022320","III",1349752,1350836,1084
"18838","WBGene00022321","III",1347787,1349400,1613
"18839","WBGene00022322","III",1346315,1347128,813
"18840","WBGene00022323","III",1344874,1345794,920
"18841","WBGene00022324","III",1340597,1342494,1897
"18842","WBGene00022325","III",1336707,1340333,3626
"18843","WBGene00022326","III",1322133,1324633,2500
"18844","WBGene00022327","III",1319016,1321671,2655
"18845","WBGene00022328","III",1309187,1311226,2039
"18846","WBGene00022329","III",1305716,1308294,2578
"18847","WBGene00022330","III",1313297,1315229,1932
"18848","WBGene00022331","III",1315401,1318986,3585
"18849","WBGene00022332","III",1311228,1313148,1920
"18850","WBGene00022333","III",1342975,1344692,1717
"18851","WBGene00022334","III",1458536,1466732,8196
"18852","WBGene00022335","III",1438832,1443190,4358
"18853","WBGene00022336","III",1419196,1419914,718
"18854","WBGene00022337","III",1399972,1401305,1333
"18855","WBGene00022338","III",1384820,1388350,3530
"18856","WBGene00022339","III",1381445,1381627,182
"18857","WBGene00022340","III",1360507,1362676,2169
"18858","WBGene00022341","III",1357080,1359135,2055
"18859","WBGene00022342","III",1359254,1359769,515
"18860","WBGene00022343","III",1375245,1375591,346
"18861","WBGene00022344","III",1376945,1378003,1058
"18862","WBGene00022345","III",1382375,1383412,1037
"18863","WBGene00022346","III",1390450,1391852,1402
"18864","WBGene00022347","III",1409243,1414116,4873
"18865","WBGene00022348","III",1419863,1427228,7365
"18866","WBGene00022349","III",1447495,1455770,8275
"18867","WBGene00022350","III",1467876,1483507,15631
"18868","WBGene00022351","III",1483622,1495330,11708
"18869","WBGene00022352","III",1374152,1376542,2390
"18870","WBGene00022353","III",1404792,1406230,1438
"18871","WBGene00022354","III",1406463,1409239,2776
"18872","WBGene00022356","III",1175107,1176553,1446
"18873","WBGene00022357","III",1080901,1081300,399
"18874","WBGene00022358","I",1543525,1556196,12671
"18875","WBGene00022360","I",1514755,1540911,26156
"18876","WBGene00022361","I",1490887,1514411,23524
"18877","WBGene00022363","I",1348503,1359595,11092
"18878","WBGene00022365","I",1376942,1385057,8115
"18879","WBGene00022366","I",1365309,1376409,11100
"18880","WBGene00022367","I",1385818,1392759,6941
"18881","WBGene00022368","I",1413915,1415807,1892
"18882","WBGene00022369","I",1416586,1425201,8615
"18883","WBGene00022370","I",1427227,1433695,6468
"18884","WBGene00022371","I",1405935,1413100,7165
"18885","WBGene00022372","I",1394569,1402975,8406
"18886","WBGene00022373","I",1436279,1441331,5052
"18887","WBGene00022374","IV",2743007,2747476,4469
"18888","WBGene00022375","IV",2730252,2732404,2152
"18889","WBGene00022376","IV",2676512,2678162,1650
"18890","WBGene00022377","IV",2673098,2675015,1917
"18891","WBGene00022378","IV",2688947,2703977,15030
"18892","WBGene00022379","IV",2713907,2716574,2667
"18893","WBGene00022380","IV",2716661,2719834,3173
"18894","WBGene00022381","IV",2720323,2725858,5535
"18895","WBGene00022382","IV",2709942,2711374,1432
"18896","WBGene00022383","I",938464,941773,3309
"18897","WBGene00022385","I",907448,911189,3741
"18898","WBGene00022386","I",882918,890194,7276
"18899","WBGene00022388","I",853451,872103,18652
"18900","WBGene00022389","I",873164,882713,9549
"18901","WBGene00022390","I",889771,895105,5334
"18902","WBGene00022391","I",912415,926877,14462
"18903","WBGene00022392","V",7986172,7988276,2104
"18904","WBGene00022393","V",7983849,7985954,2105
"18905","WBGene00022394","V",7982656,7983431,775
"18906","WBGene00022395","V",7993789,7994666,877
"18907","WBGene00022396","V",8001451,8004690,3239
"18908","WBGene00022397","V",7996178,8000233,4055
"18909","WBGene00022398","V",8006179,8007510,1331
"18910","WBGene00022399","V",8008017,8023533,15516
"18911","WBGene00022400","V",8011219,8012345,1126
"18912","WBGene00022401","V",8012397,8013951,1554
"18913","WBGene00022402","V",8010475,8011108,633
"18914","WBGene00022403","V",7943868,7946857,2989
"18915","WBGene00022404","V",7928960,7930337,1377
"18916","WBGene00022405","V",7927084,7928451,1367
"18917","WBGene00022406","V",7925783,7926920,1137
"18918","WBGene00022407","V",7934457,7935113,656
"18919","WBGene00022408","V",7936144,7937252,1108
"18920","WBGene00022409","V",7938605,7940383,1778
"18921","WBGene00022410","V",7728813,7730317,1504
"18922","WBGene00022411","X",2051907,2054048,2141
"18923","WBGene00022412","X",2026642,2031010,4368
"18924","WBGene00022413","X",2019148,2025737,6589
"18925","WBGene00022415","X",2030959,2031588,629
"18926","WBGene00022416","X",2031963,2035245,3282
"18927","WBGene00022417","X",2035943,2038220,2277
"18928","WBGene00022418","X",2039397,2046360,6963
"18929","WBGene00022419","X",2013151,2018062,4911
"18930","WBGene00022420","III",6725789,6728058,2269
"18931","WBGene00022421","III",6733992,6734520,528
"18932","WBGene00022423","IV",1386045,1399538,13493
"18933","WBGene00022425","IV",1289627,1296897,7270
"18934","WBGene00022426","IV",1178022,1182837,4815
"18935","WBGene00022427","IV",1193065,1201846,8781
"18936","WBGene00022428","IV",1182592,1186604,4012
"18937","WBGene00022431","X",256210,260110,3900
"18938","WBGene00022432","X",269127,270029,902
"18939","WBGene00022433","X",270408,274012,3604
"18940","WBGene00022434","V",166989,176823,9834
"18941","WBGene00022435","V",163842,172210,8368
"18942","WBGene00022438","II",2875101,2876618,1517
"18943","WBGene00022439","II",2867993,2870758,2765
"18944","WBGene00022440","II",2867074,2867779,705
"18945","WBGene00022441","II",2839304,2840386,1082
"18946","WBGene00022442","II",2864529,2865363,834
"18947","WBGene00022443","II",2841010,2841629,619
"18948","WBGene00022444","II",2842608,2843188,580
"18949","WBGene00022445","II",2865971,2866655,684
"18950","WBGene00022446","II",2871377,2871914,537
"18951","WBGene00022447","II",2878729,2884910,6181
"18952","WBGene00022448","II",2886317,2889016,2699
"18953","WBGene00022450","II",2895413,2900533,5120
"18954","WBGene00022452","II",2919710,2920904,1194
"18955","WBGene00022453","II",2913705,2919314,5609
"18956","WBGene00022454","I",5154529,5158467,3938
"18957","WBGene00022455","I",5138256,5139382,1126
"18958","WBGene00022456","I",5131288,5134101,2813
"18959","WBGene00022457","I",5129640,5131065,1425
"18960","WBGene00022458","I",5127828,5129611,1783
"18961","WBGene00022459","I",5119223,5123985,4762
"18962","WBGene00022460","I",5106204,5107625,1421
"18963","WBGene00022462","I",5110919,5113752,2833
"18964","WBGene00022463","I",5114119,5118852,4733
"18965","WBGene00022465","I",5100751,5101674,923
"18966","WBGene00022466","I",4641003,4644069,3066
"18967","WBGene00022467","I",4554126,4555203,1077
"18968","WBGene00022469","I",4549695,4552758,3063
"18969","WBGene00022470","I",4508917,4511126,2209
"18970","WBGene00022471","I",4511440,4516512,5072
"18971","WBGene00022472","I",4517260,4518491,1231
"18972","WBGene00022473","I",4526232,4534798,8566
"18973","WBGene00022474","I",4537449,4539725,2276
"18974","WBGene00022475","I",4555343,4556814,1471
"18975","WBGene00022476","III",1303714,1305461,1747
"18976","WBGene00022477","III",1297904,1299484,1580
"18977","WBGene00022479","III",1292051,1293215,1164
"18978","WBGene00022482","III",1259424,1260184,760
"18979","WBGene00022484","III",1249493,1251838,2345
"18980","WBGene00022485","III",1243513,1245283,1770
"18981","WBGene00022486","III",1239260,1242780,3520
"18982","WBGene00022487","III",1236015,1237142,1127
"18983","WBGene00022488","III",1208104,1213650,5546
"18984","WBGene00022489","III",1202548,1207346,4798
"18985","WBGene00022490","III",1181990,1184942,2952
"18986","WBGene00022491","III",1185248,1193812,8564
"18987","WBGene00022492","III",1194367,1196292,1925
"18988","WBGene00022493","III",1196560,1202008,5448
"18989","WBGene00022494","III",1253384,1254401,1017
"18990","WBGene00022495","III",1257213,1258414,1201
"18991","WBGene00022496","III",1261944,1262842,898
"18992","WBGene00022497","III",1214951,1215293,342
"18993","WBGene00022498","X",5005269,5007024,1755
"18994","WBGene00022499","X",4999270,5003515,4245
"18995","WBGene00022500","X",4980512,4993236,12724
"18996","WBGene00022501","X",4972575,4997598,25023
"18997","WBGene00022502","X",877239,879881,2642
"18998","WBGene00022503","X",880629,883049,2420
"18999","WBGene00022504","X",882951,888463,5512
"19000","WBGene00022505","III",8525073,8528650,3577
"19001","WBGene00022506","III",8542952,8545608,2656
"19002","WBGene00022507","III",8518904,8519945,1041
"19003","WBGene00022508","X",1910943,1913357,2414
"19004","WBGene00022509","X",1923723,1924238,515
"19005","WBGene00022511","X",1925750,1937689,11939
"19006","WBGene00022512","X",1917437,1919755,2318
"19007","WBGene00022515","X",3840869,3842468,1599
"19008","WBGene00022516","III",7761977,7763603,1626
"19009","WBGene00022517","I",837996,841746,3750
"19010","WBGene00022518","I",803368,835277,31909
"19011","WBGene00022519","I",841742,846763,5021
"19012","WBGene00022521","V",4300626,4311784,11158
"19013","WBGene00022522","V",4298559,4299841,1282
"19014","WBGene00022526","V",4315725,4317713,1988
"19015","WBGene00022527","V",4317920,4320001,2081
"19016","WBGene00022528","V",4247969,4250147,2178
"19017","WBGene00022529","V",4253502,4256574,3072
"19018","WBGene00022530","III",5219280,5220093,813
"19019","WBGene00022531","III",5203713,5206911,3198
"19020","WBGene00022532","III",5211781,5215512,3731
"19021","WBGene00022533","III",5215949,5217604,1655
"19022","WBGene00022534","III",5207567,5209557,1990
"19023","WBGene00022536","V",8699736,8712010,12274
"19024","WBGene00022537","V",8681350,8682939,1589
"19025","WBGene00022538","V",8666065,8671680,5615
"19026","WBGene00022539","V",8672017,8673506,1489
"19027","WBGene00022540","V",8674600,8677293,2693
"19028","WBGene00022541","V",8686071,8686864,793
"19029","WBGene00022542","V",8686958,8687807,849
"19030","WBGene00022544","V",8692198,8696312,4114
"19031","WBGene00022545","V",8742804,8745045,2241
"19032","WBGene00022546","V",8739437,8742259,2822
"19033","WBGene00022547","V",8736674,8738437,1763
"19034","WBGene00022548","V",8733106,8735781,2675
"19035","WBGene00022549","V",8729458,8732789,3331
"19036","WBGene00022550","V",8726516,8728894,2378
"19037","WBGene00022551","V",8721198,8722260,1062
"19038","WBGene00022552","V",8723522,8725363,1841
"19039","WBGene00022553","II",1666325,1667482,1157
"19040","WBGene00022554","II",1663699,1665764,2065
"19041","WBGene00022555","II",1655217,1656148,931
"19042","WBGene00022556","II",1644249,1644814,565
"19043","WBGene00022557","II",1652510,1653497,987
"19044","WBGene00022558","II",1647908,1648865,957
"19045","WBGene00022559","II",1649138,1650197,1059
"19046","WBGene00022560","II",1650819,1651580,761
"19047","WBGene00022561","II",1653775,1654732,957
"19048","WBGene00022562","II",1656263,1657302,1039
"19049","WBGene00022563","II",1660474,1660988,514
"19050","WBGene00022564","II",1661806,1662949,1143
"19051","WBGene00022565","II",3217907,3218990,1083
"19052","WBGene00022566","II",3216081,3216600,519
"19053","WBGene00022567","II",3214452,3215565,1113
"19054","WBGene00022568","II",3212371,3213208,837
"19055","WBGene00022569","II",3209478,3211181,1703
"19056","WBGene00022570","II",3207683,3208751,1068
"19057","WBGene00022571","II",3222406,3222827,421
"19058","WBGene00022572","II",3221126,3222010,884
"19059","WBGene00022573","II",3223497,3224731,1234
"19060","WBGene00022574","II",3224770,3225285,515
"19061","WBGene00022575","II",3225348,3225968,620
"19062","WBGene00022576","V",5792331,5794857,2526
"19063","WBGene00022577","V",5794688,5798232,3544
"19064","WBGene00022578","III",8340797,8341743,946
"19065","WBGene00022579","III",8332223,8333572,1349
"19066","WBGene00022580","III",8326516,8330947,4431
"19067","WBGene00022581","III",8333663,8334233,570
"19068","WBGene00022583","III",8331047,8331919,872
"19069","WBGene00022584","V",4694974,4700289,5315
"19070","WBGene00022586","I",6368270,6369598,1328
"19071","WBGene00022587","V",5471833,5473146,1313
"19072","WBGene00022588","V",5460106,5461438,1332
"19073","WBGene00022589","V",5465822,5468626,2804
"19074","WBGene00022590","V",5468734,5471030,2296
"19075","WBGene00022591","I",6404587,6405705,1118
"19076","WBGene00022592","I",6386149,6392524,6375
"19077","WBGene00022593","I",6409050,6417010,7960
"19078","WBGene00022594","I",6405882,6406936,1054
"19079","WBGene00022596","III",5270261,5271035,774
"19080","WBGene00022597","III",5267809,5268581,772
"19081","WBGene00022598","III",5268682,5273471,4789
"19082","WBGene00022599","III",5273800,5274787,987
"19083","WBGene00022600","III",5286086,5286305,219
"19084","WBGene00022601","V",6794239,6795130,891
"19085","WBGene00022603","V",6788449,6792665,4216
"19086","WBGene00022604","V",6800724,6801950,1226
"19087","WBGene00022605","V",6802412,6804096,1684
"19088","WBGene00022606","V",6798151,6799664,1513
"19089","WBGene00022608","IV",3637079,3640265,3186
"19090","WBGene00022609","IV",3633619,3635472,1853
"19091","WBGene00022610","IV",3609218,3613072,3854
"19092","WBGene00022611","X",5024420,5028165,3745
"19093","WBGene00022612","X",5021215,5024258,3043
"19094","WBGene00022613","X",5017924,5021064,3140
"19095","WBGene00022614","X",5028184,5029568,1384
"19096","WBGene00022615","X",5035030,5037773,2743
"19097","WBGene00022616","X",5009300,5011222,1922
"19098","WBGene00022617","IV",7108221,7109912,1691
"19099","WBGene00022618","IV",7103492,7105096,1604
"19100","WBGene00022619","IV",7098542,7098784,242
"19101","WBGene00022620","IV",7101375,7103261,1886
"19102","WBGene00022621","IV",7110457,7111403,946
"19103","WBGene00022622","IV",7105169,7107733,2564
"19104","WBGene00022623","V",6727812,6730262,2450
"19105","WBGene00022624","V",6720397,6722478,2081
"19106","WBGene00022627","V",8054430,8057558,3128
"19107","WBGene00022628","V",8047044,8049528,2484
"19108","WBGene00022629","V",8035111,8039506,4395
"19109","WBGene00022630","V",8063247,8065079,1832
"19110","WBGene00022631","I",6663050,6665160,2110
"19111","WBGene00022632","I",6655608,6658371,2763
"19112","WBGene00022633","I",6651220,6655430,4210
"19113","WBGene00022634","I",6660436,6662315,1879
"19114","WBGene00022635","I",6665077,6673840,8763
"19115","WBGene00022636","V",408265,410080,1815
"19116","WBGene00022637","V",404619,405997,1378
"19117","WBGene00022638","V",400192,401602,1410
"19118","WBGene00022639","V",396827,398756,1929
"19119","WBGene00022640","V",392628,395117,2489
"19120","WBGene00022641","V",388697,391598,2901
"19121","WBGene00022642","V",385713,388090,2377
"19122","WBGene00022643","V",381901,384688,2787
"19123","WBGene00022644","V",411782,414760,2978
"19124","WBGene00022645","V",415713,417708,1995
"19125","WBGene00022646","V",6453196,6454973,1777
"19126","WBGene00022647","X",17460778,17464966,4188
"19127","WBGene00022648","X",17465454,17466894,1440
"19128","WBGene00022649","II",6020653,6023349,2696
"19129","WBGene00022650","II",6014357,6015891,1534
"19130","WBGene00022651","II",6008458,6008762,304
"19131","WBGene00022652","II",6016229,6016561,332
"19132","WBGene00022653","V",7713990,7714698,708
"19133","WBGene00022654","V",7697142,7700760,3618
"19134","WBGene00022655","V",7701048,7703636,2588
"19135","WBGene00022656","V",7716419,7717729,1310
"19136","WBGene00022657","V",7722837,7724065,1228
"19137","WBGene00022658","V",7709050,7710037,987
"19138","WBGene00022660","III",7729709,7730011,302
"19139","WBGene00022661","III",7738085,7739656,1571
"19140","WBGene00022662","III",7739855,7740541,686
"19141","WBGene00022663","III",5345252,5346117,865
"19142","WBGene00022664","III",5341682,5344273,2591
"19143","WBGene00022665","X",7779577,7780606,1029
"19144","WBGene00022666","X",7777031,7782537,5506
"19145","WBGene00022667","X",7783190,7787966,4776
"19146","WBGene00022668","X",7790178,7793563,3385
"19147","WBGene00022669","II",5528141,5529637,1496
"19148","WBGene00022670","II",5519217,5520200,983
"19149","WBGene00022671","II",5515861,5517133,1272
"19150","WBGene00022672","II",5505870,5509056,3186
"19151","WBGene00022673","II",5509028,5513775,4747
"19152","WBGene00022674","II",5517157,5517743,586
"19153","WBGene00022675","IV",4489012,4506708,17696
"19154","WBGene00022677","IV",4508499,4511320,2821
"19155","WBGene00022678","IV",4511896,4513319,1423
"19156","WBGene00022679","IV",4515044,4517169,2125
"19157","WBGene00022680","IV",4520181,4525043,4862
"19158","WBGene00022681","IV",4548553,4552742,4189
"19159","WBGene00022682","IV",4536553,4541771,5218
"19160","WBGene00022683","IV",4528730,4530382,1652
"19161","WBGene00022685","II",1948693,1949894,1201
"19162","WBGene00022688","II",1940809,1941958,1149
"19163","WBGene00022689","II",1945518,1946517,999
"19164","WBGene00022690","II",1953680,1955668,1988
"19165","WBGene00022691","II",1956050,1958255,2205
"19166","WBGene00022694","III",6006344,6009084,2740
"19167","WBGene00022695","III",6028790,6030583,1793
"19168","WBGene00022696","III",6032696,6039475,6779
"19169","WBGene00022697","III",8405874,8409406,3532
"19170","WBGene00022698","III",8398711,8399240,529
"19171","WBGene00022699","III",8395985,8396727,742
"19172","WBGene00022700","III",8388466,8389639,1173
"19173","WBGene00022702","III",8402049,8403607,1558
"19174","WBGene00022703","III",8403715,8405562,1847
"19175","WBGene00022704","III",8409496,8412017,2521
"19176","WBGene00022705","IV",5313405,5315525,2120
"19177","WBGene00022706","IV",5310042,5311445,1403
"19178","WBGene00022707","IV",5295931,5297487,1556
"19179","WBGene00022708","IV",5302141,5303078,937
"19180","WBGene00022709","IV",5304021,5306140,2119
"19181","WBGene00022710","IV",5306599,5308146,1547
"19182","WBGene00022711","II",2930728,2933463,2735
"19183","WBGene00022712","II",2923899,2926533,2634
"19184","WBGene00022713","II",2927017,2927633,616
"19185","WBGene00022714","II",2928221,2930599,2378
"19186","WBGene00022715","II",2934805,2937952,3147
"19187","WBGene00022716","II",2938143,2940847,2704
"19188","WBGene00022717","III",8720201,8725334,5133
"19189","WBGene00022718","III",8725323,8731373,6050
"19190","WBGene00022719","III",8737686,8741412,3726
"19191","WBGene00022720","III",8742007,8743842,1835
"19192","WBGene00022721","III",8746216,8748701,2485
"19193","WBGene00022722","III",8752091,8754750,2659
"19194","WBGene00022723","X",1630615,1635727,5112
"19195","WBGene00022724","X",1651419,1653897,2478
"19196","WBGene00022725","IV",6965492,6967806,2314
"19197","WBGene00022726","IV",6971898,6972527,629
"19198","WBGene00022727","IV",6978775,6986935,8160
"19199","WBGene00022728","X",1404271,1406101,1830
"19200","WBGene00022729","X",1403744,1404117,373
"19201","WBGene00022730","X",1402217,1402860,643
"19202","WBGene00022731","X",1398824,1400751,1927
"19203","WBGene00022732","III",7091330,7093408,2078
"19204","WBGene00022733","III",7070281,7070885,604
"19205","WBGene00022734","III",7072613,7073851,1238
"19206","WBGene00022735","III",7076572,7078837,2265
"19207","WBGene00022736","III",7079077,7080789,1712
"19208","WBGene00022737","III",7083684,7085088,1404
"19209","WBGene00022738","III",7085197,7087741,2544
"19210","WBGene00022739","II",4425167,4432613,7446
"19211","WBGene00022741","II",4405864,4416553,10689
"19212","WBGene00022742","II",4422463,4424902,2439
"19213","WBGene00022743","II",4392800,4404850,12050
"19214","WBGene00022744","X",4164302,4166138,1836
"19215","WBGene00022745","X",4135133,4147662,12529
"19216","WBGene00022746","X",4139516,4139767,251
"19217","WBGene00022747","X",4176065,4177494,1429
"19218","WBGene00022748","I",6093305,6094426,1121
"19219","WBGene00022749","I",6068526,6070122,1596
"19220","WBGene00022750","I",6070236,6078895,8659
"19221","WBGene00022751","I",6087366,6087764,398
"19222","WBGene00022752","I",6090015,6090919,904
"19223","WBGene00022753","I",6095060,6096589,1529
"19224","WBGene00022754","I",6097494,6097837,343
"19225","WBGene00022755","V",612781,614908,2127
"19226","WBGene00022756","V",600595,602482,1887
"19227","WBGene00022757","V",593259,595677,2418
"19228","WBGene00022758","V",590482,592463,1981
"19229","WBGene00022759","II",4946027,4948070,2043
"19230","WBGene00022760","II",4939899,4940282,383
"19231","WBGene00022761","II",4938004,4938602,598
"19232","WBGene00022762","II",4935563,4937956,2393
"19233","WBGene00022763","II",4930873,4932114,1241
"19234","WBGene00022765","II",4944042,4945838,1796
"19235","WBGene00022766","II",4938599,4941150,2551
"19236","WBGene00022767","X",3368959,3373217,4258
"19237","WBGene00022769","X",3376874,3379234,2360
"19238","WBGene00022770","X",3382868,3385547,2679
"19239","WBGene00022771","IV",5402938,5405537,2599
"19240","WBGene00022772","IV",5397839,5398591,752
"19241","WBGene00022773","IV",5397069,5397694,625
"19242","WBGene00022774","IV",5394962,5396966,2004
"19243","WBGene00022775","IV",5391912,5393572,1660
"19244","WBGene00022776","IV",5393843,5394849,1006
"19245","WBGene00022778","IV",5411479,5412206,727
"19246","WBGene00022780","II",5293800,5295612,1812
"19247","WBGene00022781","II",5278137,5282525,4388
"19248","WBGene00022782","II",5292683,5293306,623
"19249","WBGene00022783","III",7859613,7860159,546
"19250","WBGene00022785","III",7829411,7832503,3092
"19251","WBGene00022786","III",7842381,7843636,1255
"19252","WBGene00022787","III",7855840,7857242,1402
"19253","WBGene00022788","V",9263800,9266499,2699
"19254","WBGene00022789","V",9284129,9287617,3488
"19255","WBGene00022790","V",9290683,9292118,1435
"19256","WBGene00022791","III",7773134,7773849,715
"19257","WBGene00022792","III",7763698,7766052,2354
"19258","WBGene00022793","III",7767571,7769063,1492
"19259","WBGene00022794","III",7769165,7770149,984
"19260","WBGene00022795","III",7766389,7767515,1126
"19261","WBGene00022796","III",7909563,7910758,1195
"19262","WBGene00022797","III",7901033,7904473,3440
"19263","WBGene00022798","III",7892256,7894625,2369
"19264","WBGene00022799","III",7895024,7895270,246
"19265","WBGene00022800","III",7885088,7891615,6527
"19266","WBGene00022801","III",7904945,7907843,2898
"19267","WBGene00022802","III",7910798,7911630,832
"19268","WBGene00022803","III",7881113,7883003,1890
"19269","WBGene00022804","V",1752796,1753856,1060
"19270","WBGene00022805","V",1743771,1747969,4198
"19271","WBGene00022806","V",1729116,1730649,1533
"19272","WBGene00022807","V",1738927,1741157,2230
"19273","WBGene00022808","V",1748432,1749153,721
"19274","WBGene00022809","V",1754238,1755689,1451
"19275","WBGene00022810","X",8784534,8787072,2538
"19276","WBGene00022811","X",8778847,8784441,5594
"19277","WBGene00022812","V",7801518,7803727,2209
"19278","WBGene00022813","V",7808367,7810027,1660
"19279","WBGene00022814","V",7810228,7811785,1557
"19280","WBGene00022815","I",3769681,3773876,4195
"19281","WBGene00022816","III",7625376,7641053,15677
"19282","WBGene00022817","III",7641034,7643101,2067
"19283","WBGene00022818","III",7646176,7648071,1895
"19284","WBGene00022820","X",3446311,3448253,1942
"19285","WBGene00022821","X",3443782,3444420,638
"19286","WBGene00022822","X",3441839,3442458,619
"19287","WBGene00022823","X",3427372,3430120,2748
"19288","WBGene00022824","X",3448744,3451222,2478
"19289","WBGene00022825","X",3359062,3360656,1594
"19290","WBGene00022826","X",3348121,3348642,521
"19291","WBGene00022827","X",3348878,3350401,1523
"19292","WBGene00022829","X",7206719,7210756,4037
"19293","WBGene00022830","I",4382565,4385218,2653
"19294","WBGene00022831","I",4373656,4379329,5673
"19295","WBGene00022832","I",4368089,4370504,2415
"19296","WBGene00022833","I",4363415,4364048,633
"19297","WBGene00022834","I",4364906,4367049,2143
"19298","WBGene00022835","I",4370419,4372138,1719
"19299","WBGene00022836","I",4379325,4381948,2623
"19300","WBGene00022837","I",1128324,1131737,3413
"19301","WBGene00022838","I",1107578,1112251,4673
"19302","WBGene00022840","V",8510237,8512663,2426
"19303","WBGene00022842","V",8502591,8507326,4735
"19304","WBGene00022843","V",6590583,6593634,3051
"19305","WBGene00022845","V",6583761,6587421,3660
"19306","WBGene00022846","V",6580843,6584392,3549
"19307","WBGene00022847","V",6599190,6602604,3414
"19308","WBGene00022848","V",6602728,6605375,2647
"19309","WBGene00022849","II",7061999,7064777,2778
"19310","WBGene00022850","II",7055287,7056185,898
"19311","WBGene00022851","II",7053949,7055208,1259
"19312","WBGene00022852","II",7050672,7052001,1329
"19313","WBGene00022853","II",7042884,7044633,1749
"19314","WBGene00022854","II",7038292,7041685,3393
"19315","WBGene00022855","II",7046041,7050071,4030
"19316","WBGene00022856","II",7056173,7058014,1841
"19317","WBGene00022857","II",7052078,7053186,1108
"19318","WBGene00022858","X",406459,425679,19220
"19319","WBGene00022861","X",427043,433799,6756
"19320","WBGene00022862","III",8429307,8431586,2279
"19321","WBGene00022864","III",8431552,8432214,662
"19322","WBGene00022865","III",8439468,8443607,4139
"19323","WBGene00022866","II",2329355,2331792,2437
"19324","WBGene00022867","II",2323376,2325215,1839
"19325","WBGene00022868","II",2320153,2321951,1798
"19326","WBGene00022869","II",2315084,2315622,538
"19327","WBGene00022870","II",2316163,2317877,1714
"19328","WBGene00022871","II",2322367,2322907,540
"19329","WBGene00022872","II",2326995,2329053,2058
"19330","WBGene00022873","II",2318189,2320134,1945
"19331","WBGene00022874","II",5842243,5844575,2332
"19332","WBGene00022875","II",5818598,5818831,233
"19333","WBGene00022876","II",5810514,5811749,1235
"19334","WBGene00022877","II",5812375,5815482,3107
"19335","WBGene00022880","II",5823816,5827443,3627
"19336","WBGene00022881","II",5827587,5828586,999
"19337","WBGene00022882","II",5828683,5833232,4549
"19338","WBGene00022883","II",5836777,5838553,1776
"19339","WBGene00022884","II",5845254,5845541,287
"19340","WBGene00022885","II",5838663,5839414,751
"19341","WBGene00022886","II",7561753,7562701,948
"19342","WBGene00022887","II",7529643,7530991,1348
"19343","WBGene00022888","II",7525738,7528241,2503
"19344","WBGene00022889","II",7524467,7525558,1091
"19345","WBGene00022890","II",7546807,7548129,1322
"19346","WBGene00022891","II",7551951,7553906,1955
"19347","WBGene00022892","II",7560925,7561594,669
"19348","WBGene00022893","II",7535006,7536989,1983
"19349","WBGene00022896","II",7756952,7757023,71
"19350","WBGene00022904","II",5129,5483,354
"19351","WBGene00022906","X",5407413,5407485,72
"19352","WBGene00022910","III",5626944,5628206,1262
"19353","WBGene00022916","X",16617892,16617963,71
"19354","WBGene00022918","X",2662689,2663065,376
"19355","WBGene00022919","X",2672427,2672759,332
"19356","WBGene00022922","X",3487101,3487996,895
"19357","WBGene00022926","X",3985104,3985465,361
"19358","WBGene00022927","X",3969556,3969627,71
"19359","WBGene00022929","X",3970265,3970336,71
"19360","WBGene00022930","II",3439394,3439466,72
"19361","WBGene00022932","V",8247888,8247961,73
"19362","WBGene00022938","X",8037507,8037578,71
"19363","WBGene00022940","IV",2096520,2096875,355
"19364","WBGene00022942","X",5485455,5485527,72
"19365","WBGene00022943","X",5485746,5485818,72
"19366","WBGene00022948","X",8846721,8846792,71
"19367","WBGene00022950","X",8838338,8838409,71
"19368","WBGene00022951","X",16929914,16944683,14769
"19369","WBGene00022952","X",16928271,16928341,70
"19370","WBGene00022953","I",10807204,10807275,71
"19371","WBGene00022954","X",1698674,1698746,72
"19372","WBGene00022955","I",6781803,6781874,71
"19373","WBGene00022960","IV",6562202,6562273,71
"19374","WBGene00022962","X",8969738,8969809,71
"19375","WBGene00022963","X",8971600,8971681,81
"19376","WBGene00022968","IV",7885488,7885570,82
"19377","WBGene00022970","V",5597061,5597450,389
"19378","WBGene00022972","X",8939550,8939631,81
"19379","WBGene00022973","X",9373150,9373221,71
"19380","WBGene00022974","X",5708028,5708109,81
"19381","WBGene00022975","X",5709375,5709456,81
"19382","WBGene00022978","II",3267989,3268070,81
"19383","WBGene00022981","X",8409296,8409377,81
"19384","WBGene00022982","X",1505190,1505626,436
"19385","WBGene00022985","III",7030557,7030628,71
"19386","WBGene00022997","X",9238863,9238934,71
"19387","WBGene00022999","III",8646167,8646248,81
"19388","WBGene00023000","III",8653055,8653127,72
"19389","WBGene00023002","III",8650381,8650452,71
"19390","WBGene00023007","X",8155752,8155823,71
"19391","WBGene00023017","V",3455326,3455398,72
"19392","WBGene00023020","III",502804,502889,85
"19393","WBGene00023021","II",7258389,7258829,440
"19394","WBGene00023025","II",5032771,5032844,73
"19395","WBGene00023030","IV",5261122,5261291,169
"19396","WBGene00023031","III",6724135,6724220,85
"19397","WBGene00023036","II",3302761,3303750,989
"19398","WBGene00023039","V",2242196,2242772,576
"19399","WBGene00023041","X",8386614,8386686,72
"19400","WBGene00023042","X",8404499,8404571,72
"19401","WBGene00023048","X",7176983,7177054,71
"19402","WBGene00023054","X",9059280,9059394,114
"19403","WBGene00023060","X",1089838,1089910,72
"19404","WBGene00023063","X",2553565,2553636,71
"19405","WBGene00023065","I",3828843,3829313,470
"19406","WBGene00023066","I",3821656,3821990,334
"19407","WBGene00023067","I",4789190,4789592,402
"19408","WBGene00023068","I",4790292,4790649,357
"19409","WBGene00023069","X",1011501,1012347,846
"19410","WBGene00023070","X",1379603,1379674,71
"19411","WBGene00023071","III",7337892,7338002,110
"19412","WBGene00023084","III",2650851,2651565,714
"19413","WBGene00023095","V",6551854,6551935,81
"19414","WBGene00023096","V",6559757,6559828,71
"19415","WBGene00023100","X",16503144,16503216,72
"19416","WBGene00023103","V",857325,857396,71
"19417","WBGene00023104","III",383771,384827,1056
"19418","WBGene00023106","IV",658181,658266,85
"19419","WBGene00023109","III",2032897,2032968,71
"19420","WBGene00023110","X",3036164,3036235,71
"19421","WBGene00023113","II",4565016,4565087,71
"19422","WBGene00023116","X",3994602,3994678,76
"19423","WBGene00023118","X",8819681,8819752,71
"19424","WBGene00023119","X",8820185,8820256,71
"19425","WBGene00023122","X",8818100,8818171,71
"19426","WBGene00023131","IV",66982,67052,70
"19427","WBGene00023132","X",6286321,6286392,71
"19428","WBGene00023135","I",6164191,6164264,73
"19429","WBGene00023138","II",6721766,6721848,82
"19430","WBGene00023139","X",2227191,2227262,71
"19431","WBGene00023140","III",5294979,5295050,71
"19432","WBGene00023142","I",3916064,3916391,327
"19433","WBGene00023145","V",3588314,3588385,71
"19434","WBGene00023146","V",3582131,3582202,71
"19435","WBGene00023147","III",535382,535465,83
"19436","WBGene00023148","X",9025663,9025734,71
"19437","WBGene00023152","X",1858819,1858890,71
"19438","WBGene00023160","II",3521487,3521558,71
"19439","WBGene00023162","II",3519086,3519157,71
"19440","WBGene00023163","IV",1205868,1206377,509
"19441","WBGene00023164","II",3567764,3567836,72
"19442","WBGene00023168","IV",4861754,4861827,73
"19443","WBGene00023169","I",754680,754763,83
"19444","WBGene00023172","I",2632987,2634561,1574
"19445","WBGene00023179","IV",2802337,2802408,71
"19446","WBGene00023181","IV",2808355,2808426,71
"19447","WBGene00023183","IV",867056,867133,77
"19448","WBGene00023187","IV",3115242,3115766,524
"19449","WBGene00023189","III",1122505,1122577,72
"19450","WBGene00023191","X",66509,73142,6633
"19451","WBGene00023193","I",3747,3909,162
"19452","WBGene00023194","X",1764254,1764327,73
"19453","WBGene00023195","III",1424491,1424562,71
"19454","WBGene00023200","V",7730654,7730725,71
"19455","WBGene00023201","III",6726991,6727076,85
"19456","WBGene00023202","IV",1388216,1388287,71
"19457","WBGene00023205","III",1225459,1226065,606
"19458","WBGene00023209","V",8039469,8040387,918
"19459","WBGene00023210","X",7773190,7773262,72
"19460","WBGene00023211","X",7773718,7773790,72
"19461","WBGene00023212","X",7794603,7794674,71
"19462","WBGene00023214","X",7773965,7774037,72
"19463","WBGene00023215","X",1629881,1629952,71
"19464","WBGene00023223","III",8436700,8437811,1111
"19465","WBGene00023224","III",7105441,7106460,1019
"19466","WBGene00023225","II",2310071,2311074,1003
"19467","WBGene00023226","X",1597051,1597835,784
"19468","WBGene00023227","III",1040676,1040746,70
"19469","WBGene00023228","III",1041553,1041623,70
"19470","WBGene00023230","III",1044997,1045067,70
"19471","WBGene00023231","III",1046942,1047012,70
"19472","WBGene00023232","III",1047830,1047901,71
"19473","WBGene00023233","X",17084343,17084855,512
"19474","WBGene00023235","V",7264576,7265377,801
"19475","WBGene00023236","X",1830653,1830747,94
"19476","WBGene00023237","II",5569669,5569869,200
"19477","WBGene00023238","IV",6823102,6824131,1029
"19478","WBGene00023239","V",5548869,5549887,1018
"19479","WBGene00023240","IV",2094700,2094930,230
"19480","WBGene00023241","IV",2092136,2092353,217
"19481","WBGene00023242","IV",2095237,2095469,232
"19482","WBGene00023243","IV",5162223,5162712,489
"19483","WBGene00023244","II",430014,432732,2718
"19484","WBGene00023245","X",17284339,17285449,1110
"19485","WBGene00023246","X",17280761,17283574,2813
"19486","WBGene00023247","X",17286274,17287564,1290
"19487","WBGene00023248","X",17296644,17297231,587
"19488","WBGene00023249","IV",4106574,4106646,72
"19489","WBGene00023252","IV",5611090,5612090,1000
"19490","WBGene00023253","II",12345880,12345950,70
"19491","WBGene00023254","II",12349636,12349707,71
"19492","WBGene00023255","V",2149177,2149249,72
"19493","WBGene00023257","IV",1146074,1146145,71
"19494","WBGene00023259","IV",17168665,17169058,393
"19495","WBGene00023260","II",7001627,7001698,71
"19496","WBGene00023262","V",7535582,7536416,834
"19497","WBGene00023263","X",1474006,1474087,81
"19498","WBGene00023264","V",4062497,4068573,6076
"19499","WBGene00023265","IV",4989065,4989717,652
"19500","WBGene00023266","II",2077022,2077902,880
"19501","WBGene00023267","V",7301731,7302201,470
"19502","WBGene00023268","X",4428381,4429001,620
"19503","WBGene00023270","IV",8336807,8338172,1365
"19504","WBGene00023271","X",1433063,1433143,80
"19505","WBGene00023272","II",2658912,2659174,262
"19506","WBGene00023273","I",2445420,2445983,563
"19507","WBGene00023274","I",2440205,2441169,964
"19508","WBGene00023276","V",5688753,5689477,724
"19509","WBGene00023277","IV",115521,118340,2819
"19510","WBGene00023278","II",2408308,2409325,1017
"19511","WBGene00023279","IV",4239853,4240855,1002
"19512","WBGene00023281","II",3292264,3293472,1208
"19513","WBGene00023282","II",3294021,3295068,1047
"19514","WBGene00023284","V",2255533,2256658,1125
"19515","WBGene00023285","II",2443051,2443116,65
"19516","WBGene00023287","II",801728,802693,965
"19517","WBGene00023288","IV",4143317,4144346,1029
"19518","WBGene00023289","III",1934447,1936195,1748
"19519","WBGene00023290","X",2125762,2125833,71
"19520","WBGene00023291","IV",1335896,1336434,538
"19521","WBGene00023293","II",1366396,1366469,73
"19522","WBGene00023294","II",1367941,1368013,72
"19523","WBGene00023295","I",185335,185409,74
"19524","WBGene00023297","II",1333251,1333322,71
"19525","WBGene00023298","II",1334132,1334203,71
"19526","WBGene00023299","II",1335738,1335809,71
"19527","WBGene00023300","III",2879915,2879988,73
"19528","WBGene00023301","IV",3471563,3473584,2021
"19529","WBGene00023302","IV",3447216,3448708,1492
"19530","WBGene00023303","IV",3462027,3462929,902
"19531","WBGene00023304","IV",1355414,1355486,72
"19532","WBGene00023305","IV",1365191,1365262,71
"19533","WBGene00023306","V",2007360,2007709,349
"19534","WBGene00023307","III",3099574,3099645,71
"19535","WBGene00023308","X",1620275,1620355,80
"19536","WBGene00023309","II",1476006,1476078,72
"19537","WBGene00023311","II",1478756,1478828,72
"19538","WBGene00023312","II",1481918,1481990,72
"19539","WBGene00023313","X",5232244,5233263,1019
"19540","WBGene00023314","I",4120407,4123036,2629
"19541","WBGene00023315","II",1054096,1054687,591
"19542","WBGene00023316","II",1088444,1088516,72
"19543","WBGene00023317","V",1518736,1519807,1071
"19544","WBGene00023318","II",4048525,4049129,604
"19545","WBGene00023319","II",662329,664816,2487
"19546","WBGene00023320","II",656796,658177,1381
"19547","WBGene00023321","II",656054,656180,126
"19548","WBGene00023322","V",6235913,6236854,941
"19549","WBGene00023323","IV",4725964,4727963,1999
"19550","WBGene00023324","II",6358367,6358438,71
"19551","WBGene00023325","III",383249,384177,928
"19552","WBGene00023326","IV",6141423,6142454,1031
"19553","WBGene00023327","V",9011244,9011565,321
"19554","WBGene00023329","X",2463486,2463558,72
"19555","WBGene00023330","V",7392385,7392973,588
"19556","WBGene00023331","IV",6865672,6866689,1017
"19557","WBGene00023333","III",3189669,3189742,73
"19558","WBGene00023334","III",3191651,3191720,69
"19559","WBGene00023335","V",2837634,2838805,1171
"19560","WBGene00023336","V",2839154,2840318,1164
"19561","WBGene00023337","V",2841018,2842241,1223
"19562","WBGene00023338","V",2842946,2844240,1294
"19563","WBGene00023339","V",2852425,2853605,1180
"19564","WBGene00023340","V",7756749,7757854,1105
"19565","WBGene00023342","V",6421726,6421798,72
"19566","WBGene00023343","V",1954688,1955230,542
"19567","WBGene00023345","III",941905,942868,963
"19568","WBGene00023348","II",3761803,3762838,1035
"19569","WBGene00023349","X",16522770,16522841,71
"19570","WBGene00023351","V",3731808,3732837,1029
"19571","WBGene00023353","X",4242523,4242599,76
"19572","WBGene00023355","V",6714990,6716302,1312
"19573","WBGene00023356","V",142449,142799,350
"19574","WBGene00023358","II",3586489,3587949,1460
"19575","WBGene00023363","III",1577008,1577078,70
"19576","WBGene00023364","III",1743249,1743320,71
"19577","WBGene00023367","IV",3590291,3590363,72
"19578","WBGene00023369","I",10872689,10872761,72
"19579","WBGene00023370","III",1998084,1998157,73
"19580","WBGene00023373","III",3101085,3101156,71
"19581","WBGene00023375","III",3103013,3103085,72
"19582","WBGene00023377","III",3105142,3105214,72
"19583","WBGene00023378","III",3106147,3106218,71
"19584","WBGene00023380","III",3110798,3110870,72
"19585","WBGene00023381","III",3112144,3112215,71
"19586","WBGene00023382","V",7056766,7057965,1199
"19587","WBGene00023384","V",4782229,4782301,72
"19588","WBGene00023386","III",1575333,1575405,72
"19589","WBGene00023387","III",1575430,1575502,72
"19590","WBGene00023389","IV",2659013,2659085,72
"19591","WBGene00023390","IV",2664242,2664314,72
"19592","WBGene00023392","IV",1407265,1407335,70
"19593","WBGene00023393","IV",1464681,1464753,72
"19594","WBGene00023395","III",1333921,1335467,1546
"19595","WBGene00023396","IV",2740214,2740286,72
"19596","WBGene00023397","IV",1385623,1385695,72
"19597","WBGene00023398","I",803800,803872,72
"19598","WBGene00023399","II",3227258,3228295,1037
"19599","WBGene00023400","X",1638811,1642457,3646
"19600","WBGene00023401","X",1643850,1643922,72
"19601","WBGene00023402","V",607604,608306,702
"19602","WBGene00023404","III",11456877,11462897,6020
"19603","WBGene00023405","III",8416227,8422650,6423
"19604","WBGene00023407","II",5447681,5448634,953
"19605","WBGene00023408","II",7832844,7835414,2570
"19606","WBGene00023409","I",6064088,6065298,1210
"19607","WBGene00023410","II",1259365,1262998,3633
"19608","WBGene00023411","I",8181337,8182933,1596
"19609","WBGene00023413","I",8172721,8173489,768
"19610","WBGene00023414","III",7035432,7045724,10292
"19611","WBGene00023415","I",10155161,10158558,3397
"19612","WBGene00023416","II",7496247,7497369,1122
"19613","WBGene00023417","V",9054268,9054844,576
"19614","WBGene00023418","II",10822328,10824081,1753
"19615","WBGene00023419","V",13621371,13621820,449
"19616","WBGene00023420","II",8334094,8336503,2409
"19617","WBGene00023421","IV",13105323,13106927,1604
"19618","WBGene00023422","III",4242672,4243561,889
"19619","WBGene00023423","III",4241477,4242593,1116
"19620","WBGene00023424","IV",9033576,9034440,864
"19621","WBGene00023425","II",4368490,4369692,1202
"19622","WBGene00023427","II",3342335,3343814,1479
"19623","WBGene00023428","V",10351218,10351353,135
"19624","WBGene00023429","V",16370219,16370355,136
"19625","WBGene00023430","V",10772125,10772230,105
"19626","WBGene00023431","V",9059750,9060481,731
"19627","WBGene00023432","V",6291390,6292666,1276
"19628","WBGene00023450","III",13641795,13642327,532
"19629","WBGene00023451","III",13752406,13755861,3455
"19630","WBGene00023452","I",4585874,4585983,109
"19631","WBGene00023453","III",7860147,7860256,109
"19632","WBGene00023454","V",8580542,8580651,109
"19633","WBGene00023455","V",8580858,8580967,109
"19634","WBGene00023456","X",5919149,5919258,109
"19635","WBGene00023457","X",3004291,3004400,109
"19636","WBGene00023458","X",322523,323214,691
"19637","WBGene00023459","I",12783358,12784281,923
"19638","WBGene00023460","X",4491651,4492208,557
"19639","WBGene00023462","IV",3504444,3506115,1671
"19640","WBGene00023463","IV",3482895,3484706,1811
"19641","WBGene00023464","IV",3489858,3491519,1661
"19642","WBGene00023465","IV",3485316,3487105,1789
"19643","WBGene00023466","III",7208613,7208744,131
"19644","WBGene00023467","IV",2408508,2408635,127
"19645","WBGene00023468","III",794399,794526,127
"19646","WBGene00023469","III",6374415,6374548,133
"19647","WBGene00023470","III",2071513,2072347,834
"19648","WBGene00023471","III",2063442,2065855,2413
"19649","WBGene00023472","I",9373371,9375824,2453
"19650","WBGene00023474","IV",3480011,3481860,1849
"19651","WBGene00023475","IV",3475646,3477224,1578
"19652","WBGene00023476","IV",3482112,3482565,453
"19653","WBGene00023477","X",8534677,8535106,429
"19654","WBGene00023478","IV",3900504,3902326,1822
"19655","WBGene00023479","II",3235956,3237138,1182
"19656","WBGene00023480","II",3238169,3240043,1874
"19657","WBGene00023481","IV",3458600,3460440,1840
"19658","WBGene00023483","III",12313287,12314403,1116
"19659","WBGene00023484","IV",2820708,2823519,2811
"19660","WBGene00023485","V",9355505,9356541,1036
"19661","WBGene00023486","IV",6091536,6092413,877
"19662","WBGene00023487","IV",7710045,7710826,781
"19663","WBGene00023488","IV",8422053,8424146,2093
"19664","WBGene00023489","III",6164645,6171165,6520
"19665","WBGene00023490","I",8824401,8825628,1227
"19666","WBGene00023491","X",9932371,9937133,4762
"19667","WBGene00023492","X",12425730,12426631,901
"19668","WBGene00023493","X",12356194,12356681,487
"19669","WBGene00023497","X",15726129,15732025,5896
"19670","WBGene00023498","X",15731968,15735386,3418
"19671","WBGene00023499","II",1278650,1281039,2389
"19672","WBGene00023500","X",14318119,14320398,2279
"19673","WBGene00023501","IV",17442827,17443738,911
"19674","WBGene00023502","IV",12432640,12435001,2361
"19675","WBGene00023503","V",10955923,10957020,1097
"19676","WBGene00023504","V",20579546,20580678,1132
"19677","WBGene00023505","V",16687527,16689866,2339
"19678","WBGene00023506","V",15163082,15164518,1436
"19679","WBGene00023507","V",17316351,17317719,1368
"19680","WBGene00023508","IV",16335337,16336503,1166
"19681","WBGene00023510","IV",16291988,16293070,1082
"19682","WBGene00023511","IV",16300588,16301746,1158
"19683","WBGene00023512","V",17404611,17405823,1212
"19684","WBGene00023513","IV",16332885,16334461,1576
"19685","WBGene00023514","IV",16299151,16300272,1121
"19686","WBGene00023515","V",14465095,14468246,3151
"19687","WBGene00023517","IV",16286655,16287825,1170
"19688","WBGene00023518","IV",16288111,16289310,1199
"19689","WBGene00023519","V",19978620,19981882,3262
"19690","WBGene00023520","IV",14807189,14809958,2769
"19691","WBGene00043049","I",8958061,8960889,2828
"19692","WBGene00043050","II",7613541,7614434,893
"19693","WBGene00043051","III",7926999,7928734,1735
"19694","WBGene00043052","IV",16323673,16324973,1300
"19695","WBGene00043053","V",17361541,17369294,7753
"19696","WBGene00043054","II",12490214,12491815,1601
"19697","WBGene00043055","V",20176101,20177715,1614
"19698","WBGene00043056","I",11224836,11233334,8498
"19699","WBGene00043057","III",10933631,10936129,2498
"19700","WBGene00043058","II",12450149,12451407,1258
"19701","WBGene00043059","V",9876687,9879504,2817
"19702","WBGene00043060","III",5004820,5006981,2161
"19703","WBGene00043061","IV",2759463,2762083,2620
"19704","WBGene00043062","IV",2823746,2828069,4323
"19705","WBGene00043064","IV",5209501,5210690,1189
"19706","WBGene00043065","IV",5678847,5682639,3792
"19707","WBGene00043066","IV",6464352,6468327,3975
"19708","WBGene00043067","IV",6438223,6440032,1809
"19709","WBGene00043068","IV",7562220,7563724,1504
"19710","WBGene00043069","V",8188788,8190116,1328
"19711","WBGene00043097","III",8552555,8553839,1284
"19712","WBGene00043120","II",11100141,11100462,321
"19713","WBGene00043147","IV",5165420,5165777,357
"19714","WBGene00043156","III",4961817,4963092,1275
"19715","WBGene00043187","X",11739050,11739154,104
"19716","WBGene00043239","II",2775234,2777815,2581
"19717","WBGene00043279","I",7098981,7099497,516
"19718","WBGene00043283","IV",9148949,9149297,348
"19719","WBGene00043297","III",6816643,6816880,237
"19720","WBGene00043302","V",10887873,10889004,1131
"19721","WBGene00043328","II",995288,996212,924
"19722","WBGene00043466","IV",7516585,7517035,450
"19723","WBGene00043469","X",1664855,1665025,170
"19724","WBGene00043534","II",11445289,11448895,3606
"19725","WBGene00043666","V",4163222,4163611,389
"19726","WBGene00043702","IV",2838608,2839422,814
"19727","WBGene00043705","IV",984405,990521,6116
"19728","WBGene00043743","IV",5226891,5228230,1339
"19729","WBGene00043948","III",8343771,8344336,565
"19730","WBGene00043952","V",6787952,6788460,508
"19731","WBGene00043980","X",3304026,3306939,2913
"19732","WBGene00043981","X",6559570,6562366,2796
"19733","WBGene00043982","X",7071410,7075337,3927
"19734","WBGene00043983","X",7903280,7905654,2374
"19735","WBGene00043984","II",6516359,6518380,2021
"19736","WBGene00043985","X",11707903,11710190,2287
"19737","WBGene00043986","II",4665893,4667588,1695
"19738","WBGene00043992","III",9609568,9612191,2623
"19739","WBGene00043993","III",9413461,9414602,1141
"19740","WBGene00043994","III",9725285,9727539,2254
"19741","WBGene00043995","III",9913021,9914075,1054
"19742","WBGene00043996","III",10894520,10895732,1212
"19743","WBGene00043997","III",12025559,12028811,3252
"19744","WBGene00043998","III",10551102,10552955,1853
"19745","WBGene00044000","III",12315876,12317053,1177
"19746","WBGene00044001","IV",8513205,8513916,711
"19747","WBGene00044002","V",14281120,14282322,1202
"19748","WBGene00044003","IV",15061929,15065748,3819
"19749","WBGene00044004","X",4330076,4332405,2329
"19750","WBGene00044005","III",7194094,7195425,1331
"19751","WBGene00044006","II",9251788,9254312,2524
"19752","WBGene00044007","II",9680798,9683089,2291
"19753","WBGene00044008","I",9228163,9232097,3934
"19754","WBGene00044009","IV",11924685,11925397,712
"19755","WBGene00044011","V",9628314,9629110,796
"19756","WBGene00044012","V",10121134,10122770,1636
"19757","WBGene00044013","V",10413332,10414692,1360
"19758","WBGene00044014","V",10415734,10417025,1291
"19759","WBGene00044015","V",9482181,9483182,1001
"19760","WBGene00044016","V",10504193,10505401,1208
"19761","WBGene00044018","IV",10050581,10051188,607
"19762","WBGene00044019","V",11501444,11503127,1683
"19763","WBGene00044020","V",10217079,10219022,1943
"19764","WBGene00044021","X",4107476,4110496,3020
"19765","WBGene00044022","V",10374851,10376884,2033
"19766","WBGene00044024","V",10502116,10503111,995
"19767","WBGene00044025","IV",11359864,11361509,1645
"19768","WBGene00044026","II",11468552,11469624,1072
"19769","WBGene00044027","II",10125898,10127455,1557
"19770","WBGene00044028","II",10155413,10156220,807
"19771","WBGene00044029","II",11410091,11412280,2189
"19772","WBGene00044030","II",11999260,12001422,2162
"19773","WBGene00044031","II",12542754,12544633,1879
"19774","WBGene00044032","II",12520004,12524478,4474
"19775","WBGene00044034","II",12629687,12631995,2308
"19776","WBGene00044035","II",10122765,10125015,2250
"19777","WBGene00044036","II",10442774,10442884,110
"19778","WBGene00044037","II",10006111,10006535,424
"19779","WBGene00044038","II",11293997,11294579,582
"19780","WBGene00044040","II",11558342,11558653,311
"19781","WBGene00044041","II",12402434,12404887,2453
"19782","WBGene00044042","II",12825546,12825833,287
"19783","WBGene00044043","II",12827032,12827519,487
"19784","WBGene00044044","V",10100156,10102016,1860
"19785","WBGene00044045","V",13523530,13529658,6128
"19786","WBGene00044046","II",10479920,10480081,161
"19787","WBGene00044047","II",12414036,12414905,869
"19788","WBGene00044048","II",12394856,12397756,2900
"19789","WBGene00044049","II",8102108,8105052,2944
"19790","WBGene00044051","II",12222405,12222932,527
"19791","WBGene00044052","II",12412723,12412957,234
"19792","WBGene00044053","II",14562214,14564011,1797
"19793","WBGene00044054","II",14538409,14540542,2133
"19794","WBGene00044056","II",14980957,14982118,1161
"19795","WBGene00044057","II",13039252,13039794,542
"19796","WBGene00044058","I",13201710,13204293,2583
"19797","WBGene00044059","V",17415278,17416743,1465
"19798","WBGene00044061","X",2525191,2532457,7266
"19799","WBGene00044062","II",8859074,8859696,622
"19800","WBGene00044063","II",4420255,4422319,2064
"19801","WBGene00044065","I",13802390,13806801,4411
"19802","WBGene00044066","I",13423994,13425148,1154
"19803","WBGene00044067","IV",17285733,17287454,1721
"19804","WBGene00044068","X",7218109,7226825,8716
"19805","WBGene00044069","III",10405248,10407248,2000
"19806","WBGene00044070","I",10590678,10593972,3294
"19807","WBGene00044071","X",8552261,8556351,4090
"19808","WBGene00044072","III",10120781,10122928,2147
"19809","WBGene00044073","IV",1550878,1553119,2241
"19810","WBGene00044074","II",13925268,13930516,5248
"19811","WBGene00044077","V",9213746,9217243,3497
"19812","WBGene00044078","III",4686088,4688210,2122
"19813","WBGene00044079","X",11824184,11836162,11978
"19814","WBGene00044080","V",14082753,14083584,831
"19815","WBGene00044081","V",14074456,14076725,2269
"19816","WBGene00044082","V",14101186,14102821,1635
"19817","WBGene00044084","II",13718185,13721318,3133
"19818","WBGene00044085","IV",16090484,16091939,1455
"19819","WBGene00044086","V",15338569,15339482,913
"19820","WBGene00044087","V",2175542,2177503,1961
"19821","WBGene00044088","V",3471870,3475121,3251
"19822","WBGene00044089","V",3476405,3477596,1191
"19823","WBGene00044090","V",3483091,3484781,1690
"19824","WBGene00044091","V",780299,781803,1504
"19825","WBGene00044092","IV",4223857,4225946,2089
"19826","WBGene00044093","IV",4222183,4223140,957
"19827","WBGene00044094","I",8253452,8254961,1509
"19828","WBGene00044095","V",17398454,17399396,942
"19829","WBGene00044096","V",17419156,17420298,1142
"19830","WBGene00044097","IV",14514376,14515118,742
"19831","WBGene00044099","V",2394485,2396635,2150
"19832","WBGene00044100","V",17431203,17432501,1298
"19833","WBGene00044101","V",17432993,17435209,2216
"19834","WBGene00044102","V",12805149,12806128,979
"19835","WBGene00044103","V",15818427,15819827,1400
"19836","WBGene00044104","V",15834745,15837403,2658
"19837","WBGene00044105","V",15829022,15830007,985
"19838","WBGene00044106","V",16298969,16299862,893
"19839","WBGene00044107","IV",9651394,9652484,1090
"19840","WBGene00044109","V",14239942,14241151,1209
"19841","WBGene00044112","V",14335201,14336712,1511
"19842","WBGene00044113","V",7522032,7522364,332
"19843","WBGene00044114","V",13924151,13925807,1656
"19844","WBGene00044115","V",13926698,13929320,2622
"19845","WBGene00044116","V",13929803,13931252,1449
"19846","WBGene00044117","V",4973314,4974777,1463
"19847","WBGene00044119","V",3522496,3523373,877
"19848","WBGene00044120","I",8730905,8732125,1220
"19849","WBGene00044121","X",11542129,11545061,2932
"19850","WBGene00044122","I",8150331,8151368,1037
"19851","WBGene00044124","IV",5622063,5623818,1755
"19852","WBGene00044125","IV",5615522,5619685,4163
"19853","WBGene00044126","V",8353793,8355008,1215
"19854","WBGene00044127","III",12806175,12806855,680
"19855","WBGene00044128","III",12804599,12804761,162
"19856","WBGene00044129","II",13779213,13779702,489
"19857","WBGene00044130","III",10010843,10011065,222
"19858","WBGene00044132","X",12217243,12219312,2069
"19859","WBGene00044133","X",11696996,11698065,1069
"19860","WBGene00044134","X",14516860,14519229,2369
"19861","WBGene00044135","X",11313385,11315612,2227
"19862","WBGene00044136","X",14434212,14435363,1151
"19863","WBGene00044137","X",14133896,14134344,448
"19864","WBGene00044138","X",14876150,14878855,2705
"19865","WBGene00044139","X",14807236,14807944,708
"19866","WBGene00044140","X",12347029,12347899,870
"19867","WBGene00044141","X",15051688,15052870,1182
"19868","WBGene00044142","X",15503404,15505373,1969
"19869","WBGene00044143","X",15628606,15630440,1834
"19870","WBGene00044144","X",12149953,12151474,1521
"19871","WBGene00044145","X",14469647,14470066,419
"19872","WBGene00044146","X",14470987,14471772,785
"19873","WBGene00044147","X",14479378,14480256,878
"19874","WBGene00044148","X",11952085,11953329,1244
"19875","WBGene00044149","X",12603622,12604708,1086
"19876","WBGene00044150","X",16013605,16016920,3315
"19877","WBGene00044151","X",11076182,11076767,585
"19878","WBGene00044152","X",11077772,11078243,471
"19879","WBGene00044153","X",11089243,11090679,1436
"19880","WBGene00044154","X",15793767,15794936,1169
"19881","WBGene00044155","X",15811967,15819541,7574
"19882","WBGene00044156","X",14454689,14455519,830
"19883","WBGene00044157","X",14460712,14462139,1427
"19884","WBGene00044158","II",9698281,9700463,2182
"19885","WBGene00044159","II",9915438,9916289,851
"19886","WBGene00044160","II",11120882,11121900,1018
"19887","WBGene00044161","II",11294770,11296020,1250
"19888","WBGene00044162","II",12546761,12548249,1488
"19889","WBGene00044163","II",12555884,12557129,1245
"19890","WBGene00044164","II",12752854,12753813,959
"19891","WBGene00044166","III",3545740,3546419,679
"19892","WBGene00044167","III",3840595,3841154,559
"19893","WBGene00044168","II",8471880,8473522,1642
"19894","WBGene00044169","II",9375845,9377258,1413
"19895","WBGene00044170","II",9394453,9395234,781
"19896","WBGene00044171","II",14786198,14786512,314
"19897","WBGene00044174","V",10220981,10221417,436
"19898","WBGene00044175","V",10221662,10221963,301
"19899","WBGene00044176","V",14936898,14939367,2469
"19900","WBGene00044177","V",14942137,14945704,3567
"19901","WBGene00044178","V",14946622,14947229,607
"19902","WBGene00044179","V",14953115,14954733,1618
"19903","WBGene00044180","V",14688616,14688959,343
"19904","WBGene00044181","V",16881901,16882310,409
"19905","WBGene00044182","V",16882878,16883142,264
"19906","WBGene00044183","V",16885075,16885403,328
"19907","WBGene00044184","V",16210952,16211454,502
"19908","WBGene00044185","V",16666340,16666747,407
"19909","WBGene00044187","V",20910467,20914387,3920
"19910","WBGene00044188","V",15577569,15578486,917
"19911","WBGene00044189","V",16502947,16503282,335
"19912","WBGene00044191","V",14629377,14635180,5803
"19913","WBGene00044192","V",9798926,9799179,253
"19914","WBGene00044193","V",14318961,14319731,770
"19915","WBGene00044194","V",14320546,14321313,767
"19916","WBGene00044195","V",16875877,16876144,267
"19917","WBGene00044196","V",19291646,19292393,747
"19918","WBGene00044197","V",19302787,19303728,941
"19919","WBGene00044198","V",12628957,12629905,948
"19920","WBGene00044199","V",13188025,13189406,1381
"19921","WBGene00044200","V",13646884,13648397,1513
"19922","WBGene00044201","V",14107811,14110151,2340
"19923","WBGene00044202","V",17273524,17275059,1535
"19924","WBGene00044203","V",11332987,11334293,1306
"19925","WBGene00044204","V",9931019,9932368,1349
"19926","WBGene00044205","V",16271536,16272498,962
"19927","WBGene00044206","V",15444916,15445420,504
"19928","WBGene00044207","V",17614694,17615709,1015
"19929","WBGene00044208","V",17616473,17616921,448
"19930","WBGene00044209","V",10447881,10449037,1156
"19931","WBGene00044210","V",18571833,18573026,1193
"19932","WBGene00044211","V",19991207,19994189,2982
"19933","WBGene00044212","V",17207352,17208116,764
"19934","WBGene00044213","V",16926920,16927445,525
"19935","WBGene00044215","V",18456728,18457329,601
"19936","WBGene00044216","V",14667897,14668743,846
"19937","WBGene00044217","X",14436751,14437656,905
"19938","WBGene00044218","V",12373663,12374231,568
"19939","WBGene00044219","V",15588913,15589830,917
"19940","WBGene00044220","V",16924985,16926125,1140
"19941","WBGene00044221","II",6768263,6768953,690
"19942","WBGene00044222","III",10055604,10056133,529
"19943","WBGene00044224","III",4741818,4742737,919
"19944","WBGene00044225","III",4782505,4782805,300
"19945","WBGene00044226","III",10140458,10140754,296
"19946","WBGene00044227","III",9679698,9681269,1571
"19947","WBGene00044228","III",13365425,13367747,2322
"19948","WBGene00044229","III",13361299,13364765,3466
"19949","WBGene00044230","III",3988059,3988575,516
"19950","WBGene00044232","III",11804547,11806795,2248
"19951","WBGene00044233","III",11929358,11933639,4281
"19952","WBGene00044235","II",10564891,10565401,510
"19953","WBGene00044237","I",13133638,13136156,2518
"19954","WBGene00044238","IV",17383370,17386783,3413
"19955","WBGene00044239","IV",8787459,8788057,598
"19956","WBGene00044240","IV",9975496,9976384,888
"19957","WBGene00044241","IV",9010584,9012339,1755
"19958","WBGene00044242","I",12456918,12457209,291
"19959","WBGene00044243","I",10158951,10160034,1083
"19960","WBGene00044244","IV",17264297,17264814,517
"19961","WBGene00044245","I",14838917,14839138,221
"19962","WBGene00044246","I",11268030,11268409,379
"19963","WBGene00044247","I",9249542,9250488,946
"19964","WBGene00044249","IV",14416489,14417201,712
"19965","WBGene00044250","I",11361090,11362900,1810
"19966","WBGene00044251","I",10520863,10521986,1123
"19967","WBGene00044253","IV",11827744,11828112,368
"19968","WBGene00044256","IV",13653955,13654524,569
"19969","WBGene00044257","IV",13776415,13777149,734
"19970","WBGene00044258","IV",14773598,14774634,1036
"19971","WBGene00044259","IV",15245955,15246371,416
"19972","WBGene00044260","I",13508785,13512026,3241
"19973","WBGene00044261","I",13528706,13531444,2738
"19974","WBGene00044262","I",10958297,10959906,1609
"19975","WBGene00044263","IV",15681381,15681545,164
"19976","WBGene00044264","I",14378386,14379425,1039
"19977","WBGene00044265","I",14620388,14620632,244
"19978","WBGene00044266","I",11144652,11145696,1044
"19979","WBGene00044268","IV",14531180,14531646,466
"19980","WBGene00044270","I",11719902,11722936,3034
"19981","WBGene00044271","V",14891082,14891186,104
"19982","WBGene00044272","V",14884585,14884880,295
"19983","WBGene00044275","V",14750353,14750457,104
"19984","WBGene00044276","V",9634484,9634564,80
"19985","WBGene00044277","I",2350841,2350945,104
"19986","WBGene00044278","V",16880994,16881336,342
"19987","WBGene00044279","V",3560271,3560508,237
"19988","WBGene00044280","IV",13347665,13348599,934
"19989","WBGene00044281","X",391360,394828,3468
"19990","WBGene00044282","V",4884790,4885420,630
"19991","WBGene00044283","X",7211705,7213956,2251
"19992","WBGene00044284","X",11490130,11490494,364
"19993","WBGene00044285","IV",12376869,12378050,1181
"19994","WBGene00044286","V",10651995,10654265,2270
"19995","WBGene00044287","II",6091820,6092789,969
"19996","WBGene00044288","III",488764,489452,688
"19997","WBGene00044289","I",10867554,10868530,976
"19998","WBGene00044290","IV",11320320,11320697,377
"19999","WBGene00044291","V",19405685,19406394,709
"20000","WBGene00044292","IV",3894058,3894430,372
"20001","WBGene00044293","IV",1723199,1724143,944
"20002","WBGene00044294","IV",6657981,6660434,2453
"20003","WBGene00044295","III",6518714,6520049,1335
"20004","WBGene00044296","II",5742971,5745284,2313
"20005","WBGene00044297","X",6610054,6615343,5289
"20006","WBGene00044298","II",4841374,4842211,837
"20007","WBGene00044299","X",5106260,5107039,779
"20008","WBGene00044300","II",7488242,7489661,1419
"20009","WBGene00044301","II",2625092,2627070,1978
"20010","WBGene00044302","IV",4594132,4596678,2546
"20011","WBGene00044303","X",2918730,2923984,5254
"20012","WBGene00044304","X",2892484,2898356,5872
"20013","WBGene00044305","I",5744148,5745617,1469
"20014","WBGene00044306","IV",6238192,6239437,1245
"20015","WBGene00044307","IV",6240306,6241389,1083
"20016","WBGene00044308","IV",6241855,6242795,940
"20017","WBGene00044309","IV",6243382,6244374,992
"20018","WBGene00044310","II",4351188,4353159,1971
"20019","WBGene00044311","III",6880947,6883853,2906
"20020","WBGene00044312","III",6870296,6871171,875
"20021","WBGene00044313","X",8740789,8743057,2268
"20022","WBGene00044314","II",3647411,3648599,1188
"20023","WBGene00044315","II",6749793,6751029,1236
"20024","WBGene00044316","II",6752352,6752950,598
"20025","WBGene00044317","II",6751624,6752127,503
"20026","WBGene00044318","III",640790,641625,835
"20027","WBGene00044319","III",638531,640226,1695
"20028","WBGene00044321","I",10636692,10638977,2285
"20029","WBGene00044322","II",12460641,12461471,830
"20030","WBGene00044323","II",12459772,12460551,779
"20031","WBGene00044324","III",7858979,7859512,533
"20032","WBGene00044325","IV",7782599,7783851,1252
"20033","WBGene00044326","IV",7783970,7785556,1586
"20034","WBGene00044329","IV",12092322,12093472,1150
"20035","WBGene00044330","X",11121916,11125615,3699
"20036","WBGene00044331","V",16843241,16844696,1455
"20037","WBGene00044332","V",16846867,16848466,1599
"20038","WBGene00044333","II",14576957,14578075,1118
"20039","WBGene00044338","X",8537108,8537458,350
"20040","WBGene00044339","X",8537956,8538374,418
"20041","WBGene00044340","X",8538740,8539090,350
"20042","WBGene00044341","III",1495434,1496027,593
"20043","WBGene00044342","V",7731839,7733495,1656
"20044","WBGene00044343","IV",3969931,3972616,2685
"20045","WBGene00044344","V",1821579,1823096,1517
"20046","WBGene00044345","I",47467,49857,2390
"20047","WBGene00044346","IV",5223237,5224172,935
"20048","WBGene00044347","I",1818581,1822948,4367
"20049","WBGene00044348","I",1686216,1693457,7241
"20050","WBGene00044349","I",1813909,1816061,2152
"20051","WBGene00044350","IV",6493599,6497378,3779
"20052","WBGene00044352","IV",6968209,6970280,2071
"20053","WBGene00044353","III",7088644,7090132,1488
"20054","WBGene00044354","III",7100482,7102033,1551
"20055","WBGene00044355","X",3380480,3382838,2358
"20056","WBGene00044356","V",8311510,8312041,531
"20057","WBGene00044358","I",1657513,1663331,5818
"20058","WBGene00044359","II",1864578,1864884,306
"20059","WBGene00044360","II",2163341,2163832,491
"20060","WBGene00044361","II",2280046,2280580,534
"20061","WBGene00044362","II",2418448,2419025,577
"20062","WBGene00044363","II",2635360,2637608,2248
"20063","WBGene00044364","II",2687625,2687888,263
"20064","WBGene00044365","II",2688916,2689179,263
"20065","WBGene00044366","II",2689909,2690180,271
"20066","WBGene00044367","II",2736678,2737556,878
"20067","WBGene00044368","II",2822874,2823059,185
"20068","WBGene00044369","II",2933521,2934454,933
"20069","WBGene00044371","II",3206020,3206541,521
"20070","WBGene00044372","II",3206939,3207388,449
"20071","WBGene00044373","II",3237471,3238179,708
"20072","WBGene00044374","II",3243676,3244162,486
"20073","WBGene00044375","II",3290486,3290644,158
"20074","WBGene00044376","II",3472075,3472430,355
"20075","WBGene00044377","II",3471239,3471703,464
"20076","WBGene00044379","II",3687791,3688691,900
"20077","WBGene00044380","II",3759581,3760036,455
"20078","WBGene00044381","II",3987281,3988185,904
"20079","WBGene00044382","II",3988700,3989677,977
"20080","WBGene00044383","II",4663837,4665445,1608
"20081","WBGene00044384","II",4863713,4865780,2067
"20082","WBGene00044385","II",5003960,5004849,889
"20083","WBGene00044386","II",5069764,5071365,1601
"20084","WBGene00044387","II",5067088,5067980,892
"20085","WBGene00044388","II",5159717,5161130,1413
"20086","WBGene00044389","II",5177298,5178007,709
"20087","WBGene00044390","II",5522937,5523488,551
"20088","WBGene00044391","II",5665408,5666278,870
"20089","WBGene00044392","II",5666291,5666850,559
"20090","WBGene00044393","II",5816573,5817306,733
"20091","WBGene00044394","II",5961677,5962024,347
"20092","WBGene00044395","II",6042797,6043266,469
"20093","WBGene00044396","II",7554092,7554844,752
"20094","WBGene00044397","X",12342289,12342597,308
"20095","WBGene00044398","X",12353550,12353768,218
"20096","WBGene00044399","III",13397761,13398437,676
"20097","WBGene00044401","III",453785,463811,10026
"20098","WBGene00044402","III",1328644,1330966,2322
"20099","WBGene00044403","III",2291419,2294124,2705
"20100","WBGene00044405","X",13410720,13411285,565
"20101","WBGene00044406","III",9074872,9075639,767
"20102","WBGene00044409","III",5045009,5045667,658
"20103","WBGene00044410","III",5448838,5449868,1030
"20104","WBGene00044411","III",5823957,5828651,4694
"20105","WBGene00044412","III",6065139,6066217,1078
"20106","WBGene00044413","I",10730467,10730743,276
"20107","WBGene00044414","I",6004599,6007595,2996
"20108","WBGene00044415","II",1625966,1626883,917
"20109","WBGene00044416","II",1627479,1627883,404
"20110","WBGene00044417","II",1783451,1784481,1030
"20111","WBGene00044418","II",756195,765317,9122
"20112","WBGene00044419","II",976208,978951,2743
"20113","WBGene00044420","II",99647,101061,1414
"20114","WBGene00044421","I",4578695,4579740,1045
"20115","WBGene00044423","I",3828239,3829308,1069
"20116","WBGene00044424","II",1377628,1378359,731
"20117","WBGene00044425","II",1393488,1394105,617
"20118","WBGene00044427","I",582288,583748,1460
"20119","WBGene00044428","II",171386,173779,2393
"20120","WBGene00044429","II",1588542,1589945,1403
"20121","WBGene00044430","II",1174005,1175657,1652
"20122","WBGene00044431","I",4957776,4958309,533
"20123","WBGene00044432","I",4969923,4972243,2320
"20124","WBGene00044433","I",2858524,2859913,1389
"20125","WBGene00044434","I",731068,736552,5484
"20126","WBGene00044435","I",2049140,2050177,1037
"20127","WBGene00044436","I",3603343,3604537,1194
"20128","WBGene00044437","I",3620582,3625087,4505
"20129","WBGene00044438","I",1958707,1965267,6560
"20130","WBGene00044439","II",1459140,1461307,2167
"20131","WBGene00044440","I",1610390,1620080,9690
"20132","WBGene00044441","I",4552851,4553121,270
"20133","WBGene00044442","X",7321999,7322415,416
"20134","WBGene00044443","III",8530077,8531123,1046
"20135","WBGene00044444","III",8270790,8272175,1385
"20136","WBGene00044445","III",8234526,8235543,1017
"20137","WBGene00044446","III",8004397,8005887,1490
"20138","WBGene00044447","III",7895752,7897025,1273
"20139","WBGene00044448","III",7648788,7650005,1217
"20140","WBGene00044449","III",7462267,7462466,199
"20141","WBGene00044450","III",7459258,7459493,235
"20142","WBGene00044451","III",7458815,7459031,216
"20143","WBGene00044452","III",6728155,6730170,2015
"20144","WBGene00044453","III",6735968,6736642,674
"20145","WBGene00044454","III",6579698,6579877,179
"20146","WBGene00044455","III",6495677,6498198,2521
"20147","WBGene00044457","IV",596864,598771,1907
"20148","WBGene00044458","IV",676075,676687,612
"20149","WBGene00044459","IV",719766,727481,7715
"20150","WBGene00044460","IV",717925,719451,1526
"20151","WBGene00044461","I",667615,674413,6798
"20152","WBGene00044462","IV",1103541,1104609,1068
"20153","WBGene00044463","IV",1219333,1221287,1954
"20154","WBGene00044464","IV",1485286,1489762,4476
"20155","WBGene00044466","IV",1969737,1970280,543
"20156","WBGene00044467","IV",2051500,2057079,5579
"20157","WBGene00044468","IV",2482255,2484218,1963
"20158","WBGene00044469","IV",3266404,3267677,1273
"20159","WBGene00044470","IV",3495296,3496440,1144
"20160","WBGene00044471","IV",3892998,3893283,285
"20161","WBGene00044472","IV",3895070,3895506,436
"20162","WBGene00044473","IV",3906113,3906493,380
"20163","WBGene00044474","IV",3908107,3908509,402
"20164","WBGene00044475","IV",3909381,3909799,418
"20165","WBGene00044476","IV",3917679,3918056,377
"20166","WBGene00044477","IV",4110544,4112487,1943
"20167","WBGene00044478","IV",4196173,4196695,522
"20168","WBGene00044479","IV",4292869,4293611,742
"20169","WBGene00044480","IV",4531222,4533121,1899
"20170","WBGene00044481","IV",4541769,4545918,4149
"20171","WBGene00044482","IV",4669529,4671992,2463
"20172","WBGene00044483","IV",4806697,4807319,622
"20173","WBGene00044484","IV",5040859,5045485,4626
"20174","WBGene00044485","IV",2751868,2753461,1593
"20175","WBGene00044486","IV",2779111,2780666,1555
"20176","WBGene00044487","IV",2801902,2803240,1338
"20177","WBGene00044488","IV",2805839,2809504,3665
"20178","WBGene00044489","IV",2832877,2833480,603
"20179","WBGene00044490","IV",2834816,2835357,541
"20180","WBGene00044491","IV",2831477,2832687,1210
"20181","WBGene00044492","IV",2851691,2854293,2602
"20182","WBGene00044493","IV",2918441,2919780,1339
"20183","WBGene00044495","IV",2846476,2851282,4806
"20184","WBGene00044499","IV",5482961,5483622,661
"20185","WBGene00044500","IV",5667525,5669583,2058
"20186","WBGene00044501","IV",5691030,5694646,3616
"20187","WBGene00044502","IV",6010352,6011645,1293
"20188","WBGene00044503","IV",6704925,6707052,2127
"20189","WBGene00044504","IV",7225416,7227172,1756
"20190","WBGene00044505","IV",7251541,7252428,887
"20191","WBGene00044508","IV",8083961,8086652,2691
"20192","WBGene00044509","IV",8275621,8276709,1088
"20193","WBGene00044510","IV",8273226,8275332,2106
"20194","WBGene00044511","IV",8596067,8596943,876
"20195","WBGene00044512","V",137177,141370,4193
"20196","WBGene00044513","V",271984,272937,953
"20197","WBGene00044514","V",777571,778235,664
"20198","WBGene00044515","V",1054602,1055773,1171
"20199","WBGene00044516","V",1919322,1920205,883
"20200","WBGene00044517","V",1913627,1917986,4359
"20201","WBGene00044518","V",1957417,1957932,515
"20202","WBGene00044519","V",2013418,2013860,442
"20203","WBGene00044520","V",2030177,2030407,230
"20204","WBGene00044521","V",2272441,2274353,1912
"20205","WBGene00044523","V",2889302,2890029,727
"20206","WBGene00044524","V",3125212,3125469,257
"20207","WBGene00044525","V",3197268,3198333,1065
"20208","WBGene00044526","V",3257577,3258289,712
"20209","WBGene00044527","V",3668728,3670631,1903
"20210","WBGene00044528","V",4139008,4143120,4112
"20211","WBGene00044529","V",4336762,4338925,2163
"20212","WBGene00044530","V",4365447,4366483,1036
"20213","WBGene00044531","V",4386808,4387502,694
"20214","WBGene00044533","V",4648832,4650726,1894
"20215","WBGene00044534","V",4913061,4915079,2018
"20216","WBGene00044535","V",5033398,5034171,773
"20217","WBGene00044536","V",5130318,5131538,1220
"20218","WBGene00044537","V",5240203,5240451,248
"20219","WBGene00044538","V",5365163,5366792,1629
"20220","WBGene00044539","V",5714760,5716581,1821
"20221","WBGene00044541","V",5754670,5754949,279
"20222","WBGene00044542","V",5585182,5591603,6421
"20223","WBGene00044543","V",5756493,5756657,164
"20224","WBGene00044544","V",5854848,5856414,1566
"20225","WBGene00044545","V",6576867,6577541,674
"20226","WBGene00044546","V",7129146,7129560,414
"20227","WBGene00044547","V",7259265,7260157,892
"20228","WBGene00044548","V",7399904,7400199,295
"20229","WBGene00044549","V",7612344,7615648,3304
"20230","WBGene00044550","V",7618414,7620349,1935
"20231","WBGene00044551","V",7724494,7726110,1616
"20232","WBGene00044552","V",8005326,8005692,366
"20233","WBGene00044553","V",8455396,8457606,2210
"20234","WBGene00044554","V",8602084,8602825,741
"20235","WBGene00044556","X",476561,478283,1722
"20236","WBGene00044557","X",899508,902599,3091
"20237","WBGene00044558","X",1381375,1381665,290
"20238","WBGene00044559","X",1647991,1649237,1246
"20239","WBGene00044560","X",1690039,1691512,1473
"20240","WBGene00044561","X",1748403,1748576,173
"20241","WBGene00044562","X",1816361,1816762,401
"20242","WBGene00044563","X",1860722,1863543,2821
"20243","WBGene00044564","X",3424816,3427337,2521
"20244","WBGene00044566","X",4078236,4081045,2809
"20245","WBGene00044567","X",4644404,4647192,2788
"20246","WBGene00044568","X",4866075,4866690,615
"20247","WBGene00044569","X",5448241,5450010,1769
"20248","WBGene00044570","X",5631869,5638096,6227
"20249","WBGene00044571","X",5935780,5937549,1769
"20250","WBGene00044572","X",6388255,6391591,3336
"20251","WBGene00044573","X",6468799,6469990,1191
"20252","WBGene00044574","X",6601558,6603212,1654
"20253","WBGene00044575","X",6680901,6682783,1882
"20254","WBGene00044578","X",8610906,8611344,438
"20255","WBGene00044579","X",8861258,8861650,392
"20256","WBGene00044580","X",9009780,9010457,677
"20257","WBGene00044581","X",9180062,9180923,861
"20258","WBGene00044582","V",9165820,9168041,2221
"20259","WBGene00044583","X",1714351,1715487,1136
"20260","WBGene00044584","X",5183828,5186623,2795
"20261","WBGene00044585","X",11775729,11776574,845
"20262","WBGene00044586","V",4553872,4554498,626
"20263","WBGene00044587","IV",16325172,16326601,1429
"20264","WBGene00044588","III",8432469,8435174,2705
"20265","WBGene00044589","II",6306429,6308073,1644
"20266","WBGene00044602","V",2930053,2931170,1117
"20267","WBGene00044603","III",4840187,4841024,837
"20268","WBGene00044604","III",5158873,5159605,732
"20269","WBGene00044605","X",6510929,6512195,1266
"20270","WBGene00044606","IV",10549215,10549501,286
"20271","WBGene00044607","I",9748517,9749953,1436
"20272","WBGene00044608","IV",8200604,8201233,629
"20273","WBGene00044609","III",2788441,2792973,4532
"20274","WBGene00044610","I",6627045,6627914,869
"20275","WBGene00044611","I",6104805,6105589,784
"20276","WBGene00044612","V",7063703,7065322,1619
"20277","WBGene00044614","I",8730156,8730922,766
"20278","WBGene00044615","II",6916110,6916963,853
"20279","WBGene00044616","I",5643310,5644057,747
"20280","WBGene00044617","V",9022361,9024806,2445
"20281","WBGene00044618","IV",1699899,1702820,2921
"20282","WBGene00044620","IV",4688269,4691936,3667
"20283","WBGene00044623","X",5493348,5496000,2652
"20284","WBGene00044630","X",15757868,15766354,8486
"20285","WBGene00044631","V",11773720,11776631,2911
"20286","WBGene00044632","IV",15521488,15522118,630
"20287","WBGene00044633","III",7969319,7970283,964
"20288","WBGene00044634","III",7920123,7921059,936
"20289","WBGene00044636","III",4778390,4780157,1767
"20290","WBGene00044637","V",4438932,4443223,4291
"20291","WBGene00044638","X",16213373,16213599,226
"20292","WBGene00044639","II",433659,435406,1747
"20293","WBGene00044640","II",264353,266077,1724
"20294","WBGene00044641","II",179261,192078,12817
"20295","WBGene00044642","IV",3929650,3931654,2004
"20296","WBGene00044643","II",1472625,1473581,956
"20297","WBGene00044644","I",10727755,10728808,1053
"20298","WBGene00044645","II",1519222,1520328,1106
"20299","WBGene00044646","I",10726903,10727364,461
"20300","WBGene00044648","III",5023264,5024064,800
"20301","WBGene00044649","IV",2091929,2099890,7961
"20302","WBGene00044650","IV",2199041,2209051,10010
"20303","WBGene00044651","IV",2680098,2688808,8710
"20304","WBGene00044653","V",16266765,16267762,997
"20305","WBGene00044654","V",17259173,17260534,1361
"20306","WBGene00044655","V",19777247,19778708,1461
"20307","WBGene00044657","V",17291326,17291715,389
"20308","WBGene00044658","V",15090757,15091062,305
"20309","WBGene00044659","V",16129409,16130979,1570
"20310","WBGene00044660","V",16128131,16129089,958
"20311","WBGene00044661","V",16125811,16127497,1686
"20312","WBGene00044662","II",4772835,4773991,1156
"20313","WBGene00044663","II",4774382,4774883,501
"20314","WBGene00044664","II",4998007,4998757,750
"20315","WBGene00044665","II",5011523,5012078,555
"20316","WBGene00044666","II",5040208,5040681,473
"20317","WBGene00044667","II",5289442,5290326,884
"20318","WBGene00044668","II",5731033,5731741,708
"20319","WBGene00044670","IV",16311079,16319703,8624
"20320","WBGene00044672","II",2414119,2415531,1412
"20321","WBGene00044673","II",7379177,7379612,435
"20322","WBGene00044674","III",7135024,7136149,1125
"20323","WBGene00044675","III",1247618,1249153,1535
"20324","WBGene00044676","III",2260004,2261445,1441
"20325","WBGene00044677","III",8389882,8394424,4542
"20326","WBGene00044678","III",8705109,8706345,1236
"20327","WBGene00044679","I",8520901,8521915,1014
"20328","WBGene00044680","I",9478470,9479091,621
"20329","WBGene00044681","III",874301,875413,1112
"20330","WBGene00044683","X",17438619,17439751,1132
"20331","WBGene00044684","I",8919329,8920516,1187
"20332","WBGene00044686","X",10087314,10087958,644
"20333","WBGene00044687","X",9168539,9169022,483
"20334","WBGene00044689","V",186169,200777,14608
"20335","WBGene00044690","IV",3806703,3807190,487
"20336","WBGene00044691","IV",3992682,3993412,730
"20337","WBGene00044692","II",3749061,3750785,1724
"20338","WBGene00044693","II",3746474,3747459,985
"20339","WBGene00044694","II",3747679,3748819,1140
"20340","WBGene00044695","II",1646597,1647568,971
"20341","WBGene00044696","V",8383922,8384867,945
"20342","WBGene00044697","II",1540928,1542718,1790
"20343","WBGene00044698","X",7719272,7725583,6311
"20344","WBGene00044699","V",7089498,7091601,2103
"20345","WBGene00044700","X",159638,160920,1282
"20346","WBGene00044701","X",2263176,2267472,4296
"20347","WBGene00044702","X",11436124,11437747,1623
"20348","WBGene00044703","X",11434792,11435899,1107
"20349","WBGene00044705","V",3589029,3592199,3170
"20350","WBGene00044706","I",13073837,13075124,1287
"20351","WBGene00044707","I",13143201,13144588,1387
"20352","WBGene00044708","I",13124081,13126650,2569
"20353","WBGene00044709","I",13107492,13109778,2286
"20354","WBGene00044710","I",13075122,13075381,259
"20355","WBGene00044711","I",13107140,13107457,317
"20356","WBGene00044712","I",13144912,13146453,1541
"20357","WBGene00044713","I",13210585,13211352,767
"20358","WBGene00044714","I",13211826,13213806,1980
"20359","WBGene00044716","I",13221859,13221978,119
"20360","WBGene00044718","V",3401645,3402356,711
"20361","WBGene00044719","IV",1515510,1516627,1117
"20362","WBGene00044720","II",14969902,14971233,1331
"20363","WBGene00044722","I",13127152,13127876,724
"20364","WBGene00044723","IV",668962,670555,1593
"20365","WBGene00044724","X",4101687,4102125,438
"20366","WBGene00044725","X",3656272,3657265,993
"20367","WBGene00044726","II",14988471,14992667,4196
"20368","WBGene00044727","II",15001666,15001818,152
"20369","WBGene00044728","II",15042805,15044011,1206
"20370","WBGene00044729","II",15117686,15117963,277
"20371","WBGene00044732","X",5168739,5171119,2380
"20372","WBGene00044733","II",584798,586241,1443
"20373","WBGene00044736","IV",203322,205262,1940
"20374","WBGene00044737","IV",13254225,13255538,1313
"20375","WBGene00044738","V",7603806,7609946,6140
"20376","WBGene00044739","III",9175077,9175221,144
"20377","WBGene00044741","IV",14854003,14854426,423
"20378","WBGene00044742","IV",832362,833329,967
"20379","WBGene00044743","X",9211144,9212321,1177
"20380","WBGene00044744","II",4689777,4690484,707
"20381","WBGene00044745","IV",13383905,13386091,2186
"20382","WBGene00044746","I",1832115,1832641,526
"20383","WBGene00044748","X",1405499,1405522,23
"20384","WBGene00044751","II",3328359,3328381,22
"20385","WBGene00044752","IV",6421036,6421200,164
"20386","WBGene00044753","X",2065038,2066567,1529
"20387","WBGene00044754","I",4520070,4522768,2698
"20388","WBGene00044755","II",6335478,6336334,856
"20389","WBGene00044756","II",6386767,6387568,801
"20390","WBGene00044757","IV",855673,856846,1173
"20391","WBGene00044758","V",18129171,18131125,1954
"20392","WBGene00044759","V",15398939,15399791,852
"20393","WBGene00044760","III",2802450,2803681,1231
"20394","WBGene00044761","III",1401946,1403460,1514
"20395","WBGene00044762","III",7883574,7884963,1389
"20396","WBGene00044763","III",7912698,7913600,902
"20397","WBGene00044764","I",7050042,7051712,1670
"20398","WBGene00044767","II",4850185,4851441,1256
"20399","WBGene00044768","IV",11834390,11836020,1630
"20400","WBGene00044769","I",9407174,9408282,1108
"20401","WBGene00044770","X",17334052,17336169,2117
"20402","WBGene00044771","X",17650178,17651594,1416
"20403","WBGene00044772","X",17680873,17682294,1421
"20404","WBGene00044773","X",17081128,17082042,914
"20405","WBGene00044774","V",1315643,1317919,2276
"20406","WBGene00044775","II",7523581,7524421,840
"20407","WBGene00044776","V",877530,878667,1137
"20408","WBGene00044777","V",876245,877265,1020
"20409","WBGene00044778","V",839421,839934,513
"20410","WBGene00044779","V",6652353,6653742,1389
"20411","WBGene00044780","X",8578585,8580104,1519
"20412","WBGene00044781","I",11235385,11235594,209
"20413","WBGene00044783","V",15443401,15443808,407
"20414","WBGene00044784","IV",11020498,11021438,940
"20415","WBGene00044786","I",13237054,13238302,1248
"20416","WBGene00044787","V",12434361,12436952,2591
"20417","WBGene00044788","X",9312648,9314488,1840
"20418","WBGene00044789","IV",386699,387949,1250
"20419","WBGene00044790","V",12177088,12179438,2350
"20420","WBGene00044791","V",12275625,12277046,1421
"20421","WBGene00044792","I",10526533,10530095,3562
"20422","WBGene00044795","V",17919037,17921734,2697
"20423","WBGene00044796","I",2818744,2820701,1957
"20424","WBGene00044797","IV",10881549,10882523,974
"20425","WBGene00044798","III",1765458,1770091,4633
"20426","WBGene00044799","III",7771591,7772559,968
"20427","WBGene00044800","V",13527600,13528531,931
"20428","WBGene00044803","V",5881052,5882450,1398
"20429","WBGene00044804","II",9845557,9847311,1754
"20430","WBGene00044805","I",11971179,11971797,618
"20431","WBGene00044806","II",9470521,9471924,1403
"20432","WBGene00044807","II",9469119,9470082,963
"20433","WBGene00044808","III",10684731,10685225,494
"20434","WBGene00044810","I",2107457,2108896,1439
"20435","WBGene00044811","II",3742465,3743819,1354
"20436","WBGene00044889","II",3151332,3151784,452
"20437","WBGene00044891","III",10331551,10332480,929
"20438","WBGene00044892","V",18773061,18774024,963
"20439","WBGene00044894","I",2981531,2983076,1545
"20440","WBGene00044895","I",1088514,1089742,1228
"20441","WBGene00044896","I",1332698,1334074,1376
"20442","WBGene00044897","I",1851681,1852280,599
"20443","WBGene00044898","I",6862397,6870424,8027
"20444","WBGene00044900","V",1442588,1442876,288
"20445","WBGene00044901","X",2945803,2946570,767
"20446","WBGene00044903","III",9947788,9950344,2556
"20447","WBGene00044905","I",12659729,12660647,918
"20448","WBGene00044906","IV",14339968,14342112,2144
"20449","WBGene00044907","IV",12561367,12563543,2176
"20450","WBGene00044908","IV",1241332,1243402,2070
"20451","WBGene00044909","IV",13206783,13207278,495
"20452","WBGene00044911","III",4320389,4321348,959
"20453","WBGene00044912","III",4321748,4322867,1119
"20454","WBGene00044914","IV",8850865,8851127,262
"20455","WBGene00044916","II",11130690,11132648,1958
"20456","WBGene00044917","II",11130275,11130698,423
"20457","WBGene00044920","V",13758090,13759945,1855
"20458","WBGene00044921","V",13778015,13778592,577
"20459","WBGene00044922","IV",10277264,10277918,654
"20460","WBGene00044923","V",9090876,9091039,163
"20461","WBGene00044924","II",10855642,10857177,1535
"20462","WBGene00044925","I",2085037,2085155,118
"20463","WBGene00044927","I",2688947,2689069,122
"20464","WBGene00044928","I",2935785,2935920,135
"20465","WBGene00044929","I",4175997,4176064,67
"20466","WBGene00044931","I",2070256,2070394,138
"20467","WBGene00044932","I",2069884,2070023,139
"20468","WBGene00044933","I",6082738,6082805,67
"20469","WBGene00044934","I",6105679,6105754,75
"20470","WBGene00044936","II",6248717,6248855,138
"20471","WBGene00044937","II",4942395,4942519,124
"20472","WBGene00044938","II",7184010,7184078,68
"20473","WBGene00044939","III",794742,794867,125
"20474","WBGene00044940","III",3068806,3068883,77
"20475","WBGene00044941","III",5679378,5679509,131
"20476","WBGene00044942","III",5679745,5679875,130
"20477","WBGene00044943","III",7209019,7209149,130
"20478","WBGene00044944","III",7209400,7209530,130
"20479","WBGene00044945","III",7496577,7496654,77
"20480","WBGene00044946","III",7706862,7707011,149
"20481","WBGene00044947","IV",7574122,7574191,69
"20482","WBGene00044948","IV",653902,654030,128
"20483","WBGene00044949","X",10371077,10372664,1587
"20484","WBGene00044951","II",15277890,15278575,685
"20485","WBGene00044952","IV",4390088,4390308,220
"20486","WBGene00044953","IV",8357938,8358592,654
"20487","WBGene00044954","IV",8378820,8378941,121
"20488","WBGene00044955","V",8222281,8222449,168
"20489","WBGene00044956","V",8222779,8222973,194
"20490","WBGene00044957","V",8349108,8349187,79
"20491","WBGene00044958","V",8500579,8500645,66
"20492","WBGene00044960","V",17562221,17563115,894
"20493","WBGene00044961","V",14361928,14362035,107
"20494","WBGene00044962","IV",12390526,12390655,129
"20495","WBGene00044963","V",10352710,10352836,126
"20496","WBGene00044964","I",7091584,7091718,134
"20497","WBGene00044965","V",14097435,14097517,82
"20498","WBGene00044966","IV",14864744,14864823,79
"20499","WBGene00044967","IV",13602202,13602278,76
"20500","WBGene00044971","V",14409973,14410068,95
"20501","WBGene00044972","V",13722930,13723023,93
"20502","WBGene00044973","II",13834887,13834954,67
"20503","WBGene00044974","V",9970204,9970271,67
"20504","WBGene00044975","I",14058839,14058910,71
"20505","WBGene00044976","V",19223853,19225074,1221
"20506","WBGene00044977","IV",10629431,10631245,1814
"20507","WBGene00044978","IV",13180179,13180911,732
"20508","WBGene00044979","IV",15056131,15057889,1758
"20509","WBGene00044980","V",19576046,19576076,30
"20510","WBGene00044981","II",9300311,9300335,24
"20511","WBGene00044982","I",13408674,13408697,23
"20512","WBGene00044983","IV",10051992,10052021,29
"20513","WBGene00044985","II",9028285,9028315,30
"20514","WBGene00044987","I",9581786,9582583,797
"20515","WBGene00044988","I",7053688,7054912,1224
"20516","WBGene00044989","IV",13964359,13979847,15488
"20517","WBGene00044990","IV",10764520,10765297,777
"20518","WBGene00044991","IV",10765441,10766067,626
"20519","WBGene00044995","IV",15715353,15716234,881
"20520","WBGene00044997","I",14993824,14993959,135
"20521","WBGene00044998","IV",15127491,15127794,303
"20522","WBGene00045000","IV",14974292,14974561,269
"20523","WBGene00045002","IV",10032972,10033155,183
"20524","WBGene00045003","IV",1252893,1253006,113
"20525","WBGene00045006","IV",14184855,14184975,120
"20526","WBGene00045007","IV",14189984,14190100,116
"20527","WBGene00045009","IV",11827397,11827558,161
"20528","WBGene00045012","IV",10144288,10144431,143
"20529","WBGene00045013","IV",17440642,17442125,1483
"20530","WBGene00045017","IV",11036166,11036265,99
"20531","WBGene00045018","IV",15176749,15177089,340
"20532","WBGene00045022","IV",10203729,10203964,235
"20533","WBGene00045024","IV",10596805,10600030,3225
"20534","WBGene00045027","IV",15800472,15800701,229
"20535","WBGene00045028","IV",16348409,16348751,342
"20536","WBGene00045029","IV",14803103,14803480,377
"20537","WBGene00045036","IV",12075744,12076950,1206
"20538","WBGene00045037","IV",1260207,1260519,312
"20539","WBGene00045038","IV",14635126,14636051,925
"20540","WBGene00045040","IV",16338562,16339098,536
"20541","WBGene00045043","IV",17137348,17142989,5641
"20542","WBGene00045045","IV",13598755,13600436,1681
"20543","WBGene00045046","IV",14233286,14233471,185
"20544","WBGene00045048","I",4589380,4589899,519
"20545","WBGene00045050","V",20310148,20311656,1508
"20546","WBGene00045051","IV",654229,654361,132
"20547","WBGene00045052","I",1337012,1338216,1204
"20548","WBGene00045053","I",1338749,1339773,1024
"20549","WBGene00045055","V",8228900,8228969,69
"20550","WBGene00045056","IV",11002119,11003801,1682
"20551","WBGene00045057","I",10309757,10311591,1834
"20552","WBGene00045058","I",13984308,13989588,5280
"20553","WBGene00045059","IV",13604969,13607263,2294
"20554","WBGene00045060","IV",14419711,14422038,2327
"20555","WBGene00045061","IV",14578262,14578700,438
"20556","WBGene00045062","IV",13456976,13458841,1865
"20557","WBGene00045063","IV",13934445,13964001,29556
"20558","WBGene00045065","IV",15194534,15195852,1318
"20559","WBGene00045066","IV",15004325,15005369,1044
"20560","WBGene00045067","IV",12792795,12793274,479
"20561","WBGene00045068","IV",13652423,13652935,512
"20562","WBGene00045069","IV",13649836,13650338,502
"20563","WBGene00045071","V",11314258,11314332,74
"20564","WBGene00045072","III",13303339,13303413,74
"20565","WBGene00045074","II",10545199,10545329,130
"20566","WBGene00045075","I",11646525,11647020,495
"20567","WBGene00045076","I",11647753,11648428,675
"20568","WBGene00045077","I",13997363,14007078,9715
"20569","WBGene00045078","IV",9194824,9196062,1238
"20570","WBGene00045082","I",5611663,5611817,154
"20571","WBGene00045083","II",5105157,5105231,74
"20572","WBGene00045085","IV",4389804,4389877,73
"20573","WBGene00045086","IV",7083872,7083930,58
"20574","WBGene00045087","I",4646726,4646779,53
"20575","WBGene00045088","II",219675,219791,116
"20576","WBGene00045089","III",5653866,5653968,102
"20577","WBGene00045090","II",7184419,7184492,73
"20578","WBGene00045091","II",7171842,7172004,162
"20579","WBGene00045092","III",3068486,3068562,76
"20580","WBGene00045093","I",2514168,2514311,143
"20581","WBGene00045094","I",4585249,4585409,160
"20582","WBGene00045095","II",7200233,7200418,185
"20583","WBGene00045096","IV",11738247,11738567,320
"20584","WBGene00045097","IV",16468723,16469064,341
"20585","WBGene00045098","IV",16462623,16462828,205
"20586","WBGene00045099","IV",14335194,14336491,1297
"20587","WBGene00045100","IV",16331365,16332611,1246
"20588","WBGene00045101","IV",16337021,16338502,1481
"20589","WBGene00045102","IV",14097658,14098015,357
"20590","WBGene00045103","I",12364718,12365948,1230
"20591","WBGene00045104","IV",10111721,10112028,307
"20592","WBGene00045105","IV",16293199,16293482,283
"20593","WBGene00045107","IV",16298813,16299012,199
"20594","WBGene00045108","IV",11801697,11803144,1447
"20595","WBGene00045109","IV",9511395,9511466,71
"20596","WBGene00045110","II",11876460,11876554,94
"20597","WBGene00045111","II",11876556,11876616,60
"20598","WBGene00045112","II",11876631,11876702,71
"20599","WBGene00045113","III",13303428,13303563,135
"20600","WBGene00045114","II",8547209,8547338,129
"20601","WBGene00045115","II",8091709,8091782,73
"20602","WBGene00045117","X",14477545,14477622,77
"20603","WBGene00045118","III",4689634,4689771,137
"20604","WBGene00045119","II",13834449,13834523,74
"20605","WBGene00045120","V",19643050,19643187,137
"20606","WBGene00045121","IV",9191261,9191333,72
"20607","WBGene00045122","IV",11413208,11415020,1812
"20608","WBGene00045123","II",14804502,14804559,57
"20609","WBGene00045124","III",9717380,9717458,78
"20610","WBGene00045125","II",8560691,8560772,81
"20611","WBGene00045127","II",11960898,11960959,61
"20612","WBGene00045128","IV",16930837,16931177,340
"20613","WBGene00045129","V",15190976,15191093,117
"20614","WBGene00045130","II",8602971,8603103,132
"20615","WBGene00045131","IV",12507409,12507566,157
"20616","WBGene00045132","III",8937767,8937897,130
"20617","WBGene00045133","X",14476867,14476946,79
"20618","WBGene00045134","V",10351733,10351862,129
"20619","WBGene00045136","IV",8927265,8927393,128
"20620","WBGene00045137","V",14362376,14362451,75
"20621","WBGene00045138","I",10569187,10569412,225
"20622","WBGene00045140","V",15873855,15873926,71
"20623","WBGene00045141","II",15025814,15025893,79
"20624","WBGene00045142","II",15165894,15166028,134
"20625","WBGene00045143","IV",16769758,16770320,562
"20626","WBGene00045144","IV",14239765,14241384,1619
"20627","WBGene00045146","IV",14950652,14954226,3574
"20628","WBGene00045147","II",9774764,9774834,70
"20629","WBGene00045148","II",10560717,10560934,217
"20630","WBGene00045149","III",10976663,10976746,83
"20631","WBGene00045150","I",8259437,8259498,61
"20632","WBGene00045151","V",10967490,10967616,126
"20633","WBGene00045152","II",10562952,10563064,112
"20634","WBGene00045153","IV",12086709,12086828,119
"20635","WBGene00045155","IV",17117927,17118020,93
"20636","WBGene00045156","I",8224474,8224544,70
"20637","WBGene00045157","II",8075509,8075643,134
"20638","WBGene00045158","X",14478464,14478527,63
"20639","WBGene00045159","V",14092572,14092651,79
"20640","WBGene00045162","I",10565266,10565443,177
"20641","WBGene00045163","IV",14326948,14327121,173
"20642","WBGene00045164","I",10516978,10517150,172
"20643","WBGene00045167","V",11585191,11585361,170
"20644","WBGene00045168","III",4369468,4369766,298
"20645","WBGene00045171","X",15619491,15619621,130
"20646","WBGene00045172","III",13769877,13769953,76
"20647","WBGene00045174","IV",14238549,14238614,65
"20648","WBGene00045175","IV",11468395,11468900,505
"20649","WBGene00045176","X",6867938,6868008,70
"20650","WBGene00045177","IV",287305,288127,822
"20651","WBGene00045178","IV",16630922,16631206,284
"20652","WBGene00045180","IV",9842371,9842992,621
"20653","WBGene00045183","IV",8818555,8819158,603
"20654","WBGene00045184","IV",12734262,12734895,633
"20655","WBGene00045185","IV",16454270,16454579,309
"20656","WBGene00045188","III",4373179,4375323,2144
"20657","WBGene00045190","III",7069103,7069580,477
"20658","WBGene00045192","I",8030959,8032886,1927
"20659","WBGene00045193","IV",12515688,12516609,921
"20660","WBGene00045194","IV",9511763,9511839,76
"20661","WBGene00045195","V",13588206,13588479,273
"20662","WBGene00045197","IV",11220727,11221755,1028
"20663","WBGene00045198","IV",12994676,12995924,1248
"20664","WBGene00045199","V",14096389,14096465,76
"20665","WBGene00045200","V",14094619,14094699,80
"20666","WBGene00045201","IV",13601636,13601725,89
"20667","WBGene00045202","IV",14281547,14282155,608
"20668","WBGene00045203","IV",13600847,13600925,78
"20669","WBGene00045204","IV",14863987,14864064,77
"20670","WBGene00045205","IV",6460683,6460764,81
"20671","WBGene00045207","IV",10891333,10892093,760
"20672","WBGene00045208","IV",10889471,10889878,407
"20673","WBGene00045209","IV",10887200,10887385,185
"20674","WBGene00045210","X",7846190,7847460,1270
"20675","WBGene00045211","III",11809118,11809561,443
"20676","WBGene00045212","I",5110075,5111154,1079
"20677","WBGene00045215","X",3672378,3673918,1540
"20678","WBGene00045218","I",11493036,11495080,2044
"20679","WBGene00045234","I",13077073,13077941,868
"20680","WBGene00045235","I",13077994,13078880,886
"20681","WBGene00045236","I",13079742,13080633,891
"20682","WBGene00045237","I",8660820,8663127,2307
"20683","WBGene00045238","I",13463955,13464207,252
"20684","WBGene00045239","III",12469169,12472541,3372
"20685","WBGene00045242","III",10004513,10004965,452
"20686","WBGene00045245","X",13139847,13140886,1039
"20687","WBGene00045246","III",7952623,7955816,3193
"20688","WBGene00045247","III",7966601,7969221,2620
"20689","WBGene00045248","IV",4490542,4495519,4977
"20690","WBGene00045249","IV",393156,393546,390
"20691","WBGene00045250","IV",6361968,6365407,3439
"20692","WBGene00045251","X",11847856,11848695,839
"20693","WBGene00045252","X",11907267,11910145,2878
"20694","WBGene00045253","X",11419108,11420074,966
"20695","WBGene00045254","I",12583786,12585119,1333
"20696","WBGene00045255","IV",1626973,1630756,3783
"20697","WBGene00045261","X",9310625,9311341,716
"20698","WBGene00045265","X",6436440,6437645,1205
"20699","WBGene00045268","X",2577742,2578262,520
"20700","WBGene00045269","X",5786493,5787353,860
"20701","WBGene00045270","X",360779,362938,2159
"20702","WBGene00045271","X",1737906,1739229,1323
"20703","WBGene00045272","X",16602445,16602717,272
"20704","WBGene00045273","X",17083162,17083742,580
"20705","WBGene00045275","V",7414941,7415344,403
"20706","WBGene00045276","V",7416116,7416628,512
"20707","WBGene00045277","V",7814615,7814886,271
"20708","WBGene00045278","IV",13858842,13859006,164
"20709","WBGene00045280","IV",17056746,17057831,1085
"20710","WBGene00045281","IV",16534437,16534576,139
"20711","WBGene00045282","IV",14655535,14655916,381
"20712","WBGene00045283","IV",12060397,12061329,932
"20713","WBGene00045286","IV",13611328,13611579,251
"20714","WBGene00045287","IV",13742550,13742985,435
"20715","WBGene00045289","II",13648530,13655347,6817
"20716","WBGene00045290","V",16943902,16944143,241
"20717","WBGene00045291","X",14413578,14415746,2168
"20718","WBGene00045292","X",14411418,14412855,1437
"20719","WBGene00045293","V",17547383,17549288,1905
"20720","WBGene00045294","IV",14153826,14154302,476
"20721","WBGene00045295","X",117388,119143,1755
"20722","WBGene00045297","II",4234950,4235982,1032
"20723","WBGene00045298","IV",905263,907044,1781
"20724","WBGene00045301","IV",892806,894586,1780
"20725","WBGene00045302","II",917624,919417,1793
"20726","WBGene00045304","II",3189338,3190954,1616
"20727","WBGene00045305","V",5812316,5813157,841
"20728","WBGene00045306","V",5805767,5807532,1765
"20729","WBGene00045308","V",4832011,4834377,2366
"20730","WBGene00045309","IV",9272582,9273639,1057
"20731","WBGene00045311","IV",14780940,14781266,326
"20732","WBGene00045313","IV",14527093,14527343,250
"20733","WBGene00045314","IV",12231310,12231631,321
"20734","WBGene00045315","IV",17022990,17023922,932
"20735","WBGene00045316","X",11962413,11962646,233
"20736","WBGene00045319","IV",11517186,11517620,434
"20737","WBGene00045321","IV",16758420,16758769,349
"20738","WBGene00045322","II",14713340,14718225,4885
"20739","WBGene00045323","IV",8873820,8874007,187
"20740","WBGene00045324","X",11294708,11294797,89
"20741","WBGene00045325","IV",16740693,16740789,96
"20742","WBGene00045326","IV",17309307,17309403,96
"20743","WBGene00045327","X",13857962,13858053,91
"20744","WBGene00045328","I",12595690,12595773,83
"20745","WBGene00045329","I",12594569,12594657,88
"20746","WBGene00045330","IV",14277312,14277387,75
"20747","WBGene00045331","V",14300014,14300561,547
"20748","WBGene00045332","V",14307210,14307410,200
"20749","WBGene00045336","V",12724562,12725993,1431
"20750","WBGene00045337","V",15263005,15264231,1226
"20751","WBGene00045338","V",15264653,15265786,1133
"20752","WBGene00045339","V",15266436,15267505,1069
"20753","WBGene00045340","V",13474228,13476382,2154
"20754","WBGene00045342","X",3004668,3004761,93
"20755","WBGene00045343","X",7882751,7882840,89
"20756","WBGene00045344","V",19710871,19711742,871
"20757","WBGene00045345","V",19711999,19712872,873
"20758","WBGene00045346","V",17892426,17892706,280
"20759","WBGene00045348","V",18156524,18156811,287
"20760","WBGene00045350","X",8485294,8485371,77
"20761","WBGene00045351","IV",5566422,5566491,69
"20762","WBGene00045353","V",3042092,3042181,89
"20763","WBGene00045354","X",1798928,1799016,88
"20764","WBGene00045355","V",14067819,14071215,3396
"20765","WBGene00045356","V",16598989,16600723,1734
"20766","WBGene00045357","V",16401891,16405325,3434
"20767","WBGene00045359","X",8600643,8600735,92
"20768","WBGene00045360","X",380919,380991,72
"20769","WBGene00045361","V",18751265,18752299,1034
"20770","WBGene00045362","V",18749579,18750199,620
"20771","WBGene00045363","V",18742427,18745266,2839
"20772","WBGene00045364","V",18738955,18742208,3253
"20773","WBGene00045365","X",5014040,5015452,1412
"20774","WBGene00045366","V",18720589,18723771,3182
"20775","WBGene00045367","V",10966698,10966915,217
"20776","WBGene00045368","III",9226850,9226974,124
"20777","WBGene00045370","I",8245547,8245622,75
"20778","WBGene00045371","X",14477196,14477267,71
"20779","WBGene00045372","II",14801350,14801427,77
"20780","WBGene00045373","II",12738002,12738143,141
"20781","WBGene00045374","III",4757947,4758087,140
"20782","WBGene00045375","I",11609315,11609445,130
"20783","WBGene00045376","I",9176327,9176453,126
"20784","WBGene00045377","II",14617143,14617210,67
"20785","WBGene00045378","III",10432343,10432476,133
"20786","WBGene00045379","V",11044067,11045734,1667
"20787","WBGene00045380","V",16654542,16657432,2890
"20788","WBGene00045381","V",17061889,17063095,1206
"20789","WBGene00045382","V",17068627,17069533,906
"20790","WBGene00045385","X",12068550,12070563,2013
"20791","WBGene00045386","X",12662478,12663627,1149
"20792","WBGene00045387","I",3138541,3140601,2060
"20793","WBGene00045388","II",14635795,14636093,298
"20794","WBGene00045389","II",12953683,12953856,173
"20795","WBGene00045390","V",1494769,1495453,684
"20796","WBGene00045391","IV",13709270,13709428,158
"20797","WBGene00045392","V",7954793,7955363,570
"20798","WBGene00045393","V",7953354,7954652,1298
"20799","WBGene00045394","X",3444802,3445283,481
"20800","WBGene00045395","X",4117951,4119487,1536
"20801","WBGene00045396","I",14028997,14029212,215
"20802","WBGene00045397","IV",2797061,2798573,1512
"20803","WBGene00045398","I",2940910,2941583,673
"20804","WBGene00045399","I",3564040,3565068,1028
"20805","WBGene00045400","V",12431368,12432289,921
"20806","WBGene00045401","V",13979571,13980907,1336
"20807","WBGene00045402","V",15193734,15194009,275
"20808","WBGene00045403","II",14505015,14506409,1394
"20809","WBGene00045404","II",9378557,9379596,1039
"20810","WBGene00045405","V",14085889,14087169,1280
"20811","WBGene00045406","V",14088351,14088704,353
"20812","WBGene00045407","II",8883763,8884418,655
"20813","WBGene00045408","V",17324907,17326168,1261
"20814","WBGene00045410","II",13477471,13478929,1458
"20815","WBGene00045411","V",19432441,19433072,631
"20816","WBGene00045412","V",19402296,19402955,659
"20817","WBGene00045413","V",19397828,19398982,1154
"20818","WBGene00045414","II",9479641,9480106,465
"20819","WBGene00045415","V",19460818,19462102,1284
"20820","WBGene00045416","V",18143716,18144720,1004
"20821","WBGene00045417","V",18142849,18143543,694
"20822","WBGene00045418","V",13006981,13008925,1944
"20823","WBGene00045419","V",9846158,9859963,13805
"20824","WBGene00045433","I",10926883,10933705,6822
"20825","WBGene00045434","I",10940685,10943922,3237
"20826","WBGene00045455","II",4777142,4778104,962
"20827","WBGene00045456","X",7420871,7422628,1757
"20828","WBGene00045457","II",2586078,2586911,833
"20829","WBGene00045458","I",13190578,13191921,1343
"20830","WBGene00045459","V",18010017,18010837,820
"20831","WBGene00045460","V",12751603,12752507,904
"20832","WBGene00045461","V",19436484,19437217,733
"20833","WBGene00045468","I",12953969,12955322,1353
"20834","WBGene00045473","I",9476597,9477181,584
"20835","WBGene00045474","I",12562756,12564210,1454
"20836","WBGene00045475","III",10306756,10311100,4344
"20837","WBGene00045480","X",10528002,10529264,1262
"20838","WBGene00045481","X",12144114,12145940,1826
"20839","WBGene00045482","III",13368087,13371072,2985
"20840","WBGene00045483","I",5760897,5762435,1538
"20841","WBGene00045484","III",3726683,3729570,2887
"20842","WBGene00045486","II",1545925,1546991,1066
"20843","WBGene00045487","V",18344749,18345088,339
"20844","WBGene00045488","V",13196088,13197923,1835
"20845","WBGene00045490","V",14309932,14310318,386
"20846","WBGene00045492","V",17109684,17110448,764
"20847","WBGene00045493","X",11928107,11929372,1265
"20848","WBGene00045494","X",15718625,15720415,1790
"20849","WBGene00045495","X",12989344,12991381,2037
"20850","WBGene00045496","V",18358035,18359555,1520
"20851","WBGene00045497","X",13055860,13058381,2521
"20852","WBGene00045498","I",6149197,6150480,1283
"20853","WBGene00045500","V",17080492,17082818,2326
"20854","WBGene00045501","V",17620566,17622750,2184
"20855","WBGene00045502","V",17016175,17016446,271
"20856","WBGene00045506","V",17628866,17630215,1349
"20857","WBGene00045507","V",16158679,16159694,1015
"20858","WBGene00045508","I",8469922,8471852,1930
"20859","WBGene00045509","I",12596530,12598916,2386
"20860","WBGene00045510","V",16202030,16202740,710
"20861","WBGene00045511","V",16202809,16204862,2053
"20862","WBGene00045513","V",16062661,16062888,227
"20863","WBGene00045514","V",15310120,15310437,317
"20864","WBGene00045515","V",15318961,15320553,1592
"20865","WBGene00045516","V",14638805,14639627,822
"20866","WBGene00045517","V",12727171,12727621,450
"20867","WBGene00045518","IV",5723096,5723116,20
"20868","WBGene00045521","IV",16545939,16545959,20
"20869","WBGene00045522","IV",14284757,14284777,20
"20870","WBGene00045525","IV",14087254,14087274,20
"20871","WBGene00045529","IV",13689238,13689258,20
"20872","WBGene00045532","IV",5101205,5101225,20
"20873","WBGene00045535","IV",14055385,14055405,20
"20874","WBGene00045537","IV",5759813,5759833,20
"20875","WBGene00045538","IV",16661836,16661856,20
"20876","WBGene00045541","IV",16346305,16346325,20
"20877","WBGene00045544","IV",6188675,6188695,20
"20878","WBGene00045548","IV",16717897,16717917,20
"20879","WBGene00045549","IV",6992052,6992072,20
"20880","WBGene00045551","IV",15583334,15583354,20
"20881","WBGene00045555","IV",16203925,16203945,20
"20882","WBGene00045557","IV",15655850,15655870,20
"20883","WBGene00045560","IV",14509444,14509464,20
"20884","WBGene00045561","IV",14159840,14159860,20
"20885","WBGene00045562","IV",15907905,15907925,20
"20886","WBGene00045564","IV",14432370,14432390,20
"20887","WBGene00045568","IV",14122587,14122607,20
"20888","WBGene00045572","IV",14979662,14979682,20
"20889","WBGene00045583","IV",14878399,14878419,20
"20890","WBGene00045585","IV",13839712,13839732,20
"20891","WBGene00045589","IV",14893381,14893401,20
"20892","WBGene00045590","IV",15248660,15248680,20
"20893","WBGene00045592","IV",5336132,5336152,20
"20894","WBGene00045597","IV",14639622,14639642,20
"20895","WBGene00045602","IV",16838285,16838305,20
"20896","WBGene00045606","IV",9131636,9131656,20
"20897","WBGene00045607","IV",14324699,14324719,20
"20898","WBGene00045612","IV",14405356,14405376,20
"20899","WBGene00045613","IV",15841474,15841494,20
"20900","WBGene00045614","IV",15670608,15670628,20
"20901","WBGene00045615","IV",16522239,16522259,20
"20902","WBGene00045619","IV",5614160,5614180,20
"20903","WBGene00045622","IV",16004254,16004274,20
"20904","WBGene00045623","IV",15339112,15339132,20
"20905","WBGene00045626","IV",15723563,15723583,20
"20906","WBGene00045634","IV",15711282,15711302,20
"20907","WBGene00045637","IV",14265051,14265071,20
"20908","WBGene00045640","IV",15934211,15934231,20
"20909","WBGene00045641","IV",17237035,17237055,20
"20910","WBGene00045644","IV",5133083,5133103,20
"20911","WBGene00045645","IV",14764438,14764458,20
"20912","WBGene00045646","IV",14220765,14220785,20
"20913","WBGene00045647","IV",16002350,16002370,20
"20914","WBGene00045648","IV",14976698,14976718,20
"20915","WBGene00045652","IV",15694953,15694973,20
"20916","WBGene00045653","IV",5769282,5769302,20
"20917","WBGene00045654","IV",16887548,16887568,20
"20918","WBGene00045655","IV",6042267,6042287,20
"20919","WBGene00045664","IV",14650590,14650610,20
"20920","WBGene00045665","IV",16682557,16682577,20
"20921","WBGene00045667","IV",5523137,5523157,20
"20922","WBGene00045672","IV",14607188,14607208,20
"20923","WBGene00045674","IV",16003010,16003030,20
"20924","WBGene00045676","IV",16467298,16467318,20
"20925","WBGene00045678","IV",6060482,6060502,20
"20926","WBGene00045679","IV",5763845,5763865,20
"20927","WBGene00045681","IV",15288590,15288610,20
"20928","WBGene00045682","IV",13908848,13908868,20
"20929","WBGene00045684","IV",5498795,5498815,20
"20930","WBGene00045686","IV",15568127,15568147,20
"20931","WBGene00045688","IV",6179746,6179766,20
"20932","WBGene00045689","IV",16059092,16059112,20
"20933","WBGene00045691","IV",15780730,15780750,20
"20934","WBGene00045693","IV",16250433,16250453,20
"20935","WBGene00045694","IV",15794083,15794103,20
"20936","WBGene00045695","IV",15145087,15145107,20
"20937","WBGene00045696","IV",15549833,15549853,20
"20938","WBGene00045702","IV",15904054,15904074,20
"20939","WBGene00045707","IV",16385416,16385436,20
"20940","WBGene00045710","IV",16198241,16198261,20
"20941","WBGene00045713","IV",15362018,15362038,20
"20942","WBGene00045715","IV",16781294,16781314,20
"20943","WBGene00045724","IV",14344298,14344318,20
"20944","WBGene00045726","IV",16745635,16745655,20
"20945","WBGene00045727","IV",14463088,14463108,20
"20946","WBGene00045728","IV",5078646,5078666,20
"20947","WBGene00045732","IV",6125885,6125905,20
"20948","WBGene00045733","IV",5507693,5507713,20
"20949","WBGene00045738","IV",5828590,5828610,20
"20950","WBGene00045741","IV",16046621,16046641,20
"20951","WBGene00045743","IV",5401360,5401380,20
"20952","WBGene00045745","IV",13959485,13959505,20
"20953","WBGene00045749","IV",15372663,15372683,20
"20954","WBGene00045753","IV",16018174,16018194,20
"20955","WBGene00045759","IV",15694253,15694273,20
"20956","WBGene00045761","IV",6045302,6045322,20
"20957","WBGene00045762","IV",17055693,17055713,20
"20958","WBGene00045769","IV",13907798,13907818,20
"20959","WBGene00045774","IV",15365487,15365507,20
"20960","WBGene00045775","IV",14367796,14367816,20
"20961","WBGene00045779","IV",15405591,15405611,20
"20962","WBGene00045780","IV",14636254,14636274,20
"20963","WBGene00045781","IV",14630200,14630220,20
"20964","WBGene00045783","IV",13950576,13950596,20
"20965","WBGene00045788","IV",5969707,5969727,20
"20966","WBGene00045792","IV",14357310,14357330,20
"20967","WBGene00045795","IV",16442356,16442376,20
"20968","WBGene00045796","IV",16812997,16813017,20
"20969","WBGene00045797","IV",17183863,17183883,20
"20970","WBGene00045799","IV",14907156,14907176,20
"20971","WBGene00045803","IV",16877127,16877147,20
"20972","WBGene00045805","IV",5496271,5496291,20
"20973","WBGene00045806","IV",15386654,15386674,20
"20974","WBGene00045808","IV",16747523,16747543,20
"20975","WBGene00045810","IV",16045647,16045667,20
"20976","WBGene00045814","IV",14941256,14941276,20
"20977","WBGene00045817","IV",14407708,14407728,20
"20978","WBGene00045818","IV",16871160,16871180,20
"20979","WBGene00045821","IV",16612305,16612325,20
"20980","WBGene00045822","IV",15679047,15679067,20
"20981","WBGene00045830","IV",15727463,15727483,20
"20982","WBGene00045831","IV",16709731,16709751,20
"20983","WBGene00045834","IV",15177672,15177692,20
"20984","WBGene00045841","IV",14047277,14047297,20
"20985","WBGene00045844","IV",15284598,15284618,20
"20986","WBGene00045845","IV",16888723,16888743,20
"20987","WBGene00045847","IV",5434770,5434790,20
"20988","WBGene00045851","IV",14543422,14543442,20
"20989","WBGene00045856","IV",5620016,5620036,20
"20990","WBGene00045857","IV",16259696,16259716,20
"20991","WBGene00045862","IV",14305056,14305076,20
"20992","WBGene00045863","IV",13701043,13701063,20
"20993","WBGene00045866","IV",14624220,14624240,20
"20994","WBGene00045870","IV",15569324,15569344,20
"20995","WBGene00045871","IV",14050618,14050638,20
"20996","WBGene00045873","IV",14280553,14280573,20
"20997","WBGene00045874","IV",15674302,15674322,20
"20998","WBGene00045876","IV",5137121,5137141,20
"20999","WBGene00045878","IV",15150721,15150741,20
"21000","WBGene00045880","IV",15588820,15588840,20
"21001","WBGene00045882","IV",6069709,6069729,20
"21002","WBGene00045883","IV",15546991,15547011,20
"21003","WBGene00045885","IV",13675869,13675889,20
"21004","WBGene00045886","IV",5823697,5823717,20
"21005","WBGene00045888","IV",16884670,16884690,20
"21006","WBGene00045890","IV",14578763,14578783,20
"21007","WBGene00045892","IV",14749919,14749939,20
"21008","WBGene00045896","IV",14031169,14031189,20
"21009","WBGene00045897","IV",13760220,13760240,20
"21010","WBGene00045898","IV",14285016,14285036,20
"21011","WBGene00045900","IV",5420409,5420429,20
"21012","WBGene00045903","IV",5574738,5574758,20
"21013","WBGene00045906","IV",14672518,14672538,20
"21014","WBGene00045908","IV",14294285,14294305,20
"21015","WBGene00045910","IV",6023958,6023978,20
"21016","WBGene00045918","IV",16544651,16544671,20
"21017","WBGene00045921","IV",14197667,14197687,20
"21018","WBGene00045924","IV",14472419,14472439,20
"21019","WBGene00045927","IV",5590895,5590915,20
"21020","WBGene00045929","IV",15666938,15666958,20
"21021","WBGene00045933","IV",13841963,13841983,20
"21022","WBGene00045936","IV",13798783,13798803,20
"21023","WBGene00045938","IV",16394278,16394298,20
"21024","WBGene00045940","IV",13828314,13828334,20
"21025","WBGene00045941","IV",14641217,14641237,20
"21026","WBGene00045943","IV",14123737,14123757,20
"21027","WBGene00045947","IV",15725560,15725580,20
"21028","WBGene00045948","IV",16835645,16835665,20
"21029","WBGene00045951","IV",13997032,13997052,20
"21030","WBGene00045954","IV",6505803,6505823,20
"21031","WBGene00045960","IV",5132389,5132409,20
"21032","WBGene00045961","IV",13623659,13623679,20
"21033","WBGene00045964","IV",14645094,14645114,20
"21034","WBGene00045965","IV",15615868,15615888,20
"21035","WBGene00045968","IV",14455854,14455874,20
"21036","WBGene00045969","IV",15550004,15550024,20
"21037","WBGene00045970","IV",15678947,15678967,20
"21038","WBGene00045972","IV",17129797,17129817,20
"21039","WBGene00045974","IV",17074350,17074370,20
"21040","WBGene00045975","IV",14952960,14952980,20
"21041","WBGene00045978","IV",16616792,16616812,20
"21042","WBGene00045981","IV",15389246,15389266,20
"21043","WBGene00045982","IV",15813213,15813233,20
"21044","WBGene00045983","IV",5492203,5492223,20
"21045","WBGene00045985","IV",15723786,15723806,20
"21046","WBGene00045987","IV",16181605,16181625,20
"21047","WBGene00045989","IV",16087411,16087431,20
"21048","WBGene00045990","IV",14565128,14565148,20
"21049","WBGene00045992","IV",5901148,5901168,20
"21050","WBGene00045993","IV",13838459,13838479,20
"21051","WBGene00045998","IV",16640675,16640695,20
"21052","WBGene00046004","IV",16719280,16719300,20
"21053","WBGene00046005","IV",16039005,16039025,20
"21054","WBGene00046008","IV",14362672,14362692,20
"21055","WBGene00046010","IV",15749455,15749475,20
"21056","WBGene00046011","IV",14624634,14624654,20
"21057","WBGene00046012","IV",14639380,14639400,20
"21058","WBGene00046013","IV",15144586,15144606,20
"21059","WBGene00046014","IV",5176268,5176288,20
"21060","WBGene00046015","IV",15896622,15896642,20
"21061","WBGene00046020","IV",15562010,15562030,20
"21062","WBGene00046025","IV",14268472,14268492,20
"21063","WBGene00046026","IV",14366794,14366814,20
"21064","WBGene00046027","IV",14878244,14878264,20
"21065","WBGene00046029","IV",16042244,16042264,20
"21066","WBGene00046030","IV",6176712,6176732,20
"21067","WBGene00046034","IV",17186777,17186797,20
"21068","WBGene00046035","IV",5902664,5902684,20
"21069","WBGene00046037","IV",14602638,14602658,20
"21070","WBGene00046039","IV",17185756,17185776,20
"21071","WBGene00046042","IV",14274093,14274113,20
"21072","WBGene00046048","IV",13722850,13722870,20
"21073","WBGene00046049","IV",16033325,16033345,20
"21074","WBGene00046050","IV",5584089,5584109,20
"21075","WBGene00046051","IV",13726217,13726237,20
"21076","WBGene00046058","IV",5425097,5425117,20
"21077","WBGene00046060","IV",14966689,14966709,20
"21078","WBGene00046061","IV",6042100,6042120,20
"21079","WBGene00046065","IV",17261548,17261568,20
"21080","WBGene00046066","IV",14284599,14284619,20
"21081","WBGene00046067","IV",16544405,16544425,20
"21082","WBGene00046076","IV",16623031,16623051,20
"21083","WBGene00046077","IV",6178898,6178918,20
"21084","WBGene00046078","IV",5775507,5775527,20
"21085","WBGene00046083","IV",14435857,14435877,20
"21086","WBGene00046088","IV",15697656,15697676,20
"21087","WBGene00046094","IV",5787504,5787524,20
"21088","WBGene00046095","IV",16059521,16059541,20
"21089","WBGene00046096","IV",14932050,14932070,20
"21090","WBGene00046097","IV",5506448,5506468,20
"21091","WBGene00046099","IV",13765183,13765203,20
"21092","WBGene00046103","IV",16471543,16471563,20
"21093","WBGene00046104","IV",5769501,5769521,20
"21094","WBGene00046105","IV",15699348,15699368,20
"21095","WBGene00046107","IV",14460683,14460703,20
"21096","WBGene00046108","IV",14090917,14090937,20
"21097","WBGene00046109","IV",5974848,5974868,20
"21098","WBGene00046112","IV",5907385,5907405,20
"21099","WBGene00046114","IV",14224784,14224804,20
"21100","WBGene00046115","IV",15547845,15547865,20
"21101","WBGene00046125","IV",16543188,16543208,20
"21102","WBGene00046126","IV",16537820,16537840,20
"21103","WBGene00046127","IV",15073346,15073366,20
"21104","WBGene00046131","IV",13873398,13873418,20
"21105","WBGene00046132","IV",14126024,14126044,20
"21106","WBGene00046133","IV",13956565,13956585,20
"21107","WBGene00046135","IV",16547563,16547583,20
"21108","WBGene00046137","IV",15660597,15660617,20
"21109","WBGene00046139","IV",5787751,5787771,20
"21110","WBGene00046140","IV",13964184,13964204,20
"21111","WBGene00046143","IV",5974965,5974985,20
"21112","WBGene00046145","IV",17173943,17173963,20
"21113","WBGene00046147","IV",16353004,16353024,20
"21114","WBGene00046148","IV",5807934,5807954,20
"21115","WBGene00046149","IV",14981339,14981359,20
"21116","WBGene00046150","IV",14096118,14096138,20
"21117","WBGene00046156","IV",16452202,16452222,20
"21118","WBGene00046161","IV",5914403,5914423,20
"21119","WBGene00046162","IV",15699453,15699473,20
"21120","WBGene00046163","IV",15275397,15275417,20
"21121","WBGene00046169","IV",15310569,15310589,20
"21122","WBGene00046170","IV",6187712,6187732,20
"21123","WBGene00046171","IV",16835240,16835260,20
"21124","WBGene00046176","IV",14470642,14470662,20
"21125","WBGene00046177","IV",17074903,17074923,20
"21126","WBGene00046182","IV",14812662,14812682,20
"21127","WBGene00046184","IV",14380555,14380575,20
"21128","WBGene00046189","IV",6054944,6054964,20
"21129","WBGene00046190","IV",15777728,15777748,20
"21130","WBGene00046195","IV",15721508,15721528,20
"21131","WBGene00046196","IV",13725890,13725910,20
"21132","WBGene00046198","IV",17180868,17180888,20
"21133","WBGene00046199","IV",17049123,17049143,20
"21134","WBGene00046202","IV",14564008,14564028,20
"21135","WBGene00046207","IV",14995803,14995823,20
"21136","WBGene00046209","IV",14269555,14269575,20
"21137","WBGene00046210","IV",13940535,13940555,20
"21138","WBGene00046212","IV",6080137,6080157,20
"21139","WBGene00046216","IV",14103645,14103665,20
"21140","WBGene00046219","IV",16789030,16789050,20
"21141","WBGene00046220","IV",5770496,5770516,20
"21142","WBGene00046222","IV",14910568,14910588,20
"21143","WBGene00046224","IV",15210872,15210892,20
"21144","WBGene00046231","IV",14265720,14265740,20
"21145","WBGene00046232","IV",14481731,14481751,20
"21146","WBGene00046233","IV",14951696,14951716,20
"21147","WBGene00046236","IV",16825885,16825905,20
"21148","WBGene00046237","IV",14493147,14493167,20
"21149","WBGene00046244","IV",14226366,14226386,20
"21150","WBGene00046245","IV",5419651,5419671,20
"21151","WBGene00046246","IV",14674166,14674186,20
"21152","WBGene00046249","IV",14423518,14423538,20
"21153","WBGene00046250","IV",6183393,6183413,20
"21154","WBGene00046251","IV",14322337,14322357,20
"21155","WBGene00046252","IV",5181672,5181692,20
"21156","WBGene00046254","IV",15869521,15869541,20
"21157","WBGene00046257","IV",6185415,6185435,20
"21158","WBGene00046259","IV",14890805,14890825,20
"21159","WBGene00046261","IV",5612254,5612274,20
"21160","WBGene00046262","IV",6186929,6186949,20
"21161","WBGene00046263","IV",15945883,15945903,20
"21162","WBGene00046264","IV",14392623,14392643,20
"21163","WBGene00046265","IV",16384155,16384175,20
"21164","WBGene00046267","IV",6195544,6195564,20
"21165","WBGene00046270","IV",5072747,5072767,20
"21166","WBGene00046271","IV",15171426,15171446,20
"21167","WBGene00046272","IV",5342519,5342539,20
"21168","WBGene00046275","IV",13609342,13609362,20
"21169","WBGene00046279","IV",15921889,15921909,20
"21170","WBGene00046281","IV",16020311,16020331,20
"21171","WBGene00046283","IV",15747709,15747729,20
"21172","WBGene00046284","IV",14526835,14526855,20
"21173","WBGene00046287","IV",14244607,14244627,20
"21174","WBGene00046292","IV",16175955,16175975,20
"21175","WBGene00046294","IV",5957514,5957534,20
"21176","WBGene00046296","IV",16183242,16183262,20
"21177","WBGene00046299","IV",15697322,15697342,20
"21178","WBGene00046302","IV",15164703,15164723,20
"21179","WBGene00046303","IV",15820813,15820833,20
"21180","WBGene00046313","IV",5820979,5820999,20
"21181","WBGene00046315","IV",14976397,14976417,20
"21182","WBGene00046319","IV",4845245,4845265,20
"21183","WBGene00046321","IV",5925397,5925417,20
"21184","WBGene00046326","IV",15214367,15214387,20
"21185","WBGene00046327","IV",5505629,5505649,20
"21186","WBGene00046330","IV",15810938,15810958,20
"21187","WBGene00046334","IV",16799770,16799790,20
"21188","WBGene00046336","IV",5932726,5932746,20
"21189","WBGene00046337","IV",5833693,5833713,20
"21190","WBGene00046338","IV",13699915,13699935,20
"21191","WBGene00046340","IV",15495936,15495956,20
"21192","WBGene00046343","IV",15089824,15089844,20
"21193","WBGene00046344","IV",15662439,15662459,20
"21194","WBGene00046345","IV",15815227,15815247,20
"21195","WBGene00046352","IV",5761176,5761196,20
"21196","WBGene00046353","IV",14125770,14125790,20
"21197","WBGene00046354","IV",14895171,14895191,20
"21198","WBGene00046355","IV",5803585,5803605,20
"21199","WBGene00046360","IV",14564280,14564300,20
"21200","WBGene00046362","IV",14489179,14489199,20
"21201","WBGene00046364","IV",16253668,16253688,20
"21202","WBGene00046368","IV",14267967,14267987,20
"21203","WBGene00046369","IV",14969969,14969989,20
"21204","WBGene00046372","IV",15273825,15273845,20
"21205","WBGene00046374","IV",14976503,14976523,20
"21206","WBGene00046375","IV",16112451,16112471,20
"21207","WBGene00046384","IV",15821329,15821349,20
"21208","WBGene00046387","IV",15719723,15719743,20
"21209","WBGene00046389","IV",15389512,15389532,20
"21210","WBGene00046393","IV",16605821,16605841,20
"21211","WBGene00046398","IV",13762282,13762302,20
"21212","WBGene00046401","IV",15555447,15555467,20
"21213","WBGene00046402","IV",5438539,5438559,20
"21214","WBGene00046404","IV",5193423,5193443,20
"21215","WBGene00046405","IV",6180344,6180364,20
"21216","WBGene00046406","IV",14369172,14369192,20
"21217","WBGene00046410","IV",13706049,13706069,20
"21218","WBGene00046415","IV",15707250,15707270,20
"21219","WBGene00046420","IV",15621476,15621496,20
"21220","WBGene00046421","IV",5721217,5721237,20
"21221","WBGene00046424","IV",5119729,5119749,20
"21222","WBGene00046428","IV",16069992,16070012,20
"21223","WBGene00046433","IV",15273585,15273605,20
"21224","WBGene00046441","IV",5335354,5335374,20
"21225","WBGene00046444","IV",15245179,15245199,20
"21226","WBGene00046453","IV",14635051,14635071,20
"21227","WBGene00046456","IV",14681084,14681104,20
"21228","WBGene00046457","IV",13828642,13828662,20
"21229","WBGene00046459","IV",16529118,16529138,20
"21230","WBGene00046461","IV",16387132,16387152,20
"21231","WBGene00046462","IV",14502715,14502735,20
"21232","WBGene00046476","IV",5499090,5499110,20
"21233","WBGene00046480","IV",14049246,14049266,20
"21234","WBGene00046482","IV",5952891,5952911,20
"21235","WBGene00046485","IV",16044323,16044343,20
"21236","WBGene00046487","IV",14832270,14832290,20
"21237","WBGene00046488","IV",14646740,14646760,20
"21238","WBGene00046494","IV",14811539,14811559,20
"21239","WBGene00046495","IV",16459561,16459581,20
"21240","WBGene00046496","IV",5418442,5418462,20
"21241","WBGene00046498","IV",14289900,14289920,20
"21242","WBGene00046499","IV",14960988,14961008,20
"21243","WBGene00046509","IV",5171322,5171342,20
"21244","WBGene00046511","IV",5771392,5771412,20
"21245","WBGene00046512","IV",16562712,16562732,20
"21246","WBGene00046514","IV",6991825,6991845,20
"21247","WBGene00046515","IV",15811496,15811516,20
"21248","WBGene00046517","IV",17037586,17037606,20
"21249","WBGene00046519","IV",13956059,13956079,20
"21250","WBGene00046521","IV",17154907,17154927,20
"21251","WBGene00046524","IV",13945668,13945688,20
"21252","WBGene00046525","IV",14683913,14683933,20
"21253","WBGene00046527","IV",14367228,14367248,20
"21254","WBGene00046528","IV",14372539,14372559,20
"21255","WBGene00046529","IV",16462203,16462223,20
"21256","WBGene00046530","IV",6075215,6075235,20
"21257","WBGene00046531","IV",14275852,14275872,20
"21258","WBGene00046532","IV",16003007,16003027,20
"21259","WBGene00046537","IV",14604654,14604674,20
"21260","WBGene00046538","IV",14224018,14224038,20
"21261","WBGene00046543","IV",14982801,14982821,20
"21262","WBGene00046544","IV",15793080,15793100,20
"21263","WBGene00046545","IV",16888197,16888217,20
"21264","WBGene00046546","IV",14560115,14560135,20
"21265","WBGene00046547","IV",5124603,5124623,20
"21266","WBGene00046549","IV",14297081,14297101,20
"21267","WBGene00046550","IV",14600534,14600554,20
"21268","WBGene00046553","IV",16023875,16023895,20
"21269","WBGene00046555","IV",16025550,16025570,20
"21270","WBGene00046557","IV",5594652,5594672,20
"21271","WBGene00046559","IV",6048982,6049002,20
"21272","WBGene00046565","IV",15268510,15268530,20
"21273","WBGene00046569","IV",15309942,15309962,20
"21274","WBGene00046570","IV",13759730,13759750,20
"21275","WBGene00046573","IV",15898909,15898929,20
"21276","WBGene00046575","IV",14364038,14364058,20
"21277","WBGene00046579","IV",15137220,15137240,20
"21278","WBGene00046581","IV",16357434,16357454,20
"21279","WBGene00046582","IV",14046590,14046610,20
"21280","WBGene00046586","IV",16016527,16016547,20
"21281","WBGene00046587","IV",14561431,14561451,20
"21282","WBGene00046588","IV",15537031,15537051,20
"21283","WBGene00046589","IV",5719805,5719825,20
"21284","WBGene00046590","IV",5605864,5605884,20
"21285","WBGene00046594","IV",15348127,15348147,20
"21286","WBGene00046597","IV",15535733,15535753,20
"21287","WBGene00046602","IV",16684683,16684703,20
"21288","WBGene00046603","IV",14819461,14819481,20
"21289","WBGene00046604","IV",5268540,5268560,20
"21290","WBGene00046605","IV",14817796,14817816,20
"21291","WBGene00046608","IV",6130039,6130059,20
"21292","WBGene00046610","IV",14122316,14122336,20
"21293","WBGene00046611","IV",5194049,5194069,20
"21294","WBGene00046612","IV",13962739,13962759,20
"21295","WBGene00046616","IV",15583405,15583425,20
"21296","WBGene00046617","IV",14398349,14398369,20
"21297","WBGene00046618","IV",14609436,14609456,20
"21298","WBGene00046624","IV",15567476,15567496,20
"21299","WBGene00046626","IV",16113213,16113233,20
"21300","WBGene00046628","IV",14482080,14482100,20
"21301","WBGene00046635","IV",5854809,5854829,20
"21302","WBGene00046637","IV",13833653,13833673,20
"21303","WBGene00046644","IV",14606071,14606091,20
"21304","WBGene00046648","IV",4849314,4849334,20
"21305","WBGene00046649","IV",16435595,16435615,20
"21306","WBGene00046656","IV",5161675,5161695,20
"21307","WBGene00046664","IV",16604058,16604078,20
"21308","WBGene00046665","IV",6066041,6066061,20
"21309","WBGene00046673","IV",5600776,5600796,20
"21310","WBGene00046674","IV",17015530,17015550,20
"21311","WBGene00046676","IV",15399073,15399093,20
"21312","WBGene00046677","IV",16019139,16019159,20
"21313","WBGene00046679","IV",17049689,17049709,20
"21314","WBGene00046680","IV",17217670,17217690,20
"21315","WBGene00046684","IV",15795112,15795132,20
"21316","WBGene00046685","IV",5976934,5976954,20
"21317","WBGene00046686","IV",16669345,16669365,20
"21318","WBGene00046687","IV",14176971,14176991,20
"21319","WBGene00046694","IV",14620182,14620202,20
"21320","WBGene00046696","IV",16130415,16130435,20
"21321","WBGene00046697","IV",14273943,14273963,20
"21322","WBGene00046698","IV",16613398,16613418,20
"21323","WBGene00046702","IV",16381897,16381917,20
"21324","WBGene00046703","IV",15351850,15351870,20
"21325","WBGene00046704","IV",13945623,13945643,20
"21326","WBGene00046710","IV",15955708,15955728,20
"21327","WBGene00046712","IV",6993931,6993951,20
"21328","WBGene00046714","IV",14852554,14852574,20
"21329","WBGene00046715","IV",17184417,17184437,20
"21330","WBGene00046716","IV",16041601,16041621,20
"21331","WBGene00046720","IV",17190929,17190949,20
"21332","WBGene00046721","IV",14615349,14615369,20
"21333","WBGene00046722","IV",15107123,15107143,20
"21334","WBGene00046723","IV",15095301,15095321,20
"21335","WBGene00046724","IV",16888988,16889008,20
"21336","WBGene00046729","IV",13725032,13725052,20
"21337","WBGene00046730","IV",5861273,5861293,20
"21338","WBGene00046732","IV",16207023,16207043,20
"21339","WBGene00046736","IV",6166487,6166507,20
"21340","WBGene00046738","IV",15477978,15477998,20
"21341","WBGene00046739","IV",14044625,14044645,20
"21342","WBGene00046746","IV",16035819,16035839,20
"21343","WBGene00046748","IV",15809339,15809359,20
"21344","WBGene00046749","IV",14431402,14431422,20
"21345","WBGene00046753","IV",5824387,5824407,20
"21346","WBGene00046755","IV",15623971,15623991,20
"21347","WBGene00046757","IV",14644034,14644054,20
"21348","WBGene00046758","IV",14494642,14494662,20
"21349","WBGene00046762","IV",14702666,14702686,20
"21350","WBGene00046764","IV",5927883,5927903,20
"21351","WBGene00046765","IV",15542243,15542263,20
"21352","WBGene00046768","IV",6498732,6498752,20
"21353","WBGene00046772","IV",14092027,14092047,20
"21354","WBGene00046773","IV",14998088,14998108,20
"21355","WBGene00046777","IV",16178841,16178861,20
"21356","WBGene00046785","IV",5970039,5970059,20
"21357","WBGene00046789","IV",15354975,15354995,20
"21358","WBGene00046791","IV",16191949,16191969,20
"21359","WBGene00046795","IV",16830052,16830072,20
"21360","WBGene00046796","IV",14474434,14474454,20
"21361","WBGene00046799","IV",16703282,16703302,20
"21362","WBGene00046800","IV",15818283,15818303,20
"21363","WBGene00046801","IV",14495919,14495939,20
"21364","WBGene00046804","IV",5522811,5522831,20
"21365","WBGene00046810","IV",5757986,5758006,20
"21366","WBGene00046811","IV",16250693,16250713,20
"21367","WBGene00046814","IV",15542639,15542659,20
"21368","WBGene00046815","IV",14321652,14321672,20
"21369","WBGene00046823","IV",14638070,14638090,20
"21370","WBGene00046826","IV",14433171,14433191,20
"21371","WBGene00046827","IV",16794723,16794743,20
"21372","WBGene00046832","IV",16005042,16005062,20
"21373","WBGene00046833","IV",13646547,13646567,20
"21374","WBGene00046835","IV",15714592,15714612,20
"21375","WBGene00046836","IV",15561773,15561793,20
"21376","WBGene00046837","IV",15392573,15392593,20
"21377","WBGene00046839","IV",15350531,15350551,20
"21378","WBGene00046841","IV",5565661,5565681,20
"21379","WBGene00046842","IV",14485452,14485472,20
"21380","WBGene00046843","IV",5440347,5440367,20
"21381","WBGene00046844","IV",15711614,15711634,20
"21382","WBGene00046846","IV",16099705,16099725,20
"21383","WBGene00046855","IV",14874511,14874531,20
"21384","WBGene00046858","IV",14690413,14690433,20
"21385","WBGene00046859","IV",13877232,13877252,20
"21386","WBGene00046863","IV",15396239,15396259,20
"21387","WBGene00046866","IV",5888787,5888807,20
"21388","WBGene00046868","IV",14176647,14176667,20
"21389","WBGene00046870","IV",5592162,5592182,20
"21390","WBGene00046871","IV",16884222,16884242,20
"21391","WBGene00046875","IV",4835169,4835189,20
"21392","WBGene00046878","IV",16260008,16260028,20
"21393","WBGene00046879","IV",14885188,14885208,20
"21394","WBGene00046882","IV",15614141,15614161,20
"21395","WBGene00046885","IV",15703316,15703336,20
"21396","WBGene00046886","IV",5600999,5601019,20
"21397","WBGene00046887","IV",14685608,14685628,20
"21398","WBGene00046890","IV",14852193,14852213,20
"21399","WBGene00046892","IV",15985969,15985989,20
"21400","WBGene00046895","IV",5956169,5956189,20
"21401","WBGene00046896","IV",6993583,6993603,20
"21402","WBGene00046897","IV",6164139,6164159,20
"21403","WBGene00046898","IV",16014564,16014584,20
"21404","WBGene00046904","IV",5766033,5766053,20
"21405","WBGene00046917","IV",16662196,16662216,20
"21406","WBGene00046918","IV",15679229,15679249,20
"21407","WBGene00046922","IV",14036297,14036317,20
"21408","WBGene00046926","IV",13873770,13873790,20
"21409","WBGene00046932","IV",16205483,16205503,20
"21410","WBGene00046933","IV",5430087,5430107,20
"21411","WBGene00046934","IV",16129948,16129968,20
"21412","WBGene00046935","IV",14730360,14730380,20
"21413","WBGene00046936","IV",14177689,14177709,20
"21414","WBGene00046937","IV",6389520,6389540,20
"21415","WBGene00046938","IV",16528011,16528031,20
"21416","WBGene00046942","IV",14982276,14982296,20
"21417","WBGene00046945","IV",16006060,16006080,20
"21418","WBGene00046946","IV",13712624,13712644,20
"21419","WBGene00046947","IV",16026135,16026155,20
"21420","WBGene00046950","IV",5482674,5482694,20
"21421","WBGene00046953","IV",14886425,14886445,20
"21422","WBGene00046964","IV",15625722,15625742,20
"21423","WBGene00046965","IV",14609030,14609050,20
"21424","WBGene00046968","IV",16024537,16024557,20
"21425","WBGene00046969","IV",14662649,14662669,20
"21426","WBGene00046973","IV",15613706,15613726,20
"21427","WBGene00046974","IV",14571278,14571298,20
"21428","WBGene00046978","IV",14813729,14813749,20
"21429","WBGene00046979","IV",14914002,14914022,20
"21430","WBGene00046981","IV",5829425,5829445,20
"21431","WBGene00046983","IV",14887960,14887980,20
"21432","WBGene00046987","IV",16550925,16550945,20
"21433","WBGene00046993","IV",16006585,16006605,20
"21434","WBGene00046997","IV",16163472,16163492,20
"21435","WBGene00046998","IV",16543448,16543468,20
"21436","WBGene00047000","IV",13731968,13731988,20
"21437","WBGene00047003","IV",14961570,14961590,20
"21438","WBGene00047007","IV",14274094,14274114,20
"21439","WBGene00047014","IV",15256167,15256187,20
"21440","WBGene00047017","IV",13886176,13886196,20
"21441","WBGene00047021","IV",14097002,14097022,20
"21442","WBGene00047023","IV",16137301,16137321,20
"21443","WBGene00047024","IV",6410389,6410409,20
"21444","WBGene00047027","IV",5838088,5838108,20
"21445","WBGene00047030","IV",14092272,14092292,20
"21446","WBGene00047033","IV",17205987,17206007,20
"21447","WBGene00047039","IV",16038059,16038079,20
"21448","WBGene00047043","IV",15606134,15606154,20
"21449","WBGene00047044","IV",5610789,5610809,20
"21450","WBGene00047045","IV",16018632,16018652,20
"21451","WBGene00047050","IV",15613539,15613559,20
"21452","WBGene00047053","IV",5821540,5821560,20
"21453","WBGene00047054","IV",13924307,13924327,20
"21454","WBGene00047057","IV",14608265,14608285,20
"21455","WBGene00047059","IV",15715031,15715051,20
"21456","WBGene00047060","IV",14435217,14435237,20
"21457","WBGene00047070","IV",15701559,15701579,20
"21458","WBGene00047072","IV",14683633,14683653,20
"21459","WBGene00047075","IV",14183831,14183851,20
"21460","WBGene00047080","IV",14714440,14714460,20
"21461","WBGene00047082","IV",13610116,13610136,20
"21462","WBGene00047083","IV",5840485,5840505,20
"21463","WBGene00047084","IV",5809473,5809493,20
"21464","WBGene00047085","IV",14866776,14866796,20
"21465","WBGene00047089","IV",15711337,15711357,20
"21466","WBGene00047091","IV",16582437,16582457,20
"21467","WBGene00047092","IV",16801420,16801440,20
"21468","WBGene00047093","IV",14450836,14450856,20
"21469","WBGene00047098","IV",16175842,16175862,20
"21470","WBGene00047099","IV",5918050,5918070,20
"21471","WBGene00047102","IV",5735630,5735650,20
"21472","WBGene00047104","IV",14900180,14900200,20
"21473","WBGene00047106","IV",16670183,16670203,20
"21474","WBGene00047108","IV",13726636,13726656,20
"21475","WBGene00047111","IV",5745366,5745386,20
"21476","WBGene00047114","IV",5930555,5930575,20
"21477","WBGene00047115","IV",14136624,14136644,20
"21478","WBGene00047118","IV",14126405,14126425,20
"21479","WBGene00047122","IV",5587414,5587434,20
"21480","WBGene00047124","IV",15089492,15089512,20
"21481","WBGene00047130","IV",14483678,14483698,20
"21482","WBGene00047131","IV",16137118,16137138,20
"21483","WBGene00047135","IV",14399897,14399917,20
"21484","WBGene00047139","IV",13762729,13762749,20
"21485","WBGene00047141","IV",16171215,16171235,20
"21486","WBGene00047153","IV",14294792,14294812,20
"21487","WBGene00047154","IV",4836613,4836633,20
"21488","WBGene00047155","IV",14413907,14413927,20
"21489","WBGene00047162","IV",14743903,14743923,20
"21490","WBGene00047167","IV",15212192,15212212,20
"21491","WBGene00047170","IV",15727515,15727535,20
"21492","WBGene00047171","IV",14721048,14721068,20
"21493","WBGene00047173","IV",6174272,6174292,20
"21494","WBGene00047174","IV",16078258,16078278,20
"21495","WBGene00047184","IV",13889092,13889112,20
"21496","WBGene00047185","IV",16011237,16011257,20
"21497","WBGene00047187","IV",5103112,5103132,20
"21498","WBGene00047188","IV",6174615,6174635,20
"21499","WBGene00047189","IV",16601240,16601260,20
"21500","WBGene00047191","IV",6047945,6047965,20
"21501","WBGene00047192","IV",16520746,16520766,20
"21502","WBGene00047196","IV",14887062,14887082,20
"21503","WBGene00047199","IV",16042507,16042527,20
"21504","WBGene00047205","IV",5981472,5981492,20
"21505","WBGene00047209","IV",6397494,6397514,20
"21506","WBGene00047211","IV",14403915,14403935,20
"21507","WBGene00047212","IV",16683319,16683339,20
"21508","WBGene00047213","IV",14338850,14338870,20
"21509","WBGene00047216","IV",13761626,13761646,20
"21510","WBGene00047220","IV",5861524,5861544,20
"21511","WBGene00047221","IV",5970439,5970459,20
"21512","WBGene00047225","IV",5969462,5969482,20
"21513","WBGene00047228","IV",14292641,14292661,20
"21514","WBGene00047232","IV",15768231,15768251,20
"21515","WBGene00047233","IV",5128074,5128094,20
"21516","WBGene00047234","IV",15566610,15566630,20
"21517","WBGene00047237","IV",17199155,17199175,20
"21518","WBGene00047238","IV",16547814,16547834,20
"21519","WBGene00047243","IV",16381019,16381039,20
"21520","WBGene00047245","IV",6062774,6062794,20
"21521","WBGene00047248","IV",14092024,14092044,20
"21522","WBGene00047249","IV",14403788,14403808,20
"21523","WBGene00047250","IV",15818597,15818617,20
"21524","WBGene00047252","IV",14054533,14054553,20
"21525","WBGene00047256","IV",14270029,14270049,20
"21526","WBGene00047258","IV",15706678,15706698,20
"21527","WBGene00047259","IV",5565484,5565504,20
"21528","WBGene00047260","IV",14490146,14490166,20
"21529","WBGene00047264","IV",13889751,13889771,20
"21530","WBGene00047269","IV",14904205,14904225,20
"21531","WBGene00047270","IV",17184635,17184655,20
"21532","WBGene00047272","IV",15211948,15211968,20
"21533","WBGene00047273","IV",15690034,15690054,20
"21534","WBGene00047277","IV",16553616,16553636,20
"21535","WBGene00047279","IV",15680618,15680638,20
"21536","WBGene00047280","IV",14904658,14904678,20
"21537","WBGene00047281","IV",15389736,15389756,20
"21538","WBGene00047286","IV",16182013,16182033,20
"21539","WBGene00047289","IV",14967271,14967291,20
"21540","WBGene00047295","IV",14888216,14888236,20
"21541","WBGene00047298","IV",14134497,14134517,20
"21542","WBGene00047303","IV",14806408,14806428,20
"21543","WBGene00047304","IV",13717736,13717756,20
"21544","WBGene00047307","IV",5051517,5051537,20
"21545","WBGene00047311","IV",13646066,13646086,20
"21546","WBGene00047312","IV",5199840,5199860,20
"21547","WBGene00047315","IV",14642462,14642482,20
"21548","WBGene00047323","IV",14975221,14975241,20
"21549","WBGene00047326","IV",17200621,17200641,20
"21550","WBGene00047327","IV",16774947,16774967,20
"21551","WBGene00047330","IV",13833948,13833968,20
"21552","WBGene00047331","IV",14287105,14287125,20
"21553","WBGene00047342","IV",16272794,16272814,20
"21554","WBGene00047344","IV",16023759,16023779,20
"21555","WBGene00047345","IV",16176140,16176160,20
"21556","WBGene00047349","IV",15061274,15061294,20
"21557","WBGene00047350","IV",5603867,5603887,20
"21558","WBGene00047355","IV",5518665,5518685,20
"21559","WBGene00047363","IV",5214660,5214680,20
"21560","WBGene00047364","IV",4985802,4985822,20
"21561","WBGene00047369","IV",14515432,14515452,20
"21562","WBGene00047375","IV",16606772,16606792,20
"21563","WBGene00047378","IV",5079651,5079671,20
"21564","WBGene00047379","IV",14011090,14011110,20
"21565","WBGene00047381","IV",15898597,15898617,20
"21566","WBGene00047386","IV",4843081,4843101,20
"21567","WBGene00047389","IV",15690402,15690422,20
"21568","WBGene00047393","IV",6496145,6496165,20
"21569","WBGene00047394","IV",6131753,6131773,20
"21570","WBGene00047395","IV",16190285,16190305,20
"21571","WBGene00047396","IV",5514405,5514425,20
"21572","WBGene00047398","IV",13995662,13995682,20
"21573","WBGene00047399","IV",15272925,15272945,20
"21574","WBGene00047403","IV",16619747,16619767,20
"21575","WBGene00047405","IV",13959123,13959143,20
"21576","WBGene00047408","IV",14539451,14539471,20
"21577","WBGene00047411","IV",15569423,15569443,20
"21578","WBGene00047412","IV",16558238,16558258,20
"21579","WBGene00047417","IV",14149060,14149080,20
"21580","WBGene00047428","IV",15055571,15055591,20
"21581","WBGene00047431","IV",17019021,17019041,20
"21582","WBGene00047436","IV",14220194,14220214,20
"21583","WBGene00047441","IV",16047459,16047479,20
"21584","WBGene00047444","IV",5105590,5105610,20
"21585","WBGene00047445","IV",6390377,6390397,20
"21586","WBGene00047447","IV",15569637,15569657,20
"21587","WBGene00047449","IV",15698781,15698801,20
"21588","WBGene00047450","IV",15582979,15582999,20
"21589","WBGene00047454","IV",14809271,14809291,20
"21590","WBGene00047455","IV",6057117,6057137,20
"21591","WBGene00047457","IV",14398613,14398633,20
"21592","WBGene00047460","IV",14338847,14338867,20
"21593","WBGene00047461","IV",15054811,15054831,20
"21594","WBGene00047464","IV",16186121,16186141,20
"21595","WBGene00047467","IV",5528804,5528824,20
"21596","WBGene00047472","IV",13946211,13946231,20
"21597","WBGene00047473","IV",15777129,15777149,20
"21598","WBGene00047474","IV",13692200,13692220,20
"21599","WBGene00047476","IV",14378439,14378459,20
"21600","WBGene00047479","IV",16993915,16993935,20
"21601","WBGene00047485","IV",16716455,16716475,20
"21602","WBGene00047486","IV",14401748,14401768,20
"21603","WBGene00047490","IV",14457400,14457420,20
"21604","WBGene00047491","IV",16148140,16148160,20
"21605","WBGene00047495","IV",16614150,16614170,20
"21606","WBGene00047496","IV",15817624,15817644,20
"21607","WBGene00047498","IV",15346784,15346804,20
"21608","WBGene00047499","IV",14913878,14913898,20
"21609","WBGene00047500","IV",15701663,15701683,20
"21610","WBGene00047505","IV",16475766,16475786,20
"21611","WBGene00047507","IV",17158376,17158396,20
"21612","WBGene00047508","IV",14662131,14662151,20
"21613","WBGene00047509","IV",6044470,6044490,20
"21614","WBGene00047511","IV",14265312,14265332,20
"21615","WBGene00047514","IV",16166988,16167008,20
"21616","WBGene00047519","IV",15825217,15825237,20
"21617","WBGene00047528","IV",16193390,16193410,20
"21618","WBGene00047529","IV",14358571,14358591,20
"21619","WBGene00047533","IV",15745807,15745827,20
"21620","WBGene00047537","IV",15555312,15555332,20
"21621","WBGene00047542","IV",15721449,15721469,20
"21622","WBGene00047544","IV",14406372,14406392,20
"21623","WBGene00047552","IV",13692875,13692895,20
"21624","WBGene00047555","IV",5866460,5866480,20
"21625","WBGene00047556","IV",14128159,14128179,20
"21626","WBGene00047570","IV",15829422,15829442,20
"21627","WBGene00047572","IV",14673759,14673779,20
"21628","WBGene00047575","IV",14998892,14998912,20
"21629","WBGene00047576","IV",16437745,16437765,20
"21630","WBGene00047581","IV",14127722,14127742,20
"21631","WBGene00047587","IV",16080675,16080695,20
"21632","WBGene00047596","IV",16366456,16366476,20
"21633","WBGene00047597","IV",13621601,13621621,20
"21634","WBGene00047599","IV",5862655,5862675,20
"21635","WBGene00047600","IV",15711994,15712014,20
"21636","WBGene00047602","IV",13829627,13829647,20
"21637","WBGene00047604","IV",5787922,5787942,20
"21638","WBGene00047605","IV",15495501,15495521,20
"21639","WBGene00047606","IV",15397929,15397949,20
"21640","WBGene00047607","IV",15355574,15355594,20
"21641","WBGene00047609","IV",14390876,14390896,20
"21642","WBGene00047614","IV",15053677,15053697,20
"21643","WBGene00047615","IV",15667393,15667413,20
"21644","WBGene00047618","IV",16668928,16668948,20
"21645","WBGene00047619","IV",4962088,4962108,20
"21646","WBGene00047620","IV",14087884,14087904,20
"21647","WBGene00047623","IV",14945176,14945196,20
"21648","WBGene00047630","IV",6197742,6197762,20
"21649","WBGene00047635","IV",15819237,15819257,20
"21650","WBGene00047642","IV",17074616,17074636,20
"21651","WBGene00047652","IV",16135412,16135432,20
"21652","WBGene00047657","IV",6384492,6384512,20
"21653","WBGene00047662","IV",5924799,5924819,20
"21654","WBGene00047664","IV",16039593,16039613,20
"21655","WBGene00047669","IV",14884627,14884647,20
"21656","WBGene00047670","IV",15700553,15700573,20
"21657","WBGene00047672","IV",6201021,6201041,20
"21658","WBGene00047673","IV",15547608,15547628,20
"21659","WBGene00047674","IV",15700969,15700989,20
"21660","WBGene00047675","IV",14673437,14673457,20
"21661","WBGene00047677","IV",13918439,13918459,20
"21662","WBGene00047679","IV",15310568,15310588,20
"21663","WBGene00047683","IV",5973733,5973753,20
"21664","WBGene00047685","IV",6134089,6134109,20
"21665","WBGene00047688","IV",15813760,15813780,20
"21666","WBGene00047690","IV",14259828,14259848,20
"21667","WBGene00047691","IV",5818592,5818612,20
"21668","WBGene00047693","IV",16745863,16745883,20
"21669","WBGene00047695","IV",13894551,13894571,20
"21670","WBGene00047697","IV",14265723,14265743,20
"21671","WBGene00047703","IV",16796965,16796985,20
"21672","WBGene00047704","IV",16010304,16010324,20
"21673","WBGene00047715","IV",15745679,15745699,20
"21674","WBGene00047716","IV",13897124,13897144,20
"21675","WBGene00047717","IV",14437639,14437659,20
"21676","WBGene00047720","IV",14890112,14890132,20
"21677","WBGene00047725","IV",14223516,14223536,20
"21678","WBGene00047726","IV",13608800,13608820,20
"21679","WBGene00047727","IV",17262514,17262534,20
"21680","WBGene00047732","IV",5735962,5735982,20
"21681","WBGene00047735","IV",16071973,16071993,20
"21682","WBGene00047739","IV",17233407,17233427,20
"21683","WBGene00047744","IV",15283914,15283934,20
"21684","WBGene00047745","IV",16134544,16134564,20
"21685","WBGene00047748","IV",16814974,16814994,20
"21686","WBGene00047751","IV",14898460,14898480,20
"21687","WBGene00047752","IV",14223330,14223350,20
"21688","WBGene00047755","IV",5834578,5834598,20
"21689","WBGene00047756","IV",13877500,13877520,20
"21690","WBGene00047759","IV",16473415,16473435,20
"21691","WBGene00047761","IV",5767227,5767247,20
"21692","WBGene00047762","IV",16704661,16704681,20
"21693","WBGene00047776","IV",14283540,14283560,20
"21694","WBGene00047780","IV",14170167,14170187,20
"21695","WBGene00047781","IV",15365139,15365159,20
"21696","WBGene00047783","IV",16087018,16087038,20
"21697","WBGene00047787","IV",5825470,5825490,20
"21698","WBGene00047788","IV",13888503,13888523,20
"21699","WBGene00047801","IV",14489338,14489358,20
"21700","WBGene00047803","IV",15350093,15350113,20
"21701","WBGene00047804","IV",14463332,14463352,20
"21702","WBGene00047808","IV",13894945,13894965,20
"21703","WBGene00047820","IV",6987887,6987907,20
"21704","WBGene00047823","IV",15666513,15666533,20
"21705","WBGene00047825","IV",14406203,14406223,20
"21706","WBGene00047829","IV",14672121,14672141,20
"21707","WBGene00047830","IV",16668728,16668748,20
"21708","WBGene00047831","IV",14029654,14029674,20
"21709","WBGene00047834","IV",5151213,5151233,20
"21710","WBGene00047835","IV",14054796,14054816,20
"21711","WBGene00047836","IV",13928253,13928273,20
"21712","WBGene00047838","IV",13898382,13898402,20
"21713","WBGene00047839","IV",14589929,14589949,20
"21714","WBGene00047840","IV",13994463,13994483,20
"21715","WBGene00047843","IV",16814488,16814508,20
"21716","WBGene00047846","IV",15001079,15001099,20
"21717","WBGene00047848","IV",5810691,5810711,20
"21718","WBGene00047852","IV",5810378,5810398,20
"21719","WBGene00047853","IV",14044493,14044513,20
"21720","WBGene00047859","IV",15405151,15405171,20
"21721","WBGene00047860","IV",16009478,16009498,20
"21722","WBGene00047864","IV",16442922,16442942,20
"21723","WBGene00047866","IV",17204030,17204050,20
"21724","WBGene00047867","IV",5343724,5343744,20
"21725","WBGene00047870","IV",14742915,14742935,20
"21726","WBGene00047871","IV",16027254,16027274,20
"21727","WBGene00047872","IV",14870810,14870830,20
"21728","WBGene00047874","IV",17181444,17181464,20
"21729","WBGene00047879","IV",13767962,13767982,20
"21730","WBGene00047881","IV",14993413,14993433,20
"21731","WBGene00047882","IV",5723408,5723428,20
"21732","WBGene00047883","IV",14629269,14629289,20
"21733","WBGene00047888","IV",6027005,6027025,20
"21734","WBGene00047891","IV",5513246,5513266,20
"21735","WBGene00047892","IV",15055509,15055529,20
"21736","WBGene00047894","IV",15913916,15913936,20
"21737","WBGene00047901","IV",15893831,15893851,20
"21738","WBGene00047907","IV",14456149,14456169,20
"21739","WBGene00047912","IV",13879644,13879664,20
"21740","WBGene00047915","IV",15152013,15152033,20
"21741","WBGene00047916","IV",14035201,14035221,20
"21742","WBGene00047917","IV",14358725,14358745,20
"21743","WBGene00047919","IV",16835726,16835746,20
"21744","WBGene00047920","IV",16035028,16035048,20
"21745","WBGene00047926","IV",15302797,15302817,20
"21746","WBGene00047928","IV",17149507,17149527,20
"21747","WBGene00047929","IV",15210497,15210517,20
"21748","WBGene00047930","IV",5716818,5716838,20
"21749","WBGene00047931","IV",15302064,15302084,20
"21750","WBGene00047933","IV",15796235,15796255,20
"21751","WBGene00047934","IV",15700262,15700282,20
"21752","WBGene00047935","IV",14360720,14360740,20
"21753","WBGene00047936","IV",6187579,6187599,20
"21754","WBGene00047937","IV",14952147,14952167,20
"21755","WBGene00047941","IV",9131059,9131079,20
"21756","WBGene00047942","IV",5615990,5616010,20
"21757","WBGene00047943","IV",15724354,15724374,20
"21758","WBGene00047944","IV",13838041,13838061,20
"21759","WBGene00047949","IV",6125695,6125715,20
"21760","WBGene00047950","IV",16165989,16166009,20
"21761","WBGene00047951","IV",6066821,6066841,20
"21762","WBGene00047957","IV",5144685,5144705,20
"21763","WBGene00047960","IV",14678441,14678461,20
"21764","WBGene00047962","IV",14706788,14706808,20
"21765","WBGene00047963","IV",16350554,16350574,20
"21766","WBGene00047965","IV",13971963,13971983,20
"21767","WBGene00047967","IV",16106291,16106311,20
"21768","WBGene00047968","IV",16829252,16829272,20
"21769","WBGene00047970","IV",5727249,5727269,20
"21770","WBGene00047976","IV",14983335,14983355,20
"21771","WBGene00047978","IV",14501087,14501107,20
"21772","WBGene00047980","IV",5790017,5790037,20
"21773","WBGene00047988","IV",5832009,5832029,20
"21774","WBGene00047990","IV",14626183,14626203,20
"21775","WBGene00047995","IV",16110135,16110155,20
"21776","WBGene00047996","IV",14734710,14734730,20
"21777","WBGene00048001","IV",5829007,5829027,20
"21778","WBGene00048006","IV",15345057,15345077,20
"21779","WBGene00048010","IV",14488994,14489014,20
"21780","WBGene00048016","IV",14270120,14270140,20
"21781","WBGene00048020","IV",15998681,15998701,20
"21782","WBGene00048026","IV",16788866,16788886,20
"21783","WBGene00048027","IV",15882898,15882918,20
"21784","WBGene00048030","IV",14897837,14897857,20
"21785","WBGene00048034","IV",13841856,13841876,20
"21786","WBGene00048037","IV",16025786,16025806,20
"21787","WBGene00048038","IV",17172078,17172098,20
"21788","WBGene00048045","IV",5966322,5966342,20
"21789","WBGene00048050","IV",15990779,15990799,20
"21790","WBGene00048051","IV",16016933,16016953,20
"21791","WBGene00048052","IV",14496241,14496261,20
"21792","WBGene00048054","IV",5805949,5805969,20
"21793","WBGene00048059","IV",13901895,13901915,20
"21794","WBGene00048062","IV",14220909,14220929,20
"21795","WBGene00048067","IV",14897227,14897247,20
"21796","WBGene00048068","IV",14971950,14971970,20
"21797","WBGene00048069","IV",16152402,16152422,20
"21798","WBGene00048082","IV",14456470,14456490,20
"21799","WBGene00048083","IV",14673153,14673173,20
"21800","WBGene00048092","IV",16167170,16167190,20
"21801","WBGene00048094","IV",14526288,14526308,20
"21802","WBGene00048099","IV",14268724,14268744,20
"21803","WBGene00048102","IV",13761277,13761297,20
"21804","WBGene00048104","IV",14483946,14483966,20
"21805","WBGene00048106","IV",16875773,16875793,20
"21806","WBGene00048109","IV",6048289,6048309,20
"21807","WBGene00048111","IV",15308176,15308196,20
"21808","WBGene00048114","IV",15707726,15707746,20
"21809","WBGene00048116","IV",14646481,14646501,20
"21810","WBGene00048119","IV",14988629,14988649,20
"21811","WBGene00048123","IV",13917665,13917685,20
"21812","WBGene00048129","IV",5107944,5107964,20
"21813","WBGene00048133","IV",13692204,13692224,20
"21814","WBGene00048135","IV",14484443,14484463,20
"21815","WBGene00048140","IV",5605174,5605194,20
"21816","WBGene00048141","IV",16873111,16873131,20
"21817","WBGene00048142","IV",16525298,16525318,20
"21818","WBGene00048145","IV",5522028,5522048,20
"21819","WBGene00048146","IV",16696520,16696540,20
"21820","WBGene00048147","IV",5970315,5970335,20
"21821","WBGene00048151","IV",5959527,5959547,20
"21822","WBGene00048154","IV",16715351,16715371,20
"21823","WBGene00048157","IV",15275189,15275209,20
"21824","WBGene00048164","IV",16661256,16661276,20
"21825","WBGene00048165","IV",16009706,16009726,20
"21826","WBGene00048167","IV",6066283,6066303,20
"21827","WBGene00048169","IV",5923507,5923527,20
"21828","WBGene00048170","IV",6071396,6071416,20
"21829","WBGene00048183","IV",16438866,16438886,20
"21830","WBGene00048185","IV",14231330,14231350,20
"21831","WBGene00048186","IV",14378785,14378805,20
"21832","WBGene00048190","IV",5817098,5817118,20
"21833","WBGene00048192","IV",15258111,15258131,20
"21834","WBGene00048194","IV",5179501,5179521,20
"21835","WBGene00048195","IV",16039978,16039998,20
"21836","WBGene00048196","IV",13917860,13917880,20
"21837","WBGene00048201","IV",13698051,13698071,20
"21838","WBGene00048202","IV",15966958,15966978,20
"21839","WBGene00048203","IV",5587616,5587636,20
"21840","WBGene00048205","IV",6051770,6051790,20
"21841","WBGene00048206","IV",14326268,14326288,20
"21842","WBGene00048215","IV",15563495,15563515,20
"21843","WBGene00048216","IV",14434426,14434446,20
"21844","WBGene00048221","IV",16173742,16173762,20
"21845","WBGene00048222","IV",14486076,14486096,20
"21846","WBGene00048232","IV",13991531,13991551,20
"21847","WBGene00048234","IV",17184138,17184158,20
"21848","WBGene00048235","IV",5901559,5901579,20
"21849","WBGene00048237","IV",14583747,14583767,20
"21850","WBGene00048238","IV",14488330,14488350,20
"21851","WBGene00048239","IV",4970386,4970406,20
"21852","WBGene00048240","IV",16718956,16718976,20
"21853","WBGene00048241","IV",16170410,16170430,20
"21854","WBGene00048242","IV",16003949,16003969,20
"21855","WBGene00048248","IV",14629543,14629563,20
"21856","WBGene00048249","IV",14896818,14896838,20
"21857","WBGene00048250","IV",13691817,13691837,20
"21858","WBGene00048253","IV",5200867,5200887,20
"21859","WBGene00048256","IV",17200776,17200796,20
"21860","WBGene00048257","IV",15215767,15215787,20
"21861","WBGene00048260","IV",15703944,15703964,20
"21862","WBGene00048267","IV",13888401,13888421,20
"21863","WBGene00048268","IV",15665681,15665701,20
"21864","WBGene00048274","IV",16456438,16456458,20
"21865","WBGene00048277","IV",16140166,16140186,20
"21866","WBGene00048278","IV",15402443,15402463,20
"21867","WBGene00048286","IV",16017853,16017873,20
"21868","WBGene00048288","IV",14607317,14607337,20
"21869","WBGene00048291","IV",14762570,14762590,20
"21870","WBGene00048292","IV",16179877,16179897,20
"21871","WBGene00048294","IV",15810242,15810262,20
"21872","WBGene00048297","IV",5756695,5756715,20
"21873","WBGene00048299","IV",6193699,6193719,20
"21874","WBGene00048301","IV",13833947,13833967,20
"21875","WBGene00048305","IV",15393295,15393315,20
"21876","WBGene00048306","IV",16475178,16475198,20
"21877","WBGene00048310","IV",5804587,5804607,20
"21878","WBGene00048312","IV",15662076,15662096,20
"21879","WBGene00048314","IV",14562753,14562773,20
"21880","WBGene00048316","IV",5981681,5981701,20
"21881","WBGene00048321","IV",16835182,16835202,20
"21882","WBGene00048323","IV",16251001,16251021,20
"21883","WBGene00048324","IV",16904395,16904415,20
"21884","WBGene00048326","IV",14272315,14272335,20
"21885","WBGene00048328","IV",5434387,5434407,20
"21886","WBGene00048329","IV",13955016,13955036,20
"21887","WBGene00048334","IV",14965376,14965396,20
"21888","WBGene00048336","IV",17235851,17235871,20
"21889","WBGene00048337","IV",14440799,14440819,20
"21890","WBGene00048338","IV",15355448,15355468,20
"21891","WBGene00048340","IV",16833752,16833772,20
"21892","WBGene00048345","IV",5422272,5422292,20
"21893","WBGene00048349","IV",13863445,13863465,20
"21894","WBGene00048350","IV",15710777,15710797,20
"21895","WBGene00048353","IV",16033808,16033828,20
"21896","WBGene00048354","IV",16136281,16136301,20
"21897","WBGene00048355","IV",15793924,15793944,20
"21898","WBGene00048357","IV",14296185,14296205,20
"21899","WBGene00048360","IV",16375509,16375529,20
"21900","WBGene00048364","IV",14661759,14661779,20
"21901","WBGene00048366","IV",15277166,15277186,20
"21902","WBGene00048369","IV",14915791,14915811,20
"21903","WBGene00048374","IV",13895911,13895931,20
"21904","WBGene00048375","IV",13878425,13878445,20
"21905","WBGene00048376","IV",5739537,5739557,20
"21906","WBGene00048377","IV",5094002,5094022,20
"21907","WBGene00048379","IV",5204631,5204651,20
"21908","WBGene00048380","IV",14501611,14501631,20
"21909","WBGene00048382","IV",15797761,15797781,20
"21910","WBGene00048386","IV",16073133,16073153,20
"21911","WBGene00048387","IV",14549703,14549723,20
"21912","WBGene00048388","IV",16668415,16668435,20
"21913","WBGene00048390","IV",5053075,5053095,20
"21914","WBGene00048392","IV",16207543,16207563,20
"21915","WBGene00048394","IV",15756684,15756704,20
"21916","WBGene00048397","IV",14660479,14660499,20
"21917","WBGene00048401","IV",17018754,17018774,20
"21918","WBGene00048402","IV",16796737,16796757,20
"21919","WBGene00048404","IV",14359097,14359117,20
"21920","WBGene00048411","IV",15172650,15172670,20
"21921","WBGene00048413","IV",6133306,6133326,20
"21922","WBGene00048416","IV",15659424,15659444,20
"21923","WBGene00048420","IV",14475162,14475182,20
"21924","WBGene00048421","IV",15920445,15920465,20
"21925","WBGene00048426","IV",16362969,16362989,20
"21926","WBGene00048429","IV",5442300,5442320,20
"21927","WBGene00048436","IV",5717778,5717798,20
"21928","WBGene00048441","IV",15564401,15564421,20
"21929","WBGene00048443","IV",14763859,14763879,20
"21930","WBGene00048444","IV",15787637,15787657,20
"21931","WBGene00048445","IV",16022307,16022327,20
"21932","WBGene00048446","IV",15669213,15669233,20
"21933","WBGene00048453","IV",15002280,15002300,20
"21934","WBGene00048454","IV",15694481,15694501,20
"21935","WBGene00048455","IV",14902862,14902882,20
"21936","WBGene00048460","IV",14988732,14988752,20
"21937","WBGene00048462","IV",16020135,16020155,20
"21938","WBGene00048463","IV",14469862,14469882,20
"21939","WBGene00048464","IV",14677427,14677447,20
"21940","WBGene00048473","IV",15989734,15989754,20
"21941","WBGene00048475","IV",15316117,15316137,20
"21942","WBGene00048477","IV",13935364,13935384,20
"21943","WBGene00048484","IV",4883039,4883059,20
"21944","WBGene00048485","IV",14998606,14998626,20
"21945","WBGene00048489","IV",14262630,14262650,20
"21946","WBGene00048493","IV",17248453,17248473,20
"21947","WBGene00048495","IV",15583542,15583562,20
"21948","WBGene00048497","IV",16914655,16914675,20
"21949","WBGene00048510","IV",15614847,15614867,20
"21950","WBGene00048512","IV",16014823,16014843,20
"21951","WBGene00048514","IV",14120473,14120493,20
"21952","WBGene00048518","IV",5951929,5951949,20
"21953","WBGene00048521","IV",14681730,14681750,20
"21954","WBGene00048522","IV",6075783,6075803,20
"21955","WBGene00048523","IV",13948886,13948906,20
"21956","WBGene00048525","IV",13706187,13706207,20
"21957","WBGene00048530","IV",14029460,14029480,20
"21958","WBGene00048534","IV",16891270,16891290,20
"21959","WBGene00048538","IV",16658094,16658114,20
"21960","WBGene00048542","IV",14682134,14682154,20
"21961","WBGene00048543","IV",16041904,16041924,20
"21962","WBGene00048546","IV",14526400,14526420,20
"21963","WBGene00048549","IV",14868670,14868690,20
"21964","WBGene00048550","IV",15209629,15209649,20
"21965","WBGene00048552","IV",15386083,15386103,20
"21966","WBGene00048553","IV",15704424,15704444,20
"21967","WBGene00048554","IV",15984981,15985001,20
"21968","WBGene00048557","IV",14720449,14720469,20
"21969","WBGene00048559","IV",15810667,15810687,20
"21970","WBGene00048560","IV",5585585,5585605,20
"21971","WBGene00048561","IV",15356020,15356040,20
"21972","WBGene00048564","IV",14752814,14752834,20
"21973","WBGene00048570","IV",14608500,14608520,20
"21974","WBGene00048571","IV",16164237,16164257,20
"21975","WBGene00048572","IV",15143405,15143425,20
"21976","WBGene00048573","IV",14914292,14914312,20
"21977","WBGene00048574","IV",13756776,13756796,20
"21978","WBGene00048576","IV",15707008,15707028,20
"21979","WBGene00048577","IV",5579331,5579351,20
"21980","WBGene00048581","IV",16433318,16433338,20
"21981","WBGene00048582","IV",15266732,15266752,20
"21982","WBGene00048585","IV",16877995,16878015,20
"21983","WBGene00048588","IV",16448403,16448423,20
"21984","WBGene00048590","IV",15210962,15210982,20
"21985","WBGene00048593","IV",15839015,15839035,20
"21986","WBGene00048596","IV",15813596,15813616,20
"21987","WBGene00048600","IV",16225647,16225667,20
"21988","WBGene00048601","IV",14581096,14581116,20
"21989","WBGene00048604","IV",15820623,15820643,20
"21990","WBGene00048609","IV",14432126,14432146,20
"21991","WBGene00048610","IV",14055240,14055260,20
"21992","WBGene00048611","IV",16667931,16667951,20
"21993","WBGene00048613","IV",14259686,14259706,20
"21994","WBGene00048614","IV",15385771,15385791,20
"21995","WBGene00048615","IV",13906594,13906614,20
"21996","WBGene00048616","IV",13730620,13730640,20
"21997","WBGene00048617","IV",14167663,14167683,20
"21998","WBGene00048618","IV",14835776,14835796,20
"21999","WBGene00048621","IV",17177460,17177480,20
"22000","WBGene00048622","IV",14564076,14564096,20
"22001","WBGene00048626","IV",5952980,5953000,20
"22002","WBGene00048627","IV",16524294,16524314,20
"22003","WBGene00048628","IV",15810243,15810263,20
"22004","WBGene00048629","IV",13631260,13631280,20
"22005","WBGene00048631","IV",5429617,5429637,20
"22006","WBGene00048632","IV",14994104,14994124,20
"22007","WBGene00048633","IV",6049077,6049097,20
"22008","WBGene00048634","IV",13904344,13904364,20
"22009","WBGene00048637","IV",16560228,16560248,20
"22010","WBGene00048638","IV",14685689,14685709,20
"22011","WBGene00048644","IV",14268370,14268390,20
"22012","WBGene00048646","IV",14495696,14495716,20
"22013","WBGene00048647","IV",14327993,14328013,20
"22014","WBGene00048648","IV",15722266,15722286,20
"22015","WBGene00048650","IV",14230933,14230953,20
"22016","WBGene00048651","IV",16385994,16386014,20
"22017","WBGene00048652","IV",15977193,15977213,20
"22018","WBGene00048653","IV",14679419,14679439,20
"22019","WBGene00048654","IV",17218162,17218182,20
"22020","WBGene00048655","IV",13907116,13907136,20
"22021","WBGene00048657","IV",16538189,16538209,20
"22022","WBGene00048660","IV",15319383,15319403,20
"22023","WBGene00048662","IV",15133733,15133753,20
"22024","WBGene00048664","IV",5829010,5829030,20
"22025","WBGene00048669","IV",15332425,15332445,20
"22026","WBGene00048674","IV",14979069,14979089,20
"22027","WBGene00048676","IV",15722764,15722784,20
"22028","WBGene00048677","IV",15214364,15214384,20
"22029","WBGene00048679","IV",15002745,15002765,20
"22030","WBGene00048680","IV",14119582,14119602,20
"22031","WBGene00048684","IV",15731115,15731135,20
"22032","WBGene00048688","IV",14366556,14366576,20
"22033","WBGene00048690","IV",14654283,14654303,20
"22034","WBGene00048697","IV",16709410,16709430,20
"22035","WBGene00048699","IV",15495216,15495236,20
"22036","WBGene00048700","IV",16748965,16748985,20
"22037","WBGene00048701","IV",15690570,15690590,20
"22038","WBGene00048703","IV",14503388,14503408,20
"22039","WBGene00048705","IV",14484830,14484850,20
"22040","WBGene00048709","IV",15103103,15103123,20
"22041","WBGene00048711","IV",14008041,14008061,20
"22042","WBGene00048718","IV",5348541,5348561,20
"22043","WBGene00048721","IV",15214892,15214912,20
"22044","WBGene00048724","IV",14180404,14180424,20
"22045","WBGene00048725","IV",6503247,6503267,20
"22046","WBGene00048727","IV",14372972,14372992,20
"22047","WBGene00048730","IV",16790508,16790528,20
"22048","WBGene00048734","IV",15988459,15988479,20
"22049","WBGene00048735","IV",15567024,15567044,20
"22050","WBGene00048736","IV",15329475,15329495,20
"22051","WBGene00048738","IV",6047254,6047274,20
"22052","WBGene00048740","IV",14286533,14286553,20
"22053","WBGene00048748","IV",14136749,14136769,20
"22054","WBGene00048751","IV",14228321,14228341,20
"22055","WBGene00048753","IV",13829221,13829241,20
"22056","WBGene00048756","IV",14389723,14389743,20
"22057","WBGene00048760","IV",14165314,14165334,20
"22058","WBGene00048767","IV",16820360,16820380,20
"22059","WBGene00048768","IV",16773412,16773432,20
"22060","WBGene00048771","IV",16589051,16589071,20
"22061","WBGene00048779","IV",15705043,15705063,20
"22062","WBGene00048782","IV",15551450,15551470,20
"22063","WBGene00048783","IV",14946426,14946446,20
"22064","WBGene00048784","IV",6452398,6452418,20
"22065","WBGene00048786","IV",5102542,5102562,20
"22066","WBGene00048787","IV",15537643,15537663,20
"22067","WBGene00048788","IV",16394982,16395002,20
"22068","WBGene00048790","IV",14493007,14493027,20
"22069","WBGene00048791","IV",15900538,15900558,20
"22070","WBGene00048793","IV",16142853,16142873,20
"22071","WBGene00048799","IV",15821100,15821120,20
"22072","WBGene00048802","IV",16029636,16029656,20
"22073","WBGene00048808","IV",6171882,6171902,20
"22074","WBGene00048811","IV",15170820,15170840,20
"22075","WBGene00048813","IV",14883592,14883612,20
"22076","WBGene00048817","IV",5195759,5195779,20
"22077","WBGene00048820","IV",14962948,14962968,20
"22078","WBGene00048832","IV",15328740,15328760,20
"22079","WBGene00048835","IV",5822908,5822928,20
"22080","WBGene00048836","IV",5155915,5155935,20
"22081","WBGene00048838","IV",16188508,16188528,20
"22082","WBGene00048847","IV",15996244,15996264,20
"22083","WBGene00048849","IV",5502339,5502359,20
"22084","WBGene00048850","IV",15264338,15264358,20
"22085","WBGene00048855","IV",5600980,5601000,20
"22086","WBGene00048861","IV",13926545,13926565,20
"22087","WBGene00048863","IV",14562752,14562772,20
"22088","WBGene00048866","IV",15274637,15274657,20
"22089","WBGene00048868","IV",15725355,15725375,20
"22090","WBGene00048873","IV",6169660,6169680,20
"22091","WBGene00048874","IV",5955446,5955466,20
"22092","WBGene00048876","IV",15474317,15474337,20
"22093","WBGene00048880","IV",16478306,16478326,20
"22094","WBGene00048883","IV",14488658,14488678,20
"22095","WBGene00048885","IV",14391224,14391244,20
"22096","WBGene00048886","IV",16076876,16076896,20
"22097","WBGene00048887","IV",15995445,15995465,20
"22098","WBGene00048889","IV",5970859,5970879,20
"22099","WBGene00048891","IV",16687989,16688009,20
"22100","WBGene00048893","IV",16363503,16363523,20
"22101","WBGene00048895","IV",16157696,16157716,20
"22102","WBGene00048897","IV",5168936,5168956,20
"22103","WBGene00048898","IV",14444226,14444246,20
"22104","WBGene00048899","IV",6396922,6396942,20
"22105","WBGene00048900","IV",6053254,6053274,20
"22106","WBGene00048905","IV",16609509,16609529,20
"22107","WBGene00048906","IV",15261027,15261047,20
"22108","WBGene00048908","IV",14118771,14118791,20
"22109","WBGene00048909","IV",16571218,16571238,20
"22110","WBGene00048910","IV",14361698,14361718,20
"22111","WBGene00048911","IV",14273069,14273089,20
"22112","WBGene00048914","IV",14990443,14990463,20
"22113","WBGene00048915","IV",15723260,15723280,20
"22114","WBGene00048919","IV",14643811,14643831,20
"22115","WBGene00048923","IV",15387180,15387200,20
"22116","WBGene00048924","IV",5972260,5972280,20
"22117","WBGene00048925","IV",14618007,14618027,20
"22118","WBGene00048930","IV",14660204,14660224,20
"22119","WBGene00048936","IV",5515192,5515212,20
"22120","WBGene00048938","IV",15111259,15111279,20
"22121","WBGene00048939","IV",15291666,15291686,20
"22122","WBGene00048940","IV",6472779,6472799,20
"22123","WBGene00048949","IV",15135926,15135946,20
"22124","WBGene00048951","IV",16383082,16383102,20
"22125","WBGene00048954","IV",5820533,5820553,20
"22126","WBGene00048955","IV",16672049,16672069,20
"22127","WBGene00048959","IV",5568025,5568045,20
"22128","WBGene00048960","IV",14243787,14243807,20
"22129","WBGene00048966","IV",14365824,14365844,20
"22130","WBGene00048970","IV",6114790,6114810,20
"22131","WBGene00048971","IV",16473003,16473023,20
"22132","WBGene00048974","IV",15431662,15431682,20
"22133","WBGene00048976","IV",15436500,15436520,20
"22134","WBGene00048977","IV",14131646,14131666,20
"22135","WBGene00048978","IV",5206341,5206361,20
"22136","WBGene00048979","IV",15711990,15712010,20
"22137","WBGene00048980","IV",14885301,14885321,20
"22138","WBGene00048983","IV",5583665,5583685,20
"22139","WBGene00048984","IV",14665749,14665769,20
"22140","WBGene00048990","IV",13693088,13693108,20
"22141","WBGene00048992","IV",15263856,15263876,20
"22142","WBGene00048993","IV",16523909,16523929,20
"22143","WBGene00048997","IV",15286082,15286102,20
"22144","WBGene00049000","IV",15137553,15137573,20
"22145","WBGene00049001","IV",5605685,5605705,20
"22146","WBGene00049005","IV",5586755,5586775,20
"22147","WBGene00049011","IV",16791235,16791255,20
"22148","WBGene00049012","IV",13951563,13951583,20
"22149","WBGene00049014","IV",15586216,15586236,20
"22150","WBGene00049015","IV",5823238,5823258,20
"22151","WBGene00049017","IV",5716815,5716835,20
"22152","WBGene00049020","IV",14900069,14900089,20
"22153","WBGene00049022","IV",14286769,14286789,20
"22154","WBGene00049024","IV",14708212,14708232,20
"22155","WBGene00049027","IV",15691022,15691042,20
"22156","WBGene00049034","IV",16784114,16784134,20
"22157","WBGene00049036","IV",15998838,15998858,20
"22158","WBGene00049037","IV",13907293,13907313,20
"22159","WBGene00049038","IV",16141406,16141426,20
"22160","WBGene00049041","IV",13700705,13700725,20
"22161","WBGene00049043","IV",13727574,13727594,20
"22162","WBGene00049047","IV",13693337,13693357,20
"22163","WBGene00049048","IV",15659329,15659349,20
"22164","WBGene00049049","IV",14909815,14909835,20
"22165","WBGene00049052","IV",16831007,16831027,20
"22166","WBGene00049053","IV",15111466,15111486,20
"22167","WBGene00049057","IV",15395751,15395771,20
"22168","WBGene00049058","IV",16025969,16025989,20
"22169","WBGene00049059","IV",16477068,16477088,20
"22170","WBGene00049061","IV",14178201,14178221,20
"22171","WBGene00049064","IV",14054964,14054984,20
"22172","WBGene00049066","IV",14700935,14700955,20
"22173","WBGene00049068","IV",13826310,13826330,20
"22174","WBGene00049069","IV",14700330,14700350,20
"22175","WBGene00049070","IV",6112206,6112226,20
"22176","WBGene00049071","IV",13871731,13871751,20
"22177","WBGene00049072","IV",14682363,14682383,20
"22178","WBGene00049073","IV",14943409,14943429,20
"22179","WBGene00049076","IV",15727142,15727162,20
"22180","WBGene00049079","IV",15347567,15347587,20
"22181","WBGene00049080","IV",16526549,16526569,20
"22182","WBGene00049086","IV",6115482,6115502,20
"22183","WBGene00049087","IV",15377311,15377331,20
"22184","WBGene00049088","IV",5823980,5824000,20
"22185","WBGene00049090","IV",5838557,5838577,20
"22186","WBGene00049094","IV",15357814,15357834,20
"22187","WBGene00049097","IV",14579442,14579462,20
"22188","WBGene00049101","IV",14640090,14640110,20
"22189","WBGene00049109","IV",15666732,15666752,20
"22190","WBGene00049112","IV",13891286,13891306,20
"22191","WBGene00049113","IV",14271453,14271473,20
"22192","WBGene00049119","IV",14262210,14262230,20
"22193","WBGene00049122","IV",15164560,15164580,20
"22194","WBGene00049123","IV",14373602,14373622,20
"22195","WBGene00049124","IV",15500791,15500811,20
"22196","WBGene00049129","IV",14002152,14002172,20
"22197","WBGene00049130","IV",13836909,13836929,20
"22198","WBGene00049131","IV",16662888,16662908,20
"22199","WBGene00049135","IV",14086204,14086224,20
"22200","WBGene00049143","IV",14510203,14510223,20
"22201","WBGene00049146","IV",16382663,16382683,20
"22202","WBGene00049147","IV",16639916,16639936,20
"22203","WBGene00049148","IV",16597333,16597353,20
"22204","WBGene00049151","IV",14607023,14607043,20
"22205","WBGene00049152","IV",14176887,14176907,20
"22206","WBGene00049153","IV",6480089,6480109,20
"22207","WBGene00049154","IV",14972805,14972825,20
"22208","WBGene00049155","IV",14864248,14864268,20
"22209","WBGene00049158","IV",5518662,5518682,20
"22210","WBGene00049159","IV",5980463,5980483,20
"22211","WBGene00049161","IV",15834968,15834988,20
"22212","WBGene00049162","IV",13714396,13714416,20
"22213","WBGene00049163","IV",14642810,14642830,20
"22214","WBGene00049165","IV",14265984,14266004,20
"22215","WBGene00049172","IV",5819782,5819802,20
"22216","WBGene00049174","IV",15797020,15797040,20
"22217","WBGene00049176","IV",14917499,14917519,20
"22218","WBGene00049177","IV",14899637,14899657,20
"22219","WBGene00049178","IV",14001456,14001476,20
"22220","WBGene00049179","IV",14697978,14697998,20
"22221","WBGene00049186","IV",16156085,16156105,20
"22222","WBGene00049189","IV",14508849,14508869,20
"22223","WBGene00049190","IV",5767644,5767664,20
"22224","WBGene00049192","IV",14424498,14424518,20
"22225","WBGene00049193","IV",14445766,14445786,20
"22226","WBGene00049198","IV",14581290,14581310,20
"22227","WBGene00049204","IV",15628970,15628990,20
"22228","WBGene00049213","IV",16689454,16689474,20
"22229","WBGene00049214","IV",17033726,17033746,20
"22230","WBGene00049218","IV",14653585,14653605,20
"22231","WBGene00049219","IV",13866333,13866353,20
"22232","WBGene00049222","IV",16116681,16116701,20
"22233","WBGene00049223","IV",13680505,13680525,20
"22234","WBGene00049226","IV",5707498,5707518,20
"22235","WBGene00049228","IV",14995498,14995518,20
"22236","WBGene00049232","IV",13756600,13756620,20
"22237","WBGene00049237","IV",16144085,16144105,20
"22238","WBGene00049238","IV",14437886,14437906,20
"22239","WBGene00049239","IV",14093199,14093219,20
"22240","WBGene00049240","IV",15946362,15946382,20
"22241","WBGene00049241","IV",14364667,14364687,20
"22242","WBGene00049245","IV",16177136,16177156,20
"22243","WBGene00049246","IV",16078510,16078530,20
"22244","WBGene00049248","IV",17039821,17039841,20
"22245","WBGene00049251","IV",16011114,16011134,20
"22246","WBGene00049252","IV",5097964,5097984,20
"22247","WBGene00049254","IV",15228810,15228830,20
"22248","WBGene00049258","IV",14625852,14625872,20
"22249","WBGene00049263","IV",16202874,16202894,20
"22250","WBGene00049268","IV",5852502,5852522,20
"22251","WBGene00049271","IV",15663005,15663025,20
"22252","WBGene00049272","IV",5097765,5097785,20
"22253","WBGene00049274","IV",5075442,5075462,20
"22254","WBGene00049277","IV",16443727,16443747,20
"22255","WBGene00049280","IV",5564128,5564148,20
"22256","WBGene00049282","IV",5854735,5854755,20
"22257","WBGene00049285","IV",16015910,16015930,20
"22258","WBGene00049290","IV",14225677,14225697,20
"22259","WBGene00049295","IV",4877088,4877108,20
"22260","WBGene00049297","IV",5830629,5830649,20
"22261","WBGene00049299","IV",15433766,15433786,20
"22262","WBGene00049300","IV",14816660,14816680,20
"22263","WBGene00049302","IV",5125920,5125940,20
"22264","WBGene00049303","IV",15959292,15959312,20
"22265","WBGene00049304","IV",14669020,14669040,20
"22266","WBGene00049310","IV",15746781,15746801,20
"22267","WBGene00049321","IV",14439204,14439224,20
"22268","WBGene00049322","IV",16749651,16749671,20
"22269","WBGene00049325","IV",14356792,14356812,20
"22270","WBGene00049326","IV",13953625,13953645,20
"22271","WBGene00049333","IV",17213723,17213743,20
"22272","WBGene00049334","IV",15132120,15132140,20
"22273","WBGene00049336","IV",6058266,6058286,20
"22274","WBGene00049340","IV",13878612,13878632,20
"22275","WBGene00049342","IV",14022254,14022274,20
"22276","WBGene00049346","IV",17067379,17067399,20
"22277","WBGene00049348","IV",14885533,14885553,20
"22278","WBGene00049349","IV",15271306,15271326,20
"22279","WBGene00049352","IV",14299479,14299499,20
"22280","WBGene00049353","IV",5603171,5603191,20
"22281","WBGene00049358","IV",16377039,16377059,20
"22282","WBGene00049359","IV",16130751,16130771,20
"22283","WBGene00049360","IV",13702436,13702456,20
"22284","WBGene00049362","IV",17209706,17209726,20
"22285","WBGene00049363","IV",14375746,14375766,20
"22286","WBGene00049368","IV",5734519,5734539,20
"22287","WBGene00049369","IV",16021590,16021610,20
"22288","WBGene00049371","IV",5417466,5417486,20
"22289","WBGene00049372","IV",15266621,15266641,20
"22290","WBGene00049373","IV",6447225,6447245,20
"22291","WBGene00049376","IV",15872438,15872458,20
"22292","WBGene00049379","IV",15714472,15714492,20
"22293","WBGene00049388","IV",15612597,15612617,20
"22294","WBGene00049392","IV",5829531,5829551,20
"22295","WBGene00049395","IV",15656284,15656304,20
"22296","WBGene00049399","IV",15582530,15582550,20
"22297","WBGene00049400","IV",16809403,16809423,20
"22298","WBGene00049403","IV",13733181,13733201,20
"22299","WBGene00049405","IV",17234161,17234181,20
"22300","WBGene00049408","IV",16671609,16671629,20
"22301","WBGene00049410","IV",14607913,14607933,20
"22302","WBGene00049411","IV",17073790,17073810,20
"22303","WBGene00049412","IV",16081847,16081867,20
"22304","WBGene00049414","IV",14462353,14462373,20
"22305","WBGene00049416","IV",13758037,13758057,20
"22306","WBGene00049422","IV",16020759,16020779,20
"22307","WBGene00049424","IV",14383693,14383713,20
"22308","WBGene00049426","IV",14335099,14335119,20
"22309","WBGene00049428","IV",13927872,13927892,20
"22310","WBGene00049429","IV",16745485,16745505,20
"22311","WBGene00049430","IV",14180736,14180756,20
"22312","WBGene00049434","IV",15385867,15385887,20
"22313","WBGene00049440","IV",15208045,15208065,20
"22314","WBGene00049445","IV",15796598,15796618,20
"22315","WBGene00049446","IV",16631659,16631679,20
"22316","WBGene00049452","IV",17184557,17184577,20
"22317","WBGene00049456","IV",5101932,5101952,20
"22318","WBGene00049460","IV",14448632,14448652,20
"22319","WBGene00049461","IV",16155260,16155280,20
"22320","WBGene00049463","IV",15136240,15136260,20
"22321","WBGene00049465","IV",15270493,15270513,20
"22322","WBGene00049466","IV",14024906,14024926,20
"22323","WBGene00049468","IV",16438296,16438316,20
"22324","WBGene00049469","IV",15698933,15698953,20
"22325","WBGene00049470","IV",16171372,16171392,20
"22326","WBGene00049475","IV",5283665,5283685,20
"22327","WBGene00049480","IV",15856171,15856191,20
"22328","WBGene00049485","IV",15373192,15373212,20
"22329","WBGene00049487","IV",5847197,5847217,20
"22330","WBGene00049495","IV",16623034,16623054,20
"22331","WBGene00049498","IV",15550366,15550386,20
"22332","WBGene00049500","IV",14471903,14471923,20
"22333","WBGene00049502","IV",13873154,13873174,20
"22334","WBGene00049504","IV",14473449,14473469,20
"22335","WBGene00049511","IV",5522310,5522330,20
"22336","WBGene00049513","IV",16609767,16609787,20
"22337","WBGene00049514","IV",14571141,14571161,20
"22338","WBGene00049516","IV",16578189,16578209,20
"22339","WBGene00049519","IV",14228793,14228813,20
"22340","WBGene00049524","IV",15676228,15676248,20
"22341","WBGene00049527","IV",17247337,17247357,20
"22342","WBGene00049531","IV",14482088,14482108,20
"22343","WBGene00049536","IV",16155556,16155576,20
"22344","WBGene00049537","IV",14947145,14947165,20
"22345","WBGene00049538","IV",15818908,15818928,20
"22346","WBGene00049539","IV",5171829,5171849,20
"22347","WBGene00049540","IV",14387276,14387296,20
"22348","WBGene00049543","IV",16081565,16081585,20
"22349","WBGene00049544","IV",16070535,16070555,20
"22350","WBGene00049545","IV",5717441,5717461,20
"22351","WBGene00049548","IV",14247108,14247128,20
"22352","WBGene00049551","IV",6049685,6049705,20
"22353","WBGene00049556","IV",17074978,17074998,20
"22354","WBGene00049557","IV",15386272,15386292,20
"22355","WBGene00049562","IV",5719806,5719826,20
"22356","WBGene00049563","IV",16003739,16003759,20
"22357","WBGene00049564","IV",16034064,16034084,20
"22358","WBGene00049569","IV",16028038,16028058,20
"22359","WBGene00049571","IV",16524912,16524932,20
"22360","WBGene00049572","IV",15406319,15406339,20
"22361","WBGene00049580","IV",14430122,14430142,20
"22362","WBGene00049581","IV",15661006,15661026,20
"22363","WBGene00049584","IV",6127005,6127025,20
"22364","WBGene00049586","IV",16661145,16661165,20
"22365","WBGene00049588","IV",16702765,16702785,20
"22366","WBGene00049590","IV",14127030,14127050,20
"22367","WBGene00049591","IV",17043938,17043958,20
"22368","WBGene00049593","IV",13960800,13960820,20
"22369","WBGene00049594","IV",14094927,14094947,20
"22370","WBGene00049598","IV",5075973,5075993,20
"22371","WBGene00049599","IV",15496367,15496387,20
"22372","WBGene00049601","IV",14606287,14606307,20
"22373","WBGene00049603","IV",13959035,13959055,20
"22374","WBGene00049607","IV",16076069,16076089,20
"22375","WBGene00049610","IV",14280818,14280838,20
"22376","WBGene00049615","IV",14812758,14812778,20
"22377","WBGene00049616","IV",14926733,14926753,20
"22378","WBGene00049621","IV",15658728,15658748,20
"22379","WBGene00049623","IV",13900974,13900994,20
"22380","WBGene00049627","IV",15366680,15366700,20
"22381","WBGene00049628","IV",5728643,5728663,20
"22382","WBGene00049629","IV",15989190,15989210,20
"22383","WBGene00049631","IV",15576242,15576262,20
"22384","WBGene00049632","IV",14684469,14684489,20
"22385","WBGene00049633","IV",6050109,6050129,20
"22386","WBGene00049634","IV",15856365,15856385,20
"22387","WBGene00049635","IV",15601511,15601531,20
"22388","WBGene00049636","IV",15948745,15948765,20
"22389","WBGene00049639","IV",17043310,17043330,20
"22390","WBGene00049640","IV",14318215,14318235,20
"22391","WBGene00049641","IV",14538688,14538708,20
"22392","WBGene00049642","IV",15968659,15968679,20
"22393","WBGene00049648","IV",14739292,14739312,20
"22394","WBGene00049649","IV",16384698,16384718,20
"22395","WBGene00049652","IV",5414034,5414054,20
"22396","WBGene00049654","IV",13635208,13635228,20
"22397","WBGene00049655","IV",4848176,4848196,20
"22398","WBGene00049656","IV",16548633,16548653,20
"22399","WBGene00049659","IV",15560939,15560959,20
"22400","WBGene00049662","IV",14995159,14995179,20
"22401","WBGene00049667","IV",14369966,14369986,20
"22402","WBGene00049670","IV",14221840,14221860,20
"22403","WBGene00049672","IV",13723101,13723121,20
"22404","WBGene00049674","IV",15210679,15210699,20
"22405","WBGene00049675","IV",13888840,13888860,20
"22406","WBGene00049676","IV",14723833,14723853,20
"22407","WBGene00049679","IV",15795513,15795533,20
"22408","WBGene00049684","IV",14961202,14961222,20
"22409","WBGene00049685","IV",13903548,13903568,20
"22410","WBGene00049688","IV",14388634,14388654,20
"22411","WBGene00049689","IV",5130792,5130812,20
"22412","WBGene00049690","IV",14928779,14928799,20
"22413","WBGene00049691","IV",15698147,15698167,20
"22414","WBGene00049694","IV",5706285,5706305,20
"22415","WBGene00049695","IV",15111869,15111889,20
"22416","WBGene00049696","IV",5775385,5775405,20
"22417","WBGene00049697","IV",16014195,16014215,20
"22418","WBGene00049698","IV",16606262,16606282,20
"22419","WBGene00049701","IV",14648573,14648593,20
"22420","WBGene00049704","IV",14250366,14250386,20
"22421","WBGene00049705","IV",14640910,14640930,20
"22422","WBGene00049712","IV",14248803,14248823,20
"22423","WBGene00049713","IV",14990219,14990239,20
"22424","WBGene00049718","IV",5800872,5800892,20
"22425","WBGene00049723","IV",13700230,13700250,20
"22426","WBGene00049727","IV",5565046,5565066,20
"22427","WBGene00049728","IV",16353637,16353657,20
"22428","WBGene00049730","IV",14125176,14125196,20
"22429","WBGene00049731","IV",13914908,13914928,20
"22430","WBGene00049735","IV",15702481,15702501,20
"22431","WBGene00049737","IV",14996548,14996568,20
"22432","WBGene00049740","IV",5906862,5906882,20
"22433","WBGene00049741","IV",5192686,5192706,20
"22434","WBGene00049742","IV",5107152,5107172,20
"22435","WBGene00049747","IV",14541971,14541991,20
"22436","WBGene00049749","IV",6063965,6063985,20
"22437","WBGene00049752","IV",14741303,14741323,20
"22438","WBGene00049754","IV",15312728,15312748,20
"22439","WBGene00049758","IV",16633635,16633655,20
"22440","WBGene00049759","IV",13643407,13643427,20
"22441","WBGene00049767","IV",14679207,14679227,20
"22442","WBGene00049768","IV",16134667,16134687,20
"22443","WBGene00049769","IV",13676028,13676048,20
"22444","WBGene00049775","IV",15112147,15112167,20
"22445","WBGene00049781","IV",14497268,14497288,20
"22446","WBGene00049783","IV",16386633,16386653,20
"22447","WBGene00049786","IV",15261356,15261376,20
"22448","WBGene00049789","IV",15178080,15178100,20
"22449","WBGene00049790","IV",16603846,16603866,20
"22450","WBGene00049796","IV",15388021,15388041,20
"22451","WBGene00049797","IV",14901133,14901153,20
"22452","WBGene00049798","IV",15399771,15399791,20
"22453","WBGene00049800","IV",14984576,14984596,20
"22454","WBGene00049804","IV",17213552,17213572,20
"22455","WBGene00049807","IV",5560605,5560625,20
"22456","WBGene00049809","IV",14710000,14710020,20
"22457","WBGene00049811","IV",17220989,17221009,20
"22458","WBGene00049814","IV",16908391,16908411,20
"22459","WBGene00049815","IV",13941355,13941375,20
"22460","WBGene00049818","IV",14380855,14380875,20
"22461","WBGene00049829","IV",14942199,14942219,20
"22462","WBGene00049830","IV",16522048,16522068,20
"22463","WBGene00049832","IV",14699948,14699968,20
"22464","WBGene00049835","IV",6445853,6445873,20
"22465","WBGene00049836","IV",16530598,16530618,20
"22466","WBGene00049838","IV",14925219,14925239,20
"22467","WBGene00049839","IV",14973763,14973783,20
"22468","WBGene00049840","IV",15924015,15924035,20
"22469","WBGene00049841","IV",14609338,14609358,20
"22470","WBGene00049845","IV",15383183,15383203,20
"22471","WBGene00049846","IV",5928231,5928251,20
"22472","WBGene00049849","IV",14903884,14903904,20
"22473","WBGene00049853","IV",14272391,14272411,20
"22474","WBGene00049855","IV",14311291,14311311,20
"22475","WBGene00049858","IV",14558371,14558391,20
"22476","WBGene00049860","IV",14678624,14678644,20
"22477","WBGene00049861","IV",13919657,13919677,20
"22478","WBGene00049863","IV",14500050,14500070,20
"22479","WBGene00049870","IV",16016057,16016077,20
"22480","WBGene00049871","IV",15367088,15367108,20
"22481","WBGene00049875","IV",16036778,16036798,20
"22482","WBGene00049877","IV",16013413,16013433,20
"22483","WBGene00049878","IV",14908834,14908854,20
"22484","WBGene00049879","IV",15071959,15071979,20
"22485","WBGene00049880","IV",5711382,5711402,20
"22486","WBGene00049881","IV",6126653,6126673,20
"22487","WBGene00049884","IV",16126490,16126510,20
"22488","WBGene00049886","IV",14085611,14085631,20
"22489","WBGene00049887","IV",14091588,14091608,20
"22490","WBGene00049888","IV",14222748,14222768,20
"22491","WBGene00049890","IV",16474443,16474463,20
"22492","WBGene00049891","IV",5170668,5170688,20
"22493","WBGene00049893","IV",14737189,14737209,20
"22494","WBGene00049897","IV",17073544,17073564,20
"22495","WBGene00049899","IV",14482923,14482943,20
"22496","WBGene00049900","IV",5705152,5705172,20
"22497","WBGene00049902","IV",6174633,6174653,20
"22498","WBGene00049907","IV",15975516,15975536,20
"22499","WBGene00049909","IV",14967122,14967142,20
"22500","WBGene00049912","IV",15775892,15775912,20
"22501","WBGene00049913","IV",5139765,5139785,20
"22502","WBGene00049914","IV",14463329,14463349,20
"22503","WBGene00049915","IV",6048154,6048174,20
"22504","WBGene00049917","IV",14654040,14654060,20
"22505","WBGene00049919","IV",15357157,15357177,20
"22506","WBGene00049921","IV",16814716,16814736,20
"22507","WBGene00049922","IV",15275636,15275656,20
"22508","WBGene00049926","IV",6128382,6128402,20
"22509","WBGene00049928","IV",16479064,16479084,20
"22510","WBGene00049930","IV",15482382,15482402,20
"22511","WBGene00049932","IV",5427835,5427855,20
"22512","WBGene00049933","IV",5967703,5967723,20
"22513","WBGene00049934","IV",16595704,16595724,20
"22514","WBGene00049936","IV",13681894,13681914,20
"22515","WBGene00049939","IV",14904503,14904523,20
"22516","WBGene00049942","IV",14036296,14036316,20
"22517","WBGene00049943","IV",14836135,14836155,20
"22518","WBGene00049945","IV",14895675,14895695,20
"22519","WBGene00049946","IV",13905070,13905090,20
"22520","WBGene00049947","IV",14128842,14128862,20
"22521","WBGene00049948","IV",14812054,14812074,20
"22522","WBGene00049951","IV",15248944,15248964,20
"22523","WBGene00049952","IV",5587218,5587238,20
"22524","WBGene00049954","IV",5843310,5843330,20
"22525","WBGene00049957","IV",15106524,15106544,20
"22526","WBGene00049959","IV",14299920,14299940,20
"22527","WBGene00049960","IV",14876111,14876131,20
"22528","WBGene00049968","IV",5834988,5835008,20
"22529","WBGene00049971","IV",5282927,5282947,20
"22530","WBGene00049977","IV",14707799,14707819,20
"22531","WBGene00049979","IV",5320422,5320442,20
"22532","WBGene00049981","IV",5321321,5321341,20
"22533","WBGene00049984","IV",14440517,14440537,20
"22534","WBGene00049987","IV",14849851,14849871,20
"22535","WBGene00049988","IV",14324968,14324988,20
"22536","WBGene00049991","IV",14092909,14092929,20
"22537","WBGene00049992","IV",15989441,15989461,20
"22538","WBGene00049995","IV",6158929,6158949,20
"22539","WBGene00049996","IV",13710975,13710995,20
"22540","WBGene00049997","IV",13929034,13929054,20
"22541","WBGene00049998","IV",13721895,13721915,20
"22542","WBGene00049999","IV",15533986,15534006,20
"22543","WBGene00050004","IV",5212725,5212745,20
"22544","WBGene00050007","IV",15662267,15662287,20
"22545","WBGene00050008","IV",14866269,14866289,20
"22546","WBGene00050014","IV",14300359,14300379,20
"22547","WBGene00050016","IV",5525887,5525907,20
"22548","WBGene00050022","IV",5906402,5906422,20
"22549","WBGene00050025","IV",16625225,16625245,20
"22550","WBGene00050026","IV",15904814,15904834,20
"22551","WBGene00050028","IV",16033552,16033572,20
"22552","WBGene00050030","IV",5820046,5820066,20
"22553","WBGene00050032","IV",5504859,5504879,20
"22554","WBGene00050035","IV",15963488,15963508,20
"22555","WBGene00050036","IV",14854885,14854905,20
"22556","WBGene00050038","IV",5402571,5402591,20
"22557","WBGene00050040","IV",5602068,5602088,20
"22558","WBGene00050048","IV",14400823,14400843,20
"22559","WBGene00050049","IV",14303123,14303143,20
"22560","WBGene00050050","IV",16811916,16811936,20
"22561","WBGene00050051","IV",5031210,5031230,20
"22562","WBGene00050057","IV",16575752,16575772,20
"22563","WBGene00050059","IV",5854893,5854913,20
"22564","WBGene00050060","IV",5323996,5324016,20
"22565","WBGene00050064","IV",15683483,15683503,20
"22566","WBGene00050065","IV",14170372,14170392,20
"22567","WBGene00050069","IV",14528805,14528825,20
"22568","WBGene00050070","IV",5860415,5860435,20
"22569","WBGene00050071","IV",13939090,13939110,20
"22570","WBGene00050073","IV",5155699,5155719,20
"22571","WBGene00050074","IV",14100344,14100364,20
"22572","WBGene00050075","IV",14399308,14399328,20
"22573","WBGene00050078","IV",14539651,14539671,20
"22574","WBGene00050080","IV",16131757,16131777,20
"22575","WBGene00050082","IV",17248625,17248645,20
"22576","WBGene00050086","IV",15401157,15401177,20
"22577","WBGene00050087","IV",15538916,15538936,20
"22578","WBGene00050089","IV",15535614,15535634,20
"22579","WBGene00050090","IV",15309939,15309959,20
"22580","WBGene00050094","IV",13914730,13914750,20
"22581","WBGene00050095","IV",14279584,14279604,20
"22582","WBGene00050096","IV",14973610,14973630,20
"22583","WBGene00050104","IV",13944266,13944286,20
"22584","WBGene00050106","IV",16537902,16537922,20
"22585","WBGene00050108","IV",14986561,14986581,20
"22586","WBGene00050114","IV",15724746,15724766,20
"22587","WBGene00050117","IV",16022109,16022129,20
"22588","WBGene00050118","IV",14893650,14893670,20
"22589","WBGene00050120","IV",13689781,13689801,20
"22590","WBGene00050123","IV",15094948,15094968,20
"22591","WBGene00050137","IV",14378343,14378363,20
"22592","WBGene00050142","IV",13760592,13760612,20
"22593","WBGene00050145","IV",14882840,14882860,20
"22594","WBGene00050148","IV",14281089,14281109,20
"22595","WBGene00050152","IV",15716605,15716625,20
"22596","WBGene00050154","IV",15332883,15332903,20
"22597","WBGene00050155","IV",14043558,14043578,20
"22598","WBGene00050169","IV",15717208,15717228,20
"22599","WBGene00050174","IV",17047572,17047592,20
"22600","WBGene00050179","IV",5822825,5822845,20
"22601","WBGene00050182","IV",5324591,5324611,20
"22602","WBGene00050183","IV",13730118,13730138,20
"22603","WBGene00050187","IV",5615778,5615798,20
"22604","WBGene00050188","IV",15820253,15820273,20
"22605","WBGene00050190","IV",14830867,14830887,20
"22606","WBGene00050194","IV",15673823,15673843,20
"22607","WBGene00050197","IV",14035577,14035597,20
"22608","WBGene00050203","IV",16019380,16019400,20
"22609","WBGene00050205","IV",15269692,15269712,20
"22610","WBGene00050206","IV",14037140,14037160,20
"22611","WBGene00050210","IV",16792421,16792441,20
"22612","WBGene00050211","IV",16068254,16068274,20
"22613","WBGene00050212","IV",16540137,16540157,20
"22614","WBGene00050213","IV",14946064,14946084,20
"22615","WBGene00050214","IV",15751404,15751424,20
"22616","WBGene00050217","IV",15688401,15688421,20
"22617","WBGene00050218","IV",14890551,14890571,20
"22618","WBGene00050224","IV",15980476,15980496,20
"22619","WBGene00050225","IV",5152062,5152082,20
"22620","WBGene00050226","IV",14237356,14237376,20
"22621","WBGene00050230","IV",14471813,14471833,20
"22622","WBGene00050232","IV",16356927,16356947,20
"22623","WBGene00050233","IV",15988094,15988114,20
"22624","WBGene00050234","IV",13747619,13747639,20
"22625","WBGene00050245","IV",14975701,14975721,20
"22626","WBGene00050246","IV",15654600,15654620,20
"22627","WBGene00050250","IV",14001733,14001753,20
"22628","WBGene00050251","IV",15617251,15617271,20
"22629","WBGene00050252","IV",14049719,14049739,20
"22630","WBGene00050253","IV",17185927,17185947,20
"22631","WBGene00050255","IV",5520565,5520585,20
"22632","WBGene00050256","IV",15698043,15698063,20
"22633","WBGene00050260","IV",15003267,15003287,20
"22634","WBGene00050261","IV",16194552,16194572,20
"22635","WBGene00050262","IV",14183567,14183587,20
"22636","WBGene00050263","IV",16479736,16479756,20
"22637","WBGene00050265","IV",16187383,16187403,20
"22638","WBGene00050268","IV",14495189,14495209,20
"22639","WBGene00050269","IV",5128859,5128879,20
"22640","WBGene00050271","IV",14888863,14888883,20
"22641","WBGene00050272","IV",16077504,16077524,20
"22642","WBGene00050273","IV",15001995,15002015,20
"22643","WBGene00050278","IV",5621165,5621185,20
"22644","WBGene00050279","IV",16540388,16540408,20
"22645","WBGene00050281","IV",5778931,5778951,20
"22646","WBGene00050290","IV",17224792,17224812,20
"22647","WBGene00050293","IV",14313466,14313486,20
"22648","WBGene00050297","IV",16609921,16609941,20
"22649","WBGene00050298","IV",17170772,17170792,20
"22650","WBGene00050300","IV",16870493,16870513,20
"22651","WBGene00050301","IV",13866110,13866130,20
"22652","WBGene00050302","IV",14265218,14265238,20
"22653","WBGene00050303","IV",15073713,15073733,20
"22654","WBGene00050310","IV",5341653,5341673,20
"22655","WBGene00050317","IV",15264207,15264227,20
"22656","WBGene00050320","IV",15863697,15863717,20
"22657","WBGene00050329","IV",14557701,14557721,20
"22658","WBGene00050332","IV",15147517,15147537,20
"22659","WBGene00050340","IV",15952230,15952250,20
"22660","WBGene00050344","IV",16035463,16035483,20
"22661","WBGene00050349","IV",16669629,16669649,20
"22662","WBGene00050350","IV",15654972,15654992,20
"22663","WBGene00050353","IV",16187064,16187084,20
"22664","WBGene00050357","IV",15822176,15822196,20
"22665","WBGene00050362","IV",16833561,16833581,20
"22666","WBGene00050363","IV",16887380,16887400,20
"22667","WBGene00050364","IV",15612149,15612169,20
"22668","WBGene00050367","IV",15820895,15820915,20
"22669","WBGene00050374","IV",15661904,15661924,20
"22670","WBGene00050379","IV",14438901,14438921,20
"22671","WBGene00050381","IV",13863915,13863935,20
"22672","WBGene00050387","IV",6490998,6491018,20
"22673","WBGene00050390","IV",5507312,5507332,20
"22674","WBGene00050391","IV",16022809,16022829,20
"22675","WBGene00050394","IV",14833816,14833836,20
"22676","WBGene00050397","IV",15273064,15273084,20
"22677","WBGene00050398","IV",14962752,14962772,20
"22678","WBGene00050399","IV",14651885,14651905,20
"22679","WBGene00050400","IV",16006915,16006935,20
"22680","WBGene00050401","IV",13764125,13764145,20
"22681","WBGene00050404","IV",13959883,13959903,20
"22682","WBGene00050405","IV",14647152,14647172,20
"22683","WBGene00050408","IV",16456809,16456829,20
"22684","WBGene00050409","IV",16043696,16043716,20
"22685","WBGene00050414","IV",14873405,14873425,20
"22686","WBGene00050415","IV",14338596,14338616,20
"22687","WBGene00050416","IV",16075215,16075235,20
"22688","WBGene00050417","IV",5189523,5189543,20
"22689","WBGene00050418","IV",15066263,15066283,20
"22690","WBGene00050419","IV",13889768,13889788,20
"22691","WBGene00050424","IV",15929386,15929406,20
"22692","WBGene00050425","IV",14723420,14723440,20
"22693","WBGene00050429","IV",14495458,14495478,20
"22694","WBGene00050430","IV",15238515,15238535,20
"22695","WBGene00050433","IV",15949365,15949385,20
"22696","WBGene00050434","IV",16828981,16829001,20
"22697","WBGene00050436","IV",5519607,5519627,20
"22698","WBGene00050441","IV",15497746,15497766,20
"22699","WBGene00050442","IV",5745884,5745904,20
"22700","WBGene00050444","IV",13911556,13911576,20
"22701","WBGene00050447","IV",15360630,15360650,20
"22702","WBGene00050449","IV",14811960,14811980,20
"22703","WBGene00050451","IV",5953558,5953578,20
"22704","WBGene00050453","IV",15118038,15118058,20
"22705","WBGene00050456","IV",14273320,14273340,20
"22706","WBGene00050466","IV",16835929,16835949,20
"22707","WBGene00050470","IV",16176442,16176462,20
"22708","WBGene00050472","IV",14263939,14263959,20
"22709","WBGene00050476","IV",14678165,14678185,20
"22710","WBGene00050477","IV",5339210,5339230,20
"22711","WBGene00050484","IV",15970447,15970467,20
"22712","WBGene00050487","IV",15838652,15838672,20
"22713","WBGene00050489","IV",14736998,14737018,20
"22714","WBGene00050490","IV",16069173,16069193,20
"22715","WBGene00050491","IV",14318369,14318389,20
"22716","WBGene00050495","IV",14366277,14366297,20
"22717","WBGene00050498","IV",15811322,15811342,20
"22718","WBGene00050500","IV",14742176,14742196,20
"22719","WBGene00050502","IV",15707821,15707841,20
"22720","WBGene00050506","IV",14676906,14676926,20
"22721","WBGene00050508","IV",17162999,17163019,20
"22722","WBGene00050515","IV",15824925,15824945,20
"22723","WBGene00050516","IV",5957969,5957989,20
"22724","WBGene00050519","IV",17026781,17026801,20
"22725","WBGene00050520","IV",4835578,4835598,20
"22726","WBGene00050527","IV",16166794,16166814,20
"22727","WBGene00050528","IV",14268371,14268391,20
"22728","WBGene00050532","IV",14315738,14315758,20
"22729","WBGene00050533","IV",5859006,5859026,20
"22730","WBGene00050537","IV",16362132,16362152,20
"22731","WBGene00050538","IV",16163302,16163322,20
"22732","WBGene00050540","IV",14980636,14980656,20
"22733","WBGene00050542","IV",14041792,14041812,20
"22734","WBGene00050543","IV",16837989,16838009,20
"22735","WBGene00050546","IV",15959630,15959650,20
"22736","WBGene00050550","IV",16023338,16023358,20
"22737","WBGene00050551","IV",16041738,16041758,20
"22738","WBGene00050565","IV",14557339,14557359,20
"22739","WBGene00050570","IV",15241799,15241819,20
"22740","WBGene00050572","IV",16147565,16147585,20
"22741","WBGene00050573","IV",14973277,14973297,20
"22742","WBGene00050579","IV",17199377,17199397,20
"22743","WBGene00050580","IV",5903882,5903902,20
"22744","WBGene00050581","IV",15680096,15680116,20
"22745","WBGene00050583","IV",15582223,15582243,20
"22746","WBGene00050587","IV",15127430,15127450,20
"22747","WBGene00050590","IV",16478655,16478675,20
"22748","WBGene00050592","IV",15232522,15232542,20
"22749","WBGene00050600","IV",13697152,13697172,20
"22750","WBGene00050601","IV",16542347,16542367,20
"22751","WBGene00050606","IV",16027655,16027675,20
"22752","WBGene00050607","IV",15712098,15712118,20
"22753","WBGene00050608","IV",17186505,17186525,20
"22754","WBGene00050613","IV",14439464,14439484,20
"22755","WBGene00050614","IV",15750876,15750896,20
"22756","WBGene00050617","IV",13809769,13809789,20
"22757","WBGene00050623","IV",17051687,17051707,20
"22758","WBGene00050625","IV",16914224,16914244,20
"22759","WBGene00050627","IV",16038414,16038434,20
"22760","WBGene00050629","IV",17215969,17215989,20
"22761","WBGene00050631","IV",5138559,5138579,20
"22762","WBGene00050632","IV",5718924,5718944,20
"22763","WBGene00050636","IV",14746578,14746598,20
"22764","WBGene00050641","IV",6397136,6397156,20
"22765","WBGene00050646","IV",14877374,14877394,20
"22766","WBGene00050647","IV",5818867,5818887,20
"22767","WBGene00050650","IV",16088336,16088356,20
"22768","WBGene00050653","IV",15000635,15000655,20
"22769","WBGene00050657","IV",5589636,5589656,20
"22770","WBGene00050658","IV",5428006,5428026,20
"22771","WBGene00050661","IV",15684512,15684532,20
"22772","WBGene00050662","IV",5442734,5442754,20
"22773","WBGene00050664","IV",14126661,14126681,20
"22774","WBGene00050667","IV",15112390,15112410,20
"22775","WBGene00050672","IV",13863338,13863358,20
"22776","WBGene00050675","IV",16834187,16834207,20
"22777","WBGene00050677","IV",16703127,16703147,20
"22778","WBGene00050678","IV",5902668,5902688,20
"22779","WBGene00050679","IV",14881084,14881104,20
"22780","WBGene00050681","IV",16356422,16356442,20
"22781","WBGene00050694","IV",16437017,16437037,20
"22782","WBGene00050697","IV",15898308,15898328,20
"22783","WBGene00050700","IV",16126948,16126968,20
"22784","WBGene00050701","IV",14918758,14918778,20
"22785","WBGene00050703","IV",15606887,15606907,20
"22786","WBGene00050707","IV",5860121,5860141,20
"22787","WBGene00050710","IV",17049045,17049065,20
"22788","WBGene00050711","IV",14685004,14685024,20
"22789","WBGene00050712","IV",5716933,5716953,20
"22790","WBGene00050716","IV",15941714,15941734,20
"22791","WBGene00050717","IV",16873231,16873251,20
"22792","WBGene00050722","IV",14375003,14375023,20
"22793","WBGene00050729","IV",5951787,5951807,20
"22794","WBGene00050733","IV",15979841,15979861,20
"22795","WBGene00050734","IV",14614710,14614730,20
"22796","WBGene00050744","IV",16539430,16539450,20
"22797","WBGene00050746","IV",14829670,14829690,20
"22798","WBGene00050754","IV",15384259,15384279,20
"22799","WBGene00050755","IV",15172723,15172743,20
"22800","WBGene00050764","IV",16477620,16477640,20
"22801","WBGene00050765","IV",16912480,16912500,20
"22802","WBGene00050770","IV",5787097,5787117,20
"22803","WBGene00050771","IV",14880043,14880063,20
"22804","WBGene00050772","IV",5502956,5502976,20
"22805","WBGene00050773","IV",6477896,6477916,20
"22806","WBGene00050776","IV",14899441,14899461,20
"22807","WBGene00050778","IV",15002847,15002867,20
"22808","WBGene00050781","IV",15144227,15144247,20
"22809","WBGene00050783","IV",16121209,16121229,20
"22810","WBGene00050789","IV",16817444,16817464,20
"22811","WBGene00050790","IV",15886683,15886703,20
"22812","WBGene00050791","IV",15208747,15208767,20
"22813","WBGene00050796","IV",6124712,6124732,20
"22814","WBGene00050799","IV",14654682,14654702,20
"22815","WBGene00050800","IV",16720408,16720428,20
"22816","WBGene00050805","IV",16528265,16528285,20
"22817","WBGene00050807","IV",16666662,16666682,20
"22818","WBGene00050809","IV",5079917,5079937,20
"22819","WBGene00050810","IV",5196665,5196685,20
"22820","WBGene00050812","IV",6059139,6059159,20
"22821","WBGene00050815","IV",15111578,15111598,20
"22822","WBGene00050816","IV",16659725,16659745,20
"22823","WBGene00050819","IV",14419463,14419483,20
"22824","WBGene00050823","IV",16612993,16613013,20
"22825","WBGene00050824","IV",5816745,5816765,20
"22826","WBGene00050825","IV",14966096,14966116,20
"22827","WBGene00050827","IV",16581998,16582018,20
"22828","WBGene00050829","IV",5954756,5954776,20
"22829","WBGene00050830","IV",6042781,6042801,20
"22830","WBGene00050836","IV",14988263,14988283,20
"22831","WBGene00050837","IV",5718443,5718463,20
"22832","WBGene00050838","IV",13691151,13691171,20
"22833","WBGene00050840","IV",5287811,5287831,20
"22834","WBGene00050841","IV",14316925,14316945,20
"22835","WBGene00050842","IV",13943906,13943926,20
"22836","WBGene00050847","IV",14375336,14375356,20
"22837","WBGene00050852","IV",5761936,5761956,20
"22838","WBGene00050853","IV",16213866,16213886,20
"22839","WBGene00050854","IV",6471844,6471864,20
"22840","WBGene00050856","IV",16119923,16119943,20
"22841","WBGene00050859","IV",14898938,14898958,20
"22842","WBGene00050860","IV",15808456,15808476,20
"22843","WBGene00050864","IV",16019844,16019864,20
"22844","WBGene00050870","IV",16203771,16203791,20
"22845","WBGene00050871","IV",5902803,5902823,20
"22846","WBGene00050873","IV",13894177,13894197,20
"22847","WBGene00050874","IV",5610478,5610498,20
"22848","WBGene00050875","I",11465142,11467612,2470
"22849","WBGene00050878","I",14043531,14045694,2163
"22850","WBGene00050879","I",8472556,8473481,925
"22851","WBGene00050880","I",8973066,8974575,1509
"22852","WBGene00050881","I",11160034,11162602,2568
"22853","WBGene00050883","V",16994939,16998771,3832
"22854","WBGene00050884","V",18623198,18626852,3654
"22855","WBGene00050885","IV",2711939,2713035,1096
"22856","WBGene00050889","V",11062439,11063245,806
"22857","WBGene00050890","V",10939245,10939612,367
"22858","WBGene00050891","V",18364858,18365037,179
"22859","WBGene00050892","V",20605105,20606331,1226
"22860","WBGene00050893","V",17802410,17802619,209
"22861","WBGene00050894","V",17026138,17026389,251
"22862","WBGene00050896","I",6146461,6147068,607
"22863","WBGene00050897","V",17789494,17789738,244
"22864","WBGene00050898","V",11251035,11251211,176
"22865","WBGene00050899","V",16044296,16045874,1578
"22866","WBGene00050900","V",18455355,18455934,579
"22867","WBGene00050903","V",18713728,18714612,884
"22868","WBGene00050904","V",16618341,16620908,2567
"22869","WBGene00050906","V",17468754,17469251,497
"22870","WBGene00050907","V",18395338,18395749,411
"22871","WBGene00050910","V",19484721,19484920,199
"22872","WBGene00050911","V",19485916,19486746,830
"22873","WBGene00050913","III",954873,955295,422
"22874","WBGene00050914","III",954291,954653,362
"22875","WBGene00050915","V",15729238,15730532,1294
"22876","WBGene00050916","IV",4359953,4360657,704
"22877","WBGene00050917","III",3249346,3250538,1192
"22878","WBGene00050919","III",5050107,5052068,1961
"22879","WBGene00050920","III",5156434,5156886,452
"22880","WBGene00050923","IV",16473085,16473181,96
"22881","WBGene00050926","V",20471566,20472496,930
"22882","WBGene00050927","V",20466438,20468203,1765
"22883","WBGene00050928","V",17013646,17013861,215
"22884","WBGene00050930","V",14038896,14040234,1338
"22885","WBGene00050931","III",9021370,9022635,1265
"22886","WBGene00050932","V",20614382,20615054,672
"22887","WBGene00050933","V",17234329,17234630,301
"22888","WBGene00050934","V",17236592,17238097,1505
"22889","WBGene00050935","V",18115402,18123594,8192
"22890","WBGene00050936","V",10205240,10205587,347
"22891","WBGene00050937","V",14518351,14519368,1017
"22892","WBGene00050938","V",12356256,12357309,1053
"22893","WBGene00050939","X",14743591,14744427,836
"22894","WBGene00050940","V",15056289,15056744,455
"22895","WBGene00050941","II",4797371,4798176,805
"22896","WBGene00050943","V",14875945,14876824,879
"22897","WBGene00050944","X",2807911,2809635,1724
"22898","WBGene00050945","V",11050326,11052020,1694
"22899","WBGene00050946","V",19768261,19770690,2429
"22900","WBGene00050947","V",10342055,10342743,688
"22901","WBGene00050948","II",14217107,14218064,957
"22902","WBGene00050949","V",15844453,15844768,315
"22903","WBGene00050951","V",19228477,19228824,347
"22904","WBGene00050954","V",15673361,15673449,88
"22905","WBGene00050955","V",18162034,18162668,634
"22906","WBGene00050956","V",18159652,18161339,1687
"22907","WBGene00050957","X",7398884,7400858,1974
"22908","WBGene00050958","V",17067146,17067854,708
"22909","WBGene00050961","V",16585762,16586121,359
"22910","WBGene00050962","V",16870071,16870416,345
"22911","WBGene00050964","V",14737910,14738049,139
"22912","WBGene00050965","V",17019990,17020226,236
"22913","WBGene00050967","V",19418212,19418911,699
"22914","WBGene00050968","V",13506621,13506785,164
"22915","WBGene00050970","V",11814145,11814296,151
"22916","WBGene00050971","V",18755450,18756760,1310
"22917","WBGene00050972","V",15747040,15747481,441
"22918","WBGene00050973","V",17704362,17706117,1755
"22919","WBGene00050974","V",17599978,17600872,894
"22920","WBGene00050976","V",17040739,17041961,1222
"22921","WBGene00050977","V",12632490,12633638,1148
"22922","WBGene00077434","V",20618910,20621966,3056
"22923","WBGene00077436","V",20623630,20624887,1257
"22924","WBGene00077437","IV",8597762,8598727,965
"22925","WBGene00077438","V",17532821,17535368,2547
"22926","WBGene00077439","V",13839769,13840281,512
"22927","WBGene00077440","V",15205095,15206552,1457
"22928","WBGene00077441","V",19308707,19309687,980
"22929","WBGene00077442","V",18756846,18757678,832
"22930","WBGene00077443","I",13972617,13973412,795
"22931","WBGene00077444","V",15811510,15812118,608
"22932","WBGene00077445","V",18292595,18292944,349
"22933","WBGene00077447","V",18168688,18168812,124
"22934","WBGene00077448","V",14071646,14073719,2073
"22935","WBGene00077449","V",10143936,10144192,256
"22936","WBGene00077450","V",15670472,15671784,1312
"22937","WBGene00077451","V",18706031,18706254,223
"22938","WBGene00077452","II",11532149,11532294,145
"22939","WBGene00077453","II",11533925,11534479,554
"22940","WBGene00077454","V",18709111,18709358,247
"22941","WBGene00077455","V",18685060,18686349,1289
"22942","WBGene00077457","V",19094939,19096900,1961
"22943","WBGene00077459","V",17603185,17603945,760
"22944","WBGene00077461","IV",11549793,11549864,71
"22945","WBGene00077462","IV",13238932,13239077,145
"22946","WBGene00077463","V",16582388,16582666,278
"22947","WBGene00077465","V",17115903,17116021,118
"22948","WBGene00077466","V",17117863,17117981,118
"22949","WBGene00077467","V",17118837,17118935,98
"22950","WBGene00077468","V",17120013,17120111,98
"22951","WBGene00077469","V",17121944,17122062,118
"22952","WBGene00077470","V",17122920,17123038,118
"22953","WBGene00077471","V",17123896,17124014,118
"22954","WBGene00077474","V",17128404,17128522,118
"22955","WBGene00077475","V",17129376,17129494,118
"22956","WBGene00077478","V",17132040,17132107,67
"22957","WBGene00077482","V",17126556,17126623,67
"22958","WBGene00077487","V",17121670,17121767,97
"22959","WBGene00077488","V",17118154,17118251,97
"22960","WBGene00077489","II",5094245,5095370,1125
"22961","WBGene00077490","II",4560397,4562618,2221
"22962","WBGene00077491","V",10001118,10002766,1648
"22963","WBGene00077492","V",16893740,16894107,367
"22964","WBGene00077493","V",16907969,16909971,2002
"22965","WBGene00077494","V",17051015,17051617,602
"22966","WBGene00077495","V",17380232,17381119,887
"22967","WBGene00077496","V",9510406,9510719,313
"22968","WBGene00077497","V",9489524,9489800,276
"22969","WBGene00077498","V",9854200,9854330,130
"22970","WBGene00077499","V",9855353,9855507,154
"22971","WBGene00077500","V",9982868,9983932,1064
"22972","WBGene00077501","V",9992912,9993051,139
"22973","WBGene00077502","V",10376985,10377317,332
"22974","WBGene00077503","V",10378982,10379364,382
"22975","WBGene00077504","V",10379917,10380245,328
"22976","WBGene00077508","I",12474620,12475934,1314
"22977","WBGene00077514","V",11259312,11260722,1410
"22978","WBGene00077515","I",4138604,4138730,126
"22979","WBGene00077516","III",8165540,8165672,132
"22980","WBGene00077517","III",8168243,8168383,140
"22981","WBGene00077519","I",10883557,10884193,636
"22982","WBGene00077520","I",14171864,14172786,922
"22983","WBGene00077521","I",10382746,10384222,1476
"22984","WBGene00077522","II",3146142,3146992,850
"22985","WBGene00077523","IV",2133481,2134708,1227
"22986","WBGene00077524","I",11265523,11265714,191
"22987","WBGene00077525","I",9530816,9532831,2015
"22988","WBGene00077526","I",10179004,10179744,740
"22989","WBGene00077531","III",181561,182981,1420
"22990","WBGene00077534","I",12258603,12258803,200
"22991","WBGene00077535","I",12160100,12162091,1991
"22992","WBGene00077536","V",11545536,11546376,840
"22993","WBGene00077537","I",12078050,12078748,698
"22994","WBGene00077538","V",11760671,11761894,1223
"22995","WBGene00077539","I",11012959,11014739,1780
"22996","WBGene00077543","I",7729184,7729878,694
"22997","WBGene00077546","I",13376876,13377347,471
"22998","WBGene00077548","I",7278802,7279609,807
"22999","WBGene00077549","I",11687811,11688522,711
"23000","WBGene00077551","I",7777670,7778011,341
"23001","WBGene00077552","I",7779419,7785798,6379
"23002","WBGene00077553","I",7512918,7513726,808
"23003","WBGene00077555","I",12698904,12699200,296
"23004","WBGene00077556","I",12908304,12909436,1132
"23005","WBGene00077557","I",11557986,11558671,685
"23006","WBGene00077558","I",9085351,9085848,497
"23007","WBGene00077559","I",12189521,12190218,697
"23008","WBGene00077561","I",13414273,13414465,192
"23009","WBGene00077562","V",12806490,12808277,1787
"23010","WBGene00077563","I",2352835,2356238,3403
"23011","WBGene00077564","V",12840387,12841674,1287
"23012","WBGene00077565","V",13034267,13034704,437
"23013","WBGene00077566","V",13098199,13098631,432
"23014","WBGene00077567","V",13429989,13430176,187
"23015","WBGene00077568","V",13527601,13528864,1263
"23016","WBGene00077569","V",13590111,13590793,682
"23017","WBGene00077570","V",13825613,13827051,1438
"23018","WBGene00077572","V",14020628,14021737,1109
"23019","WBGene00077573","V",14022282,14023174,892
"23020","WBGene00077574","V",14023821,14024535,714
"23021","WBGene00077576","V",14395070,14395749,679
"23022","WBGene00077577","V",14509738,14511123,1385
"23023","WBGene00077579","V",14606777,14608175,1398
"23024","WBGene00077580","V",14709196,14709428,232
"23025","WBGene00077581","V",14892495,14892799,304
"23026","WBGene00077582","V",15029469,15030183,714
"23027","WBGene00077583","V",15088427,15088699,272
"23028","WBGene00077584","V",15104724,15105197,473
"23029","WBGene00077585","V",15116268,15116595,327
"23030","WBGene00077586","V",15172363,15173477,1114
"23031","WBGene00077588","V",15304607,15305602,995
"23032","WBGene00077589","V",15363187,15363422,235
"23033","WBGene00077590","V",15380544,15380849,305
"23034","WBGene00077592","X",6176129,6177154,1025
"23035","WBGene00077593","V",4038821,4039934,1113
"23036","WBGene00077594","V",15482149,15483665,1516
"23037","WBGene00077595","V",15675885,15676512,627
"23038","WBGene00077596","V",15680156,15680916,760
"23039","WBGene00077599","I",3910781,3912471,1690
"23040","WBGene00077601","V",15902300,15902550,250
"23041","WBGene00077602","V",15911564,15911679,115
"23042","WBGene00077603","V",15929399,15929798,399
"23043","WBGene00077604","V",15946222,15946723,501
"23044","WBGene00077605","V",15978186,15978298,112
"23045","WBGene00077606","V",16004721,16004941,220
"23046","WBGene00077607","V",16032471,16034961,2490
"23047","WBGene00077608","V",16079259,16079440,181
"23048","WBGene00077609","V",16118937,16119160,223
"23049","WBGene00077610","V",16138072,16138253,181
"23050","WBGene00077611","V",16223465,16223670,205
"23051","WBGene00077613","V",16245296,16245976,680
"23052","WBGene00077615","V",16477134,16477808,674
"23053","WBGene00077616","V",16480336,16481019,683
"23054","WBGene00077617","V",16486386,16486519,133
"23055","WBGene00077618","V",16486773,16486885,112
"23056","WBGene00077619","V",16523006,16523558,552
"23057","WBGene00077620","V",16636244,16636790,546
"23058","WBGene00077621","V",16711192,16712565,1373
"23059","WBGene00077622","V",16727215,16727905,690
"23060","WBGene00077624","V",16986460,16987135,675
"23061","WBGene00077625","V",16989324,16989815,491
"23062","WBGene00077626","V",17000911,17001140,229
"23063","WBGene00077627","V",17235127,17235578,451
"23064","WBGene00077629","V",17294413,17297359,2946
"23065","WBGene00077630","V",17330691,17330881,190
"23066","WBGene00077631","V",17399470,17400000,530
"23067","WBGene00077632","V",17407974,17408383,409
"23068","WBGene00077633","V",17408437,17408643,206
"23069","WBGene00077634","II",12754610,12754877,267
"23070","WBGene00077635","II",12749093,12749381,288
"23071","WBGene00077636","II",12742546,12744256,1710
"23072","WBGene00077637","V",17605501,17605880,379
"23073","WBGene00077638","V",17611978,17612318,340
"23074","WBGene00077640","V",17697506,17699197,1691
"23075","WBGene00077641","V",17813605,17813915,310
"23076","WBGene00077643","V",201600,204279,2679
"23077","WBGene00077646","V",18296428,18297366,938
"23078","WBGene00077647","V",18315050,18315251,201
"23079","WBGene00077648","V",18385407,18385956,549
"23080","WBGene00077649","V",18396187,18397137,950
"23081","WBGene00077652","V",18466506,18467716,1210
"23082","WBGene00077653","V",18529392,18529878,486
"23083","WBGene00077655","V",18728703,18729374,671
"23084","WBGene00077656","V",18764237,18764481,244
"23085","WBGene00077657","V",18769242,18769486,244
"23086","WBGene00077658","II",10841386,10843625,2239
"23087","WBGene00077659","V",18767754,18768414,660
"23088","WBGene00077660","V",18793942,18794105,163
"23089","WBGene00077662","V",19232286,19233687,1401
"23090","WBGene00077663","V",19299562,19300461,899
"23091","WBGene00077664","V",19311863,19312819,956
"23092","WBGene00077666","V",19771135,19771298,163
"23093","WBGene00077667","V",19783158,19783393,235
"23094","WBGene00077669","V",20329705,20335364,5659
"23095","WBGene00077670","V",20362734,20363677,943
"23096","WBGene00077671","V",20369862,20370165,303
"23097","WBGene00077673","X",9166906,9167256,350
"23098","WBGene00077674","X",8218384,8218753,369
"23099","WBGene00077679","X",13724664,13726003,1339
"23100","WBGene00077680","X",11863613,11864773,1160
"23101","WBGene00077681","V",20814759,20815896,1137
"23102","WBGene00077682","V",10922986,10923336,350
"23103","WBGene00077684","I",13101357,13101901,544
"23104","WBGene00077685","I",9694596,9695172,576
"23105","WBGene00077686","I",12685387,12685569,182
"23106","WBGene00077687","I",11064370,11064636,266
"23107","WBGene00077688","V",19510780,19512164,1384
"23108","WBGene00077689","I",14434642,14435706,1064
"23109","WBGene00077690","X",6205180,6206475,1295
"23110","WBGene00077691","V",9625422,9626269,847
"23111","WBGene00077692","V",18339015,18339907,892
"23112","WBGene00077693","V",11059520,11060289,769
"23113","WBGene00077696","V",9739702,9740894,1192
"23114","WBGene00077697","V",9745240,9749228,3988
"23115","WBGene00077698","V",13092666,13094446,1780
"23116","WBGene00077699","V",11040773,11041371,598
"23117","WBGene00077701","I",4145315,4147182,1867
"23118","WBGene00077703","III",10159027,10160482,1455
"23119","WBGene00077704","II",5498710,5499150,440
"23120","WBGene00077705","X",15588311,15588370,59
"23121","WBGene00077706","X",14977119,14977178,59
"23122","WBGene00077707","X",15236362,15236423,61
"23123","WBGene00077708","I",10869370,10869474,104
"23124","WBGene00077709","II",6015534,6015627,93
"23125","WBGene00077712","V",7868470,7870807,2337
"23126","WBGene00077714","IV",10698379,10699760,1381
"23127","WBGene00077715","I",13980858,13980954,96
"23128","WBGene00077716","X",16207955,16208035,80
"23129","WBGene00077717","I",12608619,12608708,89
"23130","WBGene00077718","I",13513955,13514047,92
"23131","WBGene00077719","I",10600463,10600525,62
"23132","WBGene00077721","X",6435425,6435512,87
"23133","WBGene00077722","IV",6660461,6660519,58
"23134","WBGene00077723","II",4371838,4371907,69
"23135","WBGene00077725","III",11829248,11829311,63
"23136","WBGene00077726","IV",7767461,7767567,106
"23137","WBGene00077727","V",3042530,3042633,103
"23138","WBGene00077728","I",7701121,7701389,268
"23139","WBGene00077732","II",6198696,6201628,2932
"23140","WBGene00077750","IV",10079907,10080179,272
"23141","WBGene00077751","II",3331889,3334205,2316
"23142","WBGene00077752","IV",15583935,15586051,2116
"23143","WBGene00077753","IV",10807890,10810086,2196
"23144","WBGene00077755","IV",15206184,15206347,163
"23145","WBGene00077756","IV",9265810,9266561,751
"23146","WBGene00077757","X",14256273,14257411,1138
"23147","WBGene00077758","V",3018361,3021406,3045
"23148","WBGene00077759","II",2948929,2952729,3800
"23149","WBGene00077761","V",10942654,10943862,1208
"23150","WBGene00077762","IV",14754089,14754969,880
"23151","WBGene00077763","IV",14570160,14572721,2561
"23152","WBGene00077764","I",10514170,10514418,248
"23153","WBGene00077765","I",10290911,10292078,1167
"23154","WBGene00077766","I",13183452,13183772,320
"23155","WBGene00077767","I",7103812,7104136,324
"23156","WBGene00077768","I",8043760,8044165,405
"23157","WBGene00077769","I",12578108,12579205,1097
"23158","WBGene00077770","I",11339787,11341521,1734
"23159","WBGene00077771","I",9515002,9516776,1774
"23160","WBGene00077772","I",11824976,11825787,811
"23161","WBGene00077773","I",9158799,9159055,256
"23162","WBGene00077775","V",9946322,9948940,2618
"23163","WBGene00077781","I",2636904,2637591,687
"23164","WBGene00077782","V",11423579,11424475,896
"23165","WBGene00077783","V",10800725,10801291,566
"23166","WBGene00077784","X",5373032,5374197,1165
"23167","WBGene00077785","I",11731058,11733478,2420
"23168","WBGene00077786","V",20693906,20698278,4372
"23169","WBGene00077787","V",17072946,17073958,1012
"23170","WBGene00077788","V",13049244,13049549,305
"23171","WBGene00077789","I",13078921,13079690,769
"23172","WBGene00086546","III",8159155,8161338,2183
"23173","WBGene00086551","I",7819579,7820489,910
"23174","WBGene00086552","I",11621576,11621899,323
"23175","WBGene00086553","I",14015754,14016405,651
"23176","WBGene00086554","I",8474061,8474767,706
"23177","WBGene00086555","I",14305070,14307134,2064
"23178","WBGene00086556","I",11261227,11261977,750
"23179","WBGene00086557","I",8669861,8673618,3757
"23180","WBGene00086558","II",3744477,3745910,1433
"23181","WBGene00086559","V",19548239,19549784,1545
"23182","WBGene00086560","II",2927813,2928149,336
"23183","WBGene00086562","I",11820688,11823459,2771
"23184","WBGene00086563","I",11498450,11498715,265
"23185","WBGene00086564","I",11492358,11492773,415
"23186","WBGene00086565","V",16644799,16645237,438
"23187","WBGene00086566","II",9892778,9894370,1592
"23188","WBGene00086567","II",9917122,9917943,821
"23189","WBGene00086568","V",13443835,13445055,1220
"23190","WBGene00086569","V",20772516,20773747,1231
"23191","WBGene00119201","V",18351021,18352672,1651
"23192","WBGene00119203","III",4709248,4712547,3299
"23193","WBGene00119204","V",12608093,12608974,881
"23194","WBGene00138711","X",9869836,9870792,956
"23195","WBGene00138714","IV",17407316,17407591,275
"23196","WBGene00138715","V",17613792,17614357,565
"23197","WBGene00138716","I",13189792,13190583,791
"23198","WBGene00138717","IV",1956711,1959749,3038
"23199","WBGene00138719","V",20593262,20594846,1584
"23200","WBGene00138720","V",11935148,11936528,1380
"23201","WBGene00138721","V",12437499,12441266,3767
"23202","WBGene00138724","V",12992654,12992977,323
"23203","WBGene00138725","X",11824184,11824424,240
"23204","WBGene00164968","X",13257847,13260898,3051
"23205","WBGene00164969","X",10967302,10967798,496
"23206","WBGene00164971","X",10882284,10883371,1087
"23207","WBGene00164972","X",10883567,10884508,941
"23208","WBGene00164973","X",10477061,10477891,830
"23209","WBGene00164974","X",11440040,11440652,612
"23210","WBGene00164983","III",3855072,3856931,1859
"23211","WBGene00164985","III",13002383,13005311,2928
"23212","WBGene00164986","III",11108314,11110462,2148
"23213","WBGene00164991","IV",16630089,16630109,20
"23214","WBGene00164999","IV",14381503,14381523,20
"23215","WBGene00165004","IV",14316608,14316628,20
"23216","WBGene00165007","IV",14219322,14219342,20
"23217","WBGene00165009","IV",5507309,5507329,20
"23218","WBGene00165015","IV",14124370,14124390,20
"23219","WBGene00165017","IV",5199624,5199644,20
"23220","WBGene00165026","I",10005523,10005543,20
"23221","WBGene00165027","IV",15530867,15530887,20
"23222","WBGene00165032","IV",15695656,15695676,20
"23223","WBGene00165033","III",13712068,13712088,20
"23224","WBGene00165034","IV",16478383,16478403,20
"23225","WBGene00165035","IV",15751281,15751301,20
"23226","WBGene00165037","IV",13639711,13639731,20
"23227","WBGene00165038","IV",14433966,14433986,20
"23228","WBGene00165040","IV",14952291,14952311,20
"23229","WBGene00165046","IV",6767878,6767898,20
"23230","WBGene00165052","III",2418786,2418806,20
"23231","WBGene00165054","IV",15648666,15648686,20
"23232","WBGene00165064","IV",13797567,13797587,20
"23233","WBGene00165069","IV",14460486,14460506,20
"23234","WBGene00165071","IV",6236726,6236746,20
"23235","WBGene00165074","IV",16157943,16157963,20
"23236","WBGene00165075","IV",14960576,14960596,20
"23237","WBGene00165077","IV",6941917,6941937,20
"23238","WBGene00165080","IV",5768986,5769006,20
"23239","WBGene00165081","IV",16182695,16182715,20
"23240","WBGene00165082","IV",15391856,15391876,20
"23241","WBGene00165085","IV",16446695,16446715,20
"23242","WBGene00165089","IV",6028277,6028297,20
"23243","WBGene00165091","IV",17207741,17207761,20
"23244","WBGene00165092","II",11603462,11603482,20
"23245","WBGene00165093","IV",5959528,5959548,20
"23246","WBGene00165094","IV",5153860,5153880,20
"23247","WBGene00165097","IV",17226440,17226460,20
"23248","WBGene00165100","IV",13871481,13871501,20
"23249","WBGene00165102","IV",14271305,14271325,20
"23250","WBGene00165111","IV",15857279,15857299,20
"23251","WBGene00165119","IV",15094800,15094820,20
"23252","WBGene00165122","IV",15001693,15001713,20
"23253","WBGene00165126","IV",16277985,16278005,20
"23254","WBGene00165132","IV",15210523,15210543,20
"23255","WBGene00165133","IV",14965227,14965247,20
"23256","WBGene00165134","IV",5906154,5906174,20
"23257","WBGene00165135","IV",15707004,15707024,20
"23258","WBGene00165136","IV",9787597,9787617,20
"23259","WBGene00165143","IV",5605689,5605709,20
"23260","WBGene00165144","IV",5508573,5508593,20
"23261","WBGene00165147","IV",6836805,6836825,20
"23262","WBGene00165149","IV",14357758,14357778,20
"23263","WBGene00165150","IV",15105436,15105456,20
"23264","WBGene00165152","IV",15500985,15501005,20
"23265","WBGene00165155","IV",16001958,16001978,20
"23266","WBGene00165157","IV",15396552,15396572,20
"23267","WBGene00165158","IV",5517402,5517422,20
"23268","WBGene00165163","IV",6544643,6544663,20
"23269","WBGene00165165","IV",5376271,5376291,20
"23270","WBGene00165166","IV",14883739,14883759,20
"23271","WBGene00165167","IV",16535618,16535638,20
"23272","WBGene00165171","IV",15494052,15494072,20
"23273","WBGene00165177","IV",16874166,16874186,20
"23274","WBGene00165182","IV",5566691,5566711,20
"23275","WBGene00165185","IV",16003334,16003354,20
"23276","WBGene00165192","X",10345158,10345178,20
"23277","WBGene00165194","X",5868038,5868058,20
"23278","WBGene00165197","IV",16383632,16383652,20
"23279","WBGene00165201","IV",6258766,6258786,20
"23280","WBGene00165202","X",15326851,15326871,20
"23281","WBGene00165205","IV",14284342,14284362,20
"23282","WBGene00165208","IV",14877200,14877220,20
"23283","WBGene00165210","IV",5815598,5815618,20
"23284","WBGene00165211","IV",16463138,16463158,20
"23285","WBGene00165212","IV",13722327,13722347,20
"23286","WBGene00165213","II",1945379,1945399,20
"23287","WBGene00165218","IV",15358215,15358235,20
"23288","WBGene00165219","IV",13641901,13641921,20
"23289","WBGene00165222","IV",14617356,14617376,20
"23290","WBGene00165223","IV",16024744,16024764,20
"23291","WBGene00165224","IV",14483452,14483472,20
"23292","WBGene00165227","IV",5520752,5520772,20
"23293","WBGene00165229","IV",9433301,9433321,20
"23294","WBGene00165232","IV",15547450,15547470,20
"23295","WBGene00165234","IV",14408310,14408330,20
"23296","WBGene00165235","IV",15862161,15862181,20
"23297","WBGene00165236","IV",14376044,14376064,20
"23298","WBGene00165244","IV",14274723,14274743,20
"23299","WBGene00165248","IV",13813960,13813980,20
"23300","WBGene00165249","IV",5914171,5914191,20
"23301","WBGene00165251","IV",16047845,16047865,20
"23302","WBGene00165252","IV",14895022,14895042,20
"23303","WBGene00165257","X",15465703,15465723,20
"23304","WBGene00165268","IV",6060254,6060274,20
"23305","WBGene00165273","IV",6473541,6473561,20
"23306","WBGene00165274","V",2970559,2970579,20
"23307","WBGene00165275","IV",13889556,13889576,20
"23308","WBGene00165283","IV",15614398,15614418,20
"23309","WBGene00165284","IV",5930292,5930312,20
"23310","WBGene00165288","IV",7515372,7515392,20
"23311","WBGene00165291","IV",9160462,9160482,20
"23312","WBGene00165297","IV",5044162,5044182,20
"23313","WBGene00165298","IV",16509845,16509865,20
"23314","WBGene00165300","IV",5508114,5508134,20
"23315","WBGene00165303","III",8785173,8785193,20
"23316","WBGene00165307","IV",15880137,15880157,20
"23317","WBGene00165308","IV",15727611,15727631,20
"23318","WBGene00165309","IV",15401572,15401592,20
"23319","WBGene00165310","IV",14618376,14618396,20
"23320","WBGene00165312","IV",16047222,16047242,20
"23321","WBGene00165317","IV",5648615,5648635,20
"23322","WBGene00165321","IV",16156457,16156477,20
"23323","WBGene00165323","IV",15728263,15728283,20
"23324","WBGene00165325","IV",5779797,5779817,20
"23325","WBGene00165327","IV",15886580,15886600,20
"23326","WBGene00165329","IV",14498475,14498495,20
"23327","WBGene00165333","IV",5925490,5925510,20
"23328","WBGene00165339","IV",13694513,13694533,20
"23329","WBGene00165344","IV",15570181,15570201,20
"23330","WBGene00165348","IV",14761630,14761650,20
"23331","WBGene00165355","IV",15667655,15667675,20
"23332","WBGene00165356","IV",2318114,2318134,20
"23333","WBGene00165357","II",3048200,3048220,20
"23334","WBGene00165363","IV",13819967,13819987,20
"23335","WBGene00165364","IV",6491494,6491514,20
"23336","WBGene00165365","IV",5292713,5292733,20
"23337","WBGene00165373","IV",15648576,15648596,20
"23338","WBGene00165374","X",813306,813326,20
"23339","WBGene00165375","IV",14257770,14257790,20
"23340","WBGene00165376","IV",4273195,4273215,20
"23341","WBGene00165377","IV",14952807,14952827,20
"23342","WBGene00165379","IV",5079443,5079463,20
"23343","WBGene00165382","IV",3848973,3848993,20
"23344","WBGene00165388","IV",16607284,16607304,20
"23345","WBGene00165390","IV",15052812,15052832,20
"23346","WBGene00165391","V",14375468,14375488,20
"23347","WBGene00165392","IV",5590635,5590655,20
"23348","WBGene00165394","IV",15322364,15322384,20
"23349","WBGene00165396","IV",16017515,16017535,20
"23350","WBGene00165399","IV",5040564,5040584,20
"23351","WBGene00165402","IV",5613017,5613037,20
"23352","WBGene00165404","IV",6773119,6773139,20
"23353","WBGene00165406","IV",5719082,5719102,20
"23354","WBGene00165410","IV",5101853,5101873,20
"23355","WBGene00165416","IV",15053590,15053610,20
"23356","WBGene00165420","IV",14505855,14505875,20
"23357","WBGene00165422","IV",16214387,16214407,20
"23358","WBGene00165424","IV",15174209,15174229,20
"23359","WBGene00165426","IV",5203023,5203043,20
"23360","WBGene00165428","IV",5589108,5589128,20
"23361","WBGene00165432","IV",5880924,5880944,20
"23362","WBGene00165435","IV",14230935,14230955,20
"23363","WBGene00165438","IV",17210019,17210039,20
"23364","WBGene00165441","IV",16830193,16830213,20
"23365","WBGene00165442","IV",5401634,5401654,20
"23366","WBGene00165445","IV",6658718,6658738,20
"23367","WBGene00165451","IV",15706549,15706569,20
"23368","WBGene00165452","IV",15355570,15355590,20
"23369","WBGene00165453","IV",5744001,5744021,20
"23370","WBGene00165454","IV",15696040,15696060,20
"23371","WBGene00165456","IV",14014894,14014914,20
"23372","WBGene00165467","II",11479382,11479402,20
"23373","WBGene00165473","IV",15392151,15392171,20
"23374","WBGene00165474","IV",16987618,16987638,20
"23375","WBGene00165477","IV",14268672,14268692,20
"23376","WBGene00165479","IV",14050901,14050921,20
"23377","WBGene00165480","IV",4821275,4821295,20
"23378","WBGene00165481","IV",14241800,14241820,20
"23379","WBGene00165483","I",2524532,2524552,20
"23380","WBGene00165486","IV",16048684,16048704,20
"23381","WBGene00165492","IV",15706003,15706023,20
"23382","WBGene00165499","V",8141896,8141916,20
"23383","WBGene00165500","V",3974385,3974405,20
"23384","WBGene00165506","IV",14700678,14700698,20
"23385","WBGene00165511","IV",13660550,13660570,20
"23386","WBGene00165515","IV",16838855,16838875,20
"23387","WBGene00165516","IV",6148851,6148871,20
"23388","WBGene00165517","IV",14487473,14487493,20
"23389","WBGene00165519","IV",7823294,7823314,20
"23390","WBGene00165523","IV",15350442,15350462,20
"23391","WBGene00165526","IV",16081727,16081747,20
"23392","WBGene00165528","IV",6042855,6042875,20
"23393","WBGene00165529","IV",16124361,16124381,20
"23394","WBGene00165530","IV",14377071,14377091,20
"23395","WBGene00165534","IV",6147405,6147425,20
"23396","WBGene00165535","IV",14396541,14396561,20
"23397","WBGene00165540","IV",6255607,6255627,20
"23398","WBGene00165542","IV",5338431,5338451,20
"23399","WBGene00165544","IV",5123894,5123914,20
"23400","WBGene00165545","IV",15927685,15927705,20
"23401","WBGene00165547","IV",6273469,6273489,20
"23402","WBGene00165557","IV",16665585,16665605,20
"23403","WBGene00165558","IV",410141,410161,20
"23404","WBGene00165559","IV",4888162,4888182,20
"23405","WBGene00165563","IV",6066409,6066429,20
"23406","WBGene00165567","I",6100035,6100055,20
"23407","WBGene00165569","IV",14558208,14558228,20
"23408","WBGene00165570","IV",14414454,14414474,20
"23409","WBGene00165574","IV",6456826,6456846,20
"23410","WBGene00165575","IV",14053825,14053845,20
"23411","WBGene00165581","IV",13869786,13869806,20
"23412","WBGene00165585","IV",14499313,14499333,20
"23413","WBGene00165587","IV",5911909,5911929,20
"23414","WBGene00165589","IV",8523791,8523811,20
"23415","WBGene00165590","IV",16478020,16478040,20
"23416","WBGene00165591","IV",13925344,13925364,20
"23417","WBGene00165596","IV",7266227,7266247,20
"23418","WBGene00165599","IV",17188725,17188745,20
"23419","WBGene00165600","IV",5430293,5430313,20
"23420","WBGene00165602","IV",6046974,6046994,20
"23421","WBGene00165606","IV",14402988,14403008,20
"23422","WBGene00165607","IV",13838458,13838478,20
"23423","WBGene00165608","IV",14995801,14995821,20
"23424","WBGene00165609","IV",14506615,14506635,20
"23425","WBGene00165610","IV",16020610,16020630,20
"23426","WBGene00165618","IV",7407194,7407214,20
"23427","WBGene00165622","IV",16839712,16839732,20
"23428","WBGene00165623","IV",14000899,14000919,20
"23429","WBGene00165631","IV",5763166,5763186,20
"23430","WBGene00165632","IV",6464494,6464514,20
"23431","WBGene00165635","IV",15679642,15679662,20
"23432","WBGene00165636","IV",9536192,9536212,20
"23433","WBGene00165639","IV",5320161,5320181,20
"23434","WBGene00165642","IV",7075799,7075819,20
"23435","WBGene00165643","IV",15273222,15273242,20
"23436","WBGene00165646","IV",14590244,14590264,20
"23437","WBGene00165647","IV",8321774,8321794,20
"23438","WBGene00165649","IV",6837304,6837324,20
"23439","WBGene00165650","IV",7348878,7348898,20
"23440","WBGene00165655","IV",4940939,4940959,20
"23441","WBGene00165660","IV",14106969,14106989,20
"23442","WBGene00165663","IV",17418016,17418036,20
"23443","WBGene00165672","IV",15946107,15946127,20
"23444","WBGene00165677","IV",14660020,14660040,20
"23445","WBGene00165679","IV",5806050,5806070,20
"23446","WBGene00165681","IV",5857856,5857876,20
"23447","WBGene00165683","IV",13769271,13769291,20
"23448","WBGene00165687","III",9238777,9238797,20
"23449","WBGene00165690","IV",16048643,16048663,20
"23450","WBGene00165698","IV",15702862,15702882,20
"23451","WBGene00165701","IV",14036055,14036075,20
"23452","WBGene00165705","IV",6130328,6130348,20
"23453","WBGene00165707","IV",6111862,6111882,20
"23454","WBGene00165716","IV",6161460,6161480,20
"23455","WBGene00165717","V",11359556,11359576,20
"23456","WBGene00165720","IV",16335229,16335249,20
"23457","WBGene00165722","IV",12468387,12468407,20
"23458","WBGene00165725","X",863185,863205,20
"23459","WBGene00165726","IV",5646747,5646767,20
"23460","WBGene00165727","IV",6073002,6073022,20
"23461","WBGene00165730","IV",4819973,4819993,20
"23462","WBGene00165732","IV",5279076,5279096,20
"23463","WBGene00165734","IV",5081726,5081746,20
"23464","WBGene00165738","IV",6185795,6185815,20
"23465","WBGene00165741","IV",4965794,4965814,20
"23466","WBGene00165743","IV",5341268,5341288,20
"23467","WBGene00165744","IV",14901580,14901600,20
"23468","WBGene00165746","IV",14650591,14650611,20
"23469","WBGene00165748","IV",14262894,14262914,20
"23470","WBGene00165752","IV",5950368,5950388,20
"23471","WBGene00165753","IV",15811084,15811104,20
"23472","WBGene00165754","IV",16074795,16074815,20
"23473","WBGene00165756","V",14022237,14022257,20
"23474","WBGene00165758","IV",13865592,13865612,20
"23475","WBGene00165762","IV",5106790,5106810,20
"23476","WBGene00165763","IV",4953403,4953423,20
"23477","WBGene00165768","IV",13861232,13861252,20
"23478","WBGene00165769","IV",14571418,14571438,20
"23479","WBGene00165771","IV",13954096,13954116,20
"23480","WBGene00165773","IV",15235769,15235789,20
"23481","WBGene00165776","IV",9752573,9752593,20
"23482","WBGene00165786","IV",15944711,15944731,20
"23483","WBGene00165787","IV",5594411,5594431,20
"23484","WBGene00165789","IV",5839003,5839023,20
"23485","WBGene00165790","IV",15378218,15378238,20
"23486","WBGene00165793","IV",15275400,15275420,20
"23487","WBGene00165795","IV",15706002,15706022,20
"23488","WBGene00165796","IV",16618952,16618972,20
"23489","WBGene00165800","IV",15388275,15388295,20
"23490","WBGene00165801","IV",15816225,15816245,20
"23491","WBGene00165803","IV",14906013,14906033,20
"23492","WBGene00165809","IV",5323724,5323744,20
"23493","WBGene00165810","IV",15387452,15387472,20
"23494","WBGene00165811","IV",6809007,6809027,20
"23495","WBGene00165819","IV",14496291,14496311,20
"23496","WBGene00165820","IV",15221043,15221063,20
"23497","WBGene00165821","IV",14953561,14953581,20
"23498","WBGene00165823","IV",13756988,13757008,20
"23499","WBGene00165826","V",6278355,6278375,20
"23500","WBGene00165828","IV",13948774,13948794,20
"23501","WBGene00165831","IV",13953418,13953438,20
"23502","WBGene00165833","IV",16783977,16783997,20
"23503","WBGene00165834","IV",5598097,5598117,20
"23504","WBGene00165835","IV",15809637,15809657,20
"23505","WBGene00165841","IV",17411300,17411320,20
"23506","WBGene00165848","IV",5596479,5596499,20
"23507","WBGene00165850","IV",15863099,15863119,20
"23508","WBGene00165854","V",4227804,4227824,20
"23509","WBGene00165857","IV",16660870,16660890,20
"23510","WBGene00165858","IV",13758429,13758449,20
"23511","WBGene00165867","IV",14087665,14087685,20
"23512","WBGene00165872","IV",5041347,5041367,20
"23513","WBGene00165881","IV",8919542,8919562,20
"23514","WBGene00165884","IV",15316548,15316568,20
"23515","WBGene00165885","IV",5177494,5177514,20
"23516","WBGene00165887","IV",13863699,13863719,20
"23517","WBGene00165891","IV",5668105,5668125,20
"23518","WBGene00165893","IV",6426555,6426575,20
"23519","WBGene00165897","IV",17031075,17031095,20
"23520","WBGene00165899","IV",3739052,3739072,20
"23521","WBGene00165903","IV",14662868,14662888,20
"23522","WBGene00165905","IV",6508505,6508525,20
"23523","WBGene00165907","IV",14510080,14510100,20
"23524","WBGene00165910","IV",15991605,15991625,20
"23525","WBGene00165913","IV",4884070,4884090,20
"23526","WBGene00165917","IV",14889611,14889631,20
"23527","WBGene00165918","IV",5585586,5585606,20
"23528","WBGene00165924","II",6524503,6524523,20
"23529","WBGene00165926","IV",5722669,5722689,20
"23530","WBGene00165927","IV",16239327,16239347,20
"23531","WBGene00165928","IV",13928071,13928091,20
"23532","WBGene00165929","IV",14372744,14372764,20
"23533","WBGene00165931","IV",5003301,5003321,20
"23534","WBGene00165939","IV",14677202,14677222,20
"23535","WBGene00165940","IV",14308940,14308960,20
"23536","WBGene00165943","IV",15661455,15661475,20
"23537","WBGene00165946","IV",15509711,15509731,20
"23538","WBGene00165948","IV",4830915,4830935,20
"23539","WBGene00165949","V",13081328,13081348,20
"23540","WBGene00165954","IV",6473536,6473556,20
"23541","WBGene00165956","IV",14817587,14817607,20
"23542","WBGene00165961","IV",16825889,16825909,20
"23543","WBGene00165964","IV",6292056,6292076,20
"23544","WBGene00165965","IV",17454861,17454881,20
"23545","WBGene00165981","IV",15915705,15915725,20
"23546","WBGene00165987","IV",5959175,5959195,20
"23547","WBGene00165990","IV",13748420,13748440,20
"23548","WBGene00165993","IV",13148375,13148395,20
"23549","WBGene00165994","IV",15694357,15694377,20
"23550","WBGene00165997","IV",15707826,15707846,20
"23551","WBGene00165999","IV",7207886,7207906,20
"23552","WBGene00166000","IV",14918757,14918777,20
"23553","WBGene00166002","IV",14219686,14219706,20
"23554","WBGene00166003","IV",6036574,6036594,20
"23555","WBGene00166008","IV",6198972,6198992,20
"23556","WBGene00166009","IV",15679693,15679713,20
"23557","WBGene00166014","IV",15691849,15691869,20
"23558","WBGene00166020","IV",15483231,15483251,20
"23559","WBGene00166022","IV",15788775,15788795,20
"23560","WBGene00166027","IV",5504015,5504035,20
"23561","WBGene00166030","IV",14735358,14735378,20
"23562","WBGene00166033","IV",6214268,6214288,20
"23563","WBGene00166034","IV",16026533,16026553,20
"23564","WBGene00166043","IV",15545680,15545700,20
"23565","WBGene00166046","IV",15486404,15486424,20
"23566","WBGene00166047","IV",6426900,6426920,20
"23567","WBGene00166052","IV",14899105,14899125,20
"23568","WBGene00166055","I",4893420,4893440,20
"23569","WBGene00166058","IV",14371504,14371524,20
"23570","WBGene00166060","IV",16077860,16077880,20
"23571","WBGene00166064","IV",13946597,13946617,20
"23572","WBGene00166066","IV",12242075,12242095,20
"23573","WBGene00166068","IV",13543927,13543947,20
"23574","WBGene00166069","IV",15712354,15712374,20
"23575","WBGene00166072","IV",16751499,16751519,20
"23576","WBGene00166073","IV",9434499,9434519,20
"23577","WBGene00166077","IV",14974811,14974831,20
"23578","WBGene00166078","IV",14319116,14319136,20
"23579","WBGene00166079","IV",15272776,15272796,20
"23580","WBGene00166082","IV",16471118,16471138,20
"23581","WBGene00166084","IV",16034862,16034882,20
"23582","WBGene00166089","IV",14583550,14583570,20
"23583","WBGene00166091","IV",15413018,15413038,20
"23584","WBGene00166095","IV",15111465,15111485,20
"23585","WBGene00166097","IV",17232217,17232237,20
"23586","WBGene00166099","IV",16771443,16771463,20
"23587","WBGene00166100","IV",6576592,6576612,20
"23588","WBGene00166101","IV",6754135,6754155,20
"23589","WBGene00166105","IV",14610682,14610702,20
"23590","WBGene00166107","IV",14991035,14991055,20
"23591","WBGene00166110","IV",15211802,15211822,20
"23592","WBGene00166111","IV",16030402,16030422,20
"23593","WBGene00166113","IV",15540778,15540798,20
"23594","WBGene00166117","IV",6016871,6016891,20
"23595","WBGene00166119","IV",13978575,13978595,20
"23596","WBGene00166120","IV",4788901,4788921,20
"23597","WBGene00166125","IV",14123051,14123071,20
"23598","WBGene00166126","IV",17186670,17186690,20
"23599","WBGene00166127","IV",5591689,5591709,20
"23600","WBGene00166130","IV",14499943,14499963,20
"23601","WBGene00166131","IV",13840925,13840945,20
"23602","WBGene00166134","IV",6018279,6018299,20
"23603","WBGene00166135","IV",16195146,16195166,20
"23604","WBGene00166141","IV",5338511,5338531,20
"23605","WBGene00166142","IV",5493759,5493779,20
"23606","WBGene00166150","IV",16006767,16006787,20
"23607","WBGene00166151","IV",7896698,7896718,20
"23608","WBGene00166158","X",6004347,6004367,20
"23609","WBGene00166160","IV",5928944,5928964,20
"23610","WBGene00166162","IV",16718603,16718623,20
"23611","WBGene00166164","IV",5926544,5926564,20
"23612","WBGene00166167","IV",14128703,14128723,20
"23613","WBGene00166168","IV",13732212,13732232,20
"23614","WBGene00166171","IV",6772831,6772851,20
"23615","WBGene00166174","IV",16045252,16045272,20
"23616","WBGene00166175","IV",17152569,17152589,20
"23617","WBGene00166183","X",3516578,3516598,20
"23618","WBGene00166185","IV",5142645,5142665,20
"23619","WBGene00166188","IV",5507696,5507716,20
"23620","WBGene00166191","IV",14666656,14666676,20
"23621","WBGene00166193","IV",14507493,14507513,20
"23622","WBGene00166195","IV",14373104,14373124,20
"23623","WBGene00166198","IV",14391608,14391628,20
"23624","WBGene00166199","IV",16798337,16798357,20
"23625","WBGene00166205","IV",16030401,16030421,20
"23626","WBGene00166206","V",15951047,15951067,20
"23627","WBGene00166208","IV",13921056,13921076,20
"23628","WBGene00166210","IV",14491625,14491645,20
"23629","WBGene00166211","IV",5756857,5756877,20
"23630","WBGene00166216","IV",6013575,6013595,20
"23631","WBGene00166218","IV",16797266,16797286,20
"23632","WBGene00166220","IV",13705828,13705848,20
"23633","WBGene00166221","X",10437565,10437585,20
"23634","WBGene00166225","IV",5527620,5527640,20
"23635","WBGene00166227","IV",15713218,15713238,20
"23636","WBGene00166230","IV",13927284,13927304,20
"23637","WBGene00166234","IV",13813444,13813464,20
"23638","WBGene00166235","IV",13843734,13843754,20
"23639","WBGene00166236","IV",15613155,15613175,20
"23640","WBGene00166237","IV",15796063,15796083,20
"23641","WBGene00166238","IV",15578260,15578280,20
"23642","WBGene00166240","IV",15907522,15907542,20
"23643","WBGene00166241","IV",15901719,15901739,20
"23644","WBGene00166244","IV",16707012,16707032,20
"23645","WBGene00166246","IV",17229371,17229391,20
"23646","WBGene00166248","IV",14038774,14038794,20
"23647","WBGene00166253","IV",6543609,6543629,20
"23648","WBGene00166258","IV",6148131,6148151,20
"23649","WBGene00166259","X",13990864,13990884,20
"23650","WBGene00166261","IV",14131119,14131139,20
"23651","WBGene00166263","IV",14393724,14393744,20
"23652","WBGene00166264","IV",15386873,15386893,20
"23653","WBGene00166266","IV",6209972,6209992,20
"23654","WBGene00166269","V",9154888,9154908,20
"23655","WBGene00166273","IV",5136263,5136283,20
"23656","WBGene00166274","IV",6509203,6509223,20
"23657","WBGene00166278","IV",6959371,6959391,20
"23658","WBGene00166280","IV",14914666,14914686,20
"23659","WBGene00166281","IV",15682763,15682783,20
"23660","WBGene00166285","IV",12535086,12535106,20
"23661","WBGene00166288","II",7540017,7540037,20
"23662","WBGene00166289","III",6929886,6929906,20
"23663","WBGene00166290","I",11003572,11003592,20
"23664","WBGene00166291","IV",6202656,6202676,20
"23665","WBGene00166292","IV",5601274,5601294,20
"23666","WBGene00166294","IV",14670205,14670225,20
"23667","WBGene00166302","IV",16355342,16355362,20
"23668","WBGene00166303","IV",5041344,5041364,20
"23669","WBGene00166310","IV",14703035,14703055,20
"23670","WBGene00166311","X",17673476,17673496,20
"23671","WBGene00166312","IV",15822012,15822032,20
"23672","WBGene00166315","IV",15235514,15235534,20
"23673","WBGene00166322","IV",15934403,15934423,20
"23674","WBGene00166323","IV",6051270,6051290,20
"23675","WBGene00166325","IV",16366792,16366812,20
"23676","WBGene00166327","IV",14745925,14745945,20
"23677","WBGene00166331","I",5591348,5591368,20
"23678","WBGene00166332","I",3697596,3697616,20
"23679","WBGene00166333","IV",16437537,16437557,20
"23680","WBGene00166339","IV",5760149,5760169,20
"23681","WBGene00166345","IV",14997277,14997297,20
"23682","WBGene00166346","IV",10421249,10421269,20
"23683","WBGene00166350","IV",5121771,5121791,20
"23684","WBGene00166354","IV",15935327,15935347,20
"23685","WBGene00166356","IV",5020313,5020333,20
"23686","WBGene00166361","IV",6848453,6848473,20
"23687","WBGene00166369","IV",14680953,14680973,20
"23688","WBGene00166370","IV",4845602,4845622,20
"23689","WBGene00166372","IV",3343584,3343604,20
"23690","WBGene00166374","IV",12268648,12268668,20
"23691","WBGene00166377","IV",16840247,16840267,20
"23692","WBGene00166379","IV",14659743,14659763,20
"23693","WBGene00166380","II",10435999,10436019,20
"23694","WBGene00166384","IV",14054169,14054189,20
"23695","WBGene00166385","IV",5320693,5320713,20
"23696","WBGene00166394","IV",5319732,5319752,20
"23697","WBGene00166397","IV",6839479,6839499,20
"23698","WBGene00166401","IV",16674247,16674267,20
"23699","WBGene00166412","IV",5822650,5822670,20
"23700","WBGene00166416","IV",5668101,5668121,20
"23701","WBGene00166418","X",2874320,2874340,20
"23702","WBGene00166421","IV",13991378,13991398,20
"23703","WBGene00166422","IV",14888717,14888737,20
"23704","WBGene00166438","IV",14878980,14879000,20
"23705","WBGene00166446","IV",9131271,9131291,20
"23706","WBGene00166448","I",272607,272627,20
"23707","WBGene00166449","IV",15815881,15815901,20
"23708","WBGene00166451","IV",14559148,14559168,20
"23709","WBGene00166452","IV",16538989,16539009,20
"23710","WBGene00166457","IV",13694376,13694396,20
"23711","WBGene00166465","IV",14509715,14509735,20
"23712","WBGene00166466","IV",14562620,14562640,20
"23713","WBGene00166467","IV",15272522,15272542,20
"23714","WBGene00166471","IV",6076598,6076618,20
"23715","WBGene00166477","IV",5351257,5351277,20
"23716","WBGene00166479","IV",14892663,14892683,20
"23717","WBGene00166480","IV",6113117,6113137,20
"23718","WBGene00166488","IV",14045725,14045745,20
"23719","WBGene00166490","IV",5144311,5144331,20
"23720","WBGene00166494","IV",15720205,15720225,20
"23721","WBGene00166496","IV",15669333,15669353,20
"23722","WBGene00166500","IV",58691,58711,20
"23723","WBGene00166501","IV",14101460,14101480,20
"23724","WBGene00166502","IV",6853566,6853586,20
"23725","WBGene00166504","IV",5643165,5643185,20
"23726","WBGene00166506","IV",17261846,17261866,20
"23727","WBGene00166509","IV",4832480,4832500,20
"23728","WBGene00166511","IV",14482607,14482627,20
"23729","WBGene00166514","IV",5603155,5603175,20
"23730","WBGene00166516","IV",17232310,17232330,20
"23731","WBGene00166519","IV",16603009,16603029,20
"23732","WBGene00166520","V",11447245,11447265,20
"23733","WBGene00166523","IV",10059593,10059613,20
"23734","WBGene00166526","IV",14000998,14001018,20
"23735","WBGene00166529","IV",5004173,5004193,20
"23736","WBGene00166530","IV",16691561,16691581,20
"23737","WBGene00166531","IV",6429756,6429776,20
"23738","WBGene00166534","IV",5325992,5326012,20
"23739","WBGene00166535","IV",1356736,1356756,20
"23740","WBGene00166540","IV",17261545,17261565,20
"23741","WBGene00166549","I",5784642,5784662,20
"23742","WBGene00166559","IV",14548835,14548855,20
"23743","WBGene00166560","IV",5865129,5865149,20
"23744","WBGene00166562","V",11947275,11947295,20
"23745","WBGene00166564","IV",12547381,12547401,20
"23746","WBGene00166567","IV",7354365,7354385,20
"23747","WBGene00166568","IV",15877378,15877398,20
"23748","WBGene00166573","IV",14892187,14892207,20
"23749","WBGene00166576","IV",16995073,16995093,20
"23750","WBGene00166579","IV",16603140,16603160,20
"23751","WBGene00166582","IV",14560255,14560275,20
"23752","WBGene00166584","IV",16119420,16119440,20
"23753","WBGene00166588","IV",14702554,14702574,20
"23754","WBGene00166589","IV",5046702,5046722,20
"23755","WBGene00166590","IV",15118302,15118322,20
"23756","WBGene00166591","IV",7079943,7079963,20
"23757","WBGene00166593","IV",14359765,14359785,20
"23758","WBGene00166594","V",5525388,5525408,20
"23759","WBGene00166595","IV",15731745,15731765,20
"23760","WBGene00166596","IV",14011273,14011293,20
"23761","WBGene00166597","IV",16003597,16003617,20
"23762","WBGene00166602","IV",14737764,14737784,20
"23763","WBGene00166603","IV",5806379,5806399,20
"23764","WBGene00166609","IV",14176749,14176769,20
"23765","WBGene00166614","IV",16593347,16593367,20
"23766","WBGene00166617","IV",14887561,14887581,20
"23767","WBGene00166619","IV",17175514,17175534,20
"23768","WBGene00166623","IV",6189864,6189884,20
"23769","WBGene00166627","IV",15267026,15267046,20
"23770","WBGene00166633","IV",13763111,13763131,20
"23771","WBGene00166637","IV",16833977,16833997,20
"23772","WBGene00166638","IV",14457944,14457964,20
"23773","WBGene00166640","IV",6812914,6812934,20
"23774","WBGene00166646","IV",14492790,14492810,20
"23775","WBGene00166648","IV",15430453,15430473,20
"23776","WBGene00166649","IV",5725883,5725903,20
"23777","WBGene00166652","IV",14681523,14681543,20
"23778","WBGene00166653","IV",13955409,13955429,20
"23779","WBGene00166659","IV",5524765,5524785,20
"23780","WBGene00166662","IV",5432236,5432256,20
"23781","WBGene00166663","IV",14390234,14390254,20
"23782","WBGene00166664","IV",9447084,9447104,20
"23783","WBGene00166668","IV",14266259,14266279,20
"23784","WBGene00166681","IV",16876311,16876331,20
"23785","WBGene00166686","IV",6992379,6992399,20
"23786","WBGene00166687","IV",5826874,5826894,20
"23787","WBGene00166692","IV",14609439,14609459,20
"23788","WBGene00166693","IV",16254061,16254081,20
"23789","WBGene00166696","IV",14261272,14261292,20
"23790","WBGene00166697","IV",14375004,14375024,20
"23791","WBGene00166699","IV",13009637,13009657,20
"23792","WBGene00166710","IV",16886827,16886847,20
"23793","WBGene00166713","IV",5766034,5766054,20
"23794","WBGene00166716","IV",5436245,5436265,20
"23795","WBGene00166719","IV",14663948,14663968,20
"23796","WBGene00166720","IV",9466844,9466864,20
"23797","WBGene00166723","IV",5606525,5606545,20
"23798","WBGene00166726","IV",13941866,13941886,20
"23799","WBGene00166731","IV",5516823,5516843,20
"23800","WBGene00166732","IV",14837999,14838019,20
"23801","WBGene00166735","IV",14270313,14270333,20
"23802","WBGene00166738","IV",6773304,6773324,20
"23803","WBGene00166739","IV",15435945,15435965,20
"23804","WBGene00166740","IV",16031665,16031685,20
"23805","WBGene00166741","IV",15868226,15868246,20
"23806","WBGene00166748","IV",14922154,14922174,20
"23807","WBGene00166751","IV",5800750,5800770,20
"23808","WBGene00166760","II",6893972,6893992,20
"23809","WBGene00166765","IV",14224015,14224035,20
"23810","WBGene00166768","I",9525260,9525280,20
"23811","WBGene00166772","X",8667372,8667392,20
"23812","WBGene00166780","IV",14025120,14025140,20
"23813","WBGene00166781","IV",9140165,9140185,20
"23814","WBGene00166786","IV",5386198,5386218,20
"23815","WBGene00166794","IV",15986597,15986617,20
"23816","WBGene00166796","IV",9545862,9545882,20
"23817","WBGene00166797","IV",5342926,5342946,20
"23818","WBGene00166800","IV",14940965,14940985,20
"23819","WBGene00166801","IV",14648680,14648700,20
"23820","WBGene00166804","IV",13974484,13974504,20
"23821","WBGene00166805","IV",14483453,14483473,20
"23822","WBGene00166808","IV",5632346,5632366,20
"23823","WBGene00166811","IV",6810811,6810831,20
"23824","WBGene00166829","IV",15506079,15506099,20
"23825","WBGene00166831","IV",6500178,6500198,20
"23826","WBGene00166833","IV",5563345,5563365,20
"23827","WBGene00166834","IV",14292439,14292459,20
"23828","WBGene00166836","IV",14357119,14357139,20
"23829","WBGene00166839","IV",14685361,14685381,20
"23830","WBGene00166840","IV",14686583,14686603,20
"23831","WBGene00166841","IV",14271844,14271864,20
"23832","WBGene00166847","IV",16070076,16070096,20
"23833","WBGene00166851","IV",15405913,15405933,20
"23834","WBGene00166853","IV",5857993,5858013,20
"23835","WBGene00166854","II",3555763,3555783,20
"23836","WBGene00166856","IV",6414754,6414774,20
"23837","WBGene00166857","IV",13544327,13544347,20
"23838","WBGene00166859","IV",15321805,15321825,20
"23839","WBGene00166862","IV",5134727,5134747,20
"23840","WBGene00166867","IV",15295814,15295834,20
"23841","WBGene00166869","IV",6172327,6172347,20
"23842","WBGene00166870","IV",15847848,15847868,20
"23843","WBGene00166878","IV",17185837,17185857,20
"23844","WBGene00166885","IV",15808121,15808141,20
"23845","WBGene00166886","IV",14744522,14744542,20
"23846","WBGene00166890","IV",14413257,14413277,20
"23847","WBGene00166891","IV",5855415,5855435,20
"23848","WBGene00166894","X",9981249,9981269,20
"23849","WBGene00166898","IV",5803680,5803700,20
"23850","WBGene00166902","IV",4998963,4998983,20
"23851","WBGene00166911","IV",7096103,7096123,20
"23852","WBGene00166912","IV",16804773,16804793,20
"23853","WBGene00166919","IV",14998980,14999000,20
"23854","WBGene00166921","IV",5199458,5199478,20
"23855","WBGene00166922","IV",13768244,13768264,20
"23856","WBGene00166932","IV",5043125,5043145,20
"23857","WBGene00166933","IV",14874508,14874528,20
"23858","WBGene00166934","IV",6132673,6132693,20
"23859","WBGene00166937","IV",14434267,14434287,20
"23860","WBGene00166938","IV",14392254,14392274,20
"23861","WBGene00166939","III",2760618,2760638,20
"23862","WBGene00166946","IV",5756021,5756041,20
"23863","WBGene00166950","IV",14094928,14094948,20
"23864","WBGene00166954","IV",14829429,14829449,20
"23865","WBGene00166960","IV",16699207,16699227,20
"23866","WBGene00166962","IV",5575485,5575505,20
"23867","WBGene00166963","X",2459294,2459314,20
"23868","WBGene00166965","IV",14232231,14232251,20
"23869","WBGene00166966","IV",7940064,7940084,20
"23870","WBGene00166972","V",10917050,10917070,20
"23871","WBGene00166975","I",10005524,10005544,20
"23872","WBGene00166980","IV",17430169,17430189,20
"23873","WBGene00166986","V",14337701,14337721,20
"23874","WBGene00166988","IV",17200513,17200533,20
"23875","WBGene00166989","IV",14873812,14873832,20
"23876","WBGene00166991","IV",14056195,14056215,20
"23877","WBGene00166995","IV",13869635,13869655,20
"23878","WBGene00166996","IV",6959368,6959388,20
"23879","WBGene00166997","IV",6446890,6446910,20
"23880","WBGene00166998","IV",5073541,5073561,20
"23881","WBGene00167000","IV",5594331,5594351,20
"23882","WBGene00167003","IV",14579702,14579722,20
"23883","WBGene00167004","IV",5126457,5126477,20
"23884","WBGene00167006","I",8312100,8312120,20
"23885","WBGene00167008","IV",14702074,14702094,20
"23886","WBGene00167009","X",10655492,10655512,20
"23887","WBGene00167016","IV",14884811,14884831,20
"23888","WBGene00167017","IV",16210044,16210064,20
"23889","WBGene00167019","IV",5729396,5729416,20
"23890","WBGene00167020","IV",16796345,16796365,20
"23891","WBGene00167022","V",9799479,9799499,20
"23892","WBGene00167023","IV",17187940,17187960,20
"23893","WBGene00167025","V",5695744,5695764,20
"23894","WBGene00167028","IV",7097793,7097813,20
"23895","WBGene00167029","IV",14647209,14647229,20
"23896","WBGene00167030","IV",14614707,14614727,20
"23897","WBGene00167034","IV",6653179,6653199,20
"23898","WBGene00167035","X",15215617,15215637,20
"23899","WBGene00167039","IV",5562338,5562358,20
"23900","WBGene00167046","IV",13834147,13834167,20
"23901","WBGene00167047","IV",14122159,14122179,20
"23902","WBGene00167050","IV",14845588,14845608,20
"23903","WBGene00167053","IV",15812813,15812833,20
"23904","WBGene00167057","IV",14739617,14739637,20
"23905","WBGene00167061","IV",15612441,15612461,20
"23906","WBGene00167063","IV",4944219,4944239,20
"23907","WBGene00167065","IV",5968308,5968328,20
"23908","WBGene00167068","IV",15356166,15356186,20
"23909","WBGene00167070","IV",16987903,16987923,20
"23910","WBGene00167073","IV",14047466,14047486,20
"23911","WBGene00167074","IV",14473462,14473482,20
"23912","WBGene00167077","IV",14855256,14855276,20
"23913","WBGene00167078","IV",15563662,15563682,20
"23914","WBGene00167079","IV",5764801,5764821,20
"23915","WBGene00167080","IV",11938338,11938358,20
"23916","WBGene00167083","IV",14737722,14737742,20
"23917","WBGene00167084","IV",16536844,16536864,20
"23918","WBGene00167090","IV",6855340,6855360,20
"23919","WBGene00167091","IV",5968884,5968904,20
"23920","WBGene00167094","IV",14326269,14326289,20
"23921","WBGene00167095","IV",13874582,13874602,20
"23922","WBGene00167096","IV",6043637,6043657,20
"23923","WBGene00167102","IV",5889277,5889297,20
"23924","WBGene00167103","IV",5968305,5968325,20
"23925","WBGene00167104","IV",14290586,14290606,20
"23926","WBGene00167105","IV",5291729,5291749,20
"23927","WBGene00167107","IV",15602635,15602655,20
"23928","WBGene00167110","IV",5969113,5969133,20
"23929","WBGene00167120","V",11693920,11693940,20
"23930","WBGene00167131","IV",16193598,16193618,20
"23931","WBGene00167132","IV",14330112,14330132,20
"23932","WBGene00167133","IV",13866819,13866839,20
"23933","WBGene00167134","IV",5505146,5505166,20
"23934","WBGene00167139","IV",13731009,13731029,20
"23935","WBGene00167141","IV",5524272,5524292,20
"23936","WBGene00167142","IV",5599829,5599849,20
"23937","WBGene00167143","IV",5289938,5289958,20
"23938","WBGene00167146","IV",6142771,6142791,20
"23939","WBGene00167147","IV",15943895,15943915,20
"23940","WBGene00167148","IV",14862915,14862935,20
"23941","WBGene00167155","IV",5716198,5716218,20
"23942","WBGene00167156","IV",5561350,5561370,20
"23943","WBGene00167157","IV",5758303,5758323,20
"23944","WBGene00167159","IV",9129135,9129155,20
"23945","WBGene00167161","IV",13898253,13898273,20
"23946","WBGene00167163","IV",5720421,5720441,20
"23947","WBGene00167165","IV",15823446,15823466,20
"23948","WBGene00167172","III",749408,749428,20
"23949","WBGene00167176","IV",5565889,5565909,20
"23950","WBGene00167181","IV",16694805,16694825,20
"23951","WBGene00167182","IV",5133084,5133104,20
"23952","WBGene00167183","IV",5340778,5340798,20
"23953","WBGene00167186","IV",14665453,14665473,20
"23954","WBGene00167188","IV",14283259,14283279,20
"23955","WBGene00167190","IV",5600109,5600129,20
"23956","WBGene00167196","IV",15326727,15326747,20
"23957","WBGene00167198","IV",6491146,6491166,20
"23958","WBGene00167202","IV",6802492,6802512,20
"23959","WBGene00167204","IV",6504107,6504127,20
"23960","WBGene00167207","IV",6952878,6952898,20
"23961","WBGene00167209","IV",14953896,14953916,20
"23962","WBGene00167210","IV",15266176,15266196,20
"23963","WBGene00167214","IV",14680112,14680132,20
"23964","WBGene00167217","IV",16027063,16027083,20
"23965","WBGene00167221","V",3275255,3275275,20
"23966","WBGene00167223","IV",14497788,14497808,20
"23967","WBGene00167225","IV",5759473,5759493,20
"23968","WBGene00167228","IV",4841842,4841862,20
"23969","WBGene00167233","IV",16665768,16665788,20
"23970","WBGene00167237","IV",14876508,14876528,20
"23971","WBGene00167241","IV",6274997,6275017,20
"23972","WBGene00167242","IV",13631073,13631093,20
"23973","WBGene00167255","IV",6402160,6402180,20
"23974","WBGene00167261","IV",6131495,6131515,20
"23975","WBGene00167262","IV",13958102,13958122,20
"23976","WBGene00167263","IV",16380007,16380027,20
"23977","WBGene00167264","IV",15794793,15794813,20
"23978","WBGene00167266","IV",5079652,5079672,20
"23979","WBGene00167269","IV",6957119,6957139,20
"23980","WBGene00167273","IV",13889555,13889575,20
"23981","WBGene00167279","IV",9581734,9581754,20
"23982","WBGene00167286","IV",16209759,16209779,20
"23983","WBGene00167287","IV",15552723,15552743,20
"23984","WBGene00167290","IV",14723678,14723698,20
"23985","WBGene00167291","IV",5449434,5449454,20
"23986","WBGene00167292","IV",14610667,14610687,20
"23987","WBGene00167293","IV",5912640,5912660,20
"23988","WBGene00167297","IV",5560395,5560415,20
"23989","WBGene00167299","IV",14818753,14818773,20
"23990","WBGene00167300","IV",14900068,14900088,20
"23991","WBGene00167301","IV",5338272,5338292,20
"23992","WBGene00167302","IV",5827945,5827965,20
"23993","WBGene00167303","IV",10425884,10425904,20
"23994","WBGene00167306","IV",14494065,14494085,20
"23995","WBGene00167311","IV",6432702,6432722,20
"23996","WBGene00167313","IV",5010394,5010414,20
"23997","WBGene00167317","IV",16079260,16079280,20
"23998","WBGene00167321","IV",15275302,15275322,20
"23999","WBGene00167324","IV",13568051,13568071,20
"24000","WBGene00167325","X",11541688,11541708,20
"24001","WBGene00167330","IV",16248108,16248128,20
"24002","WBGene00167331","IV",7530659,7530679,20
"24003","WBGene00167334","X",6979743,6979763,20
"24004","WBGene00167336","IV",15696259,15696279,20
"24005","WBGene00167338","IV",14968360,14968380,20
"24006","WBGene00167341","IV",5888160,5888180,20
"24007","WBGene00167345","IV",14871274,14871294,20
"24008","WBGene00167347","IV",5599171,5599191,20
"24009","WBGene00167348","IV",5352615,5352635,20
"24010","WBGene00167349","IV",16798617,16798637,20
"24011","WBGene00167352","IV",5426063,5426083,20
"24012","WBGene00167353","IV",17233994,17234014,20
"24013","WBGene00167354","IV",13990532,13990552,20
"24014","WBGene00167356","IV",5576224,5576244,20
"24015","WBGene00167358","IV",14275333,14275353,20
"24016","WBGene00167365","IV",14486859,14486879,20
"24017","WBGene00167369","IV",14460270,14460290,20
"24018","WBGene00167370","IV",14122846,14122866,20
"24019","WBGene00167371","IV",15920181,15920201,20
"24020","WBGene00167374","IV",14651459,14651479,20
"24021","WBGene00167376","IV",4842494,4842514,20
"24022","WBGene00167382","IV",15167774,15167794,20
"24023","WBGene00167386","IV",16916723,16916743,20
"24024","WBGene00167388","V",7038393,7038413,20
"24025","WBGene00167392","IV",4866579,4866599,20
"24026","WBGene00167394","IV",8518193,8518213,20
"24027","WBGene00167395","IV",15803731,15803751,20
"24028","WBGene00167400","X",10208379,10208399,20
"24029","WBGene00167403","V",3625766,3625786,20
"24030","WBGene00167406","IV",5834084,5834104,20
"24031","WBGene00167414","IV",5094367,5094387,20
"24032","WBGene00167416","IV",14804619,14804639,20
"24033","WBGene00167417","IV",14003408,14003428,20
"24034","WBGene00167424","IV",16358558,16358578,20
"24035","WBGene00167425","IV",16017293,16017313,20
"24036","WBGene00167426","IV",13900671,13900691,20
"24037","WBGene00167427","IV",5836691,5836711,20
"24038","WBGene00167431","IV",17476504,17476524,20
"24039","WBGene00167432","IV",4844304,4844324,20
"24040","WBGene00167440","II",7994253,7994273,20
"24041","WBGene00167442","IV",16018218,16018238,20
"24042","WBGene00167443","IV",16239064,16239084,20
"24043","WBGene00167446","IV",14242658,14242678,20
"24044","WBGene00167448","IV",13928870,13928890,20
"24045","WBGene00167449","IV",10085463,10085483,20
"24046","WBGene00167451","IV",16143257,16143277,20
"24047","WBGene00167453","IV",5448838,5448858,20
"24048","WBGene00167454","IV",14494202,14494222,20
"24049","WBGene00167463","IV",14873480,14873500,20
"24050","WBGene00167467","IV",16527196,16527216,20
"24051","WBGene00167468","IV",5039838,5039858,20
"24052","WBGene00167469","IV",13971956,13971976,20
"24053","WBGene00167473","V",13539988,13540008,20
"24054","WBGene00167479","IV",17078101,17078121,20
"24055","WBGene00167485","IV",15438853,15438873,20
"24056","WBGene00167495","IV",5434773,5434793,20
"24057","WBGene00167497","IV",13762512,13762532,20
"24058","WBGene00167503","IV",6488454,6488474,20
"24059","WBGene00167507","IV",6385984,6386004,20
"24060","WBGene00167509","IV",13940190,13940210,20
"24061","WBGene00167510","IV",6657938,6657958,20
"24062","WBGene00167511","IV",16455563,16455583,20
"24063","WBGene00167512","IV",17482196,17482216,20
"24064","WBGene00167518","IV",14407846,14407866,20
"24065","WBGene00167520","IV",6651478,6651498,20
"24066","WBGene00167529","IV",14506019,14506039,20
"24067","WBGene00167531","IV",5450015,5450035,20
"24068","WBGene00167535","IV",16913088,16913108,20
"24069","WBGene00167536","IV",5670662,5670682,20
"24070","WBGene00167537","IV",5620144,5620164,20
"24071","WBGene00167539","III",3047481,3047501,20
"24072","WBGene00167542","IV",15260329,15260349,20
"24073","WBGene00167544","IV",15548834,15548854,20
"24074","WBGene00167545","IV",5823605,5823625,20
"24075","WBGene00167546","IV",15388271,15388291,20
"24076","WBGene00167547","IV",13603183,13603203,20
"24077","WBGene00167550","IV",14902209,14902229,20
"24078","WBGene00167551","IV",14504844,14504864,20
"24079","WBGene00167552","IV",4830214,4830234,20
"24080","WBGene00167562","IV",5148615,5148635,20
"24081","WBGene00167566","V",13602773,13602793,20
"24082","WBGene00167571","IV",14647464,14647484,20
"24083","WBGene00167572","IV",14540414,14540434,20
"24084","WBGene00167574","IV",6050359,6050379,20
"24085","WBGene00167575","IV",5779287,5779307,20
"24086","WBGene00167577","IV",14963555,14963575,20
"24087","WBGene00167581","IV",14967616,14967636,20
"24088","WBGene00167582","IV",4919926,4919946,20
"24089","WBGene00167586","IV",14683992,14684012,20
"24090","WBGene00167588","IV",5530352,5530372,20
"24091","WBGene00167601","IV",15054384,15054404,20
"24092","WBGene00167602","X",15290528,15290548,20
"24093","WBGene00167610","IV",16838444,16838464,20
"24094","WBGene00167612","IV",5508140,5508160,20
"24095","WBGene00167613","IV",13553420,13553440,20
"24096","WBGene00167616","III",10693142,10693162,20
"24097","WBGene00167620","IV",6044724,6044744,20
"24098","WBGene00167625","IV",14598363,14598383,20
"24099","WBGene00167626","IV",6678012,6678032,20
"24100","WBGene00167630","IV",6381374,6381394,20
"24101","WBGene00167632","V",3463423,3463443,20
"24102","WBGene00167634","IV",16668419,16668439,20
"24103","WBGene00167635","IV",14366552,14366572,20
"24104","WBGene00167640","IV",14262288,14262308,20
"24105","WBGene00167641","IV",15764283,15764303,20
"24106","WBGene00167642","IV",14031989,14032009,20
"24107","WBGene00167643","IV",15258631,15258651,20
"24108","WBGene00167647","IV",5711905,5711925,20
"24109","WBGene00167649","IV",14831305,14831325,20
"24110","WBGene00167650","IV",17046876,17046896,20
"24111","WBGene00167651","IV",6188223,6188243,20
"24112","WBGene00167652","I",7656454,7656474,20
"24113","WBGene00167655","IV",15135588,15135608,20
"24114","WBGene00167659","IV",14645645,14645665,20
"24115","WBGene00167661","IV",6940492,6940512,20
"24116","WBGene00167662","IV",14372157,14372177,20
"24117","WBGene00167664","IV",15817910,15817930,20
"24118","WBGene00167665","IV",17232889,17232909,20
"24119","WBGene00167669","IV",14368458,14368478,20
"24120","WBGene00167676","IV",6495450,6495470,20
"24121","WBGene00167677","IV",16509599,16509619,20
"24122","WBGene00167680","IV",6111133,6111153,20
"24123","WBGene00167685","IV",7052532,7052552,20
"24124","WBGene00167689","II",10309255,10309275,20
"24125","WBGene00167690","IV",16053839,16053859,20
"24126","WBGene00167692","IV",5988129,5988149,20
"24127","WBGene00167696","IV",16873675,16873695,20
"24128","WBGene00167697","IV",17176748,17176768,20
"24129","WBGene00167699","IV",16641642,16641662,20
"24130","WBGene00167707","IV",16346643,16346663,20
"24131","WBGene00167708","IV",5639820,5639840,20
"24132","WBGene00167709","I",5113683,5113703,20
"24133","WBGene00167710","IV",16040815,16040835,20
"24134","WBGene00167716","IV",16711526,16711546,20
"24135","WBGene00167719","IV",16889744,16889764,20
"24136","WBGene00167722","IV",15280558,15280578,20
"24137","WBGene00167726","IV",6804377,6804397,20
"24138","WBGene00167729","IV",15312525,15312545,20
"24139","WBGene00167730","IV",15967936,15967956,20
"24140","WBGene00167732","IV",9660515,9660535,20
"24141","WBGene00167735","IV",14572093,14572113,20
"24142","WBGene00167738","I",5547013,5547033,20
"24143","WBGene00167744","IV",14890035,14890055,20
"24144","WBGene00167745","IV",14806136,14806156,20
"24145","WBGene00167747","IV",13907111,13907131,20
"24146","WBGene00167758","IV",5416804,5416824,20
"24147","WBGene00167759","I",8138868,8138888,20
"24148","WBGene00167765","IV",16131158,16131178,20
"24149","WBGene00167768","IV",16611114,16611134,20
"24150","WBGene00167769","IV",13700050,13700070,20
"24151","WBGene00167772","IV",5821407,5821427,20
"24152","WBGene00167774","IV",5712813,5712833,20
"24153","WBGene00167776","IV",16889208,16889228,20
"24154","WBGene00167782","IV",13950753,13950773,20
"24155","WBGene00167783","II",8915660,8915680,20
"24156","WBGene00167785","IV",5587813,5587833,20
"24157","WBGene00167786","IV",15004135,15004155,20
"24158","WBGene00167787","IV",14618251,14618271,20
"24159","WBGene00167788","IV",15805940,15805960,20
"24160","WBGene00167790","IV",14359186,14359206,20
"24161","WBGene00167793","IV",12768876,12768896,20
"24162","WBGene00167796","IV",15500322,15500342,20
"24163","WBGene00167797","IV",5152686,5152706,20
"24164","WBGene00167812","IV",14278070,14278090,20
"24165","WBGene00167813","IV",6301619,6301639,20
"24166","WBGene00167814","IV",5425798,5425818,20
"24167","WBGene00167820","IV",13640880,13640900,20
"24168","WBGene00167825","IV",5605101,5605121,20
"24169","WBGene00167828","IV",14857509,14857529,20
"24170","WBGene00167829","IV",13751927,13751947,20
"24171","WBGene00167830","IV",5331149,5331169,20
"24172","WBGene00167831","IV",16445820,16445840,20
"24173","WBGene00167846","IV",15851808,15851828,20
"24174","WBGene00167847","IV",5414521,5414541,20
"24175","WBGene00167854","IV",5037362,5037382,20
"24176","WBGene00167855","IV",14496893,14496913,20
"24177","WBGene00167860","IV",14873127,14873147,20
"24178","WBGene00167863","IV",16173520,16173540,20
"24179","WBGene00167867","II",10028933,10028953,20
"24180","WBGene00167872","IV",17211559,17211579,20
"24181","WBGene00167874","IV",6403067,6403087,20
"24182","WBGene00167878","IV",14101242,14101262,20
"24183","WBGene00167885","IV",17198830,17198850,20
"24184","WBGene00167887","IV",17196521,17196541,20
"24185","WBGene00167891","IV",6005000,6005020,20
"24186","WBGene00167893","IV",15497934,15497954,20
"24187","WBGene00167897","V",10217596,10217616,20
"24188","WBGene00167901","IV",14650334,14650354,20
"24189","WBGene00167904","IV",14496096,14496116,20
"24190","WBGene00167905","IV",5182760,5182780,20
"24191","WBGene00167906","IV",16739954,16739974,20
"24192","WBGene00167909","X",12715926,12715946,20
"24193","WBGene00167913","IV",15216964,15216984,20
"24194","WBGene00167918","IV",6021562,6021582,20
"24195","WBGene00167919","IV",5147056,5147076,20
"24196","WBGene00167921","IV",16641166,16641186,20
"24197","WBGene00167922","IV",6131070,6131090,20
"24198","WBGene00167925","II",7033595,7033615,20
"24199","WBGene00167926","IV",14610337,14610357,20
"24200","WBGene00167927","IV",5129516,5129536,20
"24201","WBGene00167939","IV",13691047,13691067,20
"24202","WBGene00167948","IV",15566870,15566890,20
"24203","WBGene00167951","IV",15935057,15935077,20
"24204","WBGene00167952","IV",6200307,6200327,20
"24205","WBGene00167953","IV",16072809,16072829,20
"24206","WBGene00167956","IV",14387779,14387799,20
"24207","WBGene00167957","IV",8443095,8443115,20
"24208","WBGene00167958","IV",14988307,14988327,20
"24209","WBGene00167962","IV",6182878,6182898,20
"24210","WBGene00167966","IV",5634619,5634639,20
"24211","WBGene00167968","IV",14231586,14231606,20
"24212","WBGene00167971","IV",4872131,4872151,20
"24213","WBGene00167976","IV",15611756,15611776,20
"24214","WBGene00167978","IV",5779212,5779232,20
"24215","WBGene00167979","IV",14889544,14889564,20
"24216","WBGene00167993","IV",14680500,14680520,20
"24217","WBGene00167998","IV",14818412,14818432,20
"24218","WBGene00167999","IV",15658262,15658282,20
"24219","WBGene00168003","IV",13836505,13836525,20
"24220","WBGene00168006","IV",16149994,16150014,20
"24221","WBGene00168008","IV",14440721,14440741,20
"24222","WBGene00168009","IV",14429105,14429125,20
"24223","WBGene00168012","V",8617898,8617918,20
"24224","WBGene00168013","IV",6455545,6455565,20
"24225","WBGene00168015","IV",15723073,15723093,20
"24226","WBGene00168022","II",8534664,8534684,20
"24227","WBGene00168023","IV",15005515,15005535,20
"24228","WBGene00168024","IV",14761203,14761223,20
"24229","WBGene00168025","IV",14312905,14312925,20
"24230","WBGene00168028","IV",15259649,15259669,20
"24231","WBGene00168029","IV",14883006,14883026,20
"24232","WBGene00168033","IV",5425479,5425499,20
"24233","WBGene00168034","IV",16163582,16163602,20
"24234","WBGene00168035","IV",14883836,14883856,20
"24235","WBGene00168036","IV",4788904,4788924,20
"24236","WBGene00168039","IV",16163996,16164016,20
"24237","WBGene00168041","IV",15218562,15218582,20
"24238","WBGene00168047","IV",6093202,6093222,20
"24239","WBGene00168048","IV",15618105,15618125,20
"24240","WBGene00168049","IV",5388172,5388192,20
"24241","WBGene00168054","IV",14155142,14155162,20
"24242","WBGene00168055","IV",14395505,14395525,20
"24243","WBGene00168062","IV",6021896,6021916,20
"24244","WBGene00168066","IV",15564757,15564777,20
"24245","WBGene00168071","IV",13824320,13824340,20
"24246","WBGene00168072","IV",15764144,15764164,20
"24247","WBGene00168078","IV",16660143,16660163,20
"24248","WBGene00168079","IV",14267148,14267168,20
"24249","WBGene00168081","I",7387206,7387226,20
"24250","WBGene00168082","IV",14483203,14483223,20
"24251","WBGene00168083","IV",14474665,14474685,20
"24252","WBGene00168092","IV",5581580,5581600,20
"24253","WBGene00168096","IV",15997008,15997028,20
"24254","WBGene00168097","IV",14678910,14678930,20
"24255","WBGene00168100","IV",15669084,15669104,20
"24256","WBGene00168105","IV",5278978,5278998,20
"24257","WBGene00168109","IV",13838978,13838998,20
"24258","WBGene00168110","IV",14666436,14666456,20
"24259","WBGene00168113","IV",14169620,14169640,20
"24260","WBGene00168120","IV",5808788,5808808,20
"24261","WBGene00168121","IV",5736377,5736397,20
"24262","WBGene00168124","IV",16045697,16045717,20
"24263","WBGene00168130","X",9791006,9791026,20
"24264","WBGene00168131","IV",15572650,15572670,20
"24265","WBGene00168133","IV",15277820,15277840,20
"24266","WBGene00168145","IV",14051997,14052017,20
"24267","WBGene00168147","IV",5808374,5808394,20
"24268","WBGene00168148","IV",13943987,13944007,20
"24269","WBGene00168149","IV",16572326,16572346,20
"24270","WBGene00168150","IV",6063392,6063412,20
"24271","WBGene00168154","IV",5856274,5856294,20
"24272","WBGene00168157","IV",14026186,14026206,20
"24273","WBGene00168159","IV",6454675,6454695,20
"24274","WBGene00168163","IV",5777488,5777508,20
"24275","WBGene00168165","X",17643394,17643414,20
"24276","WBGene00168168","IV",17182106,17182126,20
"24277","WBGene00168175","IV",6112712,6112732,20
"24278","WBGene00168176","IV",16071266,16071286,20
"24279","WBGene00168180","IV",14851929,14851949,20
"24280","WBGene00168182","I",5915104,5915124,20
"24281","WBGene00168183","IV",13693578,13693598,20
"24282","WBGene00168185","IV",15819833,15819853,20
"24283","WBGene00168188","IV",16839711,16839731,20
"24284","WBGene00168190","IV",6542067,6542087,20
"24285","WBGene00168191","IV",16890929,16890949,20
"24286","WBGene00168200","IV",16148307,16148327,20
"24287","WBGene00168201","IV",5523793,5523813,20
"24288","WBGene00168204","IV",13561019,13561039,20
"24289","WBGene00168207","IV",6413264,6413284,20
"24290","WBGene00168209","IV",15795252,15795272,20
"24291","WBGene00168210","IV",5904712,5904732,20
"24292","WBGene00168212","IV",6482722,6482742,20
"24293","WBGene00168213","IV",5175171,5175191,20
"24294","WBGene00168215","IV",14401501,14401521,20
"24295","WBGene00168219","IV",16479967,16479987,20
"24296","WBGene00168227","IV",5761642,5761662,20
"24297","WBGene00168228","IV",6837922,6837942,20
"24298","WBGene00168234","IV",12740312,12740332,20
"24299","WBGene00168235","IV",15067948,15067968,20
"24300","WBGene00168238","IV",16213482,16213502,20
"24301","WBGene00168239","IV",16040957,16040977,20
"24302","WBGene00168248","IV",14401505,14401525,20
"24303","WBGene00168254","IV",15348392,15348412,20
"24304","WBGene00168255","IV",14661958,14661978,20
"24305","WBGene00168257","IV",14880929,14880949,20
"24306","WBGene00168259","IV",14964712,14964732,20
"24307","WBGene00168261","IV",5529866,5529886,20
"24308","WBGene00168263","II",10367624,10367644,20
"24309","WBGene00168264","IV",15794503,15794523,20
"24310","WBGene00168270","IV",13600955,13600975,20
"24311","WBGene00168271","IV",5080769,5080789,20
"24312","WBGene00168275","II",11645039,11645059,20
"24313","WBGene00168282","IV",16033011,16033031,20
"24314","WBGene00168283","IV",14986562,14986582,20
"24315","WBGene00168284","IV",14402914,14402934,20
"24316","WBGene00168285","IV",15088864,15088884,20
"24317","WBGene00168286","IV",15945781,15945801,20
"24318","WBGene00168288","IV",16363876,16363896,20
"24319","WBGene00168290","IV",5341522,5341542,20
"24320","WBGene00168294","IV",6983031,6983051,20
"24321","WBGene00168298","IV",15310092,15310112,20
"24322","WBGene00168300","IV",5621539,5621559,20
"24323","WBGene00168301","IV",15895191,15895211,20
"24324","WBGene00168302","IV",5002288,5002308,20
"24325","WBGene00168303","IV",14090489,14090509,20
"24326","WBGene00168304","IV",5931173,5931193,20
"24327","WBGene00168305","IV",6772693,6772713,20
"24328","WBGene00168307","IV",5048090,5048110,20
"24329","WBGene00168308","IV",13825897,13825917,20
"24330","WBGene00168309","IV",5910998,5911018,20
"24331","WBGene00168310","IV",16620229,16620249,20
"24332","WBGene00168311","IV",13974487,13974507,20
"24333","WBGene00168312","IV",5379273,5379293,20
"24334","WBGene00168316","IV",5738967,5738987,20
"24335","WBGene00168322","IV",5721863,5721883,20
"24336","WBGene00168326","IV",6058018,6058038,20
"24337","WBGene00168331","IV",13912952,13912972,20
"24338","WBGene00168334","IV",5590032,5590052,20
"24339","WBGene00168340","IV",14726168,14726188,20
"24340","WBGene00168342","IV",14880852,14880872,20
"24341","WBGene00168343","IV",6862903,6862923,20
"24342","WBGene00168346","IV",13873773,13873793,20
"24343","WBGene00168349","IV",5922717,5922737,20
"24344","WBGene00168351","IV",5718042,5718062,20
"24345","WBGene00168354","IV",5449064,5449084,20
"24346","WBGene00168356","IV",14501614,14501634,20
"24347","WBGene00168357","IV",14879829,14879849,20
"24348","WBGene00168358","IV",16906209,16906229,20
"24349","WBGene00168373","IV",15707487,15707507,20
"24350","WBGene00168375","III",7933365,7933385,20
"24351","WBGene00168377","IV",3944692,3944712,20
"24352","WBGene00168381","IV",16893084,16893104,20
"24353","WBGene00168385","IV",16771901,16771921,20
"24354","WBGene00168396","IV",14261838,14261858,20
"24355","WBGene00168397","X",13873114,13873134,20
"24356","WBGene00168400","IV",5346275,5346295,20
"24357","WBGene00168401","IV",7529271,7529291,20
"24358","WBGene00168404","IV",5515719,5515739,20
"24359","WBGene00168406","IV",14499798,14499818,20
"24360","WBGene00168408","II",12402364,12402384,20
"24361","WBGene00168409","IV",14942013,14942033,20
"24362","WBGene00168411","IV",5502733,5502753,20
"24363","WBGene00168412","IV",6652885,6652905,20
"24364","WBGene00168413","IV",14627746,14627766,20
"24365","WBGene00168419","IV",14491043,14491063,20
"24366","WBGene00168420","IV",5215949,5215969,20
"24367","WBGene00168424","IV",17248621,17248641,20
"24368","WBGene00168429","IV",14233849,14233869,20
"24369","WBGene00168431","IV",15674829,15674849,20
"24370","WBGene00168432","IV",14947402,14947422,20
"24371","WBGene00168437","IV",16023236,16023256,20
"24372","WBGene00168445","IV",14267149,14267169,20
"24373","WBGene00168451","IV",16193713,16193733,20
"24374","WBGene00168455","IV",15564170,15564190,20
"24375","WBGene00168456","IV",16085100,16085120,20
"24376","WBGene00168457","I",4584768,4584788,20
"24377","WBGene00168460","IV",9520763,9520783,20
"24378","WBGene00168462","IV",15302244,15302264,20
"24379","WBGene00168463","IV",5783583,5783603,20
"24380","WBGene00168467","IV",13608395,13608415,20
"24381","WBGene00168472","IV",5586756,5586776,20
"24382","WBGene00168478","IV",13894176,13894196,20
"24383","WBGene00168480","IV",15839561,15839581,20
"24384","WBGene00168481","IV",6504373,6504393,20
"24385","WBGene00168482","IV",14895174,14895194,20
"24386","WBGene00168485","IV",5669285,5669305,20
"24387","WBGene00168487","IV",16833249,16833269,20
"24388","WBGene00168488","II",9112162,9112182,20
"24389","WBGene00168491","IV",7075727,7075747,20
"24390","WBGene00168493","IV",13844733,13844753,20
"24391","WBGene00168494","IV",14591970,14591990,20
"24392","WBGene00168499","IV",12157797,12157817,20
"24393","WBGene00168501","IV",14089528,14089548,20
"24394","WBGene00168503","IV",16043911,16043931,20
"24395","WBGene00168509","IV",17209161,17209181,20
"24396","WBGene00168510","IV",14514134,14514154,20
"24397","WBGene00168516","IV",5215849,5215869,20
"24398","WBGene00168517","IV",5746423,5746443,20
"24399","WBGene00168518","IV",15552720,15552740,20
"24400","WBGene00168519","V",10264481,10264501,20
"24401","WBGene00168528","IV",5953557,5953577,20
"24402","WBGene00168529","IV",5617818,5617838,20
"24403","WBGene00168530","IV",17229975,17229995,20
"24404","WBGene00168531","IV",6025178,6025198,20
"24405","WBGene00168533","IV",16812787,16812807,20
"24406","WBGene00168534","IV",15895309,15895329,20
"24407","WBGene00168535","IV",14462627,14462647,20
"24408","WBGene00168539","IV",16038209,16038229,20
"24409","WBGene00168540","IV",14970369,14970389,20
"24410","WBGene00168541","IV",5518447,5518467,20
"24411","WBGene00168542","IV",15401470,15401490,20
"24412","WBGene00168545","IV",6857599,6857619,20
"24413","WBGene00168547","IV",16748337,16748357,20
"24414","WBGene00168548","IV",14264649,14264669,20
"24415","WBGene00168549","IV",15898558,15898578,20
"24416","WBGene00168555","IV",10504698,10504718,20
"24417","WBGene00168559","IV",16875274,16875294,20
"24418","WBGene00168560","IV",6867087,6867107,20
"24419","WBGene00168563","IV",6062777,6062797,20
"24420","WBGene00168565","IV",10572927,10572947,20
"24421","WBGene00168573","V",7003018,7003038,20
"24422","WBGene00168574","IV",16193125,16193145,20
"24423","WBGene00168575","IV",13629726,13629746,20
"24424","WBGene00168576","IV",5333440,5333460,20
"24425","WBGene00168577","IV",6856177,6856197,20
"24426","WBGene00168580","II",7463755,7463775,20
"24427","WBGene00168581","IV",15844845,15844865,20
"24428","WBGene00168585","IV",15898757,15898777,20
"24429","WBGene00168587","IV",13954658,13954678,20
"24430","WBGene00168589","IV",9405316,9405336,20
"24431","WBGene00168594","IV",15692965,15692985,20
"24432","WBGene00168595","IV",14579996,14580016,20
"24433","WBGene00168597","IV",4818328,4818348,20
"24434","WBGene00168604","IV",14751576,14751596,20
"24435","WBGene00168605","IV",16879207,16879227,20
"24436","WBGene00168608","IV",15724271,15724291,20
"24437","WBGene00168609","IV",15228690,15228710,20
"24438","WBGene00168610","IV",6951650,6951670,20
"24439","WBGene00168611","IV",14415256,14415276,20
"24440","WBGene00168612","IV",15173300,15173320,20
"24441","WBGene00168619","IV",13717966,13717986,20
"24442","WBGene00168620","IV",14554161,14554181,20
"24443","WBGene00168622","IV",9785303,9785323,20
"24444","WBGene00168625","IV",6856820,6856840,20
"24445","WBGene00168628","IV",14702886,14702906,20
"24446","WBGene00168630","IV",5076517,5076537,20
"24447","WBGene00168632","IV",14508248,14508268,20
"24448","WBGene00168637","IV",6514113,6514133,20
"24449","WBGene00168640","IV",5200349,5200369,20
"24450","WBGene00168642","IV",10453724,10453744,20
"24451","WBGene00168646","IV",16690591,16690611,20
"24452","WBGene00168647","IV",15554772,15554792,20
"24453","WBGene00168649","IV",15253867,15253887,20
"24454","WBGene00168650","X",14061316,14061336,20
"24455","WBGene00168658","IV",14360286,14360306,20
"24456","WBGene00168661","IV",4889784,4889804,20
"24457","WBGene00168664","IV",16810058,16810078,20
"24458","WBGene00168666","IV",5981878,5981898,20
"24459","WBGene00168670","IV",13943395,13943415,20
"24460","WBGene00168671","IV",16019841,16019861,20
"24461","WBGene00168673","IV",6546790,6546810,20
"24462","WBGene00168676","IV",14610757,14610777,20
"24463","WBGene00168677","IV",13912431,13912451,20
"24464","WBGene00168680","IV",16987902,16987922,20
"24465","WBGene00168683","IV",5829094,5829114,20
"24466","WBGene00168690","IV",16134827,16134847,20
"24467","WBGene00168693","X",15012950,15012970,20
"24468","WBGene00168694","I",4057937,4057957,20
"24469","WBGene00168700","I",9073965,9073985,20
"24470","WBGene00168701","IV",16477943,16477963,20
"24471","WBGene00168703","IV",6629981,6630001,20
"24472","WBGene00168706","IV",14987268,14987288,20
"24473","WBGene00168707","I",9535275,9535295,20
"24474","WBGene00168710","IV",6091276,6091296,20
"24475","WBGene00168712","IV",6263772,6263792,20
"24476","WBGene00168716","IV",14030844,14030864,20
"24477","WBGene00168721","IV",15809087,15809107,20
"24478","WBGene00168726","IV",6501781,6501801,20
"24479","WBGene00168729","IV",14596852,14596872,20
"24480","WBGene00168732","X",17457714,17457734,20
"24481","WBGene00168735","IV",6166124,6166144,20
"24482","WBGene00168736","IV",14877665,14877685,20
"24483","WBGene00168737","IV",6892386,6892406,20
"24484","WBGene00168741","V",7891732,7891752,20
"24485","WBGene00168743","V",5012717,5012737,20
"24486","WBGene00168745","IV",14054170,14054190,20
"24487","WBGene00168749","IV",5890224,5890244,20
"24488","WBGene00168757","IV",16040188,16040208,20
"24489","WBGene00168758","IV",15441532,15441552,20
"24490","WBGene00168761","I",7072817,7072837,20
"24491","WBGene00168766","IV",5170667,5170687,20
"24492","WBGene00168770","IV",14495787,14495807,20
"24493","WBGene00168772","IV",14616007,14616027,20
"24494","WBGene00168774","IV",16115476,16115496,20
"24495","WBGene00168777","IV",8770856,8770876,20
"24496","WBGene00168781","IV",13952282,13952302,20
"24497","WBGene00168785","II",10207531,10207551,20
"24498","WBGene00168787","IV",5734073,5734093,20
"24499","WBGene00168788","X",13109160,13109180,20
"24500","WBGene00168790","IV",5289408,5289428,20
"24501","WBGene00168791","IV",16035970,16035990,20
"24502","WBGene00168792","IV",4988973,4988993,20
"24503","WBGene00168795","IV",15108399,15108419,20
"24504","WBGene00168805","IV",6772274,6772294,20
"24505","WBGene00168809","IV",17143259,17143279,20
"24506","WBGene00168813","IV",15391861,15391881,20
"24507","WBGene00168815","IV",6769062,6769082,20
"24508","WBGene00168820","IV",6261953,6261973,20
"24509","WBGene00168823","IV",5821941,5821961,20
"24510","WBGene00168824","IV",4883536,4883556,20
"24511","WBGene00168825","IV",5857337,5857357,20
"24512","WBGene00168826","IV",14171949,14171969,20
"24513","WBGene00168832","IV",13999476,13999496,20
"24514","WBGene00168840","IV",5680675,5680695,20
"24515","WBGene00168841","IV",4833476,4833496,20
"24516","WBGene00168843","IV",14266153,14266173,20
"24517","WBGene00168849","IV",16522469,16522489,20
"24518","WBGene00168850","IV",6429835,6429855,20
"24519","WBGene00168852","IV",15981174,15981194,20
"24520","WBGene00168854","IV",5972438,5972458,20
"24521","WBGene00168856","IV",14284760,14284780,20
"24522","WBGene00168860","IV",5644434,5644454,20
"24523","WBGene00168864","II",9716752,9716772,20
"24524","WBGene00168866","IV",6113642,6113662,20
"24525","WBGene00168867","IV",14857682,14857702,20
"24526","WBGene00168871","IV",15701416,15701436,20
"24527","WBGene00168881","IV",11426134,11426154,20
"24528","WBGene00168882","IV",15987127,15987147,20
"24529","WBGene00168884","IV",5388254,5388274,20
"24530","WBGene00168890","IV",5433413,5433433,20
"24531","WBGene00168891","II",6307276,6307296,20
"24532","WBGene00168892","II",2838791,2838811,20
"24533","WBGene00168893","IV",14676278,14676298,20
"24534","WBGene00168899","II",11701104,11701124,20
"24535","WBGene00168901","IV",15063610,15063630,20
"24536","WBGene00168902","I",9699001,9699021,20
"24537","WBGene00168904","IV",17177022,17177042,20
"24538","WBGene00168905","IV",6003642,6003662,20
"24539","WBGene00168907","IV",16074338,16074358,20
"24540","WBGene00168908","IV",13613436,13613456,20
"24541","WBGene00168912","IV",15570028,15570048,20
"24542","WBGene00168913","IV",6435052,6435072,20
"24543","WBGene00168915","IV",14429888,14429908,20
"24544","WBGene00168919","IV",15654835,15654855,20
"24545","WBGene00168920","IV",15604538,15604558,20
"24546","WBGene00168921","IV",14266671,14266691,20
"24547","WBGene00168922","IV",6237126,6237146,20
"24548","WBGene00168933","IV",15548862,15548882,20
"24549","WBGene00168934","IV",5052780,5052800,20
"24550","WBGene00168939","V",4227932,4227952,20
"24551","WBGene00168941","IV",5603704,5603724,20
"24552","WBGene00168945","IV",6567493,6567513,20
"24553","WBGene00168947","IV",17212536,17212556,20
"24554","WBGene00168949","IV",15090305,15090325,20
"24555","WBGene00168952","IV",13875040,13875060,20
"24556","WBGene00168958","IV",14836567,14836587,20
"24557","WBGene00168962","IV",5971831,5971851,20
"24558","WBGene00168963","IV",5809007,5809027,20
"24559","WBGene00168965","X",7000774,7000794,20
"24560","WBGene00168966","IV",5428772,5428792,20
"24561","WBGene00168970","IV",5078400,5078420,20
"24562","WBGene00168971","IV",6056658,6056678,20
"24563","WBGene00168975","IV",15723870,15723890,20
"24564","WBGene00168977","IV",5515917,5515937,20
"24565","WBGene00168979","IV",14279752,14279772,20
"24566","WBGene00168980","X",15265427,15265447,20
"24567","WBGene00168982","IV",5790906,5790926,20
"24568","WBGene00168985","IV",5077658,5077678,20
"24569","WBGene00168989","V",17342836,17342856,20
"24570","WBGene00168990","V",11967546,11967566,20
"24571","WBGene00168995","IV",15003047,15003067,20
"24572","WBGene00168996","IV",5047240,5047260,20
"24573","WBGene00169005","IV",16025608,16025628,20
"24574","WBGene00169006","IV",13878054,13878074,20
"24575","WBGene00169007","IV",16677705,16677725,20
"24576","WBGene00169008","IV",14898115,14898135,20
"24577","WBGene00169009","IV",16210183,16210203,20
"24578","WBGene00169010","IV",14561692,14561712,20
"24579","WBGene00169011","IV",5511724,5511744,20
"24580","WBGene00169012","IV",15851573,15851593,20
"24581","WBGene00169014","IV",16058525,16058545,20
"24582","WBGene00169022","IV",15260708,15260728,20
"24583","WBGene00169023","IV",13993386,13993406,20
"24584","WBGene00169029","III",4340625,4340645,20
"24585","WBGene00169034","IV",4786213,4786233,20
"24586","WBGene00169035","IV",14674371,14674391,20
"24587","WBGene00169036","X",7617074,7617094,20
"24588","WBGene00169037","IV",14458523,14458543,20
"24589","WBGene00169040","IV",5596648,5596668,20
"24590","WBGene00169044","IV",15389511,15389531,20
"24591","WBGene00169049","IV",6126652,6126672,20
"24592","WBGene00169050","IV",16985316,16985336,20
"24593","WBGene00169051","IV",14556624,14556644,20
"24594","WBGene00169054","I",7327968,7327988,20
"24595","WBGene00169059","IV",14562131,14562151,20
"24596","WBGene00169060","IV",14230537,14230557,20
"24597","WBGene00169062","IV",17199441,17199461,20
"24598","WBGene00169064","IV",16837864,16837884,20
"24599","WBGene00169065","IV",14054495,14054515,20
"24600","WBGene00169066","IV",17244957,17244977,20
"24601","WBGene00169067","IV",15263855,15263875,20
"24602","WBGene00169069","IV",7987653,7987673,20
"24603","WBGene00169070","IV",14240613,14240633,20
"24604","WBGene00169071","II",1934707,1934727,20
"24605","WBGene00169073","IV",6437203,6437223,20
"24606","WBGene00169074","IV",14300917,14300937,20
"24607","WBGene00169078","IV",15370004,15370024,20
"24608","WBGene00169079","IV",17264798,17264818,20
"24609","WBGene00169082","IV",13752390,13752410,20
"24610","WBGene00169087","IV",15715030,15715050,20
"24611","WBGene00169089","IV",9758382,9758402,20
"24612","WBGene00169094","IV",13768455,13768475,20
"24613","WBGene00169096","IV",16009616,16009636,20
"24614","WBGene00169098","IV",5908512,5908532,20
"24615","WBGene00169103","IV",17072581,17072601,20
"24616","WBGene00169104","IV",14054963,14054983,20
"24617","WBGene00169105","IV",14864631,14864651,20
"24618","WBGene00169106","IV",15535887,15535907,20
"24619","WBGene00169107","IV",4437744,4437764,20
"24620","WBGene00169109","III",3958639,3958659,20
"24621","WBGene00169111","IV",14743352,14743372,20
"24622","WBGene00169113","IV",6542066,6542086,20
"24623","WBGene00169114","IV",6387505,6387525,20
"24624","WBGene00169118","I",4889467,4889487,20
"24625","WBGene00169119","IV",5214378,5214398,20
"24626","WBGene00169120","IV",14652279,14652299,20
"24627","WBGene00169122","IV",15400772,15400792,20
"24628","WBGene00169123","IV",16829502,16829522,20
"24629","WBGene00169125","IV",13954270,13954290,20
"24630","WBGene00169126","IV",6952557,6952577,20
"24631","WBGene00169131","IV",16011404,16011424,20
"24632","WBGene00169134","IV",14967711,14967731,20
"24633","WBGene00169135","IV",13674377,13674397,20
"24634","WBGene00169138","IV",13908129,13908149,20
"24635","WBGene00169139","IV",14445767,14445787,20
"24636","WBGene00169141","IV",16010937,16010957,20
"24637","WBGene00169143","IV",15701865,15701885,20
"24638","WBGene00169144","IV",15813600,15813620,20
"24639","WBGene00169153","IV",5077328,5077348,20
"24640","WBGene00169158","IV",5750709,5750729,20
"24641","WBGene00169162","IV",8055911,8055931,20
"24642","WBGene00169163","IV",14265313,14265333,20
"24643","WBGene00169164","IV",5214786,5214806,20
"24644","WBGene00169171","IV",6573299,6573319,20
"24645","WBGene00169175","II",126109,126129,20
"24646","WBGene00169178","IV",16047323,16047343,20
"24647","WBGene00169183","IV",15897704,15897724,20
"24648","WBGene00169186","IV",15666814,15666834,20
"24649","WBGene00169188","IV",5387909,5387929,20
"24650","WBGene00169189","IV",14360613,14360633,20
"24651","WBGene00169190","IV",16167743,16167763,20
"24652","WBGene00169191","IV",15951006,15951026,20
"24653","WBGene00169195","IV",5328319,5328339,20
"24654","WBGene00169197","IV",14896338,14896358,20
"24655","WBGene00169199","IV",16991172,16991192,20
"24656","WBGene00169204","IV",15675185,15675205,20
"24657","WBGene00169209","IV",16378912,16378932,20
"24658","WBGene00169210","IV",16710752,16710772,20
"24659","WBGene00169214","IV",15432753,15432773,20
"24660","WBGene00169215","IV",14603416,14603436,20
"24661","WBGene00169217","IV",16538064,16538084,20
"24662","WBGene00169222","I",272603,272623,20
"24663","WBGene00169223","IV",16662487,16662507,20
"24664","WBGene00169225","IV",10347297,10347317,20
"24665","WBGene00169226","IV",14054309,14054329,20
"24666","WBGene00169227","IV",10514775,10514795,20
"24667","WBGene00169232","IV",4883664,4883684,20
"24668","WBGene00169234","X",4497621,4497641,20
"24669","WBGene00169236","V",31881,31901,20
"24670","WBGene00169238","IV",13956726,13956746,20
"24671","WBGene00169247","IV",16450514,16450534,20
"24672","WBGene00169249","IV",15555283,15555303,20
"24673","WBGene00169250","IV",4904251,4904271,20
"24674","WBGene00169257","IV",6113645,6113665,20
"24675","WBGene00169259","IV",14814304,14814324,20
"24676","WBGene00169262","IV",5590992,5591012,20
"24677","WBGene00169263","IV",14184464,14184484,20
"24678","WBGene00169267","IV",14100195,14100215,20
"24679","WBGene00169268","IV",16455079,16455099,20
"24680","WBGene00169269","X",16838910,16838930,20
"24681","WBGene00169270","IV",14968358,14968378,20
"24682","WBGene00169280","IV",14738236,14738256,20
"24683","WBGene00169287","IV",15610261,15610281,20
"24684","WBGene00169297","IV",14905268,14905288,20
"24685","WBGene00169298","V",9744806,9744826,20
"24686","WBGene00169303","IV",7124072,7124092,20
"24687","WBGene00169304","IV",14272049,14272069,20
"24688","WBGene00169307","IV",5437112,5437132,20
"24689","WBGene00169309","IV",14385666,14385686,20
"24690","WBGene00169312","IV",16994560,16994580,20
"24691","WBGene00169318","IV",14472285,14472305,20
"24692","WBGene00169319","IV",12444228,12444248,20
"24693","WBGene00169320","IV",16048105,16048125,20
"24694","WBGene00169325","IV",15613950,15613970,20
"24695","WBGene00169327","IV",13771468,13771488,20
"24696","WBGene00169329","IV",14043122,14043142,20
"24697","WBGene00169333","IV",6056933,6056953,20
"24698","WBGene00169335","IV",6501777,6501797,20
"24699","WBGene00169343","IV",14294938,14294958,20
"24700","WBGene00169344","IV",14609259,14609279,20
"24701","WBGene00169345","IV",14487810,14487830,20
"24702","WBGene00169346","IV",5720265,5720285,20
"24703","WBGene00169349","IV",14043555,14043575,20
"24704","WBGene00169352","IV",6507413,6507433,20
"24705","WBGene00169353","IV",5581764,5581784,20
"24706","WBGene00169354","IV",8158229,8158249,20
"24707","WBGene00169361","V",11415207,11415227,20
"24708","WBGene00169362","X",14049828,14049848,20
"24709","WBGene00169363","IV",5376267,5376287,20
"24710","WBGene00169364","IV",12464520,12464540,20
"24711","WBGene00169366","IV",13814360,13814380,20
"24712","WBGene00169369","IV",14680239,14680259,20
"24713","WBGene00169370","IV",13797643,13797663,20
"24714","WBGene00169378","IV",16479184,16479204,20
"24715","WBGene00169379","IV",14602378,14602398,20
"24716","WBGene00169382","IV",5723409,5723429,20
"24717","WBGene00169384","IV",5123164,5123184,20
"24718","WBGene00169386","IV",17205727,17205747,20
"24719","WBGene00169389","IV",15089656,15089676,20
"24720","WBGene00169395","IV",16239445,16239465,20
"24721","WBGene00169396","IV",6054210,6054230,20
"24722","WBGene00169401","IV",16905743,16905763,20
"24723","WBGene00169402","IV",6136170,6136190,20
"24724","WBGene00169410","IV",14648963,14648983,20
"24725","WBGene00169412","IV",16192629,16192649,20
"24726","WBGene00169413","IV",6508667,6508687,20
"24727","WBGene00169414","IV",15609607,15609627,20
"24728","WBGene00169415","IV",16155825,16155845,20
"24729","WBGene00169421","IV",15480519,15480539,20
"24730","WBGene00169422","V",4080247,4080267,20
"24731","WBGene00169425","IV",16806565,16806585,20
"24732","WBGene00169426","IV",16468187,16468207,20
"24733","WBGene00169431","IV",14471282,14471302,20
"24734","WBGene00169432","IV",3852315,3852335,20
"24735","WBGene00169438","IV",15570411,15570431,20
"24736","WBGene00169443","IV",14047827,14047847,20
"24737","WBGene00169452","IV",5427417,5427437,20
"24738","WBGene00169462","I",7738671,7738691,20
"24739","WBGene00169463","IV",15722877,15722897,20
"24740","WBGene00169464","X",4531951,4531971,20
"24741","WBGene00169466","IV",15565945,15565965,20
"24742","WBGene00169469","IV",15656994,15657014,20
"24743","WBGene00169470","IV",14881650,14881670,20
"24744","WBGene00169476","IV",6052185,6052205,20
"24745","WBGene00169477","IV",15171590,15171610,20
"24746","WBGene00169479","IV",15129213,15129233,20
"24747","WBGene00169483","IV",15392174,15392194,20
"24748","WBGene00169486","IV",16181035,16181055,20
"24749","WBGene00169489","IV",6570438,6570458,20
"24750","WBGene00169496","IV",5096396,5096416,20
"24751","WBGene00169500","IV",15406647,15406667,20
"24752","WBGene00169503","V",5635538,5635558,20
"24753","WBGene00169504","IV",15596943,15596963,20
"24754","WBGene00169506","IV",13706961,13706981,20
"24755","WBGene00169510","IV",13908576,13908596,20
"24756","WBGene00169511","IV",15726212,15726232,20
"24757","WBGene00169514","IV",14223223,14223243,20
"24758","WBGene00169517","V",14133057,14133077,20
"24759","WBGene00169520","IV",5450236,5450256,20
"24760","WBGene00169521","I",5739479,5739499,20
"24761","WBGene00169522","IV",6094051,6094071,20
"24762","WBGene00169524","IV",6272908,6272928,20
"24763","WBGene00169525","IV",15351955,15351975,20
"24764","WBGene00169526","IV",14991878,14991898,20
"24765","WBGene00169528","IV",4729708,4729728,20
"24766","WBGene00169531","IV",16662795,16662815,20
"24767","WBGene00169538","V",11979313,11979333,20
"24768","WBGene00169539","IV",13810077,13810097,20
"24769","WBGene00169540","IV",16354207,16354227,20
"24770","WBGene00169541","IV",4829279,4829299,20
"24771","WBGene00169544","IV",15496795,15496815,20
"24772","WBGene00169547","IV",14356666,14356686,20
"24773","WBGene00169549","IV",15762245,15762265,20
"24774","WBGene00169550","IV",14125100,14125120,20
"24775","WBGene00169554","IV",5170022,5170042,20
"24776","WBGene00169555","IV",6502548,6502568,20
"24777","WBGene00169557","IV",14313759,14313779,20
"24778","WBGene00169560","IV",14318852,14318872,20
"24779","WBGene00169565","IV",14455523,14455543,20
"24780","WBGene00169569","IV",16375196,16375216,20
"24781","WBGene00169570","IV",14493931,14493951,20
"24782","WBGene00169573","IV",6399655,6399675,20
"24783","WBGene00169576","IV",5149013,5149033,20
"24784","WBGene00169578","IV",14220502,14220522,20
"24785","WBGene00169580","IV",14495918,14495938,20
"24786","WBGene00169582","IV",15753444,15753464,20
"24787","WBGene00169583","V",15030747,15030767,20
"24788","WBGene00169587","IV",10311404,10311424,20
"24789","WBGene00169591","IV",5716380,5716400,20
"24790","WBGene00169592","IV",7988644,7988664,20
"24791","WBGene00169595","IV",4979188,4979208,20
"24792","WBGene00169596","IV",14647011,14647031,20
"24793","WBGene00169600","IV",5889006,5889026,20
"24794","WBGene00169607","IV",5902306,5902326,20
"24795","WBGene00169609","IV",13669096,13669116,20
"24796","WBGene00169614","IV",9009611,9009631,20
"24797","WBGene00169615","IV",16022130,16022150,20
"24798","WBGene00169618","IV",5413543,5413563,20
"24799","WBGene00169620","IV",15390482,15390502,20
"24800","WBGene00169622","IV",17410521,17410541,20
"24801","WBGene00169623","IV",4829753,4829773,20
"24802","WBGene00169625","IV",5423794,5423814,20
"24803","WBGene00169627","IV",16437014,16437034,20
"24804","WBGene00169628","IV",6055818,6055838,20
"24805","WBGene00169629","IV",14430031,14430051,20
"24806","WBGene00169634","IV",13547035,13547055,20
"24807","WBGene00169638","IV",8721667,8721687,20
"24808","WBGene00169639","V",16605859,16605879,20
"24809","WBGene00169640","IV",6655580,6655600,20
"24810","WBGene00169645","IV",16174926,16174946,20
"24811","WBGene00169647","IV",14431490,14431510,20
"24812","WBGene00169648","II",10886094,10886114,20
"24813","WBGene00169650","IV",15477593,15477613,20
"24814","WBGene00169652","IV",15723070,15723090,20
"24815","WBGene00169658","IV",6083113,6083133,20
"24816","WBGene00169660","IV",13705223,13705243,20
"24817","WBGene00169664","IV",6561489,6561509,20
"24818","WBGene00169668","IV",14736141,14736161,20
"24819","WBGene00169669","IV",6070246,6070266,20
"24820","WBGene00169670","IV",14292867,14292887,20
"24821","WBGene00169671","IV",14124572,14124592,20
"24822","WBGene00169672","IV",13697472,13697492,20
"24823","WBGene00169677","IV",6199540,6199560,20
"24824","WBGene00169680","IV",17185050,17185070,20
"24825","WBGene00169681","IV",5705619,5705639,20
"24826","WBGene00169683","IV",2783442,2783462,20
"24827","WBGene00169688","IV",5500241,5500261,20
"24828","WBGene00169689","IV",15389970,15389990,20
"24829","WBGene00169691","IV",5721868,5721888,20
"24830","WBGene00169694","IV",14970996,14971016,20
"24831","WBGene00169696","IV",14423750,14423770,20
"24832","WBGene00169697","IV",14706601,14706621,20
"24833","WBGene00169698","IV",15956361,15956381,20
"24834","WBGene00169699","IV",15722879,15722899,20
"24835","WBGene00169702","IV",5756024,5756044,20
"24836","WBGene00169706","IV",16799436,16799456,20
"24837","WBGene00169709","IV",15205495,15205515,20
"24838","WBGene00169710","IV",15863956,15863976,20
"24839","WBGene00169712","IV",13796983,13797003,20
"24840","WBGene00169713","IV",14484829,14484849,20
"24841","WBGene00169726","IV",14450743,14450763,20
"24842","WBGene00169728","IV",6511099,6511119,20
"24843","WBGene00169729","IV",6513828,6513848,20
"24844","WBGene00169730","IV",14043123,14043143,20
"24845","WBGene00169732","IV",5975181,5975201,20
"24846","WBGene00169734","X",1488317,1488337,20
"24847","WBGene00169736","IV",16700358,16700378,20
"24848","WBGene00169738","IV",5288300,5288320,20
"24849","WBGene00169739","IV",5501105,5501125,20
"24850","WBGene00169740","IV",5052027,5052047,20
"24851","WBGene00169741","IV",13563716,13563736,20
"24852","WBGene00169743","IV",13766903,13766923,20
"24853","WBGene00169747","IV",14879310,14879330,20
"24854","WBGene00169751","IV",6045058,6045078,20
"24855","WBGene00169754","IV",16789764,16789784,20
"24856","WBGene00169759","IV",6867525,6867545,20
"24857","WBGene00169763","IV",16097144,16097164,20
"24858","WBGene00169767","IV",5352494,5352514,20
"24859","WBGene00169768","IV",5102880,5102900,20
"24860","WBGene00169775","IV",15263592,15263612,20
"24861","WBGene00169777","IV",16023872,16023892,20
"24862","WBGene00169778","IV",14892869,14892889,20
"24863","WBGene00169780","IV",15705139,15705159,20
"24864","WBGene00169781","IV",14874713,14874733,20
"24865","WBGene00169785","IV",15587927,15587947,20
"24866","WBGene00169787","IV",5969704,5969724,20
"24867","WBGene00169794","IV",15573020,15573040,20
"24868","WBGene00169796","IV",15141212,15141232,20
"24869","WBGene00169798","IV",13863692,13863712,20
"24870","WBGene00169799","X",13016626,13016646,20
"24871","WBGene00169801","IV",14337662,14337682,20
"24872","WBGene00169802","IV",16117211,16117231,20
"24873","WBGene00169807","IV",6568904,6568924,20
"24874","WBGene00169812","IV",13764345,13764365,20
"24875","WBGene00169814","IV",14498910,14498930,20
"24876","WBGene00169819","IV",15217920,15217940,20
"24877","WBGene00169820","IV",15411016,15411036,20
"24878","WBGene00169823","X",5833524,5833544,20
"24879","WBGene00169830","IV",17158990,17159010,20
"24880","WBGene00169831","IV",13869998,13870018,20
"24881","WBGene00169832","IV",9519090,9519110,20
"24882","WBGene00169833","IV",15694954,15694974,20
"24883","WBGene00169835","IV",16890637,16890657,20
"24884","WBGene00169837","IV",15946626,15946646,20
"24885","WBGene00169838","IV",6136011,6136031,20
"24886","WBGene00169843","IV",14221494,14221514,20
"24887","WBGene00169844","IV",13767514,13767534,20
"24888","WBGene00169845","IV",5176474,5176494,20
"24889","WBGene00169846","X",6751151,6751171,20
"24890","WBGene00169848","IV",6510110,6510130,20
"24891","WBGene00169851","IV",14483889,14483909,20
"24892","WBGene00169852","IV",5713623,5713643,20
"24893","WBGene00169855","IV",15946363,15946383,20
"24894","WBGene00169856","IV",14491468,14491488,20
"24895","WBGene00169858","IV",15712464,15712484,20
"24896","WBGene00169859","IV",5351764,5351784,20
"24897","WBGene00169860","IV",5909424,5909444,20
"24898","WBGene00169862","IV",5753828,5753848,20
"24899","WBGene00169864","IV",14126092,14126112,20
"24900","WBGene00169865","IV",15855240,15855260,20
"24901","WBGene00169867","IV",6013043,6013063,20
"24902","WBGene00169877","IV",6510014,6510034,20
"24903","WBGene00169880","IV",5968091,5968111,20
"24904","WBGene00169881","IV",10277062,10277082,20
"24905","WBGene00169886","IV",16199361,16199381,20
"24906","WBGene00169887","IV",14474806,14474826,20
"24907","WBGene00169888","IV",5439592,5439612,20
"24908","WBGene00169889","IV",14883375,14883395,20
"24909","WBGene00169890","IV",15700462,15700482,20
"24910","WBGene00169894","IV",5766509,5766529,20
"24911","WBGene00169897","IV",14964990,14965010,20
"24912","WBGene00169899","IV",15698398,15698418,20
"24913","WBGene00169900","IV",10711483,10711503,20
"24914","WBGene00169902","IV",15669458,15669478,20
"24915","WBGene00169904","IV",6568905,6568925,20
"24916","WBGene00169905","IV",14497567,14497587,20
"24917","WBGene00169906","IV",16124791,16124811,20
"24918","WBGene00169910","IV",5102360,5102380,20
"24919","WBGene00169912","IV",16202598,16202618,20
"24920","WBGene00169913","IV",13604755,13604775,20
"24921","WBGene00169917","IV",16746016,16746036,20
"24922","WBGene00169920","IV",16836881,16836901,20
"24923","WBGene00169921","IV",17187779,17187799,20
"24924","WBGene00169929","IV",5560788,5560808,20
"24925","WBGene00169931","IV",14889854,14889874,20
"24926","WBGene00169934","IV",14875515,14875535,20
"24927","WBGene00169936","IV",14278959,14278979,20
"24928","WBGene00169937","IV",14874297,14874317,20
"24929","WBGene00169940","X",13798925,13798945,20
"24930","WBGene00169950","IV",13994522,13994542,20
"24931","WBGene00169952","IV",5044354,5044374,20
"24932","WBGene00169956","IV",6018682,6018702,20
"24933","WBGene00169959","IV",16151313,16151333,20
"24934","WBGene00169960","IV",15562140,15562160,20
"24935","WBGene00169965","IV",17211560,17211580,20
"24936","WBGene00169967","IV",13992055,13992075,20
"24937","WBGene00169968","IV",6023953,6023973,20
"24938","WBGene00169971","IV",5523630,5523650,20
"24939","WBGene00169972","IV",5764800,5764820,20
"24940","WBGene00169973","IV",4630304,4630324,20
"24941","WBGene00169977","IV",5759335,5759355,20
"24942","WBGene00169978","IV",15438870,15438890,20
"24943","WBGene00169979","I",6196174,6196194,20
"24944","WBGene00169984","IV",16072443,16072463,20
"24945","WBGene00169987","X",16697151,16697171,20
"24946","WBGene00169989","IV",5182766,5182786,20
"24947","WBGene00169990","IV",7076993,7077013,20
"24948","WBGene00169992","IV",14880757,14880777,20
"24949","WBGene00169993","IV",16622484,16622504,20
"24950","WBGene00169995","IV",13804281,13804301,20
"24951","WBGene00169999","IV",17370940,17370960,20
"24952","WBGene00170006","IV",14884977,14884997,20
"24953","WBGene00170007","IV",6461322,6461342,20
"24954","WBGene00170008","IV",17211725,17211745,20
"24955","WBGene00170010","X",8427984,8428004,20
"24956","WBGene00170013","IV",5116112,5116132,20
"24957","WBGene00170017","IV",6153340,6153360,20
"24958","WBGene00170024","IV",6453652,6453672,20
"24959","WBGene00170026","IV",8947695,8947715,20
"24960","WBGene00170027","IV",17017910,17017930,20
"24961","WBGene00170028","IV",5144440,5144460,20
"24962","WBGene00170030","IV",17264168,17264188,20
"24963","WBGene00170032","IV",13697759,13697779,20
"24964","WBGene00170034","IV",5126780,5126800,20
"24965","WBGene00170041","X",16393907,16393927,20
"24966","WBGene00170045","IV",13700602,13700622,20
"24967","WBGene00170050","IV",14389526,14389546,20
"24968","WBGene00170051","IV",5751014,5751034,20
"24969","WBGene00170055","IV",14528615,14528635,20
"24970","WBGene00170071","IV",5819186,5819206,20
"24971","WBGene00170073","IV",15107521,15107541,20
"24972","WBGene00170074","IV",5884921,5884941,20
"24973","WBGene00170075","IV",14041477,14041497,20
"24974","WBGene00170078","IV",6872314,6872334,20
"24975","WBGene00170079","IV",14744186,14744206,20
"24976","WBGene00170090","IV",5929098,5929118,20
"24977","WBGene00170092","IV",14267964,14267984,20
"24978","WBGene00170099","IV",6457774,6457794,20
"24979","WBGene00170109","IV",14701404,14701424,20
"24980","WBGene00170111","IV",15813003,15813023,20
"24981","WBGene00170113","IV",15494789,15494809,20
"24982","WBGene00170119","IV",16163738,16163758,20
"24983","WBGene00170121","V",14537818,14537838,20
"24984","WBGene00170122","IV",16173433,16173453,20
"24985","WBGene00170128","IV",17059400,17059420,20
"24986","WBGene00170129","IV",15494343,15494363,20
"24987","WBGene00170131","IV",13872627,13872647,20
"24988","WBGene00170132","IV",16174414,16174434,20
"24989","WBGene00170138","IV",14555017,14555037,20
"24990","WBGene00170140","IV",15490461,15490481,20
"24991","WBGene00170143","IV",5376044,5376064,20
"24992","WBGene00170148","IV",17181849,17181869,20
"24993","WBGene00170151","IV",5595245,5595265,20
"24994","WBGene00170155","IV",17144556,17144576,20
"24995","WBGene00170158","IV",15054281,15054301,20
"24996","WBGene00170159","IV",5600018,5600038,20
"24997","WBGene00170161","IV",5761643,5761663,20
"24998","WBGene00170166","IV",14598628,14598648,20
"24999","WBGene00170167","IV",6658714,6658734,20
"25000","WBGene00170169","IV",5752061,5752081,20
"25001","WBGene00170170","IV",17202770,17202790,20
"25002","WBGene00170171","V",11984970,11984990,20
"25003","WBGene00170172","IV",15618480,15618500,20
"25004","WBGene00170174","IV",15705221,15705241,20
"25005","WBGene00170177","IV",5854234,5854254,20
"25006","WBGene00170178","IV",15570265,15570285,20
"25007","WBGene00170180","IV",16725671,16725691,20
"25008","WBGene00170184","IV",6453342,6453362,20
"25009","WBGene00170185","IV",6114032,6114052,20
"25010","WBGene00170192","V",11369884,11369904,20
"25011","WBGene00170193","IV",6052315,6052335,20
"25012","WBGene00170199","IV",5757326,5757346,20
"25013","WBGene00170201","IV",9636680,9636700,20
"25014","WBGene00170204","IV",16437316,16437336,20
"25015","WBGene00170205","IV",5496113,5496133,20
"25016","WBGene00170208","IV",14301132,14301152,20
"25017","WBGene00170211","IV",14002331,14002351,20
"25018","WBGene00170213","IV",14971433,14971453,20
"25019","WBGene00170216","IV",15560882,15560902,20
"25020","WBGene00170217","IV",16188723,16188743,20
"25021","WBGene00170219","IV",15196954,15196974,20
"25022","WBGene00170221","IV",15702863,15702883,20
"25023","WBGene00170223","IV",16668205,16668225,20
"25024","WBGene00170225","IV",10539537,10539557,20
"25025","WBGene00170227","IV",15989958,15989978,20
"25026","WBGene00170234","IV",5717777,5717797,20
"25027","WBGene00170235","IV",15571235,15571255,20
"25028","WBGene00170237","X",15656484,15656504,20
"25029","WBGene00170240","IV",14879670,14879690,20
"25030","WBGene00170241","IV",5446628,5446648,20
"25031","WBGene00170242","IV",16433818,16433838,20
"25032","WBGene00170249","IV",5105261,5105281,20
"25033","WBGene00170251","IV",13703654,13703674,20
"25034","WBGene00170256","IV",14701874,14701894,20
"25035","WBGene00170258","IV",15310812,15310832,20
"25036","WBGene00170259","IV",3661121,3661141,20
"25037","WBGene00170261","IV",16255719,16255739,20
"25038","WBGene00170266","IV",14505306,14505326,20
"25039","WBGene00170267","IV",6935040,6935060,20
"25040","WBGene00170269","IV",8099650,8099670,20
"25041","WBGene00170279","IV",15997760,15997780,20
"25042","WBGene00170281","IV",6452703,6452723,20
"25043","WBGene00170282","IV",15810388,15810408,20
"25044","WBGene00170283","IV",14618248,14618268,20
"25045","WBGene00170285","IV",13798095,13798115,20
"25046","WBGene00170288","IV",16007643,16007663,20
"25047","WBGene00170289","III",10033388,10033408,20
"25048","WBGene00170294","IV",5109513,5109533,20
"25049","WBGene00170297","IV",6452241,6452261,20
"25050","WBGene00170298","IV",4938811,4938831,20
"25051","WBGene00170307","IV",5598377,5598397,20
"25052","WBGene00170314","IV",16617544,16617564,20
"25053","WBGene00170316","IV",16372973,16372993,20
"25054","WBGene00170321","IV",16706014,16706034,20
"25055","WBGene00170323","IV",5914978,5914998,20
"25056","WBGene00170333","I",4020211,4020231,20
"25057","WBGene00170335","IV",5604258,5604278,20
"25058","WBGene00170339","IV",5820049,5820069,20
"25059","WBGene00170342","IV",16013064,16013084,20
"25060","WBGene00170343","IV",14301579,14301599,20
"25061","WBGene00170345","IV",9668198,9668218,20
"25062","WBGene00170350","IV",14875860,14875880,20
"25063","WBGene00170354","IV",6803853,6803873,20
"25064","WBGene00170357","IV",16239189,16239209,20
"25065","WBGene00170359","IV",14310785,14310805,20
"25066","WBGene00170366","IV",15562983,15563003,20
"25067","WBGene00170368","IV",6013816,6013836,20
"25068","WBGene00170369","IV",14899357,14899377,20
"25069","WBGene00170371","IV",14485550,14485570,20
"25070","WBGene00170373","IV",14416005,14416025,20
"25071","WBGene00170374","IV",16007513,16007533,20
"25072","WBGene00170376","IV",14757543,14757563,20
"25073","WBGene00170377","IV",14852005,14852025,20
"25074","WBGene00170381","II",5483967,5483987,20
"25075","WBGene00170382","IV",14457182,14457202,20
"25076","WBGene00170383","IV",5279682,5279702,20
"25077","WBGene00170384","IV",16165762,16165782,20
"25078","WBGene00170386","IV",5675059,5675079,20
"25079","WBGene00170387","IV",14686281,14686301,20
"25080","WBGene00170389","IV",15818446,15818466,20
"25081","WBGene00170390","IV",5504794,5504814,20
"25082","WBGene00170393","IV",6305231,6305251,20
"25083","WBGene00170397","IV",5171998,5172018,20
"25084","WBGene00170399","IV",16874473,16874493,20
"25085","WBGene00170401","IV",5589188,5589208,20
"25086","WBGene00170406","IV",14192970,14192990,20
"25087","WBGene00170407","IV",6058592,6058612,20
"25088","WBGene00170411","IV",14671026,14671046,20
"25089","WBGene00170420","IV",14890608,14890628,20
"25090","WBGene00170428","IV",16013851,16013871,20
"25091","WBGene00170432","V",1988418,1988438,20
"25092","WBGene00170433","IV",6111526,6111546,20
"25093","WBGene00170439","IV",14832680,14832700,20
"25094","WBGene00170442","IV",14261547,14261567,20
"25095","WBGene00170446","IV",13979509,13979529,20
"25096","WBGene00170448","IV",14085769,14085789,20
"25097","WBGene00170449","X",10795689,10795709,20
"25098","WBGene00170452","IV",15271692,15271712,20
"25099","WBGene00170457","IV",14090241,14090261,20
"25100","WBGene00170460","IV",5627464,5627484,20
"25101","WBGene00170461","IV",14978166,14978186,20
"25102","WBGene00170464","IV",14744685,14744705,20
"25103","WBGene00170473","IV",14102889,14102909,20
"25104","WBGene00170480","IV",14851159,14851179,20
"25105","WBGene00170481","IV",14916516,14916536,20
"25106","WBGene00170482","IV",16461620,16461640,20
"25107","WBGene00170483","II",4557641,4557661,20
"25108","WBGene00170488","IV",5761057,5761077,20
"25109","WBGene00170489","IV",16661372,16661392,20
"25110","WBGene00170490","IV",15622267,15622287,20
"25111","WBGene00170492","IV",6484938,6484958,20
"25112","WBGene00170496","IV",15145547,15145567,20
"25113","WBGene00170497","IV",16010303,16010323,20
"25114","WBGene00170503","IV",15811500,15811520,20
"25115","WBGene00170508","IV",15310196,15310216,20
"25116","WBGene00170509","IV",5933693,5933713,20
"25117","WBGene00170510","IV",17191307,17191327,20
"25118","WBGene00170513","IV",13864550,13864570,20
"25119","WBGene00170519","IV",16277622,16277642,20
"25120","WBGene00170521","IV",15271015,15271035,20
"25121","WBGene00170525","IV",15702549,15702569,20
"25122","WBGene00170527","IV",13902437,13902457,20
"25123","WBGene00170535","IV",16011809,16011829,20
"25124","WBGene00170536","IV",6298100,6298120,20
"25125","WBGene00170539","IV",4820589,4820609,20
"25126","WBGene00170540","IV",15571342,15571362,20
"25127","WBGene00170541","IV",15669210,15669230,20
"25128","WBGene00170546","IV",14298278,14298298,20
"25129","WBGene00170548","IV",16641500,16641520,20
"25130","WBGene00170549","X",8908597,8908617,20
"25131","WBGene00170551","IV",16021584,16021604,20
"25132","WBGene00170553","IV",16478818,16478838,20
"25133","WBGene00170556","IV",15609326,15609346,20
"25134","WBGene00170557","IV",14528199,14528219,20
"25135","WBGene00170558","IV",15142054,15142074,20
"25136","WBGene00170560","IV",15726206,15726226,20
"25137","WBGene00170562","IV",5841658,5841678,20
"25138","WBGene00170563","IV",4854245,4854265,20
"25139","WBGene00170565","IV",14150104,14150124,20
"25140","WBGene00170566","IV",6256766,6256786,20
"25141","WBGene00170567","IV",15306413,15306433,20
"25142","WBGene00170568","IV",5736280,5736300,20
"25143","WBGene00170571","IV",13706756,13706776,20
"25144","WBGene00170574","IV",13602464,13602484,20
"25145","WBGene00170580","IV",14440259,14440279,20
"25146","WBGene00170582","IV",8032833,8032853,20
"25147","WBGene00170587","IV",16031411,16031431,20
"25148","WBGene00170588","IV",6069130,6069150,20
"25149","WBGene00170589","IV",6065069,6065089,20
"25150","WBGene00170591","IV",16165446,16165466,20
"25151","WBGene00170595","IV",14377297,14377317,20
"25152","WBGene00170602","V",5983573,5983593,20
"25153","WBGene00170608","IV",16239027,16239047,20
"25154","WBGene00170609","IV",12213660,12213680,20
"25155","WBGene00170610","IV",15347609,15347629,20
"25156","WBGene00170614","IV",5526349,5526369,20
"25157","WBGene00170615","X",9569036,9569056,20
"25158","WBGene00170618","V",436982,437002,20
"25159","WBGene00170619","IV",5448688,5448708,20
"25160","WBGene00170622","IV",16273670,16273690,20
"25161","WBGene00170623","IV",16024574,16024594,20
"25162","WBGene00170625","X",9793229,9793249,20
"25163","WBGene00170629","IV",14707307,14707327,20
"25164","WBGene00170630","IV",15863960,15863980,20
"25165","WBGene00170634","IV",16509082,16509102,20
"25166","WBGene00170637","IV",13650861,13650881,20
"25167","WBGene00170638","IV",5817253,5817273,20
"25168","WBGene00170639","IV",15616417,15616437,20
"25169","WBGene00170643","IV",14232822,14232842,20
"25170","WBGene00170645","IV",6032251,6032271,20
"25171","WBGene00170652","IV",6851974,6851994,20
"25172","WBGene00170654","IV",15308515,15308535,20
"25173","WBGene00170657","IV",15870316,15870336,20
"25174","WBGene00170658","IV",5204915,5204935,20
"25175","WBGene00170661","IV",14489337,14489357,20
"25176","WBGene00170667","IV",14382629,14382649,20
"25177","WBGene00170668","IV",14170014,14170034,20
"25178","WBGene00170669","IV",5030575,5030595,20
"25179","WBGene00170672","IV",15051363,15051383,20
"25180","WBGene00170674","IV",5764895,5764915,20
"25181","WBGene00170683","IV",15842189,15842209,20
"25182","WBGene00170685","IV",15900986,15901006,20
"25183","WBGene00170688","IV",6504975,6504995,20
"25184","WBGene00170689","IV",14527583,14527603,20
"25185","WBGene00170692","IV",6455764,6455784,20
"25186","WBGene00170694","III",5394223,5394243,20
"25187","WBGene00170697","X",8491737,8491757,20
"25188","WBGene00170703","IV",9752105,9752125,20
"25189","WBGene00170704","IV",7879095,7879115,20
"25190","WBGene00170711","IV",16279402,16279422,20
"25191","WBGene00170713","IV",6031631,6031651,20
"25192","WBGene00170716","IV",4845922,4845942,20
"25193","WBGene00170717","IV",14873220,14873240,20
"25194","WBGene00170721","III",821049,821069,20
"25195","WBGene00170724","IV",14438193,14438213,20
"25196","WBGene00170725","IV",14273562,14273582,20
"25197","WBGene00170730","IV",5973120,5973140,20
"25198","WBGene00170734","IV",16725080,16725100,20
"25199","WBGene00170735","IV",16573443,16573463,20
"25200","WBGene00170738","IV",15293962,15293982,20
"25201","WBGene00170743","IV",16049935,16049955,20
"25202","WBGene00170744","IV",13608496,13608516,20
"25203","WBGene00170748","IV",5827421,5827441,20
"25204","WBGene00170749","IV",13819753,13819773,20
"25205","WBGene00170750","IV",6115681,6115701,20
"25206","WBGene00170754","IV",16978759,16978779,20
"25207","WBGene00170757","IV",15384085,15384105,20
"25208","WBGene00170758","IV",14277773,14277793,20
"25209","WBGene00170763","IV",14380707,14380727,20
"25210","WBGene00170764","IV",15151158,15151178,20
"25211","WBGene00170765","IV",14584446,14584466,20
"25212","WBGene00170768","IV",15203722,15203742,20
"25213","WBGene00170769","IV",5506211,5506231,20
"25214","WBGene00170771","IV",5931338,5931358,20
"25215","WBGene00170784","IV",15901992,15902012,20
"25216","WBGene00170788","IV",15565650,15565670,20
"25217","WBGene00170789","I",1487607,1487627,20
"25218","WBGene00170795","IV",13879420,13879440,20
"25219","WBGene00170796","II",10371154,10371174,20
"25220","WBGene00170798","IV",16444977,16444997,20
"25221","WBGene00170805","IV",12386685,12386705,20
"25222","WBGene00170806","IV",5163538,5163558,20
"25223","WBGene00170812","IV",5098845,5098865,20
"25224","WBGene00170813","IV",5142867,5142887,20
"25225","WBGene00170819","III",4014691,4014711,20
"25226","WBGene00170820","IV",16443999,16444019,20
"25227","WBGene00170821","IV",14296811,14296831,20
"25228","WBGene00170824","IV",17211175,17211195,20
"25229","WBGene00170825","IV",6022366,6022386,20
"25230","WBGene00170834","IV",14647718,14647738,20
"25231","WBGene00170835","I",5431492,5431512,20
"25232","WBGene00170837","IV",5099744,5099764,20
"25233","WBGene00170841","IV",5825133,5825153,20
"25234","WBGene00170842","IV",17423048,17423068,20
"25235","WBGene00170853","IV",5201921,5201941,20
"25236","WBGene00170854","IV",16462036,16462056,20
"25237","WBGene00170855","IV",14990526,14990546,20
"25238","WBGene00170856","IV",13703398,13703418,20
"25239","WBGene00170857","IV",15486073,15486093,20
"25240","WBGene00170860","IV",5342276,5342296,20
"25241","WBGene00170862","IV",15951177,15951197,20
"25242","WBGene00170863","IV",5584232,5584252,20
"25243","WBGene00170866","IV",15781744,15781764,20
"25244","WBGene00170869","IV",6412110,6412130,20
"25245","WBGene00170870","IV",5302097,5302117,20
"25246","WBGene00170871","IV",7783263,7783283,20
"25247","WBGene00170872","IV",5099435,5099455,20
"25248","WBGene00170874","II",4130014,4130034,20
"25249","WBGene00170878","IV",7281763,7281783,20
"25250","WBGene00170879","IV",14999594,14999614,20
"25251","WBGene00170886","IV",16284871,16284891,20
"25252","WBGene00170890","IV",6389247,6389267,20
"25253","WBGene00170891","IV",4886775,4886795,20
"25254","WBGene00170893","IV",16634012,16634032,20
"25255","WBGene00170899","IV",15584819,15584839,20
"25256","WBGene00170902","IV",17147345,17147365,20
"25257","WBGene00170904","IV",9718160,9718180,20
"25258","WBGene00170906","IV",5224270,5224290,20
"25259","WBGene00170909","IV",6413263,6413283,20
"25260","WBGene00170910","IV",14493839,14493859,20
"25261","WBGene00170911","IV",13624534,13624554,20
"25262","WBGene00170913","IV",5403468,5403488,20
"25263","WBGene00170921","IV",5522234,5522254,20
"25264","WBGene00170924","IV",6989542,6989562,20
"25265","WBGene00170926","IV",6766982,6767002,20
"25266","WBGene00170929","IV",5593044,5593064,20
"25267","WBGene00170930","IV",6462917,6462937,20
"25268","WBGene00170931","IV",16973361,16973381,20
"25269","WBGene00170936","IV",5154412,5154432,20
"25270","WBGene00170938","IV",16182014,16182034,20
"25271","WBGene00170942","IV",4990019,4990039,20
"25272","WBGene00170943","III",7392635,7392655,20
"25273","WBGene00170946","IV",15569083,15569103,20
"25274","WBGene00170950","IV",14054894,14054914,20
"25275","WBGene00170951","IV",5715627,5715647,20
"25276","WBGene00170953","I",31523,31543,20
"25277","WBGene00170954","IV",6837918,6837938,20
"25278","WBGene00170958","IV",16621621,16621641,20
"25279","WBGene00170959","IV",5196048,5196068,20
"25280","WBGene00170962","IV",15004541,15004561,20
"25281","WBGene00170963","IV",15259304,15259324,20
"25282","WBGene00170964","I",9518891,9518911,20
"25283","WBGene00170966","IV",5581974,5581994,20
"25284","WBGene00170968","IV",14458527,14458547,20
"25285","WBGene00170969","IV",5143177,5143197,20
"25286","WBGene00170970","IV",16993012,16993032,20
"25287","WBGene00170971","IV",5518868,5518888,20
"25288","WBGene00170973","IV",14853709,14853729,20
"25289","WBGene00170974","IV",15796238,15796258,20
"25290","WBGene00170975","IV",5956168,5956188,20
"25291","WBGene00170977","IV",5929913,5929933,20
"25292","WBGene00170978","IV",15815561,15815581,20
"25293","WBGene00170980","IV",5173184,5173204,20
"25294","WBGene00170983","V",7781151,7781171,20
"25295","WBGene00170986","IV",15003980,15004000,20
"25296","WBGene00170988","IV",16520534,16520554,20
"25297","WBGene00170990","IV",5610790,5610810,20
"25298","WBGene00170991","IV",6477020,6477040,20
"25299","WBGene00170995","IV",5521158,5521178,20
"25300","WBGene00170998","II",14452280,14452300,20
"25301","WBGene00171001","IV",12348873,12348893,20
"25302","WBGene00171003","IV",14498183,14498203,20
"25303","WBGene00171008","IV",15271865,15271885,20
"25304","WBGene00171009","IV",6114548,6114568,20
"25305","WBGene00171011","IV",13944812,13944832,20
"25306","WBGene00171012","IV",6043271,6043291,20
"25307","WBGene00171014","IV",5763848,5763868,20
"25308","WBGene00171015","IV",5420268,5420288,20
"25309","WBGene00171016","IV",4829060,4829080,20
"25310","WBGene00171017","IV",16010678,16010698,20
"25311","WBGene00171027","IV",15274041,15274061,20
"25312","WBGene00171029","IV",5079914,5079934,20
"25313","WBGene00171033","IV",15927887,15927907,20
"25314","WBGene00171041","IV",9676000,9676020,20
"25315","WBGene00171045","IV",5517542,5517562,20
"25316","WBGene00171047","IV",15155999,15156019,20
"25317","WBGene00171048","IV",15309395,15309415,20
"25318","WBGene00171051","IV",14589032,14589052,20
"25319","WBGene00171052","IV",5750747,5750767,20
"25320","WBGene00171054","IV",16058180,16058200,20
"25321","WBGene00171056","IV",15328192,15328212,20
"25322","WBGene00171061","IV",16053838,16053858,20
"25323","WBGene00171064","V",12881237,12881257,20
"25324","WBGene00171066","IV",5751018,5751038,20
"25325","WBGene00171069","IV",14613862,14613882,20
"25326","WBGene00171078","IV",14192094,14192114,20
"25327","WBGene00171080","IV",6039991,6040011,20
"25328","WBGene00171081","IV",15700803,15700823,20
"25329","WBGene00171082","IV",5596060,5596080,20
"25330","WBGene00171084","IV",16034441,16034461,20
"25331","WBGene00171087","IV",14962289,14962309,20
"25332","WBGene00171091","IV",4284943,4284963,20
"25333","WBGene00171099","V",15279273,15279293,20
"25334","WBGene00171104","IV",15180747,15180767,20
"25335","WBGene00171112","IV",17206257,17206277,20
"25336","WBGene00171116","IV",5909090,5909110,20
"25337","WBGene00171117","IV",16037209,16037229,20
"25338","WBGene00171121","IV",17188981,17189001,20
"25339","WBGene00171125","IV",14878701,14878721,20
"25340","WBGene00171126","IV",6854487,6854507,20
"25341","WBGene00171128","IV",14120944,14120964,20
"25342","WBGene00171141","IV",9384336,9384356,20
"25343","WBGene00171146","IV",14298946,14298966,20
"25344","WBGene00171147","IV",15822008,15822028,20
"25345","WBGene00171155","IV",4868097,4868117,20
"25346","WBGene00171162","III",6101410,6101430,20
"25347","WBGene00171166","IV",15088683,15088703,20
"25348","WBGene00171169","IV",5670486,5670506,20
"25349","WBGene00171172","IV",14902532,14902552,20
"25350","WBGene00171174","IV",6625186,6625206,20
"25351","WBGene00171175","X",5503377,5503397,20
"25352","WBGene00171177","IV",17249222,17249242,20
"25353","WBGene00171178","IV",16035396,16035416,20
"25354","WBGene00171179","IV",13558659,13558679,20
"25355","WBGene00171185","IV",6124264,6124284,20
"25356","WBGene00171187","IV",16255328,16255348,20
"25357","WBGene00171188","IV",15531458,15531478,20
"25358","WBGene00171194","IV",5927383,5927403,20
"25359","WBGene00171197","IV",14672729,14672749,20
"25360","WBGene00171201","III",2853328,2853348,20
"25361","WBGene00171204","IV",14863159,14863179,20
"25362","WBGene00171205","IV",5149814,5149834,20
"25363","WBGene00171208","IV",16812165,16812185,20
"25364","WBGene00171209","IV",13588462,13588482,20
"25365","WBGene00171211","II",9554392,9554412,20
"25366","WBGene00171216","IV",15771139,15771159,20
"25367","WBGene00171218","IV",16670450,16670470,20
"25368","WBGene00171221","IV",5172598,5172618,20
"25369","WBGene00171223","IV",14663356,14663376,20
"25370","WBGene00171224","IV",6067852,6067872,20
"25371","WBGene00171226","IV",16887048,16887068,20
"25372","WBGene00171228","IV",15910912,15910932,20
"25373","WBGene00171232","IV",5904711,5904731,20
"25374","WBGene00171233","IV",16575608,16575628,20
"25375","WBGene00171234","X",9239115,9239135,20
"25376","WBGene00171236","IV",6037114,6037134,20
"25377","WBGene00171240","IV",16288085,16288105,20
"25378","WBGene00171242","IV",5970440,5970460,20
"25379","WBGene00171244","IV",17371599,17371619,20
"25380","WBGene00171245","IV",14701405,14701425,20
"25381","WBGene00171246","IV",6466229,6466249,20
"25382","WBGene00171247","IV",15054663,15054683,20
"25383","WBGene00171249","IV",16663202,16663222,20
"25384","WBGene00171250","IV",6544957,6544977,20
"25385","WBGene00171251","IV",14887329,14887349,20
"25386","WBGene00171255","IV",13843334,13843354,20
"25387","WBGene00171256","IV",15865196,15865216,20
"25388","WBGene00171259","IV",13839216,13839236,20
"25389","WBGene00171264","IV",14906506,14906526,20
"25390","WBGene00171265","IV",14615638,14615658,20
"25391","WBGene00171269","IV",14037789,14037809,20
"25392","WBGene00171270","IV",5815289,5815309,20
"25393","WBGene00171271","IV",14851401,14851421,20
"25394","WBGene00171273","IV",14298127,14298147,20
"25395","WBGene00171280","I",8137256,8137276,20
"25396","WBGene00171281","IV",17210220,17210240,20
"25397","WBGene00171283","IV",15347219,15347239,20
"25398","WBGene00171286","III",6398482,6398502,20
"25399","WBGene00171289","IV",5294059,5294079,20
"25400","WBGene00171290","IV",5975096,5975116,20
"25401","WBGene00171291","IV",16007140,16007160,20
"25402","WBGene00171293","IV",5579061,5579081,20
"25403","WBGene00171299","IV",14413020,14413040,20
"25404","WBGene00171303","IV",16004824,16004844,20
"25405","WBGene00171305","IV",5640565,5640585,20
"25406","WBGene00171306","IV",15818709,15818729,20
"25407","WBGene00171309","IV",14962406,14962426,20
"25408","WBGene00171311","IV",5364419,5364439,20
"25409","WBGene00171324","IV",9949062,9949082,20
"25410","WBGene00171325","IV",5445075,5445095,20
"25411","WBGene00171329","IV",5286836,5286856,20
"25412","WBGene00171334","IV",17032602,17032622,20
"25413","WBGene00171336","IV",5353601,5353621,20
"25414","WBGene00171340","IV",5828288,5828308,20
"25415","WBGene00171346","I",7035351,7035371,20
"25416","WBGene00171347","IV",6574001,6574021,20
"25417","WBGene00171349","IV",5518163,5518183,20
"25418","WBGene00171354","IV",5597116,5597136,20
"25419","WBGene00171358","IV",16903629,16903649,20
"25420","WBGene00171359","IV",15478977,15478997,20
"25421","WBGene00171360","IV",5415276,5415296,20
"25422","WBGene00171364","IV",5952296,5952316,20
"25423","WBGene00171368","IV",14970906,14970926,20
"25424","WBGene00171374","IV",16877488,16877508,20
"25425","WBGene00171375","IV",14820033,14820053,20
"25426","WBGene00171381","X",12406983,12407003,20
"25427","WBGene00171385","IV",15582387,15582407,20
"25428","WBGene00171386","IV",5138173,5138193,20
"25429","WBGene00171392","IV",13909611,13909631,20
"25430","WBGene00171393","IV",7692886,7692906,20
"25431","WBGene00171396","IV",6161968,6161988,20
"25432","WBGene00171397","IV",14896821,14896841,20
"25433","WBGene00171399","IV",13925629,13925649,20
"25434","WBGene00171400","IV",16012333,16012353,20
"25435","WBGene00171403","IV",5954809,5954829,20
"25436","WBGene00171405","IV",8173416,8173436,20
"25437","WBGene00171410","IV",5638730,5638750,20
"25438","WBGene00171411","IV",5531233,5531253,20
"25439","WBGene00171412","IV",5926437,5926457,20
"25440","WBGene00171414","IV",16032818,16032838,20
"25441","WBGene00171415","IV",14247381,14247401,20
"25442","WBGene00171416","IV",12001589,12001609,20
"25443","WBGene00171419","IV",12226184,12226204,20
"25444","WBGene00171420","IV",14008704,14008724,20
"25445","WBGene00171421","IV",14371199,14371219,20
"25446","WBGene00171424","IV",17204331,17204351,20
"25447","WBGene00171425","IV",14889456,14889476,20
"25448","WBGene00171428","IV",15659924,15659944,20
"25449","WBGene00171432","IV",5562652,5562672,20
"25450","WBGene00171436","IV",16667989,16668009,20
"25451","WBGene00171441","IV",6542496,6542516,20
"25452","WBGene00171442","V",13022211,13022231,20
"25453","WBGene00171443","IV",16555918,16555938,20
"25454","WBGene00171447","IV",14678911,14678931,20
"25455","WBGene00171450","IV",16183989,16184009,20
"25456","WBGene00171451","IV",6129912,6129932,20
"25457","WBGene00171454","IV",4819243,4819263,20
"25458","WBGene00171455","IV",16608460,16608480,20
"25459","WBGene00171461","III",7660841,7660861,20
"25460","WBGene00171463","IV",13808403,13808423,20
"25461","WBGene00171468","IV",5523395,5523415,20
"25462","WBGene00171470","IV",5973117,5973137,20
"25463","WBGene00171471","IV",16023577,16023597,20
"25464","WBGene00171473","IV",14821276,14821296,20
"25465","WBGene00171479","IV",14053972,14053992,20
"25466","WBGene00171482","IV",13649691,13649711,20
"25467","WBGene00171483","IV",16558628,16558648,20
"25468","WBGene00171484","IV",6503507,6503527,20
"25469","WBGene00171485","V",4944876,4944896,20
"25470","WBGene00171486","V",3885045,3885065,20
"25471","WBGene00171487","IV",5138734,5138754,20
"25472","WBGene00171489","IV",6995874,6995894,20
"25473","WBGene00171492","IV",15086237,15086257,20
"25474","WBGene00171494","IV",6197739,6197759,20
"25475","WBGene00171500","X",7840783,7840803,20
"25476","WBGene00171501","IV",16548480,16548500,20
"25477","WBGene00171502","IV",15254159,15254179,20
"25478","WBGene00171504","IV",6063512,6063532,20
"25479","WBGene00171505","V",8042722,8042742,20
"25480","WBGene00171506","IV",16015656,16015676,20
"25481","WBGene00171510","IV",15705749,15705769,20
"25482","WBGene00171517","IV",16870677,16870697,20
"25483","WBGene00171518","IV",16354110,16354130,20
"25484","WBGene00171521","IV",5033857,5033877,20
"25485","WBGene00171525","X",13317770,13317790,20
"25486","WBGene00171526","IV",5928590,5928610,20
"25487","WBGene00171528","IV",14003035,14003055,20
"25488","WBGene00171530","IV",5802810,5802830,20
"25489","WBGene00171532","IV",5515564,5515584,20
"25490","WBGene00171536","IV",15005059,15005079,20
"25491","WBGene00171537","IV",15719979,15719999,20
"25492","WBGene00171541","IV",14052275,14052295,20
"25493","WBGene00171550","IV",6126062,6126082,20
"25494","WBGene00171558","IV",14645189,14645209,20
"25495","WBGene00171559","IV",5778321,5778341,20
"25496","WBGene00171565","IV",5141553,5141573,20
"25497","WBGene00171566","IV",5614284,5614304,20
"25498","WBGene00171567","IV",4848605,4848625,20
"25499","WBGene00171568","IV",14326526,14326546,20
"25500","WBGene00171571","IV",7051457,7051477,20
"25501","WBGene00171576","V",6042792,6042812,20
"25502","WBGene00171577","II",8540658,8540678,20
"25503","WBGene00171580","IV",14582601,14582621,20
"25504","WBGene00171584","IV",5449754,5449774,20
"25505","WBGene00171588","IV",16369663,16369683,20
"25506","WBGene00171590","IV",16872019,16872039,20
"25507","WBGene00171591","IV",5448519,5448539,20
"25508","WBGene00171593","IV",14975166,14975186,20
"25509","WBGene00171601","IV",16904912,16904932,20
"25510","WBGene00171607","IV",15690661,15690681,20
"25511","WBGene00171611","IV",14037357,14037377,20
"25512","WBGene00171613","IV",16475545,16475565,20
"25513","WBGene00171616","IV",5011861,5011881,20
"25514","WBGene00171617","IV",5559098,5559118,20
"25515","WBGene00171620","IV",13860092,13860112,20
"25516","WBGene00171621","IV",13469849,13469869,20
"25517","WBGene00171622","X",16480800,16480820,20
"25518","WBGene00171623","IV",16030588,16030608,20
"25519","WBGene00171625","IV",5643978,5643998,20
"25520","WBGene00171626","V",10345999,10346019,20
"25521","WBGene00171627","IV",16554842,16554862,20
"25522","WBGene00171633","V",17156026,17156046,20
"25523","WBGene00171634","IV",13954817,13954837,20
"25524","WBGene00171641","IV",15789638,15789658,20
"25525","WBGene00171642","IV",15548606,15548626,20
"25526","WBGene00171644","IV",14307541,14307561,20
"25527","WBGene00171646","IV",5230591,5230611,20
"25528","WBGene00171648","V",9412375,9412395,20
"25529","WBGene00171651","IV",15251742,15251762,20
"25530","WBGene00171652","IV",6111073,6111093,20
"25531","WBGene00171653","IV",5532913,5532933,20
"25532","WBGene00171654","IV",6399525,6399545,20
"25533","WBGene00171660","IV",15630378,15630398,20
"25534","WBGene00171662","IV",16082943,16082963,20
"25535","WBGene00171664","IV",15406157,15406177,20
"25536","WBGene00171666","IV",14457941,14457961,20
"25537","WBGene00171674","IV",15531922,15531942,20
"25538","WBGene00171676","V",7003298,7003318,20
"25539","WBGene00171678","I",7235352,7235372,20
"25540","WBGene00171680","IV",5141920,5141940,20
"25541","WBGene00171681","IV",6305452,6305472,20
"25542","WBGene00171682","IV",16479523,16479543,20
"25543","WBGene00171683","IV",15267154,15267174,20
"25544","WBGene00171684","IV",14919212,14919232,20
"25545","WBGene00171688","IV",16196948,16196968,20
"25546","WBGene00171690","IV",5506214,5506234,20
"25547","WBGene00171691","IV",5819785,5819805,20
"25548","WBGene00171694","IV",6657393,6657413,20
"25549","WBGene00171695","IV",4887422,4887442,20
"25550","WBGene00171697","IV",14309640,14309660,20
"25551","WBGene00171699","IV",14273769,14273789,20
"25552","WBGene00171703","IV",7272195,7272215,20
"25553","WBGene00171705","IV",16692145,16692165,20
"25554","WBGene00171706","IV",5587313,5587333,20
"25555","WBGene00171708","V",16103739,16103759,20
"25556","WBGene00171709","IV",16013584,16013604,20
"25557","WBGene00171715","IV",15296592,15296612,20
"25558","WBGene00171718","II",14483493,14483513,20
"25559","WBGene00171725","IV",5449060,5449080,20
"25560","WBGene00171737","IV",15328425,15328445,20
"25561","WBGene00171742","IV",15563820,15563840,20
"25562","WBGene00171743","IV",17176438,17176458,20
"25563","WBGene00171746","IV",14873800,14873820,20
"25564","WBGene00171747","IV",16555349,16555369,20
"25565","WBGene00171750","IV",5750844,5750864,20
"25566","WBGene00171751","IV",14415135,14415155,20
"25567","WBGene00171754","IV",6811718,6811738,20
"25568","WBGene00171758","IV",6466226,6466246,20
"25569","WBGene00171760","IV",5118824,5118844,20
"25570","WBGene00171761","IV",15243761,15243781,20
"25571","WBGene00171764","IV",5640850,5640870,20
"25572","WBGene00171765","IV",14472649,14472669,20
"25573","WBGene00171766","IV",5905971,5905991,20
"25574","WBGene00171768","IV",15395260,15395280,20
"25575","WBGene00171770","IV",15677505,15677525,20
"25576","WBGene00171772","IV",5617116,5617136,20
"25577","WBGene00171777","IV",14498362,14498382,20
"25578","WBGene00171780","IV",6247133,6247153,20
"25579","WBGene00171785","IV",15805592,15805612,20
"25580","WBGene00171786","V",14933144,14933164,20
"25581","WBGene00171791","IV",14116862,14116882,20
"25582","WBGene00171793","IV",14307085,14307105,20
"25583","WBGene00171794","IV",15335685,15335705,20
"25584","WBGene00171799","IV",5080772,5080792,20
"25585","WBGene00171800","IV",15609604,15609624,20
"25586","WBGene00171801","IV",16660514,16660534,20
"25587","WBGene00171805","IV",4838345,4838365,20
"25588","WBGene00171806","IV",6048330,6048350,20
"25589","WBGene00171807","IV",16007416,16007436,20
"25590","WBGene00171810","IV",14489528,14489548,20
"25591","WBGene00171811","IV",14918994,14919014,20
"25592","WBGene00171812","IV",14604348,14604368,20
"25593","WBGene00171813","IV",14867809,14867829,20
"25594","WBGene00171816","III",10807482,10807502,20
"25595","WBGene00171817","IV",14907282,14907302,20
"25596","WBGene00171818","I",115656,115676,20
"25597","WBGene00171823","IV",14618134,14618154,20
"25598","WBGene00171826","IV",16683051,16683071,20
"25599","WBGene00171829","IV",14282947,14282967,20
"25600","WBGene00171838","IV",15351031,15351051,20
"25601","WBGene00171840","IV",6567897,6567917,20
"25602","WBGene00171841","IV",6058591,6058611,20
"25603","WBGene00171842","IV",17191492,17191512,20
"25604","WBGene00171848","IV",6399935,6399955,20
"25605","WBGene00171850","IV",5419756,5419776,20
"25606","WBGene00171855","IV",15497443,15497463,20
"25607","WBGene00171863","IV",15393835,15393855,20
"25608","WBGene00171865","IV",6566801,6566821,20
"25609","WBGene00171866","IV",15731339,15731359,20
"25610","WBGene00171867","IV",14140546,14140566,20
"25611","WBGene00171869","IV",9677414,9677434,20
"25612","WBGene00171870","IV",15669471,15669491,20
"25613","WBGene00171872","IV",7284073,7284093,20
"25614","WBGene00171873","IV",15558516,15558536,20
"25615","WBGene00171876","IV",16557438,16557458,20
"25616","WBGene00171889","IV",14461929,14461949,20
"25617","WBGene00171892","IV",14393371,14393391,20
"25618","WBGene00171897","IV",14891428,14891448,20
"25619","WBGene00171899","IV",16660371,16660391,20
"25620","WBGene00171903","IV",14471147,14471167,20
"25621","WBGene00171905","IV",6385861,6385881,20
"25622","WBGene00171906","IV",6092146,6092166,20
"25623","WBGene00171916","IV",13643845,13643865,20
"25624","WBGene00171927","IV",14647039,14647059,20
"25625","WBGene00171932","IV",16838756,16838776,20
"25626","WBGene00171934","IV",6057497,6057517,20
"25627","WBGene00171935","I",7286301,7286321,20
"25628","WBGene00171936","IV",14495077,14495097,20
"25629","WBGene00171940","IV",5779571,5779591,20
"25630","WBGene00171941","IV",5205574,5205594,20
"25631","WBGene00171946","IV",5716201,5716221,20
"25632","WBGene00171956","IV",15315221,15315241,20
"25633","WBGene00171958","IV",14010744,14010764,20
"25634","WBGene00171959","IV",15151821,15151841,20
"25635","WBGene00171961","IV",14535362,14535382,20
"25636","WBGene00171963","IV",14859174,14859194,20
"25637","WBGene00171967","IV",14943551,14943571,20
"25638","WBGene00171973","IV",16807159,16807179,20
"25639","WBGene00171974","IV",14875932,14875952,20
"25640","WBGene00171977","X",8254578,8254598,20
"25641","WBGene00171978","IV",6953874,6953894,20
"25642","WBGene00171979","IV",12001030,12001050,20
"25643","WBGene00171980","IV",5529408,5529428,20
"25644","WBGene00171985","III",4283600,4283620,20
"25645","WBGene00171986","IV",12927392,12927412,20
"25646","WBGene00172002","IV",13603252,13603272,20
"25647","WBGene00172004","IV",14093196,14093216,20
"25648","WBGene00172007","IV",13861017,13861037,20
"25649","WBGene00172013","V",19811809,19811829,20
"25650","WBGene00172019","IV",14877479,14877499,20
"25651","WBGene00172021","I",9884711,9884731,20
"25652","WBGene00172023","IV",15532090,15532110,20
"25653","WBGene00172024","IV",14430367,14430387,20
"25654","WBGene00172026","IV",15404490,15404510,20
"25655","WBGene00172027","IV",4834607,4834627,20
"25656","WBGene00172028","IV",15687014,15687034,20
"25657","WBGene00172039","IV",15794991,15795011,20
"25658","WBGene00172042","IV",5593664,5593684,20
"25659","WBGene00172045","IV",15902418,15902438,20
"25660","WBGene00172050","IV",16195995,16196015,20
"25661","WBGene00172053","IV",16001382,16001402,20
"25662","WBGene00172054","X",11138620,11138640,20
"25663","WBGene00172056","X",2770771,2770791,20
"25664","WBGene00172059","IV",13759389,13759409,20
"25665","WBGene00172061","IV",14509968,14509988,20
"25666","WBGene00172064","IV",13645445,13645465,20
"25667","WBGene00172067","IV",14815103,14815123,20
"25668","WBGene00172071","IV",6467643,6467663,20
"25669","WBGene00172072","IV",6651186,6651206,20
"25670","WBGene00172073","IV",5614977,5614997,20
"25671","WBGene00172075","IV",13874946,13874966,20
"25672","WBGene00172078","IV",5925189,5925209,20
"25673","WBGene00172079","IV",15549128,15549148,20
"25674","WBGene00172092","IV",6052936,6052956,20
"25675","WBGene00172098","IV",6062637,6062657,20
"25676","WBGene00172107","IV",15729223,15729243,20
"25677","WBGene00172109","IV",5560394,5560414,20
"25678","WBGene00172112","IV",6807539,6807559,20
"25679","WBGene00172117","IV",15565349,15565369,20
"25680","WBGene00172121","IV",16045987,16046007,20
"25681","WBGene00172122","IV",16724858,16724878,20
"25682","WBGene00172127","IV",16527655,16527675,20
"25683","WBGene00172130","IV",5438134,5438154,20
"25684","WBGene00172131","IV",13959572,13959592,20
"25685","WBGene00172133","IV",8103531,8103551,20
"25686","WBGene00172136","IV",16476505,16476525,20
"25687","WBGene00172143","IV",15725356,15725376,20
"25688","WBGene00172149","IV",15098459,15098479,20
"25689","WBGene00172153","IV",15616409,15616429,20
"25690","WBGene00172154","IV",5807376,5807396,20
"25691","WBGene00172161","IV",16829727,16829747,20
"25692","WBGene00172163","IV",6184119,6184139,20
"25693","WBGene00172166","IV",5316375,5316395,20
"25694","WBGene00172169","II",1320733,1320753,20
"25695","WBGene00172171","IV",16477623,16477643,20
"25696","WBGene00172174","IV",5807638,5807658,20
"25697","WBGene00172176","IV",5140762,5140782,20
"25698","WBGene00172180","IV",13807961,13807981,20
"25699","WBGene00172181","IV",5115790,5115810,20
"25700","WBGene00172185","IV",16048101,16048121,20
"25701","WBGene00172188","IV",14462872,14462892,20
"25702","WBGene00172189","IV",14617170,14617190,20
"25703","WBGene00172190","IV",6043583,6043603,20
"25704","WBGene00172193","IV",13976827,13976847,20
"25705","WBGene00172198","IV",15722434,15722454,20
"25706","WBGene00172199","IV",16031690,16031710,20
"25707","WBGene00172202","IV",15108269,15108289,20
"25708","WBGene00172203","IV",5492830,5492850,20
"25709","WBGene00172204","II",12398795,12398815,20
"25710","WBGene00172206","IV",6138551,6138571,20
"25711","WBGene00172207","V",4796391,4796411,20
"25712","WBGene00172208","IV",14881082,14881102,20
"25713","WBGene00172214","IV",14050258,14050278,20
"25714","WBGene00172216","IV",5596056,5596076,20
"25715","WBGene00172217","IV",17215037,17215057,20
"25716","WBGene00172218","IV",10278161,10278181,20
"25717","WBGene00172220","IV",13696759,13696779,20
"25718","WBGene00172223","IV",6050517,6050537,20
"25719","WBGene00172227","IV",5970998,5971018,20
"25720","WBGene00172230","III",12119009,12119029,20
"25721","WBGene00172233","IV",14177588,14177608,20
"25722","WBGene00172244","IV",6159415,6159435,20
"25723","WBGene00172245","IV",15701903,15701923,20
"25724","WBGene00172250","IV",5598345,5598365,20
"25725","WBGene00172255","IV",17210844,17210864,20
"25726","WBGene00172256","IV",16836907,16836927,20
"25727","WBGene00172257","V",4236289,4236309,20
"25728","WBGene00172258","IV",14989419,14989439,20
"25729","WBGene00172264","IV",15668856,15668876,20
"25730","WBGene00172271","IV",4789336,4789356,20
"25731","WBGene00172274","IV",15695227,15695247,20
"25732","WBGene00172283","IV",15680291,15680311,20
"25733","WBGene00172284","IV",14526061,14526081,20
"25734","WBGene00172285","IV",17357116,17357136,20
"25735","WBGene00172287","X",6039714,6039734,20
"25736","WBGene00172291","IV",13693913,13693933,20
"25737","WBGene00172292","IV",15864062,15864082,20
"25738","WBGene00172294","IV",16471363,16471383,20
"25739","WBGene00172296","IV",15697184,15697204,20
"25740","WBGene00172304","IV",14242307,14242327,20
"25741","WBGene00172309","IV",5968508,5968528,20
"25742","WBGene00172311","IV",6304549,6304569,20
"25743","WBGene00172315","V",4245568,4245588,20
"25744","WBGene00172318","IV",17022167,17022187,20
"25745","WBGene00172320","IV",6514356,6514376,20
"25746","WBGene00172321","IV",9561990,9562010,20
"25747","WBGene00172323","IV",15541317,15541337,20
"25748","WBGene00172324","IV",15922951,15922971,20
"25749","WBGene00172327","IV",13700706,13700726,20
"25750","WBGene00172330","X",10452570,10452590,20
"25751","WBGene00172332","IV",6066282,6066302,20
"25752","WBGene00172333","IV",15410055,15410075,20
"25753","WBGene00172334","IV",6185666,6185686,20
"25754","WBGene00172339","IV",6203568,6203588,20
"25755","WBGene00172346","IV",14446198,14446218,20
"25756","WBGene00172351","IV",14160220,14160240,20
"25757","WBGene00172353","III",6483185,6483205,20
"25758","WBGene00172357","IV",15699226,15699246,20
"25759","WBGene00172358","IV",5603707,5603727,20
"25760","WBGene00172364","IV",15356707,15356727,20
"25761","WBGene00172367","IV",16745315,16745335,20
"25762","WBGene00172368","IV",14295075,14295095,20
"25763","WBGene00172369","IV",14046293,14046313,20
"25764","WBGene00172371","IV",4889285,4889305,20
"25765","WBGene00172373","IV",13944585,13944605,20
"25766","WBGene00172377","IV",5499788,5499808,20
"25767","WBGene00172379","X",12569233,12569253,20
"25768","WBGene00172382","IV",14183013,14183033,20
"25769","WBGene00172383","IV",15348126,15348146,20
"25770","WBGene00172384","V",13768081,13768101,20
"25771","WBGene00172387","IV",13979403,13979423,20
"25772","WBGene00172393","IV",14470556,14470576,20
"25773","WBGene00172394","IV",5157758,5157778,20
"25774","WBGene00172399","IV",5205003,5205023,20
"25775","WBGene00172401","II",13058799,13058819,20
"25776","WBGene00172403","IV",5119257,5119277,20
"25777","WBGene00172406","V",10473255,10473275,20
"25778","WBGene00172407","IV",15348877,15348897,20
"25779","WBGene00172409","IV",14603628,14603648,20
"25780","WBGene00172410","IV",5906692,5906712,20
"25781","WBGene00172412","X",7962042,7962062,20
"25782","WBGene00172414","IV",6508416,6508436,20
"25783","WBGene00172415","IV",14807890,14807910,20
"25784","WBGene00172419","I",1556641,1556661,20
"25785","WBGene00172420","IV",6598924,6598944,20
"25786","WBGene00172426","IV",8798869,8798889,20
"25787","WBGene00172427","X",9133973,9133993,20
"25788","WBGene00172428","IV",14191901,14191921,20
"25789","WBGene00172429","IV",16599660,16599680,20
"25790","WBGene00172432","IV",5566268,5566288,20
"25791","WBGene00172433","IV",14473295,14473315,20
"25792","WBGene00172435","IV",5447944,5447964,20
"25793","WBGene00172442","IV",14026578,14026598,20
"25794","WBGene00172452","IV",14009135,14009155,20
"25795","WBGene00172453","IV",5930981,5931001,20
"25796","WBGene00172457","IV",15645569,15645589,20
"25797","WBGene00172458","IV",15695453,15695473,20
"25798","WBGene00172464","IV",5929097,5929117,20
"25799","WBGene00172466","IV",15563114,15563134,20
"25800","WBGene00172469","IV",13906670,13906690,20
"25801","WBGene00172470","IV",14489997,14490017,20
"25802","WBGene00172471","IV",6493142,6493162,20
"25803","WBGene00172472","IV",7055429,7055449,20
"25804","WBGene00172483","V",16038827,16038847,20
"25805","WBGene00172491","IV",5529507,5529527,20
"25806","WBGene00172496","IV",16071583,16071603,20
"25807","WBGene00172499","IV",16476739,16476759,20
"25808","WBGene00172505","IV",5600781,5600801,20
"25809","WBGene00172507","IV",16081038,16081058,20
"25810","WBGene00172509","IV",5095664,5095684,20
"25811","WBGene00172514","IV",5337044,5337064,20
"25812","WBGene00172516","IV",6572388,6572408,20
"25813","WBGene00172519","V",9138406,9138426,20
"25814","WBGene00172537","IV",14367707,14367727,20
"25815","WBGene00172538","IV",15349876,15349896,20
"25816","WBGene00172539","IV",16453423,16453443,20
"25817","WBGene00172543","IV",15813346,15813366,20
"25818","WBGene00172545","IV",6765381,6765401,20
"25819","WBGene00172554","IV",13907297,13907317,20
"25820","WBGene00172557","IV",6069424,6069444,20
"25821","WBGene00172560","IV",5340304,5340324,20
"25822","WBGene00172561","IV",16068463,16068483,20
"25823","WBGene00172562","IV",16069293,16069313,20
"25824","WBGene00172565","IV",6438791,6438811,20
"25825","WBGene00172567","IV",14654039,14654059,20
"25826","WBGene00172571","IV",14263194,14263214,20
"25827","WBGene00172573","IV",16670002,16670022,20
"25828","WBGene00172578","IV",15264337,15264357,20
"25829","WBGene00172580","IV",15614607,15614627,20
"25830","WBGene00172581","IV",15128104,15128124,20
"25831","WBGene00172585","IV",15706203,15706223,20
"25832","WBGene00172591","IV",6049890,6049910,20
"25833","WBGene00172592","IV",6648295,6648315,20
"25834","WBGene00172593","IV",5142125,5142145,20
"25835","WBGene00172598","V",12468407,12468427,20
"25836","WBGene00172604","V",7904030,7904050,20
"25837","WBGene00172605","IV",15957378,15957398,20
"25838","WBGene00172607","IV",16173162,16173182,20
"25839","WBGene00172610","IV",14874123,14874143,20
"25840","WBGene00172611","IV",6858068,6858088,20
"25841","WBGene00172613","IV",15848326,15848346,20
"25842","WBGene00172615","IV",15699652,15699672,20
"25843","WBGene00172618","IV",17469644,17469664,20
"25844","WBGene00172619","IV",6575052,6575072,20
"25845","WBGene00172621","IV",14032387,14032407,20
"25846","WBGene00172625","IV",6510467,6510487,20
"25847","WBGene00172626","IV",14600047,14600067,20
"25848","WBGene00172629","IV",17071031,17071051,20
"25849","WBGene00172630","IV",17214932,17214952,20
"25850","WBGene00172634","IV",15694361,15694381,20
"25851","WBGene00172635","IV",5515093,5515113,20
"25852","WBGene00172636","IV",16670365,16670385,20
"25853","WBGene00172645","IV",4786735,4786755,20
"25854","WBGene00172647","IV",16669983,16670003,20
"25855","WBGene00172649","IV",6055495,6055515,20
"25856","WBGene00172650","IV",5439958,5439978,20
"25857","WBGene00172651","IV",6066040,6066060,20
"25858","WBGene00172652","IV",5135850,5135870,20
"25859","WBGene00172654","I",13817000,13817020,20
"25860","WBGene00172658","IV",12062143,12062163,20
"25861","WBGene00172661","IV",6063292,6063312,20
"25862","WBGene00172663","IV",15435799,15435819,20
"25863","WBGene00172666","IV",16149030,16149050,20
"25864","WBGene00172671","IV",6438604,6438624,20
"25865","WBGene00172677","IV",15807607,15807627,20
"25866","WBGene00172680","IV",14483204,14483224,20
"25867","WBGene00172683","IV",14338242,14338262,20
"25868","WBGene00172684","X",3158860,3158880,20
"25869","WBGene00172690","IV",15409826,15409846,20
"25870","WBGene00172692","IV",5958321,5958341,20
"25871","WBGene00172695","IV",6047708,6047728,20
"25872","WBGene00172698","IV",16629737,16629757,20
"25873","WBGene00172707","IV",14269694,14269714,20
"25874","WBGene00172714","IV",14050415,14050435,20
"25875","WBGene00172717","IV",15585508,15585528,20
"25876","WBGene00172718","IV",14542277,14542297,20
"25877","WBGene00172722","IV",14619198,14619218,20
"25878","WBGene00172723","IV",14088762,14088782,20
"25879","WBGene00172724","IV",16275918,16275938,20
"25880","WBGene00172726","IV",14380381,14380401,20
"25881","WBGene00172727","IV",6432290,6432310,20
"25882","WBGene00172728","IV",14509220,14509240,20
"25883","WBGene00172734","IV",6209976,6209996,20
"25884","WBGene00172742","IV",14031867,14031887,20
"25885","WBGene00172745","IV",15676486,15676506,20
"25886","WBGene00172749","IV",15701337,15701357,20
"25887","WBGene00172750","X",14222416,14222436,20
"25888","WBGene00172754","IV",5432804,5432824,20
"25889","WBGene00172755","X",7306443,7306463,20
"25890","WBGene00172758","IV",5437311,5437331,20
"25891","WBGene00172759","IV",16536902,16536922,20
"25892","WBGene00172760","IV",14914386,14914406,20
"25893","WBGene00172770","IV",6860921,6860941,20
"25894","WBGene00172772","IV",6479089,6479109,20
"25895","WBGene00172774","IV",15306252,15306272,20
"25896","WBGene00172775","IV",17237288,17237308,20
"25897","WBGene00172777","IV",13914315,13914335,20
"25898","WBGene00172778","IV",16032495,16032515,20
"25899","WBGene00172779","IV",14872794,14872814,20
"25900","WBGene00172784","IV",6750776,6750796,20
"25901","WBGene00172785","IV",15139286,15139306,20
"25902","WBGene00172787","IV",15811865,15811885,20
"25903","WBGene00172790","III",8423403,8423423,20
"25904","WBGene00172791","IV",16437369,16437389,20
"25905","WBGene00172794","IV",4990488,4990508,20
"25906","WBGene00172795","IV",6180001,6180021,20
"25907","WBGene00172797","IV",14887748,14887768,20
"25908","WBGene00172799","IV",15405588,15405608,20
"25909","WBGene00172802","I",9925695,9925715,20
"25910","WBGene00172806","IV",13906383,13906403,20
"25911","WBGene00172808","IV",15668753,15668773,20
"25912","WBGene00172811","IV",14489176,14489196,20
"25913","WBGene00172812","IV",13897008,13897028,20
"25914","WBGene00172813","IV",5643694,5643714,20
"25915","WBGene00172819","IV",14056166,14056186,20
"25916","WBGene00172822","IV",15887052,15887072,20
"25917","WBGene00172823","IV",13718862,13718882,20
"25918","WBGene00172827","IV",5925908,5925928,20
"25919","WBGene00172830","IV",6069888,6069908,20
"25920","WBGene00172832","IV",5933516,5933536,20
"25921","WBGene00172833","X",16690315,16690335,20
"25922","WBGene00172834","IV",16540705,16540725,20
"25923","WBGene00172835","IV",15508779,15508799,20
"25924","WBGene00172838","IV",14932520,14932540,20
"25925","WBGene00172839","IV",16391321,16391341,20
"25926","WBGene00172840","IV",5776608,5776628,20
"25927","WBGene00172841","IV",15631885,15631905,20
"25928","WBGene00172849","V",2566450,2566470,20
"25929","WBGene00172851","IV",16271053,16271073,20
"25930","WBGene00172856","IV",16810981,16811001,20
"25931","WBGene00172860","IV",16126515,16126535,20
"25932","WBGene00172862","X",3957199,3957219,20
"25933","WBGene00172863","IV",5978469,5978489,20
"25934","WBGene00172865","IV",15885749,15885769,20
"25935","WBGene00172867","IV",5762390,5762410,20
"25936","WBGene00172868","IV",6623250,6623270,20
"25937","WBGene00172869","X",16167757,16167777,20
"25938","WBGene00172872","IV",16751399,16751419,20
"25939","WBGene00172873","IV",16144295,16144315,20
"25940","WBGene00172874","IV",15900541,15900561,20
"25941","WBGene00172875","IV",13911234,13911254,20
"25942","WBGene00172877","IV",14884510,14884530,20
"25943","WBGene00172885","IV",5724227,5724247,20
"25944","WBGene00172886","X",5516328,5516348,20
"25945","WBGene00172888","IV",16173739,16173759,20
"25946","WBGene00172891","IV",15733522,15733542,20
"25947","WBGene00172900","IV",5331024,5331044,20
"25948","WBGene00172909","IV",5762172,5762192,20
"25949","WBGene00172912","IV",6505283,6505303,20
"25950","WBGene00172916","IV",14390122,14390142,20
"25951","WBGene00172918","IV",10541043,10541063,20
"25952","WBGene00172920","IV",16123816,16123836,20
"25953","WBGene00172925","IV",14037610,14037630,20
"25954","WBGene00172931","IV",6544393,6544413,20
"25955","WBGene00172934","IV",15212406,15212426,20
"25956","WBGene00172941","IV",17198696,17198716,20
"25957","WBGene00172942","IV",5143560,5143580,20
"25958","WBGene00172944","IV",15668752,15668772,20
"25959","WBGene00172946","IV",6639512,6639532,20
"25960","WBGene00172951","IV",16508195,16508215,20
"25961","WBGene00172952","IV",6432699,6432719,20
"25962","WBGene00172959","IV",15369437,15369457,20
"25963","WBGene00172961","IV",14726813,14726833,20
"25964","WBGene00172963","IV",5592956,5592976,20
"25965","WBGene00172974","IV",5281768,5281788,20
"25966","WBGene00172979","IV",13898254,13898274,20
"25967","WBGene00172981","IV",16568428,16568448,20
"25968","WBGene00172985","IV",6191472,6191492,20
"25969","WBGene00172996","IV",16796002,16796022,20
"25970","WBGene00172999","IV",5809208,5809228,20
"25971","WBGene00173000","III",13480497,13480517,20
"25972","WBGene00173004","IV",6058040,6058060,20
"25973","WBGene00173006","IV",14086709,14086729,20
"25974","WBGene00173015","IV",5505534,5505554,20
"25975","WBGene00173018","IV",6038598,6038618,20
"25976","WBGene00173019","IV",6343409,6343429,20
"25977","WBGene00173023","IV",14169885,14169905,20
"25978","WBGene00173024","IV",14665595,14665615,20
"25979","WBGene00173027","IV",5923213,5923233,20
"25980","WBGene00173032","IV",6493138,6493158,20
"25981","WBGene00173033","IV",15370887,15370907,20
"25982","WBGene00173043","I",13460414,13460434,20
"25983","WBGene00173044","V",10860077,10860097,20
"25984","WBGene00173046","IV",14641671,14641691,20
"25985","WBGene00173047","IV",15399277,15399297,20
"25986","WBGene00173050","IV",15711608,15711628,20
"25987","WBGene00173052","IV",5519433,5519453,20
"25988","WBGene00173053","IV",7839516,7839536,20
"25989","WBGene00173061","IV",15802573,15802593,20
"25990","WBGene00173063","IV",5596946,5596966,20
"25991","WBGene00173065","IV",14412933,14412953,20
"25992","WBGene00173067","IV",5671009,5671029,20
"25993","WBGene00173068","IV",16029921,16029941,20
"25994","WBGene00173070","IV",6388031,6388051,20
"25995","WBGene00173071","IV",16556125,16556145,20
"25996","WBGene00173075","IV",10451843,10451863,20
"25997","WBGene00173077","IV",14987578,14987598,20
"25998","WBGene00173082","IV",5095227,5095247,20
"25999","WBGene00173083","IV",5342916,5342936,20
"26000","WBGene00173091","IV",16083588,16083608,20
"26001","WBGene00173095","IV",16026412,16026432,20
"26002","WBGene00173096","IV",14088266,14088286,20
"26003","WBGene00173097","IV",15616640,15616660,20
"26004","WBGene00173098","IV",15490738,15490758,20
"26005","WBGene00173106","X",1960772,1960792,20
"26006","WBGene00173108","IV",16046618,16046638,20
"26007","WBGene00173110","IV",6545074,6545094,20
"26008","WBGene00173113","IV",6255862,6255882,20
"26009","WBGene00173118","III",12361439,12361459,20
"26010","WBGene00173119","IV",13876646,13876666,20
"26011","WBGene00173122","IV",6091500,6091520,20
"26012","WBGene00173126","IV",15179590,15179610,20
"26013","WBGene00173128","IV",6177027,6177047,20
"26014","WBGene00173130","IV",16138239,16138259,20
"26015","WBGene00173132","IV",13919163,13919183,20
"26016","WBGene00173135","IV",13869194,13869214,20
"26017","WBGene00173137","IV",6412722,6412742,20
"26018","WBGene00173141","IV",5889274,5889294,20
"26019","WBGene00173144","IV",13757317,13757337,20
"26020","WBGene00173145","IV",14682660,14682680,20
"26021","WBGene00173147","IV",15819178,15819198,20
"26022","WBGene00173159","IV",16750005,16750025,20
"26023","WBGene00173160","IV",15714007,15714027,20
"26024","WBGene00173163","IV",15207407,15207427,20
"26025","WBGene00173168","X",14199371,14199391,20
"26026","WBGene00173169","IV",14474197,14474217,20
"26027","WBGene00173176","IV",15650814,15650834,20
"26028","WBGene00173181","IV",14915228,14915248,20
"26029","WBGene00173188","IV",14616389,14616409,20
"26030","WBGene00173190","IV",6386756,6386776,20
"26031","WBGene00173191","IV",14407460,14407480,20
"26032","WBGene00173194","IV",15497442,15497462,20
"26033","WBGene00173198","IV",15275019,15275039,20
"26034","WBGene00173208","IV",5592826,5592846,20
"26035","WBGene00173210","IV",16883724,16883744,20
"26036","WBGene00173211","IV",13720996,13721016,20
"26037","WBGene00173216","IV",14804099,14804119,20
"26038","WBGene00173223","IV",17225743,17225763,20
"26039","WBGene00173226","IV",15751155,15751175,20
"26040","WBGene00173228","IV",16035156,16035176,20
"26041","WBGene00173230","IV",16126126,16126146,20
"26042","WBGene00173233","IV",16871398,16871418,20
"26043","WBGene00173234","IV",13710258,13710278,20
"26044","WBGene00173238","I",4479639,4479659,20
"26045","WBGene00173241","IV",16466382,16466402,20
"26046","WBGene00173242","IV",14535694,14535714,20
"26047","WBGene00173245","V",9631060,9631080,20
"26048","WBGene00173246","IV",17185215,17185235,20
"26049","WBGene00173248","III",4011895,4011915,20
"26050","WBGene00173249","IV",5888267,5888287,20
"26051","WBGene00173250","IV",5513664,5513684,20
"26052","WBGene00173252","IV",14258489,14258509,20
"26053","WBGene00173256","IV",14101543,14101563,20
"26054","WBGene00173261","IV",13823316,13823336,20
"26055","WBGene00173263","IV",5756692,5756712,20
"26056","WBGene00173268","IV",15366853,15366873,20
"26057","WBGene00173270","IV",5265097,5265117,20
"26058","WBGene00173271","IV",16835039,16835059,20
"26059","WBGene00173276","IV",16228690,16228710,20
"26060","WBGene00173278","IV",16539750,16539770,20
"26061","WBGene00173283","IV",5780945,5780965,20
"26062","WBGene00173284","IV",13705123,13705143,20
"26063","WBGene00173293","IV",5121275,5121295,20
"26064","WBGene00173294","IV",4820087,4820107,20
"26065","WBGene00173298","V",11071504,11071524,20
"26066","WBGene00173301","IV",6433919,6433939,20
"26067","WBGene00173305","IV",13871254,13871274,20
"26068","WBGene00173308","IV",17206199,17206219,20
"26069","WBGene00173312","IV",16350587,16350607,20
"26070","WBGene00173315","IV",15561657,15561677,20
"26071","WBGene00173317","IV",5423002,5423022,20
"26072","WBGene00173319","IV",13661393,13661413,20
"26073","WBGene00173320","IV",13760792,13760812,20
"26074","WBGene00173322","IV",15617525,15617545,20
"26075","WBGene00173323","IV",5337885,5337905,20
"26076","WBGene00173324","IV",13770673,13770693,20
"26077","WBGene00173326","IV",5718034,5718054,20
"26078","WBGene00173331","IV",13872102,13872122,20
"26079","WBGene00173333","V",6131797,6131817,20
"26080","WBGene00173337","I",5450436,5450456,20
"26081","WBGene00173338","IV",14598483,14598503,20
"26082","WBGene00173340","IV",14121177,14121197,20
"26083","WBGene00173344","IV",15367738,15367758,20
"26084","WBGene00173345","IV",7350683,7350703,20
"26085","WBGene00173356","IV",6495968,6495988,20
"26086","WBGene00173360","IV",14506349,14506369,20
"26087","WBGene00173363","IV",13981456,13981476,20
"26088","WBGene00173365","IV",15083129,15083149,20
"26089","WBGene00173366","IV",4994086,4994106,20
"26090","WBGene00173374","IV",14684857,14684877,20
"26091","WBGene00173375","IV",16002216,16002236,20
"26092","WBGene00173377","IV",14193137,14193157,20
"26093","WBGene00173381","IV",13705694,13705714,20
"26094","WBGene00173383","IV",6440963,6440983,20
"26095","WBGene00173384","IV",15805040,15805060,20
"26096","WBGene00173388","IV",14664618,14664638,20
"26097","WBGene00173390","IV",14036000,14036020,20
"26098","WBGene00173393","IV",5449751,5449771,20
"26099","WBGene00173394","IV",14619134,14619154,20
"26100","WBGene00173404","IV",16508610,16508630,20
"26101","WBGene00173405","IV",6406394,6406414,20
"26102","WBGene00173412","IV",4834067,4834087,20
"26103","WBGene00173413","IV",16664074,16664094,20
"26104","WBGene00173419","IV",6064742,6064762,20
"26105","WBGene00173420","IV",5956475,5956495,20
"26106","WBGene00173421","IV",13908213,13908233,20
"26107","WBGene00173423","IV",14672291,14672311,20
"26108","WBGene00173425","IV",16442191,16442211,20
"26109","WBGene00173426","IV",6640505,6640525,20
"26110","WBGene00173431","IV",15669085,15669105,20
"26111","WBGene00173432","IV",15465695,15465715,20
"26112","WBGene00173437","IV",16472730,16472750,20
"26113","WBGene00173438","IV",13844465,13844485,20
"26114","WBGene00173443","IV",14293903,14293923,20
"26115","WBGene00173444","IV",14817047,14817067,20
"26116","WBGene00173459","IV",6245116,6245136,20
"26117","WBGene00173462","IV",15694165,15694185,20
"26118","WBGene00173468","IV",6954737,6954757,20
"26119","WBGene00173472","IV",5203843,5203863,20
"26120","WBGene00173476","IV",13640309,13640329,20
"26121","WBGene00173478","IV",14119981,14120001,20
"26122","WBGene00173480","IV",15508977,15508997,20
"26123","WBGene00173483","IV",14315796,14315816,20
"26124","WBGene00173487","IV",17205085,17205105,20
"26125","WBGene00173491","IV",16269065,16269085,20
"26126","WBGene00173495","IV",12309030,12309050,20
"26127","WBGene00173505","IV",16316059,16316079,20
"26128","WBGene00173506","IV",6153344,6153364,20
"26129","WBGene00173509","X",9539290,9539310,20
"26130","WBGene00173512","IV",16505726,16505746,20
"26131","WBGene00173516","I",5388900,5388920,20
"26132","WBGene00173517","IV",5819293,5819313,20
"26133","WBGene00173518","IV",5837476,5837496,20
"26134","WBGene00173521","IV",14229157,14229177,20
"26135","WBGene00173528","IV",14987994,14988014,20
"26136","WBGene00173533","IV",14362445,14362465,20
"26137","WBGene00173534","IV",7349585,7349605,20
"26138","WBGene00173535","IV",16151079,16151099,20
"26139","WBGene00173538","IV",14753875,14753895,20
"26140","WBGene00173542","X",10987953,10987973,20
"26141","WBGene00173545","IV",15809543,15809563,20
"26142","WBGene00173548","IV",15305280,15305300,20
"26143","WBGene00173557","V",9904624,9904644,20
"26144","WBGene00173560","IV",9617512,9617532,20
"26145","WBGene00173564","IV",14404382,14404402,20
"26146","WBGene00173566","IV",15092551,15092571,20
"26147","WBGene00173567","IV",15388707,15388727,20
"26148","WBGene00173568","X",307606,307626,20
"26149","WBGene00173574","IV",14663224,14663244,20
"26150","WBGene00173576","IV",14872002,14872022,20
"26151","WBGene00173577","IV",5808147,5808167,20
"26152","WBGene00173581","IV",16534907,16534927,20
"26153","WBGene00173589","IV",16256616,16256636,20
"26154","WBGene00173591","IV",7641682,7641702,20
"26155","WBGene00173594","IV",6520664,6520684,20
"26156","WBGene00173598","IV",5141916,5141936,20
"26157","WBGene00173603","IV",6395778,6395798,20
"26158","WBGene00173607","IV",9080280,9080300,20
"26159","WBGene00173609","IV",6386954,6386974,20
"26160","WBGene00173610","IV",13909453,13909473,20
"26161","WBGene00173612","IV",5442609,5442629,20
"26162","WBGene00173613","IV",6504585,6504605,20
"26163","WBGene00173614","IV",15863178,15863198,20
"26164","WBGene00173615","IV",14615378,14615398,20
"26165","WBGene00173617","IV",4953109,4953129,20
"26166","WBGene00173618","II",5936917,5936937,20
"26167","WBGene00173620","IV",5830869,5830889,20
"26168","WBGene00173623","IV",14036734,14036754,20
"26169","WBGene00173626","IV",6082509,6082529,20
"26170","WBGene00173628","IV",7733937,7733957,20
"26171","WBGene00173629","IV",14963328,14963348,20
"26172","WBGene00173631","IV",14858572,14858592,20
"26173","WBGene00173634","IV",14964795,14964815,20
"26174","WBGene00173635","II",747315,747335,20
"26175","WBGene00173636","IV",6054174,6054194,20
"26176","WBGene00173637","IV",11245849,11245869,20
"26177","WBGene00173638","IV",6091497,6091517,20
"26178","WBGene00173640","IV",12262096,12262116,20
"26179","WBGene00173643","IV",14473886,14473906,20
"26180","WBGene00173648","IV",11507507,11507527,20
"26181","WBGene00173652","IV",14884334,14884354,20
"26182","WBGene00173653","IV",5934058,5934078,20
"26183","WBGene00173657","IV",15935768,15935788,20
"26184","WBGene00173658","IV",15729623,15729643,20
"26185","WBGene00173659","IV",5598115,5598135,20
"26186","WBGene00173663","IV",14487558,14487578,20
"26187","WBGene00173665","IV",10269390,10269410,20
"26188","WBGene00173666","IV",5760483,5760503,20
"26189","WBGene00173668","IV",17024000,17024020,20
"26190","WBGene00173669","IV",15810387,15810407,20
"26191","WBGene00173675","IV",13724169,13724189,20
"26192","WBGene00173683","IV",5388077,5388097,20
"26193","WBGene00173687","IV",16044661,16044681,20
"26194","WBGene00173691","IV",17228975,17228995,20
"26195","WBGene00173694","IV",13917319,13917339,20
"26196","WBGene00173695","IV",13707666,13707686,20
"26197","WBGene00173700","IV",15854682,15854702,20
"26198","WBGene00173705","IV",15540300,15540320,20
"26199","WBGene00173712","IV",14295752,14295772,20
"26200","WBGene00173713","IV",14653686,14653706,20
"26201","WBGene00173715","IV",14962020,14962040,20
"26202","WBGene00173716","IV",5733216,5733236,20
"26203","WBGene00173720","IV",14808528,14808548,20
"26204","WBGene00173723","III",6028570,6028590,20
"26205","WBGene00173728","IV",6513080,6513100,20
"26206","WBGene00173729","IV",6839759,6839779,20
"26207","WBGene00173734","IV",5578280,5578300,20
"26208","WBGene00173744","IV",14090269,14090289,20
"26209","WBGene00173745","IV",6436623,6436643,20
"26210","WBGene00173746","IV",14361414,14361434,20
"26211","WBGene00173749","IV",16023240,16023260,20
"26212","WBGene00173751","IV",6140592,6140612,20
"26213","WBGene00173752","IV",5755665,5755685,20
"26214","WBGene00173755","IV",6491588,6491608,20
"26215","WBGene00173756","IV",5418148,5418168,20
"26216","WBGene00173758","IV",16467881,16467901,20
"26217","WBGene00173760","IV",14993662,14993682,20
"26218","WBGene00173761","IV",15822284,15822304,20
"26219","WBGene00173765","IV",15061499,15061519,20
"26220","WBGene00173766","IV",13938376,13938396,20
"26221","WBGene00173768","V",12850370,12850390,20
"26222","WBGene00173772","IV",16071208,16071228,20
"26223","WBGene00173774","IV",4831342,4831362,20
"26224","WBGene00173776","IV",6775420,6775440,20
"26225","WBGene00173777","IV",6852023,6852043,20
"26226","WBGene00173778","IV",16837525,16837545,20
"26227","WBGene00173779","IV",5629796,5629816,20
"26228","WBGene00173782","IV",14861213,14861233,20
"26229","WBGene00173788","IV",6989293,6989313,20
"26230","WBGene00173789","IV",16025031,16025051,20
"26231","WBGene00173790","I",14376095,14376115,20
"26232","WBGene00173805","IV",5595961,5595981,20
"26233","WBGene00173806","IV",6434593,6434613,20
"26234","WBGene00173809","X",9755032,9755052,20
"26235","WBGene00173813","IV",6065068,6065088,20
"26236","WBGene00173829","IV",13837723,13837743,20
"26237","WBGene00173830","IV",13710157,13710177,20
"26238","WBGene00173831","IV",8031141,8031161,20
"26239","WBGene00173833","IV",8253856,8253876,20
"26240","WBGene00173834","IV",16130754,16130774,20
"26241","WBGene00173836","IV",5755869,5755889,20
"26242","WBGene00173837","IV",15273249,15273269,20
"26243","WBGene00173840","II",7805925,7805945,20
"26244","WBGene00173843","IV",16137010,16137030,20
"26245","WBGene00173845","IV",5041647,5041667,20
"26246","WBGene00173848","V",3541154,3541174,20
"26247","WBGene00173852","IV",15655162,15655182,20
"26248","WBGene00173853","IV",11276754,11276774,20
"26249","WBGene00173854","IV",13943202,13943222,20
"26250","WBGene00173859","IV",14890893,14890913,20
"26251","WBGene00173862","X",8059683,8059703,20
"26252","WBGene00173867","IV",14267697,14267717,20
"26253","WBGene00173877","IV",16154887,16154907,20
"26254","WBGene00173886","IV",17131397,17131417,20
"26255","WBGene00173891","IV",5950711,5950731,20
"26256","WBGene00173897","IV",15811081,15811101,20
"26257","WBGene00173902","IV",15558595,15558615,20
"26258","WBGene00173905","IV",9065252,9065272,20
"26259","WBGene00173906","IV",15168165,15168185,20
"26260","WBGene00173914","IV",16732324,16732344,20
"26261","WBGene00173916","IV",16370984,16371004,20
"26262","WBGene00173918","IV",5117578,5117598,20
"26263","WBGene00173920","IV",5386925,5386945,20
"26264","WBGene00173922","IV",15831960,15831980,20
"26265","WBGene00173926","IV",5801443,5801463,20
"26266","WBGene00173931","IV",5336498,5336518,20
"26267","WBGene00173933","IV",5043129,5043149,20
"26268","WBGene00173939","IV",14899215,14899235,20
"26269","WBGene00173950","IV",6133309,6133329,20
"26270","WBGene00173952","IV",6189579,6189599,20
"26271","WBGene00173954","IV",14666543,14666563,20
"26272","WBGene00173955","IV",14715375,14715395,20
"26273","WBGene00173961","IV",14488655,14488675,20
"26274","WBGene00173963","IV",13818105,13818125,20
"26275","WBGene00173965","IV",16377447,16377467,20
"26276","WBGene00173967","IV",13711731,13711751,20
"26277","WBGene00173968","IV",15683006,15683026,20
"26278","WBGene00173980","IV",5765122,5765142,20
"26279","WBGene00173992","IV",14391609,14391629,20
"26280","WBGene00173995","V",9995541,9995561,20
"26281","WBGene00173997","IV",16049244,16049264,20
"26282","WBGene00174003","IV",6384238,6384258,20
"26283","WBGene00174004","IV",6434477,6434497,20
"26284","WBGene00174008","IV",9600489,9600509,20
"26285","WBGene00174009","IV",15928462,15928482,20
"26286","WBGene00174010","IV",4951495,4951515,20
"26287","WBGene00174011","IV",14566352,14566372,20
"26288","WBGene00174013","IV",16814304,16814324,20
"26289","WBGene00174015","IV",16021307,16021327,20
"26290","WBGene00174019","IV",16174746,16174766,20
"26291","WBGene00174022","IV",13664557,13664577,20
"26292","WBGene00174023","IV",7818618,7818638,20
"26293","WBGene00174025","IV",5342671,5342691,20
"26294","WBGene00174026","V",3448742,3448762,20
"26295","WBGene00174027","IV",16610736,16610756,20
"26296","WBGene00174031","IV",14410919,14410939,20
"26297","WBGene00174032","IV",5915065,5915085,20
"26298","WBGene00174046","IV",4845603,4845623,20
"26299","WBGene00174050","IV",15066160,15066180,20
"26300","WBGene00174052","IV",16754754,16754774,20
"26301","WBGene00174054","III",10249452,10249472,20
"26302","WBGene00174056","IV",14975007,14975027,20
"26303","WBGene00174058","IV",5630970,5630990,20
"26304","WBGene00174061","IV",16892481,16892501,20
"26305","WBGene00174062","IV",5734382,5734402,20
"26306","WBGene00174066","IV",5816238,5816258,20
"26307","WBGene00174067","IV",5986381,5986401,20
"26308","WBGene00174070","IV",13825675,13825695,20
"26309","WBGene00174076","IV",5526682,5526702,20
"26310","WBGene00174081","IV",14471024,14471044,20
"26311","WBGene00174082","IV",16435260,16435280,20
"26312","WBGene00174084","V",6800468,6800488,20
"26313","WBGene00174085","IV",13756286,13756306,20
"26314","WBGene00174088","V",1454942,1454962,20
"26315","WBGene00174089","IV",12167542,12167562,20
"26316","WBGene00174092","IV",17212879,17212899,20
"26317","WBGene00174098","IV",15246442,15246462,20
"26318","WBGene00174104","IV",13775223,13775243,20
"26319","WBGene00174106","IV",5193280,5193300,20
"26320","WBGene00174107","IV",15793724,15793744,20
"26321","WBGene00174111","V",11659395,11659415,20
"26322","WBGene00174116","IV",16708094,16708114,20
"26323","WBGene00174118","IV",13822761,13822781,20
"26324","WBGene00174119","IV",13896810,13896830,20
"26325","WBGene00174122","IV",16634255,16634275,20
"26326","WBGene00174126","IV",5512655,5512675,20
"26327","WBGene00174132","IV",15949513,15949533,20
"26328","WBGene00174133","IV",6065863,6065883,20
"26329","WBGene00174135","IV",6136578,6136598,20
"26330","WBGene00174139","IV",5602145,5602165,20
"26331","WBGene00174140","III",6834880,6834900,20
"26332","WBGene00174141","IV",15960920,15960940,20
"26333","WBGene00174144","IV",14086359,14086379,20
"26334","WBGene00174145","IV",5044741,5044761,20
"26335","WBGene00174148","IV",17246275,17246295,20
"26336","WBGene00174151","IV",15689918,15689938,20
"26337","WBGene00174154","V",2020808,2020828,20
"26338","WBGene00174157","IV",13907773,13907793,20
"26339","WBGene00174160","IV",7384434,7384454,20
"26340","WBGene00174161","I",3745502,3745522,20
"26341","WBGene00174163","IV",15705022,15705042,20
"26342","WBGene00174164","IV",16066901,16066921,20
"26343","WBGene00174166","IV",17204392,17204412,20
"26344","WBGene00174168","IV",5717448,5717468,20
"26345","WBGene00174170","IV",16038633,16038653,20
"26346","WBGene00174172","IV",5503945,5503965,20
"26347","WBGene00174182","IV",17181217,17181237,20
"26348","WBGene00174183","IV",17489551,17489571,20
"26349","WBGene00174184","IV",10009452,10009472,20
"26350","WBGene00174187","IV",15574141,15574161,20
"26351","WBGene00174188","IV",15585907,15585927,20
"26352","WBGene00174190","IV",5818717,5818737,20
"26353","WBGene00174192","IV",16069668,16069688,20
"26354","WBGene00174200","IV",13649476,13649496,20
"26355","WBGene00174201","IV",17199280,17199300,20
"26356","WBGene00174202","IV",15217559,15217579,20
"26357","WBGene00174208","IV",5976751,5976771,20
"26358","WBGene00174210","IV",15679546,15679566,20
"26359","WBGene00174211","X",8297981,8298001,20
"26360","WBGene00174212","IV",17058383,17058403,20
"26361","WBGene00174216","IV",16566345,16566365,20
"26362","WBGene00174217","IV",14739154,14739174,20
"26363","WBGene00174221","IV",7534697,7534717,20
"26364","WBGene00174223","IV",6655423,6655443,20
"26365","WBGene00174226","IV",15401288,15401308,20
"26366","WBGene00174230","IV",16473593,16473613,20
"26367","WBGene00174231","IV",5604120,5604140,20
"26368","WBGene00174236","IV",14407921,14407941,20
"26369","WBGene00174237","IV",6076317,6076337,20
"26370","WBGene00174242","IV",5564649,5564669,20
"26371","WBGene00174244","IV",15372497,15372517,20
"26372","WBGene00174250","IV",14801731,14801751,20
"26373","WBGene00174260","IV",15713593,15713613,20
"26374","WBGene00174261","IV",16479442,16479462,20
"26375","WBGene00174265","IV",6754134,6754154,20
"26376","WBGene00174266","IV",5282862,5282882,20
"26377","WBGene00174270","IV",14055977,14055997,20
"26378","WBGene00174278","IV",15679349,15679369,20
"26379","WBGene00174281","IV",14628770,14628790,20
"26380","WBGene00174283","IV",14471600,14471620,20
"26381","WBGene00174285","IV",15280898,15280918,20
"26382","WBGene00174286","IV",15723867,15723887,20
"26383","WBGene00174293","IV",5762684,5762704,20
"26384","WBGene00174297","IV",16037641,16037661,20
"26385","WBGene00174300","IV",17026522,17026542,20
"26386","WBGene00174303","IV",14601008,14601028,20
"26387","WBGene00174309","IV",10786991,10787011,20
"26388","WBGene00174311","I",10374152,10374172,20
"26389","WBGene00174312","IV",16612701,16612721,20
"26390","WBGene00174314","IV",5046629,5046649,20
"26391","WBGene00174315","IV",4894235,4894255,20
"26392","WBGene00174316","IV",5500828,5500848,20
"26393","WBGene00174317","IV",14263275,14263295,20
"26394","WBGene00174318","IV",5420567,5420587,20
"26395","WBGene00174319","IV",15929856,15929876,20
"26396","WBGene00174322","X",5996101,5996121,20
"26397","WBGene00174324","IV",16046294,16046314,20
"26398","WBGene00174328","IV",15584105,15584125,20
"26399","WBGene00174329","IV",16784604,16784624,20
"26400","WBGene00174332","III",6094213,6094233,20
"26401","WBGene00174335","IV",13641029,13641049,20
"26402","WBGene00174337","IV",5154153,5154173,20
"26403","WBGene00174339","IV",13797757,13797777,20
"26404","WBGene00174344","IV",5595249,5595269,20
"26405","WBGene00174345","IV",4846672,4846692,20
"26406","WBGene00174346","IV",13564902,13564922,20
"26407","WBGene00174349","IV",14278771,14278791,20
"26408","WBGene00174352","IV",5971771,5971791,20
"26409","WBGene00174353","IV",4934125,4934145,20
"26410","WBGene00174354","IV",15681127,15681147,20
"26411","WBGene00174355","IV",14361799,14361819,20
"26412","WBGene00174356","IV",14672607,14672627,20
"26413","WBGene00174363","IV",15181502,15181522,20
"26414","WBGene00174367","II",6873159,6873179,20
"26415","WBGene00174375","IV",5321636,5321656,20
"26416","WBGene00174376","IV",4952373,4952393,20
"26417","WBGene00174377","IV",17237523,17237543,20
"26418","WBGene00174380","IV",17225549,17225569,20
"26419","WBGene00174381","IV",5590031,5590051,20
"26420","WBGene00174382","IV",6115118,6115138,20
"26421","WBGene00174384","IV",2613381,2613401,20
"26422","WBGene00174392","IV",14888219,14888239,20
"26423","WBGene00174401","IV",5135845,5135865,20
"26424","WBGene00174402","IV",14889855,14889875,20
"26425","WBGene00174405","IV",6052507,6052527,20
"26426","WBGene00174406","IV",6014349,6014369,20
"26427","WBGene00174407","IV",6507835,6507855,20
"26428","WBGene00174408","IV",13897668,13897688,20
"26429","WBGene00174409","IV",5956555,5956575,20
"26430","WBGene00174410","II",5308103,5308123,20
"26431","WBGene00174416","IV",16223219,16223239,20
"26432","WBGene00174417","IV",15067700,15067720,20
"26433","WBGene00174423","IV",5347800,5347820,20
"26434","WBGene00174429","IV",5109905,5109925,20
"26435","WBGene00174432","IV",5824325,5824345,20
"26436","WBGene00174433","IV",5602231,5602251,20
"26437","WBGene00174436","IV",14899102,14899122,20
"26438","WBGene00174440","IV",14373247,14373267,20
"26439","WBGene00174441","IV",14443762,14443782,20
"26440","WBGene00174443","IV",14945784,14945804,20
"26441","WBGene00174445","IV",16005213,16005233,20
"26442","WBGene00174447","IV",14607697,14607717,20
"26443","WBGene00174448","III",5144973,5144993,20
"26444","WBGene00174449","IV",15896849,15896869,20
"26445","WBGene00174452","IV",14450432,14450452,20
"26446","WBGene00174453","IV",14393494,14393514,20
"26447","WBGene00174456","IV",13640133,13640153,20
"26448","WBGene00174465","IV",8698015,8698035,20
"26449","WBGene00174467","IV",5503427,5503447,20
"26450","WBGene00174471","IV",13957041,13957061,20
"26451","WBGene00174472","II",11387717,11387737,20
"26452","WBGene00174477","IV",14378879,14378899,20
"26453","WBGene00174478","X",3048050,3048070,20
"26454","WBGene00174479","IV",13865123,13865143,20
"26455","WBGene00174483","IV",13770090,13770110,20
"26456","WBGene00174484","IV",14617064,14617084,20
"26457","WBGene00174486","IV",15355316,15355336,20
"26458","WBGene00174488","V",11053280,11053300,20
"26459","WBGene00174489","IV",14472847,14472867,20
"26460","WBGene00174493","IV",15966593,15966613,20
"26461","WBGene00174494","IV",5932923,5932943,20
"26462","WBGene00174496","IV",5078481,5078501,20
"26463","WBGene00174497","V",14402073,14402093,20
"26464","WBGene00174499","IV",15360780,15360800,20
"26465","WBGene00174502","IV",17267446,17267466,20
"26466","WBGene00174504","IV",16174065,16174085,20
"26467","WBGene00174516","IV",16443529,16443549,20
"26468","WBGene00174517","IV",14092654,14092674,20
"26469","WBGene00174518","IV",15270717,15270737,20
"26470","WBGene00174523","IV",13859618,13859638,20
"26471","WBGene00174526","IV",5527905,5527925,20
"26472","WBGene00174528","IV",6124711,6124731,20
"26473","WBGene00174533","IV",17200219,17200239,20
"26474","WBGene00174537","IV",4982036,4982056,20
"26475","WBGene00174538","IV",13949357,13949377,20
"26476","WBGene00174539","IV",14481619,14481639,20
"26477","WBGene00174541","IV",5137410,5137430,20
"26478","WBGene00174544","IV",6994559,6994579,20
"26479","WBGene00174545","IV",15779254,15779274,20
"26480","WBGene00174547","IV",14414511,14414531,20
"26481","WBGene00174551","IV",16473712,16473732,20
"26482","WBGene00174554","IV",5135632,5135652,20
"26483","WBGene00174557","IV",5791118,5791138,20
"26484","WBGene00174560","IV",4915613,4915633,20
"26485","WBGene00174565","IV",14392799,14392819,20
"26486","WBGene00174569","IV",14092823,14092843,20
"26487","WBGene00174570","IV",15274819,15274839,20
"26488","WBGene00174573","IV",17059709,17059729,20
"26489","WBGene00174574","IV",14804621,14804641,20
"26490","WBGene00174576","IV",17187574,17187594,20
"26491","WBGene00174577","IV",16029045,16029065,20
"26492","WBGene00174583","IV",5613104,5613124,20
"26493","WBGene00174585","IV",5599732,5599752,20
"26494","WBGene00174590","IV",14485806,14485826,20
"26495","WBGene00174591","IV",15953461,15953481,20
"26496","WBGene00174595","IV",14368603,14368623,20
"26497","WBGene00174599","IV",16084313,16084333,20
"26498","WBGene00174606","IV",5213330,5213350,20
"26499","WBGene00174607","IV",5929387,5929407,20
"26500","WBGene00174610","IV",16834064,16834084,20
"26501","WBGene00174612","IV",5036542,5036562,20
"26502","WBGene00174619","IV",14663599,14663619,20
"26503","WBGene00174620","IV",5098458,5098478,20
"26504","WBGene00174621","IV",16783361,16783381,20
"26505","WBGene00174625","IV",5907088,5907108,20
"26506","WBGene00174626","IV",16444498,16444518,20
"26507","WBGene00174627","IV",5332712,5332732,20
"26508","WBGene00174628","IV",15897362,15897382,20
"26509","WBGene00174630","IV",16912684,16912704,20
"26510","WBGene00174631","IV",15349079,15349099,20
"26511","WBGene00174633","IV",6629980,6630000,20
"26512","WBGene00174634","IV",6142883,6142903,20
"26513","WBGene00174635","IV",14456462,14456482,20
"26514","WBGene00174636","IV",5131585,5131605,20
"26515","WBGene00174638","IV",14143932,14143952,20
"26516","WBGene00174646","X",17322449,17322469,20
"26517","WBGene00174647","IV",14587895,14587915,20
"26518","WBGene00174648","IV",5434894,5434914,20
"26519","WBGene00174653","IV",13826854,13826874,20
"26520","WBGene00174661","IV",14278962,14278982,20
"26521","WBGene00174662","IV",16205353,16205373,20
"26522","WBGene00174663","IV",16025780,16025800,20
"26523","WBGene00174671","II",6923664,6923684,20
"26524","WBGene00174673","IV",15792200,15792220,20
"26525","WBGene00174678","IV",17037186,17037206,20
"26526","WBGene00174687","V",2292477,2292497,20
"26527","WBGene00174690","IV",5619352,5619372,20
"26528","WBGene00174692","IV",6834621,6834641,20
"26529","WBGene00174694","IV",16181494,16181514,20
"26530","WBGene00174696","IV",11275628,11275648,20
"26531","WBGene00174703","IV",14847804,14847824,20
"26532","WBGene00174707","V",11500653,11500673,20
"26533","WBGene00174712","IV",17262885,17262905,20
"26534","WBGene00174714","IV",15845986,15846006,20
"26535","WBGene00174715","IV",16165763,16165783,20
"26536","WBGene00174721","IV",5641093,5641113,20
"26537","WBGene00174722","IV",14749140,14749160,20
"26538","WBGene00174723","IV",5599146,5599166,20
"26539","WBGene00174726","IV",5670241,5670261,20
"26540","WBGene00174733","IV",16030591,16030611,20
"26541","WBGene00174735","IV",15981455,15981475,20
"26542","WBGene00174736","IV",16795856,16795876,20
"26543","WBGene00174737","IV",6479713,6479733,20
"26544","WBGene00174739","IV",14263562,14263582,20
"26545","WBGene00174741","I",5540544,5540564,20
"26546","WBGene00174744","IV",17413851,17413871,20
"26547","WBGene00174745","IV",16019524,16019544,20
"26548","WBGene00174749","IV",6177228,6177248,20
"26549","WBGene00174751","IV",17363657,17363677,20
"26550","WBGene00174752","IV",16749201,16749221,20
"26551","WBGene00174753","II",10067146,10067166,20
"26552","WBGene00174755","IV",15786674,15786694,20
"26553","WBGene00174756","IV",14563443,14563463,20
"26554","WBGene00174757","X",15294005,15294025,20
"26555","WBGene00174760","I",1093137,1093157,20
"26556","WBGene00174761","IV",14898620,14898640,20
"26557","WBGene00174763","IV",7854952,7854972,20
"26558","WBGene00174764","IV",11276796,11276816,20
"26559","WBGene00174766","IV",13746710,13746730,20
"26560","WBGene00174769","IV",5819079,5819099,20
"26561","WBGene00174770","I",5486067,5486087,20
"26562","WBGene00174774","IV",14865532,14865552,20
"26563","WBGene00174780","IV",15247417,15247437,20
"26564","WBGene00174781","IV",14810942,14810962,20
"26565","WBGene00174787","V",4989323,4989343,20
"26566","WBGene00174793","IV",6954076,6954096,20
"26567","WBGene00174795","IV",6065663,6065683,20
"26568","WBGene00174797","IV",5140427,5140447,20
"26569","WBGene00174798","IV",16821434,16821454,20
"26570","WBGene00174803","IV",6777677,6777697,20
"26571","WBGene00174806","IV",16445271,16445291,20
"26572","WBGene00174808","IV",5199092,5199112,20
"26573","WBGene00174811","IV",16480201,16480221,20
"26574","WBGene00174812","IV",7172973,7172993,20
"26575","WBGene00174813","IV",4875304,4875324,20
"26576","WBGene00174814","IV",14756848,14756868,20
"26577","WBGene00174817","IV",6244515,6244535,20
"26578","WBGene00174818","IV",6509544,6509564,20
"26579","WBGene00174821","IV",5927405,5927425,20
"26580","WBGene00174823","X",9903288,9903308,20
"26581","WBGene00174824","IV",14456350,14456370,20
"26582","WBGene00174826","IV",17184800,17184820,20
"26583","WBGene00174832","IV",15283046,15283066,20
"26584","WBGene00174833","IV",5172796,5172816,20
"26585","WBGene00174837","IV",11459543,11459563,20
"26586","WBGene00174840","IV",14037847,14037867,20
"26587","WBGene00174841","IV",17068007,17068027,20
"26588","WBGene00174843","IV",5596945,5596965,20
"26589","WBGene00174847","IV",5101495,5101515,20
"26590","WBGene00174850","IV",14351305,14351325,20
"26591","WBGene00174851","IV",8121755,8121775,20
"26592","WBGene00174852","II",4117525,4117545,20
"26593","WBGene00174854","IV",14299364,14299384,20
"26594","WBGene00174863","IV",5505141,5505161,20
"26595","WBGene00174865","IV",5121621,5121641,20
"26596","WBGene00174866","IV",15285337,15285357,20
"26597","WBGene00174868","IV",15919921,15919941,20
"26598","WBGene00174872","IV",13879641,13879661,20
"26599","WBGene00174873","IV",15531099,15531119,20
"26600","WBGene00174878","IV",16185477,16185497,20
"26601","WBGene00174884","IV",7049407,7049427,20
"26602","WBGene00174886","III",8899774,8899794,20
"26603","WBGene00174889","IV",16040189,16040209,20
"26604","WBGene00174891","IV",5338053,5338073,20
"26605","WBGene00174895","V",12519218,12519238,20
"26606","WBGene00174896","IV",14457181,14457201,20
"26607","WBGene00174900","IV",15649014,15649034,20
"26608","WBGene00174901","IV",16836065,16836085,20
"26609","WBGene00174902","IV",15565581,15565601,20
"26610","WBGene00174903","IV",13362168,13362188,20
"26611","WBGene00174904","IV",4965539,4965559,20
"26612","WBGene00174909","X",15266410,15266430,20
"26613","WBGene00174912","IV",14105353,14105373,20
"26614","WBGene00174913","IV",5174472,5174492,20
"26615","WBGene00174916","IV",13950754,13950774,20
"26616","WBGene00174919","IV",16509184,16509204,20
"26617","WBGene00174922","IV",14457803,14457823,20
"26618","WBGene00174923","IV",17228084,17228104,20
"26619","WBGene00174925","IV",12423676,12423696,20
"26620","WBGene00174926","IV",15787469,15787489,20
"26621","WBGene00174933","IV",5128686,5128706,20
"26622","WBGene00174936","IV",11622285,11622305,20
"26623","WBGene00174938","IV",6992504,6992524,20
"26624","WBGene00174944","IV",5964031,5964051,20
"26625","WBGene00174946","IV",6027993,6028013,20
"26626","WBGene00174951","IV",5607070,5607090,20
"26627","WBGene00174954","IV",7050710,7050730,20
"26628","WBGene00174955","IV",5955068,5955088,20
"26629","WBGene00174957","IV",13707669,13707689,20
"26630","WBGene00174960","IV",15264630,15264650,20
"26631","WBGene00174961","V",3074755,3074775,20
"26632","WBGene00174963","IV",5041554,5041574,20
"26633","WBGene00174964","IV",15544287,15544307,20
"26634","WBGene00174971","IV",10510525,10510545,20
"26635","WBGene00174972","IV",9753982,9754002,20
"26636","WBGene00174976","IV",5714752,5714772,20
"26637","WBGene00174977","IV",6279795,6279815,20
"26638","WBGene00174978","IV",6449767,6449787,20
"26639","WBGene00174981","IV",13762583,13762603,20
"26640","WBGene00174982","IV",5971986,5972006,20
"26641","WBGene00174988","IV",8697063,8697083,20
"26642","WBGene00174991","IV",5616989,5617009,20
"26643","WBGene00174992","IV",5584086,5584106,20
"26644","WBGene00174998","IV",5606952,5606972,20
"26645","WBGene00174999","IV",15900982,15901002,20
"26646","WBGene00175000","IV",15414052,15414072,20
"26647","WBGene00175001","IV",16015319,16015339,20
"26648","WBGene00175005","IV",14269175,14269195,20
"26649","WBGene00175006","X",17438218,17438238,20
"26650","WBGene00175007","IV",16387844,16387864,20
"26651","WBGene00175012","IV",16668206,16668226,20
"26652","WBGene00175016","IV",6165904,6165924,20
"26653","WBGene00175017","IV",16016611,16016631,20
"26654","WBGene00175018","IV",15689650,15689670,20
"26655","WBGene00175021","IV",5495644,5495664,20
"26656","WBGene00175025","II",8419948,8420156,208
"26657","WBGene00175027","V",6692247,6694768,2521
"26658","WBGene00175028","II",12621088,12621958,870
"26659","WBGene00175029","X",2243115,2244467,1352
"26660","WBGene00175030","II",9703812,9704789,977
"26661","WBGene00175031","II",9375107,9375848,741
"26662","WBGene00175034","II",10270387,10271193,806
"26663","WBGene00175035","II",8562302,8563759,1457
"26664","WBGene00175036","I",13971283,13971419,136
"26665","WBGene00184956","II",12557808,12560264,2456
"26666","WBGene00184990","III",3724222,3724980,758
"26667","WBGene00185001","III",13254675,13256456,1781
"26668","WBGene00185002","III",9835192,9838311,3119
"26669","WBGene00185005","III",13377830,13378342,512
"26670","WBGene00185006","III",9002054,9002636,582
"26671","WBGene00185014","III",4734356,4736065,1709
"26672","WBGene00185048","III",10505480,10505899,419
"26673","WBGene00185055","III",11403017,11404197,1180
"26674","WBGene00185067","II",14348886,14349406,520
"26675","WBGene00185076","IV",16190569,16192891,2322
"26676","WBGene00185077","IV",13188293,13189051,758
"26677","WBGene00185078","III",194460,210063,15603
"26678","WBGene00185079","II",456113,457886,1773
"26679","WBGene00185086","I",5514651,5516025,1374
"26680","WBGene00185088","IV",805102,806236,1134
"26681","WBGene00185089","II",4231385,4234620,3235
"26682","WBGene00185092","IV",12896698,12898448,1750
"26683","WBGene00185093","IV",12901680,12902171,491
"26684","WBGene00185095","IV",9621994,9622372,378
"26685","WBGene00185096","IV",9622925,9623365,440
"26686","WBGene00185097","IV",17316155,17316510,355
"26687","WBGene00185098","I",1672821,1676434,3613
"26688","WBGene00185100","IV",11755274,11755970,696
"26689","WBGene00185101","IV",16393968,16394646,678
"26690","WBGene00185102","IV",15646031,15646433,402
"26691","WBGene00185116","IV",9624035,9624392,357
"26692","WBGene00185117","V",11040320,11040666,346
"26693","WBGene00185118","V",20383359,20384396,1037
"26694","WBGene00185119","V",18211124,18212725,1601
"26695","WBGene00189930","V",17700436,17700824,388
"26696","WBGene00189931","V",17699959,17700310,351
"26697","WBGene00189932","V",17696190,17696848,658
"26698","WBGene00189933","V",11547095,11548156,1061
"26699","WBGene00189937","V",17610036,17610609,573
"26700","WBGene00189943","V",19820590,19822193,1603
"26701","WBGene00189944","III",4049498,4051271,1773
"26702","WBGene00189946","V",19742492,19742874,382
"26703","WBGene00189947","V",13931525,13932198,673
"26704","WBGene00189948","V",12644800,12646632,1832
"26705","WBGene00189949","I",94828,95367,539
"26706","WBGene00189950","III",2211420,2217095,5675
"26707","WBGene00189951","IV",6354024,6357243,3219
"26708","WBGene00189952","III",5188726,5190175,1449
"26709","WBGene00189953","III",1970071,1970533,462
"26710","WBGene00189954","III",167385,169556,2171
"26711","WBGene00189955","III",173797,174558,761
"26712","WBGene00189956","III",1008436,1009913,1477
"26713","WBGene00189957","V",5937096,5939188,2092
"26714","WBGene00189958","I",10380095,10380767,672
"26715","WBGene00189961","IV",2969940,2973394,3454
"26716","WBGene00189964","II",8242110,8242204,94
"26717","WBGene00189966","V",17428879,17428996,117
"26718","WBGene00189967","II",12728756,12728826,70
"26719","WBGene00189968","IV",9682879,9682982,103
"26720","WBGene00189969","X",15237169,15237228,59
"26721","WBGene00189970","X",15242774,15242849,75
"26722","WBGene00189973","V",15289873,15289967,94
"26723","WBGene00189978","V",20472742,20472760,18
"26724","WBGene00189979","I",13852867,13852884,17
"26725","WBGene00189980","X",13397038,13397054,16
"26726","WBGene00189981","V",19908448,19908468,20
"26727","WBGene00189986","IV",8999806,8999922,116
"26728","WBGene00189987","IV",583813,587829,4016
"26729","WBGene00189993","IV",17343051,17343493,442
"26730","WBGene00189995","IV",5865986,5867299,1313
"26731","WBGene00194641","X",2381581,2382335,754
"26732","WBGene00194642","II",5669028,5669680,652
"26733","WBGene00194643","IV",13207468,13209666,2198
"26734","WBGene00194644","IV",12555311,12556482,1171
"26735","WBGene00194645","IV",15847396,15848086,690
"26736","WBGene00194646","IV",15845998,15846665,667
"26737","WBGene00194647","IV",16506581,16507232,651
"26738","WBGene00194649","IV",14782644,14783342,698
"26739","WBGene00194650","III",3830279,3832240,1961
"26740","WBGene00194651","IV",8783271,8785254,1983
"26741","WBGene00194652","I",12155124,12156391,1267
"26742","WBGene00194653","I",9250659,9251828,1169
"26743","WBGene00194654","I",7175539,7176434,895
"26744","WBGene00194656","I",9644416,9644728,312
"26745","WBGene00194657","I",12601898,12602957,1059
"26746","WBGene00194658","IV",10294811,10295267,456
"26747","WBGene00194659","I",13652524,13652727,203
"26748","WBGene00194660","I",13661522,13662332,810
"26749","WBGene00194661","IV",14932972,14933624,652
"26750","WBGene00194663","X",11280619,11281248,629
"26751","WBGene00194664","X",15640903,15642853,1950
"26752","WBGene00194665","IV",11918201,11920775,2574
"26753","WBGene00194666","IV",14699387,14699942,555
"26754","WBGene00194667","IV",15649825,15650906,1081
"26755","WBGene00194669","IV",9674271,9675699,1428
"26756","WBGene00194670","X",8108094,8109210,1116
"26757","WBGene00194672","IV",16919725,16919886,161
"26758","WBGene00194674","X",14423871,14424751,880
"26759","WBGene00194675","X",14375868,14376499,631
"26760","WBGene00194676","V",19487318,19487781,463
"26761","WBGene00194677","V",10795800,10796828,1028
"26762","WBGene00194678","V",13966218,13966742,524
"26763","WBGene00194679","X",1852845,1853802,957
"26764","WBGene00194680","V",18709810,18711696,1886
"26765","WBGene00194681","V",17158684,17159351,667
"26766","WBGene00194682","V",17154643,17155430,787
"26767","WBGene00194683","III",10195907,10197080,1173
"26768","WBGene00194684","III",11031609,11032963,1354
"26769","WBGene00194686","V",14349384,14349699,315
"26770","WBGene00194687","X",553340,555529,2189
"26771","WBGene00194689","V",20526453,20526737,284
"26772","WBGene00194690","III",13570854,13572525,1671
"26773","WBGene00194691","III",9545120,9545897,777
"26774","WBGene00194692","III",4026568,4028161,1593
"26775","WBGene00194695","V",18322336,18323327,991
"26776","WBGene00194696","II",5412196,5412610,414
"26777","WBGene00194697","I",5516102,5517380,1278
"26778","WBGene00194698","I",10919377,10919777,400
"26779","WBGene00194699","V",19482835,19482984,149
"26780","WBGene00194700","I",6024150,6025014,864
"26781","WBGene00194701","I",2556252,2557425,1173
"26782","WBGene00194702","I",3773928,3774500,572
"26783","WBGene00194703","I",6329536,6330181,645
"26784","WBGene00194704","II",1586605,1587329,724
"26785","WBGene00194706","V",14521205,14522614,1409
"26786","WBGene00194707","V",14519371,14521100,1729
"26787","WBGene00194708","V",15426166,15426970,804
"26788","WBGene00194710","II",6218687,6219511,824
"26789","WBGene00194711","II",2612612,2614060,1448
"26790","WBGene00194712","V",11492756,11493413,657
"26791","WBGene00194713","II",3662204,3662618,414
"26792","WBGene00194714","II",1645410,1646299,889
"26793","WBGene00194715","V",16733290,16733706,416
"26794","WBGene00194716","III",8898325,8898465,140
"26795","WBGene00194717","II",3219687,3220774,1087
"26796","WBGene00194725","III",10085403,10086064,661
"26797","WBGene00194726","III",7586790,7588212,1422
"26798","WBGene00194727","III",11807784,11808464,680
"26799","WBGene00194729","III",7656719,7657171,452
"26800","WBGene00194730","III",7922538,7922983,445
"26801","WBGene00194731","III",10638971,10639701,730
"26802","WBGene00194733","III",11732442,11732773,331
"26803","WBGene00194734","III",7608570,7609268,698
"26804","WBGene00194735","III",1332016,1333708,1692
"26805","WBGene00194737","III",289464,294627,5163
"26806","WBGene00194738","III",1757834,1758251,417
"26807","WBGene00194742","III",7188357,7188971,614
"26808","WBGene00194744","V",20519227,20520062,835
"26809","WBGene00194746","III",1386993,1388497,1504
"26810","WBGene00194747","III",2944084,2946230,2146
"26811","WBGene00194748","III",4458110,4458306,196
"26812","WBGene00194759","V",20142595,20142859,264
"26813","WBGene00194768","V",14741575,14745363,3788
"26814","WBGene00194769","V",16603529,16610952,7423
"26815","WBGene00194771","V",13274942,13275273,331
"26816","WBGene00194780","V",10222307,10223521,1214
"26817","WBGene00194783","V",11390516,11390925,409
"26818","WBGene00194784","V",11479706,11479951,245
"26819","WBGene00194785","V",11996180,11996556,376
"26820","WBGene00194786","V",12800734,12803033,2299
"26821","WBGene00194787","V",12949907,12950246,339
"26822","WBGene00194788","V",14482287,14482836,549
"26823","WBGene00194793","X",11079299,11079772,473
"26824","WBGene00194794","X",14966154,14967778,1624
"26825","WBGene00194795","X",12348718,12349119,401
"26826","WBGene00194799","V",16617762,16618080,318
"26827","WBGene00194800","X",10474214,10474902,688
"26828","WBGene00194801","V",17606350,17606922,572
"26829","WBGene00194803","V",19434387,19434753,366
"26830","WBGene00194804","II",11600300,11600383,83
"26831","WBGene00194805","IV",10914618,10914678,60
"26832","WBGene00194806","I",9447362,9447421,59
"26833","WBGene00194807","II",13333763,13333827,64
"26834","WBGene00194808","II",10867116,10867172,56
"26835","WBGene00194809","I",13812596,13812655,59
"26836","WBGene00194810","I",13834876,13834941,65
"26837","WBGene00194811","X",12758360,12758649,289
"26838","WBGene00194812","V",20179916,20180761,845
"26839","WBGene00194814","X",13400747,13401468,721
"26840","WBGene00194815","V",19465854,19467648,1794
"26841","WBGene00194816","IV",5405645,5407375,1730
"26842","WBGene00194821","V",6807762,6809062,1300
"26843","WBGene00194822","IV",1021772,1021832,60
"26844","WBGene00194823","IV",1026580,1026640,60
"26845","WBGene00194825","IV",1021303,1021365,62
"26846","WBGene00194826","IV",1027218,1027281,63
"26847","WBGene00194827","III",6968870,6968924,54
"26848","WBGene00194828","III",7278715,7278778,63
"26849","WBGene00194830","V",2924580,2924655,75
"26850","WBGene00194831","X",1873827,1873884,57
"26851","WBGene00194832","IV",6365345,6368903,3558
"26852","WBGene00194833","IV",8346799,8347728,929
"26853","WBGene00194834","IV",4816946,4817263,317
"26854","WBGene00194835","IV",4756605,4756942,337
"26855","WBGene00194836","II",5689431,5690000,569
"26856","WBGene00194839","IV",6623690,6624493,803
"26857","WBGene00194842","X",16265943,16271827,5884
"26858","WBGene00194843","IV",3450891,3452027,1136
"26859","WBGene00194844","IV",753731,755668,1937
"26860","WBGene00194847","X",9997664,9998040,376
"26861","WBGene00194848","II",11835634,11837523,1889
"26862","WBGene00194849","X",15596215,15596689,474
"26863","WBGene00194850","II",10914666,10915252,586
"26864","WBGene00194851","II",11166676,11167704,1028
"26865","WBGene00194852","III",13502813,13503578,765
"26866","WBGene00194853","III",12694186,12695743,1557
"26867","WBGene00194854","III",12693503,12693859,356
"26868","WBGene00194855","III",12194490,12196993,2503
"26869","WBGene00194861","III",10438078,10438898,820
"26870","WBGene00194864","III",11611242,11612471,1229
"26871","WBGene00194865","III",13357251,13358172,921
"26872","WBGene00194866","III",11695342,11696446,1104
"26873","WBGene00194867","IV",9624713,9625074,361
"26874","WBGene00194868","III",10388632,10391728,3096
"26875","WBGene00194869","IV",11737031,11737369,338
"26876","WBGene00194870","III",13319265,13321892,2627
"26877","WBGene00194871","III",9037958,9038566,608
"26878","WBGene00194883","IV",7433544,7433958,414
"26879","WBGene00194884","II",14214428,14216765,2337
"26880","WBGene00194885","IV",14934497,14935013,516
"26881","WBGene00194886","III",9987367,9987728,361
"26882","WBGene00194888","II",14510227,14511289,1062
"26883","WBGene00194891","II",11820584,11821144,560
"26884","WBGene00194892","II",14411095,14412218,1123
"26885","WBGene00194894","V",4108662,4109973,1311
"26886","WBGene00194895","V",7707142,7708625,1483
"26887","WBGene00194896","V",2631754,2638476,6722
"26888","WBGene00194898","V",3320343,3320532,189
"26889","WBGene00194902","V",3670841,3672012,1171
"26890","WBGene00194905","II",15013395,15014442,1047
"26891","WBGene00194906","II",9717669,9718698,1029
"26892","WBGene00194907","X",14262802,14263573,771
"26893","WBGene00194908","V",2120856,2121959,1103
"26894","WBGene00194909","V",8624101,8626854,2753
"26895","WBGene00194910","V",6780637,6783128,2491
"26896","WBGene00194912","V",10184689,10186007,1318
"26897","WBGene00194913","IV",15646992,15647312,320
"26898","WBGene00194914","IV",10029667,10029772,105
"26899","WBGene00194915","IV",13259172,13261576,2404
"26900","WBGene00194916","II",7577723,7580244,2521
"26901","WBGene00194917","IV",13602674,13603264,590
"26902","WBGene00194918","IV",12899708,12900013,305
"26903","WBGene00194919","IV",12900567,12900897,330
"26904","WBGene00194920","IV",14127477,14127855,378
"26905","WBGene00194921","V",7798079,7800602,2523
"26906","WBGene00194922","IV",10899406,10899540,134
"26907","WBGene00194923","IV",14934821,14937128,2307
"26908","WBGene00194924","IV",16629366,16629636,270
"26909","WBGene00194925","IV",12895294,12896203,909
"26910","WBGene00194926","IV",12893773,12894724,951
"26911","WBGene00194927","IV",16528684,16528870,186
"26912","WBGene00194928","V",8035259,8036060,801
"26913","WBGene00194929","IV",16184157,16184621,464
"26914","WBGene00194930","IV",15390902,15391027,125
"26915","WBGene00194931","IV",15791146,15791343,197
"26916","WBGene00194932","X",11846439,11847160,721
"26917","WBGene00194933","IV",11754843,11755103,260
"26918","WBGene00194934","IV",11665310,11667989,2679
"26919","WBGene00194935","II",10317297,10317631,334
"26920","WBGene00194939","II",13781328,13781966,638
"26921","WBGene00194940","II",8685923,8686579,656
"26922","WBGene00194945","IV",12927683,12928125,442
"26923","WBGene00194951","IV",15634739,15634927,188
"26924","WBGene00194952","II",10494807,10495671,864
"26925","WBGene00194955","II",11176285,11176748,463
"26926","WBGene00194957","IV",17065382,17065761,379
"26927","WBGene00194981","III",12386897,12387721,824
"26928","WBGene00194982","V",18783800,18784954,1154
"26929","WBGene00194983","X",6178244,6178547,303
"26930","WBGene00194984","IV",10689640,10690309,669
"26931","WBGene00194985","II",3096228,3096957,729
"26932","WBGene00194986","II",4991587,4993077,1490
"26933","WBGene00194987","II",6716169,6716354,185
"26934","WBGene00194989","V",3959420,3959524,104
"26935","WBGene00194993","V",9086858,9087021,163
"26936","WBGene00194997","IV",7316732,7316853,121
"26937","WBGene00194998","II",1860646,1861335,689
"26938","WBGene00194999","I",10724479,10724586,107
"26939","WBGene00195000","III",5080798,5080898,100
"26940","WBGene00195001","IV",4864635,4864735,100
"26941","WBGene00195003","IV",3943303,3943744,441
"26942","WBGene00195004","IV",1726145,1727980,1835
"26943","WBGene00195005","IV",11659573,11659673,100
"26944","WBGene00195006","IV",4080171,4080946,775
"26945","WBGene00195007","II",14399565,14399629,64
"26946","WBGene00195009","IV",8352338,8352913,575
"26947","WBGene00195010","IV",3701334,3701920,586
"26948","WBGene00195011","IV",4511440,4511724,284
"26949","WBGene00195012","IV",1821817,1822408,591
"26950","WBGene00195016","III",5211220,5211518,298
"26951","WBGene00195017","III",5031410,5031708,298
"26952","WBGene00195021","IV",4725436,4725454,18
"26953","WBGene00195022","II",3305738,3305756,18
"26954","WBGene00195023","II",3307469,3307488,19
"26955","WBGene00195024","II",3309988,3310006,18
"26956","WBGene00195025","II",3309254,3309274,20
"26957","WBGene00195027","II",3306367,3306386,19
"26958","WBGene00195034","III",178876,178895,19
"26959","WBGene00195035","V",1690350,1690368,18
"26960","WBGene00195036","X",191796,191816,20
"26961","WBGene00195040","II",2996388,2996407,19
"26962","WBGene00195043","IV",14764060,14764305,245
"26963","WBGene00195045","I",3362369,3363362,993
"26964","WBGene00195046","IV",8627644,8627839,195
"26965","WBGene00195048","IV",4170776,4171569,793
"26966","WBGene00195049","IV",3641396,3642307,911
"26967","WBGene00195050","IV",6905846,6906390,544
"26968","WBGene00195051","IV",6919773,6920220,447
"26969","WBGene00195056","I",3109628,3110672,1044
"26970","WBGene00195057","I",5268419,5269463,1044
"26971","WBGene00195058","V",18819065,18819410,345
"26972","WBGene00195060","V",17539172,17539475,303
"26973","WBGene00195061","V",18467944,18468197,253
"26974","WBGene00195063","IV",205239,208049,2810
"26975","WBGene00195065","V",13752394,13752713,319
"26976","WBGene00195067","IV",3428134,3428534,400
"26977","WBGene00195068","I",1215045,1217263,2218
"26978","WBGene00195069","I",4984138,4984744,606
"26979","WBGene00195070","II",3446957,3448020,1063
"26980","WBGene00195071","II",3448206,3448759,553
"26981","WBGene00195072","II",3442490,3443254,764
"26982","WBGene00195073","II",3267663,3271505,3842
"26983","WBGene00195077","II",3787451,3788479,1028
"26984","WBGene00195081","X",3416888,3419213,2325
"26985","WBGene00195084","X",9674539,9674865,326
"26986","WBGene00195086","V",9122317,9123260,943
"26987","WBGene00195093","IV",5207109,5209481,2372
"26988","WBGene00195117","V",16274827,16275232,405
"26989","WBGene00195142","II",8214057,8214469,412
"26990","WBGene00195143","II",9136202,9137554,1352
"26991","WBGene00195144","II",9138103,9138475,372
"26992","WBGene00195145","II",10487038,10488281,1243
"26993","WBGene00195146","II",11556704,11557201,497
"26994","WBGene00195147","II",8420098,8422054,1956
"26995","WBGene00195148","II",11476058,11476515,457
"26996","WBGene00195149","II",14388513,14388824,311
"26997","WBGene00195150","II",13081776,13082322,546
"26998","WBGene00195151","V",20396071,20396472,401
"26999","WBGene00195154","V",4385667,4386293,626
"27000","WBGene00195155","I",13853079,13853727,648
"27001","WBGene00195157","V",10240573,10241188,615
"27002","WBGene00195158","V",20595426,20595730,304
"27003","WBGene00195159","V",11076485,11076666,181
"27004","WBGene00195160","V",4411646,4411814,168
"27005","WBGene00195164","V",6288907,6289587,680
"27006","WBGene00195165","V",17625127,17627598,2471
"27007","WBGene00195166","V",12656874,12658179,1305
"27008","WBGene00195168","X",6190252,6191210,958
"27009","WBGene00195169","V",1197813,1200672,2859
"27010","WBGene00195170","V",16043099,16043761,662
"27011","WBGene00195171","V",5366899,5368915,2016
"27012","WBGene00195172","V",17300960,17302490,1530
"27013","WBGene00195174","III",10141032,10141428,396
"27014","WBGene00195175","I",14566307,14566783,476
"27015","WBGene00195176","V",19457420,19458857,1437
"27016","WBGene00195177","V",19462912,19463759,847
"27017","WBGene00195178","I",6642719,6643667,948
"27018","WBGene00195179","I",5333779,5334931,1152
"27019","WBGene00195180","I",4427024,4428026,1002
"27020","WBGene00195181","V",10409763,10410091,328
"27021","WBGene00195182","II",5598453,5599374,921
"27022","WBGene00195183","X",389516,390551,1035
"27023","WBGene00195184","X",1417749,1418621,872
"27024","WBGene00195185","X",1419503,1420122,619
"27025","WBGene00195186","X",1420699,1423497,2798
"27026","WBGene00195188","X",1426337,1426525,188
"27027","WBGene00195189","X",5016075,5017844,1769
"27028","WBGene00195192","V",7550322,7551482,1160
"27029","WBGene00195208","X",11097081,11098177,1096
"27030","WBGene00195209","X",9536563,9536792,229
"27031","WBGene00195210","X",15773858,15774185,327
"27032","WBGene00195211","X",11226256,11226656,400
"27033","WBGene00195212","X",15093581,15095073,1492
"27034","WBGene00195213","X",12977244,12977551,307
"27035","WBGene00195214","X",12977092,12977852,760
"27036","WBGene00195215","X",11938187,11938900,713
"27037","WBGene00195226","V",6772569,6773165,596
"27038","WBGene00195227","I",13927959,13928792,833
"27039","WBGene00195228","I",13927091,13927548,457
"27040","WBGene00195229","I",13923061,13923763,702
"27041","WBGene00195230","I",11264685,11264987,302
"27042","WBGene00195231","I",11265105,11265427,322
"27043","WBGene00195232","I",11268619,11268958,339
"27044","WBGene00195233","V",17315591,17315954,363
"27045","WBGene00195235","V",14668953,14669340,387
"27046","WBGene00195237","V",19851966,19852022,56
"27047","WBGene00195238","II",1061648,1061741,93
"27048","WBGene00195239","II",7053036,7053844,808
"27049","WBGene00195240","V",19152279,19152428,149
"27050","WBGene00195242","V",20195986,20196416,430
"27051","WBGene00195243","V",20606423,20606717,294
"27052","WBGene00195244","I",9482785,9483517,732
"27053","WBGene00195245","IV",8428614,8428739,125
"27054","WBGene00195246","II",4941771,4942318,547
"27055","WBGene00195247","I",12274999,12275342,343
"27056","WBGene00195248","II",11496780,11497993,1213
"27057","WBGene00195250","V",12118018,12118987,969
"27058","WBGene00195252","V",11204492,11207983,3491
"27059","WBGene00195253","I",12643008,12644321,1313
"27060","WBGene00195254","I",12642403,12642900,497
"27061","WBGene00195255","I",12640720,12641501,781
"27062","WBGene00195256","V",10539414,10539925,511
"27063","WBGene00195257","I",7059892,7061254,1362
"27064","WBGene00195258","X",3311611,3311760,149
"27065","WBGene00195262","X",5668796,5668920,124
"27066","WBGene00195263","X",4480828,4481026,198
"27067","WBGene00195265","X",3781333,3781476,143
"27068","WBGene00195266","V",4310609,4310687,78
"27069","WBGene00195267","IV",5751272,5751401,129
"27070","WBGene00195268","V",1236858,1236909,51
"27071","WBGene00195269","X",5891679,5891902,223
"27072","WBGene00195270","III",4649471,4649690,219
"27073","WBGene00195271","III",3367810,3367997,187
"27074","WBGene00195275","X",7224588,7224782,194
"27075","WBGene00195276","V",9081528,9081613,85
"27076","WBGene00195278","X",5791020,5791159,139
"27077","WBGene00195280","IV",14394130,14394289,159
"27078","WBGene00195281","X",10622583,10622707,124
"27079","WBGene00195282","V",19387608,19387661,53
"27080","WBGene00195285","V",11350058,11350115,57
"27081","WBGene00195286","V",11281583,11281725,142
"27082","WBGene00195287","II",7694441,7694590,149
"27083","WBGene00195289","I",2410190,2410261,71
"27084","WBGene00195291","X",4082618,4082724,106
"27085","WBGene00195292","III",11414732,11414846,114
"27086","WBGene00195294","III",3606554,3606702,148
"27087","WBGene00195295","X",3314481,3314693,212
"27088","WBGene00195299","X",13009018,13009220,202
"27089","WBGene00195300","V",8667351,8667494,143
"27090","WBGene00195301","IV",11572599,11572736,137
"27091","WBGene00195302","II",7034062,7034335,273
"27092","WBGene00195304","X",1930716,1930870,154
"27093","WBGene00195305","V",11700926,11701142,216
"27094","WBGene00195306","V",8203954,8204102,148
"27095","WBGene00195307","V",18175781,18175846,65
"27096","WBGene00195308","IV",12012388,12012667,279
"27097","WBGene00195309","IV",9440471,9440620,149
"27098","WBGene00195310","X",13799776,13799969,193
"27099","WBGene00195311","II",8203265,8203375,110
"27100","WBGene00195312","X",6142967,6143046,79
"27101","WBGene00195314","III",9896855,9897004,149
"27102","WBGene00195317","III",9242008,9242135,127
"27103","WBGene00195319","V",1412607,1412702,95
"27104","WBGene00195320","I",11392811,11392915,104
"27105","WBGene00195324","X",3179642,3179851,209
"27106","WBGene00195325","III",9344813,9344986,173
"27107","WBGene00195326","X",10108108,10108246,138
"27108","WBGene00195328","V",8783169,8783391,222
"27109","WBGene00195329","III",9133874,9134019,145
"27110","WBGene00195330","X",7478474,7478657,183
"27111","WBGene00195331","III",9976685,9977031,346
"27112","WBGene00195332","X",13653725,13653816,91
"27113","WBGene00195333","III",13056379,13056601,222
"27114","WBGene00195334","X",3097928,3098063,135
"27115","WBGene00195335","II",3039516,3039756,240
"27116","WBGene00195337","X",5128194,5128279,85
"27117","WBGene00195338","V",11343267,11343394,127
"27118","WBGene00195342","V",11169004,11169152,148
"27119","WBGene00195347","II",6418219,6418373,154
"27120","WBGene00195348","IV",9919961,9920083,122
"27121","WBGene00195349","II",5293449,5293530,81
"27122","WBGene00195351","V",6458951,6459152,201
"27123","WBGene00195352","I",6283496,6283637,141
"27124","WBGene00195354","IV",10919395,10919539,144
"27125","WBGene00195355","I",1575714,1575803,89
"27126","WBGene00195356","IV",7981988,7982352,364
"27127","WBGene00195357","X",16273765,16273854,89
"27128","WBGene00195358","V",8767324,8767375,51
"27129","WBGene00195359","II",7623578,7623816,238
"27130","WBGene00195360","X",4905354,4905783,429
"27131","WBGene00195362","III",1425562,1425711,149
"27132","WBGene00195363","IV",4470962,4471169,207
"27133","WBGene00195365","IV",7619391,7619610,219
"27134","WBGene00195366","V",9550064,9550207,143
"27135","WBGene00195368","III",6805229,6805433,204
"27136","WBGene00195370","IV",4669216,4669336,120
"27137","WBGene00195371","III",8457401,8457592,191
"27138","WBGene00195372","X",4576406,4576536,130
"27139","WBGene00195373","X",857774,857948,174
"27140","WBGene00195374","V",18233480,18233629,149
"27141","WBGene00195375","X",12909889,12910028,139
"27142","WBGene00195377","X",14951911,14952060,149
"27143","WBGene00195380","X",12844811,12844960,149
"27144","WBGene00195381","IV",9006210,9006270,60
"27145","WBGene00195382","V",10681186,10681544,358
"27146","WBGene00195383","X",6037860,6037942,82
"27147","WBGene00195385","X",7213054,7213195,141
"27148","WBGene00195386","V",13169697,13169844,147
"27149","WBGene00195387","X",13467641,13467820,179
"27150","WBGene00195389","X",14636727,14636939,212
"27151","WBGene00195390","IV",12364961,12365179,218
"27152","WBGene00195393","IV",4572319,4572436,117
"27153","WBGene00195394","I",8987095,8987231,136
"27154","WBGene00195395","X",5444167,5444441,274
"27155","WBGene00195396","V",6458711,6458839,128
"27156","WBGene00195399","IV",12208010,12208159,149
"27157","WBGene00195400","I",10066793,10066869,76
"27158","WBGene00195401","X",16647194,16647336,142
"27159","WBGene00195404","X",16770158,16770302,144
"27160","WBGene00195405","I",10506417,10506638,221
"27161","WBGene00195406","IV",5974023,5974258,235
"27162","WBGene00195407","IV",12414387,12414535,148
"27163","WBGene00195408","II",5764301,5764441,140
"27164","WBGene00195409","X",7279518,7279602,84
"27165","WBGene00195410","III",2204157,2204207,50
"27166","WBGene00195411","II",11925411,11925486,75
"27167","WBGene00195412","III",9935321,9935470,149
"27168","WBGene00195413","II",7484561,7484700,139
"27169","WBGene00195414","II",4807317,4807466,149
"27170","WBGene00195415","II",6990257,6990361,104
"27171","WBGene00195416","X",5478896,5479045,149
"27172","WBGene00195417","I",9734112,9734369,257
"27173","WBGene00195420","V",1855781,1855843,62
"27174","WBGene00195421","V",6754640,6754873,233
"27175","WBGene00195422","III",12642877,12643026,149
"27176","WBGene00195423","V",11372539,11372672,133
"27177","WBGene00195424","I",1156163,1156454,291
"27178","WBGene00195425","X",4980300,4980473,173
"27179","WBGene00195426","I",4745315,4745455,140
"27180","WBGene00195427","III",9081281,9081413,132
"27181","WBGene00195429","X",6066564,6066755,191
"27182","WBGene00195430","X",5475197,5475393,196
"27183","WBGene00195432","II",6545548,6545696,148
"27184","WBGene00195433","X",8381780,8381874,94
"27185","WBGene00195435","IV",11717223,11717363,140
"27186","WBGene00195436","IV",2664753,2665339,586
"27187","WBGene00195438","V",10004084,10004308,224
"27188","WBGene00195439","X",16053839,16053988,149
"27189","WBGene00195441","II",11595516,11595734,218
"27190","WBGene00195442","V",12428392,12428470,78
"27191","WBGene00195443","I",2739658,2739796,138
"27192","WBGene00195446","X",16300586,16300674,88
"27193","WBGene00195447","X",15680261,15680395,134
"27194","WBGene00195448","I",5707045,5707124,79
"27195","WBGene00195449","X",17390770,17390872,102
"27196","WBGene00195450","III",4603360,4603508,148
"27197","WBGene00195451","X",2646001,2646071,70
"27198","WBGene00195452","X",8546223,8546434,211
"27199","WBGene00195453","V",11075600,11075965,365
"27200","WBGene00195454","V",7804667,7804812,145
"27201","WBGene00195455","I",6263980,6264092,112
"27202","WBGene00195456","X",4076070,4076290,220
"27203","WBGene00195458","V",6543566,6543771,205
"27204","WBGene00195459","I",7726572,7726639,67
"27205","WBGene00195461","IV",4574357,4574451,94
"27206","WBGene00195464","II",3049230,3049366,136
"27207","WBGene00195466","X",3064888,3065033,145
"27208","WBGene00195467","X",8655173,8655389,216
"27209","WBGene00195468","V",10861936,10862069,133
"27210","WBGene00195470","V",5932473,5932569,96
"27211","WBGene00195471","X",13632264,13632601,337
"27212","WBGene00195472","X",10930370,10930421,51
"27213","WBGene00195476","I",5860401,5860547,146
"27214","WBGene00195477","IV",14869945,14870066,121
"27215","WBGene00195478","X",11031069,11031140,71
"27216","WBGene00195481","X",7220359,7220575,216
"27217","WBGene00195482","IV",5977444,5977576,132
"27218","WBGene00195483","X",6513543,6513842,299
"27219","WBGene00195484","X",3834292,3834428,136
"27220","WBGene00195485","I",5344433,5344654,221
"27221","WBGene00195486","I",6375006,6375564,558
"27222","WBGene00195487","X",4319010,4319292,282
"27223","WBGene00195489","III",2973591,2973653,62
"27224","WBGene00195490","II",10978458,10978666,208
"27225","WBGene00195491","X",15213519,15213658,139
"27226","WBGene00195492","X",9783269,9783446,177
"27227","WBGene00195494","X",13164500,13164641,141
"27228","WBGene00195498","II",1319221,1319273,52
"27229","WBGene00195499","X",6774529,6774678,149
"27230","WBGene00195500","V",10556449,10556598,149
"27231","WBGene00195501","V",1871980,1872075,95
"27232","WBGene00195505","II",10959920,10960126,206
"27233","WBGene00195507","X",5183330,5183526,196
"27234","WBGene00195508","X",9599234,9599366,132
"27235","WBGene00195509","III",9639499,9639636,137
"27236","WBGene00195510","IV",1906974,1907171,197
"27237","WBGene00195511","III",4109871,4110018,147
"27238","WBGene00195512","X",14045456,14045598,142
"27239","WBGene00195514","I",796997,797295,298
"27240","WBGene00195515","IV",6991070,6991246,176
"27241","WBGene00195516","III",1525618,1525667,49
"27242","WBGene00195518","III",7859532,7859678,146
"27243","WBGene00195519","X",59625,59849,224
"27244","WBGene00195520","IV",8062584,8062698,114
"27245","WBGene00195521","II",7797010,7797130,120
"27246","WBGene00195524","X",14717718,14718001,283
"27247","WBGene00195525","II",14724821,14724969,148
"27248","WBGene00195526","X",9844833,9844942,109
"27249","WBGene00195527","II",10986563,10986765,202
"27250","WBGene00195528","X",16579390,16579520,130
"27251","WBGene00195530","X",774692,774890,198
"27252","WBGene00195531","IV",5110592,5110701,109
"27253","WBGene00195532","X",5381314,5381525,211
"27254","WBGene00195533","IV",862750,862972,222
"27255","WBGene00195534","IV",11871665,11871812,147
"27256","WBGene00195535","II",289604,289658,54
"27257","WBGene00195536","V",11498433,11498734,301
"27258","WBGene00195537","V",12027748,12027884,136
"27259","WBGene00195538","X",10616924,10617025,101
"27260","WBGene00195542","X",8997091,8997303,212
"27261","WBGene00195543","V",6204032,6204171,139
"27262","WBGene00195544","I",946027,946117,90
"27263","WBGene00195547","V",10724007,10724149,142
"27264","WBGene00195548","X",6964600,6964741,141
"27265","WBGene00195549","V",14231581,14231717,136
"27266","WBGene00195550","IV",9366884,9367011,127
"27267","WBGene00195551","V",13295547,13295684,137
"27268","WBGene00195552","II",11398963,11399085,122
"27269","WBGene00195554","X",6402763,6403012,249
"27270","WBGene00195556","V",6683338,6683551,213
"27271","WBGene00195557","IV",3587544,3587691,147
"27272","WBGene00195558","II",5724155,5724322,167
"27273","WBGene00195559","IV",8289712,8289860,148
"27274","WBGene00195563","X",12388544,12388692,148
"27275","WBGene00195564","X",3854223,3854431,208
"27276","WBGene00195567","X",9406949,9407066,117
"27277","WBGene00195568","X",8650698,8650784,86
"27278","WBGene00195569","IV",11817151,11817288,137
"27279","WBGene00195572","X",10934722,10934870,148
"27280","WBGene00195573","X",16558939,16559033,94
"27281","WBGene00195574","X",910342,910488,146
"27282","WBGene00195576","IV",3085591,3085960,369
"27283","WBGene00195579","II",11268588,11268812,224
"27284","WBGene00195580","X",15136565,15136686,121
"27285","WBGene00195582","III",6994161,6994303,142
"27286","WBGene00195583","X",2513906,2514029,123
"27287","WBGene00195584","X",11196015,11196156,141
"27288","WBGene00195585","III",11353308,11353393,85
"27289","WBGene00195587","V",12326708,12326899,191
"27290","WBGene00195588","III",10151983,10152103,120
"27291","WBGene00195591","II",9968377,9968542,165
"27292","WBGene00195594","II",6831872,6832154,282
"27293","WBGene00195595","II",6522736,6522854,118
"27294","WBGene00195596","I",12198600,12198685,85
"27295","WBGene00195598","X",2097657,2097787,130
"27296","WBGene00195599","III",10169613,10169741,128
"27297","WBGene00195600","V",10019174,10019228,54
"27298","WBGene00195601","II",9430362,9430429,67
"27299","WBGene00195602","II",6725298,6725432,134
"27300","WBGene00195603","X",11669699,11669804,105
"27301","WBGene00195604","II",6718358,6718528,170
"27302","WBGene00195608","I",11381622,11381692,70
"27303","WBGene00195609","III",11720180,11720253,73
"27304","WBGene00195610","I",815976,816026,50
"27305","WBGene00195613","I",9089012,9089228,216
"27306","WBGene00195616","X",13351110,13351321,211
"27307","WBGene00195619","II",5559527,5559612,85
"27308","WBGene00195620","X",16596003,16596071,68
"27309","WBGene00195621","V",8026525,8026673,148
"27310","WBGene00195622","II",104211,104435,224
"27311","WBGene00195623","IV",2890642,2890843,201
"27312","WBGene00195624","V",11919723,11920034,311
"27313","WBGene00195626","IV",10427545,10427691,146
"27314","WBGene00195627","IV",7212867,7213013,146
"27315","WBGene00195628","IV",13218247,13218387,140
"27316","WBGene00195629","X",14744542,14744679,137
"27317","WBGene00195630","V",7971425,7971617,192
"27318","WBGene00195631","X",15276988,15277063,75
"27319","WBGene00195632","X",4058693,4058839,146
"27320","WBGene00195637","V",5975365,5975459,94
"27321","WBGene00195639","V",11308758,11308979,221
"27322","WBGene00195641","II",6385465,6385597,132
"27323","WBGene00195642","X",11132770,11132971,201
"27324","WBGene00195644","II",12362444,12362530,86
"27325","WBGene00195647","V",6739765,6739914,149
"27326","WBGene00195648","X",16363684,16363954,270
"27327","WBGene00195650","II",6395750,6395876,126
"27328","WBGene00195651","V",9243400,9243549,149
"27329","WBGene00195652","III",9861590,9861742,152
"27330","WBGene00195653","II",466849,466905,56
"27331","WBGene00195654","IV",6448080,6448229,149
"27332","WBGene00195655","III",10516645,10516839,194
"27333","WBGene00195656","II",7887845,7887968,123
"27334","WBGene00195657","X",8925640,8925720,80
"27335","WBGene00195658","V",13226065,13226288,223
"27336","WBGene00195659","IV",10979797,10979929,132
"27337","WBGene00195661","IV",7657145,7657500,355
"27338","WBGene00195665","IV",7407689,7407829,140
"27339","WBGene00195666","X",11791610,11791745,135
"27340","WBGene00195667","X",7525138,7525281,143
"27341","WBGene00195668","X",2531356,2531443,87
"27342","WBGene00195669","X",9085688,9085829,141
"27343","WBGene00195670","X",2899494,2899553,59
"27344","WBGene00195671","V",12961340,12961484,144
"27345","WBGene00195677","II",6823308,6823528,220
"27346","WBGene00195678","X",12081933,12082082,149
"27347","WBGene00195680","IV",4670526,4670675,149
"27348","WBGene00195683","I",12202898,12203022,124
"27349","WBGene00195685","V",11089116,11089262,146
"27350","WBGene00195686","X",14920660,14920783,123
"27351","WBGene00195687","X",7298888,7299033,145
"27352","WBGene00195689","V",11198234,11198365,131
"27353","WBGene00195691","III",4878458,4878553,95
"27354","WBGene00195692","X",6221389,6221538,149
"27355","WBGene00195693","V",11426608,11426783,175
"27356","WBGene00195695","II",1371110,1371159,49
"27357","WBGene00195698","X",6390062,6390203,141
"27358","WBGene00195699","X",14358844,14358976,132
"27359","WBGene00195700","II",11746923,11747060,137
"27360","WBGene00195701","X",10150480,10150580,100
"27361","WBGene00195702","II",12541676,12541765,89
"27362","WBGene00195705","IV",14033557,14034004,447
"27363","WBGene00195708","II",9020817,9021195,378
"27364","WBGene00195710","X",9303474,9303595,121
"27365","WBGene00195714","V",5973923,5974062,139
"27366","WBGene00195715","III",4643410,4643509,99
"27367","WBGene00195716","V",1039277,1039326,49
"27368","WBGene00195718","X",5857092,5857402,310
"27369","WBGene00195719","I",9543729,9543951,222
"27370","WBGene00195720","II",5358352,5358575,223
"27371","WBGene00195722","X",5121890,5122009,119
"27372","WBGene00195723","V",10519711,10519892,181
"27373","WBGene00195724","IV",3423759,3423842,83
"27374","WBGene00195725","X",2153588,2153743,155
"27375","WBGene00195727","X",3469570,3469765,195
"27376","WBGene00195728","II",6491936,6492164,228
"27377","WBGene00195729","X",15773313,15773416,103
"27378","WBGene00195730","II",8569141,8569289,148
"27379","WBGene00195731","X",13377773,13377887,114
"27380","WBGene00195732","X",4343957,4344244,287
"27381","WBGene00195733","V",10721429,10721578,149
"27382","WBGene00195735","IV",4548201,4548350,149
"27383","WBGene00195737","III",1418845,1419061,216
"27384","WBGene00195739","III",11472224,11472372,148
"27385","WBGene00195740","X",14639936,14640131,195
"27386","WBGene00195742","II",2247802,2247884,82
"27387","WBGene00195743","X",4721115,4721255,140
"27388","WBGene00195745","V",12220905,12221028,123
"27389","WBGene00195746","III",5964598,5964718,120
"27390","WBGene00195747","III",4721880,4722074,194
"27391","WBGene00195750","V",12773997,12774128,131
"27392","WBGene00195751","I",9328407,9328490,83
"27393","WBGene00195752","I",9942956,9943165,209
"27394","WBGene00195753","IV",5964253,5964420,167
"27395","WBGene00195754","II",13193696,13193840,144
"27396","WBGene00195755","I",5968741,5968963,222
"27397","WBGene00195756","X",11576798,11576963,165
"27398","WBGene00195757","IV",16855413,16855562,149
"27399","WBGene00195759","V",11347657,11347804,147
"27400","WBGene00195761","X",15040751,15040960,209
"27401","WBGene00195762","X",3862515,3862636,121
"27402","WBGene00195763","III",6056289,6056383,94
"27403","WBGene00195765","X",17203563,17203705,142
"27404","WBGene00195766","II",5764886,5765035,149
"27405","WBGene00195767","X",7323752,7323834,82
"27406","WBGene00195769","V",19126043,19126128,85
"27407","WBGene00195771","I",3377398,3377547,149
"27408","WBGene00195773","III",11558449,11558574,125
"27409","WBGene00195774","X",14995646,14995869,223
"27410","WBGene00195775","II",7813329,7813478,149
"27411","WBGene00195776","I",10497962,10498106,144
"27412","WBGene00195777","V",11807355,11807560,205
"27413","WBGene00195778","III",8755404,8755486,82
"27414","WBGene00195779","III",2754060,2754208,148
"27415","WBGene00195780","X",5172931,5173261,330
"27416","WBGene00195782","X",4619952,4620263,311
"27417","WBGene00195783","III",8146215,8146321,106
"27418","WBGene00195784","II",6829670,6830160,490
"27419","WBGene00195785","X",15016210,15016339,129
"27420","WBGene00195786","X",6160986,6161172,186
"27421","WBGene00195787","X",14688600,14688738,138
"27422","WBGene00195789","X",7456548,7456697,149
"27423","WBGene00195790","V",11954335,11954552,217
"27424","WBGene00195791","III",8498953,8499169,216
"27425","WBGene00195792","III",9622268,9622410,142
"27426","WBGene00195795","X",5976673,5976811,138
"27427","WBGene00195796","III",1166470,1166685,215
"27428","WBGene00195797","X",2213458,2213580,122
"27429","WBGene00195798","X",15360461,15360551,90
"27430","WBGene00195799","III",6744662,6744790,128
"27431","WBGene00195801","V",11610134,11610282,148
"27432","WBGene00195802","V",8928211,8928408,197
"27433","WBGene00195803","V",6514965,6515111,146
"27434","WBGene00195804","IV",17473288,17473422,134
"27435","WBGene00195805","IV",12201131,12201275,144
"27436","WBGene00195808","II",5880154,5880502,348
"27437","WBGene00195809","V",12780331,12780479,148
"27438","WBGene00195811","IV",8253090,8253177,87
"27439","WBGene00195814","X",15661260,15661404,144
"27440","WBGene00195815","X",9092001,9092134,133
"27441","WBGene00195816","V",13069011,13069169,158
"27442","WBGene00195817","I",9857383,9857532,149
"27443","WBGene00195818","X",11448295,11448435,140
"27444","WBGene00195819","V",11036177,11036372,195
"27445","WBGene00195820","X",6410539,6410672,133
"27446","WBGene00195821","X",2614541,2614668,127
"27447","WBGene00195822","IV",3838036,3838157,121
"27448","WBGene00195823","X",8724097,8724233,136
"27449","WBGene00195824","X",7681035,7681120,85
"27450","WBGene00195825","V",3455131,3455293,162
"27451","WBGene00195826","IV",7445369,7445504,135
"27452","WBGene00195827","X",5268230,5268340,110
"27453","WBGene00195828","IV",16005604,16005828,224
"27454","WBGene00195830","X",15213439,15213643,204
"27455","WBGene00195831","V",11404670,11404811,141
"27456","WBGene00195832","V",10726253,10726469,216
"27457","WBGene00195833","I",7954977,7955033,56
"27458","WBGene00195834","X",15487433,15487568,135
"27459","WBGene00195836","X",10705017,10705148,131
"27460","WBGene00195839","V",15465211,15465300,89
"27461","WBGene00195840","V",11629638,11629784,146
"27462","WBGene00195841","II",5701658,5701726,68
"27463","WBGene00195843","X",12175795,12176014,219
"27464","WBGene00195845","X",13506108,13506388,280
"27465","WBGene00195846","IV",14225095,14225184,89
"27466","WBGene00195847","II",4312345,4312450,105
"27467","WBGene00195848","II",6613599,6613780,181
"27468","WBGene00195850","X",10594115,10594245,130
"27469","WBGene00195851","X",16155407,16155514,107
"27470","WBGene00195853","IV",6384959,6385163,204
"27471","WBGene00195854","V",10904185,10904329,144
"27472","WBGene00195856","V",11525414,11525719,305
"27473","WBGene00195857","X",6951127,6951272,145
"27474","WBGene00195858","X",13166126,13166179,53
"27475","WBGene00195859","V",14933850,14934145,295
"27476","WBGene00195860","IV",12782066,12782191,125
"27477","WBGene00195861","I",6888744,6888884,140
"27478","WBGene00195862","II",8727050,8727263,213
"27479","WBGene00195864","IV",683055,683144,89
"27480","WBGene00195865","II",15265686,15265757,71
"27481","WBGene00195866","X",10508961,10509231,270
"27482","WBGene00195867","V",16648757,16648846,89
"27483","WBGene00195868","X",7649193,7649417,224
"27484","WBGene00195871","II",14428755,14428833,78
"27485","WBGene00195873","X",1619293,1619341,48
"27486","WBGene00195874","V",12334521,12334658,137
"27487","WBGene00195875","X",17413692,17413815,123
"27488","WBGene00195876","X",8505807,8505951,144
"27489","WBGene00195877","X",5973534,5973668,134
"27490","WBGene00195878","V",11675086,11675304,218
"27491","WBGene00195879","X",5867034,5867218,184
"27492","WBGene00195880","V",12358068,12358214,146
"27493","WBGene00195881","V",10722912,10723038,126
"27494","WBGene00195882","II",10502652,10503191,539
"27495","WBGene00195883","I",8503351,8503449,98
"27496","WBGene00195884","I",9439549,9439698,149
"27497","WBGene00195885","V",11528266,11528414,148
"27498","WBGene00195886","X",7585378,7585509,131
"27499","WBGene00195887","III",11274376,11274432,56
"27500","WBGene00195888","I",8680578,8680678,100
"27501","WBGene00195889","X",2330725,2330860,135
"27502","WBGene00195891","II",11097548,11097693,145
"27503","WBGene00195892","II",7570172,7570377,205
"27504","WBGene00195893","V",14617689,14617808,119
"27505","WBGene00195895","X",2679561,2679692,131
"27506","WBGene00195900","IV",10174395,10174610,215
"27507","WBGene00195901","III",3067569,3067793,224
"27508","WBGene00195903","V",20369940,20370029,89
"27509","WBGene00195904","II",11308343,11308492,149
"27510","WBGene00195905","IV",6983933,6984071,138
"27511","WBGene00195906","III",8619137,8619228,91
"27512","WBGene00195907","X",2219012,2219151,139
"27513","WBGene00195908","II",15253969,15254045,76
"27514","WBGene00195909","I",9940977,9941032,55
"27515","WBGene00195910","V",10681181,10681539,358
"27516","WBGene00195911","IV",6645868,6646001,133
"27517","WBGene00195912","X",6782675,6782811,136
"27518","WBGene00195915","III",7527288,7527425,137
"27519","WBGene00195918","V",5388189,5388338,149
"27520","WBGene00195919","II",9088918,9089040,122
"27521","WBGene00195921","IV",11566261,11566417,156
"27522","WBGene00195925","X",5699945,5700072,127
"27523","WBGene00195926","I",6174995,6175138,143
"27524","WBGene00195927","IV",11286257,11286403,146
"27525","WBGene00195928","X",5791500,5791635,135
"27526","WBGene00195930","III",6158943,6159059,116
"27527","WBGene00195932","IV",7700539,7700761,222
"27528","WBGene00195934","V",5359229,5359358,129
"27529","WBGene00195935","IV",8136304,8136444,140
"27530","WBGene00195936","III",8570592,8570731,139
"27531","WBGene00195938","X",12629426,12629569,143
"27532","WBGene00195939","X",6705970,6706181,211
"27533","WBGene00195940","X",4162114,4162246,132
"27534","WBGene00195941","V",13811607,13811823,216
"27535","WBGene00195942","V",12737728,12737916,188
"27536","WBGene00195943","II",578661,578714,53
"27537","WBGene00195944","X",6516419,6516718,299
"27538","WBGene00195945","II",10957959,10958048,89
"27539","WBGene00195947","IV",10502284,10502394,110
"27540","WBGene00195948","IV",16389199,16389288,89
"27541","WBGene00195949","II",15109725,15109772,47
"27542","WBGene00195950","X",7587727,7587875,148
"27543","WBGene00195951","X",9409154,9409317,163
"27544","WBGene00195952","III",9345020,9345170,150
"27545","WBGene00195953","X",5084511,5084636,125
"27546","WBGene00195955","I",14042919,14042987,68
"27547","WBGene00195957","X",6215343,6215503,160
"27548","WBGene00195958","X",7209463,7209588,125
"27549","WBGene00195959","X",15224216,15224340,124
"27550","WBGene00195960","IV",6983724,6983935,211
"27551","WBGene00195961","X",6579817,6580022,205
"27552","WBGene00195963","V",20647601,20647659,58
"27553","WBGene00195965","X",7613270,7613419,149
"27554","WBGene00195966","X",6960324,6960450,126
"27555","WBGene00195967","IV",10657153,10657297,144
"27556","WBGene00195968","X",3657981,3658199,218
"27557","WBGene00195969","X",3371410,3371558,148
"27558","WBGene00195970","X",2907288,2907432,144
"27559","WBGene00195971","V",12295614,12295739,125
"27560","WBGene00195972","II",14635325,14635417,92
"27561","WBGene00195973","II",7720897,7721026,129
"27562","WBGene00195974","II",11393819,11394059,240
"27563","WBGene00195975","X",15590594,15590727,133
"27564","WBGene00195976","II",13962728,13962780,52
"27565","WBGene00195978","X",16012687,16013060,373
"27566","WBGene00195979","V",6270075,6270219,144
"27567","WBGene00195981","X",5703404,5703528,124
"27568","WBGene00195982","V",12210542,12210682,140
"27569","WBGene00195985","I",13701496,13701546,50
"27570","WBGene00195987","X",14046351,14046575,224
"27571","WBGene00195991","II",3280449,3280502,53
"27572","WBGene00195992","X",4129899,4130088,189
"27573","WBGene00195993","V",5505124,5505261,137
"27574","WBGene00195994","X",17571920,17572059,139
"27575","WBGene00195995","X",5097458,5097678,220
"27576","WBGene00195996","II",13714202,13714262,60
"27577","WBGene00195997","III",8473466,8473554,88
"27578","WBGene00196000","III",297116,297208,92
"27579","WBGene00196001","X",2926311,2926451,140
"27580","WBGene00196002","X",3837729,3837877,148
"27581","WBGene00196004","X",5821931,5822034,103
"27582","WBGene00196005","X",7217805,7218076,271
"27583","WBGene00196006","I",4859244,4859320,76
"27584","WBGene00196007","II",11508750,11508815,65
"27585","WBGene00196008","V",15065350,15065533,183
"27586","WBGene00196012","X",5321276,5321402,126
"27587","WBGene00196013","X",4812826,4813104,278
"27588","WBGene00196015","IV",3233162,3233303,141
"27589","WBGene00196016","III",5790254,5790314,60
"27590","WBGene00196018","V",15547866,15547960,94
"27591","WBGene00196020","IV",12218409,12218543,134
"27592","WBGene00196021","V",7175054,7175254,200
"27593","WBGene00196022","II",7716009,7716154,145
"27594","WBGene00196023","X",5189077,5189216,139
"27595","WBGene00196024","V",10632945,10633090,145
"27596","WBGene00196025","V",11986638,11986760,122
"27597","WBGene00196026","III",10777396,10777442,46
"27598","WBGene00196027","II",6205270,6205505,235
"27599","WBGene00196029","X",4077654,4077801,147
"27600","WBGene00196031","III",12015478,12015552,74
"27601","WBGene00196033","V",18718257,18718377,120
"27602","WBGene00196034","V",11080405,11080624,219
"27603","WBGene00196036","X",2087929,2087989,60
"27604","WBGene00196039","X",353236,353341,105
"27605","WBGene00196040","III",12209330,12209390,60
"27606","WBGene00196041","V",14484955,14485179,224
"27607","WBGene00196042","V",6889026,6889170,144
"27608","WBGene00196044","IV",6989959,6990174,215
"27609","WBGene00196045","II",6394284,6394414,130
"27610","WBGene00196046","II",5050068,5050265,197
"27611","WBGene00196047","X",15542290,15542413,123
"27612","WBGene00196049","IV",6985782,6986209,427
"27613","WBGene00196050","X",5734063,5734181,118
"27614","WBGene00196052","V",9076660,9076784,124
"27615","WBGene00196054","X",2858527,2858672,145
"27616","WBGene00196055","X",2447552,2447684,132
"27617","WBGene00196056","V",11176926,11177134,208
"27618","WBGene00196057","II",6020330,6020518,188
"27619","WBGene00196058","IV",878075,878127,52
"27620","WBGene00196059","V",11799391,11799530,139
"27621","WBGene00196060","V",13113089,13113305,216
"27622","WBGene00196062","I",14224179,14224257,78
"27623","WBGene00196063","V",8545971,8546169,198
"27624","WBGene00196064","IV",7099484,7099618,134
"27625","WBGene00196066","V",11175524,11175717,193
"27626","WBGene00196067","II",14098591,14098644,53
"27627","WBGene00196068","V",9734374,9734567,193
"27628","WBGene00196069","III",1795738,1796028,290
"27629","WBGene00196070","III",6396637,6396688,51
"27630","WBGene00196071","III",4462226,4462369,143
"27631","WBGene00196072","III",2008289,2008438,149
"27632","WBGene00196078","V",11338931,11339072,141
"27633","WBGene00196079","IV",11901243,11901373,130
"27634","WBGene00196081","V",8920198,8920347,149
"27635","WBGene00196082","III",83581,83633,52
"27636","WBGene00196083","X",6848046,6848249,203
"27637","WBGene00196086","X",12721602,12721842,240
"27638","WBGene00196088","V",11956139,11956280,141
"27639","WBGene00196089","II",6972687,6972790,103
"27640","WBGene00196090","X",693176,693393,217
"27641","WBGene00196091","V",9550466,9550598,132
"27642","WBGene00196092","III",9805112,9805261,149
"27643","WBGene00196093","II",6416848,6417068,220
"27644","WBGene00196096","IV",5394940,5395158,218
"27645","WBGene00196098","IV",1094087,1094209,122
"27646","WBGene00196099","I",6172671,6172796,125
"27647","WBGene00196100","I",9852612,9852799,187
"27648","WBGene00196101","I",10305808,10305959,151
"27649","WBGene00196102","II",6132911,6133040,129
"27650","WBGene00196103","V",18588078,18588224,146
"27651","WBGene00196104","IV",13217885,13217965,80
"27652","WBGene00196105","II",10085013,10085132,119
"27653","WBGene00196106","X",10432082,10432230,148
"27654","WBGene00196107","X",6891812,6891943,131
"27655","WBGene00196109","X",16986922,16987145,223
"27656","WBGene00196110","V",5626446,5626670,224
"27657","WBGene00196111","II",11393848,11394152,304
"27658","WBGene00196112","V",11210561,11210791,230
"27659","WBGene00196113","V",6354526,6354663,137
"27660","WBGene00196115","X",14961700,14961846,146
"27661","WBGene00196118","V",10479386,10479515,129
"27662","WBGene00196119","II",11753693,11753918,225
"27663","WBGene00196120","X",10128229,10128631,402
"27664","WBGene00196121","X",11740281,11740413,132
"27665","WBGene00196123","V",12297356,12297489,133
"27666","WBGene00196124","I",6577275,6577476,201
"27667","WBGene00196127","V",14223584,14223709,125
"27668","WBGene00196130","X",7132068,7132131,63
"27669","WBGene00196131","III",6335236,6335385,149
"27670","WBGene00196132","X",6167498,6167668,170
"27671","WBGene00196134","IV",8994746,8994872,126
"27672","WBGene00196136","II",3434728,3434779,51
"27673","WBGene00196137","V",9217527,9217651,124
"27674","WBGene00196138","IV",6841147,6841262,115
"27675","WBGene00196140","X",4899803,4899948,145
"27676","WBGene00196141","III",9982302,9982553,251
"27677","WBGene00196143","I",9598114,9598245,131
"27678","WBGene00196144","V",14573237,14573358,121
"27679","WBGene00196145","X",2231797,2231928,131
"27680","WBGene00196146","I",10033045,10033190,145
"27681","WBGene00196147","IV",13331408,13331541,133
"27682","WBGene00196148","II",8894052,8894174,122
"27683","WBGene00196149","V",6344979,6345167,188
"27684","WBGene00196150","III",8216458,8216570,112
"27685","WBGene00196152","X",14646166,14646292,126
"27686","WBGene00196153","X",3743235,3743324,89
"27687","WBGene00196154","IV",3852722,3852987,265
"27688","WBGene00196155","X",8361181,8361330,149
"27689","WBGene00196157","X",10176610,10176752,142
"27690","WBGene00196158","II",7003260,7003355,95
"27691","WBGene00196159","II",14429826,14429966,140
"27692","WBGene00196160","X",12872180,12872318,138
"27693","WBGene00196162","X",4555499,4555642,143
"27694","WBGene00196163","V",12352814,12352957,143
"27695","WBGene00196164","IV",11899304,11899441,137
"27696","WBGene00196167","V",14824401,14824456,55
"27697","WBGene00196168","X",15426133,15426282,149
"27698","WBGene00196172","V",1115573,1115791,218
"27699","WBGene00196173","II",10358139,10358286,147
"27700","WBGene00196175","X",12091601,12091817,216
"27701","WBGene00196176","V",10717331,10717628,297
"27702","WBGene00196177","III",82334,82389,55
"27703","WBGene00196178","II",7485086,7485216,130
"27704","WBGene00196180","X",3956062,3956207,145
"27705","WBGene00196181","V",7776303,7776446,143
"27706","WBGene00196182","II",4783653,4783864,211
"27707","WBGene00196183","X",4074240,4074366,126
"27708","WBGene00196184","X",16756918,16756973,55
"27709","WBGene00196185","IV",3858184,3858398,214
"27710","WBGene00196187","I",11392637,11392692,55
"27711","WBGene00196188","I",7040641,7040711,70
"27712","WBGene00196189","V",6458915,6459117,202
"27713","WBGene00196190","X",8654732,8654955,223
"27714","WBGene00196192","V",6053436,6053502,66
"27715","WBGene00196193","III",9307827,9307967,140
"27716","WBGene00196195","IV",4570698,4570962,264
"27717","WBGene00196196","I",4412016,4412101,85
"27718","WBGene00196197","V",13868872,13868924,52
"27719","WBGene00196198","X",6962815,6963071,256
"27720","WBGene00196199","X",12462598,12462682,84
"27721","WBGene00196201","V",11168611,11168829,218
"27722","WBGene00196202","V",12475799,12475927,128
"27723","WBGene00196204","I",10095271,10095537,266
"27724","WBGene00196205","III",12549806,12549889,83
"27725","WBGene00196206","IV",12401624,12401767,143
"27726","WBGene00196207","X",8389155,8389304,149
"27727","WBGene00196208","X",7873987,7874211,224
"27728","WBGene00196209","X",5444114,5444391,277
"27729","WBGene00196210","X",13448669,13448758,89
"27730","WBGene00196213","V",11899935,11900079,144
"27731","WBGene00196214","II",6532845,6532932,87
"27732","WBGene00196215","I",6615514,6615591,77
"27733","WBGene00196216","X",10846324,10846518,194
"27734","WBGene00196217","IV",13200140,13200289,149
"27735","WBGene00196219","I",4746464,4746903,439
"27736","WBGene00196220","II",415068,415132,64
"27737","WBGene00196222","III",2641881,2642099,218
"27738","WBGene00196223","X",4156877,4157010,133
"27739","WBGene00196225","V",1164211,1164356,145
"27740","WBGene00196226","IV",11717219,11717359,140
"27741","WBGene00196227","X",5479992,5480102,110
"27742","WBGene00196228","X",7643886,7644025,139
"27743","WBGene00196229","X",1806982,1807201,219
"27744","WBGene00196230","IV",6478305,6478431,126
"27745","WBGene00196231","V",11437480,11437642,162
"27746","WBGene00196233","X",7864059,7864215,156
"27747","WBGene00196235","I",2831305,2831674,369
"27748","WBGene00196236","X",4950059,4950199,140
"27749","WBGene00196237","V",11375289,11375432,143
"27750","WBGene00196238","X",13655907,13656002,95
"27751","WBGene00196240","X",5475132,5475356,224
"27752","WBGene00196241","X",434625,434756,131
"27753","WBGene00196243","I",7671532,7671642,110
"27754","WBGene00196247","X",15131084,15131218,134
"27755","WBGene00196248","X",8311709,8311919,210
"27756","WBGene00196249","V",12424731,12424898,167
"27757","WBGene00196250","X",888633,888782,149
"27758","WBGene00196251","V",12129195,12129400,205
"27759","WBGene00196253","X",10927615,10927819,204
"27760","WBGene00196254","X",3314072,3314270,198
"27761","WBGene00196255","IV",10566277,10566328,51
"27762","WBGene00196257","V",11073006,11073175,169
"27763","WBGene00196258","V",8545366,8545574,208
"27764","WBGene00196259","IV",4573037,4573186,149
"27765","WBGene00196260","I",2698564,2698712,148
"27766","WBGene00196261","V",12586528,12586676,148
"27767","WBGene00196262","X",16317833,16317967,134
"27768","WBGene00196263","X",4810108,4810245,137
"27769","WBGene00196264","X",13158053,13158244,191
"27770","WBGene00196265","III",7800548,7800695,147
"27771","WBGene00196266","II",11275071,11275250,179
"27772","WBGene00196273","X",15508091,15508219,128
"27773","WBGene00196274","II",10998059,10998207,148
"27774","WBGene00196275","X",7467846,7468059,213
"27775","WBGene00196276","I",5093813,5093900,87
"27776","WBGene00196277","X",3953063,3953273,210
"27777","WBGene00196279","IV",14385304,14385409,105
"27778","WBGene00196280","IV",4465345,4465466,121
"27779","WBGene00196281","X",6953545,6953692,147
"27780","WBGene00196282","X",5792303,5792617,314
"27781","WBGene00196284","X",7638144,7638355,211
"27782","WBGene00196285","II",6170060,6170198,138
"27783","WBGene00196288","II",7625221,7625359,138
"27784","WBGene00196289","X",6573145,6573281,136
"27785","WBGene00196290","IV",10919318,10919461,143
"27786","WBGene00196291","III",9639844,9639990,146
"27787","WBGene00196295","III",3368485,3368633,148
"27788","WBGene00196296","I",2370805,2370858,53
"27789","WBGene00196297","I",13327492,13327567,75
"27790","WBGene00196298","II",10758991,10759138,147
"27791","WBGene00196300","X",14819499,14819674,175
"27792","WBGene00196301","X",9597008,9597134,126
"27793","WBGene00196303","V",12024212,12024613,401
"27794","WBGene00196304","X",13145213,13145271,58
"27795","WBGene00196305","X",3178971,3179155,184
"27796","WBGene00196306","X",5770756,5770955,199
"27797","WBGene00196307","X",14654623,14654863,240
"27798","WBGene00196308","X",5895862,5896060,198
"27799","WBGene00196312","V",11704765,11704901,136
"27800","WBGene00196313","II",4809627,4809738,111
"27801","WBGene00196315","IV",4389808,4389957,149
"27802","WBGene00196317","X",2771854,2772013,159
"27803","WBGene00196318","X",16776914,16777035,121
"27804","WBGene00196319","V",4161612,4161725,113
"27805","WBGene00196320","IV",3332177,3332239,62
"27806","WBGene00196321","X",10618790,10619009,219
"27807","WBGene00196322","II",4904279,4904428,149
"27808","WBGene00196323","X",696451,696539,88
"27809","WBGene00196325","IV",12001077,12001217,140
"27810","WBGene00196326","V",18575353,18575431,78
"27811","WBGene00196327","II",8194995,8195115,120
"27812","WBGene00196328","II",14077133,14077226,93
"27813","WBGene00196329","III",3589207,3589355,148
"27814","WBGene00196330","V",8668990,8669118,128
"27815","WBGene00196331","X",12025181,12025315,134
"27816","WBGene00196334","III",9910758,9910903,145
"27817","WBGene00196335","X",15434025,15434221,196
"27818","WBGene00196336","IV",10422420,10422635,215
"27819","WBGene00196337","V",12211311,12211445,134
"27820","WBGene00196338","V",11340052,11340271,219
"27821","WBGene00196339","IV",3711979,3712066,87
"27822","WBGene00196340","V",6460665,6460811,146
"27823","WBGene00196343","I",11329000,11329059,59
"27824","WBGene00196344","V",11307918,11308060,142
"27825","WBGene00196346","V",11344086,11344308,222
"27826","WBGene00196347","X",7844877,7845025,148
"27827","WBGene00196349","X",14778259,14778398,139
"27828","WBGene00196350","X",16388921,16389017,96
"27829","WBGene00196354","X",10594892,10595084,192
"27830","WBGene00196356","II",2353605,2353692,87
"27831","WBGene00196358","V",372721,373263,542
"27832","WBGene00196359","III",5762282,5762364,82
"27833","WBGene00196360","I",11947973,11948033,60
"27834","WBGene00196361","X",15142449,15142591,142
"27835","WBGene00196362","II",3249093,3249142,49
"27836","WBGene00196363","X",6134402,6134690,288
"27837","WBGene00196366","III",675552,675665,113
"27838","WBGene00196367","I",6280456,6280583,127
"27839","WBGene00196368","III",13531064,13531168,104
"27840","WBGene00196369","X",6898316,6898532,216
"27841","WBGene00196373","III",8466752,8466870,118
"27842","WBGene00196374","II",8956103,8956247,144
"27843","WBGene00196375","IV",11872100,11872246,146
"27844","WBGene00196376","III",8776169,8776376,207
"27845","WBGene00196381","III",3637327,3637466,139
"27846","WBGene00196384","IV",11681471,11681620,149
"27847","WBGene00196388","III",9241659,9241793,134
"27848","WBGene00196389","I",514364,514492,128
"27849","WBGene00196390","X",8902996,8903117,121
"27850","WBGene00196391","III",9879320,9879469,149
"27851","WBGene00196392","V",6741720,6741865,145
"27852","WBGene00196393","X",11673449,11673578,129
"27853","WBGene00196394","I",774365,774585,220
"27854","WBGene00196396","I",15067668,15068355,687
"27855","WBGene00196397","I",5311869,5312003,134
"27856","WBGene00196398","I",9099016,9099154,138
"27857","WBGene00196400","IV",15318466,15318561,95
"27858","WBGene00196401","V",7072368,7072555,187
"27859","WBGene00196403","X",14711281,14711422,141
"27860","WBGene00196406","I",9734086,9734297,211
"27861","WBGene00196408","X",9740444,9740560,116
"27862","WBGene00196409","II",6411879,6412018,139
"27863","WBGene00196410","X",4009009,4009154,145
"27864","WBGene00196412","III",11564620,11564811,191
"27865","WBGene00196413","V",15499167,15499266,99
"27866","WBGene00196415","X",5543482,5543680,198
"27867","WBGene00196416","X",4403768,4403905,137
"27868","WBGene00196417","I",6810439,6810571,132
"27869","WBGene00196418","I",11977978,11978084,106
"27870","WBGene00196419","IV",6992877,6992968,91
"27871","WBGene00196420","III",7848235,7848376,141
"27872","WBGene00196422","X",3857990,3858125,135
"27873","WBGene00196424","X",14636539,14636667,128
"27874","WBGene00196425","X",14790168,14790441,273
"27875","WBGene00196428","I",2070673,2070891,218
"27876","WBGene00196431","V",20695921,20696144,223
"27877","WBGene00196435","X",5730733,5730864,131
"27878","WBGene00196436","V",8796368,8796557,189
"27879","WBGene00196439","II",12363098,12363170,72
"27880","WBGene00196440","V",6548579,6548722,143
"27881","WBGene00196441","IV",11710499,11710644,145
"27882","WBGene00196442","II",8946418,8946562,144
"27883","WBGene00196443","II",7969506,7969645,139
"27884","WBGene00196444","X",9079940,9080127,187
"27885","WBGene00196445","X",4429565,4429621,56
"27886","WBGene00196446","X",2901094,2901234,140
"27887","WBGene00196447","X",7531713,7531861,148
"27888","WBGene00196448","V",18024637,18024700,63
"27889","WBGene00196449","V",1371265,1371363,98
"27890","WBGene00196451","V",6563495,6563555,60
"27891","WBGene00196452","III",11554958,11555063,105
"27892","WBGene00196453","X",7665533,7665603,70
"27893","WBGene00196455","X",11211583,11211633,50
"27894","WBGene00196456","X",8580395,8580560,165
"27895","WBGene00196457","X",4635797,4635938,141
"27896","WBGene00196458","V",4157558,4157631,73
"27897","WBGene00196459","III",7217055,7217110,55
"27898","WBGene00196460","X",8006144,8006337,193
"27899","WBGene00196463","X",8436648,8436793,145
"27900","WBGene00196464","II",7569575,7569778,203
"27901","WBGene00196467","X",4789054,4789271,217
"27902","WBGene00196470","III",8371944,8372080,136
"27903","WBGene00196471","V",13199398,13199546,148
"27904","WBGene00196472","X",9086033,9086223,190
"27905","WBGene00196473","X",14915702,14915845,143
"27906","WBGene00196475","V",9238703,9238852,149
"27907","WBGene00196476","X",6163471,6163673,202
"27908","WBGene00196477","V",13219641,13219903,262
"27909","WBGene00196480","I",6047859,6047987,128
"27910","WBGene00196481","II",1319290,1319341,51
"27911","WBGene00196482","X",16523338,16523416,78
"27912","WBGene00196483","V",11711931,11712113,182
"27913","WBGene00196486","III",3588607,3588756,149
"27914","WBGene00196487","II",5740435,5740569,134
"27915","WBGene00196489","X",6494850,6494974,124
"27916","WBGene00196490","III",4104945,4105085,140
"27917","WBGene00196491","V",5955357,5955479,122
"27918","WBGene00196493","I",4334502,4334637,135
"27919","WBGene00196494","X",4551042,4551228,186
"27920","WBGene00196495","X",5667849,5667993,144
"27921","WBGene00196496","II",10986833,10986981,148
"27922","WBGene00196498","IV",5979445,5979594,149
"27923","WBGene00196500","V",11483836,11484013,177
"27924","WBGene00196501","V",10724632,10724977,345
"27925","WBGene00196502","I",12173706,12173912,206
"27926","WBGene00196504","X",11133896,11134039,143
"27927","WBGene00196506","X",11571852,11572062,210
"27928","WBGene00196509","V",5704989,5705238,249
"27929","WBGene00196511","X",8952130,8952471,341
"27930","WBGene00196515","II",8899595,8899744,149
"27931","WBGene00196516","II",7592095,7592240,145
"27932","WBGene00196517","I",2744953,2745118,165
"27933","WBGene00196518","IV",11791122,11791243,121
"27934","WBGene00196519","IV",11172410,11172539,129
"27935","WBGene00196521","II",5727769,5727959,190
"27936","WBGene00196522","V",10433903,10434032,129
"27937","WBGene00196523","II",7960626,7960769,143
"27938","WBGene00196524","IV",9362756,9362905,149
"27939","WBGene00196527","IV",1908586,1908702,116
"27940","WBGene00196528","V",13106808,13106955,147
"27941","WBGene00196529","V",6682537,6682842,305
"27942","WBGene00196531","X",13387661,13387807,146
"27943","WBGene00196532","X",9844581,9844693,112
"27944","WBGene00196533","I",5854783,5854865,82
"27945","WBGene00196535","IV",5100347,5100464,117
"27946","WBGene00196536","V",9442976,9443200,224
"27947","WBGene00196537","V",10914923,10915137,214
"27948","WBGene00196538","X",11057372,11057510,138
"27949","WBGene00196540","IV",3587571,3587719,148
"27950","WBGene00196541","III",2933117,2933283,166
"27951","WBGene00196542","II",6898187,6898286,99
"27952","WBGene00196545","IV",8048271,8048393,122
"27953","WBGene00196546","II",11013854,11013987,133
"27954","WBGene00196547","V",12326709,12326900,191
"27955","WBGene00196549","II",5861989,5862137,148
"27956","WBGene00196551","I",11567483,11567635,152
"27957","WBGene00196552","V",7175901,7176125,224
"27958","WBGene00196553","II",4492452,4492566,114
"27959","WBGene00196555","X",2513851,2514011,160
"27960","WBGene00196556","X",10801001,10801139,138
"27961","WBGene00196558","X",14068846,14068987,141
"27962","WBGene00196559","IV",12204970,12205165,195
"27963","WBGene00196560","X",11552207,11552272,65
"27964","WBGene00196561","V",6063818,6063949,131
"27965","WBGene00196562","II",6522696,6522814,118
"27966","WBGene00196563","II",7907689,7907828,139
"27967","WBGene00196564","IV",11039024,11039173,149
"27968","WBGene00196565","III",4461789,4461906,117
"27969","WBGene00196566","I",1447135,1447234,99
"27970","WBGene00196567","X",6777930,6778153,223
"27971","WBGene00196568","X",10613838,10614061,223
"27972","WBGene00196569","X",5748719,5748837,118
"27973","WBGene00196571","V",9633374,9633508,134
"27974","WBGene00196572","III",12230145,12230277,132
"27975","WBGene00196573","X",14490327,14490548,221
"27976","WBGene00196575","V",6021696,6021833,137
"27977","WBGene00196577","III",11355887,11356051,164
"27978","WBGene00196578","II",5885087,5885293,206
"27979","WBGene00196579","X",16646334,16646531,197
"27980","WBGene00196581","IV",11817364,11817588,224
"27981","WBGene00196582","X",11385729,11385872,143
"27982","WBGene00196583","IV",7212821,7212968,147
"27983","WBGene00196586","II",6832857,6832989,132
"27984","WBGene00196588","V",6204165,6204452,287
"27985","WBGene00196589","II",7716774,7716884,110
"27986","WBGene00196590","IV",11298659,11298802,143
"27987","WBGene00196591","X",3787771,3787918,147
"27988","WBGene00196592","X",2368440,2368713,273
"27989","WBGene00196593","X",5397449,5397575,126
"27990","WBGene00196594","IV",3837639,3837830,191
"27991","WBGene00196595","X",15448859,15449006,147
"27992","WBGene00196596","X",5173136,5173264,128
"27993","WBGene00196597","X",8654506,8654648,142
"27994","WBGene00196598","V",12974160,12974309,149
"27995","WBGene00196602","V",11711326,11711467,141
"27996","WBGene00196603","V",11031334,11031480,146
"27997","WBGene00196604","X",2592018,2592178,160
"27998","WBGene00196606","X",15342226,15342367,141
"27999","WBGene00196610","I",13643855,13644077,222
"28000","WBGene00196612","V",13052689,13052825,136
"28001","WBGene00196613","X",6588066,6588196,130
"28002","WBGene00196615","V",13600520,13600744,224
"28003","WBGene00196616","X",6991659,6991802,143
"28004","WBGene00196617","V",9911119,9911331,212
"28005","WBGene00196618","X",15664560,15664721,161
"28006","WBGene00196619","X",13657651,13657855,204
"28007","WBGene00196622","I",7611209,7611315,106
"28008","WBGene00196623","X",16147618,16147746,128
"28009","WBGene00196624","X",287772,287824,52
"28010","WBGene00196625","V",6342645,6342823,178
"28011","WBGene00196627","X",9091387,9091630,243
"28012","WBGene00196629","IV",7397569,7397843,274
"28013","WBGene00196630","X",13203577,13203716,139
"28014","WBGene00196631","V",7977866,7978005,139
"28015","WBGene00196632","X",5981806,5981924,118
"28016","WBGene00196635","V",6267789,6268010,221
"28017","WBGene00196637","X",2549520,2549605,85
"28018","WBGene00196639","I",7952463,7952648,185
"28019","WBGene00196640","II",162199,162345,146
"28020","WBGene00196641","X",7994487,7994609,122
"28021","WBGene00196642","X",2930312,2930469,157
"28022","WBGene00196643","X",14946772,14946938,166
"28023","WBGene00196644","V",10019997,10020293,296
"28024","WBGene00196645","X",8017426,8017573,147
"28025","WBGene00196646","X",3066117,3066244,127
"28026","WBGene00196648","V",11404667,11404810,143
"28027","WBGene00196649","III",8494177,8494320,143
"28028","WBGene00196650","IV",11793319,11793446,127
"28029","WBGene00196653","V",12335176,12335444,268
"28030","WBGene00196654","X",1934005,1934179,174
"28031","WBGene00196655","V",5803970,5804113,143
"28032","WBGene00196656","X",8771237,8771375,138
"28033","WBGene00196658","I",6887834,6887895,61
"28034","WBGene00196660","V",10722703,10722844,141
"28035","WBGene00196661","X",12088462,12088599,137
"28036","WBGene00196663","X",12084778,12084983,205
"28037","WBGene00196664","X",1931040,1931252,212
"28038","WBGene00196665","X",7033786,7033911,125
"28039","WBGene00196666","II",8631949,8632040,91
"28040","WBGene00196668","IV",651054,651115,61
"28041","WBGene00196669","III",11459270,11459419,149
"28042","WBGene00196670","III",9105823,9105889,66
"28043","WBGene00196672","X",12175905,12176054,149
"28044","WBGene00196673","IV",12786129,12786255,126
"28045","WBGene00196674","X",12059812,12059925,113
"28046","WBGene00196676","X",2213659,2214017,358
"28047","WBGene00196678","V",11806516,11806583,67
"28048","WBGene00196679","I",10040005,10040223,218
"28049","WBGene00196681","X",4978174,4978288,114
"28050","WBGene00196682","X",13504092,13504295,203
"28051","WBGene00196683","X",8393532,8393618,86
"28052","WBGene00196684","X",3563816,3563991,175
"28053","WBGene00196685","X",2212242,2212532,290
"28054","WBGene00196686","X",11382134,11382222,88
"28055","WBGene00196687","X",6040587,6040729,142
"28056","WBGene00196688","V",20479374,20479505,131
"28057","WBGene00196689","IV",8028511,8028657,146
"28058","WBGene00196690","V",7035362,7035564,202
"28059","WBGene00196691","X",8765333,8765478,145
"28060","WBGene00196692","X",90282,90420,138
"28061","WBGene00196693","X",13008229,13008419,190
"28062","WBGene00196694","II",6133710,6133913,203
"28063","WBGene00196695","IV",10159601,10159690,89
"28064","WBGene00196696","III",3066337,3066468,131
"28065","WBGene00196700","X",14649232,14649571,339
"28066","WBGene00196701","V",12801220,12801443,223
"28067","WBGene00196702","IV",11783071,11783205,134
"28068","WBGene00196703","I",11537529,11537591,62
"28069","WBGene00196704","X",4294742,4294952,210
"28070","WBGene00196706","X",3802780,3802891,111
"28071","WBGene00196707","III",4754236,4754352,116
"28072","WBGene00196708","X",7460608,7460734,126
"28073","WBGene00196709","V",11078481,11078624,143
"28074","WBGene00196710","V",10569880,10570016,136
"28075","WBGene00196711","II",9992455,9992575,120
"28076","WBGene00196712","II",8451550,8451730,180
"28077","WBGene00196713","II",3422222,3422292,70
"28078","WBGene00196715","V",11658659,11658835,176
"28079","WBGene00196716","X",9468212,9468344,132
"28080","WBGene00196718","I",10927581,10927663,82
"28081","WBGene00196719","X",7721082,7721230,148
"28082","WBGene00196720","I",10246503,10246653,150
"28083","WBGene00196721","I",6554504,6554709,205
"28084","WBGene00196723","X",2869542,2869745,203
"28085","WBGene00196725","III",11471821,11471955,134
"28086","WBGene00196727","II",7806220,7806376,156
"28087","WBGene00196728","X",14829758,14829895,137
"28088","WBGene00196729","IV",10175145,10175378,233
"28089","WBGene00196730","V",16764704,16764852,148
"28090","WBGene00196731","X",15994215,15994438,223
"28091","WBGene00196733","IV",6996202,6996550,348
"28092","WBGene00196735","V",10721144,10721427,283
"28093","WBGene00196736","III",4200502,4200547,45
"28094","WBGene00196737","X",6577916,6578060,144
"28095","WBGene00196740","IV",5727770,5727919,149
"28096","WBGene00196741","X",3622312,3622434,122
"28097","WBGene00196742","X",2331738,2331817,79
"28098","WBGene00196743","I",9853886,9854158,272
"28099","WBGene00196744","IV",6462184,6462340,156
"28100","WBGene00196745","X",11574723,11574938,215
"28101","WBGene00196746","X",750576,750657,81
"28102","WBGene00196747","III",3307303,3307353,50
"28103","WBGene00196749","II",1371296,1371349,53
"28104","WBGene00196751","V",6247771,6247971,200
"28105","WBGene00196753","X",5858696,5859141,445
"28106","WBGene00196755","X",11519146,11519236,90
"28107","WBGene00196758","IV",10973725,10973948,223
"28108","WBGene00196759","V",11954900,11955029,129
"28109","WBGene00196762","II",2978039,2978092,53
"28110","WBGene00196763","X",9330691,9330941,250
"28111","WBGene00196764","X",6046880,6047029,149
"28112","WBGene00196765","X",7467152,7467296,144
"28113","WBGene00196766","V",11696017,11696141,124
"28114","WBGene00196768","I",14949930,14949980,50
"28115","WBGene00196770","X",15107986,15108210,224
"28116","WBGene00196771","II",2228069,2228122,53
"28117","WBGene00196772","X",3423203,3423252,49
"28118","WBGene00196775","V",13688859,13689004,145
"28119","WBGene00196777","V",8948483,8948613,130
"28120","WBGene00196778","IV",5598629,5598685,56
"28121","WBGene00196779","X",3156506,3156599,93
"28122","WBGene00196780","I",9425033,9425233,200
"28123","WBGene00196781","I",512017,512166,149
"28124","WBGene00196782","IV",3283750,3283899,149
"28125","WBGene00196783","III",4524864,4525065,201
"28126","WBGene00196784","X",6390059,6390200,141
"28127","WBGene00196785","III",6030837,6030961,124
"28128","WBGene00196786","II",6031206,6031349,143
"28129","WBGene00196787","III",8132596,8132733,137
"28130","WBGene00196789","X",3867756,3868026,270
"28131","WBGene00196791","I",3280163,3280267,104
"28132","WBGene00196792","IV",6182295,6182547,252
"28133","WBGene00196793","X",14030136,14030311,175
"28134","WBGene00196795","IV",5862949,5863087,138
"28135","WBGene00196796","I",2835837,2835984,147
"28136","WBGene00196797","X",15279339,15279459,120
"28137","WBGene00196798","X",16604710,16604802,92
"28138","WBGene00196799","V",11869443,11869515,72
"28139","WBGene00196802","I",9541168,9541223,55
"28140","WBGene00196803","II",8984865,8985001,136
"28141","WBGene00196804","X",6071657,6071720,63
"28142","WBGene00196805","V",12537647,12537700,53
"28143","WBGene00196807","X",2333510,2333646,136
"28144","WBGene00196808","X",15751417,15751494,77
"28145","WBGene00196809","X",15189812,15189958,146
"28146","WBGene00196810","X",5841170,5841350,180
"28147","WBGene00196811","V",11947551,11947698,147
"28148","WBGene00196812","V",19119402,19119455,53
"28149","WBGene00196814","X",10505095,10505522,427
"28150","WBGene00196815","X",14690487,14690703,216
"28151","WBGene00196816","V",9091451,9091627,176
"28152","WBGene00196817","IV",2983851,2983954,103
"28153","WBGene00196818","III",5964589,5964711,122
"28154","WBGene00196819","II",6828871,6829075,204
"28155","WBGene00196820","X",7518941,7519090,149
"28156","WBGene00196821","IV",126263,126391,128
"28157","WBGene00196822","V",11174780,11174875,95
"28158","WBGene00196825","V",14524351,14524500,149
"28159","WBGene00196826","IV",5964772,5964873,101
"28160","WBGene00196827","II",5544173,5544291,118
"28161","WBGene00196829","V",8456008,8456095,87
"28162","WBGene00196830","II",6182085,6182302,217
"28163","WBGene00196831","II",6161363,6161506,143
"28164","WBGene00196832","V",14468572,14468746,174
"28165","WBGene00196834","V",9181689,9181838,149
"28166","WBGene00196836","V",13294231,13294354,123
"28167","WBGene00196837","I",11596211,11596263,52
"28168","WBGene00196838","V",12296887,12297125,238
"28169","WBGene00196840","V",11210146,11210292,146
"28170","WBGene00196841","X",2764816,2764895,79
"28171","WBGene00196842","II",7988230,7988362,132
"28172","WBGene00196843","X",5726346,5726495,149
"28173","WBGene00196845","V",6697871,6698001,130
"28174","WBGene00196846","IV",6910158,6910307,149
"28175","WBGene00196847","III",1794934,1795047,113
"28176","WBGene00196848","III",8390219,8390367,148
"28177","WBGene00196851","IV",189234,189321,87
"28178","WBGene00196852","IV",10503673,10503934,261
"28179","WBGene00196853","V",12877915,12878062,147
"28180","WBGene00196854","V",5582801,5583021,220
"28181","WBGene00196856","III",9764747,9765109,362
"28182","WBGene00196858","III",8452967,8453099,132
"28183","WBGene00196859","II",11657211,11657410,199
"28184","WBGene00196860","V",11351856,11351985,129
"28185","WBGene00196861","IV",5388820,5389044,224
"28186","WBGene00196863","X",16274497,16274565,68
"28187","WBGene00196865","III",1099649,1099702,53
"28188","WBGene00196867","IV",7098571,7098933,362
"28189","WBGene00196868","V",5403849,5403997,148
"28190","WBGene00196870","III",5520700,5520896,196
"28191","WBGene00196872","V",9731015,9731311,296
"28192","WBGene00196873","X",5734074,5734192,118
"28193","WBGene00196874","II",5718085,5718223,138
"28194","WBGene00196875","IV",1192710,1192762,52
"28195","WBGene00196877","V",6480533,6480749,216
"28196","WBGene00196878","IV",743463,743762,299
"28197","WBGene00196879","I",5084898,5085028,130
"28198","WBGene00196882","V",11502362,11502489,127
"28199","WBGene00196884","X",7151458,7151745,287
"28200","WBGene00196885","V",8041671,8041721,50
"28201","WBGene00196886","II",7428521,7428670,149
"28202","WBGene00196887","V",12338853,12338968,115
"28203","WBGene00196888","X",2447104,2447245,141
"28204","WBGene00196890","I",14676120,14676189,69
"28205","WBGene00196892","II",10072419,10072636,217
"28206","WBGene00196893","V",6346277,6346425,148
"28207","WBGene00196894","X",3896430,3896579,149
"28208","WBGene00196895","X",10126421,10126535,114
"28209","WBGene00196896","II",14080478,14080627,149
"28210","WBGene00196898","V",5674478,5674609,131
"28211","WBGene00196899","V",19371970,19372040,70
"28212","WBGene00196900","IV",5073957,5074104,147
"28213","WBGene00196901","V",18503095,18503171,76
"28214","WBGene00196902","V",5973952,5974092,140
"28215","WBGene00196903","I",5586356,5586492,136
"28216","WBGene00196904","IV",10981549,10981674,125
"28217","WBGene00196906","IV",12419459,12419603,144
"28218","WBGene00196908","II",5358434,5358583,149
"28219","WBGene00196909","X",5249160,5249292,132
"28220","WBGene00196910","III",7465784,7465933,149
"28221","WBGene00196912","IV",13333115,13333300,185
"28222","WBGene00196913","II",5465296,5465513,217
"28223","WBGene00196914","X",5973796,5973911,115
"28224","WBGene00196916","III",6326758,6326826,68
"28225","WBGene00196917","I",10103210,10103353,143
"28226","WBGene00196918","X",5866711,5866847,136
"28227","WBGene00196919","X",9863231,9863450,219
"28228","WBGene00196921","III",12130507,12130646,139
"28229","WBGene00196925","X",10432888,10433014,126
"28230","WBGene00196928","V",5865674,5865822,148
"28231","WBGene00196929","X",11560203,11560460,257
"28232","WBGene00196931","IV",12126761,12127057,296
"28233","WBGene00196932","V",18792835,18792932,97
"28234","WBGene00196933","III",10506679,10506825,146
"28235","WBGene00196934","I",996207,996655,448
"28236","WBGene00196935","V",6355695,6355895,200
"28237","WBGene00196937","X",10726971,10727108,137
"28238","WBGene00196939","II",10087825,10088008,183
"28239","WBGene00196941","X",2143478,2143598,120
"28240","WBGene00196942","V",12736228,12736352,124
"28241","WBGene00196943","IV",9957234,9957381,147
"28242","WBGene00196944","V",14986771,14986919,148
"28243","WBGene00196946","X",10593777,10593994,217
"28244","WBGene00196947","X",4700037,4700130,93
"28245","WBGene00196948","X",7588004,7588152,148
"28246","WBGene00196949","II",11288400,11288599,199
"28247","WBGene00196950","II",6482824,6482946,122
"28248","WBGene00196952","X",9876016,9876140,124
"28249","WBGene00196953","X",15682203,15682342,139
"28250","WBGene00196955","V",7035625,7035837,212
"28251","WBGene00196956","V",11979959,11980101,142
"28252","WBGene00196957","V",9287688,9288024,336
"28253","WBGene00196959","X",13351389,13351569,180
"28254","WBGene00196960","III",6835668,6835810,142
"28255","WBGene00196961","X",14970458,14970580,122
"28256","WBGene00196962","IV",6756243,6756442,199
"28257","WBGene00196964","X",13780119,13780267,148
"28258","WBGene00196965","X",8445182,8445331,149
"28259","WBGene00196966","X",7753341,7753484,143
"28260","WBGene00196967","X",6916475,6916664,189
"28261","WBGene00196968","II",10804628,10804812,184
"28262","WBGene00196969","X",6737129,6737276,147
"28263","WBGene00196971","X",2906462,2906663,201
"28264","WBGene00196973","III",6158772,6158871,99
"28265","WBGene00196974","X",6886681,6886736,55
"28266","WBGene00196977","X",5084223,5084369,146
"28267","WBGene00196979","X",4125940,4126084,144
"28268","WBGene00196980","IV",6061939,6062071,132
"28269","WBGene00196981","III",8576121,8576319,198
"28270","WBGene00196982","III",11738584,11738685,101
"28271","WBGene00196983","III",7536700,7536888,188
"28272","WBGene00196985","IV",12217377,12217444,67
"28273","WBGene00196986","X",14557438,14557777,339
"28274","WBGene00196987","V",9062881,9063143,262
"28275","WBGene00196988","II",13167847,13167984,137
"28276","WBGene00196990","V",6549134,6549258,124
"28277","WBGene00196992","II",6613885,6614023,138
"28278","WBGene00196993","I",7034159,7034366,207
"28279","WBGene00196994","II",7892058,7892192,134
"28280","WBGene00196995","IV",877492,877561,69
"28281","WBGene00196996","V",6527059,6527207,148
"28282","WBGene00196997","V",12277081,12277131,50
"28283","WBGene00196998","V",15517406,15517472,66
"28284","WBGene00197000","X",6160557,6160697,140
"28285","WBGene00197001","V",12114786,12114982,196
"28286","WBGene00197002","IV",7686028,7686237,209
"28287","WBGene00197003","II",11157793,11157934,141
"28288","WBGene00197004","IV",12522529,12522625,96
"28289","WBGene00197005","I",9752385,9752527,142
"28290","WBGene00197010","V",10634350,10634464,114
"28291","WBGene00197013","V",11958072,11958253,181
"28292","WBGene00197014","I",10674283,10674414,131
"28293","WBGene00197017","V",8541783,8541905,122
"28294","WBGene00197021","III",1524956,1525004,48
"28295","WBGene00197022","II",15120135,15120232,97
"28296","WBGene00197023","IV",3233519,3233663,144
"28297","WBGene00197024","X",3201083,3201230,147
"28298","WBGene00197025","X",7945252,7945391,139
"28299","WBGene00197027","X",4265613,4265812,199
"28300","WBGene00197030","X",8481879,8482059,180
"28301","WBGene00197031","II",9572276,9572342,66
"28302","WBGene00197033","II",9061612,9061833,221
"28303","WBGene00197036","V",12583408,12583541,133
"28304","WBGene00197037","III",10747948,10748170,222
"28305","WBGene00197038","X",13196141,13196402,261
"28306","WBGene00197039","III",445651,445781,130
"28307","WBGene00197040","IV",7093164,7093312,148
"28308","WBGene00197041","IV",787367,787430,63
"28309","WBGene00197042","III",6836979,6837124,145
"28310","WBGene00197043","X",17073097,17073245,148
"28311","WBGene00197044","I",9548997,9549110,113
"28312","WBGene00197045","V",10819943,10820145,202
"28313","WBGene00197047","II",11493042,11493183,141
"28314","WBGene00197048","III",8510340,8510479,139
"28315","WBGene00197049","II",14893746,14893812,66
"28316","WBGene00197050","III",10153240,10153388,148
"28317","WBGene00197053","V",10457598,10457875,277
"28318","WBGene00197054","III",9130889,9131032,143
"28319","WBGene00197057","IV",7841504,7841651,147
"28320","WBGene00197059","I",6456341,6456487,146
"28321","WBGene00197060","V",16592217,16592319,102
"28322","WBGene00197062","I",3260309,3260458,149
"28323","WBGene00197063","I",5358369,5358507,138
"28324","WBGene00197064","X",15553164,15553294,130
"28325","WBGene00197065","II",10658897,10659108,211
"28326","WBGene00197066","V",6355357,6355892,535
"28327","WBGene00197068","II",6170348,6170485,137
"28328","WBGene00197069","IV",2388949,2389097,148
"28329","WBGene00197070","X",9225395,9225480,85
"28330","WBGene00197072","X",7217823,7218094,271
"28331","WBGene00197078","V",5780869,5781015,146
"28332","WBGene00197079","X",3971863,3972002,139
"28333","WBGene00197080","V",20278113,20278412,299
"28334","WBGene00197081","V",10841714,10841845,131
"28335","WBGene00197082","II",10957969,10958057,88
"28336","WBGene00197083","V",8247479,8247574,95
"28337","WBGene00197085","II",7966314,7966428,114
"28338","WBGene00197086","X",10932109,10932302,193
"28339","WBGene00197087","X",2763910,2764052,142
"28340","WBGene00197088","V",20312423,20312570,147
"28341","WBGene00197090","II",8844702,8844924,222
"28342","WBGene00197093","IV",11166053,11166123,70
"28343","WBGene00197094","IV",10190724,10190861,137
"28344","WBGene00197095","II",6531858,6532076,218
"28345","WBGene00197097","X",8285404,8285627,223
"28346","WBGene00197099","IV",3634982,3635120,138
"28347","WBGene00197100","III",6819699,6819817,118
"28348","WBGene00197101","X",5801202,5801283,81
"28349","WBGene00197103","X",16626870,16627004,134
"28350","WBGene00197104","V",10490340,10490634,294
"28351","WBGene00197105","II",6685533,6685681,148
"28352","WBGene00197106","III",6831775,6831923,148
"28353","WBGene00197108","V",5847611,5847679,68
"28354","WBGene00197109","III",11472431,11472608,177
"28355","WBGene00197110","V",5957259,5957408,149
"28356","WBGene00197111","IV",1689060,1689209,149
"28357","WBGene00197112","I",14530932,14530980,48
"28358","WBGene00197113","V",10461849,10461997,148
"28359","WBGene00197117","X",14958243,14958462,219
"28360","WBGene00197118","X",6164766,6164983,217
"28361","WBGene00197119","V",9422918,9423123,205
"28362","WBGene00197120","X",2389140,2389285,145
"28363","WBGene00197121","I",12223553,12223605,52
"28364","WBGene00197122","V",8441870,8441925,55
"28365","WBGene00197123","II",5902211,5902355,144
"28366","WBGene00197124","X",10128544,10128675,131
"28367","WBGene00197125","V",4525961,4526031,70
"28368","WBGene00197126","V",13290567,13290716,149
"28369","WBGene00197127","V",7733562,7733774,212
"28370","WBGene00197129","IV",11353130,11353270,140
"28371","WBGene00197130","X",10667012,10667102,90
"28372","WBGene00197132","X",2099232,2099404,172
"28373","WBGene00197133","V",16764925,16765074,149
"28374","WBGene00197134","X",16551509,16551583,74
"28375","WBGene00197135","X",14694689,14694855,166
"28376","WBGene00197136","II",11285443,11285576,133
"28377","WBGene00197137","X",11124071,11124217,146
"28378","WBGene00197138","I",10389626,10389774,148
"28379","WBGene00197140","I",8852826,8852917,91
"28380","WBGene00197141","V",9250109,9250171,62
"28381","WBGene00197142","I",8722388,8722612,224
"28382","WBGene00197144","IV",11842183,11842327,144
"28383","WBGene00197145","II",581488,581554,66
"28384","WBGene00197147","II",10991323,10991436,113
"28385","WBGene00197148","IV",7407405,7407538,133
"28386","WBGene00197149","IV",10568909,10569016,107
"28387","WBGene00197150","I",8264201,8264286,85
"28388","WBGene00197151","X",13936988,13937259,271
"28389","WBGene00197152","IV",16388408,16388565,157
"28390","WBGene00197153","X",12440863,12441010,147
"28391","WBGene00197154","X",9932378,9932547,169
"28392","WBGene00197155","V",12370042,12370181,139
"28393","WBGene00197156","I",11457137,11457225,88
"28394","WBGene00197159","V",13232328,13232468,140
"28395","WBGene00197162","I",757536,757618,82
"28396","WBGene00197163","II",7717241,7717382,141
"28397","WBGene00197164","II",6639409,6639491,82
"28398","WBGene00197166","I",9547208,9547351,143
"28399","WBGene00197168","X",10431075,10431256,181
"28400","WBGene00197169","X",9378565,9378695,130
"28401","WBGene00197170","X",8945150,8945233,83
"28402","WBGene00197172","III",4104733,4104878,145
"28403","WBGene00197173","X",5793806,5793926,120
"28404","WBGene00197174","X",3788597,3788731,134
"28405","WBGene00197175","IV",7414416,7414559,143
"28406","WBGene00197176","V",19167843,19167896,53
"28407","WBGene00197177","I",11978757,11978847,90
"28408","WBGene00197178","X",7327015,7327171,156
"28409","WBGene00197179","III",11467643,11467761,118
"28410","WBGene00197180","IV",5803092,5803234,142
"28411","WBGene00197183","V",11379092,11379310,218
"28412","WBGene00197184","III",8452081,8452207,126
"28413","WBGene00197185","X",14912639,14912770,131
"28414","WBGene00197186","X",14761105,14761253,148
"28415","WBGene00197188","II",13029816,13029949,133
"28416","WBGene00197189","X",16643439,16643588,149
"28417","WBGene00197191","III",7624120,7624202,82
"28418","WBGene00197192","III",8290296,8290441,145
"28419","WBGene00197194","X",10310667,10310755,88
"28420","WBGene00197195","IV",4536075,4536215,140
"28421","WBGene00197199","II",6818627,6818771,144
"28422","WBGene00197200","X",11000302,11000369,67
"28423","WBGene00197201","X",4949953,4950087,134
"28424","WBGene00197202","X",15405897,15406027,130
"28425","WBGene00197203","X",3080884,3081072,188
"28426","WBGene00197205","X",12205769,12205903,134
"28427","WBGene00197206","X",6482778,6482926,148
"28428","WBGene00197207","V",11191223,11191427,204
"28429","WBGene00197208","III",10136781,10136911,130
"28430","WBGene00197209","V",13082792,13082934,142
"28431","WBGene00197210","II",5453808,5453951,143
"28432","WBGene00197211","X",8882381,8882472,91
"28433","WBGene00197212","V",5133176,5133325,149
"28434","WBGene00197214","II",11020904,11020995,91
"28435","WBGene00197217","X",15659773,15659919,146
"28436","WBGene00197218","V",11087291,11087478,187
"28437","WBGene00197219","X",10310826,10310923,97
"28438","WBGene00197221","X",4110058,4110231,173
"28439","WBGene00197222","V",6017718,6017851,133
"28440","WBGene00197223","X",2885522,2885645,123
"28441","WBGene00197225","V",11167918,11168057,139
"28442","WBGene00197227","II",6826783,6826930,147
"28443","WBGene00197228","V",10043437,10043561,124
"28444","WBGene00197229","I",9909325,9909435,110
"28445","WBGene00197231","II",14250504,14250651,147
"28446","WBGene00197234","I",5357541,5357785,244
"28447","WBGene00197235","X",5722043,5722229,186
"28448","WBGene00197236","II",6414084,6414206,122
"28449","WBGene00197237","II",11547622,11547771,149
"28450","WBGene00197238","IV",5662888,5663110,222
"28451","WBGene00197239","V",12338893,12339022,129
"28452","WBGene00197240","IV",11428990,11429099,109
"28453","WBGene00197241","IV",3524812,3524902,90
"28454","WBGene00197242","V",11899908,11900052,144
"28455","WBGene00197243","X",16619321,16619411,90
"28456","WBGene00197244","X",8889085,8889189,104
"28457","WBGene00197245","III",5931430,5931560,130
"28458","WBGene00197249","V",5521640,5521767,127
"28459","WBGene00197250","V",11341412,11341705,293
"28460","WBGene00197251","V",11063241,11063347,106
"28461","WBGene00197252","X",6887128,6887275,147
"28462","WBGene00197253","X",16886246,16886423,177
"28463","WBGene00197256","X",5362029,5362170,141
"28464","WBGene00197257","IV",11494936,11495338,402
"28465","WBGene00197258","I",7993295,7993579,284
"28466","WBGene00197259","I",11666412,11666470,58
"28467","WBGene00197260","V",13209685,13209825,140
"28468","WBGene00197261","II",5749915,5750029,114
"28469","WBGene00197262","X",13812098,13812389,291
"28470","WBGene00197264","I",834416,834465,49
"28471","WBGene00197265","II",8353440,8353637,197
"28472","WBGene00197269","X",16608652,16608876,224
"28473","WBGene00197270","X",12890274,12890360,86
"28474","WBGene00197272","IV",8080849,8080965,116
"28475","WBGene00197275","IV",10189700,10190102,402
"28476","WBGene00197277","I",2070216,2070358,142
"28477","WBGene00197278","V",13166271,13166493,222
"28478","WBGene00197279","V",8796630,8796928,298
"28479","WBGene00197280","V",8051056,8051319,263
"28480","WBGene00197281","III",11727182,11727252,70
"28481","WBGene00197282","II",12354668,12354763,95
"28482","WBGene00197284","III",3799393,3799447,54
"28483","WBGene00197286","X",5115749,5115880,131
"28484","WBGene00197287","IV",1183790,1183864,74
"28485","WBGene00197288","V",6359286,6359427,141
"28486","WBGene00197289","V",11246947,11247124,177
"28487","WBGene00197291","IV",146729,146845,116
"28488","WBGene00197293","II",7549436,7549584,148
"28489","WBGene00197296","X",2661904,2662027,123
"28490","WBGene00197298","III",4666950,4667236,286
"28491","WBGene00197299","X",4761909,4762046,137
"28492","WBGene00197300","X",11124651,11124943,292
"28493","WBGene00197301","V",5062505,5062649,144
"28494","WBGene00197302","II",4818454,4818602,148
"28495","WBGene00197303","I",9789221,9789490,269
"28496","WBGene00197304","II",11803105,11803254,149
"28497","WBGene00197305","I",9571921,9572094,173
"28498","WBGene00197306","III",1808775,1808924,149
"28499","WBGene00197307","III",11477937,11478086,149
"28500","WBGene00197308","IV",7491551,7491691,140
"28501","WBGene00197310","X",7642390,7642598,208
"28502","WBGene00197313","V",5699947,5700119,172
"28503","WBGene00197314","X",3315454,3315733,279
"28504","WBGene00197315","IV",9949583,9949707,124
"28505","WBGene00197316","II",7465008,7465152,144
"28506","WBGene00197317","V",3591805,3591862,57
"28507","WBGene00197320","X",2128153,2128235,82
"28508","WBGene00197321","X",10431730,10431790,60
"28509","WBGene00197322","III",9730478,9730614,136
"28510","WBGene00197324","I",9379946,9380095,149
"28511","WBGene00197326","V",8558141,8558290,149
"28512","WBGene00197327","X",11448362,11448507,145
"28513","WBGene00197328","II",5858603,5858772,169
"28514","WBGene00197330","V",2619315,2619368,53
"28515","WBGene00197331","III",6666582,6666661,79
"28516","WBGene00197332","X",14955307,14955592,285
"28517","WBGene00197334","V",6744040,6744185,145
"28518","WBGene00197335","III",5603596,5603756,160
"28519","WBGene00197336","II",4354957,4355047,90
"28520","WBGene00197338","X",851723,852022,299
"28521","WBGene00197339","V",18581397,18581693,296
"28522","WBGene00197342","II",11200560,11200671,111
"28523","WBGene00197343","II",13932490,13932620,130
"28524","WBGene00197344","X",3329562,3329700,138
"28525","WBGene00197347","IV",17451530,17451714,184
"28526","WBGene00197349","X",4555943,4556374,431
"28527","WBGene00197350","II",8984758,8984819,61
"28528","WBGene00197351","III",8811149,8811287,138
"28529","WBGene00197353","I",12672255,12672320,65
"28530","WBGene00197354","V",9959727,9959833,106
"28531","WBGene00197356","X",16389915,16390010,95
"28532","WBGene00197357","V",18696381,18696527,146
"28533","WBGene00197359","X",6951153,6951298,145
"28534","WBGene00197360","X",4498491,4498652,161
"28535","WBGene00197361","I",1307480,1307624,144
"28536","WBGene00197362","X",12205978,12206100,122
"28537","WBGene00197363","V",6709123,6709275,152
"28538","WBGene00197364","I",9539531,9539670,139
"28539","WBGene00197367","V",11705489,11705693,204
"28540","WBGene00197370","IV",3709405,3709456,51
"28541","WBGene00197372","X",7468296,7468422,126
"28542","WBGene00197374","III",9348294,9348424,130
"28543","WBGene00197375","V",6347067,6347207,140
"28544","WBGene00197376","IV",4579856,4580181,325
"28545","WBGene00197377","X",4584743,4584867,124
"28546","WBGene00197378","I",10593124,10593216,92
"28547","WBGene00197380","X",8421212,8421314,102
"28548","WBGene00197381","X",4554368,4554582,214
"28549","WBGene00197382","V",6246582,6246912,330
"28550","WBGene00197383","X",2778005,2778282,277
"28551","WBGene00197384","V",5561257,5561348,91
"28552","WBGene00197385","II",6565360,6565482,122
"28553","WBGene00197386","IV",15793408,15793497,89
"28554","WBGene00197389","X",6691416,6691549,133
"28555","WBGene00197390","X",16730568,16730700,132
"28556","WBGene00197391","III",8069340,8069485,145
"28557","WBGene00197392","II",330956,331105,149
"28558","WBGene00197393","V",15499497,15499605,108
"28559","WBGene00197395","II",12268961,12269053,92
"28560","WBGene00197396","X",11287860,11287997,137
"28561","WBGene00197397","IV",3085848,3086069,221
"28562","WBGene00197398","V",10680970,10681114,144
"28563","WBGene00197402","X",4885015,4885156,141
"28564","WBGene00197403","X",2215820,2215941,121
"28565","WBGene00197405","II",2526970,2527019,49
"28566","WBGene00197406","X",12875748,12875950,202
"28567","WBGene00197407","X",8357321,8357526,205
"28568","WBGene00197408","IV",9477546,9477765,219
"28569","WBGene00197409","III",9306855,9306990,135
"28570","WBGene00197410","II",5768222,5768345,123
"28571","WBGene00197411","I",4975375,4975508,133
"28572","WBGene00197412","II",11314157,11314295,138
"28573","WBGene00197414","X",9699773,9699889,116
"28574","WBGene00197415","X",3793543,3793641,98
"28575","WBGene00197416","X",8442206,8442344,138
"28576","WBGene00197417","X",5209712,5209789,77
"28577","WBGene00197418","X",6969761,6969976,215
"28578","WBGene00197420","IV",4674389,4674506,117
"28579","WBGene00197421","X",7861791,7861996,205
"28580","WBGene00197422","X",11385739,11385879,140
"28581","WBGene00197423","II",11147194,11147418,224
"28582","WBGene00197424","III",10816925,10817064,139
"28583","WBGene00197426","II",8751152,8751359,207
"28584","WBGene00197428","III",9305890,9306028,138
"28585","WBGene00197429","X",12092308,12092502,194
"28586","WBGene00197431","IV",3132022,3132136,114
"28587","WBGene00197432","I",6882058,6882188,130
"28588","WBGene00197434","X",7643910,7644052,142
"28589","WBGene00197436","V",5218250,5218383,133
"28590","WBGene00197437","X",8668660,8668803,143
"28591","WBGene00197439","X",3064422,3064626,204
"28592","WBGene00197440","III",13016107,13016179,72
"28593","WBGene00197441","I",6212695,6212915,220
"28594","WBGene00197442","II",11329194,11329338,144
"28595","WBGene00197444","X",16482971,16483177,206
"28596","WBGene00197446","III",3587601,3587747,146
"28597","WBGene00197448","II",5289160,5289295,135
"28598","WBGene00197451","X",14653660,14653883,223
"28599","WBGene00197452","X",5477799,5477932,133
"28600","WBGene00197454","V",12245360,12245509,149
"28601","WBGene00197455","X",14958295,14958504,209
"28602","WBGene00197456","IV",13071109,13071228,119
"28603","WBGene00197457","I",6934996,6935252,256
"28604","WBGene00197459","X",3214546,3214695,149
"28605","WBGene00197461","X",14818981,14819119,138
"28606","WBGene00197462","X",12674475,12674686,211
"28607","WBGene00197463","X",5298123,5298270,147
"28608","WBGene00197464","X",4422886,4422964,78
"28609","WBGene00197465","X",5475493,5475688,195
"28610","WBGene00197466","X",2922241,2922384,143
"28611","WBGene00197467","V",12221203,12221423,220
"28612","WBGene00197468","V",11347113,11347315,202
"28613","WBGene00197469","IV",6051991,6052089,98
"28614","WBGene00197470","IV",4670104,4670253,149
"28615","WBGene00197472","IV",4570693,4570957,264
"28616","WBGene00197473","X",10846439,10846573,134
"28617","WBGene00197475","X",5697449,5697671,222
"28618","WBGene00197477","V",6195703,6195974,271
"28619","WBGene00197478","II",1106019,1106239,220
"28620","WBGene00197479","X",9254318,9254461,143
"28621","WBGene00197482","X",4550089,4550290,201
"28622","WBGene00197483","V",7069737,7069884,147
"28623","WBGene00197484","X",11241791,11242014,223
"28624","WBGene00197485","IV",5706885,5706981,96
"28625","WBGene00197486","III",7215795,7215958,163
"28626","WBGene00197487","X",607910,608134,224
"28627","WBGene00197488","X",6894101,6894238,137
"28628","WBGene00197489","II",6211584,6211671,87
"28629","WBGene00197491","V",12325636,12325770,134
"28630","WBGene00197492","X",10113665,10113814,149
"28631","WBGene00197493","V",10718461,10718597,136
"28632","WBGene00197495","X",2522331,2522617,286
"28633","WBGene00197496","II",7589731,7589867,136
"28634","WBGene00197498","X",2520713,2520843,130
"28635","WBGene00197499","X",7590955,7591074,119
"28636","WBGene00197501","V",10592928,10593073,145
"28637","WBGene00197502","II",6714025,6714134,109
"28638","WBGene00197503","I",3099681,3099769,88
"28639","WBGene00197505","I",4856793,4856938,145
"28640","WBGene00197507","X",4809364,4809504,140
"28641","WBGene00197510","X",15014085,15014224,139
"28642","WBGene00197511","X",4154959,4155023,64
"28643","WBGene00197514","III",4357998,4358057,59
"28644","WBGene00197515","X",13351505,13351635,130
"28645","WBGene00197517","X",7823385,7823525,140
"28646","WBGene00197520","V",7225132,7225333,201
"28647","WBGene00197521","V",6797018,6797166,148
"28648","WBGene00197522","X",10924218,10924354,136
"28649","WBGene00197523","V",11959711,11959851,140
"28650","WBGene00197524","V",11791042,11791191,149
"28651","WBGene00197525","V",6659870,6659936,66
"28652","WBGene00197529","IV",11899289,11899426,137
"28653","WBGene00197531","X",12049521,12049659,138
"28654","WBGene00197532","X",13198230,13198348,118
"28655","WBGene00197533","II",2442409,2442480,71
"28656","WBGene00197534","IV",11858183,11858326,143
"28657","WBGene00197536","III",1513840,1513892,52
"28658","WBGene00197537","V",1978901,1979022,121
"28659","WBGene00197539","III",7524270,7524355,85
"28660","WBGene00197540","II",4106587,4106674,87
"28661","WBGene00197541","IV",8175041,8175118,77
"28662","WBGene00197542","V",6466387,6466567,180
"28663","WBGene00197543","X",10591447,10591586,139
"28664","WBGene00197544","X",15769998,15770092,94
"28665","WBGene00197545","II",15136253,15136401,148
"28666","WBGene00197546","X",17565811,17566022,211
"28667","WBGene00197547","V",19148451,19148615,164
"28668","WBGene00197548","X",15189419,15189680,261
"28669","WBGene00197552","II",3501821,3502045,224
"28670","WBGene00197553","X",8003572,8003705,133
"28671","WBGene00197554","X",3741541,3741741,200
"28672","WBGene00197555","IV",3254734,3254824,90
"28673","WBGene00197556","X",5085607,5085701,94
"28674","WBGene00197557","X",2763504,2763649,145
"28675","WBGene00197559","I",11587696,11587757,61
"28676","WBGene00197560","II",2979269,2979343,74
"28677","WBGene00197561","II",4809929,4810070,141
"28678","WBGene00197563","X",7067769,7067909,140
"28679","WBGene00197564","X",11592878,11593025,147
"28680","WBGene00197565","I",14792483,14792571,88
"28681","WBGene00197566","X",5713650,5713741,91
"28682","WBGene00197567","V",10630886,10631020,134
"28683","WBGene00197568","IV",13050339,13050487,148
"28684","WBGene00197569","X",5791367,5791496,129
"28685","WBGene00197571","X",5736264,5736514,250
"28686","WBGene00197573","X",6899916,6900099,183
"28687","WBGene00197574","X",14044446,14044699,253
"28688","WBGene00197576","X",7427354,7427504,150
"28689","WBGene00197577","II",573555,573934,379
"28690","WBGene00197578","X",5817174,5817441,267
"28691","WBGene00197579","V",9297158,9297294,136
"28692","WBGene00197580","IV",12342569,12342710,141
"28693","WBGene00197582","X",5195549,5195833,284
"28694","WBGene00197583","V",11433428,11433632,204
"28695","WBGene00197584","IV",7343697,7343872,175
"28696","WBGene00197585","I",8901648,8901794,146
"28697","WBGene00197586","X",3866143,3866213,70
"28698","WBGene00197587","V",11538636,11538845,209
"28699","WBGene00197589","X",7906582,7906665,83
"28700","WBGene00197591","V",6244807,6245017,210
"28701","WBGene00197592","X",11606129,11606277,148
"28702","WBGene00197593","IV",343389,343446,57
"28703","WBGene00197594","II",9082193,9082340,147
"28704","WBGene00197595","I",4172204,4172306,102
"28705","WBGene00197596","X",9128221,9128410,189
"28706","WBGene00197597","X",14504340,14504527,187
"28707","WBGene00197598","IV",560788,560925,137
"28708","WBGene00197599","X",2906166,2906382,216
"28709","WBGene00197600","X",7948572,7948798,226
"28710","WBGene00197601","V",11428940,11429089,149
"28711","WBGene00197602","V",15551786,15551876,90
"28712","WBGene00197604","III",10747787,10748158,371
"28713","WBGene00197605","X",5041379,5041494,115
"28714","WBGene00197608","V",11335777,11335914,137
"28715","WBGene00197609","III",8520784,8520915,131
"28716","WBGene00197611","IV",13077817,13077873,56
"28717","WBGene00197612","II",15145575,15145685,110
"28718","WBGene00197613","I",10927401,10927489,88
"28719","WBGene00197614","X",9976873,9976930,57
"28720","WBGene00197615","X",5475469,5475590,121
"28721","WBGene00197616","V",10822770,10822887,117
"28722","WBGene00197617","IV",5860905,5861042,137
"28723","WBGene00197619","II",2859579,2859631,52
"28724","WBGene00197620","III",12250463,12250572,109
"28725","WBGene00197621","V",8533018,8533170,152
"28726","WBGene00197622","V",5586384,5586498,114
"28727","WBGene00197623","V",11741396,11741480,84
"28728","WBGene00197624","IV",736529,736623,94
"28729","WBGene00197625","V",9082516,9082655,139
"28730","WBGene00197626","IV",6985189,6985334,145
"28731","WBGene00197630","V",14139475,14139565,90
"28732","WBGene00197632","X",17670486,17670770,284
"28733","WBGene00197633","III",6348659,6348808,149
"28734","WBGene00197634","X",13635669,13635818,149
"28735","WBGene00197636","IV",3135091,3135240,149
"28736","WBGene00197637","III",6837859,6838008,149
"28737","WBGene00197639","III",10783044,10783176,132
"28738","WBGene00197640","V",13223613,13223805,192
"28739","WBGene00197642","X",6961303,6961673,370
"28740","WBGene00197643","V",6357963,6358104,141
"28741","WBGene00197644","X",15526828,15526967,139
"28742","WBGene00197645","X",4763363,4763501,138
"28743","WBGene00197646","IV",12552031,12552133,102
"28744","WBGene00197647","X",3827406,3827600,194
"28745","WBGene00197648","II",11634196,11634334,138
"28746","WBGene00197650","III",2553769,2553919,150
"28747","WBGene00197651","X",15433616,15433741,125
"28748","WBGene00197652","III",10016678,10016878,200
"28749","WBGene00197656","X",13201170,13201419,249
"28750","WBGene00197657","V",16219156,16219248,92
"28751","WBGene00197658","X",10731978,10732062,84
"28752","WBGene00197660","II",5069360,5069658,298
"28753","WBGene00197661","III",5814520,5814669,149
"28754","WBGene00197663","V",6359494,6359850,356
"28755","WBGene00197664","V",18616306,18616443,137
"28756","WBGene00197665","V",14815693,14815835,142
"28757","WBGene00197666","III",5602054,5602179,125
"28758","WBGene00197667","X",4388975,4389314,339
"28759","WBGene00197668","X",7236902,7237045,143
"28760","WBGene00197669","III",4475576,4475782,206
"28761","WBGene00197670","III",3533291,3533440,149
"28762","WBGene00197671","X",7554675,7554822,147
"28763","WBGene00197672","IV",7397576,7397850,274
"28764","WBGene00197674","V",11957328,11957465,137
"28765","WBGene00197679","V",6346557,6346645,88
"28766","WBGene00197680","X",2742664,2742755,91
"28767","WBGene00197682","II",2123149,2123200,51
"28768","WBGene00197684","III",9017532,9017731,199
"28769","WBGene00197685","II",9729190,9729403,213
"28770","WBGene00197686","II",5960747,5960846,99
"28771","WBGene00197688","V",12210518,12210662,144
"28772","WBGene00197689","IV",12425502,12425640,138
"28773","WBGene00197690","IV",7661884,7661975,91
"28774","WBGene00197691","II",8755854,8756134,280
"28775","WBGene00197694","II",10675349,10675498,149
"28776","WBGene00197695","IV",8058939,8059160,221
"28777","WBGene00197697","II",287659,287724,65
"28778","WBGene00197698","II",11396422,11396571,149
"28779","WBGene00197699","V",10983171,10983313,142
"28780","WBGene00197701","II",11753268,11753479,211
"28781","WBGene00197702","III",4970664,4970855,191
"28782","WBGene00197703","IV",12536497,12536634,137
"28783","WBGene00197704","I",10102230,10102353,123
"28784","WBGene00197705","X",13571109,13571293,184
"28785","WBGene00197706","X",4177492,4177630,138
"28786","WBGene00197707","X",14970460,14970586,126
"28787","WBGene00197708","III",8059179,8059325,146
"28788","WBGene00197710","X",6207835,6207981,146
"28789","WBGene00197711","V",10471233,10471294,61
"28790","WBGene00197712","I",6581853,6582000,147
"28791","WBGene00197714","I",3010493,3010618,125
"28792","WBGene00197715","V",10294698,10294841,143
"28793","WBGene00197716","I",7544618,7544730,112
"28794","WBGene00197717","X",2316352,2316538,186
"28795","WBGene00197718","V",8555002,8555151,149
"28796","WBGene00197719","III",6153402,6153481,79
"28797","WBGene00197721","IV",2432538,2432595,57
"28798","WBGene00197722","III",10516106,10516231,125
"28799","WBGene00197724","IV",11031735,11031874,139
"28800","WBGene00197726","II",6868015,6868270,255
"28801","WBGene00197727","X",2084183,2084251,68
"28802","WBGene00197729","X",11130180,11130316,136
"28803","WBGene00197730","V",11029805,11029920,115
"28804","WBGene00197731","V",11658153,11658364,211
"28805","WBGene00197732","V",11337876,11338077,201
"28806","WBGene00197733","X",11476076,11476255,179
"28807","WBGene00197735","V",9407022,9407113,91
"28808","WBGene00197736","I",5919380,5919529,149
"28809","WBGene00197739","V",10664303,10664444,141
"28810","WBGene00197741","II",5257259,5257329,70
"28811","WBGene00197742","X",8390115,8390376,261
"28812","WBGene00197746","II",6011610,6011660,50
"28813","WBGene00197747","V",3761530,3761646,116
"28814","WBGene00197750","X",3459848,3459992,144
"28815","WBGene00197752","V",11677995,11678199,204
"28816","WBGene00197753","V",11945935,11946074,139
"28817","WBGene00197754","III",1175637,1175688,51
"28818","WBGene00197756","V",5818752,5818831,79
"28819","WBGene00197758","I",9548842,9548984,142
"28820","WBGene00197761","X",8054573,8054708,135
"28821","WBGene00197762","X",7720987,7721128,141
"28822","WBGene00197765","V",8808205,8808351,146
"28823","WBGene00197767","III",4360099,4360248,149
"28824","WBGene00197768","X",12085058,12085204,146
"28825","WBGene00197769","V",10720539,10720733,194
"28826","WBGene00197771","X",13130023,13130155,132
"28827","WBGene00197773","X",3572379,3572566,187
"28828","WBGene00197775","V",5844489,5844626,137
"28829","WBGene00197776","I",9907403,9907525,122
"28830","WBGene00197778","II",6461456,6461594,138
"28831","WBGene00197779","V",9063313,9063451,138
"28832","WBGene00197780","X",2152449,2152648,199
"28833","WBGene00197783","X",9847024,9847178,154
"28834","WBGene00197784","X",7467368,7467563,195
"28835","WBGene00197785","I",11773564,11773987,423
"28836","WBGene00197787","X",1929423,1929947,524
"28837","WBGene00197788","I",6667205,6667349,144
"28838","WBGene00197789","I",13702646,13702735,89
"28839","WBGene00197792","X",15213312,15213453,141
"28840","WBGene00197793","X",5658326,5658630,304
"28841","WBGene00197796","IV",12133997,12134145,148
"28842","WBGene00197798","II",7814129,7814331,202
"28843","WBGene00197801","V",11951854,11951989,135
"28844","WBGene00197802","V",6877261,6877392,131
"28845","WBGene00197803","II",11167189,11167304,115
"28846","WBGene00197804","X",7652554,7652656,102
"28847","WBGene00197805","IV",6576775,6577101,326
"28848","WBGene00197806","X",6402683,6402881,198
"28849","WBGene00197807","X",3082307,3082394,87
"28850","WBGene00197809","II",11518848,11518922,74
"28851","WBGene00197810","IV",4861765,4861831,66
"28852","WBGene00197811","IV",4490396,4490512,116
"28853","WBGene00197812","III",6994709,6994920,211
"28854","WBGene00197813","IV",9947771,9947981,210
"28855","WBGene00197814","II",2226471,2226530,59
"28856","WBGene00197815","IV",561527,561648,121
"28857","WBGene00197817","X",9509833,9510036,203
"28858","WBGene00197818","IV",6997438,6997524,86
"28859","WBGene00197819","II",8732700,8732843,143
"28860","WBGene00197820","X",12051342,12051574,232
"28861","WBGene00197822","X",6796322,6796449,127
"28862","WBGene00197823","I",11121082,11121159,77
"28863","WBGene00197824","IV",15507656,15507805,149
"28864","WBGene00197826","X",7705959,7706099,140
"28865","WBGene00197827","V",12323636,12323693,57
"28866","WBGene00197828","X",12665224,12665323,99
"28867","WBGene00197829","X",11141674,11141818,144
"28868","WBGene00197830","V",11010899,11011033,134
"28869","WBGene00197832","X",7637861,7638045,184
"28870","WBGene00197833","X",5572724,5572922,198
"28871","WBGene00197834","V",12924239,12924378,139
"28872","WBGene00197835","III",5967883,5968032,149
"28873","WBGene00197836","V",10838180,10838323,143
"28874","WBGene00197839","X",5586494,5586643,149
"28875","WBGene00197840","V",13681535,13681669,134
"28876","WBGene00197841","V",11403325,11403453,128
"28877","WBGene00197842","IV",2995005,2995146,141
"28878","WBGene00197843","III",12983652,12983754,102
"28879","WBGene00197844","X",14610463,14610589,126
"28880","WBGene00197845","II",5879861,5880005,144
"28881","WBGene00197850","X",12008986,12009121,135
"28882","WBGene00197853","X",17315076,17315205,129
"28883","WBGene00197855","V",14725532,14725686,154
"28884","WBGene00197856","V",13609876,13610090,214
"28885","WBGene00197857","IV",9008933,9008989,56
"28886","WBGene00197859","X",6010065,6010288,223
"28887","WBGene00197862","X",6322642,6322913,271
"28888","WBGene00197863","X",2618448,2618652,204
"28889","WBGene00197865","IV",8920426,8920489,63
"28890","WBGene00197867","II",14191477,14191607,130
"28891","WBGene00197868","V",8946376,8946498,122
"28892","WBGene00197870","III",13225151,13225237,86
"28893","WBGene00197872","I",3260566,3260714,148
"28894","WBGene00197874","III",4963426,4963566,140
"28895","WBGene00197877","III",11472472,11472739,267
"28896","WBGene00197879","V",9692319,9692392,73
"28897","WBGene00197880","X",5525175,5525380,205
"28898","WBGene00197882","V",6141111,6141326,215
"28899","WBGene00197883","II",6827288,6827491,203
"28900","WBGene00197884","III",5878333,5878482,149
"28901","WBGene00197885","V",14618744,14619091,347
"28902","WBGene00197886","II",14474825,14474920,95
"28903","WBGene00197887","X",16090729,16090857,128
"28904","WBGene00197888","I",8384300,8384442,142
"28905","WBGene00197889","V",14487463,14487611,148
"28906","WBGene00197890","X",15380668,15380799,131
"28907","WBGene00197891","V",15359678,15359827,149
"28908","WBGene00197892","V",19079112,19079257,145
"28909","WBGene00197893","V",20890663,20890786,123
"28910","WBGene00197894","X",16284313,16284396,83
"28911","WBGene00197895","III",8109592,8109734,142
"28912","WBGene00197896","X",15354039,15354149,110
"28913","WBGene00197898","III",11095331,11095480,149
"28914","WBGene00197900","I",5551759,5551841,82
"28915","WBGene00197901","IV",11785170,11785521,351
"28916","WBGene00197902","II",9964072,9964177,105
"28917","WBGene00197903","X",6574040,6574579,539
"28918","WBGene00197905","V",5868403,5868541,138
"28919","WBGene00197906","III",5991644,5992220,576
"28920","WBGene00197909","II",13028600,13028719,119
"28921","WBGene00197912","X",5477372,5477579,207
"28922","WBGene00197915","IV",6789892,6790041,149
"28923","WBGene00197918","X",1590078,1590155,77
"28924","WBGene00197924","II",10422951,10423040,89
"28925","WBGene00197927","III",8506546,8506695,149
"28926","WBGene00197928","V",10671241,10671376,135
"28927","WBGene00197930","X",10098260,10098396,136
"28928","WBGene00197933","X",8417893,8417998,105
"28929","WBGene00197934","X",7217096,7217239,143
"28930","WBGene00197935","X",14818987,14819125,138
"28931","WBGene00197936","IV",6425689,6425805,116
"28932","WBGene00197939","IV",7275874,7276076,202
"28933","WBGene00197940","I",2656826,2657013,187
"28934","WBGene00197943","V",13229933,13230091,158
"28935","WBGene00197944","V",7978843,7978962,119
"28936","WBGene00197946","II",5292330,5292413,83
"28937","WBGene00197950","I",8530118,8530204,86
"28938","WBGene00197951","IV",10990279,10990428,149
"28939","WBGene00197952","II",10071878,10071952,74
"28940","WBGene00197953","X",4065483,4065625,142
"28941","WBGene00197954","III",4767011,4767148,137
"28942","WBGene00197956","X",11560586,11560724,138
"28943","WBGene00197957","I",9942323,9942758,435
"28944","WBGene00197959","IV",6035226,6035298,72
"28945","WBGene00197960","X",8886390,8886452,62
"28946","WBGene00197961","I",530215,530326,111
"28947","WBGene00197965","I",6979629,6979773,144
"28948","WBGene00197966","III",4774929,4775118,189
"28949","WBGene00197967","X",10176606,10176744,138
"28950","WBGene00197968","II",7551570,7551719,149
"28951","WBGene00197969","X",14905400,14905614,214
"28952","WBGene00197970","X",15151374,15151641,267
"28953","WBGene00197971","I",9087743,9087883,140
"28954","WBGene00197973","X",14752187,14752265,78
"28955","WBGene00197974","II",12354676,12354775,99
"28956","WBGene00197975","X",16615872,16616020,148
"28957","WBGene00197976","II",5462216,5462408,192
"28958","WBGene00197977","X",2389149,2389295,146
"28959","WBGene00197978","I",812295,812442,147
"28960","WBGene00197979","II",5806273,5806348,75
"28961","WBGene00197981","X",3850357,3850496,139
"28962","WBGene00197982","X",2896161,2896292,131
"28963","WBGene00197983","II",13029637,13029754,117
"28964","WBGene00197984","III",10496080,10496379,299
"28965","WBGene00197985","V",6550073,6550290,217
"28966","WBGene00197987","IV",7641907,7642052,145
"28967","WBGene00197989","X",15134645,15134783,138
"28968","WBGene00197990","X",4072757,4072878,121
"28969","WBGene00197991","V",11083642,11083789,147
"28970","WBGene00197992","X",6219995,6220151,156
"28971","WBGene00197994","X",11813695,11813894,199
"28972","WBGene00197995","X",3315058,3315308,250
"28973","WBGene00197996","I",3116084,3116175,91
"28974","WBGene00197997","IV",11789160,11789372,212
"28975","WBGene00197998","X",2448581,2448719,138
"28976","WBGene00198000","X",16576439,16576499,60
"28977","WBGene00198001","I",3246221,3246370,149
"28978","WBGene00198004","X",12897209,12897327,118
"28979","WBGene00198006","X",4381716,4381821,105
"28980","WBGene00198007","V",13105856,13106070,214
"28981","WBGene00198008","X",8261351,8261571,220
"28982","WBGene00198009","II",103344,103475,131
"28983","WBGene00198010","II",11928410,11928559,149
"28984","WBGene00198011","I",10278174,10278301,127
"28985","WBGene00198013","II",8894186,8894375,189
"28986","WBGene00198014","X",15630903,15631031,128
"28987","WBGene00198017","III",9037744,9037913,169
"28988","WBGene00198019","V",13214865,13215012,147
"28989","WBGene00198020","X",6960249,6960398,149
"28990","WBGene00198021","II",5841399,5841514,115
"28991","WBGene00198023","X",2226844,2226987,143
"28992","WBGene00198024","X",9090592,9090764,172
"28993","WBGene00198025","X",8438838,8438976,138
"28994","WBGene00198026","I",2739991,2740283,292
"28995","WBGene00198028","V",11190949,11191087,138
"28996","WBGene00198029","II",11567119,11567323,204
"28997","WBGene00198030","V",8541908,8542076,168
"28998","WBGene00198032","X",8609037,8609120,83
"28999","WBGene00198034","X",9790190,9790241,51
"29000","WBGene00198035","III",11722259,11722325,66
"29001","WBGene00198036","II",5291047,5291334,287
"29002","WBGene00198037","V",13166787,13166926,139
"29003","WBGene00198040","II",5741292,5741456,164
"29004","WBGene00198042","I",7475046,7475283,237
"29005","WBGene00198043","IV",5415967,5416111,144
"29006","WBGene00198044","II",205199,205337,138
"29007","WBGene00198045","II",11081164,11081309,145
"29008","WBGene00198046","X",13812181,13812397,216
"29009","WBGene00198047","I",9736636,9736785,149
"29010","WBGene00198048","V",18588077,18588223,146
"29011","WBGene00198049","V",16338545,16338631,86
"29012","WBGene00198050","V",6033568,6033845,277
"29013","WBGene00198053","II",7808201,7808359,158
"29014","WBGene00198054","II",7725587,7725701,114
"29015","WBGene00198055","III",12131973,12132115,142
"29016","WBGene00198057","X",8876082,8876164,82
"29017","WBGene00198058","IV",12176924,12177072,148
"29018","WBGene00198060","II",1404954,1405008,54
"29019","WBGene00198061","I",9074581,9074668,87
"29020","WBGene00198062","X",7462727,7462869,142
"29021","WBGene00198063","X",5904438,5904565,127
"29022","WBGene00198068","X",9098920,9099210,290
"29023","WBGene00198072","X",9235351,9235446,95
"29024","WBGene00198073","X",7460797,7460924,127
"29025","WBGene00198075","V",11434935,11435277,342
"29026","WBGene00198076","IV",6858321,6858428,107
"29027","WBGene00198078","X",2103591,2103723,132
"29028","WBGene00198081","II",10992579,10992717,138
"29029","WBGene00198082","V",17725789,17725842,53
"29030","WBGene00198083","X",11744498,11744558,60
"29031","WBGene00198084","V",6683750,6683963,213
"29032","WBGene00198085","X",2385605,2385750,145
"29033","WBGene00198086","IV",1905347,1905405,58
"29034","WBGene00198087","IV",11163420,11163520,100
"29035","WBGene00198088","II",10975073,10975211,138
"29036","WBGene00198093","I",5358146,5358293,147
"29037","WBGene00198094","IV",1789565,1789712,147
"29038","WBGene00198096","X",11028440,11028640,200
"29039","WBGene00198098","X",2712170,2712352,182
"29040","WBGene00198099","X",16982296,16982439,143
"29041","WBGene00198101","I",8305488,8305702,214
"29042","WBGene00198103","X",6665914,6666062,148
"29043","WBGene00198106","X",8305162,8305269,107
"29044","WBGene00198107","II",10959823,10959904,81
"29045","WBGene00198108","III",10133145,10133236,91
"29046","WBGene00198110","V",5972043,5972191,148
"29047","WBGene00198111","X",15696442,15696570,128
"29048","WBGene00198112","V",5403877,5404165,288
"29049","WBGene00198115","II",10566616,10566723,107
"29050","WBGene00198116","X",4319103,4319307,204
"29051","WBGene00198118","III",7806915,7807079,164
"29052","WBGene00198120","I",3405747,3405879,132
"29053","WBGene00198121","V",12325992,12326137,145
"29054","WBGene00198122","II",6380894,6381085,191
"29055","WBGene00198124","IV",7235559,7235759,200
"29056","WBGene00198125","X",5210656,5210718,62
"29057","WBGene00198126","V",10563412,10563538,126
"29058","WBGene00198127","III",10397598,10397729,131
"29059","WBGene00198128","II",5902601,5902756,155
"29060","WBGene00198129","X",5323112,5323162,50
"29061","WBGene00198130","IV",9914297,9914428,131
"29062","WBGene00198131","I",9001845,9002054,209
"29063","WBGene00198132","IV",9526176,9526318,142
"29064","WBGene00198133","V",9247935,9248149,214
"29065","WBGene00198135","III",13661603,13661862,259
"29066","WBGene00198139","V",12479261,12479407,146
"29067","WBGene00198140","V",4123780,4124153,373
"29068","WBGene00198141","X",3966776,3966912,136
"29069","WBGene00198142","V",5848178,5848319,141
"29070","WBGene00198143","V",6131115,6131319,204
"29071","WBGene00198144","I",9546789,9547061,272
"29072","WBGene00198145","III",4063740,4063820,80
"29073","WBGene00198146","I",12288203,12288408,205
"29074","WBGene00198151","I",9708611,9708753,142
"29075","WBGene00198152","IV",7405925,7406074,149
"29076","WBGene00198155","X",3792834,3792975,141
"29077","WBGene00198156","X",10107886,10108034,148
"29078","WBGene00198157","X",2517143,2517290,147
"29079","WBGene00198158","V",20018423,20018652,229
"29080","WBGene00198159","II",11277196,11277345,149
"29081","WBGene00198160","X",10130166,10130350,184
"29082","WBGene00198161","IV",7757288,7757413,125
"29083","WBGene00198162","V",6202753,6202918,165
"29084","WBGene00198165","II",4565026,4565093,67
"29085","WBGene00198167","X",6691801,6691980,179
"29086","WBGene00198168","X",5670699,5670832,133
"29087","WBGene00198169","V",6659021,6659161,140
"29088","WBGene00198170","I",11984224,11984297,73
"29089","WBGene00198171","X",11665654,11665839,185
"29090","WBGene00198173","X",2788245,2788540,295
"29091","WBGene00198174","V",6267418,6267637,219
"29092","WBGene00198175","IV",6988341,6988546,205
"29093","WBGene00198176","V",9383831,9383973,142
"29094","WBGene00198178","V",9664771,9664912,141
"29095","WBGene00198179","II",11446849,11447212,363
"29096","WBGene00198180","X",8444674,8444820,146
"29097","WBGene00198182","III",4475514,4475657,143
"29098","WBGene00198183","II",8833110,8833239,129
"29099","WBGene00198184","IV",6994905,6995018,113
"29100","WBGene00198185","II",1345988,1346137,149
"29101","WBGene00198190","I",10569085,10569217,132
"29102","WBGene00198191","X",6155369,6155559,190
"29103","WBGene00198192","X",13823633,13823859,226
"29104","WBGene00198193","IV",6809739,6809875,136
"29105","WBGene00198194","X",2553790,2553929,139
"29106","WBGene00198196","IV",7414153,7414274,121
"29107","WBGene00198201","II",2502960,2503056,96
"29108","WBGene00198202","I",12830505,12830609,104
"29109","WBGene00198203","X",3796904,3797035,131
"29110","WBGene00198206","II",12239992,12240136,144
"29111","WBGene00198207","I",1156088,1156264,176
"29112","WBGene00198208","I",11407247,11407305,58
"29113","WBGene00198209","II",8751016,8751201,185
"29114","WBGene00198210","II",7484213,7484342,129
"29115","WBGene00198211","V",13156268,13156479,211
"29116","WBGene00198212","III",2276077,2276258,181
"29117","WBGene00198213","X",4971512,4971654,142
"29118","WBGene00198214","I",9435160,9435327,167
"29119","WBGene00198215","V",11990796,11990929,133
"29120","WBGene00198216","III",4552061,4552275,214
"29121","WBGene00198217","II",5577182,5577273,91
"29122","WBGene00198218","X",10990835,10990928,93
"29123","WBGene00198219","X",10708758,10708883,125
"29124","WBGene00198220","V",13225314,13225438,124
"29125","WBGene00198221","I",5782088,5782152,64
"29126","WBGene00198223","X",7861156,7861304,148
"29127","WBGene00198224","IV",175725,175865,140
"29128","WBGene00198226","II",7716233,7716381,148
"29129","WBGene00198227","X",15305756,15305901,145
"29130","WBGene00198228","V",9109367,9109500,133
"29131","WBGene00198229","X",9702240,9702380,140
"29132","WBGene00198231","V",13704093,13704146,53
"29133","WBGene00198232","II",6563399,6563467,68
"29134","WBGene00198233","X",13782243,13782331,88
"29135","WBGene00198235","III",9291225,9291315,90
"29136","WBGene00198236","II",5728140,5728200,60
"29137","WBGene00198237","X",4883700,4883841,141
"29138","WBGene00198238","I",5969290,5969354,64
"29139","WBGene00198239","X",16689975,16690068,93
"29140","WBGene00198240","X",3202439,3202635,196
"29141","WBGene00198241","X",12875787,12876001,214
"29142","WBGene00198242","V",10680409,10680545,136
"29143","WBGene00198243","X",4554081,4554219,138
"29144","WBGene00198244","X",433894,434076,182
"29145","WBGene00198245","I",5044740,5044883,143
"29146","WBGene00198246","V",11281951,11282097,146
"29147","WBGene00198247","IV",3087185,3087334,149
"29148","WBGene00198248","V",5551341,5551490,149
"29149","WBGene00198251","X",7269292,7269438,146
"29150","WBGene00198255","II",1106860,1106928,68
"29151","WBGene00198256","III",11422669,11422812,143
"29152","WBGene00198257","V",11341835,11342020,185
"29153","WBGene00198258","IV",11996528,11996631,103
"29154","WBGene00198259","II",5218464,5218667,203
"29155","WBGene00198261","II",6135153,6135262,109
"29156","WBGene00198262","IV",7236444,7236651,207
"29157","WBGene00198263","X",4088772,4088985,213
"29158","WBGene00198264","V",12233645,12233780,135
"29159","WBGene00198265","V",3734649,3734700,51
"29160","WBGene00198266","X",7014761,7014826,65
"29161","WBGene00198267","I",6264565,6264709,144
"29162","WBGene00198268","II",6823310,6823530,220
"29163","WBGene00198269","X",15678773,15678916,143
"29164","WBGene00198271","II",12944985,12945128,143
"29165","WBGene00198274","II",6172213,6172370,157
"29166","WBGene00198275","X",15580060,15580209,149
"29167","WBGene00198276","V",8949984,8950245,261
"29168","WBGene00198277","I",4660521,4660713,192
"29169","WBGene00198278","X",3821583,3821786,203
"29170","WBGene00198280","I",10407458,10407585,127
"29171","WBGene00198281","X",1880808,1880893,85
"29172","WBGene00198282","II",10321295,10321343,48
"29173","WBGene00198283","X",2779900,2780085,185
"29174","WBGene00198284","V",6618155,6618234,79
"29175","WBGene00198286","III",7208653,7208796,143
"29176","WBGene00198287","V",6348274,6348482,208
"29177","WBGene00198289","X",8996890,8997026,136
"29178","WBGene00198291","V",18526474,18526590,116
"29179","WBGene00198292","X",2216639,2216901,262
"29180","WBGene00198295","X",2764027,2764173,146
"29181","WBGene00198296","IV",6759289,6759500,211
"29182","WBGene00198297","X",12090809,12091301,492
"29183","WBGene00198298","X",10902948,10903093,145
"29184","WBGene00198302","X",2036686,2036821,135
"29185","WBGene00198303","V",13588763,13588987,224
"29186","WBGene00198304","X",5478221,5478348,127
"29187","WBGene00198306","X",8656567,8656764,197
"29188","WBGene00198307","IV",11568418,11568755,337
"29189","WBGene00198308","X",13672223,13672315,92
"29190","WBGene00198309","II",7570858,7571148,290
"29191","WBGene00198310","X",7327235,7327441,206
"29192","WBGene00198311","IV",10958022,10958119,97
"29193","WBGene00198312","II",8948434,8948806,372
"29194","WBGene00198313","IV",11871300,11871516,216
"29195","WBGene00198314","X",7223063,7223202,139
"29196","WBGene00198315","I",9752601,9752742,141
"29197","WBGene00198316","III",10161888,10162103,215
"29198","WBGene00198319","X",6517140,6517283,143
"29199","WBGene00198321","II",10977378,10977527,149
"29200","WBGene00198323","X",7643414,7643542,128
"29201","WBGene00198325","II",4815249,4815557,308
"29202","WBGene00198328","I",742120,742286,166
"29203","WBGene00198330","X",6898105,6898246,141
"29204","WBGene00198331","V",1542312,1542363,51
"29205","WBGene00198333","IV",12005980,12006204,224
"29206","WBGene00198337","III",9738297,9738446,149
"29207","WBGene00198338","II",5578132,5578269,137
"29208","WBGene00198339","X",8630094,8630148,54
"29209","WBGene00198340","V",12358424,12358606,182
"29210","WBGene00198341","IV",7318632,7318780,148
"29211","WBGene00198344","III",9162856,9163004,148
"29212","WBGene00198347","X",8487882,8488030,148
"29213","WBGene00198348","V",10041652,10041776,124
"29214","WBGene00198349","X",6066476,6066741,265
"29215","WBGene00198350","V",6757042,6757176,134
"29216","WBGene00198351","V",8661530,8661718,188
"29217","WBGene00198352","X",7209079,7209263,184
"29218","WBGene00198355","V",12450569,12450708,139
"29219","WBGene00198356","X",14954883,14955231,348
"29220","WBGene00198357","IV",7468499,7468599,100
"29221","WBGene00198358","X",4480695,4480831,136
"29222","WBGene00198359","IV",9950102,9950238,136
"29223","WBGene00198360","V",11958187,11958328,141
"29224","WBGene00198361","III",11477928,11478077,149
"29225","WBGene00198362","III",1220429,1220570,141
"29226","WBGene00198365","II",13916005,13916183,178
"29227","WBGene00198366","X",3327975,3328110,135
"29228","WBGene00198367","IV",3424160,3424362,202
"29229","WBGene00198368","III",5602334,5602474,140
"29230","WBGene00198370","V",6744672,6744855,183
"29231","WBGene00198371","X",6952140,6952331,191
"29232","WBGene00198372","III",1964618,1964767,149
"29233","WBGene00198373","X",7542526,7542735,209
"29234","WBGene00198374","X",5577946,5578000,54
"29235","WBGene00198375","I",9553804,9553945,141
"29236","WBGene00198376","X",7469617,7469765,148
"29237","WBGene00198379","III",9637514,9637658,144
"29238","WBGene00198380","X",5655329,5655609,280
"29239","WBGene00198381","X",5193554,5193755,201
"29240","WBGene00198382","X",7639117,7639285,168
"29241","WBGene00198383","X",16627127,16627264,137
"29242","WBGene00198384","X",4555933,4556289,356
"29243","WBGene00198385","X",3955545,3955760,215
"29244","WBGene00198387","III",9119465,9119614,149
"29245","WBGene00198391","I",7566945,7567094,149
"29246","WBGene00198392","X",7725751,7725885,134
"29247","WBGene00198394","III",9354220,9354399,179
"29248","WBGene00198398","V",20483657,20483887,230
"29249","WBGene00198399","X",16389501,16389609,108
"29250","WBGene00198402","V",6731594,6731865,271
"29251","WBGene00198403","V",12988154,12988442,288
"29252","WBGene00198406","II",8177143,8177344,201
"29253","WBGene00198409","III",11131432,11131484,52
"29254","WBGene00198410","V",5868417,5868555,138
"29255","WBGene00198411","I",14229032,14229101,69
"29256","WBGene00198412","IV",6985776,6985992,216
"29257","WBGene00198414","X",3902375,3902622,247
"29258","WBGene00198415","X",13730351,13730440,89
"29259","WBGene00198416","X",5867114,5867253,139
"29260","WBGene00198418","X",1589666,1589742,76
"29261","WBGene00198419","X",12407383,12407685,302
"29262","WBGene00198420","III",12116659,12116735,76
"29263","WBGene00198422","V",14599097,14599205,108
"29264","WBGene00198423","I",9774074,9774215,141
"29265","WBGene00198424","V",18175439,18175496,57
"29266","WBGene00198426","V",15065163,15065370,207
"29267","WBGene00198429","V",11445503,11445706,203
"29268","WBGene00198430","IV",12425523,12425720,197
"29269","WBGene00198431","II",11619929,11620215,286
"29270","WBGene00198432","II",2338977,2339042,65
"29271","WBGene00198435","II",6637613,6637762,149
"29272","WBGene00198436","II",7974496,7974641,145
"29273","WBGene00198437","X",15223895,15224031,136
"29274","WBGene00198438","V",12210262,12210399,137
"29275","WBGene00198442","II",11205595,11205798,203
"29276","WBGene00198443","III",2555962,2556107,145
"29277","WBGene00198445","II",11796217,11796386,169
"29278","WBGene00198446","II",6408861,6409078,217
"29279","WBGene00198448","IV",8927142,8927258,116
"29280","WBGene00198450","X",3471085,3471220,135
"29281","WBGene00198451","V",18613183,18613258,75
"29282","WBGene00198452","V",13218346,13218521,175
"29283","WBGene00198453","V",15465079,15465180,101
"29284","WBGene00198454","V",12459197,12459335,138
"29285","WBGene00198455","II",13717547,13717754,207
"29286","WBGene00198456","III",8465861,8466124,263
"29287","WBGene00198457","II",5142041,5142187,146
"29288","WBGene00198458","X",8505664,8505948,284
"29289","WBGene00198459","III",9792901,9793050,149
"29290","WBGene00198460","X",9303216,9303403,187
"29291","WBGene00198461","V",13289028,13289176,148
"29292","WBGene00198462","II",14018353,14018440,87
"29293","WBGene00198463","III",4969346,4969487,141
"29294","WBGene00198464","X",16285279,16285372,93
"29295","WBGene00198465","X",15564468,15564579,111
"29296","WBGene00198466","V",6359491,6359711,220
"29297","WBGene00198467","III",9625325,9625473,148
"29298","WBGene00198469","V",14899700,14899760,60
"29299","WBGene00198470","II",13829286,13829492,206
"29300","WBGene00198471","V",19341046,19341194,148
"29301","WBGene00198472","II",6140561,6140843,282
"29302","WBGene00198473","IV",13440546,13440658,112
"29303","WBGene00198474","X",6321034,6321170,136
"29304","WBGene00198475","IV",12058068,12058217,149
"29305","WBGene00198476","V",9218319,9218567,248
"29306","WBGene00198477","X",2069242,2069391,149
"29307","WBGene00198479","III",1734020,1734072,52
"29308","WBGene00198480","II",11567398,11567560,162
"29309","WBGene00198482","I",10134405,10134524,119
"29310","WBGene00198483","X",4939527,4939662,135
"29311","WBGene00198485","X",3356088,3356229,141
"29312","WBGene00198489","V",20685581,20685651,70
"29313","WBGene00198490","V",5821621,5821848,227
"29314","WBGene00198491","V",10328203,10328409,206
"29315","WBGene00198492","X",8203879,8204101,222
"29316","WBGene00198494","X",6211128,6211249,121
"29317","WBGene00198495","X",11132768,11132969,201
"29318","WBGene00198496","X",10430696,10430819,123
"29319","WBGene00198497","I",10037643,10037840,197
"29320","WBGene00198502","X",5492811,5492918,107
"29321","WBGene00198503","IV",1508701,1508925,224
"29322","WBGene00198504","IV",7718020,7718166,146
"29323","WBGene00198506","V",13828095,13828251,156
"29324","WBGene00198507","I",4856882,4857115,233
"29325","WBGene00198508","IV",11883516,11883662,146
"29326","WBGene00198510","II",3511156,3511212,56
"29327","WBGene00198511","X",7922726,7922838,112
"29328","WBGene00198512","X",6799085,6799221,136
"29329","WBGene00198513","III",492494,492835,341
"29330","WBGene00198515","X",16392315,16392511,196
"29331","WBGene00198519","II",10083559,10083679,120
"29332","WBGene00198520","V",5698052,5698195,143
"29333","WBGene00198521","III",7530859,7530990,131
"29334","WBGene00198523","X",7965631,7965678,47
"29335","WBGene00198525","II",7674864,7674999,135
"29336","WBGene00198526","V",5330124,5330211,87
"29337","WBGene00198528","X",7606460,7606664,204
"29338","WBGene00198529","V",11674727,11674938,211
"29339","WBGene00198530","III",6464287,6464567,280
"29340","WBGene00198533","IV",1183198,1183304,106
"29341","WBGene00198534","II",146739,146962,223
"29342","WBGene00198536","V",8254329,8254682,353
"29343","WBGene00198537","V",5220083,5220133,50
"29344","WBGene00198538","III",2395607,2395656,49
"29345","WBGene00198539","V",9069801,9069856,55
"29346","WBGene00198541","II",7888234,7888439,205
"29347","WBGene00198542","X",15010170,15010286,116
"29348","WBGene00198543","X",10431819,10432007,188
"29349","WBGene00198546","II",11753049,11753188,139
"29350","WBGene00198547","X",14582879,14583101,222
"29351","WBGene00198548","IV",11354057,11354196,139
"29352","WBGene00198549","V",13107101,13107372,271
"29353","WBGene00198552","V",12340153,12340352,199
"29354","WBGene00198553","IV",13217897,13217983,86
"29355","WBGene00198554","I",6171595,6171658,63
"29356","WBGene00198555","X",9845217,9845284,67
"29357","WBGene00198556","X",8616245,8616384,139
"29358","WBGene00198557","X",5739257,5739479,222
"29359","WBGene00198559","IV",15039676,15039823,147
"29360","WBGene00198560","III",9355494,9355824,330
"29361","WBGene00198561","III",1808400,1808549,149
"29362","WBGene00198563","X",16530821,16530955,134
"29363","WBGene00198565","IV",3278546,3278656,110
"29364","WBGene00198566","III",7495088,7495231,143
"29365","WBGene00198568","X",2131644,2131902,258
"29366","WBGene00198569","V",11233317,11233536,219
"29367","WBGene00198571","X",7222490,7222748,258
"29368","WBGene00198574","IV",4504546,4504676,130
"29369","WBGene00198575","III",4899802,4899950,148
"29370","WBGene00198577","II",6186486,6186634,148
"29371","WBGene00198578","X",2906105,2906250,145
"29372","WBGene00198580","IV",14313084,14313231,147
"29373","WBGene00198581","IV",2734970,2735038,68
"29374","WBGene00198582","II",6828613,6828746,133
"29375","WBGene00198583","X",5859334,5859532,198
"29376","WBGene00198584","V",11335488,11335631,143
"29377","WBGene00198586","I",7066995,7067144,149
"29378","WBGene00198587","V",12662619,12662782,163
"29379","WBGene00198588","I",14092171,14092309,138
"29380","WBGene00198589","IV",558931,559121,190
"29381","WBGene00198591","X",14992117,14992253,136
"29382","WBGene00198593","X",7454018,7454219,201
"29383","WBGene00198595","IV",11999191,11999332,141
"29384","WBGene00198596","IV",7319973,7320121,148
"29385","WBGene00198597","IV",6366450,6366598,148
"29386","WBGene00198598","X",5705301,5705431,130
"29387","WBGene00198599","IV",11567743,11567967,224
"29388","WBGene00198602","X",6218929,6219153,224
"29389","WBGene00198604","X",9950353,9950495,142
"29390","WBGene00198606","X",6892091,6892234,143
"29391","WBGene00198608","X",777204,777353,149
"29392","WBGene00198609","I",14763290,14763433,143
"29393","WBGene00198611","IV",7343047,7343196,149
"29394","WBGene00198614","II",9081268,9081403,135
"29395","WBGene00198615","V",11659562,11659785,223
"29396","WBGene00198616","X",6905855,6905999,144
"29397","WBGene00198617","IV",5419847,5419908,61
"29398","WBGene00198620","X",17421517,17421759,242
"29399","WBGene00198621","II",1375853,1375908,55
"29400","WBGene00198623","X",6010809,6011015,206
"29401","WBGene00198624","V",13680248,13680397,149
"29402","WBGene00198626","III",1168091,1168159,68
"29403","WBGene00198627","X",7534555,7534757,202
"29404","WBGene00198628","X",3064735,3064884,149
"29405","WBGene00198629","V",11706246,11706809,563
"29406","WBGene00198630","X",13511961,13512046,85
"29407","WBGene00198631","X",15189335,15189664,329
"29408","WBGene00198633","III",8523347,8523495,148
"29409","WBGene00198634","II",10389765,10389975,210
"29410","WBGene00198636","X",8692549,8692722,173
"29411","WBGene00198638","III",13668642,13668790,148
"29412","WBGene00198639","II",5880138,5880284,146
"29413","WBGene00198640","IV",6438154,6438281,127
"29414","WBGene00198641","V",8944198,8944398,200
"29415","WBGene00198642","III",10634173,10634381,208
"29416","WBGene00198643","X",12011552,12011727,175
"29417","WBGene00198644","V",16341772,16341859,87
"29418","WBGene00198646","X",6635357,6635492,135
"29419","WBGene00198647","X",5275353,5275481,128
"29420","WBGene00198648","V",11532143,11532250,107
"29421","WBGene00198650","V",7983684,7983833,149
"29422","WBGene00198651","I",6992718,6992853,135
"29423","WBGene00198652","IV",9918860,9918952,92
"29424","WBGene00198653","V",12778845,12778985,140
"29425","WBGene00198654","X",7649561,7649775,214
"29426","WBGene00198656","III",12858384,12858507,123
"29427","WBGene00198659","III",9995803,9995952,149
"29428","WBGene00198660","X",10507645,10507846,201
"29429","WBGene00198663","V",9424612,9424770,158
"29430","WBGene00198664","II",8727792,8727941,149
"29431","WBGene00198665","X",3738614,3738881,267
"29432","WBGene00198667","V",9667345,9667399,54
"29433","WBGene00198668","IV",7451626,7451770,144
"29434","WBGene00198670","X",10515858,10515967,109
"29435","WBGene00198671","X",693613,693760,147
"29436","WBGene00198673","V",19025781,19025835,54
"29437","WBGene00198674","IV",9915043,9915389,346
"29438","WBGene00198676","V",18716943,18717092,149
"29439","WBGene00198677","V",14618069,14618293,224
"29440","WBGene00198679","II",6883834,6883976,142
"29441","WBGene00198680","X",8004320,8004458,138
"29442","WBGene00198681","V",14833331,14833455,124
"29443","WBGene00198684","X",5041335,5041449,114
"29444","WBGene00198685","V",13609899,13610114,215
"29445","WBGene00198686","V",12773092,12773364,272
"29446","WBGene00198687","IV",12691322,12691371,49
"29447","WBGene00198688","IV",4568533,4568679,146
"29448","WBGene00198690","III",8501505,8501587,82
"29449","WBGene00198692","II",11097308,11097601,293
"29450","WBGene00198696","II",9730005,9730216,211
"29451","WBGene00198697","X",7216687,7216866,179
"29452","WBGene00198698","IV",11785176,11785527,351
"29453","WBGene00198699","IV",7275857,7276007,150
"29454","WBGene00198700","X",10843930,10844060,130
"29455","WBGene00198701","X",8409475,8409553,78
"29456","WBGene00198702","V",11737506,11737649,143
"29457","WBGene00198704","X",5121886,5122005,119
"29458","WBGene00198705","V",13228320,13228459,139
"29459","WBGene00198706","X",10597663,10597790,127
"29460","WBGene00198707","IV",314661,314762,101
"29461","WBGene00198709","IV",12201946,12202312,366
"29462","WBGene00198711","III",3541179,3541327,148
"29463","WBGene00198713","IV",6786048,6786188,140
"29464","WBGene00198714","X",17390894,17391034,140
"29465","WBGene00198716","II",10068555,10068625,70
"29466","WBGene00198717","X",6150677,6150883,206
"29467","WBGene00198719","II",203733,203882,149
"29468","WBGene00198720","IV",10085099,10085248,149
"29469","WBGene00198721","V",6930829,6930965,136
"29470","WBGene00198722","X",11560220,11560467,247
"29471","WBGene00198723","III",4766570,4766719,149
"29472","WBGene00198724","V",11190393,11190539,146
"29473","WBGene00198725","V",11782907,11783052,145
"29474","WBGene00198726","V",11406076,11406232,156
"29475","WBGene00198727","I",2614878,2615027,149
"29476","WBGene00198728","V",12478101,12478382,281
"29477","WBGene00198729","II",15253601,15253662,61
"29478","WBGene00198731","V",12336698,12336908,210
"29479","WBGene00198732","V",11029644,11029784,140
"29480","WBGene00198733","X",4804335,4804419,84
"29481","WBGene00198734","X",4137718,4137851,133
"29482","WBGene00198735","V",19147321,19147393,72
"29483","WBGene00198737","III",5989353,5989491,138
"29484","WBGene00198738","IV",9982936,9983095,159
"29485","WBGene00198739","IV",8051843,8051992,149
"29486","WBGene00198740","II",5463057,5463266,209
"29487","WBGene00198742","IV",4672996,4673060,64
"29488","WBGene00198743","X",12050249,12050463,214
"29489","WBGene00198745","X",15515957,15516240,283
"29490","WBGene00198746","X",7586498,7586830,332
"29491","WBGene00198748","X",14490006,14490148,142
"29492","WBGene00198749","X",11597878,11598024,146
"29493","WBGene00198750","III",7012254,7012402,148
"29494","WBGene00198751","IV",10189153,10189301,148
"29495","WBGene00198752","II",1370949,1370999,50
"29496","WBGene00198753","IV",17472075,17472212,137
"29497","WBGene00198754","X",14334728,14334814,86
"29498","WBGene00198755","X",9504219,9504275,56
"29499","WBGene00198758","III",1218366,1218452,86
"29500","WBGene00198759","V",9112133,9112271,138
"29501","WBGene00198760","X",15773523,15773608,85
"29502","WBGene00198761","X",3467490,3467637,147
"29503","WBGene00198764","IV",8171832,8172056,224
"29504","WBGene00198765","II",2220483,2220632,149
"29505","WBGene00198766","V",6135164,6135298,134
"29506","WBGene00198767","V",5845330,5845477,147
"29507","WBGene00198768","X",12589695,12589842,147
"29508","WBGene00198770","V",5676300,5676732,432
"29509","WBGene00198771","V",11133875,11134086,211
"29510","WBGene00198772","X",11473182,11473302,120
"29511","WBGene00198773","I",8519265,8519413,148
"29512","WBGene00198774","II",6017199,6017381,182
"29513","WBGene00198775","II",34075,34200,125
"29514","WBGene00198776","X",7648117,7648272,155
"29515","WBGene00198780","IV",16388549,16388640,91
"29516","WBGene00198782","V",1264510,1264561,51
"29517","WBGene00198787","X",7718982,7719107,125
"29518","WBGene00198792","X",8819923,8819996,73
"29519","WBGene00198793","V",10719563,10719706,143
"29520","WBGene00198794","V",10833603,10833752,149
"29521","WBGene00198795","III",4362461,4362677,216
"29522","WBGene00198796","X",7467633,7467769,136
"29523","WBGene00198798","IV",14032802,14032997,195
"29524","WBGene00198801","II",7814823,7815026,203
"29525","WBGene00198802","V",12210878,12211018,140
"29526","WBGene00198803","X",7158741,7158888,147
"29527","WBGene00198804","V",10716912,10717478,566
"29528","WBGene00198805","III",5782173,5782309,136
"29529","WBGene00198806","X",2743649,2743748,99
"29530","WBGene00198807","V",12874898,12875028,130
"29531","WBGene00198808","IV",6997085,6997353,268
"29532","WBGene00198810","X",7524075,7524256,181
"29533","WBGene00198811","V",11009670,11009815,145
"29534","WBGene00198812","IV",16755958,16756084,126
"29535","WBGene00198815","IV",4490386,4490503,117
"29536","WBGene00198818","III",10532334,10532482,148
"29537","WBGene00198819","X",6397154,6397290,136
"29538","WBGene00198822","V",11953704,11953960,256
"29539","WBGene00198826","I",8608954,8609101,147
"29540","WBGene00198827","V",12929158,12929460,302
"29541","WBGene00198829","V",10637591,10637673,82
"29542","WBGene00198830","III",8209966,8210052,86
"29543","WBGene00198831","V",6348911,6349131,220
"29544","WBGene00198832","IV",9949432,9949697,265
"29545","WBGene00198834","IV",6564321,6564470,149
"29546","WBGene00198835","X",15027749,15027876,127
"29547","WBGene00198836","III",2648346,2648471,125
"29548","WBGene00198838","I",9854233,9854382,149
"29549","WBGene00198839","I",5780981,5781129,148
"29550","WBGene00198840","V",5445569,5445712,143
"29551","WBGene00198841","X",5170104,5170329,225
"29552","WBGene00198842","X",8097431,8097646,215
"29553","WBGene00198843","V",6745694,6745873,179
"29554","WBGene00198844","III",5967874,5968023,149
"29555","WBGene00198845","V",12325562,12325769,207
"29556","WBGene00198846","III",12212579,12212680,101
"29557","WBGene00198847","X",9568783,9568907,124
"29558","WBGene00198848","I",10734143,10734256,113
"29559","WBGene00198849","X",3198879,3199097,218
"29560","WBGene00198850","II",11532138,11532225,87
"29561","WBGene00198851","X",10164641,10164691,50
"29562","WBGene00198852","V",5849945,5850092,147
"29563","WBGene00198853","II",6229150,6229218,68
"29564","WBGene00198854","X",12081503,12081716,213
"29565","WBGene00198855","II",5901804,5902066,262
"29566","WBGene00198856","X",11467176,11467530,354
"29567","WBGene00198857","V",19723025,19723113,88
"29568","WBGene00198858","X",5129564,5129863,299
"29569","WBGene00198859","II",9028705,9028906,201
"29570","WBGene00198860","III",8106652,8106737,85
"29571","WBGene00198861","X",15296386,15296511,125
"29572","WBGene00198863","X",7718938,7719074,136
"29573","WBGene00198864","IV",10980862,10981058,196
"29574","WBGene00198865","X",12050216,12050430,214
"29575","WBGene00198869","X",7462849,7462987,138
"29576","WBGene00198870","X",2747773,2747983,210
"29577","WBGene00198872","X",14994098,14994233,135
"29578","WBGene00198873","V",12038653,12039151,498
"29579","WBGene00198874","V",11758839,11759125,286
"29580","WBGene00198875","X",15511866,15511959,93
"29581","WBGene00198878","V",10723823,10723943,120
"29582","WBGene00198879","X",14042818,14043079,261
"29583","WBGene00198880","V",7099063,7099196,133
"29584","WBGene00198881","X",13638364,13638493,129
"29585","WBGene00198883","I",2678059,2678205,146
"29586","WBGene00198885","II",6175289,6175428,139
"29587","WBGene00198887","V",10915505,10915651,146
"29588","WBGene00198888","X",5763914,5764017,103
"29589","WBGene00198889","III",4617038,4617187,149
"29590","WBGene00198890","X",5490461,5490541,80
"29591","WBGene00198895","III",4392675,4392733,58
"29592","WBGene00198896","X",10166785,10167063,278
"29593","WBGene00198898","V",11098928,11099073,145
"29594","WBGene00198899","X",7467637,7467773,136
"29595","WBGene00198901","IV",6389970,6390098,128
"29596","WBGene00198903","IV",3789132,3789248,116
"29597","WBGene00198904","V",1165128,1165196,68
"29598","WBGene00198905","II",8875072,8875249,177
"29599","WBGene00198906","II",10529447,10529798,351
"29600","WBGene00198907","X",10596667,10596751,84
"29601","WBGene00198908","V",11847084,11847306,222
"29602","WBGene00198910","X",7524855,7524993,138
"29603","WBGene00198911","II",14076767,14076908,141
"29604","WBGene00198912","X",3477575,3477710,135
"29605","WBGene00198914","IV",9915956,9916151,195
"29606","WBGene00198916","II",8893384,8893944,560
"29607","WBGene00198917","X",4686157,4686217,60
"29608","WBGene00198918","IV",10958282,10958420,138
"29609","WBGene00198919","III",1220976,1221117,141
"29610","WBGene00198920","V",11009356,11009489,133
"29611","WBGene00198924","II",6968392,6968562,170
"29612","WBGene00198925","III",10297208,10297342,134
"29613","WBGene00198926","IV",1404619,1404674,55
"29614","WBGene00198927","X",5847430,5847563,133
"29615","WBGene00198929","IV",7390275,7390419,144
"29616","WBGene00198930","V",10266122,10266259,137
"29617","WBGene00198931","X",15742034,15742154,120
"29618","WBGene00198932","IV",138965,139091,126
"29619","WBGene00198934","II",13932296,13932436,140
"29620","WBGene00198936","X",6101029,6101165,136
"29621","WBGene00198940","V",6267426,6267720,294
"29622","WBGene00198941","I",8631879,8632030,151
"29623","WBGene00198942","III",551008,551069,61
"29624","WBGene00198943","III",1099775,1099830,55
"29625","WBGene00198944","IV",16398681,16398807,126
"29626","WBGene00198945","V",14028461,14028640,179
"29627","WBGene00198946","I",5879139,5879491,352
"29628","WBGene00198947","X",7638927,7639061,134
"29629","WBGene00198950","III",13635866,13635998,132
"29630","WBGene00198951","V",5850618,5850762,144
"29631","WBGene00198952","X",17038605,17038743,138
"29632","WBGene00198953","II",1375070,1375216,146
"29633","WBGene00198954","V",9886412,9886474,62
"29634","WBGene00198955","X",12175132,12175276,144
"29635","WBGene00198958","III",4451137,4451286,149
"29636","WBGene00198959","X",11757819,11757920,101
"29637","WBGene00198960","X",9501316,9501429,113
"29638","WBGene00198961","X",5554879,5555020,141
"29639","WBGene00198962","X",6235779,6235954,175
"29640","WBGene00198963","X",2101113,2101242,129
"29641","WBGene00198964","III",8865268,8865366,98
"29642","WBGene00198966","III",13167633,13167689,56
"29643","WBGene00198970","X",10132282,10132431,149
"29644","WBGene00198973","X",2206581,2206723,142
"29645","WBGene00198975","IV",6790115,6790336,221
"29646","WBGene00198976","X",11569848,11569917,69
"29647","WBGene00198979","V",8942856,8942999,143
"29648","WBGene00198980","IV",6026607,6026825,218
"29649","WBGene00198981","V",6621175,6621319,144
"29650","WBGene00198982","X",8052906,8053089,183
"29651","WBGene00198985","IV",6881228,6881359,131
"29652","WBGene00198987","II",15255361,15255436,75
"29653","WBGene00198988","IV",9473362,9473423,61
"29654","WBGene00198991","III",9744517,9744937,420
"29655","WBGene00198992","X",3611359,3611495,136
"29656","WBGene00198993","IV",9944477,9944626,149
"29657","WBGene00198994","IV",6954784,6954925,141
"29658","WBGene00198995","II",13963105,13963213,108
"29659","WBGene00198998","III",6590533,6590586,53
"29660","WBGene00199000","X",2358345,2358541,196
"29661","WBGene00199003","III",766504,766653,149
"29662","WBGene00199005","I",10432630,10432761,131
"29663","WBGene00199006","V",12985769,12985827,58
"29664","WBGene00199007","X",9126153,9126302,149
"29665","WBGene00199008","I",6133007,6133129,122
"29666","WBGene00199009","X",3697755,3697852,97
"29667","WBGene00199010","I",5722399,5722547,148
"29668","WBGene00199011","X",8486822,8487109,287
"29669","WBGene00199012","X",8426708,8426968,260
"29670","WBGene00199013","I",13535827,13535906,79
"29671","WBGene00199016","V",6227322,6227605,283
"29672","WBGene00199017","I",1738614,1738724,110
"29673","WBGene00199018","X",10591152,10591372,220
"29674","WBGene00199019","V",12487364,12487513,149
"29675","WBGene00199020","III",11020516,11020664,148
"29676","WBGene00199024","II",5188282,5188413,131
"29677","WBGene00199025","IV",3508959,3509108,149
"29678","WBGene00199027","II",13444414,13444463,49
"29679","WBGene00199029","IV",12416924,12417019,95
"29680","WBGene00199031","X",12180739,12180950,211
"29681","WBGene00199032","II",11089631,11089780,149
"29682","WBGene00199033","X",15516462,15516649,187
"29683","WBGene00199034","X",3200688,3201049,361
"29684","WBGene00199035","V",12918191,12918772,581
"29685","WBGene00199036","I",4311816,4311888,72
"29686","WBGene00199037","IV",7276737,7276872,135
"29687","WBGene00199038","X",15290794,15290936,142
"29688","WBGene00199039","I",9894898,9895116,218
"29689","WBGene00199040","II",7613344,7613490,146
"29690","WBGene00199041","II",11199004,11199213,209
"29691","WBGene00199042","IV",6773627,6773687,60
"29692","WBGene00199044","I",3402254,3402325,71
"29693","WBGene00199045","II",15165891,15166026,135
"29694","WBGene00199046","X",10931913,10932049,136
"29695","WBGene00199047","X",15828686,15828834,148
"29696","WBGene00199048","X",10123265,10123475,210
"29697","WBGene00199049","V",1348197,1348249,52
"29698","WBGene00199050","IV",2126770,2126869,99
"29699","WBGene00199051","X",6744272,6744601,329
"29700","WBGene00199052","X",5314541,5314983,442
"29701","WBGene00199053","II",9071154,9071303,149
"29702","WBGene00199054","X",5874837,5874964,127
"29703","WBGene00199056","X",10843933,10844063,130
"29704","WBGene00199057","II",7794453,7794602,149
"29705","WBGene00199059","III",1604580,1604664,84
"29706","WBGene00199060","X",3190270,3190477,207
"29707","WBGene00199062","I",10001314,10001534,220
"29708","WBGene00199063","II",6712544,6712692,148
"29709","WBGene00199065","V",10834571,10834693,122
"29710","WBGene00199066","V",5616051,5616273,222
"29711","WBGene00199069","V",11628561,11628704,143
"29712","WBGene00199073","V",6348277,6348485,208
"29713","WBGene00199074","X",13488582,13488744,162
"29714","WBGene00199075","V",13645973,13646042,69
"29715","WBGene00199076","V",11202281,11202420,139
"29716","WBGene00199077","I",9858282,9858430,148
"29717","WBGene00199078","III",8678483,8678574,91
"29718","WBGene00199079","X",13536926,13537074,148
"29719","WBGene00199080","V",11707812,11707944,132
"29720","WBGene00199082","II",3035338,3035459,121
"29721","WBGene00199083","IV",7453497,7453638,141
"29722","WBGene00199084","X",15161218,15161312,94
"29723","WBGene00199085","X",12161552,12161772,220
"29724","WBGene00199086","X",7457248,7457395,147
"29725","WBGene00199089","X",16019555,16019704,149
"29726","WBGene00199090","X",17261755,17262044,289
"29727","WBGene00199091","V",10564424,10564555,131
"29728","WBGene00199093","V",6352484,6352688,204
"29729","WBGene00199094","X",16407272,16407415,143
"29730","WBGene00199095","II",8948134,8948313,179
"29731","WBGene00199096","X",10009107,10009191,84
"29732","WBGene00199097","X",7037215,7037344,129
"29733","WBGene00199098","X",7994361,7994537,176
"29734","WBGene00199099","V",14864392,14864541,149
"29735","WBGene00199100","IV",2303147,2303211,64
"29736","WBGene00199101","X",7607015,7607157,142
"29737","WBGene00199102","II",15036205,15036349,144
"29738","WBGene00199103","I",2758298,2758405,107
"29739","WBGene00199104","II",9072948,9073017,69
"29740","WBGene00199106","I",4778890,4779037,147
"29741","WBGene00199107","IV",11721428,11721577,149
"29742","WBGene00199110","II",6342816,6342876,60
"29743","WBGene00199112","II",8028170,8028555,385
"29744","WBGene00199113","I",11596688,11596757,69
"29745","WBGene00199114","II",10529373,10529774,401
"29746","WBGene00199115","IV",3162345,3162463,118
"29747","WBGene00199116","I",5494417,5494474,57
"29748","WBGene00199117","III",8211648,8211842,194
"29749","WBGene00199118","X",9971454,9971619,165
"29750","WBGene00199121","V",10466680,10466824,144
"29751","WBGene00199122","II",7725251,7725396,145
"29752","WBGene00199123","X",14958671,14958856,185
"29753","WBGene00199125","V",13563274,13563448,174
"29754","WBGene00199126","IV",6139076,6139219,143
"29755","WBGene00199127","II",14898116,14898231,115
"29756","WBGene00199131","II",3525573,3525620,47
"29757","WBGene00199133","V",5799450,5799653,203
"29758","WBGene00199135","X",12255600,12255738,138
"29759","WBGene00199139","II",574127,574270,143
"29760","WBGene00199141","V",12886632,12886718,86
"29761","WBGene00199142","X",2664275,2664574,299
"29762","WBGene00199143","V",8559980,8560079,99
"29763","WBGene00199145","II",9211790,9211890,100
"29764","WBGene00199147","V",5780154,5780254,100
"29765","WBGene00199149","V",10330697,10330836,139
"29766","WBGene00199152","X",4072647,4072842,195
"29767","WBGene00199153","X",4760696,4760894,198
"29768","WBGene00199154","III",9119142,9119291,149
"29769","WBGene00199156","X",6783007,6783155,148
"29770","WBGene00199157","II",10099963,10100060,97
"29771","WBGene00199158","X",10479128,10479362,234
"29772","WBGene00199159","V",14817213,14817360,147
"29773","WBGene00199160","I",5216231,5216370,139
"29774","WBGene00199161","II",8832222,8832359,137
"29775","WBGene00199164","III",12302252,12302303,51
"29776","WBGene00199166","II",8750332,8750635,303
"29777","WBGene00199170","X",15296850,15297122,272
"29778","WBGene00199171","IV",17366630,17366821,191
"29779","WBGene00199172","III",1144180,1144268,88
"29780","WBGene00199175","X",13021528,13021656,128
"29781","WBGene00199176","X",5801469,5801552,83
"29782","WBGene00199177","V",11427809,11427984,175
"29783","WBGene00199179","X",14577697,14577904,207
"29784","WBGene00199180","V",8334256,8334307,51
"29785","WBGene00199181","X",3223306,3223569,263
"29786","WBGene00199184","V",12576883,12577097,214
"29787","WBGene00199188","III",10624730,10624817,87
"29788","WBGene00199190","III",9989480,9989628,148
"29789","WBGene00199191","I",10398621,10398759,138
"29790","WBGene00199193","IV",546002,546089,87
"29791","WBGene00199194","X",6217547,6217694,147
"29792","WBGene00199197","V",6471500,6471700,200
"29793","WBGene00199198","X",13576986,13577119,133
"29794","WBGene00199199","X",11137625,11137760,135
"29795","WBGene00199200","I",14162846,14162939,93
"29796","WBGene00199201","I",2876337,2876554,217
"29797","WBGene00199203","II",8984034,8984317,283
"29798","WBGene00199204","V",11458666,11458880,214
"29799","WBGene00199206","II",7678635,7679048,413
"29800","WBGene00199208","V",12987943,12988110,167
"29801","WBGene00199211","I",8459050,8459331,281
"29802","WBGene00199212","X",10768872,10769074,202
"29803","WBGene00199213","III",3377875,3378377,502
"29804","WBGene00199214","X",10085964,10086036,72
"29805","WBGene00199217","I",4322310,4322459,149
"29806","WBGene00199218","III",9968937,9969109,172
"29807","WBGene00199219","X",17200395,17200525,130
"29808","WBGene00199221","III",4769873,4770018,145
"29809","WBGene00199224","X",2920477,2920617,140
"29810","WBGene00199225","II",9757952,9758061,109
"29811","WBGene00199226","III",1929684,1929732,48
"29812","WBGene00199227","X",7170852,7170987,135
"29813","WBGene00199229","V",6233098,6233234,136
"29814","WBGene00199235","III",4747989,4748132,143
"29815","WBGene00199236","II",7815056,7815267,211
"29816","WBGene00199238","V",12665380,12665518,138
"29817","WBGene00199241","X",14874301,14874737,436
"29818","WBGene00199242","IV",5956954,5957103,149
"29819","WBGene00199243","X",14633982,14634100,118
"29820","WBGene00199245","X",15530394,15530445,51
"29821","WBGene00199246","X",3781123,3781246,123
"29822","WBGene00199247","V",9082724,9082860,136
"29823","WBGene00199248","V",11453843,11454057,214
"29824","WBGene00199249","X",1089836,1089903,67
"29825","WBGene00199250","I",9555802,9556018,216
"29826","WBGene00199251","X",15274212,15274324,112
"29827","WBGene00199253","IV",8938710,8938786,76
"29828","WBGene00199254","X",15131081,15131215,134
"29829","WBGene00199255","X",2301865,2302002,137
"29830","WBGene00199256","I",10752419,10752557,138
"29831","WBGene00199258","X",5841185,5841361,176
"29832","WBGene00199259","IV",11790415,11790564,149
"29833","WBGene00199260","X",12642122,12642248,126
"29834","WBGene00199261","X",8986583,8986699,116
"29835","WBGene00199262","X",8691517,8691713,196
"29836","WBGene00199263","III",207301,207368,67
"29837","WBGene00199266","X",2056199,2056348,149
"29838","WBGene00199267","II",11788286,11788339,53
"29839","WBGene00199268","X",5100018,5100171,153
"29840","WBGene00199270","II",6410826,6410956,130
"29841","WBGene00199272","IV",6997680,6997808,128
"29842","WBGene00199273","III",5814760,5814819,59
"29843","WBGene00199274","IV",2996038,2996186,148
"29844","WBGene00199275","V",10388296,10388442,146
"29845","WBGene00199277","IV",10828161,10828296,135
"29846","WBGene00199278","III",5086477,5086558,81
"29847","WBGene00199280","I",9605751,9605844,93
"29848","WBGene00199281","IV",2433742,2433792,50
"29849","WBGene00199283","II",13145135,13145310,175
"29850","WBGene00199284","IV",5922440,5922588,148
"29851","WBGene00199287","IV",6364714,6364826,112
"29852","WBGene00199289","V",6925728,6925872,144
"29853","WBGene00199290","X",3455554,3455701,147
"29854","WBGene00199291","V",14499554,14499640,86
"29855","WBGene00199293","X",5730730,5730857,127
"29856","WBGene00199294","X",697838,697958,120
"29857","WBGene00199295","V",11169277,11169559,282
"29858","WBGene00199296","V",12551724,12551855,131
"29859","WBGene00199297","I",6525051,6525215,164
"29860","WBGene00199300","I",6866589,6866731,142
"29861","WBGene00199301","X",12878090,12878222,132
"29862","WBGene00199303","X",11872229,11872313,84
"29863","WBGene00199304","IV",8193174,8193373,199
"29864","WBGene00199306","X",13556407,13556573,166
"29865","WBGene00199307","V",11949373,11949510,137
"29866","WBGene00199308","II",11402677,11402825,148
"29867","WBGene00199311","X",3348040,3348146,106
"29868","WBGene00199312","II",8896580,8896721,141
"29869","WBGene00199313","X",3411985,3412107,122
"29870","WBGene00199314","V",14506038,14506183,145
"29871","WBGene00199315","V",11078682,11078751,69
"29872","WBGene00199316","X",7556358,7556507,149
"29873","WBGene00199317","X",5919084,5919210,126
"29874","WBGene00199318","I",10770571,10770720,149
"29875","WBGene00199319","III",6313888,6314034,146
"29876","WBGene00199321","II",5957680,5957819,139
"29877","WBGene00199322","IV",17252225,17252351,126
"29878","WBGene00199323","V",8343489,8343602,113
"29879","WBGene00199325","III",3345994,3346111,117
"29880","WBGene00199326","X",16797115,16797174,59
"29881","WBGene00199327","X",4619698,4619900,202
"29882","WBGene00199329","X",3317231,3317475,244
"29883","WBGene00199330","X",15912383,15912529,146
"29884","WBGene00199331","II",11868495,11868635,140
"29885","WBGene00199332","X",5492808,5492910,102
"29886","WBGene00199333","I",10389828,10389960,132
"29887","WBGene00199334","V",9073432,9073628,196
"29888","WBGene00199336","II",8125653,8125786,133
"29889","WBGene00199338","X",7648383,7648603,220
"29890","WBGene00199342","IV",11431652,11431798,146
"29891","WBGene00199343","X",11369047,11369158,111
"29892","WBGene00199344","V",9385564,9385772,208
"29893","WBGene00199348","X",12675197,12675346,149
"29894","WBGene00199349","X",11759059,11759194,135
"29895","WBGene00199353","IV",6840691,6840824,133
"29896","WBGene00199354","IV",5811209,5811365,156
"29897","WBGene00199356","V",12340578,12340636,58
"29898","WBGene00199358","X",4487115,4487164,49
"29899","WBGene00199360","II",11752835,11752984,149
"29900","WBGene00199362","I",8852705,8852765,60
"29901","WBGene00199363","II",10100098,10100303,205
"29902","WBGene00199364","X",13124637,13124783,146
"29903","WBGene00199365","X",9932367,9932496,129
"29904","WBGene00199367","V",18688865,18688944,79
"29905","WBGene00199368","II",12989466,12989649,183
"29906","WBGene00199370","V",5697696,5697836,140
"29907","WBGene00199371","V",11314223,11314316,93
"29908","WBGene00199373","X",10503648,10503766,118
"29909","WBGene00199374","X",4553078,4553209,131
"29910","WBGene00199375","V",13563628,13563717,89
"29911","WBGene00199376","III",11478649,11478766,117
"29912","WBGene00199378","V",18527655,18527759,104
"29913","WBGene00199380","II",7589943,7590088,145
"29914","WBGene00199381","III",13413400,13413496,96
"29915","WBGene00199382","X",3312845,3313011,166
"29916","WBGene00199383","IV",11712398,11712544,146
"29917","WBGene00199384","X",10311234,10311442,208
"29918","WBGene00199385","X",3072404,3072546,142
"29919","WBGene00199386","X",6219350,6219460,110
"29920","WBGene00199387","IV",7198736,7199088,352
"29921","WBGene00199388","II",1242097,1242171,74
"29922","WBGene00199389","X",9141338,9141517,179
"29923","WBGene00199391","V",10641613,10641734,121
"29924","WBGene00199392","X",507067,507210,143
"29925","WBGene00199393","X",852865,853014,149
"29926","WBGene00199394","I",12521525,12521646,121
"29927","WBGene00199396","X",16532556,16532730,174
"29928","WBGene00199397","II",8212832,8212943,111
"29929","WBGene00199398","V",8662340,8662476,136
"29930","WBGene00199399","X",7641673,7641783,110
"29931","WBGene00199400","I",6238574,6238710,136
"29932","WBGene00199401","III",4518243,4518435,192
"29933","WBGene00199402","III",5720418,5720561,143
"29934","WBGene00199404","III",9546143,9546340,197
"29935","WBGene00199405","X",10119413,10119653,240
"29936","WBGene00199406","V",2707867,2707948,81
"29937","WBGene00199407","I",4410871,4411060,189
"29938","WBGene00199408","I",12728003,12728151,148
"29939","WBGene00199409","II",4811336,4811433,97
"29940","WBGene00199410","X",6244429,6244578,149
"29941","WBGene00199412","IV",5334696,5334843,147
"29942","WBGene00199413","X",13443374,13443504,130
"29943","WBGene00199414","X",7506598,7506743,145
"29944","WBGene00199416","I",13369999,13370080,81
"29945","WBGene00199417","I",2835345,2835482,137
"29946","WBGene00199418","V",4116684,4116741,57
"29947","WBGene00199419","III",3586143,3586247,104
"29948","WBGene00199420","V",9112347,9112571,224
"29949","WBGene00199421","V",6354245,6354389,144
"29950","WBGene00199422","I",801555,801698,143
"29951","WBGene00199423","IV",11996499,11996613,114
"29952","WBGene00199424","X",2526209,2526291,82
"29953","WBGene00199425","X",6147736,6147877,141
"29954","WBGene00199426","II",7461714,7461857,143
"29955","WBGene00199429","X",6689257,6689456,199
"29956","WBGene00199432","I",11933465,11933575,110
"29957","WBGene00199433","X",13730758,13730867,109
"29958","WBGene00199434","IV",6785415,6785536,121
"29959","WBGene00199435","II",7928345,7928422,77
"29960","WBGene00199436","I",11244290,11244385,95
"29961","WBGene00199437","IV",7663144,7663291,147
"29962","WBGene00199438","X",11086472,11086531,59
"29963","WBGene00199440","X",16445806,16446025,219
"29964","WBGene00199441","IV",5967106,5967297,191
"29965","WBGene00199444","II",14208524,14208658,134
"29966","WBGene00199446","IV",4578137,4578267,130
"29967","WBGene00199447","X",11405159,11405299,140
"29968","WBGene00199448","X",13675845,13675985,140
"29969","WBGene00199449","X",6971001,6971141,140
"29970","WBGene00199450","II",5223645,5223770,125
"29971","WBGene00199451","V",6879479,6879874,395
"29972","WBGene00199452","IV",15604302,15604384,82
"29973","WBGene00199454","V",5868982,5869144,162
"29974","WBGene00199455","V",5160620,5160766,146
"29975","WBGene00199456","V",6348913,6349136,223
"29976","WBGene00199457","III",6836965,6837110,145
"29977","WBGene00199458","V",10680063,10680277,214
"29978","WBGene00199459","V",18175251,18175314,63
"29979","WBGene00199460","III",6638932,6639138,206
"29980","WBGene00199461","II",7545434,7545560,126
"29981","WBGene00199462","II",7724749,7724892,143
"29982","WBGene00199463","I",6592082,6592231,149
"29983","WBGene00199465","X",5506767,5506869,102
"29984","WBGene00199467","I",12061010,12061103,93
"29985","WBGene00199470","II",10304761,10304846,85
"29986","WBGene00199471","II",5605635,5605783,148
"29987","WBGene00199472","V",5567878,5568102,224
"29988","WBGene00199473","X",12492679,12492824,145
"29989","WBGene00199474","V",12220592,12220751,159
"29990","WBGene00199475","III",7730850,7730999,149
"29991","WBGene00199476","V",13073249,13073395,146
"29992","WBGene00199477","V",11431140,11431288,148
"29993","WBGene00199478","IV",9118388,9118644,256
"29994","WBGene00199479","IV",11796553,11796699,146
"29995","WBGene00199480","V",6875872,6876091,219
"29996","WBGene00199481","V",11437864,11437919,55
"29997","WBGene00199483","III",11728404,11728552,148
"29998","WBGene00199485","IV",11821992,11822209,217
"29999","WBGene00199487","IV",12058891,12059040,149
"30000","WBGene00199488","V",6227530,6227897,367
"30001","WBGene00199489","X",16629835,16629977,142
"30002","WBGene00199493","III",9699494,9699643,149
"30003","WBGene00199495","I",10169441,10169580,139
"30004","WBGene00199498","III",6747422,6747586,164
"30005","WBGene00199499","V",13689501,13689725,224
"30006","WBGene00199501","X",2035289,2035504,215
"30007","WBGene00199502","V",11189975,11190173,198
"30008","WBGene00199504","V",5226574,5226952,378
"30009","WBGene00199505","I",10062220,10062354,134
"30010","WBGene00199507","X",7019693,7019818,125
"30011","WBGene00199508","I",14282075,14282140,65
"30012","WBGene00199509","IV",6984197,6984547,350
"30013","WBGene00199512","II",6234133,6234255,122
"30014","WBGene00199513","III",8985092,8985191,99
"30015","WBGene00199514","III",7494873,7495012,139
"30016","WBGene00199515","X",3527275,3527419,144
"30017","WBGene00199516","IV",12401218,12401366,148
"30018","WBGene00199517","X",15575526,15575801,275
"30019","WBGene00199518","X",6520083,6520227,144
"30020","WBGene00199521","X",2774824,2774968,144
"30021","WBGene00199522","III",3785725,3785874,149
"30022","WBGene00199523","I",10406129,10406272,143
"30023","WBGene00199524","X",7200117,7200239,122
"30024","WBGene00199525","X",11270890,11271006,116
"30025","WBGene00199528","II",9566239,9566322,83
"30026","WBGene00199529","IV",4383907,4383964,57
"30027","WBGene00199530","I",10669868,10670017,149
"30028","WBGene00199531","I",9551121,9551266,145
"30029","WBGene00199532","II",11947579,11947716,137
"30030","WBGene00199534","X",15385878,15386026,148
"30031","WBGene00199535","V",20694110,20694195,85
"30032","WBGene00199538","X",11814029,11814194,165
"30033","WBGene00199541","IV",15059461,15059685,224
"30034","WBGene00199542","V",20032726,20032875,149
"30035","WBGene00199547","III",708557,708706,149
"30036","WBGene00199548","II",12679804,12679861,57
"30037","WBGene00199549","IV",11649463,11649597,134
"30038","WBGene00199550","X",2506761,2506833,72
"30039","WBGene00199552","III",8821562,8821653,91
"30040","WBGene00199553","X",12908670,12908803,133
"30041","WBGene00199554","X",5859429,5859575,146
"30042","WBGene00199557","III",8873960,8874078,118
"30043","WBGene00199558","V",10466669,10466813,144
"30044","WBGene00199559","II",6435988,6436110,122
"30045","WBGene00199561","III",11459443,11459550,107
"30046","WBGene00199562","X",16532790,16533049,259
"30047","WBGene00199563","X",14054048,14054383,335
"30048","WBGene00199565","X",10901139,10901203,64
"30049","WBGene00199568","X",15428271,15428475,204
"30050","WBGene00199569","X",4444257,4444398,141
"30051","WBGene00199572","X",6893862,6893983,121
"30052","WBGene00199573","IV",7849611,7849778,167
"30053","WBGene00199575","X",15222275,15222406,131
"30054","WBGene00199576","II",368533,368618,85
"30055","WBGene00199578","III",11371455,11371530,75
"30056","WBGene00199579","X",8198069,8198265,196
"30057","WBGene00199580","II",10967167,10967231,64
"30058","WBGene00199583","V",7744238,7744346,108
"30059","WBGene00199585","X",434390,434522,132
"30060","WBGene00199587","X",12256263,12256412,149
"30061","WBGene00199589","X",6958363,6958436,73
"30062","WBGene00199594","X",8257745,8257890,145
"30063","WBGene00199598","X",6687212,6687435,223
"30064","WBGene00199599","X",7457469,7457609,140
"30065","WBGene00199603","IV",14621524,14621580,56
"30066","WBGene00199604","III",10783027,10783159,132
"30067","WBGene00199605","X",10963817,10963914,97
"30068","WBGene00199606","II",7809203,7809409,206
"30069","WBGene00199608","X",10935142,10935274,132
"30070","WBGene00199609","I",5778431,5778493,62
"30071","WBGene00199610","X",5662894,5663223,329
"30072","WBGene00199612","X",16618286,16618374,88
"30073","WBGene00199613","III",8287782,8287922,140
"30074","WBGene00199615","V",11756644,11756898,254
"30075","WBGene00199616","III",7814702,7814791,89
"30076","WBGene00199617","V",11658887,11659036,149
"30077","WBGene00199618","II",3984329,3984520,191
"30078","WBGene00199619","III",5662456,5662679,223
"30079","WBGene00199620","III",10967192,10967341,149
"30080","WBGene00199622","I",8917852,8918001,149
"30081","WBGene00199624","X",15288870,15289094,224
"30082","WBGene00199625","III",3740956,3741036,80
"30083","WBGene00199626","V",5456490,5456706,216
"30084","WBGene00199627","X",3822565,3822795,230
"30085","WBGene00199628","IV",16382402,16382508,106
"30086","WBGene00199629","I",9914947,9915096,149
"30087","WBGene00199630","II",11088105,11088300,195
"30088","WBGene00199631","II",5900229,5900328,99
"30089","WBGene00199632","X",6485073,6485324,251
"30090","WBGene00199633","II",6141728,6141863,135
"30091","WBGene00199634","X",7269709,7269858,149
"30092","WBGene00199635","I",2368687,2368744,57
"30093","WBGene00199636","V",6013281,6013403,122
"30094","WBGene00199637","X",7378766,7378860,94
"30095","WBGene00199638","X",2459885,2460033,148
"30096","WBGene00199639","V",14366611,14366756,145
"30097","WBGene00199640","I",9039990,9040126,136
"30098","WBGene00199641","V",9609407,9609615,208
"30099","WBGene00199642","IV",5657318,5657370,52
"30100","WBGene00199643","X",10660952,10661145,193
"30101","WBGene00199644","V",12342079,12342275,196
"30102","WBGene00199645","II",6866341,6866426,85
"30103","WBGene00199647","V",6463029,6463178,149
"30104","WBGene00199648","I",8783875,8784034,159
"30105","WBGene00199649","X",5793598,5793736,138
"30106","WBGene00199652","X",5728960,5729182,222
"30107","WBGene00199653","IV",5986890,5987170,280
"30108","WBGene00199655","III",4131203,4131345,142
"30109","WBGene00199656","X",9806711,9806849,138
"30110","WBGene00199657","III",4875838,4875962,124
"30111","WBGene00199658","II",10989933,10990078,145
"30112","WBGene00199660","X",14269370,14269504,134
"30113","WBGene00199661","X",3970093,3970283,190
"30114","WBGene00199662","I",11653252,11653343,91
"30115","WBGene00199663","V",8779604,8779796,192
"30116","WBGene00199665","IV",10193552,10193767,215
"30117","WBGene00199666","IV",6391403,6391592,189
"30118","WBGene00199667","X",11651504,11651731,227
"30119","WBGene00199669","I",3248205,3248416,211
"30120","WBGene00199670","I",6286348,6286572,224
"30121","WBGene00199671","III",12192243,12192297,54
"30122","WBGene00199672","X",5799050,5799389,339
"30123","WBGene00199674","II",14496894,14497177,283
"30124","WBGene00199675","X",11872506,11872590,84
"30125","WBGene00199676","III",8479483,8479691,208
"30126","WBGene00199678","X",6309047,6309235,188
"30127","WBGene00199679","X",488295,488444,149
"30128","WBGene00199682","X",14019962,14020123,161
"30129","WBGene00199686","II",6397644,6397786,142
"30130","WBGene00199687","II",12343635,12343688,53
"30131","WBGene00199689","X",5696304,5696434,130
"30132","WBGene00199690","X",5603968,5604150,182
"30133","WBGene00199691","IV",784513,784607,94
"30134","WBGene00199692","IV",11210982,11211199,217
"30135","WBGene00199693","II",6827619,6827763,144
"30136","WBGene00199694","II",15273617,15273693,76
"30137","WBGene00199695","II",13835916,13836122,206
"30138","WBGene00199696","IV",11491464,11491527,63
"30139","WBGene00199697","I",11669985,11670094,109
"30140","WBGene00199698","III",9861964,9862113,149
"30141","WBGene00199699","II",11589728,11589877,149
"30142","WBGene00199700","X",8262818,8263025,207
"30143","WBGene00199701","III",7206792,7206941,149
"30144","WBGene00199702","X",9602794,9602857,63
"30145","WBGene00199705","V",11350184,11350262,78
"30146","WBGene00199707","X",8955911,8956002,91
"30147","WBGene00199708","X",5476577,5476691,114
"30148","WBGene00199710","I",5344872,5345013,141
"30149","WBGene00199711","X",7215547,7215688,141
"30150","WBGene00199713","IV",6556814,6556909,95
"30151","WBGene00199714","V",4803102,4803228,126
"30152","WBGene00199716","X",11135783,11135925,142
"30153","WBGene00199717","V",11231869,11232053,184
"30154","WBGene00199718","I",7290946,7291013,67
"30155","WBGene00199720","II",1349052,1349201,149
"30156","WBGene00199722","X",9078241,9078332,91
"30157","WBGene00199723","II",488882,488964,82
"30158","WBGene00199724","II",5782209,5782288,79
"30159","WBGene00199725","III",11406618,11406842,224
"30160","WBGene00199726","IV",9464494,9464642,148
"30161","WBGene00199727","X",3798005,3798157,152
"30162","WBGene00199728","V",6359289,6359430,141
"30163","WBGene00199729","V",8051686,8051808,122
"30164","WBGene00199731","III",7978471,7978545,74
"30165","WBGene00199734","I",9722202,9722424,222
"30166","WBGene00199735","II",8296172,8296311,139
"30167","WBGene00199736","X",12086314,12086473,159
"30168","WBGene00199738","X",15158850,15158977,127
"30169","WBGene00199740","II",11617753,11617883,130
"30170","WBGene00199742","V",10039888,10040022,134
"30171","WBGene00199744","V",9853952,9854019,67
"30172","WBGene00199745","III",4612700,4612754,54
"30173","WBGene00199746","V",13683109,13683247,138
"30174","WBGene00199748","III",6801979,6802112,133
"30175","WBGene00199750","V",7964690,7964837,147
"30176","WBGene00199751","IV",11112001,11112189,188
"30177","WBGene00199752","V",11898931,11899145,214
"30178","WBGene00199753","V",7922920,7923057,137
"30179","WBGene00199754","III",4968391,4968517,126
"30180","WBGene00199756","X",14886314,14886462,148
"30181","WBGene00199758","X",7170884,7171017,133
"30182","WBGene00199759","X",5860335,5860482,147
"30183","WBGene00199761","X",12202045,12202191,146
"30184","WBGene00199763","X",7385731,7385865,134
"30185","WBGene00199764","II",6441174,6441381,207
"30186","WBGene00199766","I",6135718,6135920,202
"30187","WBGene00199767","II",4011457,4011509,52
"30188","WBGene00199768","I",9914276,9914459,183
"30189","WBGene00199769","X",5041121,5041268,147
"30190","WBGene00199770","X",3226762,3226904,142
"30191","WBGene00199771","X",2919596,2919745,149
"30192","WBGene00199772","X",2210201,2210475,274
"30193","WBGene00199773","II",15255469,15255577,108
"30194","WBGene00199775","I",13637212,13637277,65
"30195","WBGene00199776","V",6323910,6324124,214
"30196","WBGene00199777","III",8201620,8201974,354
"30197","WBGene00199778","IV",9898846,9898972,126
"30198","WBGene00199779","II",8748105,8748235,130
"30199","WBGene00199780","II",6032642,6032722,80
"30200","WBGene00199781","I",9456829,9456977,148
"30201","WBGene00199783","III",10808038,10808182,144
"30202","WBGene00199784","IV",12416563,12416706,143
"30203","WBGene00199785","IV",7416363,7416581,218
"30204","WBGene00199786","X",5476995,5477124,129
"30205","WBGene00199787","IV",7420987,7421115,128
"30206","WBGene00199789","X",15200941,15201088,147
"30207","WBGene00199792","IV",6997481,6997571,90
"30208","WBGene00199793","II",9070436,9070517,81
"30209","WBGene00199794","IV",12012463,12012876,413
"30210","WBGene00199795","V",10723173,10723536,363
"30211","WBGene00199797","X",5534335,5534484,149
"30212","WBGene00199798","IV",14013791,14013877,86
"30213","WBGene00199800","X",3063495,3063629,134
"30214","WBGene00199801","X",10018420,10018500,80
"30215","WBGene00199804","X",14162211,14162311,100
"30216","WBGene00199808","V",15515475,15515595,120
"30217","WBGene00199811","V",13810389,13810598,209
"30218","WBGene00199812","IV",7276383,7276595,212
"30219","WBGene00199813","II",3527232,3527284,52
"30220","WBGene00199814","I",11628149,11628355,206
"30221","WBGene00199815","X",3457068,3457192,124
"30222","WBGene00199816","I",5879340,5879554,214
"30223","WBGene00199817","V",8588515,8588654,139
"30224","WBGene00199818","V",20347785,20347873,88
"30225","WBGene00199819","II",8749282,8749399,117
"30226","WBGene00199820","X",11820398,11820483,85
"30227","WBGene00199822","X",15003261,15003393,132
"30228","WBGene00199823","X",6074820,6075018,198
"30229","WBGene00199824","V",6929532,6929681,149
"30230","WBGene00199829","V",11975337,11975480,143
"30231","WBGene00199830","X",3596580,3596720,140
"30232","WBGene00199831","X",6971443,6971586,143
"30233","WBGene00199832","II",6867860,6867975,115
"30234","WBGene00199833","X",17003875,17004144,269
"30235","WBGene00199834","III",1577984,1578043,59
"30236","WBGene00199835","X",13525259,13525465,206
"30237","WBGene00199836","IV",594481,594630,149
"30238","WBGene00199837","X",5603455,5603576,121
"30239","WBGene00199839","X",10931827,10931974,147
"30240","WBGene00199840","I",9858873,9859091,218
"30241","WBGene00199842","X",16440625,16440746,121
"30242","WBGene00199843","IV",4677699,4677811,112
"30243","WBGene00199845","X",16177725,16177791,66
"30244","WBGene00199847","X",12081372,12081570,198
"30245","WBGene00199849","IV",7453424,7453567,143
"30246","WBGene00199851","X",11560633,11560781,148
"30247","WBGene00199853","X",9500013,9500143,130
"30248","WBGene00199854","III",8532546,8532596,50
"30249","WBGene00199855","V",8935076,8935217,141
"30250","WBGene00199856","X",8408700,8408982,282
"30251","WBGene00199857","X",5763804,5763927,123
"30252","WBGene00199858","X",11753302,11753655,353
"30253","WBGene00199859","V",11960270,11960397,127
"30254","WBGene00199861","V",4877039,4877188,149
"30255","WBGene00199862","II",10512203,10512284,81
"30256","WBGene00199864","II",9028704,9028842,138
"30257","WBGene00199865","X",5138764,5138894,130
"30258","WBGene00199866","V",13658733,13658889,156
"30259","WBGene00199867","IV",10981510,10981642,132
"30260","WBGene00199869","V",11705275,11705421,146
"30261","WBGene00199871","V",11673882,11674298,416
"30262","WBGene00199876","III",4616314,4616512,198
"30263","WBGene00199877","IV",9916273,9916412,139
"30264","WBGene00199878","II",11358205,11358331,126
"30265","WBGene00199880","X",6948623,6948772,149
"30266","WBGene00199881","V",12390880,12391063,183
"30267","WBGene00199882","X",15376661,15376751,90
"30268","WBGene00199883","V",12039687,12040046,359
"30269","WBGene00199886","IV",16400125,16400214,89
"30270","WBGene00199888","II",3769101,3769151,50
"30271","WBGene00199889","IV",1373272,1373386,114
"30272","WBGene00199890","V",11949910,11950038,128
"30273","WBGene00199891","V",10818565,10818712,147
"30274","WBGene00199896","V",9685667,9685945,278
"30275","WBGene00199897","V",11844719,11845217,498
"30276","WBGene00199898","V",6930280,6930428,148
"30277","WBGene00199899","I",110551,110771,220
"30278","WBGene00199900","I",2682866,2683011,145
"30279","WBGene00199901","II",14076597,14076746,149
"30280","WBGene00199902","X",5339399,5339538,139
"30281","WBGene00199903","X",10086480,10086579,99
"30282","WBGene00199905","X",12049788,12050001,213
"30283","WBGene00199909","V",12506310,12506452,142
"30284","WBGene00199910","III",3389532,3389628,96
"30285","WBGene00199911","X",7716377,7716518,141
"30286","WBGene00199912","III",6944393,6944542,149
"30287","WBGene00199913","V",1230820,1230968,148
"30288","WBGene00199914","X",5659698,5659863,165
"30289","WBGene00199916","X",8796810,8796895,85
"30290","WBGene00199917","X",4419399,4419607,208
"30291","WBGene00199918","II",6943941,6944018,77
"30292","WBGene00199919","IV",14033942,14034090,148
"30293","WBGene00199922","X",3862540,3862786,246
"30294","WBGene00199923","I",8046557,8046749,192
"30295","WBGene00199924","III",10380842,10380887,45
"30296","WBGene00199926","V",13026696,13026980,284
"30297","WBGene00199927","IV",1415260,1415311,51
"30298","WBGene00199928","I",9914348,9914497,149
"30299","WBGene00199932","IV",5506866,5507124,258
"30300","WBGene00199934","X",14478868,14478954,86
"30301","WBGene00199935","X",10690118,10690194,76
"30302","WBGene00199937","III",5980384,5980519,135
"30303","WBGene00199938","X",15311369,15311503,134
"30304","WBGene00199939","X",10132610,10132762,152
"30305","WBGene00199942","V",13114171,13114307,136
"30306","WBGene00199943","III",4450312,4450401,89
"30307","WBGene00199944","X",15040736,15040935,199
"30308","WBGene00199945","X",10501088,10501194,106
"30309","WBGene00199946","I",8307643,8307733,90
"30310","WBGene00199947","X",8053154,8053499,345
"30311","WBGene00199948","X",4223252,4223327,75
"30312","WBGene00199949","IV",5836278,5836499,221
"30313","WBGene00199950","X",7524887,7525025,138
"30314","WBGene00199952","X",15387763,15387883,120
"30315","WBGene00199953","IV",11842187,11842331,144
"30316","WBGene00199954","X",2749009,2749142,133
"30317","WBGene00199958","II",5367026,5367150,124
"30318","WBGene00199959","X",11116831,11116975,144
"30319","WBGene00199963","V",19208015,19208068,53
"30320","WBGene00199969","III",7625942,7625993,51
"30321","WBGene00199970","V",5442648,5442784,136
"30322","WBGene00199971","I",8909387,8909527,140
"30323","WBGene00199972","X",2048919,2049066,147
"30324","WBGene00199973","IV",6364724,6364905,181
"30325","WBGene00199974","X",6214981,6215104,123
"30326","WBGene00199976","V",11078491,11078633,142
"30327","WBGene00199977","X",10748837,10748904,67
"30328","WBGene00199978","I",10753066,10753212,146
"30329","WBGene00199980","V",18076917,18076973,56
"30330","WBGene00199982","II",5221949,5222158,209
"30331","WBGene00199983","V",11080384,11080603,219
"30332","WBGene00199984","II",3330510,3330562,52
"30333","WBGene00199985","V",11336064,11336367,303
"30334","WBGene00199986","X",15627897,15628039,142
"30335","WBGene00199989","IV",7245989,7246505,516
"30336","WBGene00199991","V",4600961,4601034,73
"30337","WBGene00199992","I",7176696,7176842,146
"30338","WBGene00199994","X",12648316,12648456,140
"30339","WBGene00199995","V",13237791,13237945,154
"30340","WBGene00199996","IV",2439210,2439357,147
"30341","WBGene00199997","IV",5927961,5928086,125
"30342","WBGene00199998","I",8459041,8459254,213
"30343","WBGene00200002","X",5456915,5457061,146
"30344","WBGene00200003","V",6239812,6240017,205
"30345","WBGene00200005","IV",8181668,8181763,95
"30346","WBGene00200006","X",5869740,5869866,126
"30347","WBGene00200008","IV",2997357,2997652,295
"30348","WBGene00200009","II",6118399,6118601,202
"30349","WBGene00200010","II",6209972,6210114,142
"30350","WBGene00200011","V",12214978,12215121,143
"30351","WBGene00200014","V",9225724,9226002,278
"30352","WBGene00200015","III",2683624,2683713,89
"30353","WBGene00200018","IV",12047001,12047146,145
"30354","WBGene00200019","V",14618842,14619106,264
"30355","WBGene00200020","X",15275490,15275550,60
"30356","WBGene00200023","X",11814744,11814865,121
"30357","WBGene00200026","X",15127597,15127737,140
"30358","WBGene00200027","IV",8002455,8002588,133
"30359","WBGene00200030","X",14641172,14641380,208
"30360","WBGene00200032","V",11379048,11379192,144
"30361","WBGene00200033","III",11467830,11467989,159
"30362","WBGene00200035","II",2201558,2201670,112
"30363","WBGene00200036","V",14499218,14499311,93
"30364","WBGene00200039","IV",7326857,7326973,116
"30365","WBGene00200040","X",697530,697662,132
"30366","WBGene00200041","X",6748198,6748259,61
"30367","WBGene00200042","X",3488125,3488383,258
"30368","WBGene00200043","IV",2119242,2119337,95
"30369","WBGene00200044","V",9283328,9283677,349
"30370","WBGene00200045","X",12668238,12668370,132
"30371","WBGene00200046","I",3553556,3553607,51
"30372","WBGene00200047","V",11631208,11631370,162
"30373","WBGene00200051","V",12210138,12210306,168
"30374","WBGene00200053","V",8782994,8783291,297
"30375","WBGene00200054","IV",624064,624270,206
"30376","WBGene00200055","X",13555254,13555403,149
"30377","WBGene00200056","V",9758829,9759084,255
"30378","WBGene00200057","III",7145041,7145183,142
"30379","WBGene00200058","X",12889933,12890030,97
"30380","WBGene00200059","IV",5957206,5957340,134
"30381","WBGene00200061","II",14250477,14250624,147
"30382","WBGene00200062","X",5459669,5459818,149
"30383","WBGene00200063","X",9699758,9699874,116
"30384","WBGene00200064","V",16391349,16391429,80
"30385","WBGene00200065","X",8652482,8652679,197
"30386","WBGene00200068","X",5538746,5539136,390
"30387","WBGene00200070","V",8920402,8920582,180
"30388","WBGene00200071","V",11166184,11166357,173
"30389","WBGene00200074","V",5736412,5736536,124
"30390","WBGene00200075","IV",14611292,14611387,95
"30391","WBGene00200076","X",16407466,16407612,146
"30392","WBGene00200077","X",16378108,16378195,87
"30393","WBGene00200078","III",6513923,6514026,103
"30394","WBGene00200081","II",6713444,6713665,221
"30395","WBGene00200082","X",8152798,8152896,98
"30396","WBGene00200083","II",2847755,2847891,136
"30397","WBGene00200088","V",6353519,6353665,146
"30398","WBGene00200089","V",9318160,9318285,125
"30399","WBGene00200090","V",9503561,9503633,72
"30400","WBGene00200092","V",19393815,19393868,53
"30401","WBGene00200094","V",18922932,18923079,147
"30402","WBGene00200096","I",13297659,13297746,87
"30403","WBGene00200097","X",14679155,14679235,80
"30404","WBGene00200098","I",2876698,2876843,145
"30405","WBGene00200099","III",9817403,9817479,76
"30406","WBGene00200100","X",3832255,3832393,138
"30407","WBGene00200101","I",11951990,11952214,224
"30408","WBGene00200102","IV",2261958,2262107,149
"30409","WBGene00200104","I",4780230,4780323,93
"30410","WBGene00200106","II",4565715,4565805,90
"30411","WBGene00200108","II",3036421,3036633,212
"30412","WBGene00200109","IV",9913045,9913330,285
"30413","WBGene00200112","V",15013019,15013112,93
"30414","WBGene00200115","II",15086831,15086980,149
"30415","WBGene00200116","V",12899080,12899268,188
"30416","WBGene00200117","I",5429936,5430054,118
"30417","WBGene00200118","X",6693062,6693278,216
"30418","WBGene00200119","X",9975913,9976228,315
"30419","WBGene00200121","II",6181712,6181859,147
"30420","WBGene00200122","V",11759552,11759696,144
"30421","WBGene00200123","V",10841715,10841846,131
"30422","WBGene00200126","II",9077516,9077647,131
"30423","WBGene00200127","X",12255330,12255470,140
"30424","WBGene00200128","II",11189583,11189723,140
"30425","WBGene00200129","X",5868163,5868312,149
"30426","WBGene00200131","V",10332293,10332539,246
"30427","WBGene00200132","V",14876385,14876461,76
"30428","WBGene00200133","III",5823024,5823171,147
"30429","WBGene00200134","III",3786664,3786812,148
"30430","WBGene00200135","V",10557197,10557346,149
"30431","WBGene00200136","II",6835587,6835693,106
"30432","WBGene00200138","X",4437651,4437775,124
"30433","WBGene00200139","II",2983671,2983729,58
"30434","WBGene00200140","IV",3424727,3424807,80
"30435","WBGene00200141","X",4124914,4125058,144
"30436","WBGene00200143","IV",9910362,9910620,258
"30437","WBGene00200144","II",2070307,2070498,191
"30438","WBGene00200145","IV",10190628,10190839,211
"30439","WBGene00200147","X",10547044,10547177,133
"30440","WBGene00200148","X",2358354,2358550,196
"30441","WBGene00200150","III",9708845,9709069,224
"30442","WBGene00200151","X",4740858,4740974,116
"30443","WBGene00200152","X",6078610,6078757,147
"30444","WBGene00200153","II",8830032,8830140,108
"30445","WBGene00200154","II",9038863,9039150,287
"30446","WBGene00200158","I",10313229,10313442,213
"30447","WBGene00200159","I",6695368,6695424,56
"30448","WBGene00200160","V",10715346,10715495,149
"30449","WBGene00200161","IV",11718865,11719075,210
"30450","WBGene00200163","X",11140316,11140454,138
"30451","WBGene00200164","IV",10150762,10150906,144
"30452","WBGene00200167","V",12558012,12558191,179
"30453","WBGene00200168","V",7103050,7103195,145
"30454","WBGene00200169","IV",8277056,8277166,110
"30455","WBGene00200170","X",4711899,4712154,255
"30456","WBGene00200172","IV",11725953,11726098,145
"30457","WBGene00200173","II",4974622,4974771,149
"30458","WBGene00200175","X",13572878,13572942,64
"30459","WBGene00200176","V",8950806,8950994,188
"30460","WBGene00200179","X",15519963,15520083,120
"30461","WBGene00200180","X",3320002,3320281,279
"30462","WBGene00200181","III",8905451,8905588,137
"30463","WBGene00200182","X",14549525,14549674,149
"30464","WBGene00200184","X",7037403,7037603,200
"30465","WBGene00200185","IV",5354132,5354274,142
"30466","WBGene00200186","X",3931347,3931532,185
"30467","WBGene00200187","IV",7403575,7403795,220
"30468","WBGene00200188","X",13014450,13014580,130
"30469","WBGene00200190","X",8465612,8465756,144
"30470","WBGene00200192","V",12814780,12814883,103
"30471","WBGene00200193","II",9035443,9035542,99
"30472","WBGene00200194","X",3585274,3585397,123
"30473","WBGene00200196","X",9938204,9938316,112
"30474","WBGene00200197","II",13948958,13949159,201
"30475","WBGene00200198","III",10538515,10538663,148
"30476","WBGene00200201","IV",5657416,5657565,149
"30477","WBGene00200202","V",5214823,5214873,50
"30478","WBGene00200203","I",6608341,6608517,176
"30479","WBGene00200204","V",12002131,12002280,149
"30480","WBGene00200205","III",5602199,5602344,145
"30481","WBGene00200206","III",7712952,7713015,63
"30482","WBGene00200207","IV",4580954,4581180,226
"30483","WBGene00200209","X",5311761,5311908,147
"30484","WBGene00200210","V",12340807,12340936,129
"30485","WBGene00200211","II",5958388,5958536,148
"30486","WBGene00200212","III",4740894,4741081,187
"30487","WBGene00200214","IV",6786038,6786178,140
"30488","WBGene00200215","V",6881115,6881321,206
"30489","WBGene00200216","V",8107867,8108151,284
"30490","WBGene00200217","II",5585978,5586124,146
"30491","WBGene00200220","II",14206528,14206596,68
"30492","WBGene00200221","V",9412197,9412296,99
"30493","WBGene00200222","III",10785188,10785334,146
"30494","WBGene00200223","IV",12348168,12348302,134
"30495","WBGene00200224","X",6970234,6970370,136
"30496","WBGene00200231","II",9774358,9774478,120
"30497","WBGene00200232","I",11949822,11949894,72
"30498","WBGene00200233","IV",8005502,8005647,145
"30499","WBGene00200236","IV",12552078,12552205,127
"30500","WBGene00200237","IV",14496654,14496778,124
"30501","WBGene00200238","V",2682130,2682187,57
"30502","WBGene00200239","X",6691197,6691344,147
"30503","WBGene00200240","X",1590498,1590583,85
"30504","WBGene00200242","X",4437842,4437982,140
"30505","WBGene00200243","I",10235231,10235407,176
"30506","WBGene00200244","V",8895340,8895711,371
"30507","WBGene00200245","II",7534570,7534714,144
"30508","WBGene00200246","IV",2260495,2260604,109
"30509","WBGene00200248","IV",12002980,12003129,149
"30510","WBGene00200249","V",6135714,6135914,200
"30511","WBGene00200250","X",7214954,7215275,321
"30512","WBGene00200251","III",5812842,5812967,125
"30513","WBGene00200252","X",10821297,10821454,157
"30514","WBGene00200253","I",5292779,5292837,58
"30515","WBGene00200254","I",10133590,10133661,71
"30516","WBGene00200255","II",9571153,9571301,148
"30517","WBGene00200257","IV",5972576,5972721,145
"30518","WBGene00200258","II",14280116,14280251,135
"30519","WBGene00200259","V",14487483,14487680,197
"30520","WBGene00200260","III",13731506,13731585,79
"30521","WBGene00200261","V",5851249,5851398,149
"30522","WBGene00200262","I",4637833,4637970,137
"30523","WBGene00200263","X",3839587,3839678,91
"30524","WBGene00200264","I",2830335,2830483,148
"30525","WBGene00200266","X",12876077,12876225,148
"30526","WBGene00200267","IV",2650835,2650891,56
"30527","WBGene00200268","X",16387963,16388239,276
"30528","WBGene00200269","X",15314242,15314310,68
"30529","WBGene00200270","X",16661217,16661428,211
"30530","WBGene00200271","III",8736727,8736873,146
"30531","WBGene00200273","II",10382582,10382651,69
"30532","WBGene00200274","II",4565383,4565470,87
"30533","WBGene00200276","I",12149561,12149766,205
"30534","WBGene00200277","I",11287748,11287818,70
"30535","WBGene00200278","III",6798080,6798352,272
"30536","WBGene00200279","III",9276100,9276241,141
"30537","WBGene00200280","V",10984710,10984888,178
"30538","WBGene00200281","V",12207425,12207538,113
"30539","WBGene00200282","IV",7236445,7236654,209
"30540","WBGene00200285","X",2774854,2775001,147
"30541","WBGene00200287","X",1089160,1089247,87
"30542","WBGene00200288","IV",6984756,6984903,147
"30543","WBGene00200289","X",10900222,10900346,124
"30544","WBGene00200290","I",10636292,10636441,149
"30545","WBGene00200292","II",6143532,6143639,107
"30546","WBGene00200293","X",8997096,8997383,287
"30547","WBGene00200296","X",10612819,10612956,137
"30548","WBGene00200297","X",8952530,8952670,140
"30549","WBGene00200298","III",4036154,4036212,58
"30550","WBGene00200299","X",5477348,5477564,216
"30551","WBGene00200300","I",5345276,5345425,149
"30552","WBGene00200301","I",14320342,14320592,250
"30553","WBGene00200302","II",13029440,13029561,121
"30554","WBGene00200305","X",5228002,5228150,148
"30555","WBGene00200306","X",17390530,17390659,129
"30556","WBGene00200308","II",6588779,6589129,350
"30557","WBGene00200309","X",5927745,5927837,92
"30558","WBGene00200310","I",2703263,2703458,195
"30559","WBGene00200311","II",11929014,11929081,67
"30560","WBGene00200312","IV",7311292,7311439,147
"30561","WBGene00200313","X",4117176,4117309,133
"30562","WBGene00200315","X",12830691,12830803,112
"30563","WBGene00200317","I",9552092,9552221,129
"30564","WBGene00200318","X",3914446,3914545,99
"30565","WBGene00200320","V",18078169,18078256,87
"30566","WBGene00200321","X",12676695,12676840,145
"30567","WBGene00200323","X",2497901,2498037,136
"30568","WBGene00200326","X",14798117,14798262,145
"30569","WBGene00200328","X",7269934,7270156,222
"30570","WBGene00200329","X",7176000,7176187,187
"30571","WBGene00200330","II",13065381,13065520,139
"30572","WBGene00200333","X",7619532,7619743,211
"30573","WBGene00200335","V",11335121,11335290,169
"30574","WBGene00200337","II",8107178,8107272,94
"30575","WBGene00200338","X",8392758,8392845,87
"30576","WBGene00200339","X",10818383,10818603,220
"30577","WBGene00200340","IV",3862871,3862988,117
"30578","WBGene00200341","V",6468944,6469092,148
"30579","WBGene00200342","X",5107538,5107601,63
"30580","WBGene00200343","II",2466344,2466416,72
"30581","WBGene00200344","X",5814741,5814838,97
"30582","WBGene00200345","I",14896563,14896784,221
"30583","WBGene00200346","V",14619278,14619387,109
"30584","WBGene00200347","V",10715875,10716225,350
"30585","WBGene00200348","X",7639670,7639813,143
"30586","WBGene00200350","V",18565927,18566066,139
"30587","WBGene00200352","II",12541920,12542018,98
"30588","WBGene00200354","IV",9952991,9953216,225
"30589","WBGene00200355","X",6520097,6520291,194
"30590","WBGene00200357","X",15433339,15433474,135
"30591","WBGene00200358","X",9931715,9931860,145
"30592","WBGene00200360","X",2522737,2522853,116
"30593","WBGene00200361","X",6146016,6146170,154
"30594","WBGene00200362","X",10502571,10502711,140
"30595","WBGene00200365","I",9380354,9380499,145
"30596","WBGene00200366","X",7456060,7456274,214
"30597","WBGene00200367","V",11087692,11087857,165
"30598","WBGene00200368","X",4066488,4066615,127
"30599","WBGene00200370","V",11083097,11083246,149
"30600","WBGene00200372","X",12252489,12252749,260
"30601","WBGene00200373","V",7099061,7099195,134
"30602","WBGene00200374","III",11478592,11478757,165
"30603","WBGene00200375","II",9112813,9112958,145
"30604","WBGene00200377","X",4490426,4490540,114
"30605","WBGene00200378","IV",11433630,11433885,255
"30606","WBGene00200379","V",6353522,6353742,220
"30607","WBGene00200381","X",4477880,4478017,137
"30608","WBGene00200383","IV",2394474,2394536,62
"30609","WBGene00200384","X",5123079,5123243,164
"30610","WBGene00200385","IV",17421786,17421835,49
"30611","WBGene00200386","II",4960891,4961040,149
"30612","WBGene00200388","IV",7512001,7512150,149
"30613","WBGene00200389","V",11347874,11348009,135
"30614","WBGene00200390","X",11126633,11126782,149
"30615","WBGene00200391","III",9331206,9331348,142
"30616","WBGene00200392","IV",11712194,11712335,141
"30617","WBGene00200394","X",5567170,5567319,149
"30618","WBGene00200395","X",3309282,3309420,138
"30619","WBGene00200396","II",6001161,6001291,130
"30620","WBGene00200397","III",9807566,9807783,217
"30621","WBGene00200398","II",4810867,4811011,144
"30622","WBGene00200400","X",6958727,6959110,383
"30623","WBGene00200401","X",12656672,12656812,140
"30624","WBGene00200403","III",6741492,6741631,139
"30625","WBGene00200405","IV",11995528,11995676,148
"30626","WBGene00200407","X",6219194,6219329,135
"30627","WBGene00200408","I",806419,806659,240
"30628","WBGene00200409","V",6862148,6862206,58
"30629","WBGene00200411","X",8419403,8419500,97
"30630","WBGene00200412","X",5699809,5700018,209
"30631","WBGene00200414","V",19339965,19340045,80
"30632","WBGene00200416","X",3062466,3062595,129
"30633","WBGene00200418","III",5653995,5654130,135
"30634","WBGene00200420","X",15335175,15335314,139
"30635","WBGene00200421","X",4093591,4093719,128
"30636","WBGene00200423","V",11461959,11462177,218
"30637","WBGene00200425","II",4965152,4965300,148
"30638","WBGene00200427","I",9051243,9051328,85
"30639","WBGene00200428","I",9722096,9722380,284
"30640","WBGene00200429","IV",7188962,7189106,144
"30641","WBGene00200430","IV",9821739,9821887,148
"30642","WBGene00200431","V",9598656,9598735,79
"30643","WBGene00200432","II",1349352,1349501,149
"30644","WBGene00200433","V",13159982,13160124,142
"30645","WBGene00200435","II",7493801,7493861,60
"30646","WBGene00200436","V",13077970,13078118,148
"30647","WBGene00200437","X",4916350,4916538,188
"30648","WBGene00200438","III",8280439,8280575,136
"30649","WBGene00200439","II",11072513,11072658,145
"30650","WBGene00200440","X",13775565,13775626,61
"30651","WBGene00200441","I",8790296,8790456,160
"30652","WBGene00200442","I",3248249,3248533,284
"30653","WBGene00200443","X",14303629,14303764,135
"30654","WBGene00200448","IV",2403473,2403611,138
"30655","WBGene00200451","X",9086286,9086433,147
"30656","WBGene00200452","X",5795555,5795698,143
"30657","WBGene00200454","X",9806513,9806723,210
"30658","WBGene00200456","IV",7392263,7392538,275
"30659","WBGene00200457","IV",15594697,15594931,234
"30660","WBGene00200458","X",10654628,10654757,129
"30661","WBGene00200459","IV",11857100,11857483,383
"30662","WBGene00200461","IV",8061416,8061506,90
"30663","WBGene00200463","IV",9944486,9944635,149
"30664","WBGene00200464","X",5670903,5671019,116
"30665","WBGene00200468","IV",12166856,12167079,223
"30666","WBGene00200471","IV",10193054,10193180,126
"30667","WBGene00200472","X",15222014,15222206,192
"30668","WBGene00200473","V",17755708,17755819,111
"30669","WBGene00200474","V",6465434,6465633,199
"30670","WBGene00200475","II",2763657,2763713,56
"30671","WBGene00200476","III",3566922,3567090,168
"30672","WBGene00200477","III",11388344,11388489,145
"30673","WBGene00200479","X",4417758,4417888,130
"30674","WBGene00200482","I",11667911,11667969,58
"30675","WBGene00200483","V",10478319,10478460,141
"30676","WBGene00200485","III",9867885,9868012,127
"30677","WBGene00200487","X",7463757,7464205,448
"30678","WBGene00200488","X",3974333,3974451,118
"30679","WBGene00200489","X",16556944,16557168,224
"30680","WBGene00200490","V",10117112,10117411,299
"30681","WBGene00200491","X",4062103,4062294,191
"30682","WBGene00200493","II",6416335,6416466,131
"30683","WBGene00200494","II",10686572,10686784,212
"30684","WBGene00200495","II",7812603,7812734,131
"30685","WBGene00200497","V",10461544,10461699,155
"30686","WBGene00200498","X",7544861,7545292,431
"30687","WBGene00200499","II",5773232,5773346,114
"30688","WBGene00200500","II",8952028,8952285,257
"30689","WBGene00200501","X",11130154,11130297,143
"30690","WBGene00200502","X",7825780,7826072,292
"30691","WBGene00200503","V",6010693,6010747,54
"30692","WBGene00200504","X",13875148,13875283,135
"30693","WBGene00200505","V",5384015,5384084,69
"30694","WBGene00200506","I",816036,816306,270
"30695","WBGene00200507","I",10011505,10011836,331
"30696","WBGene00200509","X",14773098,14773247,149
"30697","WBGene00200510","I",2655867,2655923,56
"30698","WBGene00200511","X",2456308,2456448,140
"30699","WBGene00200513","X",9602056,9602195,139
"30700","WBGene00200514","II",7615506,7615667,161
"30701","WBGene00200515","V",4800692,4800909,217
"30702","WBGene00200517","I",11639261,11639313,52
"30703","WBGene00200519","I",7290712,7290859,147
"30704","WBGene00200520","V",4994220,4994368,148
"30705","WBGene00200521","I",6172999,6173139,140
"30706","WBGene00200522","V",12327090,12327157,67
"30707","WBGene00200525","IV",11211349,11211497,148
"30708","WBGene00200526","IV",6842957,6843029,72
"30709","WBGene00200528","X",17520983,17521191,208
"30710","WBGene00200531","IV",10576081,10576156,75
"30711","WBGene00200532","IV",12594734,12594831,97
"30712","WBGene00200533","V",9867897,9868046,149
"30713","WBGene00200534","X",15508505,15508643,138
"30714","WBGene00200535","X",852344,852493,149
"30715","WBGene00200536","X",14047779,14047918,139
"30716","WBGene00200537","X",2518676,2518739,63
"30717","WBGene00200538","IV",11149633,11149770,137
"30718","WBGene00200540","V",11675149,11675358,209
"30719","WBGene00200543","X",12909172,12909311,139
"30720","WBGene00200545","X",8631213,8631343,130
"30721","WBGene00200546","X",2674090,2674310,220
"30722","WBGene00200547","X",5860303,5860450,147
"30723","WBGene00200548","X",15387673,15387805,132
"30724","WBGene00200550","I",5949396,5949448,52
"30725","WBGene00200552","X",11272306,11272478,172
"30726","WBGene00200553","IV",5098958,5099058,100
"30727","WBGene00200554","X",9090817,9090918,101
"30728","WBGene00200555","II",7635456,7635601,145
"30729","WBGene00200556","I",8001196,8001328,132
"30730","WBGene00200557","II",7563840,7564049,209
"30731","WBGene00200558","II",13906234,13906290,56
"30732","WBGene00200561","IV",11474031,11474252,221
"30733","WBGene00200562","X",8268601,8268820,219
"30734","WBGene00200563","X",3188395,3188466,71
"30735","WBGene00200565","IV",17267783,17267892,109
"30736","WBGene00200566","III",8289690,8289797,107
"30737","WBGene00200567","V",6680686,6680894,208
"30738","WBGene00200568","X",13435961,13436048,87
"30739","WBGene00200570","V",5695800,5695948,148
"30740","WBGene00200572","V",1140917,1141004,87
"30741","WBGene00200573","V",6227753,6227898,145
"30742","WBGene00200575","V",5780500,5780645,145
"30743","WBGene00200576","X",2104154,2104376,222
"30744","WBGene00200577","I",530395,530683,288
"30745","WBGene00200579","II",5962755,5962888,133
"30746","WBGene00200580","X",8846504,8846582,78
"30747","WBGene00200581","V",11945412,11945561,149
"30748","WBGene00200582","V",11897727,11897871,144
"30749","WBGene00200583","X",13121229,13121418,189
"30750","WBGene00200584","II",11492517,11492666,149
"30751","WBGene00200585","V",11433696,11433831,135
"30752","WBGene00200587","II",5736566,5736709,143
"30753","WBGene00200588","X",8259505,8259611,106
"30754","WBGene00200589","X",10403423,10403653,230
"30755","WBGene00200590","V",7741627,7741690,63
"30756","WBGene00200593","X",10311025,10311127,102
"30757","WBGene00200594","IV",5985445,5985560,115
"30758","WBGene00200595","X",14199625,14199771,146
"30759","WBGene00200596","V",8801247,8801419,172
"30760","WBGene00200597","X",6669023,6669159,136
"30761","WBGene00200598","III",4497829,4497976,147
"30762","WBGene00200599","III",13411365,13411439,74
"30763","WBGene00200600","IV",7679173,7679318,145
"30764","WBGene00200602","III",710194,710337,143
"30765","WBGene00200604","X",5319883,5320027,144
"30766","WBGene00200605","IV",12198709,12198855,146
"30767","WBGene00200606","I",2084806,2085027,221
"30768","WBGene00200607","IV",3014674,3014941,267
"30769","WBGene00200608","I",2272359,2272439,80
"30770","WBGene00200611","X",14054785,14054909,124
"30771","WBGene00200612","II",12728753,12728823,70
"30772","WBGene00200613","III",7811118,7811245,127
"30773","WBGene00200615","III",2048736,2048885,149
"30774","WBGene00200616","IV",787847,787909,62
"30775","WBGene00200617","II",7716016,7716162,146
"30776","WBGene00200618","IV",11652109,11652251,142
"30777","WBGene00200620","X",3903348,3903487,139
"30778","WBGene00200622","V",11680125,11680271,146
"30779","WBGene00200623","III",3784849,3784991,142
"30780","WBGene00200624","III",4614540,4614666,126
"30781","WBGene00200625","X",14610504,14610613,109
"30782","WBGene00200626","X",6051995,6052067,72
"30783","WBGene00200627","V",6248164,6248304,140
"30784","WBGene00200628","X",5661464,5661747,283
"30785","WBGene00200630","IV",7845656,7845868,212
"30786","WBGene00200631","X",8117765,8117911,146
"30787","WBGene00200632","II",9025855,9025992,137
"30788","WBGene00200633","IV",6015507,6015655,148
"30789","WBGene00200635","IV",6988838,6988983,145
"30790","WBGene00200636","X",1929001,1929225,224
"30791","WBGene00200637","II",333878,333965,87
"30792","WBGene00200638","V",14126256,14126389,133
"30793","WBGene00200640","IV",1676961,1677040,79
"30794","WBGene00200641","X",12195334,12195469,135
"30795","WBGene00200642","X",10948261,10948324,63
"30796","WBGene00200643","V",6032192,6032341,149
"30797","WBGene00200644","I",4329116,4329239,123
"30798","WBGene00200645","X",6741322,6741454,132
"30799","WBGene00200646","X",11571741,11572035,294
"30800","WBGene00200647","V",12578599,12578744,145
"30801","WBGene00200649","IV",4502454,4502585,131
"30802","WBGene00200650","IV",11748939,11749074,135
"30803","WBGene00200651","IV",7092099,7092219,120
"30804","WBGene00200654","I",5429932,5430014,82
"30805","WBGene00200659","V",7142715,7142860,145
"30806","WBGene00200660","II",3556034,3556111,77
"30807","WBGene00200664","V",5705062,5705277,215
"30808","WBGene00200665","X",5263977,5264191,214
"30809","WBGene00200666","V",14998815,14998958,143
"30810","WBGene00200667","V",14373350,14373481,131
"30811","WBGene00200668","I",11131538,11131597,59
"30812","WBGene00200669","I",6031806,6031982,176
"30813","WBGene00200670","X",7583546,7583679,133
"30814","WBGene00200671","V",9745030,9745152,122
"30815","WBGene00200672","I",7259839,7259938,99
"30816","WBGene00200673","V",8495300,8495384,84
"30817","WBGene00200675","X",12260417,12260771,354
"30818","WBGene00200677","V",11500071,11500211,140
"30819","WBGene00200678","IV",8261007,8261150,143
"30820","WBGene00200679","X",15125532,15125668,136
"30821","WBGene00200680","X",4732629,4732695,66
"30822","WBGene00200683","II",10718475,10718613,138
"30823","WBGene00200684","IV",9909284,9909503,219
"30824","WBGene00200685","V",11794335,11794471,136
"30825","WBGene00200688","I",9546590,9546718,128
"30826","WBGene00200689","IV",12192170,12192353,183
"30827","WBGene00200692","X",15220384,15220532,148
"30828","WBGene00200694","X",8585038,8585114,76
"30829","WBGene00200695","V",8930202,8930260,58
"30830","WBGene00200697","II",3014034,3014236,202
"30831","WBGene00200699","V",11213653,11213798,145
"30832","WBGene00200700","I",6757175,6757233,58
"30833","WBGene00200701","IV",6841555,6841698,143
"30834","WBGene00200702","III",6375045,6375184,139
"30835","WBGene00200705","I",13951750,13951876,126
"30836","WBGene00200706","IV",12057566,12057706,140
"30837","WBGene00200707","I",1691497,1691645,148
"30838","WBGene00200709","III",12399897,12399986,89
"30839","WBGene00200710","V",5604546,5604657,111
"30840","WBGene00200711","X",7844355,7844499,144
"30841","WBGene00200712","V",9451075,9451209,134
"30842","WBGene00200713","V",12879560,12879748,188
"30843","WBGene00200714","V",12211086,12211230,144
"30844","WBGene00200716","IV",8060937,8061142,205
"30845","WBGene00200717","X",13010107,13010289,182
"30846","WBGene00200719","V",6894448,6894590,142
"30847","WBGene00200721","X",6941881,6941954,73
"30848","WBGene00200722","X",3773277,3773539,262
"30849","WBGene00200723","IV",3168800,3168949,149
"30850","WBGene00200725","III",1822462,1822545,83
"30851","WBGene00200727","IV",9913880,9914084,204
"30852","WBGene00200730","IV",7676532,7676681,149
"30853","WBGene00200733","II",5226523,5226643,120
"30854","WBGene00200734","V",10839689,10839837,148
"30855","WBGene00200735","X",14655687,14655935,248
"30856","WBGene00200736","II",5740062,5740174,112
"30857","WBGene00200737","IV",7326748,7326940,192
"30858","WBGene00200738","X",14959502,14959623,121
"30859","WBGene00200740","X",284982,285040,58
"30860","WBGene00200741","X",7037408,7037611,203
"30861","WBGene00200743","V",10691426,10691559,133
"30862","WBGene00200744","X",3902998,3903145,147
"30863","WBGene00200745","V",13003500,13003586,86
"30864","WBGene00200746","V",9966123,9966382,259
"30865","WBGene00200747","X",2907713,2907856,143
"30866","WBGene00200749","II",11000791,11000933,142
"30867","WBGene00200751","IV",6958983,6959120,137
"30868","WBGene00200753","X",4245149,4245286,137
"30869","WBGene00200754","V",12556952,12557099,147
"30870","WBGene00200755","IV",12417914,12418003,89
"30871","WBGene00200756","X",14561402,14561690,288
"30872","WBGene00200757","IV",8954378,8954493,115
"30873","WBGene00200758","V",11623557,11623751,194
"30874","WBGene00200760","I",13096366,13096520,154
"30875","WBGene00200762","V",10715344,10715493,149
"30876","WBGene00200763","III",5769900,5769996,96
"30877","WBGene00200764","II",13944283,13944476,193
"30878","WBGene00200765","II",5678380,5678529,149
"30879","WBGene00200768","I",2614667,2614816,149
"30880","WBGene00200769","III",11362564,11362786,222
"30881","WBGene00200770","V",14820381,14820528,147
"30882","WBGene00200775","X",10594807,10595056,249
"30883","WBGene00200776","III",168489,168766,277
"30884","WBGene00200780","X",4573946,4574283,337
"30885","WBGene00200782","X",10456884,10457012,128
"30886","WBGene00200784","II",6464815,6464931,116
"30887","WBGene00200785","IV",6204039,6204256,217
"30888","WBGene00200786","I",10750030,10750293,263
"30889","WBGene00200791","IV",11092587,11092853,266
"30890","WBGene00200793","V",11661113,11661279,166
"30891","WBGene00200794","X",9743585,9743678,93
"30892","WBGene00200795","II",8017571,8017701,130
"30893","WBGene00200798","V",7965520,7965599,79
"30894","WBGene00200800","IV",5960087,5960295,208
"30895","WBGene00200801","X",13197067,13197359,292
"30896","WBGene00200802","II",6175238,6175373,135
"30897","WBGene00200804","II",4976917,4977131,214
"30898","WBGene00200806","X",12252365,12252492,127
"30899","WBGene00200808","II",5966755,5967030,275
"30900","WBGene00200809","V",11078863,11079007,144
"30901","WBGene00200810","I",11392735,11392902,167
"30902","WBGene00200811","V",15505197,15505284,87
"30903","WBGene00200812","II",5543581,5543698,117
"30904","WBGene00200813","II",13788897,13789046,149
"30905","WBGene00200814","IV",3846077,3846225,148
"30906","WBGene00200816","IV",8002465,8002907,442
"30907","WBGene00200818","II",6831863,6832141,278
"30908","WBGene00200819","IV",6995270,6995388,118
"30909","WBGene00200820","III",247074,247223,149
"30910","WBGene00200821","II",4455032,4455100,68
"30911","WBGene00200823","IV",2998720,2998868,148
"30912","WBGene00200824","X",7584020,7584432,412
"30913","WBGene00200826","X",5854253,5854400,147
"30914","WBGene00200827","V",14463186,14463357,171
"30915","WBGene00200828","X",5819105,5819343,238
"30916","WBGene00200830","V",10727135,10727413,278
"30917","WBGene00200831","X",5733891,5734008,117
"30918","WBGene00200833","I",6632451,6632594,143
"30919","WBGene00200835","IV",5931825,5931971,146
"30920","WBGene00200836","V",19414846,19414992,146
"30921","WBGene00200837","V",12310411,12310480,69
"30922","WBGene00200839","X",2885312,2885454,142
"30923","WBGene00200840","I",10757145,10757203,58
"30924","WBGene00200843","II",9089724,9089822,98
"30925","WBGene00200845","X",10080772,10081046,274
"30926","WBGene00200846","X",9999605,9999776,171
"30927","WBGene00200847","V",14214858,14215005,147
"30928","WBGene00200848","II",1408617,1408708,91
"30929","WBGene00200850","IV",620482,620555,73
"30930","WBGene00200851","III",10484343,10484425,82
"30931","WBGene00200852","X",12255257,12255451,194
"30932","WBGene00200856","III",12132165,12132302,137
"30933","WBGene00200857","X",4171160,4171301,141
"30934","WBGene00200858","V",12465344,12465562,218
"30935","WBGene00200861","V",8643485,8643558,73
"30936","WBGene00200863","IV",10973202,10973349,147
"30937","WBGene00200865","IV",3836670,3836811,141
"30938","WBGene00200866","X",9054799,9054870,71
"30939","WBGene00200867","II",6833790,6834006,216
"30940","WBGene00200870","II",13060057,13060505,448
"30941","WBGene00200871","IV",5052423,5052555,132
"30942","WBGene00200872","X",12086529,12086741,212
"30943","WBGene00200874","II",6853081,6853295,214
"30944","WBGene00200875","V",12115375,12115553,178
"30945","WBGene00200876","II",3439206,3439292,86
"30946","WBGene00200877","X",15241345,15241434,89
"30947","WBGene00200878","I",3567651,3567707,56
"30948","WBGene00200880","X",3470848,3470958,110
"30949","WBGene00200882","X",12631909,12632125,216
"30950","WBGene00200883","V",12545188,12545237,49
"30951","WBGene00200884","V",10536891,10537038,147
"30952","WBGene00200885","II",12494728,12494862,134
"30953","WBGene00200888","I",12195268,12195334,66
"30954","WBGene00200889","X",3818959,3819085,126
"30955","WBGene00200890","V",13575980,13576177,197
"30956","WBGene00200891","X",2749063,2749202,139
"30957","WBGene00200893","X",11605558,11605779,221
"30958","WBGene00200894","III",4449531,4449609,78
"30959","WBGene00200895","II",6121441,6121665,224
"30960","WBGene00200896","III",8493175,8493374,199
"30961","WBGene00200898","IV",5980161,5980274,113
"30962","WBGene00200900","I",8452153,8452312,159
"30963","WBGene00200901","X",9473626,9473750,124
"30964","WBGene00200903","III",6887716,6887803,87
"30965","WBGene00200904","III",9178431,9178568,137
"30966","WBGene00200905","X",10555546,10555744,198
"30967","WBGene00200906","X",4434658,4434783,125
"30968","WBGene00200907","IV",9611700,9611843,143
"30969","WBGene00200908","IV",9874628,9874741,113
"30970","WBGene00200909","X",9092991,9093213,222
"30971","WBGene00200910","I",11678461,11678550,89
"30972","WBGene00200911","IV",14033327,14033448,121
"30973","WBGene00200912","V",11755996,11756154,158
"30974","WBGene00200914","III",8653608,8653681,73
"30975","WBGene00200916","V",11674420,11674556,136
"30976","WBGene00200919","III",5989000,5989141,141
"30977","WBGene00200920","V",10681603,10681748,145
"30978","WBGene00200921","V",12536533,12536644,111
"30979","WBGene00200922","V",12874896,12875026,130
"30980","WBGene00200923","V",11710455,11710601,146
"30981","WBGene00200926","V",6917408,6917560,152
"30982","WBGene00200927","IV",17117868,17118017,149
"30983","WBGene00200929","V",9629214,9629354,140
"30984","WBGene00200930","X",12419365,12419510,145
"30985","WBGene00200931","V",13043296,13043424,128
"30986","WBGene00200932","V",10997336,10997477,141
"30987","WBGene00200934","IV",7400768,7401117,349
"30988","WBGene00200935","X",3193964,3194093,129
"30989","WBGene00200939","III",4626517,4626650,133
"30990","WBGene00200940","IV",10129124,10129196,72
"30991","WBGene00200941","X",11465094,11465331,237
"30992","WBGene00200943","IV",1361338,1361394,56
"30993","WBGene00200944","V",12214804,12214916,112
"30994","WBGene00200946","II",11255572,11255859,287
"30995","WBGene00200947","II",6151667,6151821,154
"30996","WBGene00200948","IV",8009466,8009675,209
"30997","WBGene00200949","X",13644615,13644810,195
"30998","WBGene00200950","X",10114833,10114897,64
"30999","WBGene00200951","V",11869080,11869194,114
"31000","WBGene00200952","X",14858816,14858937,121
"31001","WBGene00200953","I",7951655,7952140,485
"31002","WBGene00200954","X",14201018,14201194,176
"31003","WBGene00200957","I",11803258,11803404,146
"31004","WBGene00200959","X",6222371,6222520,149
"31005","WBGene00200960","III",9765005,9765148,143
"31006","WBGene00200963","II",23086,23234,148
"31007","WBGene00200965","X",6073975,6074150,175
"31008","WBGene00200966","IV",7209319,7209516,197
"31009","WBGene00200967","V",12111156,12111281,125
"31010","WBGene00200968","IV",12131739,12131888,149
"31011","WBGene00200969","IV",5509028,5509170,142
"31012","WBGene00200971","X",8476379,8476728,349
"31013","WBGene00200972","X",5666488,5666680,192
"31014","WBGene00200973","III",4525149,4525370,221
"31015","WBGene00200974","V",19747204,19747319,115
"31016","WBGene00200975","IV",9956833,9956950,117
"31017","WBGene00200976","V",11209285,11209425,140
"31018","WBGene00200977","X",6587842,6587988,146
"31019","WBGene00200978","X",637567,637783,216
"31020","WBGene00200979","V",11199530,11199726,196
"31021","WBGene00200980","V",11416795,11416944,149
"31022","WBGene00200981","V",13722505,13722645,140
"31023","WBGene00200982","IV",5834276,5834425,149
"31024","WBGene00200983","X",4238335,4238475,140
"31025","WBGene00200986","V",12747609,12747801,192
"31026","WBGene00200987","I",9448542,9448669,127
"31027","WBGene00200989","V",9285819,9285951,132
"31028","WBGene00200990","X",8653808,8653952,144
"31029","WBGene00200994","I",2684865,2684995,130
"31030","WBGene00200995","X",12179264,12179488,224
"31031","WBGene00200996","II",7892661,7892875,214
"31032","WBGene00200997","II",7030309,7030435,126
"31033","WBGene00200998","X",15693619,15694203,584
"31034","WBGene00200999","X",5249144,5249278,134
"31035","WBGene00201001","III",7032273,7032370,97
"31036","WBGene00201002","V",10723098,10723389,291
"31037","WBGene00201005","IV",11524235,11524523,288
"31038","WBGene00201006","X",6656882,6656982,100
"31039","WBGene00201007","X",4060240,4060492,252
"31040","WBGene00201008","X",7006905,7007016,111
"31041","WBGene00201009","X",12079942,12080019,77
"31042","WBGene00201010","X",3596570,3596708,138
"31043","WBGene00201012","V",11082604,11082742,138
"31044","WBGene00201014","V",8950738,8950923,185
"31045","WBGene00201015","IV",12042839,12042988,149
"31046","WBGene00201017","I",12955940,12956099,159
"31047","WBGene00201018","I",178232,178291,59
"31048","WBGene00201019","I",2742383,2742528,145
"31049","WBGene00201020","V",6541884,6541999,115
"31050","WBGene00201021","III",11425729,11425849,120
"31051","WBGene00201022","IV",2650949,2651022,73
"31052","WBGene00201023","IV",12795584,12795708,124
"31053","WBGene00201024","X",7699443,7699519,76
"31054","WBGene00201025","V",12975583,12975732,149
"31055","WBGene00201026","II",9070427,9070513,86
"31056","WBGene00201027","V",12233397,12233589,192
"31057","WBGene00201028","X",2591766,2591856,90
"31058","WBGene00201030","IV",5858332,5858616,284
"31059","WBGene00201031","IV",11692444,11692592,148
"31060","WBGene00201034","V",11436456,11436592,136
"31061","WBGene00201036","V",5614169,5614414,245
"31062","WBGene00201037","X",4815762,4815965,203
"31063","WBGene00201038","X",2950282,2950448,166
"31064","WBGene00201039","X",14702497,14702674,177
"31065","WBGene00201040","III",4134265,4134414,149
"31066","WBGene00201041","V",6341210,6341323,113
"31067","WBGene00201042","X",2716558,2716705,147
"31068","WBGene00201043","X",4651550,4651743,193
"31069","WBGene00201044","X",13207018,13207162,144
"31070","WBGene00201045","X",7215705,7215869,164
"31071","WBGene00201046","III",1567538,1567599,61
"31072","WBGene00201047","X",4784914,4785029,115
"31073","WBGene00201051","III",11467807,11467986,179
"31074","WBGene00201052","IV",10298994,10299137,143
"31075","WBGene00201054","V",10824782,10824995,213
"31076","WBGene00201055","V",10833224,10833425,201
"31077","WBGene00201056","V",13243888,13244152,264
"31078","WBGene00201057","IV",12426525,12426720,195
"31079","WBGene00201058","V",11137345,11137546,201
"31080","WBGene00201060","II",3975329,3975399,70
"31081","WBGene00201062","V",14656555,14656699,144
"31082","WBGene00201064","X",17173933,17174046,113
"31083","WBGene00201065","X",8023325,8023575,250
"31084","WBGene00201066","V",10665735,10665883,148
"31085","WBGene00201069","X",6515272,6515554,282
"31086","WBGene00201070","X",2762132,2762260,128
"31087","WBGene00201071","II",7514644,7514787,143
"31088","WBGene00201072","IV",9898492,9898694,202
"31089","WBGene00201073","II",6617800,6617918,118
"31090","WBGene00201074","II",6610395,6610625,230
"31091","WBGene00201075","I",10400397,10400619,222
"31092","WBGene00201076","IV",12201129,12201273,144
"31093","WBGene00201077","X",15200807,15200890,83
"31094","WBGene00201078","X",13377503,13377648,145
"31095","WBGene00201079","II",14430461,14430558,97
"31096","WBGene00201081","X",17002072,17002214,142
"31097","WBGene00201082","X",15380625,15380758,133
"31098","WBGene00201083","X",15666337,15666432,95
"31099","WBGene00201084","I",9986343,9986413,70
"31100","WBGene00201085","V",12329163,12329299,136
"31101","WBGene00201086","X",2046006,2046152,146
"31102","WBGene00201087","X",4877198,4877493,295
"31103","WBGene00201088","X",3659022,3659162,140
"31104","WBGene00201090","III",8533609,8533754,145
"31105","WBGene00201092","X",2155659,2155798,139
"31106","WBGene00201093","II",15263177,15263458,281
"31107","WBGene00201094","V",12487949,12488130,181
"31108","WBGene00201096","I",6136592,6136686,94
"31109","WBGene00201098","V",10598740,10598964,224
"31110","WBGene00201099","X",2510721,2510861,140
"31111","WBGene00201100","II",6324112,6324224,112
"31112","WBGene00201101","I",14371639,14371785,146
"31113","WBGene00201104","I",10261434,10261502,68
"31114","WBGene00201107","I",9549252,9549400,148
"31115","WBGene00201108","IV",5977019,5977318,299
"31116","WBGene00201109","IV",6014643,6014792,149
"31117","WBGene00201110","X",10933726,10933866,140
"31118","WBGene00201111","III",4018117,4018305,188
"31119","WBGene00201112","X",5699529,5699662,133
"31120","WBGene00201113","X",4062018,4062252,234
"31121","WBGene00201115","X",11134951,11135078,127
"31122","WBGene00201116","X",6936563,6936711,148
"31123","WBGene00201117","II",7794478,7794627,149
"31124","WBGene00201118","IV",10613888,10614057,169
"31125","WBGene00201119","V",6467965,6468173,208
"31126","WBGene00201120","X",9856223,9856438,215
"31127","WBGene00201121","II",7888249,7888454,205
"31128","WBGene00201123","V",11093578,11093725,147
"31129","WBGene00201124","X",14684549,14684644,95
"31130","WBGene00201125","V",6105348,6105710,362
"31131","WBGene00201126","X",3159717,3159861,144
"31132","WBGene00201128","I",5871404,5871512,108
"31133","WBGene00201129","X",3024214,3024437,223
"31134","WBGene00201130","V",11188576,11188862,286
"31135","WBGene00201131","II",7653930,7654026,96
"31136","WBGene00201132","X",6048627,6048906,279
"31137","WBGene00201133","IV",12204276,12204411,135
"31138","WBGene00201134","I",9152289,9152396,107
"31139","WBGene00201135","X",12248379,12248433,54
"31140","WBGene00201141","IV",2044679,2044796,117
"31141","WBGene00201142","IV",6171588,6171753,165
"31142","WBGene00201143","X",4801144,4801254,110
"31143","WBGene00201146","X",7458142,7458237,95
"31144","WBGene00201147","I",11391517,11391569,52
"31145","WBGene00201148","V",12327198,12327295,97
"31146","WBGene00201149","II",8894427,8894618,191
"31147","WBGene00201150","III",9882718,9882942,224
"31148","WBGene00201151","IV",14764825,14765035,210
"31149","WBGene00201153","II",6886239,6886388,149
"31150","WBGene00201155","V",14425971,14426103,132
"31151","WBGene00201156","X",5460418,5460713,295
"31152","WBGene00201158","X",6702077,6702340,263
"31153","WBGene00201159","V",11697486,11697633,147
"31154","WBGene00201165","I",5104969,5105103,134
"31155","WBGene00201166","IV",5980619,5980754,135
"31156","WBGene00201168","II",8901812,8902025,213
"31157","WBGene00201170","I",12001061,12001137,76
"31158","WBGene00201173","X",14064063,14064176,113
"31159","WBGene00201174","X",8156625,8156711,86
"31160","WBGene00201175","X",8036674,8036762,88
"31161","WBGene00201176","X",505008,505118,110
"31162","WBGene00201177","X",1926664,1926927,263
"31163","WBGene00201178","X",6688564,6688778,214
"31164","WBGene00201179","IV",12345393,12345459,66
"31165","WBGene00201180","X",9137735,9137807,72
"31166","WBGene00201181","I",9731485,9731631,146
"31167","WBGene00201182","II",6724960,6725157,197
"31168","WBGene00201183","IV",11573682,11574035,353
"31169","WBGene00201185","V",9740981,9741075,94
"31170","WBGene00201190","I",2799609,2799671,62
"31171","WBGene00201194","II",10987921,10988062,141
"31172","WBGene00201196","V",6526091,6526234,143
"31173","WBGene00201198","X",17457085,17457233,148
"31174","WBGene00201199","IV",842805,842891,86
"31175","WBGene00201200","IV",9362301,9362381,80
"31176","WBGene00201201","II",14571840,14571925,85
"31177","WBGene00201202","I",9962713,9962855,142
"31178","WBGene00201203","X",16620993,16621138,145
"31179","WBGene00201204","X",13472060,13472124,64
"31180","WBGene00201205","X",4905719,4905861,142
"31181","WBGene00201206","X",15629778,15629828,50
"31182","WBGene00201207","X",11643830,11643892,62
"31183","WBGene00201208","V",5445541,5445689,148
"31184","WBGene00201209","I",11539503,11539577,74
"31185","WBGene00201210","V",5862657,5862850,193
"31186","WBGene00201211","IV",3166157,3166306,149
"31187","WBGene00201212","X",12877108,12877378,270
"31188","WBGene00201213","X",10279387,10279521,134
"31189","WBGene00201214","V",11368782,11368919,137
"31190","WBGene00201216","II",1384761,1384815,54
"31191","WBGene00201217","V",4803125,4803249,124
"31192","WBGene00201218","X",3973694,3973838,144
"31193","WBGene00201219","IV",9816163,9816310,147
"31194","WBGene00201220","X",4410647,4410733,86
"31195","WBGene00201221","II",6396604,6396726,122
"31196","WBGene00201223","III",8279645,8279736,91
"31197","WBGene00201224","X",5800457,5800599,142
"31198","WBGene00201226","II",4779773,4779912,139
"31199","WBGene00201228","X",10597705,10597832,127
"31200","WBGene00201229","II",10072340,10072597,257
"31201","WBGene00201231","X",5613324,5613471,147
"31202","WBGene00201232","V",9456465,9456520,55
"31203","WBGene00201233","V",15127400,15127514,114
"31204","WBGene00201234","V",8141184,8141244,60
"31205","WBGene00201236","X",16591764,16591926,162
"31206","WBGene00201237","III",4807211,4807359,148
"31207","WBGene00201238","IV",4517335,4517471,136
"31208","WBGene00201239","X",12168119,12168254,135
"31209","WBGene00201241","X",10654112,10654257,145
"31210","WBGene00201242","V",6024713,6024858,145
"31211","WBGene00201243","V",11656866,11656963,97
"31212","WBGene00201244","II",6399430,6399560,130
"31213","WBGene00201246","V",9219347,9219537,190
"31214","WBGene00201247","II",6832872,6833000,128
"31215","WBGene00201248","X",5506723,5506843,120
"31216","WBGene00201250","II",11078470,11078618,148
"31217","WBGene00201251","X",2426485,2426634,149
"31218","WBGene00201252","III",7193362,7193501,139
"31219","WBGene00201253","X",7466624,7466835,211
"31220","WBGene00201254","X",6956897,6957181,284
"31221","WBGene00201255","I",2835767,2835983,216
"31222","WBGene00201256","II",6414424,6414586,162
"31223","WBGene00201257","V",11944973,11945194,221
"31224","WBGene00201258","III",11554797,11554922,125
"31225","WBGene00201260","X",2734716,2734863,147
"31226","WBGene00201261","III",5031670,5031817,147
"31227","WBGene00201262","X",2294330,2294446,116
"31228","WBGene00201263","II",7812645,7812847,202
"31229","WBGene00201267","II",7815493,7815699,206
"31230","WBGene00201268","X",16156933,16157078,145
"31231","WBGene00201269","X",12559881,12559942,61
"31232","WBGene00201270","I",7033811,7033950,139
"31233","WBGene00201272","IV",9953798,9954021,223
"31234","WBGene00201273","V",9789889,9790033,144
"31235","WBGene00201274","I",916168,916317,149
"31236","WBGene00201275","X",12823385,12823577,192
"31237","WBGene00201277","III",8465613,8465786,173
"31238","WBGene00201279","X",11713901,11714049,148
"31239","WBGene00201280","II",5465988,5466135,147
"31240","WBGene00201281","X",7613495,7613718,223
"31241","WBGene00201282","IV",9444639,9444766,127
"31242","WBGene00201283","V",14690667,14690816,149
"31243","WBGene00201284","II",5879620,5879769,149
"31244","WBGene00201285","III",10187848,10188108,260
"31245","WBGene00201286","V",10904894,10905037,143
"31246","WBGene00201288","V",6411336,6411399,63
"31247","WBGene00201289","X",9595770,9595902,132
"31248","WBGene00201290","V",19363909,19364000,91
"31249","WBGene00201291","IV",6098209,6098429,220
"31250","WBGene00201293","V",13221847,13222067,220
"31251","WBGene00201294","II",5890124,5890263,139
"31252","WBGene00201295","X",10392824,10392968,144
"31253","WBGene00201296","X",9085269,9085471,202
"31254","WBGene00201297","X",2103775,2103920,145
"31255","WBGene00201299","II",5772887,5773081,194
"31256","WBGene00201300","I",3248489,3248627,138
"31257","WBGene00201301","V",6000346,6000492,146
"31258","WBGene00201302","X",13825988,13826196,208
"31259","WBGene00201303","II",11042934,11043080,146
"31260","WBGene00201306","II",6151426,6151493,67
"31261","WBGene00201308","X",3889186,3889321,135
"31262","WBGene00201309","V",11214296,11214437,141
"31263","WBGene00201311","X",9637840,9637928,88
"31264","WBGene00201312","X",16300058,16300157,99
"31265","WBGene00201313","X",4117824,4117995,171
"31266","WBGene00201314","X",14876165,14876312,147
"31267","WBGene00201315","X",3978781,3978924,143
"31268","WBGene00201316","X",7747027,7747419,392
"31269","WBGene00201318","I",9919580,9919708,128
"31270","WBGene00201319","I",9139172,9139321,149
"31271","WBGene00201320","X",5958821,5958893,72
"31272","WBGene00201321","X",2125553,2125702,149
"31273","WBGene00201322","III",8395132,8395248,116
"31274","WBGene00201324","III",3233988,3234135,147
"31275","WBGene00201326","X",1931284,1931469,185
"31276","WBGene00201327","II",6707595,6707876,281
"31277","WBGene00201328","IV",16005805,16005954,149
"31278","WBGene00201330","X",6568900,6569110,210
"31279","WBGene00201332","V",1292861,1292930,69
"31280","WBGene00201333","X",15084603,15084705,102
"31281","WBGene00201334","X",7279945,7280083,138
"31282","WBGene00201338","X",7866261,7866608,347
"31283","WBGene00201339","II",4170090,4170175,85
"31284","WBGene00201340","X",4294636,4294770,134
"31285","WBGene00201342","IV",11211827,11211962,135
"31286","WBGene00201343","X",6126826,6126975,149
"31287","WBGene00201346","X",2528619,2528837,218
"31288","WBGene00201348","II",5927176,5927312,136
"31289","WBGene00201349","III",9975766,9975878,112
"31290","WBGene00201350","X",8836068,8836195,127
"31291","WBGene00201351","I",1974779,1974991,212
"31292","WBGene00201354","V",18566471,18566579,108
"31293","WBGene00201357","III",9606006,9606155,149
"31294","WBGene00201358","V",11680484,11680616,132
"31295","WBGene00201364","X",3332713,3332843,130
"31296","WBGene00201365","II",11889830,11889998,168
"31297","WBGene00201366","X",16791971,16792117,146
"31298","WBGene00201367","II",14903335,14903393,58
"31299","WBGene00201370","X",4554289,4554572,283
"31300","WBGene00201372","V",6213716,6213931,215
"31301","WBGene00201373","II",12678314,12678397,83
"31302","WBGene00201374","IV",11455812,11456020,208
"31303","WBGene00201375","X",10829970,10830118,148
"31304","WBGene00201376","IV",3085176,3085371,195
"31305","WBGene00201377","X",3949542,3949649,107
"31306","WBGene00201378","X",5816374,5816699,325
"31307","WBGene00201381","II",774112,774233,121
"31308","WBGene00201382","X",4549097,4549369,272
"31309","WBGene00201383","I",10398908,10399056,148
"31310","WBGene00201384","V",9156407,9156538,131
"31311","WBGene00201385","III",8288808,8288956,148
"31312","WBGene00201386","IV",5355565,5355714,149
"31313","WBGene00201387","III",2645112,2645227,115
"31314","WBGene00201388","X",3862705,3862808,103
"31315","WBGene00201389","III",8909074,8909217,143
"31316","WBGene00201390","II",6482535,6482641,106
"31317","WBGene00201391","IV",2177080,2177147,67
"31318","WBGene00201392","X",13074547,13074836,289
"31319","WBGene00201393","I",9545189,9545407,218
"31320","WBGene00201394","IV",1900987,1901135,148
"31321","WBGene00201395","II",11538028,11538123,95
"31322","WBGene00201396","IV",4459543,4459603,60
"31323","WBGene00201397","V",9769028,9769165,137
"31324","WBGene00201398","I",15060861,15061159,298
"31325","WBGene00201402","IV",7280962,7281103,141
"31326","WBGene00201403","IV",14464238,14464320,82
"31327","WBGene00201407","IV",3278800,3278936,136
"31328","WBGene00201408","X",9769239,9769370,131
"31329","WBGene00201410","V",8665709,8665918,209
"31330","WBGene00201411","X",3191481,3191723,242
"31331","WBGene00201412","IV",3083150,3083299,149
"31332","WBGene00201413","X",2334776,2334988,212
"31333","WBGene00201416","X",7873944,7874093,149
"31334","WBGene00201417","X",3309825,3309960,135
"31335","WBGene00201418","III",11792781,11792858,77
"31336","WBGene00201419","V",6257926,6258075,149
"31337","WBGene00201420","X",16530046,16530190,144
"31338","WBGene00201422","V",12474515,12474649,134
"31339","WBGene00201423","II",4925418,4925593,175
"31340","WBGene00201424","V",7098797,7098945,148
"31341","WBGene00201425","X",10504017,10504089,72
"31342","WBGene00201426","X",6219921,6220068,147
"31343","WBGene00201427","IV",7499419,7499643,224
"31344","WBGene00201429","III",3367435,3367584,149
"31345","WBGene00201430","V",979903,979994,91
"31346","WBGene00201431","X",4475101,4475250,149
"31347","WBGene00201432","X",14790643,14790789,146
"31348","WBGene00201434","V",17756710,17756802,92
"31349","WBGene00201435","I",6285688,6285899,211
"31350","WBGene00201438","II",11752032,11752234,202
"31351","WBGene00201439","II",4811125,4811335,210
"31352","WBGene00201440","I",6831471,6831522,51
"31353","WBGene00201441","IV",11406887,11407033,146
"31354","WBGene00201446","X",865357,865480,123
"31355","WBGene00201447","IV",80152,80203,51
"31356","WBGene00201448","I",11943666,11943815,149
"31357","WBGene00201450","X",11434004,11434146,142
"31358","WBGene00201451","V",12190700,12190785,85
"31359","WBGene00201452","II",6083060,6083232,172
"31360","WBGene00201453","V",2674002,2674102,100
"31361","WBGene00201456","I",536804,536931,127
"31362","WBGene00201457","V",6476934,6477016,82
"31363","WBGene00201458","I",7021295,7021584,289
"31364","WBGene00201459","II",5485688,5485766,78
"31365","WBGene00201461","III",13721446,13721594,148
"31366","WBGene00201463","V",18680055,18680336,281
"31367","WBGene00201466","III",3632455,3632608,153
"31368","WBGene00201468","X",6011348,6011502,154
"31369","WBGene00201470","I",4494898,4495058,160
"31370","WBGene00201471","V",7987301,7987450,149
"31371","WBGene00201472","X",5876096,5876223,127
"31372","WBGene00201473","V",14505851,14506035,184
"31373","WBGene00201474","III",6738396,6738536,140
"31374","WBGene00201476","III",1887736,1887818,82
"31375","WBGene00201477","IV",12418418,12418563,145
"31376","WBGene00201478","I",7798813,7798947,134
"31377","WBGene00201479","X",5040234,5040514,280
"31378","WBGene00201480","X",10253601,10253936,335
"31379","WBGene00201481","X",6488826,6489034,208
"31380","WBGene00201482","V",11463141,11463277,136
"31381","WBGene00201485","X",3251260,3251398,138
"31382","WBGene00201486","X",6240331,6240541,210
"31383","WBGene00201487","IV",5973827,5973962,135
"31384","WBGene00201489","X",6962808,6962998,190
"31385","WBGene00201492","X",5472688,5472833,145
"31386","WBGene00201493","X",2676337,2676519,182
"31387","WBGene00201494","I",6847134,6847308,174
"31388","WBGene00201495","II",4967817,4967908,91
"31389","WBGene00201503","X",5480219,5480496,277
"31390","WBGene00201505","II",5226524,5226644,120
"31391","WBGene00201506","X",5454659,5454845,186
"31392","WBGene00201507","V",13154786,13154926,140
"31393","WBGene00201508","I",10493662,10493885,223
"31394","WBGene00201512","V",8889868,8889980,112
"31395","WBGene00201513","II",7529396,7529542,146
"31396","WBGene00201515","IV",11716525,11716701,176
"31397","WBGene00201516","X",14959671,14959939,268
"31398","WBGene00201517","I",10237462,10237682,220
"31399","WBGene00201518","X",14673774,14673908,134
"31400","WBGene00201519","III",7659803,7659862,59
"31401","WBGene00201521","X",12876360,12876490,130
"31402","WBGene00201523","III",9262509,9262685,176
"31403","WBGene00201524","X",10711289,10711415,126
"31404","WBGene00201525","X",7469640,7469788,148
"31405","WBGene00201526","X",2214235,2214582,347
"31406","WBGene00201528","II",7568431,7568646,215
"31407","WBGene00201529","IV",2259460,2259578,118
"31408","WBGene00201530","V",10677668,10677817,149
"31409","WBGene00201531","X",4085730,4085796,66
"31410","WBGene00201532","IV",7275209,7275415,206
"31411","WBGene00201534","I",1278808,1279042,234
"31412","WBGene00201535","IV",6984762,6984909,147
"31413","WBGene00201538","V",11506699,11506847,148
"31414","WBGene00201539","III",9265004,9265143,139
"31415","WBGene00201540","X",7842784,7843005,221
"31416","WBGene00201541","III",7460073,7460200,127
"31417","WBGene00201543","X",16655441,16655664,223
"31418","WBGene00201544","X",8648640,8648788,148
"31419","WBGene00201546","IV",4110054,4110124,70
"31420","WBGene00201547","III",7973327,7973465,138
"31421","WBGene00201548","III",12821614,12821764,150
"31422","WBGene00201549","II",7593309,7593587,278
"31423","WBGene00201551","X",15560496,15560635,139
"31424","WBGene00201555","IV",11878798,11878947,149
"31425","WBGene00201556","II",7487529,7487625,96
"31426","WBGene00201557","X",11248069,11248268,199
"31427","WBGene00201558","III",9081466,9081595,129
"31428","WBGene00201559","X",3318284,3318603,319
"31429","WBGene00201560","V",12357455,12357602,147
"31430","WBGene00201561","III",9640123,9640341,218
"31431","WBGene00201563","V",11679713,11679920,207
"31432","WBGene00201564","X",5816432,5816909,477
"31433","WBGene00201565","V",9963245,9963296,51
"31434","WBGene00201566","III",8509737,8509878,141
"31435","WBGene00201567","V",6461262,6461411,149
"31436","WBGene00201568","IV",6363149,6363208,59
"31437","WBGene00201569","I",2684870,2684997,127
"31438","WBGene00201570","II",5379662,5379881,219
"31439","WBGene00201571","II",5186136,5186274,138
"31440","WBGene00201572","X",13284752,13284852,100
"31441","WBGene00201573","I",779157,779241,84
"31442","WBGene00201574","IV",3085551,3085772,221
"31443","WBGene00201575","V",6520199,6520335,136
"31444","WBGene00201576","IV",7926601,7926814,213
"31445","WBGene00201577","X",2215230,2215446,216
"31446","WBGene00201578","IV",11523879,11524062,183
"31447","WBGene00201579","V",6847378,6847590,212
"31448","WBGene00201580","X",8426441,8426649,208
"31449","WBGene00201581","II",5042454,5042598,144
"31450","WBGene00201582","X",3899244,3899407,163
"31451","WBGene00201584","X",8446353,8446493,140
"31452","WBGene00201585","III",9738529,9738678,149
"31453","WBGene00201587","X",7214688,7214836,148
"31454","WBGene00201589","I",8461415,8461554,139
"31455","WBGene00201591","II",13031073,13031212,139
"31456","WBGene00201592","IV",5964200,5964356,156
"31457","WBGene00201593","X",5098596,5098742,146
"31458","WBGene00201594","III",7532161,7532301,140
"31459","WBGene00201596","II",6120483,6120679,196
"31460","WBGene00201597","X",2043255,2043333,78
"31461","WBGene00201598","X",15526832,15527031,199
"31462","WBGene00201599","V",12212065,12212191,126
"31463","WBGene00201600","IV",5942311,5942427,116
"31464","WBGene00201606","III",8457784,8457930,146
"31465","WBGene00201608","III",278658,278708,50
"31466","WBGene00201609","X",10557543,10557691,148
"31467","WBGene00201610","X",2356656,2356786,130
"31468","WBGene00201612","V",7171103,7171252,149
"31469","WBGene00201615","II",2119449,2119594,145
"31470","WBGene00201619","V",13344704,13344844,140
"31471","WBGene00201620","X",6855427,6855862,435
"31472","WBGene00201621","II",6394917,6395055,138
"31473","WBGene00201624","II",11286527,11286786,259
"31474","WBGene00201625","V",12554533,12554637,104
"31475","WBGene00201626","V",10940659,10940853,194
"31476","WBGene00201630","II",7511833,7511975,142
"31477","WBGene00201631","III",8639299,8639436,137
"31478","WBGene00201633","X",5820067,5820260,193
"31479","WBGene00201634","IV",8067517,8067735,218
"31480","WBGene00201636","III",8289329,8289478,149
"31481","WBGene00201638","X",15889070,15889263,193
"31482","WBGene00201639","III",2557344,2557493,149
"31483","WBGene00201640","IV",3513761,3513967,206
"31484","WBGene00201641","X",10394242,10394427,185
"31485","WBGene00201642","II",8028060,8028245,185
"31486","WBGene00201643","V",8914619,8914758,139
"31487","WBGene00201644","II",6827632,6827773,141
"31488","WBGene00201645","X",8440313,8440445,132
"31489","WBGene00201646","V",14851339,14851471,132
"31490","WBGene00201648","IV",8070262,8070407,145
"31491","WBGene00201649","X",15519439,15519567,128
"31492","WBGene00201650","IV",2998769,2998917,148
"31493","WBGene00201651","X",10083931,10084012,81
"31494","WBGene00201652","II",6707608,6707889,281
"31495","WBGene00201653","IV",9912058,9912197,139
"31496","WBGene00201654","V",6901136,6901285,149
"31497","WBGene00201658","III",8491776,8491893,117
"31498","WBGene00201659","IV",17226310,17226365,55
"31499","WBGene00201660","X",6743978,6744311,333
"31500","WBGene00201661","V",2659707,2659836,129
"31501","WBGene00201662","I",6374842,6374988,146
"31502","WBGene00201664","V",9978506,9978676,170
"31503","WBGene00201666","V",11186062,11186203,141
"31504","WBGene00201667","I",788097,788219,122
"31505","WBGene00201670","II",14249642,14249789,147
"31506","WBGene00201671","IV",867080,867215,135
"31507","WBGene00201673","X",5866481,5866620,139
"31508","WBGene00201674","II",7772464,7772603,139
"31509","WBGene00201675","II",7625262,7625401,139
"31510","WBGene00201676","I",7181234,7181382,148
"31511","WBGene00201677","V",12299929,12300049,120
"31512","WBGene00201678","I",10770088,10770210,122
"31513","WBGene00201679","V",14506109,14506323,214
"31514","WBGene00201680","II",6464772,6464893,121
"31515","WBGene00201682","I",4324093,4324220,127
"31516","WBGene00201683","III",8276173,8276280,107
"31517","WBGene00201684","IV",2655060,2655189,129
"31518","WBGene00201687","X",11252576,11252667,91
"31519","WBGene00201688","I",13951771,13952052,281
"31520","WBGene00201689","III",8506843,8506992,149
"31521","WBGene00201691","V",19539746,19539963,217
"31522","WBGene00201693","IV",2314119,2314289,170
"31523","WBGene00201694","I",5412497,5412640,143
"31524","WBGene00201695","V",5607440,5607537,97
"31525","WBGene00201696","II",13974358,13974458,100
"31526","WBGene00201697","IV",3546879,3546958,79
"31527","WBGene00201698","X",7220344,7220557,213
"31528","WBGene00201699","IV",7088201,7088350,149
"31529","WBGene00201702","III",9646671,9646796,125
"31530","WBGene00201703","X",11127158,11127299,141
"31531","WBGene00201705","X",7581070,7581200,130
"31532","WBGene00201706","X",4727990,4728160,170
"31533","WBGene00201707","III",6678045,6678122,77
"31534","WBGene00201709","V",19373558,19373631,73
"31535","WBGene00201710","I",7208831,7208922,91
"31536","WBGene00201715","IV",9609893,9610020,127
"31537","WBGene00201716","IV",11235985,11236133,148
"31538","WBGene00201717","X",5729600,5729720,120
"31539","WBGene00201718","X",4339089,4339234,145
"31540","WBGene00201719","III",9851659,9851794,135
"31541","WBGene00201721","X",2536478,2536680,202
"31542","WBGene00201723","I",14177438,14177510,72
"31543","WBGene00201725","V",12884400,12884549,149
"31544","WBGene00201727","X",4879929,4880018,89
"31545","WBGene00201729","X",6944902,6945120,218
"31546","WBGene00201730","V",20763537,20763833,296
"31547","WBGene00201731","IV",3231685,3231763,78
"31548","WBGene00201732","III",6828701,6828849,148
"31549","WBGene00201733","X",13206272,13206417,145
"31550","WBGene00201734","X",7794326,7794415,89
"31551","WBGene00201735","II",6834141,6834326,185
"31552","WBGene00201736","X",3337060,3337276,216
"31553","WBGene00201737","I",11537217,11537301,84
"31554","WBGene00201739","V",10915943,10916128,185
"31555","WBGene00201741","X",4813170,4813642,472
"31556","WBGene00201744","II",7719219,7719365,146
"31557","WBGene00201745","X",7951626,7951836,210
"31558","WBGene00201746","X",4431321,4431470,149
"31559","WBGene00201747","IV",7096897,7097045,148
"31560","WBGene00201748","II",6182470,6182545,75
"31561","WBGene00201749","IV",5561741,5561963,222
"31562","WBGene00201750","V",6473855,6473987,132
"31563","WBGene00201751","II",586700,586849,149
"31564","WBGene00201752","II",11749496,11749590,94
"31565","WBGene00201753","I",10750563,10750705,142
"31566","WBGene00201754","I",6082808,6082939,131
"31567","WBGene00201755","I",6790698,6790838,140
"31568","WBGene00201757","II",5679414,5679605,191
"31569","WBGene00201759","II",9417919,9418007,88
"31570","WBGene00201760","IV",555718,555855,137
"31571","WBGene00201762","X",3476356,3476568,212
"31572","WBGene00201764","V",14862082,14862227,145
"31573","WBGene00201765","I",4749896,4750042,146
"31574","WBGene00201767","III",1813985,1814134,149
"31575","WBGene00201770","V",10247117,10247257,140
"31576","WBGene00201771","X",4244808,4245009,201
"31577","WBGene00201773","II",2442121,2442170,49
"31578","WBGene00201774","V",12683343,12683424,81
"31579","WBGene00201775","IV",12417174,12417325,151
"31580","WBGene00201776","V",18813835,18813911,76
"31581","WBGene00201777","I",1251252,1251322,70
"31582","WBGene00201778","X",14557901,14558035,134
"31583","WBGene00201779","X",5263435,5263564,129
"31584","WBGene00201782","I",13095249,13095509,260
"31585","WBGene00201783","V",13934711,13934774,63
"31586","WBGene00201784","X",2666073,2666334,261
"31587","WBGene00201786","X",14997472,14997612,140
"31588","WBGene00201788","III",11371304,11371489,185
"31589","WBGene00201789","X",13009772,13009913,141
"31590","WBGene00201791","X",15117036,15117158,122
"31591","WBGene00201793","X",9375842,9375978,136
"31592","WBGene00201796","X",699140,699284,144
"31593","WBGene00201797","V",11336546,11336743,197
"31594","WBGene00201798","V",8545704,8545865,161
"31595","WBGene00201799","X",10724089,10724141,52
"31596","WBGene00201800","X",4331037,4331184,147
"31597","WBGene00201801","I",7887214,7887335,121
"31598","WBGene00201802","V",18931628,18931684,56
"31599","WBGene00201803","V",11502311,11502441,130
"31600","WBGene00201804","V",10703522,10703607,85
"31601","WBGene00201806","V",6473368,6473645,277
"31602","WBGene00201807","V",8660466,8660790,324
"31603","WBGene00201808","X",11192125,11192346,221
"31604","WBGene00201809","V",11708871,11709183,312
"31605","WBGene00201811","X",15354082,15354200,118
"31606","WBGene00201812","X",2206575,2206717,142
"31607","WBGene00201814","III",510876,510967,91
"31608","WBGene00201815","II",8891077,8891249,172
"31609","WBGene00201817","II",7930825,7930897,72
"31610","WBGene00201818","V",12983599,12983653,54
"31611","WBGene00201819","III",4142401,4142454,53
"31612","WBGene00201820","II",6620511,6620645,134
"31613","WBGene00201822","V",5613270,5613493,223
"31614","WBGene00201823","X",3701768,3701819,51
"31615","WBGene00201825","X",12180164,12180313,149
"31616","WBGene00201827","V",7967167,7967373,206
"31617","WBGene00201830","IV",2805622,2805708,86
"31618","WBGene00201832","X",5022776,5022923,147
"31619","WBGene00201833","X",14634003,14634121,118
"31620","WBGene00201835","X",5864767,5864872,105
"31621","WBGene00201836","X",5818149,5818733,584
"31622","WBGene00201838","III",4947433,4947485,52
"31623","WBGene00201840","X",10594145,10594274,129
"31624","WBGene00201841","V",15763708,15763848,140
"31625","WBGene00201842","IV",7348429,7348577,148
"31626","WBGene00201843","V",13243352,13243557,205
"31627","WBGene00201846","III",1744641,1744693,52
"31628","WBGene00201847","V",6336295,6336510,215
"31629","WBGene00201848","IV",4784835,4784986,151
"31630","WBGene00201849","IV",12010399,12010681,282
"31631","WBGene00201850","X",5317996,5318118,122
"31632","WBGene00201851","IV",7428467,7428881,414
"31633","WBGene00201852","X",15694129,15694277,148
"31634","WBGene00201853","X",7216469,7216613,144
"31635","WBGene00201855","V",8820986,8821096,110
"31636","WBGene00201857","V",6338764,6338901,137
"31637","WBGene00201858","V",12491202,12491346,144
"31638","WBGene00201859","X",2553855,2553998,143
"31639","WBGene00201861","X",16042599,16042692,93
"31640","WBGene00201862","III",6518105,6518158,53
"31641","WBGene00201867","X",12062234,12062379,145
"31642","WBGene00201868","V",6468593,6468732,139
"31643","WBGene00201869","I",10244352,10244462,110
"31644","WBGene00201870","X",8652818,8652920,102
"31645","WBGene00201871","II",9061982,9062128,146
"31646","WBGene00201873","V",8928413,8928543,130
"31647","WBGene00201874","V",10722915,10723043,128
"31648","WBGene00201876","X",4872888,4873022,134
"31649","WBGene00201878","IV",13090414,13090638,224
"31650","WBGene00201879","V",13028037,13028170,133
"31651","WBGene00201880","X",15194547,15194680,133
"31652","WBGene00201881","X",13540033,13540173,140
"31653","WBGene00201882","III",10525995,10526181,186
"31654","WBGene00201883","V",12330458,12330606,148
"31655","WBGene00201884","X",5855574,5855723,149
"31656","WBGene00201885","II",15206833,15206982,149
"31657","WBGene00201887","X",13036548,13036634,86
"31658","WBGene00201888","II",14076583,14076732,149
"31659","WBGene00201889","III",4951448,4951496,48
"31660","WBGene00201891","X",12088023,12088244,221
"31661","WBGene00201892","X",16996694,16996870,176
"31662","WBGene00201893","X",13495836,13496144,308
"31663","WBGene00201894","X",8397151,8397561,410
"31664","WBGene00201896","III",1557220,1557272,52
"31665","WBGene00201897","IV",10227656,10227778,122
"31666","WBGene00201899","II",6227232,6227378,146
"31667","WBGene00201900","V",10602216,10602430,214
"31668","WBGene00201901","I",6163380,6163599,219
"31669","WBGene00201902","V",10665953,10666100,147
"31670","WBGene00201904","V",10825845,10826061,216
"31671","WBGene00201905","X",6636018,6636167,149
"31672","WBGene00201907","V",11948727,11948939,212
"31673","WBGene00201908","X",16155567,16155774,207
"31674","WBGene00201909","X",14024488,14024761,273
"31675","WBGene00201911","X",7174316,7174540,224
"31676","WBGene00201913","II",15264825,15264885,60
"31677","WBGene00201914","IV",10963801,10963948,147
"31678","WBGene00201915","IV",12199577,12199716,139
"31679","WBGene00201916","I",6893303,6893447,144
"31680","WBGene00201917","V",6925687,6925834,147
"31681","WBGene00201918","II",11223444,11223575,131
"31682","WBGene00201919","V",10719561,10719704,143
"31683","WBGene00201920","X",3054573,3054700,127
"31684","WBGene00201921","X",10849581,10849862,281
"31685","WBGene00201923","V",11199800,11199939,139
"31686","WBGene00201925","I",5719373,5719522,149
"31687","WBGene00201926","I",9894298,9894822,524
"31688","WBGene00201928","II",10506204,10506287,83
"31689","WBGene00201929","IV",9912269,9912413,144
"31690","WBGene00201930","II",10073484,10073761,277
"31691","WBGene00201933","V",10467021,10467158,137
"31692","WBGene00201936","V",11213512,11213637,125
"31693","WBGene00201937","II",6131504,6131576,72
"31694","WBGene00201939","V",11705871,11706095,224
"31695","WBGene00201940","V",11664934,11665077,143
"31696","WBGene00201941","X",14200425,14200645,220
"31697","WBGene00201942","IV",11572528,11572671,143
"31698","WBGene00201943","X",5811884,5812170,286
"31699","WBGene00201945","IV",5046865,5046999,134
"31700","WBGene00201946","X",7644190,7644335,145
"31701","WBGene00201948","V",5795935,5796146,211
"31702","WBGene00201949","V",12538580,12538794,214
"31703","WBGene00201951","X",2757420,2757508,88
"31704","WBGene00201952","V",11674719,11674930,211
"31705","WBGene00201953","I",6459477,6459596,119
"31706","WBGene00201955","X",4165815,4165949,134
"31707","WBGene00201959","X",6221023,6221154,131
"31708","WBGene00201960","X",4556743,4556881,138
"31709","WBGene00201962","III",4666853,4667214,361
"31710","WBGene00201963","IV",14033092,14033171,79
"31711","WBGene00201964","V",10536755,10536899,144
"31712","WBGene00201966","V",4826993,4827264,271
"31713","WBGene00201967","X",12414391,12414566,175
"31714","WBGene00201969","X",15217485,15217630,145
"31715","WBGene00201970","X",9469106,9469163,57
"31716","WBGene00201971","II",11223963,11224157,194
"31717","WBGene00201973","I",14372018,14372079,61
"31718","WBGene00201975","X",2510714,2510851,137
"31719","WBGene00201976","I",11837979,11838112,133
"31720","WBGene00201977","II",14574217,14574409,192
"31721","WBGene00201978","X",15447732,15447860,128
"31722","WBGene00201980","X",7456923,7457064,141
"31723","WBGene00201981","III",4624950,4625174,224
"31724","WBGene00201982","II",6833778,6834000,222
"31725","WBGene00201983","III",7033437,7033514,77
"31726","WBGene00201984","IV",8008427,8008572,145
"31727","WBGene00201985","IV",16397703,16397789,86
"31728","WBGene00201986","III",8737441,8737652,211
"31729","WBGene00201987","V",11621314,11621389,75
"31730","WBGene00201988","II",6865564,6865759,195
"31731","WBGene00201991","IV",8205117,8205400,283
"31732","WBGene00201992","V",12525285,12525432,147
"31733","WBGene00201993","X",14861877,14862153,276
"31734","WBGene00201994","X",11464663,11464786,123
"31735","WBGene00201997","V",11653975,11654115,140
"31736","WBGene00201998","V",6900449,6900664,215
"31737","WBGene00201999","III",9447748,9447859,111
"31738","WBGene00202000","II",13020773,13021074,301
"31739","WBGene00202001","X",8789174,8789289,115
"31740","WBGene00202003","V",19758124,19758177,53
"31741","WBGene00202006","V",12111554,12111714,160
"31742","WBGene00202009","V",3205889,3206113,224
"31743","WBGene00202010","X",6015286,6015461,175
"31744","WBGene00202011","V",11859699,11859842,143
"31745","WBGene00202017","IV",11045642,11045791,149
"31746","WBGene00202020","X",2926522,2926702,180
"31747","WBGene00202022","V",9734380,9734573,193
"31748","WBGene00202023","V",9314912,9315039,127
"31749","WBGene00202024","X",14332145,14332205,60
"31750","WBGene00202026","II",6834745,6834957,212
"31751","WBGene00202027","I",14831271,14831388,117
"31752","WBGene00202028","X",5800374,5800490,116
"31753","WBGene00202029","X",3824371,3824708,337
"31754","WBGene00202030","IV",10222036,10222243,207
"31755","WBGene00202033","II",8270210,8270347,137
"31756","WBGene00202034","X",5493541,5493738,197
"31757","WBGene00202035","X",12877132,12877398,266
"31758","WBGene00202036","X",10392829,10393040,211
"31759","WBGene00202037","IV",9628607,9628706,99
"31760","WBGene00202039","I",9916865,9916947,82
"31761","WBGene00202041","IV",2654357,2654506,149
"31762","WBGene00202042","X",13824542,13824676,134
"31763","WBGene00202044","X",5802566,5802704,138
"31764","WBGene00202046","III",10516484,10516604,120
"31765","WBGene00202048","IV",11817387,11817610,223
"31766","WBGene00202050","X",10624823,10624897,74
"31767","WBGene00202051","X",10226116,10226294,178
"31768","WBGene00202052","X",5729879,5730021,142
"31769","WBGene00202053","V",11060662,11060808,146
"31770","WBGene00202054","V",11450543,11450761,218
"31771","WBGene00202056","X",15446452,15446675,223
"31772","WBGene00202058","V",6355289,6355567,278
"31773","WBGene00202059","X",16621631,16621771,140
"31774","WBGene00202061","II",5466112,5466251,139
"31775","WBGene00202062","X",4409779,4409877,98
"31776","WBGene00202063","I",2835483,2835622,139
"31777","WBGene00202064","IV",1115800,1115911,111
"31778","WBGene00202066","III",4454895,4455035,140
"31779","WBGene00202067","V",7746125,7746271,146
"31780","WBGene00202068","X",6979402,6979507,105
"31781","WBGene00202070","X",12563784,12563870,86
"31782","WBGene00202072","IV",6988844,6988989,145
"31783","WBGene00202074","V",10724770,10725038,268
"31784","WBGene00202075","X",8944211,8944307,96
"31785","WBGene00202076","V",6542137,6542286,149
"31786","WBGene00202077","V",9796176,9796364,188
"31787","WBGene00202079","IV",9459324,9459543,219
"31788","WBGene00202080","V",5991530,5991672,142
"31789","WBGene00202081","X",7586882,7587091,209
"31790","WBGene00202082","II",5862213,5862362,149
"31791","WBGene00202084","V",10174999,10175194,195
"31792","WBGene00202085","I",7029888,7030001,113
"31793","WBGene00202086","II",11062772,11062996,224
"31794","WBGene00202088","II",11396417,11396566,149
"31795","WBGene00202089","IV",11354069,11354207,138
"31796","WBGene00202091","X",7464349,7464473,124
"31797","WBGene00202092","X",2105112,2105246,134
"31798","WBGene00202093","I",809294,809476,182
"31799","WBGene00202095","X",12876770,12877035,265
"31800","WBGene00202096","III",11479155,11479331,176
"31801","WBGene00202097","IV",6841485,6841609,124
"31802","WBGene00202098","IV",11219705,11219772,67
"31803","WBGene00202099","V",4919845,4919990,145
"31804","WBGene00202100","X",12904470,12904525,55
"31805","WBGene00202101","III",1878262,1878315,53
"31806","WBGene00202102","X",11718866,11719000,134
"31807","WBGene00202103","IV",11435601,11435810,209
"31808","WBGene00202104","X",3375412,3375547,135
"31809","WBGene00202105","II",5878662,5878776,114
"31810","WBGene00202106","X",2676553,2676756,203
"31811","WBGene00202107","III",8021034,8021107,73
"31812","WBGene00202108","V",14443345,14443430,85
"31813","WBGene00202110","I",1840679,1840745,66
"31814","WBGene00202112","X",16534210,16534357,147
"31815","WBGene00202113","II",8891541,8891876,335
"31816","WBGene00202114","II",7597371,7597502,131
"31817","WBGene00202116","II",12326390,12326505,115
"31818","WBGene00202117","III",1163345,1163430,85
"31819","WBGene00202118","II",7436422,7436642,220
"31820","WBGene00202120","X",2416031,2416180,149
"31821","WBGene00202121","IV",5814724,5814864,140
"31822","WBGene00202122","V",6023038,6023187,149
"31823","WBGene00202124","V",10463392,10463546,154
"31824","WBGene00202127","II",11269038,11269187,149
"31825","WBGene00202128","V",13352499,13352634,135
"31826","WBGene00202131","V",9623088,9623211,123
"31827","WBGene00202132","X",3976848,3977067,219
"31828","WBGene00202133","V",10175071,10175196,125
"31829","WBGene00202136","I",10400694,10400840,146
"31830","WBGene00202139","II",408354,408403,49
"31831","WBGene00202140","X",15381522,15381659,137
"31832","WBGene00202141","III",1003113,1003175,62
"31833","WBGene00202142","I",9550011,9550220,209
"31834","WBGene00202144","III",706173,706287,114
"31835","WBGene00202147","X",6891415,6891563,148
"31836","WBGene00202148","I",2700617,2700838,221
"31837","WBGene00202149","III",8289295,8289444,149
"31838","WBGene00202150","X",14708033,14708094,61
"31839","WBGene00202151","V",11692784,11692967,183
"31840","WBGene00202152","I",9039224,9039351,127
"31841","WBGene00202153","X",15236122,15236212,90
"31842","WBGene00202156","I",5871394,5871503,109
"31843","WBGene00202158","III",9974688,9974894,206
"31844","WBGene00202159","II",6439684,6439894,210
"31845","WBGene00202160","X",7469934,7470079,145
"31846","WBGene00202161","V",5892771,5892911,140
"31847","WBGene00202163","V",9305233,9305400,167
"31848","WBGene00202164","II",1235860,1235967,107
"31849","WBGene00202165","II",6497298,6497437,139
"31850","WBGene00202166","IV",5977394,5977529,135
"31851","WBGene00202167","X",10937569,10937909,340
"31852","WBGene00202168","X",4789626,4789841,215
"31853","WBGene00202169","III",6824453,6824599,146
"31854","WBGene00202170","I",9036031,9036175,144
"31855","WBGene00202171","IV",12180564,12180776,212
"31856","WBGene00202172","X",4065385,4065602,217
"31857","WBGene00202173","I",8953172,8953254,82
"31858","WBGene00202174","X",7426279,7426464,185
"31859","WBGene00202177","V",7098600,7098943,343
"31860","WBGene00202178","V",20756529,20756737,208
"31861","WBGene00202181","X",8198060,8198260,200
"31862","WBGene00202182","IV",11594382,11594598,216
"31863","WBGene00202183","X",11822508,11822653,145
"31864","WBGene00202185","X",10311728,10311865,137
"31865","WBGene00202186","V",5973532,5973746,214
"31866","WBGene00202187","III",2032515,2032590,75
"31867","WBGene00202189","III",1535673,1535722,49
"31868","WBGene00202190","X",3068191,3068324,133
"31869","WBGene00202195","III",3678536,3678685,149
"31870","WBGene00202196","II",10989265,10989463,198
"31871","WBGene00202197","X",7174074,7174205,131
"31872","WBGene00202198","X",14047507,14047697,190
"31873","WBGene00202199","X",6687644,6687861,217
"31874","WBGene00202202","II",13272631,13272780,149
"31875","WBGene00202205","X",11061913,11062057,144
"31876","WBGene00202206","X",6371376,6371464,88
"31877","WBGene00202207","V",20590888,20590947,59
"31878","WBGene00202208","V",20119824,20119973,149
"31879","WBGene00202209","IV",1628461,1628555,94
"31880","WBGene00202211","X",5664365,5664504,139
"31881","WBGene00202212","II",10988742,10988964,222
"31882","WBGene00202213","II",2979389,2979442,53
"31883","WBGene00202215","II",7565018,7565526,508
"31884","WBGene00202217","X",6688457,6688593,136
"31885","WBGene00202218","X",8233592,8233718,126
"31886","WBGene00202220","III",13420442,13420566,124
"31887","WBGene00202222","II",6393271,6393340,69
"31888","WBGene00202223","II",3981050,3981101,51
"31889","WBGene00202224","IV",2083612,2083761,149
"31890","WBGene00202226","X",10849650,10849866,216
"31891","WBGene00202227","X",15693460,15693609,149
"31892","WBGene00202228","II",3036836,3036904,68
"31893","WBGene00202231","II",8900419,8900769,350
"31894","WBGene00202232","IV",9196814,9197111,297
"31895","WBGene00202233","I",7890631,7890682,51
"31896","WBGene00202235","II",6397466,6397684,218
"31897","WBGene00202236","X",11070002,11070091,89
"31898","WBGene00202237","I",9731348,9731484,136
"31899","WBGene00202239","IV",3587349,3587496,147
"31900","WBGene00202241","X",13577923,13578047,124
"31901","WBGene00202242","X",17155494,17155639,145
"31902","WBGene00202243","X",10228372,10228503,131
"31903","WBGene00202244","X",3865022,3865162,140
"31904","WBGene00202245","V",11209455,11209697,242
"31905","WBGene00202247","V",6525612,6525807,195
"31906","WBGene00202249","V",14428301,14428448,147
"31907","WBGene00202250","IV",7207589,7207738,149
"31908","WBGene00202254","IV",6987441,6987590,149
"31909","WBGene00202256","V",12168844,12169124,280
"31910","WBGene00202258","X",13818586,13818735,149
"31911","WBGene00202260","IV",11796916,11797065,149
"31912","WBGene00202262","II",4441824,4442009,185
"31913","WBGene00202263","I",4868171,4868280,109
"31914","WBGene00202264","IV",12001291,12001435,144
"31915","WBGene00202265","X",5888484,5888536,52
"31916","WBGene00202266","IV",11883037,11883186,149
"31917","WBGene00202268","X",3313067,3313216,149
"31918","WBGene00202269","V",12351289,12351426,137
"31919","WBGene00202272","IV",4579218,4579367,149
"31920","WBGene00202273","IV",9196813,9197110,297
"31921","WBGene00202274","V",11464413,11464558,145
"31922","WBGene00202275","III",6743531,6743639,108
"31923","WBGene00202276","X",3253309,3253432,123
"31924","WBGene00202279","V",11338389,11338613,224
"31925","WBGene00202281","IV",11680801,11680934,133
"31926","WBGene00202282","X",15580510,15580655,145
"31927","WBGene00202283","X",10115810,10115889,79
"31928","WBGene00202284","V",3246429,3246494,65
"31929","WBGene00202285","IV",2226976,2227029,53
"31930","WBGene00202286","II",5485483,5485607,124
"31931","WBGene00202287","X",5874868,5874996,128
"31932","WBGene00202289","X",2901163,2901416,253
"31933","WBGene00202291","X",10254151,10254288,137
"31934","WBGene00202292","X",5460761,5460888,127
"31935","WBGene00202294","X",5523050,5523181,131
"31936","WBGene00202295","I",10494334,10494548,214
"31937","WBGene00202297","V",13575080,13575215,135
"31938","WBGene00202299","III",6689929,6690019,90
"31939","WBGene00202300","II",9262232,9262375,143
"31940","WBGene00202301","IV",12201572,12201721,149
"31941","WBGene00202302","X",5459867,5460091,224
"31942","WBGene00202304","X",14885848,14886013,165
"31943","WBGene00202306","II",14438235,14438289,54
"31944","WBGene00202307","III",8962317,8962466,149
"31945","WBGene00202310","V",11351312,11351451,139
"31946","WBGene00202311","III",9978383,9978604,221
"31947","WBGene00202312","II",5649619,5649692,73
"31948","WBGene00202313","III",12801772,12801921,149
"31949","WBGene00202314","IV",7274099,7274323,224
"31950","WBGene00202315","V",10672291,10672923,632
"31951","WBGene00202316","X",4699793,4699916,123
"31952","WBGene00202317","IV",5974017,5974252,235
"31953","WBGene00202318","IV",6985183,6985328,145
"31954","WBGene00202319","I",9544400,9544549,149
"31955","WBGene00202320","IV",11713374,11713522,148
"31956","WBGene00202322","III",9242530,9242726,196
"31957","WBGene00202324","II",1305501,1305551,50
"31958","WBGene00202325","V",5571908,5572049,141
"31959","WBGene00202326","X",16655352,16655598,246
"31960","WBGene00202327","V",9024733,9025028,295
"31961","WBGene00202331","I",6051145,6051282,137
"31962","WBGene00202332","IV",6839064,6839199,135
"31963","WBGene00202333","X",15310400,15310693,293
"31964","WBGene00202334","III",7918951,7919145,194
"31965","WBGene00202335","V",6686402,6686550,148
"31966","WBGene00202336","II",5894084,5894223,139
"31967","WBGene00202337","X",3797105,3797231,126
"31968","WBGene00202339","V",7747116,7747265,149
"31969","WBGene00202341","III",7642148,7642231,83
"31970","WBGene00202342","IV",12006208,12006357,149
"31971","WBGene00202343","X",15426582,15426806,224
"31972","WBGene00202346","I",14626980,14627052,72
"31973","WBGene00202349","I",4496673,4496814,141
"31974","WBGene00202350","X",16388472,16388631,159
"31975","WBGene00202355","II",9416488,9416703,215
"31976","WBGene00202358","II",11111231,11111353,122
"31977","WBGene00202359","I",846171,846491,320
"31978","WBGene00202360","II",7516434,7516583,149
"31979","WBGene00202361","IV",10902908,10902996,88
"31980","WBGene00202364","III",3785099,3785246,147
"31981","WBGene00202365","I",7267095,7267226,131
"31982","WBGene00202367","IV",4796264,4796412,148
"31983","WBGene00202369","I",11176950,11177099,149
"31984","WBGene00202370","X",3472486,3472598,112
"31985","WBGene00202371","IV",12401262,12401483,221
"31986","WBGene00202372","IV",16031887,16032001,114
"31987","WBGene00202373","II",4295342,4295596,254
"31988","WBGene00202374","X",16792418,16792526,108
"31989","WBGene00202375","IV",7538775,7538924,149
"31990","WBGene00202376","IV",3854898,3855138,240
"31991","WBGene00202377","X",6221037,6221243,206
"31992","WBGene00202378","II",9024529,9024613,84
"31993","WBGene00202379","X",5543556,5543763,207
"31994","WBGene00202380","X",598296,598401,105
"31995","WBGene00202383","II",7632986,7633198,212
"31996","WBGene00202384","I",12001685,12001833,148
"31997","WBGene00202385","IV",6499747,6499886,139
"31998","WBGene00202386","X",4276465,4276521,56
"31999","WBGene00202387","V",11336818,11336941,123
"32000","WBGene00202389","III",11467449,11467620,171
"32001","WBGene00202390","IV",5814403,5814543,140
"32002","WBGene00202391","X",6149259,6149478,219
"32003","WBGene00202393","X",2527958,2528075,117
"32004","WBGene00202394","II",9801887,9802030,143
"32005","WBGene00202395","II",5950185,5950318,133
"32006","WBGene00202396","III",1627280,1627333,53
"32007","WBGene00202397","X",3469476,3469752,276
"32008","WBGene00202398","IV",10305178,10305247,69
"32009","WBGene00202399","X",16000781,16000930,149
"32010","WBGene00202400","II",5181774,5181980,206
"32011","WBGene00202401","X",2885440,2885578,138
"32012","WBGene00202402","V",18694010,18694158,148
"32013","WBGene00202404","X",3948309,3948388,79
"32014","WBGene00202405","I",6283531,6283672,141
"32015","WBGene00202406","X",4554091,4554229,138
"32016","WBGene00202407","X",3035964,3036111,147
"32017","WBGene00202408","I",2514167,2514255,88
"32018","WBGene00202409","IV",5521352,5521552,200
"32019","WBGene00202410","III",13056382,13056604,222
"32020","WBGene00202411","X",3332190,3332414,224
"32021","WBGene00202413","III",6801982,6802186,204
"32022","WBGene00202415","IV",8636944,8637035,91
"32023","WBGene00202416","X",14773372,14773505,133
"32024","WBGene00202417","X",9369077,9369211,134
"32025","WBGene00202419","IV",10499919,10500197,278
"32026","WBGene00202421","X",6219724,6219795,71
"32027","WBGene00202422","IV",6103136,6103274,138
"32028","WBGene00202423","X",7213323,7213470,147
"32029","WBGene00202424","X",6570064,6570211,147
"32030","WBGene00202425","X",2351079,2351206,127
"32031","WBGene00202427","V",11458594,11458837,243
"32032","WBGene00202428","II",14946422,14946475,53
"32033","WBGene00202429","X",6956907,6957187,280
"32034","WBGene00202431","IV",143981,144075,94
"32035","WBGene00202432","III",11733819,11733941,122
"32036","WBGene00202434","X",3821855,3821995,140
"32037","WBGene00202436","V",1172727,1172934,207
"32038","WBGene00202439","V",9769363,9769544,181
"32039","WBGene00202440","III",3621520,3621644,124
"32040","WBGene00202441","I",9797853,9797912,59
"32041","WBGene00202442","IV",7538344,7538487,143
"32042","WBGene00202444","I",553658,553785,127
"32043","WBGene00202445","III",10819642,10819999,357
"32044","WBGene00202446","III",4514153,4514320,167
"32045","WBGene00202447","X",16530116,16530265,149
"32046","WBGene00202449","I",4746970,4747116,146
"32047","WBGene00202451","X",3858414,3858585,171
"32048","WBGene00202453","III",8460654,8460794,140
"32049","WBGene00202458","X",3069274,3069556,282
"32050","WBGene00202460","X",7457672,7457885,213
"32051","WBGene00202461","X",9056580,9056729,149
"32052","WBGene00202462","III",2880332,2880396,64
"32053","WBGene00202464","X",4549244,4549459,215
"32054","WBGene00202465","V",6468310,6468449,139
"32055","WBGene00202467","II",7795435,7795582,147
"32056","WBGene00202468","X",7635669,7635814,145
"32057","WBGene00202470","X",11129664,11129810,146
"32058","WBGene00202476","IV",11176100,11176246,146
"32059","WBGene00202479","II",4907228,4907363,135
"32060","WBGene00202480","IV",11956477,11956647,170
"32061","WBGene00202481","X",4584729,4584846,117
"32062","WBGene00202482","X",3310675,3310819,144
"32063","WBGene00202483","II",4762715,4762968,253
"32064","WBGene00202484","X",6050834,6051154,320
"32065","WBGene00202486","X",13068541,13068743,202
"32066","WBGene00202487","III",4649454,4649602,148
"32067","WBGene00202488","V",8667319,8667456,137
"32068","WBGene00202490","V",8661541,8661788,247
"32069","WBGene00202493","X",4080643,4080786,143
"32070","WBGene00202494","I",111287,111436,149
"32071","WBGene00202496","V",4787466,4788400,934
"32072","WBGene00202497","V",4789123,4790045,922
"32073","WBGene00202498","V",4785095,4785433,338
"32074","WBGene00202499","V",8752055,8753066,1011
"32075","WBGene00202500","V",5729692,5730943,1251
"32076","WBGene00202501","V",6935553,6935863,310
"32077","WBGene00202502","V",2261019,2261847,828
"32078","WBGene00202504","V",16535472,16535884,412
"32079","WBGene00202511","V",9255778,9257519,1741
"32080","WBGene00202512","V",9058401,9059594,1193
"32081","WBGene00202513","II",9850310,9850826,516
"32082","WBGene00202514","V",15146387,15146861,474
"32083","WBGene00206354","II",10134945,10135829,884
"32084","WBGene00206355","II",8694427,8695814,1387
"32085","WBGene00206356","I",6214665,6215731,1066
"32086","WBGene00206357","I",5487376,5488241,865
"32087","WBGene00206358","V",6521097,6522034,937
"32088","WBGene00206359","V",758576,761259,2683
"32089","WBGene00206360","X",6188148,6189422,1274
"32090","WBGene00206361","X",4680979,4682716,1737
"32091","WBGene00206362","I",4661115,4662219,1104
"32092","WBGene00206363","I",5739503,5740301,798
"32093","WBGene00206364","X",4545703,4549948,4245
"32094","WBGene00206365","X",9172578,9173318,740
"32095","WBGene00206366","II",378651,380361,1710
"32096","WBGene00206368","II",674416,674935,519
"32097","WBGene00206369","V",16009456,16009750,294
"32098","WBGene00206370","V",14955021,14955774,753
"32099","WBGene00206371","II",5940863,5941660,797
"32100","WBGene00206372","II",3036187,3037757,1570
"32101","WBGene00206373","II",5056211,5058113,1902
"32102","WBGene00206374","II",3972262,3972757,495
"32103","WBGene00206375","IV",4880738,4880850,112
"32104","WBGene00206377","II",11771978,11774039,2061
"32105","WBGene00206378","X",1801456,1805087,3631
"32106","WBGene00206379","X",7191667,7191886,219
"32107","WBGene00206380","IV",7166783,7167930,1147
"32108","WBGene00206381","X",2565415,2565973,558
"32109","WBGene00206382","X",16397070,16398368,1298
"32110","WBGene00206383","V",10647775,10648005,230
"32111","WBGene00206384","X",1485906,1486185,279
"32112","WBGene00206385","II",3387143,3387603,460
"32113","WBGene00206386","X",6420074,6420781,707
"32114","WBGene00206388","X",6439702,6440564,862
"32115","WBGene00206389","X",13430245,13431488,1243
"32116","WBGene00206390","III",13030920,13031858,938
"32117","WBGene00206391","II",13771026,13771320,294
"32118","WBGene00206392","V",4294156,4296020,1864
"32119","WBGene00206393","I",11648796,11649015,219
"32120","WBGene00206394","II",12442595,12442781,186
"32121","WBGene00206395","II",9861946,9862247,301
"32122","WBGene00206411","V",809465,809832,367
"32123","WBGene00206412","II",6242096,6242523,427
"32124","WBGene00206413","II",2325256,2326245,989
"32125","WBGene00206414","II",4211425,4213335,1910
"32126","WBGene00206415","II",2033586,2034812,1226
"32127","WBGene00206416","II",606350,606735,385
"32128","WBGene00206417","II",607852,608310,458
"32129","WBGene00206418","V",19449738,19450914,1176
"32130","WBGene00206420","III",9408963,9409751,788
"32131","WBGene00206423","III",11694136,11695169,1033
"32132","WBGene00206459","III",7601470,7604324,2854
"32133","WBGene00206460","V",12624158,12624463,305
"32134","WBGene00206461","III",11232421,11234861,2440
"32135","WBGene00206462","V",15599171,15599731,560
"32136","WBGene00206464","I",10516036,10516432,396
"32137","WBGene00206466","X",11957563,11958395,832
"32138","WBGene00206469","IV",13189157,13193249,4092
"32139","WBGene00206470","IV",10879403,10880664,1261
"32140","WBGene00206471","V",10275402,10275646,244
"32141","WBGene00206473","IV",5490555,5491154,599
"32142","WBGene00206474","I",10594474,10595487,1013
"32143","WBGene00206475","X",7656401,7656975,574
"32144","WBGene00206478","X",640833,641563,730
"32145","WBGene00206479","II",12344834,12345286,452
"32146","WBGene00206481","II",9397812,9398500,688
"32147","WBGene00206482","X",9273738,9274671,933
"32148","WBGene00206483","X",9282142,9283086,944
"32149","WBGene00206484","X",5148175,5148891,716
"32150","WBGene00206485","X",7397646,7398035,389
"32151","WBGene00206486","III",2308256,2309744,1488
"32152","WBGene00206487","IV",283647,287212,3565
"32153","WBGene00206488","III",9877251,9881044,3793
"32154","WBGene00206489","V",13407222,13407929,707
"32155","WBGene00206490","IV",14802547,14802781,234
"32156","WBGene00206491","IV",15529206,15530144,938
"32157","WBGene00206492","V",18750163,18750691,528
"32158","WBGene00206493","IV",13459916,13460992,1076
"32159","WBGene00206494","V",14409094,14409889,795
"32160","WBGene00206495","V",17435678,17436592,914
"32161","WBGene00206496","V",18397323,18397888,565
"32162","WBGene00206497","I",11058524,11061435,2911
"32163","WBGene00206498","V",10812063,10812344,281
"32164","WBGene00206499","V",17893883,17894059,176
"32165","WBGene00206500","V",19306641,19307006,365
"32166","WBGene00206501","V",14289833,14290736,903
"32167","WBGene00206502","II",8715397,8715740,343
"32168","WBGene00206505","V",20456846,20457254,408
"32169","WBGene00206506","V",17686256,17686939,683
"32170","WBGene00206507","V",18280277,18280528,251
"32171","WBGene00206508","V",18425103,18425644,541
"32172","WBGene00206509","V",16933960,16934596,636
"32173","WBGene00206510","V",20134606,20135347,741
"32174","WBGene00206511","V",2626166,2630091,3925
"32175","WBGene00206512","III",1983749,1984960,1211
"32176","WBGene00206513","III",5743384,5744820,1436
"32177","WBGene00206514","II",6499119,6500261,1142
"32178","WBGene00206515","IV",8839663,8840261,598
"32179","WBGene00206516","V",15654424,15655237,813
"32180","WBGene00206517","II",4990102,4990613,511
"32181","WBGene00206518","II",1742835,1743792,957
"32182","WBGene00206519","II",1748378,1749943,1565
"32183","WBGene00206520","IV",12765504,12765886,382
"32184","WBGene00206521","II",7087361,7087875,514
"32185","WBGene00206522","II",3335422,3337139,1717
"32186","WBGene00206523","V",18802924,18803360,436
"32187","WBGene00206524","V",18801433,18802177,744
"32188","WBGene00206525","III",4189380,4190341,961
"32189","WBGene00206526","II",9376071,9376310,239
"32190","WBGene00206527","X",16055620,16056282,662
"32191","WBGene00206528","I",11213762,11214696,934
"32192","WBGene00206529","II",6852319,6853491,1172
"32193","WBGene00206530","I",11063360,11065373,2013
"32194","WBGene00206531","X",13411584,13412122,538
"32195","WBGene00206532","I",11686110,11686948,838
"32196","WBGene00206533","III",8218219,8219342,1123
"32197","WBGene00206534","V",16302254,16302551,297
"32198","WBGene00206535","V",19771523,19771724,201
"32199","WBGene00206536","V",18146965,18154396,7431
"32200","WBGene00206537","X",11627701,11628563,862
"32201","WBGene00206538","II",10717336,10719579,2243
"32202","WBGene00215616","X",11076989,11077435,446
"32203","WBGene00219205","II",10942527,10943417,890
"32204","WBGene00219207","IV",9103876,9104191,315
"32205","WBGene00219208","V",13131873,13133565,1692
"32206","WBGene00219209","V",10687901,10688563,662
"32207","WBGene00219210","V",18131667,18133232,1565
"32208","WBGene00219214","II",9782219,9782437,218
"32209","WBGene00219215","IV",10420863,10421187,324
"32210","WBGene00219216","IV",4155273,4157185,1912
"32211","WBGene00219217","IV",11159570,11160807,1237
"32212","WBGene00219218","IV",6341458,6342472,1014
"32213","WBGene00219219","I",2888448,2888557,109
"32214","WBGene00219220","III",6971976,6972085,109
"32215","WBGene00219221","IV",9757508,9757616,108
"32216","WBGene00219222","II",12346299,12346381,82
"32217","WBGene00219223","III",13728414,13728513,99
"32218","WBGene00219226","II",13461755,13461864,109
"32219","WBGene00219227","I",9512307,9512416,109
"32220","WBGene00219228","II",13182606,13182715,109
"32221","WBGene00219229","IV",9825312,9825421,109
"32222","WBGene00219231","I",11885596,11885705,109
"32223","WBGene00219232","II",12238602,12238711,109
"32224","WBGene00219233","V",18036732,18036841,109
"32225","WBGene00219234","I",10643029,10643724,695
"32226","WBGene00219235","V",4673650,4674597,947
"32227","WBGene00219236","V",4671030,4672610,1580
"32228","WBGene00219238","II",3629295,3630860,1565
"32229","WBGene00219239","II",1562163,1562875,712
"32230","WBGene00219241","IV",16842656,16842942,286
"32231","WBGene00219242","V",14369543,14369876,333
"32232","WBGene00219243","IV",13696058,13698690,2632
"32233","WBGene00219244","IV",16481233,16481735,502
"32234","WBGene00219245","X",1390847,1390964,117
"32235","WBGene00219246","II",6747182,6747242,60
"32236","WBGene00219247","X",1872466,1872526,60
"32237","WBGene00219248","X",1872952,1873008,56
"32238","WBGene00219250","X",1875738,1875794,56
"32239","WBGene00219252","IV",5668921,5669019,98
"32240","WBGene00219253","I",6185080,6185144,64
"32241","WBGene00219262","IV",2398652,2398761,109
"32242","WBGene00219264","III",3249151,3249260,109
"32243","WBGene00219265","IV",1381705,1381814,109
"32244","WBGene00219266","III",5785117,5785226,109
"32245","WBGene00219267","II",2284810,2284919,109
"32246","WBGene00219270","IV",409762,409872,110
"32247","WBGene00219271","II",1775547,1776350,803
"32248","WBGene00219272","II",5540984,5541822,838
"32249","WBGene00219274","X",17243357,17244762,1405
"32250","WBGene00219275","I",2322025,2322596,571
"32251","WBGene00219278","X",12604710,12605171,461
"32252","WBGene00219279","X",12602896,12603261,365
"32253","WBGene00219280","III",10012436,10013205,769
"32254","WBGene00219281","I",7121657,7122194,537
"32255","WBGene00219282","I",8616405,8616814,409
"32256","WBGene00219283","I",8863996,8865475,1479
"32257","WBGene00219284","I",9533802,9534310,508
"32258","WBGene00219285","I",9600445,9601015,570
"32259","WBGene00219286","I",9704870,9705420,550
"32260","WBGene00219287","I",11272480,11273477,997
"32261","WBGene00219288","I",13527366,13527963,597
"32262","WBGene00219289","II",8169573,8169862,289
"32263","WBGene00219290","II",9523170,9523534,364
"32264","WBGene00219291","II",9551836,9552393,557
"32265","WBGene00219292","II",9683110,9683830,720
"32266","WBGene00219293","II",11499643,11500464,821
"32267","WBGene00219294","II",11782195,11782579,384
"32268","WBGene00219295","III",3453300,3453932,632
"32269","WBGene00219296","III",3548294,3549004,710
"32270","WBGene00219297","III",4669921,4671591,1670
"32271","WBGene00219298","III",9513891,9514549,658
"32272","WBGene00219299","III",4161237,4161827,590
"32273","WBGene00219300","X",16247920,16250554,2634
"32274","WBGene00219301","X",11699572,11700357,785
"32275","WBGene00219302","V",19485319,19485873,554
"32276","WBGene00219303","X",16887140,16889262,2122
"32277","WBGene00219304","IV",3898478,3899806,1328
"32278","WBGene00219306","II",6268939,6269516,577
"32279","WBGene00219307","IV",3895963,3897997,2034
"32280","WBGene00219308","V",16648027,16648480,453
"32281","WBGene00219309","V",20564383,20564666,283
"32282","WBGene00219310","I",9410614,9411379,765
"32283","WBGene00219313","I",9414456,9416703,2247
"32284","WBGene00219314","III",9998542,9999335,793
"32285","WBGene00219315","II",2068354,2068971,617
"32286","WBGene00219316","V",15530783,15533251,2468
"32287","WBGene00219317","III",6969543,6970019,476
"32288","WBGene00219318","V",14708258,14708639,381
"32289","WBGene00219319","I",11305882,11307450,1568
"32290","WBGene00219321","II",1581194,1582440,1246
"32291","WBGene00219322","II",2169062,2169511,449
"32292","WBGene00219323","V",15436573,15436848,275
"32293","WBGene00219324","V",14324823,14325539,716
"32294","WBGene00219325","V",10967919,10970281,2362
"32295","WBGene00219326","V",16528935,16530213,1278
"32296","WBGene00219327","IV",11915767,11916126,359
"32297","WBGene00219329","III",8786354,8787128,774
"32298","WBGene00219330","V",12760348,12760969,621
"32299","WBGene00219331","IV",16206266,16206911,645
"32300","WBGene00219332","IV",17059283,17063800,4517
"32301","WBGene00219337","V",12951337,12952023,686
"32302","WBGene00219342","IV",14690937,14691733,796
"32303","WBGene00219343","V",18724748,18725759,1011
"32304","WBGene00219351","X",15828626,15829772,1146
"32305","WBGene00219352","X",15820053,15820465,412
"32306","WBGene00219362","X",4167459,4169791,2332
"32307","WBGene00219368","X",4362936,4363315,379
"32308","WBGene00219369","X",4367159,4367514,355
"32309","WBGene00219370","V",18434511,18435061,550
"32310","WBGene00219371","X",8521914,8522901,987
"32311","WBGene00219372","X",6980784,6983132,2348
"32312","WBGene00219373","X",6989675,6990994,1319
"32313","WBGene00219374","X",9119774,9123064,3290
"32314","WBGene00219375","X",8120410,8123220,2810
"32315","WBGene00219376","X",8847122,8848482,1360
"32316","WBGene00219377","IV",3996302,3996875,573
"32317","WBGene00219378","II",11802751,11803978,1227
"32318","WBGene00219381","V",17764831,17765177,346
"32319","WBGene00219383","V",17251911,17252309,398
"32320","WBGene00219395","IV",15112931,15113217,286
"32321","WBGene00219399","IV",1049607,1051685,2078
"32322","WBGene00219410","IV",3395881,3396552,671
"32323","WBGene00219411","X",3760949,3762547,1598
"32324","WBGene00219412","IV",6971128,6971313,185
"32325","WBGene00219413","IV",2317797,2318027,230
"32326","WBGene00219414","V",16059781,16060235,454
"32327","WBGene00219415","V",10276942,10277353,411
"32328","WBGene00219416","V",12351396,12351832,436
"32329","WBGene00219417","X",9631257,9633238,1981
"32330","WBGene00219418","IV",10021583,10021750,167
"32331","WBGene00219420","V",11146907,11147008,101
"32332","WBGene00219421","III",11609868,11611126,1258
"32333","WBGene00219422","I",11011435,11014274,2839
"32334","WBGene00219423","IV",2100240,2102893,2653
"32335","WBGene00219424","IV",2778141,2778571,430
"32336","WBGene00219425","IV",3000541,3008892,8351
"32337","WBGene00219434","II",11568654,11569242,588
"32338","WBGene00219436","IV",7920416,7922012,1596
"32339","WBGene00219437","IV",1163426,1164746,1320
"32340","WBGene00219442","IV",11164719,11165377,658
"32341","WBGene00219443","IV",14937510,14937793,283
"32342","WBGene00219444","IV",14996721,15000519,3798
"32343","WBGene00219445","V",17894785,17894985,200
"32344","WBGene00219446","V",17897546,17897746,200
"32345","WBGene00219447","V",17904129,17904329,200
"32346","WBGene00219448","V",11882456,11882750,294
"32347","WBGene00219449","V",6101904,6102581,677
"32348","WBGene00219450","I",8949567,8951670,2103
"32349","WBGene00219451","X",1978014,1980938,2924
"32350","WBGene00219452","V",19252181,19253054,873
"32351","WBGene00219453","IV",8845774,8846093,319
"32352","WBGene00219455","V",19491602,19491820,218
"32353","WBGene00219456","IV",11916879,11917365,486
"32354","WBGene00219458","IV",11500721,11502103,1382
"32355","WBGene00219460","I",3132974,3135233,2259
"32356","WBGene00219476","IV",8922150,8922900,750
"32357","WBGene00219477","V",16319026,16320470,1444
"32358","WBGene00219478","IV",16067170,16067445,275
"32359","WBGene00219483","V",19876279,19877978,1699
"32360","WBGene00219489","IV",11469620,11469748,128
"32361","WBGene00219490","IV",17220003,17220816,813
"32362","WBGene00219491","II",15129407,15130688,1281
"32363","WBGene00219492","II",15126574,15129014,2440
"32364","WBGene00219493","V",17530303,17530714,411
"32365","WBGene00219497","IV",4259737,4260391,654
"32366","WBGene00219498","I",10203437,10203743,306
"32367","WBGene00219544","X",9938813,9940042,1229
"32368","WBGene00219545","X",10301317,10301416,99
"32369","WBGene00219546","X",10303745,10304026,281
"32370","WBGene00219547","IV",16868812,16869000,188
"32371","WBGene00219548","IV",13230978,13231450,472
"32372","WBGene00219549","V",17664203,17665997,1794
"32373","WBGene00219551","IV",9875696,9875916,220
"32374","WBGene00219553","V",14043544,14045148,1604
"32375","WBGene00219554","IV",4060535,4062269,1734
"32376","WBGene00219555","II",12828636,12829352,716
"32377","WBGene00219557","I",12775554,12776532,978
"32378","WBGene00219558","II",13770843,13771616,773
"32379","WBGene00219559","X",14018610,14019376,766
"32380","WBGene00219561","X",12517114,12519034,1920
"32381","WBGene00219562","V",19420701,19420857,156
"32382","WBGene00219563","III",3633005,3635788,2783
"32383","WBGene00219564","X",14079397,14080037,640
"32384","WBGene00219565","II",8688171,8691915,3744
"32385","WBGene00219566","X",11563625,11563749,124
"32386","WBGene00219567","II",12352959,12355909,2950
"32387","WBGene00219568","III",3654944,3655233,289
"32388","WBGene00219569","III",3672048,3674245,2197
"32389","WBGene00219570","III",3664858,3667041,2183
"32390","WBGene00219571","X",11991484,11991933,449
"32391","WBGene00219572","V",10176233,10179264,3031
"32392","WBGene00219573","V",12439502,12440814,1312
"32393","WBGene00219574","X",14505700,14505868,168
"32394","WBGene00219575","IV",8959570,8960955,1385
"32395","WBGene00219577","IV",10235539,10236680,1141
"32396","WBGene00219578","I",7372296,7372529,233
"32397","WBGene00219579","X",13141635,13142031,396
"32398","WBGene00219580","I",12215538,12216323,785
"32399","WBGene00219581","I",9382458,9383548,1090
"32400","WBGene00219582","I",9375257,9375823,566
"32401","WBGene00219583","V",10951232,10951557,325
"32402","WBGene00219584","V",13753828,13754385,557
"32403","WBGene00219585","V",20596009,20596222,213
"32404","WBGene00219586","V",15565170,15566425,1255
"32405","WBGene00219587","X",11524986,11526635,1649
"32406","WBGene00219588","I",8974865,8975116,251
"32407","WBGene00219589","II",11170721,11176247,5526
"32408","WBGene00219590","II",8819812,8820154,342
"32409","WBGene00219591","I",7333035,7334533,1498
"32410","WBGene00219592","I",8865945,8866624,679
"32411","WBGene00219596","X",15831417,15833245,1828
"32412","WBGene00219597","IV",9700864,9701286,422
"32413","WBGene00219598","I",8503994,8505566,1572
"32414","WBGene00219599","III",13740732,13741023,291
"32415","WBGene00219600","X",15617415,15617830,415
"32416","WBGene00219601","III",10817263,10821245,3982
"32417","WBGene00219602","IV",11808730,11809673,943
"32418","WBGene00219603","IV",10809558,10810538,980
"32419","WBGene00219604","II",7884403,7884801,398
"32420","WBGene00219605","II",7836075,7841128,5053
"32421","WBGene00219606","II",7837826,7841485,3659
"32422","WBGene00219607","V",11238812,11239060,248
"32423","WBGene00219608","I",7952885,7953125,240
"32424","WBGene00219609","X",16002599,16003728,1129
"32425","WBGene00219610","II",9237181,9239151,1970
"32426","WBGene00219611","V",15443826,15444354,528
"32427","WBGene00219612","V",11641024,11643916,2892
"32428","WBGene00219613","V",11179318,11181719,2401
"32429","WBGene00219614","III",10718341,10719485,1144
"32430","WBGene00219615","III",10732273,10736681,4408
"32431","WBGene00219617","V",18725359,18725896,537
"32432","WBGene00219618","IV",14958931,14959349,418
"32433","WBGene00219619","III",11126863,11129355,2492
"32434","WBGene00219620","II",14218808,14220379,1571
"32435","WBGene00219621","I",11013400,11014203,803
"32436","WBGene00219624","V",18011580,18012103,523
"32437","WBGene00219625","V",18649942,18650327,385
"32438","WBGene00219626","IV",9060779,9063687,2908
"32439","WBGene00219627","IV",15522594,15524764,2170
"32440","WBGene00219628","III",12098751,12099477,726
"32441","WBGene00219629","III",12149562,12151118,1556
"32442","WBGene00219630","V",20142573,20142824,251
"32443","WBGene00219631","V",20192730,20193439,709
"32444","WBGene00219632","V",20217904,20219148,1244
"32445","WBGene00219636","V",19895684,19897795,2111
"32446","WBGene00219637","I",14027780,14028126,346
"32447","WBGene00219638","V",12810467,12810739,272
"32448","WBGene00219639","X",15745719,15746204,485
"32449","WBGene00219640","IV",12555610,12556053,443
"32450","WBGene00219641","II",11887765,11888180,415
"32451","WBGene00219642","II",10294092,10295693,1601
"32452","WBGene00219643","X",2243115,2243239,124
"32453","WBGene00219644","V",8766699,8767745,1046
"32454","WBGene00219645","X",737234,742376,5142
"32455","WBGene00219646","IV",3430310,3432470,2160
"32456","WBGene00219647","II",560597,560990,393
"32457","WBGene00219648","X",7398308,7398711,403
"32458","WBGene00219649","V",5994260,5994540,280
"32459","WBGene00219650","X",2822754,2823508,754
"32460","WBGene00219651","X",7947451,7947970,519
"32461","WBGene00219652","V",4759370,4760334,964
"32462","WBGene00219653","IV",5155938,5156839,901
"32463","WBGene00219654","I",5073579,5079303,5724
"32464","WBGene00219655","II",7287417,7287813,396
"32465","WBGene00219656","II",2166431,2170212,3781
"32466","WBGene00219657","II",4812847,4814228,1381
"32467","WBGene00219658","V",7007301,7007617,316
"32468","WBGene00219659","V",7854250,7854959,709
"32469","WBGene00219660","III",3150222,3151352,1130
"32470","WBGene00219661","III",3151809,3152607,798
"32471","WBGene00219662","IV",5737186,5738105,919
"32472","WBGene00219663","I",5046474,5046785,311
"32473","WBGene00219664","II",6993992,6994362,370
"32474","WBGene00219665","IV",2160278,2160857,579
"32475","WBGene00219666","V",8152035,8154464,2429
"32476","WBGene00219667","II",2615725,2616219,494
"32477","WBGene00219669","III",2439873,2440783,910
"32478","WBGene00219670","III",2439940,2440819,879
"32479","WBGene00219671","IV",4977096,4977288,192
"32480","WBGene00219672","II",5329561,5331221,1660
"32481","WBGene00219673","V",5425185,5427031,1846
"32482","WBGene00219674","II",5765041,5765401,360
"32483","WBGene00219675","II",5781921,5782113,192
"32484","WBGene00219676","X",17421887,17422340,453
"32485","WBGene00219677","X",17697239,17697346,107
"32486","WBGene00219678","I",3703542,3704956,1414
"32487","WBGene00219679","II",6099410,6099849,439
"32488","WBGene00219680","II",6927637,6927825,188
"32489","WBGene00219681","V",5685230,5685651,421
"32490","WBGene00219682","IV",5582041,5582262,221
"32491","WBGene00219683","V",6003575,6006746,3171
"32492","WBGene00219684","IV",4238173,4238408,235
"32493","WBGene00219685","X",1791722,1792573,851
"32494","WBGene00219686","II",7238948,7242909,3961
"32495","WBGene00219687","II",2681408,2681658,250
"32496","WBGene00219688","IV",4242086,4242466,380
"32497","WBGene00219689","IV",4241224,4241765,541
"32498","WBGene00219690","II",3313083,3313507,424
"32499","WBGene00219691","X",16905584,16906010,426
"32500","WBGene00219692","I",2644965,2645309,344
"32501","WBGene00219693","X",16822383,16823391,1008
"32502","WBGene00219694","IV",5380408,5381217,809
"32503","WBGene00219695","IV",8628327,8629553,1226
"32504","WBGene00219696","II",2421070,2423075,2005
"32505","WBGene00219697","II",7371784,7372735,951
"32506","WBGene00219698","V",5789946,5790325,379
"32507","WBGene00219699","X",9069138,9073735,4597
"32508","WBGene00219700","X",1982710,1982883,173
"32509","WBGene00219701","III",8787415,8789578,2163
"32510","WBGene00219702","II",6615646,6617232,1586
"32511","WBGene00219703","I",5356232,5356728,496
"32512","WBGene00219704","II",5459265,5459761,496
"32513","WBGene00219705","I",6136720,6136927,207
"32514","WBGene00219706","IV",3450370,3450735,365
"32515","WBGene00219707","II",2501838,2503802,1964
"32516","WBGene00219708","II",1071507,1071839,332
"32517","WBGene00219709","III",832984,833347,363
"32518","WBGene00219710","I",3410345,3411465,1120
"32519","WBGene00219711","X",1531977,1535983,4006
"32520","WBGene00219712","I",3122011,3127661,5650
"32521","WBGene00219713","II",6369727,6369877,150
"32522","WBGene00219714","V",3012695,3013087,392
"32523","WBGene00219715","IV",3805237,3806561,1324
"32524","WBGene00219716","X",8753852,8754217,365
"32525","WBGene00219717","V",5949200,5949388,188
"32526","WBGene00219718","III",2936109,2937002,893
"32527","WBGene00219719","III",7543476,7545064,1588
"32528","WBGene00219720","III",5024881,5025007,126
"32529","WBGene00219721","I",4467346,4467684,338
"32530","WBGene00219722","X",2326744,2329092,2348
"32531","WBGene00219723","IV",8453296,8457035,3739
"32532","WBGene00219724","X",16775220,16775505,285
"32533","WBGene00219725","I",3870642,3871267,625
"32534","WBGene00219726","III",7612108,7613428,1320
"32535","WBGene00219727","I",4683182,4683865,683
"32536","WBGene00219728","II",1820242,1820946,704
"32537","WBGene00219729","IV",8231731,8235014,3283
"32538","WBGene00219730","V",1863875,1863990,115
"32539","WBGene00219731","II",5236029,5236342,313
"32540","WBGene00219732","X",3952660,3954347,1687
"32541","WBGene00219733","I",6860395,6861997,1602
"32542","WBGene00219734","V",1150906,1153207,2301
"32543","WBGene00219735","X",2369181,2370544,1363
"32544","WBGene00219736","X",16508081,16509294,1213
"32545","WBGene00219737","X",17240348,17242413,2065
"32546","WBGene00219738","III",6451048,6451567,519
"32547","WBGene00219739","V",3717700,3723734,6034
"32548","WBGene00219740","V",7085069,7085609,540
"32549","WBGene00219741","IV",4059931,4061723,1792
"32550","WBGene00219742","II",607407,607773,366
"32551","WBGene00219743","X",6256778,6258976,2198
"32552","WBGene00219744","II",4059052,4059523,471
"32553","WBGene00219745","III",352222,355402,3180
"32554","WBGene00219746","I",4699610,4702866,3256
"32555","WBGene00219748","II",1990692,1991487,795
"32556","WBGene00219749","I",2046539,2048913,2374
"32557","WBGene00219750","IV",160164,161663,1499
"32558","WBGene00219751","X",1995743,1996672,929
"32559","WBGene00219752","IV",1629779,1629987,208
"32560","WBGene00219753","II",15257371,15259799,2428
"32561","WBGene00219754","I",4295024,4296741,1717
"32562","WBGene00219755","II",3596226,3596812,586
"32563","WBGene00219756","II",3597516,3597914,398
"32564","WBGene00219757","II",3509948,3510110,162
"32565","WBGene00219758","II",3373169,3374185,1016
"32566","WBGene00219759","V",1197814,1198060,246
"32567","WBGene00219760","I",1916942,1917064,122
"32568","WBGene00219761","III",3035541,3037543,2002
"32569","WBGene00219762","IV",1033999,1035986,1987
"32570","WBGene00219763","IV",735162,735704,542
"32571","WBGene00219764","IV",3201459,3203707,2248
"32572","WBGene00219765","III",7402234,7406071,3837
"32573","WBGene00219766","I",1822401,1823043,642
"32574","WBGene00219767","I",1696199,1697676,1477
"32575","WBGene00219768","V",3184083,3185004,921
"32576","WBGene00219769","X",1765233,1765806,573
"32577","WBGene00219770","III",1325891,1327724,1833
"32578","WBGene00219771","III",1370495,1371568,1073
"32579","WBGene00219772","III",1294930,1298375,3445
"32580","WBGene00219773","V",410589,410930,341
"32581","WBGene00219774","II",11030631,11031500,869
"32582","WBGene00219775","II",11032203,11033177,974
"32583","WBGene00219776","X",2243483,2243586,103
"32584","WBGene00219777","V",14130595,14130674,79
"32585","WBGene00219779","I",6024143,6024233,90
"32586","WBGene00219780","II",7745690,7745852,162
"32587","WBGene00219781","V",11738712,11738801,89
"32588","WBGene00219782","V",20480009,20480133,124
"32589","WBGene00219783","III",4357715,4357818,103
"32590","WBGene00219784","V",39259,39364,105
"32591","WBGene00219785","IV",5981716,5981795,79
"32592","WBGene00219786","V",13130359,13130478,119
"32593","WBGene00219787","I",10092662,10092778,116
"32594","WBGene00219788","I",10103538,10103626,88
"32595","WBGene00219790","III",1918532,1918708,176
"32596","WBGene00219791","IV",6645512,6645749,237
"32597","WBGene00219792","IV",6648692,6648891,199
"32598","WBGene00219793","IV",9096629,9096716,87
"32599","WBGene00219794","X",15552397,15552487,90
"32600","WBGene00219795","III",8227863,8228045,182
"32601","WBGene00219796","I",9658731,9659037,306
"32602","WBGene00219797","II",6843240,6843363,123
"32603","WBGene00219798","I",9703077,9703323,246
"32604","WBGene00219799","X",10840284,10840374,90
"32605","WBGene00219800","X",1107079,1107207,128
"32606","WBGene00219801","V",728231,728328,97
"32607","WBGene00219803","II",10574651,10574840,189
"32608","WBGene00219804","IV",5832891,5833059,168
"32609","WBGene00219805","X",4524046,4524172,126
"32610","WBGene00219807","III",7491789,7491871,82
"32611","WBGene00219809","II",11106181,11106342,161
"32612","WBGene00219810","X",14324406,14324470,64
"32613","WBGene00219811","I",9332534,9332649,115
"32614","WBGene00219813","X",2791417,2791555,138
"32615","WBGene00219814","X",2795029,2795096,67
"32616","WBGene00219815","III",8101226,8101315,89
"32617","WBGene00219816","X",1831628,1831762,134
"32618","WBGene00219817","I",7391591,7391692,101
"32619","WBGene00219818","II",6991969,6992213,244
"32620","WBGene00219819","II",9136235,9136366,131
"32621","WBGene00219820","I",11595127,11595198,71
"32622","WBGene00219822","IV",6792974,6793200,226
"32623","WBGene00219823","II",5705155,5705274,119
"32624","WBGene00219824","V",5576222,5576373,151
"32625","WBGene00219825","II",10065831,10065983,152
"32626","WBGene00219826","II",6691986,6692079,93
"32627","WBGene00219827","III",6186625,6186821,196
"32628","WBGene00219828","III",698712,698824,112
"32629","WBGene00219829","V",5504965,5505047,82
"32630","WBGene00219830","I",4078904,4079024,120
"32631","WBGene00219832","IV",8043909,8044010,101
"32632","WBGene00219833","I",7500236,7500327,91
"32633","WBGene00219834","I",7518822,7519001,179
"32634","WBGene00219835","I",7519240,7519339,99
"32635","WBGene00219836","X",14653468,14653655,187
"32636","WBGene00219837","IV",9725532,9725758,226
"32637","WBGene00219838","III",5916268,5916938,670
"32638","WBGene00219839","II",6303261,6303345,84
"32639","WBGene00219840","III",115429,115559,130
"32640","WBGene00219841","III",8447043,8447095,52
"32641","WBGene00219842","III",8467709,8467998,289
"32642","WBGene00219844","II",7264656,7264738,82
"32643","WBGene00219845","I",5825720,5825888,168
"32644","WBGene00219846","X",17270627,17270798,171
"32645","WBGene00219847","X",11792115,11792284,169
"32646","WBGene00219848","X",11216346,11216479,133
"32647","WBGene00219849","X",1681752,1681886,134
"32648","WBGene00219850","III",4004435,4004617,182
"32649","WBGene00219851","V",7854865,7854964,99
"32650","WBGene00219852","II",8130695,8130981,286
"32651","WBGene00219857","I",3105031,3105218,187
"32652","WBGene00219859","X",11992067,11992190,123
"32653","WBGene00219860","V",12303599,12303693,94
"32654","WBGene00219861","IV",17166375,17166458,83
"32655","WBGene00219862","X",12805203,12805316,113
"32656","WBGene00219863","I",8010207,8010366,159
"32657","WBGene00219864","III",6358898,6359005,107
"32658","WBGene00219865","III",6360219,6360385,166
"32659","WBGene00219868","X",8546076,8546204,128
"32660","WBGene00219869","V",11800960,11801200,240
"32661","WBGene00219871","I",4138208,4138333,125
"32662","WBGene00219872","II",7195414,7195475,61
"32663","WBGene00219873","II",5420273,5420360,87
"32664","WBGene00219874","IV",10464386,10464483,97
"32665","WBGene00219875","X",6989876,6989944,68
"32666","WBGene00219876","X",16371115,16371212,97
"32667","WBGene00219878","X",697958,698071,113
"32668","WBGene00219879","II",11620025,11620295,270
"32669","WBGene00219881","II",5335930,5335986,56
"32670","WBGene00219882","I",6768385,6768545,160
"32671","WBGene00219883","X",10142440,10142512,72
"32672","WBGene00219884","X",1491155,1491238,83
"32673","WBGene00219885","X",1504884,1504998,114
"32674","WBGene00219886","X",1506302,1506390,88
"32675","WBGene00219887","X",1509050,1509119,69
"32676","WBGene00219888","V",7196237,7196580,343
"32677","WBGene00219890","II",5487297,5487488,191
"32678","WBGene00219891","IV",11580794,11580987,193
"32679","WBGene00219892","X",10502130,10502235,105
"32680","WBGene00219893","X",4410243,4410419,176
"32681","WBGene00219894","I",9375847,9375990,143
"32682","WBGene00219895","I",9381717,9381833,116
"32683","WBGene00219896","X",12723757,12723847,90
"32684","WBGene00219897","X",12725211,12725353,142
"32685","WBGene00219898","III",4740851,4740927,76
"32686","WBGene00219899","V",10940466,10940629,163
"32687","WBGene00219901","II",7677322,7677491,169
"32688","WBGene00219902","II",6548700,6548890,190
"32689","WBGene00219903","X",13529585,13529649,64
"32690","WBGene00219904","X",9992962,9993067,105
"32691","WBGene00219905","V",7567999,7568131,132
"32692","WBGene00219906","X",1422020,1422344,324
"32693","WBGene00219907","II",14606034,14606129,95
"32694","WBGene00219908","IV",8752805,8752860,55
"32695","WBGene00219909","IV",7948012,7948171,159
"32696","WBGene00219910","I",14924360,14924453,93
"32697","WBGene00219911","I",14929757,14930015,258
"32698","WBGene00219912","X",16698131,16698298,167
"32699","WBGene00219913","V",14453199,14453276,77
"32700","WBGene00219914","V",8545100,8545205,105
"32701","WBGene00219915","X",7630545,7630635,90
"32702","WBGene00219916","IV",17278413,17278502,89
"32703","WBGene00219917","IV",17280046,17280169,123
"32704","WBGene00219918","I",5453364,5453478,114
"32705","WBGene00219919","I",7715956,7716041,85
"32706","WBGene00219920","I",7731356,7731446,90
"32707","WBGene00219921","V",17068622,17068692,70
"32708","WBGene00219922","X",538341,538457,116
"32709","WBGene00219923","I",11198966,11199146,180
"32710","WBGene00219926","I",9500624,9500823,199
"32711","WBGene00219929","I",11519974,11520102,128
"32712","WBGene00219930","I",2666384,2666468,84
"32713","WBGene00219932","V",318954,319050,96
"32714","WBGene00219933","II",4605583,4605672,89
"32715","WBGene00219934","IV",4027728,4027811,83
"32716","WBGene00219935","IV",11026131,11026219,88
"32717","WBGene00219936","III",3953250,3953401,151
"32718","WBGene00219937","I",1444507,1444641,134
"32719","WBGene00219938","V",11532129,11532230,101
"32720","WBGene00219939","IV",11854322,11854409,87
"32721","WBGene00219940","I",14759178,14759412,234
"32722","WBGene00219941","IV",11593653,11593740,87
"32723","WBGene00219942","III",6066328,6066443,115
"32724","WBGene00219943","I",12276742,12276807,65
"32725","WBGene00219945","II",9356152,9356295,143
"32726","WBGene00219947","V",9293333,9293632,299
"32727","WBGene00219949","II",11756785,11756919,134
"32728","WBGene00219950","I",11237817,11237980,163
"32729","WBGene00219951","I",9442684,9442798,114
"32730","WBGene00219952","X",4507523,4507580,57
"32731","WBGene00219953","I",3956075,3956137,62
"32732","WBGene00219955","I",6582791,6582913,122
"32733","WBGene00219957","V",20439633,20439759,126
"32734","WBGene00219958","X",1092307,1092436,129
"32735","WBGene00219959","X",1982844,1982935,91
"32736","WBGene00219960","X",11623506,11623598,92
"32737","WBGene00219961","V",8420602,8420682,80
"32738","WBGene00219962","X",16274288,16274342,54
"32739","WBGene00219963","X",16284790,16284864,74
"32740","WBGene00219964","X",16943323,16943517,194
"32741","WBGene00219966","V",2794316,2794365,49
"32742","WBGene00219967","X",14609606,14609679,73
"32743","WBGene00219968","III",8797173,8797340,167
"32744","WBGene00219969","II",13521301,13521471,170
"32745","WBGene00219970","III",13058378,13058486,108
"32746","WBGene00219971","X",2634102,2634223,121
"32747","WBGene00219972","I",10781278,10781400,122
"32748","WBGene00219974","X",2772193,2772304,111
"32749","WBGene00219975","X",13768692,13768807,115
"32750","WBGene00219976","I",8866808,8866973,165
"32751","WBGene00219977","III",13276960,13277074,114
"32752","WBGene00219978","IV",564193,564285,92
"32753","WBGene00219979","V",14359109,14359253,144
"32754","WBGene00219980","II",5469257,5469308,51
"32755","WBGene00219981","X",12157202,12157263,61
"32756","WBGene00219982","V",10929162,10929233,71
"32757","WBGene00219986","III",3416505,3416601,96
"32758","WBGene00219987","I",10516874,10516950,76
"32759","WBGene00219988","II",5912215,5912317,102
"32760","WBGene00219990","X",12512868,12512926,58
"32761","WBGene00219992","V",9453282,9453376,94
"32762","WBGene00219994","IV",6775982,6776047,65
"32763","WBGene00219995","X",12642648,12642787,139
"32764","WBGene00219997","X",8230503,8230562,59
"32765","WBGene00219998","I",9751182,9751336,154
"32766","WBGene00220000","I",6835506,6835631,125
"32767","WBGene00220001","III",833435,833609,174
"32768","WBGene00220002","II",2556628,2556798,170
"32769","WBGene00220004","I",3415825,3415924,99
"32770","WBGene00220005","IV",10176491,10176675,184
"32771","WBGene00220006","I",6351172,6351260,88
"32772","WBGene00220007","V",9490335,9490467,132
"32773","WBGene00220008","V",10350780,10350912,132
"32774","WBGene00220009","II",4550211,4550428,217
"32775","WBGene00220011","X",16564730,16564828,98
"32776","WBGene00220012","IV",4705843,4705967,124
"32777","WBGene00220013","IV",12304806,12304931,125
"32778","WBGene00220014","X",7720932,7721071,139
"32779","WBGene00220017","III",5180665,5180841,176
"32780","WBGene00220019","I",7139060,7139384,324
"32781","WBGene00220020","III",385365,385438,73
"32782","WBGene00220021","II",3957203,3957372,169
"32783","WBGene00220024","III",10821681,10821813,132
"32784","WBGene00220026","II",1050590,1050702,112
"32785","WBGene00220028","X",6808710,6808911,201
"32786","WBGene00220029","IV",6117751,6117876,125
"32787","WBGene00220030","X",4972019,4972123,104
"32788","WBGene00220031","IV",477757,477838,81
"32789","WBGene00220032","IV",11083147,11083243,96
"32790","WBGene00220033","IV",12112937,12113057,120
"32791","WBGene00220034","IV",3521958,3522027,69
"32792","WBGene00220035","X",8233476,8233595,119
"32793","WBGene00220037","II",7623528,7623698,170
"32794","WBGene00220039","I",6412870,6413067,197
"32795","WBGene00220041","I",7859940,7860105,165
"32796","WBGene00220042","IV",4769344,4769440,96
"32797","WBGene00220043","II",6047894,6048055,161
"32798","WBGene00220044","III",3820206,3820273,67
"32799","WBGene00220045","V",11917089,11917242,153
"32800","WBGene00220046","V",11921548,11921671,123
"32801","WBGene00220047","III",4190497,4190640,143
"32802","WBGene00220051","X",4394470,4394643,173
"32803","WBGene00220052","II",10555251,10555371,120
"32804","WBGene00220053","II",10557565,10557644,79
"32805","WBGene00220054","I",4494681,4494760,79
"32806","WBGene00220055","X",2329038,2329103,65
"32807","WBGene00220056","V",5630354,5630510,156
"32808","WBGene00220057","III",5996803,5996854,51
"32809","WBGene00220058","II",7827866,7828074,208
"32810","WBGene00220059","V",9619692,9619780,88
"32811","WBGene00220060","II",873652,873780,128
"32812","WBGene00220061","II",8877143,8877260,117
"32813","WBGene00220064","I",6153645,6153753,108
"32814","WBGene00220065","I",6176802,6176928,126
"32815","WBGene00220066","X",9754602,9754743,141
"32816","WBGene00220068","III",13632988,13633067,79
"32817","WBGene00220069","I",263502,263618,116
"32818","WBGene00220070","X",2214806,2214991,185
"32819","WBGene00220071","II",9622415,9622695,280
"32820","WBGene00220072","III",623810,623915,105
"32821","WBGene00220073","IV",5664715,5664938,223
"32822","WBGene00220074","III",7387621,7387711,90
"32823","WBGene00220075","II",12519086,12519217,131
"32824","WBGene00220076","II",12524827,12524900,73
"32825","WBGene00220078","X",16721943,16722113,170
"32826","WBGene00220079","X",13881792,13881882,90
"32827","WBGene00220080","X",13888362,13888541,179
"32828","WBGene00220081","I",7968753,7968828,75
"32829","WBGene00220082","II",8637943,8638084,141
"32830","WBGene00220083","V",8466468,8466556,88
"32831","WBGene00220084","V",8484761,8484823,62
"32832","WBGene00220087","I",9994307,9994475,168
"32833","WBGene00220088","III",4657812,4657934,122
"32834","WBGene00220090","II",9060731,9060812,81
"32835","WBGene00220091","II",9072478,9072560,82
"32836","WBGene00220092","II",9124971,9125239,268
"32837","WBGene00220093","X",11484493,11484600,107
"32838","WBGene00220094","X",11484826,11484924,98
"32839","WBGene00220095","II",161614,161771,157
"32840","WBGene00220096","II",6397946,6398144,198
"32841","WBGene00220097","X",17217724,17217823,99
"32842","WBGene00220098","X",1856473,1856529,56
"32843","WBGene00220099","V",11433182,11433417,235
"32844","WBGene00220100","I",6105759,6105820,61
"32845","WBGene00220101","X",16057374,16057539,165
"32846","WBGene00220102","V",3709273,3709376,103
"32847","WBGene00220105","III",13476587,13476800,213
"32848","WBGene00220106","I",8135840,8135955,115
"32849","WBGene00220107","V",6484968,6485061,93
"32850","WBGene00220108","II",14804795,14804876,81
"32851","WBGene00220111","X",4222324,4222465,141
"32852","WBGene00220112","I",11088202,11088273,71
"32853","WBGene00220113","IV",4019990,4020060,70
"32854","WBGene00220114","V",2639491,2639595,104
"32855","WBGene00220117","IV",4347632,4347831,199
"32856","WBGene00220118","I",2822737,2822836,99
"32857","WBGene00220119","III",5837716,5837829,113
"32858","WBGene00220120","III",50558,50682,124
"32859","WBGene00220121","V",14832594,14832711,117
"32860","WBGene00220122","V",17715785,17715983,198
"32861","WBGene00220123","V",6224746,6224801,55
"32862","WBGene00220125","II",13946946,13947079,133
"32863","WBGene00220126","I",2826883,2827073,190
"32864","WBGene00220127","I",9106600,9106697,97
"32865","WBGene00220128","I",13730032,13730144,112
"32866","WBGene00220129","IV",16428729,16428854,125
"32867","WBGene00220132","IV",9277659,9277758,99
"32868","WBGene00220133","II",3990985,3992043,1058
"32869","WBGene00220134","II",12041957,12042146,189
"32870","WBGene00220135","I",12824119,12824172,53
"32871","WBGene00220136","I",2019432,2019523,91
"32872","WBGene00220138","V",10473551,10473649,98
"32873","WBGene00220139","V",1889910,1889998,88
"32874","WBGene00220140","III",1024809,1024901,92
"32875","WBGene00220142","I",10858078,10858150,72
"32876","WBGene00220143","II",12617507,12617636,129
"32877","WBGene00220144","III",10658232,10658368,136
"32878","WBGene00220145","III",1861964,1862105,141
"32879","WBGene00220146","X",1993449,1993562,113
"32880","WBGene00220147","I",13370685,13370819,134
"32881","WBGene00220148","I",13438492,13438592,100
"32882","WBGene00220149","IV",15188019,15188094,75
"32883","WBGene00220150","III",11674955,11675007,52
"32884","WBGene00220154","IV",1651899,1651954,55
"32885","WBGene00220155","IV",1669842,1669974,132
"32886","WBGene00220157","IV",15029447,15029597,150
"32887","WBGene00220158","X",2990127,2990228,101
"32888","WBGene00220159","V",20711151,20711279,128
"32889","WBGene00220160","V",20713251,20713345,94
"32890","WBGene00220163","III",11238451,11238559,108
"32891","WBGene00220164","III",11454262,11454506,244
"32892","WBGene00220165","I",3472658,3472776,118
"32893","WBGene00220166","I",3503718,3503822,104
"32894","WBGene00220167","I",3524904,3525115,211
"32895","WBGene00220168","III",11118361,11118484,123
"32896","WBGene00220170","II",13369057,13369157,100
"32897","WBGene00220171","I",13470748,13470891,143
"32898","WBGene00220172","III",12368319,12368544,225
"32899","WBGene00220173","V",982811,982906,95
"32900","WBGene00220174","V",18606497,18606591,94
"32901","WBGene00220175","IV",16492572,16492795,223
"32902","WBGene00220176","IV",16592791,16592943,152
"32903","WBGene00220177","II",1509287,1509358,71
"32904","WBGene00220179","I",3249391,3249478,87
"32905","WBGene00220183","IV",828004,828129,125
"32906","WBGene00220185","IV",14780839,14780933,94
"32907","WBGene00220186","IV",14875170,14875262,92
"32908","WBGene00220187","II",11537527,11537629,102
"32909","WBGene00220191","I",539086,539242,156
"32910","WBGene00220192","IV",373521,373603,82
"32911","WBGene00220193","III",1553423,1553520,97
"32912","WBGene00220194","IV",10976009,10976074,65
"32913","WBGene00220195","I",2888585,2888707,122
"32914","WBGene00220196","IV",2193994,2194122,128
"32915","WBGene00220198","I",1791398,1791491,93
"32916","WBGene00220200","III",2599058,2599168,110
"32917","WBGene00220201","X",47179,47506,327
"32918","WBGene00220203","IV",6664399,6664555,156
"32919","WBGene00220204","IV",6751615,6751707,92
"32920","WBGene00220205","IV",15234446,15234620,174
"32921","WBGene00220206","V",1326450,1326538,88
"32922","WBGene00220207","III",12123200,12123256,56
"32923","WBGene00220209","X",1744604,1744678,74
"32924","WBGene00220210","III",13534567,13534637,70
"32925","WBGene00220212","I",5918270,5918445,175
"32926","WBGene00220213","IV",1465620,1465713,93
"32927","WBGene00220214","III",12018804,12018872,68
"32928","WBGene00220215","III",1069058,1069313,255
"32929","WBGene00220216","IV",2713893,2713953,60
"32930","WBGene00220217","I",906339,906481,142
"32931","WBGene00220218","V",17135165,17135239,74
"32932","WBGene00220219","X",2046485,2046638,153
"32933","WBGene00220220","X",2047031,2047238,207
"32934","WBGene00220221","IV",15567251,15567339,88
"32935","WBGene00220222","IV",15649207,15649360,153
"32936","WBGene00220223","IV",15853103,15853207,104
"32937","WBGene00220224","IV",16022500,16022632,132
"32938","WBGene00220226","I",14662960,14663056,96
"32939","WBGene00220227","II",2895367,2895466,99
"32940","WBGene00220232","I",14029279,14029364,85
"32941","WBGene00220233","III",5267193,5267314,121
"32942","WBGene00220234","IV",9079210,9079459,249
"32943","WBGene00220235","V",14851142,14851238,96
"32944","WBGene00220236","II",11635225,11635327,102
"32945","WBGene00220237","II",11641913,11642044,131
"32946","WBGene00220238","IV",4538702,4538916,214
"32947","WBGene00220239","V",17115526,17115629,103
"32948","WBGene00220240","I",14893830,14893934,104
"32949","WBGene00220241","I",14906270,14906399,129
"32950","WBGene00220243","I",6092686,6092811,125
"32951","WBGene00220244","III",9815506,9815625,119
"32952","WBGene00220246","I",9122524,9122693,169
"32953","WBGene00220247","II",9992257,9992337,80
"32954","WBGene00220248","II",11890454,11890696,242
"32955","WBGene00220249","III",5029912,5030274,362
"32956","WBGene00220250","IV",5021188,5025746,4558
"32957","WBGene00220251","IV",12797146,12798805,1659
"32958","WBGene00220252","IV",10505286,10506344,1058
"32959","WBGene00220253","V",10695481,10695612,131
"32960","WBGene00220254","IV",15752484,15752707,223
"32961","WBGene00220256","V",19029253,19033214,3961
"32962","WBGene00220257","V",7386675,7387855,1180
"32963","WBGene00220258","III",8190805,8191275,470
"32964","WBGene00220259","III",7074250,7076349,2099
"32965","WBGene00220260","IV",16156908,16165267,8359
"32966","WBGene00220261","I",10333471,10334590,1119
"32967","WBGene00235003","V",20590604,20593025,2421
"32968","WBGene00235086","V",11053373,11053698,325
"32969","WBGene00235087","II",431492,431554,62
"32970","WBGene00235088","II",438399,438461,62
"32971","WBGene00235089","V",20634183,20634387,204
"32972","WBGene00235090","V",17573208,17574227,1019
"32973","WBGene00235091","V",16451976,16452316,340
"32974","WBGene00235092","V",7527455,7527955,500
"32975","WBGene00235093","V",7526000,7526360,360
"32976","WBGene00235094","V",3236444,3236726,282
"32977","WBGene00235095","IV",11327356,11327569,213
"32978","WBGene00235102","IV",2890888,2891636,748
"32979","WBGene00235106","V",14471159,14471791,632
"32980","WBGene00235107","IV",15096097,15096299,202
"32981","WBGene00235109","IV",14492028,14492774,746
"32982","WBGene00235110","X",3756967,3758439,1472
"32983","WBGene00235111","IV",12463865,12463996,131
"32984","WBGene00235113","V",7714972,7716090,1118
"32985","WBGene00235114","V",7712239,7713168,929
"32986","WBGene00235115","IV",3993884,3994418,534
"32987","WBGene00235116","V",7356024,7356784,760
"32988","WBGene00235117","V",2298945,2301005,2060
"32989","WBGene00235118","V",6558766,6559220,454
"32990","WBGene00235119","IV",4635451,4635961,510
"32991","WBGene00235120","IV",4636301,4636970,669
"32992","WBGene00235121","IV",14446555,14447620,1065
"32993","WBGene00235128","IV",13164319,13164678,359
"32994","WBGene00235129","IV",12361764,12361908,144
"32995","WBGene00235132","IV",11693793,11693927,134
"32996","WBGene00235133","V",15449165,15449601,436
"32997","WBGene00235134","IV",11199330,11199790,460
"32998","WBGene00235152","X",15821008,15821690,682
"32999","WBGene00235153","X",15823406,15824092,686
"33000","WBGene00235157","V",20816257,20816439,182
"33001","WBGene00235158","I",2149823,2151826,2003
"33002","WBGene00235159","V",5588079,5588177,98
"33003","WBGene00235160","V",5587285,5587418,133
"33004","WBGene00235161","V",5586955,5587086,131
"33005","WBGene00235163","V",172813,173163,350
"33006","WBGene00235164","II",2289560,2290301,741
"33007","WBGene00235165","V",4416022,4416814,792
"33008","WBGene00235167","IV",12319457,12319627,170
"33009","WBGene00235179","V",4354440,4354541,101
"33010","WBGene00235180","X",17018509,17018612,103
"33011","WBGene00235181","V",13734042,13734156,114
"33012","WBGene00235183","IV",4239760,4239861,101
"33013","WBGene00235190","III",400386,400538,152
"33014","WBGene00235197","I",6169084,6169195,111
"33015","WBGene00235201","V",17418693,17418780,87
"33016","WBGene00235206","II",13942499,13942647,148
"33017","WBGene00235235","X",1891509,1891629,120
"33018","WBGene00235247","IV",4930954,4931055,101
"33019","WBGene00235250","X",8838602,8838687,85
"33020","WBGene00235251","X",13713639,13713727,88
"33021","WBGene00235252","IV",6470291,6470372,81
"33022","WBGene00235254","I",10936329,10936705,376
"33023","WBGene00235255","II",14501123,14501455,332
"33024","WBGene00235256","II",14256610,14256987,377
"33025","WBGene00235257","IV",53401,53631,230
"33026","WBGene00235258","IV",57981,58395,414
"33027","WBGene00235259","IV",64400,66128,1728
"33028","WBGene00235260","IV",61748,65984,4236
"33029","WBGene00235261","IV",76370,76531,161
"33030","WBGene00235262","IV",79276,79380,104
"33031","WBGene00235263","IV",451118,454916,3798
"33032","WBGene00235264","IV",455073,455401,328
"33033","WBGene00235265","IV",503015,503470,455
"33034","WBGene00235266","IV",1427569,1429063,1494
"33035","WBGene00235267","IV",1429041,1430367,1326
"33036","WBGene00235268","IV",2809410,2812848,3438
"33037","WBGene00235269","II",5626316,5627263,947
"33038","WBGene00235270","II",5626433,5630943,4510
"33039","WBGene00235271","IV",8652135,8652868,733
"33040","WBGene00235272","IV",7063324,7064644,1320
"33041","WBGene00235273","IV",5480607,5482297,1690
"33042","WBGene00235274","IV",2138251,2140631,2380
"33043","WBGene00235275","IV",8241545,8243699,2154
"33044","WBGene00235276","IV",8393459,8394201,742
"33045","WBGene00235277","IV",2216636,2216861,225
"33046","WBGene00235278","IV",4527132,4528538,1406
"33047","WBGene00235279","IV",3070134,3076307,6173
"33048","WBGene00235280","IV",8611586,8611983,397
"33049","WBGene00235281","IV",5457268,5457721,453
"33050","WBGene00235282","IV",8346891,8347164,273
"33051","WBGene00235283","IV",806426,807030,604
"33052","WBGene00235284","IV",12029704,12029772,68
"33053","WBGene00235285","IV",3911542,3911940,398
"33054","WBGene00235286","IV",9123278,9123876,598
"33055","WBGene00235287","IV",688380,698404,10024
"33056","WBGene00235288","IV",2561658,2562030,372
"33057","WBGene00235289","IV",6347513,6347875,362
"33058","WBGene00235290","IV",8603255,8603674,419
"33059","WBGene00235291","IV",6541692,6548523,6831
"33060","WBGene00235292","IV",4591013,4592756,1743
"33061","WBGene00235293","IV",3914717,3915012,295
"33062","WBGene00235294","IV",2597574,2597970,396
"33063","WBGene00235295","IV",7175646,7176276,630
"33064","WBGene00235296","IV",8169974,8170120,146
"33065","WBGene00235297","IV",3912853,3913125,272
"33066","WBGene00235298","IV",12337193,12337366,173
"33067","WBGene00235299","IV",2487275,2487483,208
"33068","WBGene00235300","IV",16867494,16867889,395
"33069","WBGene00235301","IV",13867074,13867418,344
"33070","WBGene00235302","IV",9166051,9166152,101
"33071","WBGene00235303","IV",6254935,6255033,98
"33072","WBGene00235304","IV",16918379,16918501,122
"33073","WBGene00235305","IV",16917784,16918444,660
"33074","WBGene00235307","V",8755897,8757098,1201
"33075","WBGene00235308","V",7860786,7861688,902
"33076","WBGene00235309","V",9128253,9128397,144
"33077","WBGene00235310","V",4320460,4322218,1758
"33078","WBGene00235311","V",6949569,6949854,285
"33079","WBGene00235312","V",8637245,8638125,880
"33080","WBGene00235313","V",9046976,9047605,629
"33081","WBGene00235314","V",12525,13369,844
"33082","WBGene00235315","V",1219936,1220558,622
"33083","WBGene00235316","V",9155615,9156736,1121
"33084","WBGene00235317","V",6554067,6554408,341
"33085","WBGene00235318","V",8427131,8427435,304
"33086","WBGene00235319","V",5777429,5777901,472
"33087","WBGene00235320","V",4792110,4793137,1027
"33088","WBGene00235322","V",13276259,13276360,101
"33089","WBGene00235323","V",13011479,13011665,186
"33090","WBGene00235324","V",7322215,7323790,1575
"33091","WBGene00235325","V",8343878,8345514,1636
"33092","WBGene00235326","V",2119829,2120215,386
"33093","WBGene00235327","V",893968,894775,807
"33094","WBGene00235328","V",9651544,9651777,233
"33095","WBGene00235329","V",2892227,2892624,397
"33096","WBGene00235330","V",9108585,9109140,555
"33097","WBGene00235331","V",8216344,8216541,197
"33098","WBGene00235332","V",6549448,6549894,446
"33099","WBGene00235333","II",429219,429836,617
"33100","WBGene00235335","V",14501340,14501435,95
"33101","WBGene00235336","V",7545487,7545591,104
"33102","WBGene00235338","II",444132,446928,2796
"33103","WBGene00235340","IV",2441477,2451333,9856
"33104","WBGene00235341","IV",2559581,2559999,418
"33105","WBGene00235342","IV",2562371,2562646,275
"33106","WBGene00235343","IV",2572407,2572683,276
"33107","WBGene00235346","IV",2678231,2678622,391
"33108","WBGene00235348","IV",2679497,2679668,171
"33109","WBGene00235350","IV",2762680,2765612,2932
"33110","WBGene00235351","II",960533,960857,324
"33111","WBGene00235352","II",1937063,1940147,3084
"33112","WBGene00235353","IV",3051756,3052358,602
"33113","WBGene00235354","II",1944058,1945168,1110
"33114","WBGene00235355","II",1946964,1947930,966
"33115","WBGene00235356","IV",3219894,3220296,402
"33116","WBGene00235357","IV",3578889,3579615,726
"33117","WBGene00235359","IV",3907292,3907627,335
"33118","WBGene00235361","IV",3918460,3918723,263
"33119","WBGene00235362","IV",3952847,3953922,1075
"33120","WBGene00235363","IV",4115943,4116101,158
"33121","WBGene00235364","IV",4115576,4115734,158
"33122","WBGene00235365","IV",4114468,4114631,163
"33123","WBGene00235366","IV",4116960,4117070,110
"33124","WBGene00235367","IV",4135488,4135843,355
"33125","WBGene00235368","IV",4139685,4140363,678
"33126","WBGene00235369","IV",4166541,4168120,1579
"33127","WBGene00235370","IV",4186113,4186620,507
"33128","WBGene00235371","IV",4219271,4220083,812
"33129","WBGene00235372","IV",4306275,4306578,303
"33130","WBGene00235373","IV",4394410,4397925,3515
"33131","WBGene00235374","IV",4775242,4776096,854
"33132","WBGene00235375","IV",4859255,4860255,1000
"33133","WBGene00235376","IV",4920355,4929476,9121
"33134","WBGene00235378","IV",4978684,4978991,307
"33135","WBGene00235380","IV",5157141,5157326,185
"33136","WBGene00235381","I",22882,23600,718
"33137","WBGene00235382","IV",5303305,5303728,423
"33138","WBGene00235383","IV",5408426,5411166,2740
"33139","WBGene00235385","I",316637,318258,1621
"33140","WBGene00235386","IV",5935551,5935778,227
"33141","WBGene00235387","I",471135,473890,2755
"33142","WBGene00235388","I",482040,483880,1840
"33143","WBGene00235389","IV",6012596,6012771,175
"33144","WBGene00235390","I",585119,585376,257
"33145","WBGene00235391","IV",6595430,6596027,597
"33146","WBGene00236785","IV",6731973,6732170,197
"33147","WBGene00236786","IV",6805115,6805908,793
"33148","WBGene00236787","IV",6920781,6921027,246
"33149","WBGene00236788","IV",6973091,6973742,651
"33150","WBGene00236789","I",740835,741878,1043
"33151","WBGene00236797","I",1692352,1693675,1323
"33152","WBGene00236798","I",5315917,5316885,968
"33153","WBGene00236799","V",2802073,2802874,801
"33154","WBGene00236800","I",10174455,10175591,1136
"33155","WBGene00236806","IV",7250458,7254204,3746
"33156","WBGene00236807","IV",7256558,7256888,330
"33157","WBGene00236808","I",1015204,1015731,527
"33158","WBGene00236809","I",1112418,1115501,3083
"33159","WBGene00249808","I",1189970,1190830,860
"33160","WBGene00249812","II",3306220,3306240,20
"33161","WBGene00249813","II",3309269,3309287,18
"33162","WBGene00249815","IV",7947429,7948052,623
"33163","WBGene00249816","IV",8121908,8122240,332
"33164","WBGene00249817","IV",8127734,8128909,1175
"33165","WBGene00249825","IV",8353636,8354209,573
"33166","WBGene00249826","IV",8605512,8607840,2328
"33167","WBGene00255375","IV",8677590,8678019,429
"33168","WBGene00255420","I",1945814,1949520,3706
"33169","WBGene00255426","IV",10114525,10115129,604
"33170","WBGene00255435","IV",10652719,10654002,1283
"33171","WBGene00255441","IV",10847412,10847596,184
"33172","WBGene00255457","I",2436550,2437084,534
"33173","WBGene00255469","IV",12442068,12443035,967
"33174","WBGene00255522","IV",14577004,14577273,269
"33175","WBGene00255543","IV",14997836,14997936,100
"33176","WBGene00255545","IV",15114624,15114773,149
"33177","WBGene00255546","IV",15118690,15120241,1551
"33178","WBGene00255549","I",2760304,2761184,880
"33179","WBGene00255550","I",2787981,2788418,437
"33180","WBGene00255553","IV",16693505,16694667,1162
"33181","WBGene00255561","II",18637,18697,60
"33182","WBGene00255562","IV",5022928,5022995,67
"33183","WBGene00255563","X",17608227,17608288,61
"33184","WBGene00255564","III",6194849,6194906,57
"33185","WBGene00255567","II",11603572,11603635,63
"33186","WBGene00255568","I",3710171,3710241,70
"33187","WBGene00255570","IV",11722093,11722166,73
"33188","WBGene00255571","IV",14452441,14452502,61
"33189","WBGene00255572","IV",2079009,2079082,73
"33190","WBGene00255573","V",15150353,15150421,68
"33191","WBGene00255574","IV",10856119,10856180,61
"33192","WBGene00255575","II",11840444,11840500,56
"33193","WBGene00255576","I",11096994,11097055,61
"33194","WBGene00255577","I",13629835,13629901,66
"33195","WBGene00255578","I",2538611,2538670,59
"33196","WBGene00255579","V",1221313,1221368,55
"33197","WBGene00255582","IV",6294579,6294635,56
"33198","WBGene00255584","I",14368397,14368473,76
"33199","WBGene00255586","IV",6178148,6178231,83
"33200","WBGene00255587","II",13619493,13619554,61
"33201","WBGene00255594","I",218060,219099,1039
"33202","WBGene00255595","IV",8929031,8930322,1291
"33203","WBGene00255596","III",5782736,5783832,1096
"33204","WBGene00255597","III",1379140,1380663,1523
"33205","WBGene00255598","III",1056263,1060061,3798
"33206","WBGene00255600","II",6623423,6625389,1966
"33207","WBGene00255605","I",6710870,6711201,331
"33208","WBGene00255606","I",6710216,6710543,327
"33209","WBGene00255607","X",16687681,16688155,474
"33210","WBGene00255611","IV",16919151,16919312,161
"33211","WBGene00255702","IV",17439643,17439951,308
"33212","WBGene00255703","IV",17438395,17439169,774
"33213","WBGene00255704","V",8575,8739,164
"33214","WBGene00255709","IV",16930183,16930367,184
"33215","WBGene00255714","I",10633279,10634078,799
"33216","WBGene00255728","V",243136,244341,1205
"33217","WBGene00255729","V",524796,525140,344
"33218","WBGene00255730","V",630289,631890,1601
"33219","WBGene00255731","V",889714,890523,809
"33220","WBGene00255732","V",891135,891931,796
"33221","WBGene00255733","V",892692,893537,845
"33222","WBGene00255736","II",395098,395894,796
"33223","WBGene00268189","V",1081483,1082372,889
"33224","WBGene00268190","V",1079831,1080777,946
"33225","WBGene00268192","V",1733298,1734080,782
"33226","WBGene00268193","V",1737565,1738915,1350
"33227","WBGene00268194","V",1798200,1799694,1494
"33228","WBGene00268196","V",2019070,2022464,3394
"33229","WBGene00268197","V",2050915,2051607,692
"33230","WBGene00268198","V",2144020,2144508,488
"33231","WBGene00268199","V",2148657,2149532,875
"33232","WBGene00268202","V",2296998,2298686,1688
"33233","WBGene00268203","V",2575662,2576717,1055
"33234","WBGene00268204","V",2601959,2602119,160
"33235","WBGene00268205","V",2747687,2747917,230
"33236","WBGene00268206","V",2812531,2813948,1417
"33237","WBGene00268207","II",589161,589993,832
"33238","WBGene00268208","II",592129,592686,557
"33239","WBGene00268209","II",614257,614516,259
"33240","WBGene00268210","II",656185,656761,576
"33241","WBGene00268211","II",691145,691632,487
"33242","WBGene00268212","V",4064168,4066210,2042
"33243","WBGene00268213","V",3350177,3350967,790
"33244","WBGene00268214","X",11961443,11961777,334
"33245","WBGene00268215","X",11961699,11961971,272
"33246","WBGene00268216","I",14319114,14319913,799
"33247","WBGene00269331","II",779380,779882,502
"33248","WBGene00269332","II",783095,783632,537
"33249","WBGene00269333","II",793673,794638,965
"33250","WBGene00269336","II",839090,839443,353
"33251","WBGene00269337","II",842674,843029,355
"33252","WBGene00269338","II",919575,920407,832
"33253","WBGene00269346","II",928736,928969,233
"33254","WBGene00269352","V",3230897,3230974,77
"33255","WBGene00269355","V",3281828,3282704,876
"33256","WBGene00269373","II",1026028,1027725,1697
"33257","WBGene00269376","II",5097952,5098467,515
"33258","WBGene00269378","V",3493637,3496943,3306
"33259","WBGene00269379","II",6201573,6203010,1437
"33260","WBGene00269381","III",7365902,7366448,546
"33261","WBGene00269382","I",5838245,5838845,600
"33262","WBGene00269383","V",18736689,18737785,1096
"33263","WBGene00269384","V",5716793,5717325,532
"33264","WBGene00269385","V",4655475,4655786,311
"33265","WBGene00269386","V",4660271,4660737,466
"33266","WBGene00269387","II",3299825,3300676,851
"33267","WBGene00269388","II",1726141,1727106,965
"33268","WBGene00269389","II",1805711,1806458,747
"33269","WBGene00269390","II",1804209,1805408,1199
"33270","WBGene00269392","X",11850873,11851729,856
"33271","WBGene00269393","I",5741186,5741622,436
"33272","WBGene00269394","II",2012998,2013386,388
"33273","WBGene00269419","II",1572522,1573300,778
"33274","WBGene00269420","II",1547060,1548182,1122
"33275","WBGene00269421","II",10809279,10809847,568
"33276","WBGene00269422","X",12123452,12123916,464
"33277","WBGene00269423","V",3681521,3681685,164
"33278","WBGene00269424","V",4020728,4021876,1148
"33279","WBGene00269425","V",4036111,4038054,1943
"33280","WBGene00269426","V",4051417,4052327,910
"33281","WBGene00269427","V",4066530,4067073,543
"33282","WBGene00269428","V",4066850,4067804,954
"33283","WBGene00269429","V",4216147,4216461,314
"33284","WBGene00269430","V",4282675,4283598,923
"33285","WBGene00269431","II",2091772,2092111,339
"33286","WBGene00269432","V",4296721,4298089,1368
"33287","WBGene00269433","III",10063296,10063871,575
"33288","WBGene00269434","III",146917,147607,690
"33289","WBGene00269435","I",10879138,10879572,434
"33290","WBGene00269436","V",4379643,4381592,1949
"33291","WBGene00269437","V",4424353,4424637,284
"33292","WBGene00269438","III",11892172,11893022,850
