"","ensembl_gene_id","chromosome_name","start_position","end_position","length"
"1","FBgn0262374","2L",8258616,8258692,76
"2","FBgn0265984","2R",22689495,22690295,800
"3","FBgn0025637","X",656114,657899,1785
"4","FBgn0029858","X",6291303,6294177,2874
"5","FBgn0044049","3L",9803399,9804263,864
"6","FBgn0038461","3R",16990334,16991878,1544
"7","FBgn0035721","3L",6955991,6957440,1449
"8","FBgn0263473","2R",18994696,18994842,146
"9","FBgn0040383","X",750347,758719,8372
"10","FBgn0032728","2L",18969028,18972004,2976
"11","FBgn0039250","3R",24922473,24925160,2687
"12","FBgn0266167","2L",10004310,10005043,733
"13","FBgn0267440","3R",9821390,9822259,869
"14","FBgn0266535","3L",13208543,13208958,415
"15","FBgn0030398","X",12553124,12554235,1111
"16","FBgn0038223","3R",14320191,14326689,6498
"17","FBgn0082969","2R",21330434,21330565,131
"18","FBgn0031866","2L",6874900,6906656,31756
"19","FBgn0266246","3R",12335924,12339275,3351
"20","FBgn0267627","3L",22359458,22360868,1410
"21","FBgn0266642","2R",21309395,21310146,751
"22","FBgn0036799","3L",18600150,18617943,17793
"23","FBgn0013683","mitochondrion_genome",9545,9835,290
"24","FBgn0035692","3L",6192124,6193179,1055
"25","FBgn0054025","3L",2959722,2961049,1327
"26","FBgn0267606","3L",21003707,21004201,494
"27","FBgn0261856","2R",7000154,7001696,1542
"28","FBgn0265532","X",2071710,2072189,479
"29","FBgn0042106","3R",23684057,23686537,2480
"30","FBgn0001124","2R",16138352,16141928,3576
"31","FBgn0266621","2R",6663395,6664195,800
"32","FBgn0053252","X",16896215,16897187,972
"33","FBgn0263832","3L",4040529,4042597,2068
"34","FBgn0011965","3R",5388228,5388300,72
"35","FBgn0039719","3R",29905464,29906448,984
"36","FBgn0029718","X",4647871,4648646,775
"37","FBgn0025832","2R",16854025,16855464,1439
"38","FBgn0050466","2R",15568960,15573170,4210
"39","FBgn0038627","3R",18573091,18590726,17635
"40","FBgn0086662","3R",5598015,5598157,142
"41","FBgn0025866","3L",9888762,9893319,4557
"42","FBgn0053012","2R",12367353,12370886,3533
"43","FBgn0036133","3L",11109690,11112117,2427
"44","FBgn0264574","3L",914074,993788,79714
"45","FBgn0259186","2R",24517824,24519152,1328
"46","FBgn0053458","2R",16486674,16487801,1127
"47","FBgn0019686","2L",20061422,20064381,2959
"48","FBgn0034795","2R",22888928,22894425,5497
"49","FBgn0033766","2R",12679967,12686179,6212
"50","FBgn0029959","X",7734923,7736756,1833
"51","FBgn0035321","3L",2252744,2257423,4679
"52","FBgn0053511","2L",21081127,21082494,1367
"53","FBgn0034275","2R",17750293,17753214,2921
"54","FBgn0050406","2R",21848407,21848478,71
"55","FBgn0031835","2L",6568400,6601068,32668
"56","FBgn0259859","Y",941169,942020,851
"57","FBgn0263987","X",5412386,5420867,8481
"58","FBgn0032791","2L",19490262,19491679,1417
"59","FBgn0030625","X",15293031,15297169,4138
"60","FBgn0266148","2L",14557939,14558852,913
"61","FBgn0000316","X",255674,258469,2795
"62","FBgn0038855","3R",21102199,21105113,2914
"63","FBgn0038221","3R",14302428,14304458,2030
"64","FBgn0045866","3R",25039374,25040443,1069
"65","FBgn0000108","X",530501,579044,48543
"66","FBgn0266595","3L",13599230,13599883,653
"67","FBgn0036660","3L",16776531,16779736,3205
"68","FBgn0266377","2R",23657567,23680844,23277
"69","FBgn0035955","3L",9008624,9009838,1214
"70","FBgn0035279","3L",1824129,1831783,7654
"71","FBgn0027109","3R",16609220,16611325,2105
"72","FBgn0037633","3R",8803471,8805802,2331
"73","FBgn0028539","2L",13784084,13790562,6478
"74","FBgn0267171","X",21373635,21374417,782
"75","FBgn0040228","2L",15005733,15006607,874
"76","FBgn0250754","3R",16458280,16469663,11383
"77","FBgn0038238","3R",14559166,14560054,888
"78","FBgn0040334","X",2617758,2619738,1980
"79","FBgn0036010","3L",9542245,9543999,1754
"80","FBgn0037818","3R",10675560,10677251,1691
"81","FBgn0025885","2R",7454922,7458874,3952
"82","FBgn0267802","3R",7883693,7884441,748
"83","FBgn0039476","3R",27024968,27026109,1141
"84","FBgn0043841","2L",12403270,12423439,20169
"85","FBgn0037517","3R",7790633,7793483,2850
"86","FBgn0039437","3R",26624587,26625652,1065
"87","FBgn0032689","2L",18599755,18605249,5494
"88","FBgn0266001","2L",6507424,6508404,980
"89","FBgn0037460","3R",6626930,6627900,970
"90","FBgn0033737","2R",12428449,12431099,2650
"91","FBgn0052208","3L",19471656,19472228,572
"92","FBgn0036665","3L",16809658,16829074,19416
"93","FBgn0033076","2R",6600044,6600978,934
"94","FBgn0085205","2L",4004080,4004480,400
"95","FBgn0267439","2L",10392867,10393434,567
"96","FBgn0035496","3L",4093207,4094344,1137
"97","FBgn0030722","X",16061902,16062898,996
"98","FBgn0029813","X",5814864,5815820,956
"99","FBgn0036056","3L",9893188,9894743,1555
"100","FBgn0038567","3R",18152120,18153640,1520
"101","FBgn0037653","3R",9006456,9008030,1574
"102","FBgn0262476","2R",18514574,18526439,11865
"103","FBgn0037391","3R",5858083,5862405,4322
"104","FBgn0051822","2L",15836725,15837444,719
"105","FBgn0053192","3R",20534962,20535301,339
"106","FBgn0031091","X",20160355,20165830,5475
"107","FBgn0004841","3R",10737592,10751228,13636
"108","FBgn0265851","2R",20302195,20302995,800
"109","FBgn0039958","2L",23161122,23174484,13362
"110","FBgn0039381","3R",25881984,25888230,6246
"111","FBgn0000158","3R",25243039,25245057,2018
"112","FBgn0029941","X",7281089,7405797,124708
"113","FBgn0051760","2L",12142780,12170508,27728
"114","FBgn0032536","2L",13914725,13956188,41463
"115","FBgn0034691","2R",22080176,22085767,5591
"116","FBgn0000414","3L",16712126,16724575,12449
"117","FBgn0035851","3L",8191270,8196573,5303
"118","FBgn0040076","3R",13710017,13711835,1818
"119","FBgn0263038","2L",14163508,14180686,17178
"120","FBgn0011957","2R",6161535,6161607,72
"121","FBgn0043539","2L",1991381,1992160,779
"122","FBgn0035600","3L",5360211,5362798,2587
"123","FBgn0265597","X",12988615,13079070,90455
"124","FBgn0284243","2R",19447319,19451600,4281
"125","FBgn0003028","X",5048273,5070929,22656
"126","FBgn0028855","2L",14712471,14713298,827
"127","FBgn0011672","3R",21051383,21060800,9417
"128","FBgn0265740","3L",11034802,11035905,1103
"129","FBgn0265468","3L",11315299,11315860,561
"130","FBgn0039936","4",853557,867025,13468
"131","FBgn0266895","2L",16534962,16535228,266
"132","FBgn0024897","X",1686624,1690187,3563
"133","FBgn0053556","3L",7094818,7123297,28479
"134","FBgn0267099","X",9120717,9120918,201
"135","FBgn0266398","3R",26004278,26004681,403
"136","FBgn0032669","2L",18154851,18155942,1091
"137","FBgn0264260","2L",15776442,15776852,410
"138","FBgn0262816","2R",16380516,16385765,5249
"139","FBgn0083960","2L",4958411,4965430,7019
"140","FBgn0036740","3L",17620123,17621625,1502
"141","FBgn0262291","3L",11773731,11773878,147
"142","FBgn0039616","3R",28923044,28925086,2042
"143","FBgn0030196","X",10383353,10385861,2508
"144","FBgn0037877","3R",11217898,11220064,2166
"145","FBgn0035143","3L",581337,582810,1473
"146","FBgn0266203","2L",1380083,1381326,1243
"147","FBgn0051677","2L",20603535,20604196,661
"148","FBgn0032296","2L",10740782,10743935,3153
"149","FBgn0267390","3L",15566013,15576313,10300
"150","FBgn0261501","2R",17599389,17599607,218
"151","FBgn0082980","2L",22535458,22535593,135
"152","FBgn0261624","X",20881814,20882626,812
"153","FBgn0083973","2L",22151623,22152640,1017
"154","FBgn0032054","2L",8517411,8519176,1765
"155","FBgn0052344","3L",321233,324720,3487
"156","FBgn0267645","3L",4744950,4745310,360
"157","FBgn0267710","3R",20238507,20239091,584
"158","FBgn0011740","3R",9412548,9417264,4716
"159","FBgn0031972","2L",7999670,8004286,4616
"160","FBgn0038233","3R",14509049,14511712,2663
"161","FBgn0260959","2R",11895997,11903918,7921
"162","FBgn0032313","2L",10900501,10901785,1284
"163","FBgn0024320","2L",10213812,10221216,7404
"164","FBgn0050349","2R",8907518,8910885,3367
"165","FBgn0032251","2L",10439440,10441047,1607
"166","FBgn0266624","2R",7631495,7635219,3724
"167","FBgn0037231","3R",4307435,4310947,3512
"168","FBgn0036591","3L",16278458,16279271,813
"169","FBgn0265509","2R",15330395,15331195,800
"170","FBgn0052461","3L",22954421,22955302,881
"171","FBgn0030057","X",8688627,8690227,1600
"172","FBgn0034246","2R",17574979,17581525,6546
"173","FBgn0262877","2L",6932121,6932954,833
"174","FBgn0036483","3L",15131508,15136934,5426
"175","FBgn0002873","X",14247732,14258595,10863
"176","FBgn0026869","4",538332,557854,19522
"177","FBgn0035986","3L",9406179,9410832,4653
"178","FBgn0040285","X",15446179,15449883,3704
"179","FBgn0051631","2L",6799744,6799816,72
"180","FBgn0033339","2R",8893613,8898798,5185
"181","FBgn0031343","2L",1498455,1500608,2153
"182","FBgn0034871","2R",23511286,23512225,939
"183","FBgn0032020","2L",8320328,8321285,957
"184","FBgn0001254","3L",3510974,3512681,1707
"185","FBgn0267881","Y",3134941,3135206,265
"186","FBgn0014949","3R",22586149,22586625,476
"187","FBgn0263110","3L",4193993,4224003,30010
"188","FBgn0052440","3L",21360179,21361229,1050
"189","FBgn0267224","3L",16319440,16319931,491
"190","FBgn0286198","2L",7791175,7795959,4784
"191","FBgn0019936","3R",20822181,20823356,1175
"192","FBgn0036979","3L",20370313,20371746,1433
"193","FBgn0085810","3L",24553110,24554200,1090
"194","FBgn0035213","3L",1339460,1342403,2943
"195","FBgn0267201","3R",16214278,16214957,679
"196","FBgn0037005","3L",20506032,20507375,1343
"197","FBgn0051514","3R",9779519,9782693,3174
"198","FBgn0261841","3R",21365609,21368279,2670
"199","FBgn0037359","3R",5655139,5656336,1197
"200","FBgn0032782","2L",19432574,19435841,3267
"201","FBgn0039770","3R",30435177,30443599,8422
"202","FBgn0265070","2L",10695058,10698195,3137
"203","FBgn0038069","3R",12638481,12640033,1552
"204","FBgn0033179","2R",7465018,7466759,1741
"205","FBgn0003356","3R",29923754,29924615,861
"206","FBgn0032228","2L",10354743,10356597,1854
"207","FBgn0260955","2L",14744845,14745210,365
"208","FBgn0031857","2L",6759829,6772755,12926
"209","FBgn0004108","3L",16766072,16777465,11393
"210","FBgn0037824","3R",10706974,10707460,486
"211","FBgn0031655","2L",4955509,4958292,2783
"212","FBgn0036294","3L",12505374,12507840,2466
"213","FBgn0028644","2L",16000291,16041703,41412
"214","FBgn0261857","3R",20734748,20735323,575
"215","FBgn0010441","3R",27251131,27253182,2051
"216","FBgn0039099","3R",23678895,23679855,960
"217","FBgn0035237","3L",1576699,1600845,24146
"218","FBgn0038132","3R",13287655,13288813,1158
"219","FBgn0038659","3R",18906609,18910755,4146
"220","FBgn0038316","3R",15318203,15320069,1866
"221","FBgn0265586","2L",17625098,17625690,592
"222","FBgn0030390","X",12456409,12457763,1354
"223","FBgn0263559","X",21298275,21298345,70
"224","FBgn0030905","X",18258551,18259517,966
"225","FBgn0038941","3R",22329300,22330546,1246
"226","FBgn0036532","3L",15809485,15809977,492
"227","FBgn0034745","2R",22609334,22613376,4042
"228","FBgn0034774","2R",22755219,22755896,677
"229","FBgn0285954","X",16288810,16293520,4710
"230","FBgn0038816","3R",20635480,20644279,8799
"231","FBgn0033638","2R",11619479,11640941,21462
"232","FBgn0031564","2L",3703659,3704253,594
"233","FBgn0261807","2R",19635279,19635941,662
"234","FBgn0087021","3R",12961745,12963249,1504
"235","FBgn0263744","2L",16699921,16700825,904
"236","FBgn0267214","3R",25845678,25846318,640
"237","FBgn0036498","3L",15496574,15498055,1481
"238","FBgn0038960","3R",22405939,22408640,2701
"239","FBgn0029503","3R",24186359,24187785,1426
"240","FBgn0033550","2R",10812157,10813310,1153
"241","FBgn0043578","3L",16727299,16727989,690
"242","FBgn0263216","X",9966615,9977405,10790
"243","FBgn0033184","2R",7508527,7510357,1830
"244","FBgn0267461","3L",1001027,1002195,1168
"245","FBgn0264469","3L",21528546,21529115,569
"246","FBgn0038183","3R",13780964,13782082,1118
"247","FBgn0030439","X",12974683,12976231,1548
"248","FBgn0051575","3R",17658381,17658453,72
"249","FBgn0035476","3L",3938624,3940125,1501
"250","FBgn0053395","2R",19750620,19750754,134
"251","FBgn0051251","3R",17683740,17684915,1175
"252","FBgn0039145","3R",24054391,24055092,701
"253","FBgn0030323","X",11677344,11678589,1245
"254","FBgn0037506","3R",7500951,7502376,1425
"255","FBgn0040389","X",2343997,2344649,652
"256","FBgn0033526","2R",10466001,10468540,2539
"257","FBgn0039743","3R",30052514,30054697,2183
"258","FBgn0263399","3R",17911376,17912045,669
"259","FBgn0030710","X",15941077,15944449,3372
"260","FBgn0034735","2R",22492197,22494295,2098
"261","FBgn0267765","3R",24815759,24817131,1372
"262","FBgn0036640","3L",16576859,16580306,3447
"263","FBgn0259745","2R",7478853,7489823,10970
"264","FBgn0024814","3L",20241053,20243735,2682
"265","FBgn0028950","2L",15610171,15611719,1548
"266","FBgn0036790","3L",18560258,18576326,16068
"267","FBgn0086074","3L",7639717,7639794,77
"268","FBgn0084049","2R",4731514,4732343,829
"269","FBgn0031659","2L",4971702,4973687,1985
"270","FBgn0053447","2R",19731409,19731543,134
"271","FBgn0053557","X",10009210,10010049,839
"272","FBgn0261560","2L",3478434,3479612,1178
"273","FBgn0028941","2L",13542268,13543633,1365
"274","FBgn0031715","2L",5535861,5536758,897
"275","FBgn0027509","2L",2147518,2151664,4146
"276","FBgn0032775","2L",19390370,19398493,8123
"277","FBgn0038011","3R",12311353,12313119,1766
"278","FBgn0053317","2L",20901134,20901524,390
"279","FBgn0003525","3R",29251826,29255800,3974
"280","FBgn0259851","Y",904859,905678,819
"281","FBgn0038195","3R",14032371,14035041,2670
"282","FBgn0261341","3L",19690033,19695260,5227
"283","FBgn0030960","X",18791668,18793517,1849
"284","FBgn0028292","X",9256168,9259202,3034
"285","FBgn0275434","3L",13840611,13842198,1587
"286","FBgn0086044","X",9929889,9930006,117
"287","FBgn0039009","3R",22704254,22707278,3024
"288","FBgn0035631","3L",5765846,5767084,1238
"289","FBgn0036474","3L",15076907,15078447,1540
"290","FBgn0085366","X",7417253,7417693,440
"291","FBgn0030340","X",11842662,11846099,3437
"292","FBgn0038009","3R",12270890,12271300,410
"293","FBgn0083015","3L",11822984,11823124,140
"294","FBgn0015546","2L",14362069,14366840,4771
"295","FBgn0000566","2R",18627918,18629395,1477
"296","FBgn0262237","X",22833440,22833583,143
"297","FBgn0031189","X",22473698,22474998,1300
"298","FBgn0016059","2R",17672839,17683499,10660
"299","FBgn0023170","2R",24061853,24062431,578
"300","FBgn0040290","3L",8170640,8175978,5338
"301","FBgn0085831","Y",3024149,3024385,236
"302","FBgn0266888","2L",15280028,15280449,421
"303","FBgn0024329","3R",18733106,18743594,10488
"304","FBgn0264347","2L",15960243,15961190,947
"305","FBgn0030992","X",19183421,19187278,3857
"306","FBgn0267435","3R",31204180,31210730,6550
"307","FBgn0001301","2L",18129884,18138083,8199
"308","FBgn0265369","2L",3616296,3617619,1323
"309","FBgn0002734","3R",25997621,25998633,1012
"310","FBgn0034483","2R",20211585,20212619,1034
"311","FBgn0032375","2L",11789919,11791011,1092
"312","FBgn0266748","3R",16991978,16992976,998
"313","FBgn0266804","2R",12777324,12778995,1671
"314","FBgn0032391","2L",11990927,11992848,1921
"315","FBgn0085523","Y",953256,954313,1057
"316","FBgn0260234","3R",19914320,19915412,1092
"317","FBgn0023550","X",2201820,2203866,2046
"318","FBgn0265840","2R",20014495,20014695,200
"319","FBgn0284416","2L",12774054,12775252,1198
"320","FBgn0013342","3L",1630348,1637752,7404
"321","FBgn0026149","X",9356634,9358594,1960
"322","FBgn0002629","3R",26023821,26024579,758
"323","FBgn0261639","3L",24546138,24546986,848
"324","FBgn0002645","3R",32055279,32068441,13162
"325","FBgn0029891","X",6683798,6687302,3504
"326","FBgn0010217","4",1031484,1034917,3433
"327","FBgn0037590","3R",8510077,8511358,1281
"328","FBgn0051806","2L",16984978,16985634,656
"329","FBgn0011020","3R",7151367,7154219,2852
"330","FBgn0265413","X",9070318,9078499,8181
"331","FBgn0267717","3L",11229029,11229437,408
"332","FBgn0038944","3R",22334257,22340307,6050
"333","FBgn0083035","2L",20419145,20419281,136
"334","FBgn0034314","2R",18180496,18182519,2023
"335","FBgn0037936","3R",11688381,11690051,1670
"336","FBgn0034821","2R",23090100,23094266,4166
"337","FBgn0037834","3R",10786481,10788226,1745
"338","FBgn0085391","3R",28026615,28090740,64125
"339","FBgn0028889","2L",15132306,15132389,83
"340","FBgn0033692","2R",12180493,12182373,1880
"341","FBgn0267141","3R",11486788,11487227,439
"342","FBgn0265658","2R",16810595,16811095,500
"343","FBgn0031872","2L",6945464,6948808,3344
"344","FBgn0032768","2L",19298345,19299933,1588
"345","FBgn0086066","3L",829922,829992,70
"346","FBgn0265829","2L",10542860,10543522,662
"347","FBgn0032682","2L",18485417,18488021,2604
"348","FBgn0054005","2R",18048108,18048909,801
"349","FBgn0267110","3R",8228008,8229448,1440
"350","FBgn0015222","3R",30385573,30388178,2605
"351","FBgn0052183","3L",17690015,17748839,58824
"352","FBgn0035207","3L",1313696,1318330,4634
"353","FBgn0267648","3R",21354445,21359768,5323
"354","FBgn0266084","3L",8753619,8798719,45100
"355","FBgn0045759","3L",6990622,6994447,3825
"356","FBgn0037174","3L",22669956,22680034,10078
"357","FBgn0267910","X",3545750,3546110,360
"358","FBgn0030314","X",11573731,11576152,2421
"359","FBgn0036099","3L",10691024,10692598,1574
"360","FBgn0267612","3R",24439867,24440510,643
"361","FBgn0030538","X",14171487,14172624,1137
"362","FBgn0086063","3L",827312,827383,71
"363","FBgn0034722","2R",22375090,22378484,3394
"364","FBgn0030966","X",18846389,18848566,2177
"365","FBgn0053203","3R",28870606,28887709,17103
"366","FBgn0050234","2R",17143965,17144046,81
"367","FBgn0037831","3R",10761310,10766756,5446
"368","FBgn0029133","X",13212325,13214408,2083
"369","FBgn0262893","3L",15530085,15531473,1388
"370","FBgn0035247","3L",1637942,1639235,1293
"371","FBgn0052409","3L",5899528,5900936,1408
"372","FBgn0010213","2R",16772785,16773915,1130
"373","FBgn0267951","3L",10797626,10798408,782
"374","FBgn0039485","3R",27101406,27102917,1511
"375","FBgn0032692","2L",18614339,18616106,1767
"376","FBgn0028686","X",11125101,11126785,1684
"377","FBgn0038819","3R",20669571,20672821,3250
"378","FBgn0265498","2R",13854659,13855894,1235
"379","FBgn0030540","X",14176923,14178456,1533
"380","FBgn0037662","3R",9177517,9179098,1581
"381","FBgn0002021","2L",19049843,19051612,1769
"382","FBgn0032225","2L",10344442,10347706,3264
"383","FBgn0030744","X",16381954,16384908,2954
"384","FBgn0267422","Y",3340824,3341546,722
"385","FBgn0037708","3R",9553696,9555408,1712
"386","FBgn0264901","3R",24231186,24231719,533
"387","FBgn0035524","3L",4281504,4282817,1313
"388","FBgn0038511","3R",17425768,17446499,20731
"389","FBgn0083037","2L",20418670,20418804,134
"390","FBgn0015245","X",11108482,11112308,3826
"391","FBgn0065092","3L",434855,434918,63
"392","FBgn0031858","2L",6774041,6778444,4403
"393","FBgn0038114","3R",13042050,13044086,2036
"394","FBgn0028669","2R",18908961,18911895,2934
"395","FBgn0266946","3L",15143801,15144170,369
"396","FBgn0264776","3R",15507940,15508886,946
"397","FBgn0030613","X",15089682,15113762,24080
"398","FBgn0004511","X",11769769,11778784,9015
"399","FBgn0033192","2R",7540111,7564435,24324
"400","FBgn0036859","3L",19269351,19274168,4817
"401","FBgn0259189","X",7879800,7881679,1879
"402","FBgn0002936","2L",877302,878270,968
"403","FBgn0260954","2L",14741161,14741840,679
"404","FBgn0034274","2R",17748935,17750136,1201
"405","FBgn0035643","3L",5882304,5884090,1786
"406","FBgn0036273","3L",12277655,12281476,3821
"407","FBgn0265701","X",8707974,8708184,210
"408","FBgn0031109","X",20415744,20416521,777
"409","FBgn0035005","2R",24445500,24446839,1339
"410","FBgn0027582","2L",11115635,11120319,4684
"411","FBgn0267536","3L",9991736,9992583,847
"412","FBgn0003687","2R",21686192,21687642,1450
"413","FBgn0263494","3L",9385646,9386112,466
"414","FBgn0262355","2L",16944723,16945374,651
"415","FBgn0267036","X",2269996,2270507,511
"416","FBgn0039696","3R",29795697,29799354,3657
"417","FBgn0011960","3R",8140727,8140799,72
"418","FBgn0266143","2L",14019395,14020325,930
"419","FBgn0267508","rDNA",4492,5312,820
"420","FBgn0085424","2L",12587625,12628135,40510
"421","FBgn0267072","X",4805459,4805683,224
"422","FBgn0263445","2R",12875164,12877280,2116
"423","FBgn0051139","3R",22747690,22749056,1366
"424","FBgn0262008","3L",10099357,10100881,1524
"425","FBgn0266699","3R",30781178,30783645,2467
"426","FBgn0039205","3R",24529773,24530558,785
"427","FBgn0286035","3R",9630255,9630440,185
"428","FBgn0266944","3L",15457491,15457878,387
"429","FBgn0032444","2L",12690336,12692934,2598
"430","FBgn0265147","2L",14241071,14241732,661
"431","FBgn0029863","X",6303975,6306745,2770
"432","FBgn0267615","3L",21398317,21398941,624
"433","FBgn0039883","3R",31812609,31846570,33961
"434","FBgn0262852","X",11587283,11589173,1890
"435","FBgn0267913","2R",12169558,12171706,2148
"436","FBgn0037126","3L",21737706,21738430,724
"437","FBgn0020617","2R",20916753,20937030,20277
"438","FBgn0032602","2L",16758184,16760554,2370
"439","FBgn0266253","3R",25496078,25496478,400
"440","FBgn0038439","3R",16484566,16495422,10856
"441","FBgn0025874","3L",13962658,13964702,2044
"442","FBgn0050486","2R",12848034,12848993,959
"443","FBgn0266029","2L",5564811,5565755,944
"444","FBgn0032519","2L",13395360,13396184,824
"445","FBgn0030389","X",12454729,12455683,954
"446","FBgn0266907","2L",355663,356891,1228
"447","FBgn0082946","3L",1666892,1666964,72
"448","FBgn0030122","X",9273413,9275653,2240
"449","FBgn0032004","2L",8216851,8218017,1166
"450","FBgn0039844","3R",31382109,31391893,9784
"451","FBgn0031959","2L",7873495,7879552,6057
"452","FBgn0037044","3L",21027915,21030141,2226
"453","FBgn0264376","2L",19919845,19921926,2081
"454","FBgn0031114","X",20424069,20426402,2333
"455","FBgn0265921","X",20758489,20759626,1137
"456","FBgn0259870","211000022279165",14,1118,1104
"457","FBgn0032705","2L",18708846,18711297,2451
"458","FBgn0267529","3L",8183583,8183998,415
"459","FBgn0035176","3L",902898,903810,912
"460","FBgn0039529","3R",27623359,27626011,2652
"461","FBgn0036112","3L",10972648,10973476,828
"462","FBgn0266628","2R",10541595,10541995,400
"463","FBgn0027330","X",8716713,8720277,3564
"464","FBgn0032925","2L",21163641,21166090,2449
"465","FBgn0067628","3R",14886456,14887739,1283
"466","FBgn0052580","X",16009114,16061722,52608
"467","FBgn0263072","X",10602641,10620190,17549
"468","FBgn0259168","X",17862697,17887222,24525
"469","FBgn0033485","2R",10098518,10099590,1072
"470","FBgn0053764","3L",4266789,4267503,714
"471","FBgn0052699","X",9571537,9579987,8450
"472","FBgn0266026","2L",3389348,3389753,405
"473","FBgn0033554","2R",10821098,10821640,542
"474","FBgn0004594","3L",15657628,15658149,521
"475","FBgn0035263","3L",1724390,1725647,1257
"476","FBgn0010114","2R",9227785,9247249,19464
"477","FBgn0038373","3R",15846534,15848436,1902
"478","FBgn0035309","3L",2167550,2169108,1558
"479","FBgn0250785","2L",20788662,20797042,8380
"480","FBgn0264897","3R",4774516,4775053,537
"481","FBgn0037594","3R",8552608,8553968,1360
"482","FBgn0262403","2R",15657066,15657163,97
"483","FBgn0267256","2L",10657627,10658031,404
"484","FBgn0034281","2R",17860760,17861591,831
"485","FBgn0027588","X",21600502,21605264,4762
"486","FBgn0032864","2L",20461585,20463444,1859
"487","FBgn0265531","X",2065455,2066106,651
"488","FBgn0011933","2R",6162023,6162096,73
"489","FBgn0038028","3R",12380869,12382691,1822
"490","FBgn0052453","3L",22697230,22697970,740
"491","FBgn0261283","3L",19793935,19798979,5044
"492","FBgn0034224","2R",17475214,17476272,1058
"493","FBgn0001986","2L",15752263,15755900,3637
"494","FBgn0086443","2L",19129469,19131954,2485
"495","FBgn0038202","3R",14104488,14108321,3833
"496","FBgn0034808","2R",22993669,22998884,5215
"497","FBgn0032585","2L",16488148,16490182,2034
"498","FBgn0003068","X",2685580,2692780,7200
"499","FBgn0267506","rDNA",55104,59294,4190
"500","FBgn0002632","3R",26032911,26034047,1136
"501","FBgn0051963","2L",4418977,4419048,71
"502","FBgn0085569","2R",3363857,3364402,545
"503","FBgn0050316","2R",6171687,6171759,72
"504","FBgn0032848","2L",20093972,20096253,2281
"505","FBgn0019949","2R",22636063,22637727,1664
"506","FBgn0286005","2R",18180151,18180205,54
"507","FBgn0011276","X",2680199,2681723,1524
"508","FBgn0025676","3L",708601,710607,2006
"509","FBgn0259795","2R",16534943,16537086,2143
"510","FBgn0003256","2R",1071462,1125927,54465
"511","FBgn0010295","X",3241491,3242084,593
"512","FBgn0053378","2R",19756879,19757013,134
"513","FBgn0053792","2R",12632674,12633454,780
"514","FBgn0033876","2R",13841761,13846255,4494
"515","FBgn0038385","3R",15920898,15932887,11989
"516","FBgn0003944","3R",16656623,16734426,77803
"517","FBgn0047351","3R",23699328,23700354,1026
"518","FBgn0035469","3L",3896900,3897498,598
"519","FBgn0085466","3R",28283719,28284725,1006
"520","FBgn0039532","3R",27636412,27639871,3459
"521","FBgn0027550","2L",10761116,10764971,3855
"522","FBgn0050295","2R",20870791,20879145,8354
"523","FBgn0038938","3R",22298805,22304420,5615
"524","FBgn0001086","2L",16310956,16313097,2141
"525","FBgn0011850","2R",19726142,19726213,71
"526","FBgn0001291","2R",10096480,10098556,2076
"527","FBgn0004901","3R",7909598,7911779,2181
"528","FBgn0030418","X",12744212,12749785,5573
"529","FBgn0037758","3R",9797769,9801026,3257
"530","FBgn0030512","X",13684380,13718285,33905
"531","FBgn0040487","3L",14945499,14946125,626
"532","FBgn0042104","3R",7780884,7783446,2562
"533","FBgn0052850","4",314923,331387,16464
"534","FBgn0263590","X",7872827,7873640,813
"535","FBgn0265426","3R",7263440,7264292,852
"536","FBgn0034186","2R",17059331,17062634,3303
"537","FBgn0045468","3R",21845454,21846659,1205
"538","FBgn0265140","3R",14664907,14697292,32385
"539","FBgn0259932","3L",9972312,9974023,1711
"540","FBgn0267264","2L",19322938,19326106,3168
"541","FBgn0039226","3R",24797460,24799668,2208
"542","FBgn0036502","3L",15505188,15508252,3064
"543","FBgn0261998","3L",17792088,17797594,5506
"544","FBgn0262109","3L",224106,230964,6858
"545","FBgn0082948","3L",20454246,20454324,78
"546","FBgn0041781","2L",10976772,10982395,5623
"547","FBgn0030525","X",13796389,13797638,1249
"548","FBgn0038550","3R",17805679,17807085,1406
"549","FBgn0051368","3R",11882790,11892382,9592
"550","FBgn0030658","X",15578205,15579857,1652
"551","FBgn0036879","3L",19519649,19520419,770
"552","FBgn0039890","4",184076,193829,9753
"553","FBgn0032067","2L",8769159,8772344,3185
"554","FBgn0038549","3R",17803225,17805249,2024
"555","FBgn0263830","X",22958856,22960091,1235
"556","FBgn0266579","3R",27639886,27656996,17110
"557","FBgn0036984","3L",20407103,20410566,3463
"558","FBgn0051281","3R",22966284,22967842,1558
"559","FBgn0014028","2R",6807626,6809172,1546
"560","FBgn0030590","X",14862989,14871181,8192
"561","FBgn0034511","2R",20526311,20526825,514
"562","FBgn0267871","Y",3071943,3072466,523
"563","FBgn0044810","3R",20904917,20905518,601
"564","FBgn0025383","X",1472522,1473727,1205
"565","FBgn0000289","2R",14173693,14182838,9145
"566","FBgn0267142","3R",12244989,12245353,364
"567","FBgn0038405","3R",16181020,16186235,5215
"568","FBgn0040512","3L",16671664,16673555,1891
"569","FBgn0261788","3L",7655389,7718395,63006
"570","FBgn0031929","2L",7689311,7691061,1750
"571","FBgn0266966","3L",6728201,6728701,500
"572","FBgn0039078","3R",23408684,23472278,63594
"573","FBgn0036935","3L",20098084,20103827,5743
"574","FBgn0041605","3R",4280221,4304604,24383
"575","FBgn0263442","2L",5969859,5971025,1166
"576","FBgn0033365","2R",9019032,9031045,12013
"577","FBgn0285992","X",4921677,4928133,6456
"578","FBgn0039315","3R",25287474,25288930,1456
"579","FBgn0003267","3R",26876771,26881171,4400
"580","FBgn0053413","2R",19743995,19744129,134
"581","FBgn0263517","2R",6835533,6835635,102
"582","FBgn0267169","X",18311395,18311926,531
"583","FBgn0005779","2L",3109672,3110998,1326
"584","FBgn0003008","2R",23967939,23968943,1004
"585","FBgn0034705","2R",22177419,22182879,5460
"586","FBgn0086062","3L",827075,827144,69
"587","FBgn0265845","2R",20136959,20137162,203
"588","FBgn0039927","4",1126602,1137919,11317
"589","FBgn0265677","2L",3268269,3268646,377
"590","FBgn0035070","2R",24848994,24850200,1206
"591","FBgn0031855","2L",6742502,6756133,13631
"592","FBgn0267442","X",4985671,4986397,726
"593","FBgn0016041","X",7736893,7739978,3085
"594","FBgn0265817","2L",20947135,20948170,1035
"595","FBgn0013433","2L",16049965,16081684,31719
"596","FBgn0264373","2L",16001785,16002401,616
"597","FBgn0267736","3L",14053100,14054304,1204
"598","FBgn0031265","2L",564163,566472,2309
"599","FBgn0051547","3R",5489505,5502702,13197
"600","FBgn0040279","3R",6299128,6300738,1610
"601","FBgn0039683","3R",29692591,29697025,4434
"602","FBgn0037563","3R",8289395,8290578,1183
"603","FBgn0265598","X",18515428,18572809,57381
"604","FBgn0259978","2R",5702112,5705439,3327
"605","FBgn0263994","X",15175441,15189931,14490
"606","FBgn0033474","2R",10028443,10032893,4450
"607","FBgn0031060","X",19699820,19701755,1935
"608","FBgn0250814","3L",16584124,16586111,1987
"609","FBgn0051624","2L",21199045,21200375,1330
"610","FBgn0263765","2L",15277797,15279497,1700
"611","FBgn0025525","3L",1140429,1177276,36847
"612","FBgn0033826","2R",13297202,13298467,1265
"613","FBgn0034317","2R",18187707,18188573,866
"614","FBgn0035782","3L",7436808,7437466,658
"615","FBgn0262334","2R",20585314,20585405,91
"616","FBgn0033061","2R",6078641,6080572,1931
"617","FBgn0267727","2L",10056900,10060095,3195
"618","FBgn0025549","X",7288367,7291298,2931
"619","FBgn0085784","2R",1806864,1807342,478
"620","FBgn0002643","2R",13991203,14060356,69153
"621","FBgn0034451","2R",19485494,19486837,1343
"622","FBgn0020371","2L",15484729,15485545,816
"623","FBgn0266010","2R",23290677,23291377,700
"624","FBgn0085442","2R",24881570,24888615,7045
"625","FBgn0267306","3L",5334846,5335103,257
"626","FBgn0058298","3L",23726829,23727989,1160
"627","FBgn0053477","2R",10409155,10409751,596
"628","FBgn0039210","3R",24583067,24585160,2093
"629","FBgn0265299","2R",7992196,7992567,371
"630","FBgn0053319","2L",20928824,20929525,701
"631","FBgn0029995","X",8084018,8087213,3195
"632","FBgn0037815","3R",10413301,10414242,941
"633","FBgn0005664","2L",11944129,11947131,3002
"634","FBgn0053774","2R",9399753,9400329,576
"635","FBgn0031178","X",21428614,21429256,642
"636","FBgn0262107","3L",2088166,2089626,1460
"637","FBgn0039404","3R",26056630,26057350,720
"638","FBgn0010300","2L",19133816,19179758,45942
"639","FBgn0261722","3L",15810081,15816410,6329
"640","FBgn0053095","3R",25097672,25102146,4474
"641","FBgn0028540","2L",13774340,13780165,5825
"642","FBgn0051475","3R",19180659,19201096,20437
"643","FBgn0036080","3L",10273204,10274624,1420
"644","FBgn0259198","X",18724914,18725672,758
"645","FBgn0002930","2R",7156477,7158241,1764
"646","FBgn0036279","3L",12368646,12391444,22798
"647","FBgn0265202","3R",30183845,30184398,553
"648","FBgn0039407","3R",26059496,26061293,1797
"649","FBgn0013995","3R",20978183,21015613,37430
"650","FBgn0030662","X",15585289,15593534,8245
"651","FBgn0262789","3L",27170036,27170567,531
"652","FBgn0038866","3R",21163778,21165161,1383
"653","FBgn0013750","2R",15322501,15325490,2989
"654","FBgn0033969","2R",14817857,14819987,2130
"655","FBgn0284253","2L",3510328,3514656,4328
"656","FBgn0011884","2R",13431777,13431850,73
"657","FBgn0263086","2L",18309187,18309446,259
"658","FBgn0025645","X",2937027,2938073,1046
"659","FBgn0029903","X",6803684,6813830,10146
"660","FBgn0039736","3R",30006034,30009189,3155
"661","FBgn0051944","2L",2009538,2009609,71
"662","FBgn0035550","3L",4473068,4475095,2027
"663","FBgn0033778","2R",12872787,12875012,2225
"664","FBgn0033846","2R",13506430,13513112,6682
"665","FBgn0031728","2L",5662849,5670838,7989
"666","FBgn0087012","3R",4612870,4633304,20434
"667","FBgn0032524","2L",13444103,13445651,1548
"668","FBgn0033885","2R",13942534,13943377,843
"669","FBgn0030703","X",15887567,15890109,2542
"670","FBgn0266538","3R",22032150,22034286,2136
"671","FBgn0085273","3L",14235053,14235941,888
"672","FBgn0265926","3L",11247404,11248097,693
"673","FBgn0001233","3L",3192969,3197059,4090
"674","FBgn0266864","2R",23720320,23721007,687
"675","FBgn0263270","2R",10360213,10360840,627
"676","FBgn0260721","3L",17885254,17885528,274
"677","FBgn0039070","3R",23286093,23288051,1958
"678","FBgn0266218","2L",6619080,6619446,366
"679","FBgn0005649","3R",24043056,24048265,5209
"680","FBgn0265581","2L",16982483,16983085,602
"681","FBgn0085520","Y",3267088,3268196,1108
"682","FBgn0032036","2L",8384455,8388804,4349
"683","FBgn0034072","2R",16081176,16098564,17388
"684","FBgn0267246","3L",1806043,1806932,889
"685","FBgn0039459","3R",26863376,26864559,1183
"686","FBgn0262006","3R",17406048,17406511,463
"687","FBgn0039677","3R",29669149,29671478,2329
"688","FBgn0033657","2R",11845324,11852324,7000
"689","FBgn0033762","2R",12652805,12655743,2938
"690","FBgn0264391","2L",19470844,19471627,783
"691","FBgn0086706","3L",8972056,8974765,2709
"692","FBgn0051729","2L",13289997,13301668,11671
"693","FBgn0045474","3L",20737569,20739430,1861
"694","FBgn0003074","2R",8910900,8914069,3169
"695","FBgn0266675","3L",17529868,17530202,334
"696","FBgn0014000","2L",19966727,19967685,958
"697","FBgn0025716","2R",17429353,17430963,1610
"698","FBgn0266638","2R",17040195,17043298,3103
"699","FBgn0033656","2R",11842103,11844240,2137
"700","FBgn0035210","3L",1332307,1333146,839
"701","FBgn0262407","2R",14215802,14215864,62
"702","FBgn0054010","2L",8009603,8010652,1049
"703","FBgn0034650","2R",21670152,21671593,1441
"704","FBgn0005612","2R",23978801,23985177,6376
"705","FBgn0036305","3L",12750119,12753402,3283
"706","FBgn0039833","3R",31232415,31235362,2947
"707","FBgn0039943","X",23082738,23084576,1838
"708","FBgn0265752","3L",13343550,13344250,700
"709","FBgn0267619","3L",21767229,21767915,686
"710","FBgn0039714","3R",29863701,29868895,5194
"711","FBgn0261119","2R",18447361,18451041,3680
"712","FBgn0053369","2R",19760215,19760349,134
"713","FBgn0261067","2R",21169969,21170672,703
"714","FBgn0029810","X",5792140,5794543,2403
"715","FBgn0030120","X",9268438,9269925,1487
"716","FBgn0262447","2R",9553762,9553824,62
"717","FBgn0032110","2L",9342832,9344777,1945
"718","FBgn0052413","3L",5902887,5904052,1165
"719","FBgn0050147","2R",20606881,20618217,11336
"720","FBgn0265082","3R",4910552,4945576,35024
"721","FBgn0034807","2R",22985420,22986339,919
"722","FBgn0261699","2L",6271024,6271468,444
"723","FBgn0029118","3L",5561701,5563691,1990
"724","FBgn0003510","3R",30039719,30043071,3352
"725","FBgn0086265","2L",5963087,5964951,1864
"726","FBgn0263462","2R",16857413,16857578,165
"727","FBgn0029084","2R",22139935,22141364,1429
"728","FBgn0005322","2L",10302173,10303947,1774
"729","FBgn0045035","3R",15232212,15242236,10024
"730","FBgn0040608","3R",26727314,26730117,2803
"731","FBgn0266970","3L",6154714,6155203,489
"732","FBgn0034856","2R",23381197,23382591,1394
"733","FBgn0053892","2L",21477461,21478055,594
"734","FBgn0039128","3R",23931639,23932728,1089
"735","FBgn0034360","2R",18613090,18614255,1165
"736","FBgn0035632","3L",5767017,5768794,1777
"737","FBgn0011953","X",14103719,14103791,72
"738","FBgn0036580","3L",16231081,16232038,957
"739","FBgn0038331","3R",15371957,15374237,2280
"740","FBgn0039192","3R",24364081,24364980,899
"741","FBgn0031168","X",21249976,21251148,1172
"742","FBgn0011603","2L",4468000,4477022,9022
"743","FBgn0052057","3L",10147454,10186108,38654
"744","FBgn0035645","3L",5897638,5899395,1757
"745","FBgn0085339","2L",6663664,6674780,11116
"746","FBgn0053429","2R",19738086,19738220,134
"747","FBgn0046692","2R",4546691,4565281,18590
"748","FBgn0031440","2L",2609994,2611283,1289
"749","FBgn0029506","2R",7012254,7018362,6108
"750","FBgn0039265","3R",25047706,25049455,1749
"751","FBgn0265099","2R",7431696,7432496,800
"752","FBgn0061476","3R",31210966,31213376,2410
"753","FBgn0262357","2L",4411155,4411824,669
"754","FBgn0261397","2R",7500147,7508625,8478
"755","FBgn0264862","X",16806047,16809230,3183
"756","FBgn0039038","3R",23012412,23015475,3063
"757","FBgn0038747","3R",19905164,19914272,9108
"758","FBgn0045485","2L",17180338,17181632,1294
"759","FBgn0029990","X",8035741,8037517,1776
"760","FBgn0266989","3L",5984120,5984340,220
"761","FBgn0030605","X",15063733,15064926,1193
"762","FBgn0267070","X",18666067,18666717,650
"763","FBgn0036690","3L",17029812,17032080,2268
"764","FBgn0036759","3L",17838650,17841427,2777
"765","FBgn0014861","3R",8264970,8267924,2954
"766","FBgn0053901","2L",21453790,21454202,412
"767","FBgn0037995","3R",12197941,12199473,1532
"768","FBgn0036486","3L",15154233,15158562,4329
"769","FBgn0265176","2R",15294595,15295088,493
"770","FBgn0015380","2L",19190342,19208621,18279
"771","FBgn0284081","3R",5821972,5822435,463
"772","FBgn0020633","3L",8891596,8894310,2714
"773","FBgn0051848","2L",13264996,13265876,880
"774","FBgn0038398","3R",16083878,16087222,3344
"775","FBgn0037554","3R",8233507,8237389,3882
"776","FBgn0015614","2R",7786010,7789053,3043
"777","FBgn0051845","2L",13777195,13778124,929
"778","FBgn0031255","2L",422873,425321,2448
"779","FBgn0027609","2L",4442870,4444680,1810
"780","FBgn0037828","3R",10735277,10735957,680
"781","FBgn0035461","3L",3803832,3806459,2627
"782","FBgn0014466","X",8477117,8478320,1203
"783","FBgn0037396","3R",6025826,6027238,1412
"784","FBgn0034970","2R",24065975,24068485,2510
"785","FBgn0036765","3L",17879096,17883653,4557
"786","FBgn0265063","3R",19297246,19297695,449
"787","FBgn0083946","3R",25169565,25193776,24211
"788","FBgn0266064","3R",15141843,15147531,5688
"789","FBgn0264470","3L",21884511,21887039,2528
"790","FBgn0029155","3R",27151662,27157603,5941
"791","FBgn0085428","2R",16307269,16316485,9216
"792","FBgn0267889","Y",3188367,3188632,265
"793","FBgn0003655","X",6363418,6365708,2290
"794","FBgn0010808","3R",31052616,31053915,1299
"795","FBgn0082972","2R",21326739,21326870,131
"796","FBgn0033110","2R",6872996,6875819,2823
"797","FBgn0001990","2L",15766133,15768349,2216
"798","FBgn0052483","3L",688523,690081,1558
"799","FBgn0033212","2R",7676540,7698902,22362
"800","FBgn0033807","2R",13212405,13214496,2091
"801","FBgn0051700","2L",22066517,22067170,653
"802","FBgn0010611","2R",16336090,16341242,5152
"803","FBgn0262790","2R",10352456,10353114,658
"804","FBgn0030065","X",8838323,8872774,34451
"805","FBgn0052762","X",5500208,5501229,1021
"806","FBgn0037028","3L",20813353,20816075,2722
"807","FBgn0030764","X",16630673,16632235,1562
"808","FBgn0033065","2R",6173684,6176195,2511
"809","FBgn0040629","3R",31262598,31263878,1280
"810","FBgn0040554","3R",13455511,13466106,10595
"811","FBgn0261859","3R",15095957,15131926,35969
"812","FBgn0030748","X",16415046,16417585,2539
"813","FBgn0037986","3R",12040528,12043453,2925
"814","FBgn0031116","X",20433950,20445599,11649
"815","FBgn0037092","3L",21507852,21512749,4897
"816","FBgn0000227","2L",4683052,4684461,1409
"817","FBgn0030377","X",12176440,12178626,2186
"818","FBgn0039562","3R",27948711,27952151,3440
"819","FBgn0030336","X",11808506,11816551,8045
"820","FBgn0030222","X",10623725,10627112,3387
"821","FBgn0262099","3L",16755489,16755720,231
"822","FBgn0266963","3L",6936567,6937405,838
"823","FBgn0267189","X",10217627,10219303,1676
"824","FBgn0265924","3L",11246953,11247223,270
"825","FBgn0259151","2L",16337989,16340368,2379
"826","FBgn0285943","2R",16496889,16499429,2540
"827","FBgn0031628","2L",4794549,4796581,2032
"828","FBgn0033216","2R",7714923,7716781,1858
"829","FBgn0038849","3R",21047462,21048829,1367
"830","FBgn0262239","2L",5641191,5641279,88
"831","FBgn0037147","3L",22026230,22028325,2095
"832","FBgn0038219","3R",14262387,14263367,980
"833","FBgn0086519","2R",11277957,11278445,488
"834","FBgn0053998","2R",18738492,18739143,651
"835","FBgn0012002","3R",17617761,17617833,72
"836","FBgn0262542","3R",21729502,21729895,393
"837","FBgn0011742","X",16548290,16553968,5678
"838","FBgn0050020","2R",10886810,10893191,6381
"839","FBgn0038000","3R",12222387,12224048,1661
"840","FBgn0263025","3R",27695235,27696531,1296
"841","FBgn0021767","X",8447691,8455069,7378
"842","FBgn0045862","3R",27700361,27703445,3084
"843","FBgn0038074","3R",12674608,12676084,1476
"844","FBgn0014411","X",1873853,1876474,2621
"845","FBgn0010768","3R",19164211,19170576,6365
"846","FBgn0267795","3L",14053215,14071583,18368
"847","FBgn0016076","2L",5288944,5311223,22279
"848","FBgn0031201","X",22809292,22811935,2643
"849","FBgn0038388","3R",15962167,15963867,1700
"850","FBgn0011949","X",14016808,14016880,72
"851","FBgn0029831","X",5988791,5992640,3849
"852","FBgn0267001","X",12043698,12335214,291516
"853","FBgn0033873","2R",13833575,13835096,1521
"854","FBgn0033304","2R",8570499,8572147,1648
"855","FBgn0029892","X",6687596,6688774,1178
"856","FBgn0046876","3R",6109642,6111034,1392
"857","FBgn0051391","3R",10703372,10705075,1703
"858","FBgn0039896","4",227922,230428,2506
"859","FBgn0028744","2R",17789679,17792448,2769
"860","FBgn0037069","3L",21300580,21301171,591
"861","FBgn0259857","Y",934058,935745,1687
"862","FBgn0083123","2R",14621601,14624498,2897
"863","FBgn0045823","3L",9714324,9717716,3392
"864","FBgn0264892","2L",13284927,13286538,1611
"865","FBgn0263864","2R",17020027,17026703,6676
"866","FBgn0052246","3L",4621219,4622985,1766
"867","FBgn0053527","2R",24577566,24578143,577
"868","FBgn0032684","2L",18509560,18513512,3952
"869","FBgn0034406","2R",18860375,18862078,1703
"870","FBgn0047330","3L",4859810,4860470,660
"871","FBgn0063493","2R",18406924,18407688,764
"872","FBgn0264789","3R",5250913,5252132,1219
"873","FBgn0038655","3R",18898121,18899342,1221
"874","FBgn0027864","X",8690327,8691811,1484
"875","FBgn0267970","X",1299770,1300333,563
"876","FBgn0264867","2L",4241070,4242397,1327
"877","FBgn0028684","3R",23752876,23754623,1747
"878","FBgn0027504","2R",12146024,12151057,5033
"879","FBgn0086082","3L",20453733,20453821,88
"880","FBgn0035975","3L",9334332,9338336,4004
"881","FBgn0036741","3L",17621824,17630971,9147
"882","FBgn0035708","3L",6609325,6619113,9788
"883","FBgn0264539","2R",13224175,13224462,287
"884","FBgn0266137","3R",29630304,29659984,29680
"885","FBgn0263697","2R",13858952,13860432,1480
"886","FBgn0050344","2R",9145260,9148512,3252
"887","FBgn0022288","2R",5754517,5756327,1810
"888","FBgn0053462","2R",15696794,15698010,1216
"889","FBgn0067903","2R",23600914,23601773,859
"890","FBgn0034035","2R",15677218,15678956,1738
"891","FBgn0037105","3L",21613797,21617376,3579
"892","FBgn0034420","2R",19164143,19178223,14080
"893","FBgn0034264","2R",17723309,17725056,1747
"894","FBgn0050299","2R",7070760,7070833,73
"895","FBgn0033799","2R",13163959,13168032,4073
"896","FBgn0267895","Y",3218291,3218817,526
"897","FBgn0032283","2L",10686124,10687066,942
"898","FBgn0283678","2L",11284327,11285706,1379
"899","FBgn0266915","2L",10441820,10442204,384
"900","FBgn0086603","2R",9097030,9097169,139
"901","FBgn0015609","2L",17647053,17778340,131287
"902","FBgn0030271","X",11142541,11143755,1214
"903","FBgn0035755","3L",7250718,7263920,13202
"904","FBgn0052016","4",951542,958392,6850
"905","FBgn0011202","2L",20758144,20768053,9909
"906","FBgn0005683","2L",10420625,10422780,2155
"907","FBgn0028342","X",10212970,10217393,4423
"908","FBgn0034261","2R",17683574,17690822,7248
"909","FBgn0262361","3L",8318542,8318966,424
"910","FBgn0033859","2R",13593644,13596557,2913
"911","FBgn0004360","2R",9494166,9503188,9022
"912","FBgn0267630","3L",22872380,22873723,1343
"913","FBgn0031026","X",19531032,19531742,710
"914","FBgn0263409","3R",24439867,24440469,602
"915","FBgn0023540","X",2162196,2172281,10085
"916","FBgn0052391","3L",7068211,7069199,988
"917","FBgn0000015","3R",16927212,16972236,45024
"918","FBgn0267016","2L",14745329,14745538,209
"919","FBgn0086660","3L",5764258,5764394,136
"920","FBgn0033751","2R",12517264,12518912,1648
"921","FBgn0037364","3R",5680054,5685434,5380
"922","FBgn0035164","3L",836667,837821,1154
"923","FBgn0266464","3R",13833497,13837991,4494
"924","FBgn0035641","3L",5871501,5873518,2017
"925","FBgn0030734","X",16293853,16297718,3865
"926","FBgn0033238","2R",7949839,7950465,626
"927","FBgn0051374","3R",11437547,11451791,14244
"928","FBgn0284435","X",142208,200663,58455
"929","FBgn0062961","2R",18711391,18711951,560
"930","FBgn0263579","3R",29008753,29008852,99
"931","FBgn0037433","3R",6344029,6345087,1058
"932","FBgn0053773","3R",31035346,31036124,778
"933","FBgn0264384","X",8972908,9048991,76083
"934","FBgn0003268","3R",31580951,31588244,7293
"935","FBgn0034782","2R",22834647,22836701,2054
"936","FBgn0035859","3L",8222141,8222953,812
"937","FBgn0050237","2R",16207635,16207706,71
"938","FBgn0033252","2R",8052080,8065554,13474
"939","FBgn0250836","3L",7130874,7131505,631
"940","FBgn0035771","3L",7360561,7364366,3805
"941","FBgn0263589","X",4368786,4373471,4685
"942","FBgn0036768","3L",17887705,17891404,3699
"943","FBgn0039754","3R",30185423,30191252,5829
"944","FBgn0052591","X",14927202,14928944,1742
"945","FBgn0020238","3R",18242531,18250550,8019
"946","FBgn0263485","2R",12161126,12161303,177
"947","FBgn0015561","2R",9195205,9199870,4665
"948","FBgn0064766","3L",11210786,11214097,3311
"949","FBgn0266589","3L",6304760,6305503,743
"950","FBgn0020445","2L",3334875,3354829,19954
"951","FBgn0267625","3L",22345383,22346236,853
"952","FBgn0032721","2L",18855126,18859248,4122
"953","FBgn0265704","3L",70504,71042,538
"954","FBgn0050001","2R",9821168,9822955,1787
"955","FBgn0030005","X",8135824,8137046,1222
"956","FBgn0052237","3L",4849438,4852461,3023
"957","FBgn0284410","2L",3587068,3587469,401
"958","FBgn0014011","3L",7432762,7435190,2428
"959","FBgn0019928","2R",13434207,13435045,838
"960","FBgn0259113","3R",21666562,21671750,5188
"961","FBgn0023395","3L",19447173,19450238,3065
"962","FBgn0036000","3L",9459369,9460799,1430
"963","FBgn0267297","3L",20912890,20913169,279
"964","FBgn0039735","3R",30003681,30004861,1180
"965","FBgn0034710","2R",22203694,22205593,1899
"966","FBgn0259737","2R",15202193,15202987,794
"967","FBgn0052062","3L",10481412,10594012,112600
"968","FBgn0014179","2L",9579498,9581745,2247
"969","FBgn0033815","2R",13235980,13237055,1075
"970","FBgn0267658","3R",18698135,18701290,3155
"971","FBgn0029821","X",5905746,5908001,2255
"972","FBgn0052650","X",12897503,12898669,1166
"973","FBgn0035099","3L",146433,149056,2623
"974","FBgn0035298","3L",1963143,1966805,3662
"975","FBgn0030537","X",14169592,14171545,1953
"976","FBgn0039792","3R",30627241,30629028,1787
"977","FBgn0029961","X",7764982,7766826,1844
"978","FBgn0030824","X",17203112,17203925,813
"979","FBgn0250911","3L",2631715,2641984,10269
"980","FBgn0034085","2R",16171112,16178307,7195
"981","FBgn0015791","2L",14355145,14358764,3619
"982","FBgn0031034","X",19592609,19595548,2939
"983","FBgn0042696","4",268175,276369,8194
"984","FBgn0266983","3L",19454760,19455672,912
"985","FBgn0035430","3L",3291459,3299000,7541
"986","FBgn0266986","3L",16196502,16197219,717
"987","FBgn0031792","2L",6263557,6264490,933
"988","FBgn0011774","3R",11410047,11412440,2393
"989","FBgn0266172","3R",21362968,21365488,2520
"990","FBgn0036503","3L",15516533,15517056,523
"991","FBgn0040227","3R",23680039,23682317,2278
"992","FBgn0034177","2R",17001994,17003599,1605
"993","FBgn0034086","2R",16185122,16186506,1384
"994","FBgn0038860","3R",21130216,21132720,2504
"995","FBgn0266204","2L",16293069,16293721,652
"996","FBgn0085196","2L",16002981,16003641,660
"997","FBgn0263597","3R",27694883,27695057,174
"998","FBgn0039867","3R",31735503,31736963,1460
"999","FBgn0003358","3R",29925226,29926189,963
"1000","FBgn0033358","2R",8963164,8968184,5020
"1001","FBgn0030873","X",17848110,17850342,2232
"1002","FBgn0003751","2L",10271443,10272324,881
"1003","FBgn0262166","2R",16194062,16196333,2271
"1004","FBgn0029716","X",4558072,4560317,2245
"1005","FBgn0260401","2R",18167255,18168380,1125
"1006","FBgn0266816","2R",13243996,13245045,1049
"1007","FBgn0031483","2L",2974859,2976862,2003
"1008","FBgn0086027","2R",22197269,22197374,105
"1009","FBgn0053725","3L",12482609,12486446,3837
"1010","FBgn0030812","X",17068717,17077897,9180
"1011","FBgn0032454","2L",12708792,12712952,4160
"1012","FBgn0022710","X",15510877,15554278,43401
"1013","FBgn0037098","3L",21543850,21554928,11078
"1014","FBgn0050096","2R",16320815,16322124,1309
"1015","FBgn0027495","2R",12140631,12143272,2641
"1016","FBgn0028481","2L",922793,958098,35305
"1017","FBgn0085486","2R",16670326,16671836,1510
"1018","FBgn0034383","2R",18743806,18744996,1190
"1019","FBgn0001142","2L",132077,134472,2395
"1020","FBgn0027586","2L",13236494,13239297,2803
"1021","FBgn0000094","3R",30209948,30210382,434
"1022","FBgn0030804","X",16889810,16890637,827
"1023","FBgn0267783","3R",30357255,30358138,883
"1024","FBgn0051858","2L",12496616,12497333,717
"1025","FBgn0030872","X",17844949,17848223,3274
"1026","FBgn0031319","2L",1177690,1182454,4764
"1027","FBgn0014343","3L",12693639,12710249,16610
"1028","FBgn0039911","4",583108,589348,6240
"1029","FBgn0039503","3R",27264374,27265430,1056
"1030","FBgn0011824","2R",21095958,21097305,1347
"1031","FBgn0033929","2R",14363048,14365473,2425
"1032","FBgn0052447","3L",21690612,21706365,15753
"1033","FBgn0266067","2L",5690530,5691421,891
"1034","FBgn0033978","2R",14875829,14877654,1825
"1035","FBgn0034700","2R",22138895,22139295,400
"1036","FBgn0040849","2R",4917519,5021955,104436
"1037","FBgn0041629","X",8709652,8712478,2826
"1038","FBgn0031632","2L",4821774,4828945,7171
"1039","FBgn0051560","3R",6309976,6310998,1022
"1040","FBgn0053729","2L",21453073,21453108,35
"1041","FBgn0035218","3L",1421199,1423471,2272
"1042","FBgn0031547","2L",3522521,3524056,1535
"1043","FBgn0044046","X",3667621,3668845,1224
"1044","FBgn0283535","3R",5591763,5595356,3593
"1045","FBgn0038947","3R",22356685,22360711,4026
"1046","FBgn0036342","3L",13046977,13048919,1942
"1047","FBgn0013764","2R",24031538,24033943,2405
"1048","FBgn0024913","4",1077331,1084796,7465
"1049","FBgn0259733","3R",13813109,13814648,1539
"1050","FBgn0267118","3R",4585178,4589308,4130
"1051","FBgn0054007","2L",20495030,20495758,728
"1052","FBgn0262477","3R",9726020,9730872,4852
"1053","FBgn0050447","2R",19947196,19948080,884
"1054","FBgn0000256","2L",3872646,3902860,30214
"1055","FBgn0031082","X",20000968,20002096,1128
"1056","FBgn0035788","3L",7471559,7472514,955
"1057","FBgn0039227","3R",24799967,24805259,5292
"1058","FBgn0263465","2L",232166,232253,87
"1059","FBgn0035039","2R",24611703,24613906,2203
"1060","FBgn0029771","X",5516608,5518771,2163
"1061","FBgn0266076","3L",10365228,10365325,97
"1062","FBgn0265746","3L",12658903,12660095,1192
"1063","FBgn0022768","X",4679988,4686903,6915
"1064","FBgn0053500","3L",11508637,11508903,266
"1065","FBgn0038750","3R",19915868,19917839,1971
"1066","FBgn0034098","2R",16238103,16240722,2619
"1067","FBgn0261976","2L",4386182,4387356,1174
"1068","FBgn0020224","3L",8424954,8432246,7292
"1069","FBgn0030263","X",11090210,11092098,1888
"1070","FBgn0025830","2R",16850437,16854104,3667
"1071","FBgn0265988","3L",1950306,1964178,13872
"1072","FBgn0054026","X",9533818,9534625,807
"1073","FBgn0052085","3L",11650517,11680344,29827
"1074","FBgn0033633","2R",11405597,11408079,2482
"1075","FBgn0267946","3R",7775410,7775768,358
"1076","FBgn0038739","3R",19864496,19866869,2373
"1077","FBgn0052681","X",10376651,10381352,4701
"1078","FBgn0033654","2R",11827170,11839825,12655
"1079","FBgn0051051","3R",28519548,28520515,967
"1080","FBgn0261555","3L",9547220,9596713,49493
"1081","FBgn0039187","3R",24349182,24356241,7059
"1082","FBgn0085472","2R",14367979,14369067,1088
"1083","FBgn0002022","2L",19041862,19043614,1752
"1084","FBgn0265265","X",7407208,7407854,646
"1085","FBgn0051157","3R",13047731,13049294,1563
"1086","FBgn0031995","2L",8190808,8196918,6110
"1087","FBgn0263403","3R",11088420,11089356,936
"1088","FBgn0013531","2L",8071812,8072848,1036
"1089","FBgn0032685","2L",18517487,18531967,14480
"1090","FBgn0053643","2L",13531074,13531662,588
"1091","FBgn0262160","2L",13021868,13060140,38272
"1092","FBgn0031111","X",20417921,20418964,1043
"1093","FBgn0265842","2R",20058095,20058795,700
"1094","FBgn0029909","X",6831397,6832684,1287
"1095","FBgn0263034","3L",22504487,22505218,731
"1096","FBgn0032665","2L",18114547,18115220,673
"1097","FBgn0259481","3L",11522757,11562233,39476
"1098","FBgn0004856","X",9103870,9106604,2734
"1099","FBgn0265791","2L",10650857,10651454,597
"1100","FBgn0267665","3L",10286900,10307954,21054
"1101","FBgn0034062","2R",16009401,16011438,2037
"1102","FBgn0039930","4",1028675,1029361,686
"1103","FBgn0265809","2L",12570672,12571157,485
"1104","FBgn0050273","2R",22667155,22668848,1693
"1105","FBgn0032746","2L",19049076,19049884,808
"1106","FBgn0259749","2L",6468538,6473904,5366
"1107","FBgn0085408","2R",14308142,14351802,43660
"1108","FBgn0063392","2L",9894205,9894285,80
"1109","FBgn0043577","3L",16726541,16727288,747
"1110","FBgn0010019","X",467057,469335,2278
"1111","FBgn0032029","2L",8370454,8374250,3796
"1112","FBgn0032087","2L",9010583,9011358,775
"1113","FBgn0028554","2L",6914301,6920210,5909
"1114","FBgn0037763","3R",9815928,9816979,1051
"1115","FBgn0028690","3R",5789493,5791569,2076
"1116","FBgn0038629","3R",18592801,18621327,28526
"1117","FBgn0038055","3R",12456573,12458444,1871
"1118","FBgn0052286","3L",3097519,3097590,71
"1119","FBgn0263314","2L",8490739,8491360,621
"1120","FBgn0027492","3R",27561675,27582241,20566
"1121","FBgn0040674","2R",6838074,6839055,981
"1122","FBgn0284414","2L",2637669,2638540,871
"1123","FBgn0030552","X",14226289,14227949,1660
"1124","FBgn0262716","3L",8113407,8115902,2495
"1125","FBgn0039453","3R",26735417,26736307,890
"1126","FBgn0023527","X",2262837,2264825,1988
"1127","FBgn0050345","2R",9148689,9151892,3203
"1128","FBgn0004003","2R",19249395,19250917,1522
"1129","FBgn0267037","X",3968933,3972054,3121
"1130","FBgn0261630","2L",8891440,8892180,740
"1131","FBgn0267239","3R",13443070,13444076,1006
"1132","FBgn0063497","2R",18400713,18401467,754
"1133","FBgn0032196","2L",10224457,10226808,2351
"1134","FBgn0259739","3L",18042733,18044214,1481
"1135","FBgn0259111","2L",7223328,7249343,26015
"1136","FBgn0035488","3L",4037523,4040482,2959
"1137","FBgn0031224","2L",143323,144227,904
"1138","FBgn0028468","3R",21108446,21110834,2388
"1139","FBgn0050021","2R",11226458,11232516,6058
"1140","FBgn0031746","2L",5886002,5886609,607
"1141","FBgn0053213","3R",27918182,27919460,1278
"1142","FBgn0083966","3R",26189004,26189977,973
"1143","FBgn0005777","3R",9747875,9751094,3219
"1144","FBgn0266428","2L",14359285,14361303,2018
"1145","FBgn0267194","3R",18360983,18361193,210
"1146","FBgn0267912","X",16560684,16587172,26488
"1147","FBgn0265058","2R",6873149,6880088,6939
"1148","FBgn0029811","X",5804677,5805344,667
"1149","FBgn0035437","3L",3322025,3328871,6846
"1150","FBgn0051002","3R",31393582,31395304,1722
"1151","FBgn0036510","3L",15563427,15565559,2132
"1152","FBgn0053013","2R",12363320,12366579,3259
"1153","FBgn0015770","3R",7365939,7369305,3366
"1154","FBgn0037135","3L",21824740,21827856,3116
"1155","FBgn0028939","2L",13980126,13983269,3143
"1156","FBgn0266995","3L",15987784,15988041,257
"1157","FBgn0032895","2L",20852578,20857113,4535
"1158","FBgn0035960","3L",9073105,9074467,1362
"1159","FBgn0063389","2L",9894477,9894544,67
"1160","FBgn0035453","3L",3615382,3616682,1300
"1161","FBgn0034961","2R",24029317,24030555,1238
"1162","FBgn0051091","3R",25899903,25902172,2269
"1163","FBgn0011224","3R",31846987,32015520,168533
"1164","FBgn0036974","3L",20348355,20353873,5518
"1165","FBgn0265690","2L",11660292,11660937,645
"1166","FBgn0035092","2R",25032377,25040377,8000
"1167","FBgn0083025","2L",20418997,20419133,136
"1168","FBgn0036036","3L",9719328,9720464,1136
"1169","FBgn0031826","2L",6497053,6498466,1413
"1170","FBgn0051741","2L",18084256,18086714,2458
"1171","FBgn0010403","3R",5976177,5976817,640
"1172","FBgn0035397","3L",3071133,3090406,19273
"1173","FBgn0032247","2L",10428829,10429988,1159
"1174","FBgn0085209","2L",6060510,6060938,428
"1175","FBgn0267614","3L",21302421,21304135,1714
"1176","FBgn0263232","3L",13965203,13973067,7864
"1177","FBgn0263656","2R",7020133,7020746,613
"1178","FBgn0036571","3L",16122002,16126052,4050
"1179","FBgn0265785","2L",5883741,5884345,604
"1180","FBgn0285975","rDNA",46106,46174,68
"1181","FBgn0027597","2L",1750687,1752122,1435
"1182","FBgn0033529","2R",10480163,10481886,1723
"1183","FBgn0004170","X",396060,397497,1437
"1184","FBgn0033827","2R",13298995,13301547,2552
"1185","FBgn0030687","X",15762956,15769514,6558
"1186","FBgn0052128","3L",13211551,13211622,71
"1187","FBgn0030664","X",15662585,15663319,734
"1188","FBgn0010399","3R",5508842,5523328,14486
"1189","FBgn0053700","3L",9514119,9525544,11425
"1190","FBgn0085331","3R",9822999,9823823,824
"1191","FBgn0266652","3L",24290290,24290864,574
"1192","FBgn0259732","3R",13813109,13814648,1539
"1193","FBgn0034205","2R",17195203,17197159,1956
"1194","FBgn0275436","2R",13968308,13969902,1594
"1195","FBgn0050259","2R",22701345,22704447,3102
"1196","FBgn0051437","3R",25383700,25384623,923
"1197","FBgn0034067","2R",16017737,16024627,6890
"1198","FBgn0038857","3R",21117857,21118856,999
"1199","FBgn0030342","X",11852692,11854931,2239
"1200","FBgn0285966","3R",19920708,19920862,154
"1201","FBgn0029525","X",482777,487581,4804
"1202","FBgn0052533","X",19474156,19479411,5255
"1203","FBgn0265828","2L",9119582,9120040,458
"1204","FBgn0033983","2R",14929703,14934861,5158
"1205","FBgn0052457","3L",22987642,22988262,620
"1206","FBgn0083970","2L",8190297,8190781,484
"1207","FBgn0035780","3L",7400070,7401671,1601
"1208","FBgn0000633","2R",13623044,13749367,126323
"1209","FBgn0032305","2L",10837732,10842597,4865
"1210","FBgn0265187","2R",23055474,23061549,6075
"1211","FBgn0052153","3L",16222031,16222103,72
"1212","FBgn0265346","2R",10785714,10786026,312
"1213","FBgn0040799","3L",16264713,16265100,387
"1214","FBgn0038577","3R",18187805,18188707,902
"1215","FBgn0034240","2R",17547769,17556289,8520
"1216","FBgn0029710","X",4542630,4544497,1867
"1217","FBgn0030292","X",11349998,11350474,476
"1218","FBgn0033594","2R",11244247,11245199,952
"1219","FBgn0004186","3R",23827870,23828033,163
"1220","FBgn0035090","2R",24973431,24975341,1910
"1221","FBgn0265318","3R",8562828,8563798,970
"1222","FBgn0011290","3R",11678386,11679690,1304
"1223","FBgn0031003","X",19243631,19245224,1593
"1224","FBgn0005638","2R",24331522,24334307,2785
"1225","FBgn0050036","2R",11977536,11979018,1482
"1226","FBgn0053728","2L",21433984,21434019,35
"1227","FBgn0266094","X",14952345,14953697,1352
"1228","FBgn0010340","3R",14124163,14125548,1385
"1229","FBgn0052304","3L",2267858,2268590,732
"1230","FBgn0028560","2R",10085442,10087127,1685
"1231","FBgn0267754","3R",27245333,27245701,368
"1232","FBgn0035763","3L",7326273,7328842,2569
"1233","FBgn0028412","2L",11585433,11586833,1400
"1234","FBgn0022893","2L",21626309,21629932,3623
"1235","FBgn0065073","2R",23073829,23073968,139
"1236","FBgn0052520","X",21304441,21304535,94
"1237","FBgn0267994","3R",22314543,22315162,619
"1238","FBgn0266354","X",16969069,17066732,97663
"1239","FBgn0266357","2L",1345501,1345840,339
"1240","FBgn0267742","3R",26847809,26849236,1427
"1241","FBgn0000100","3L",22075867,22077487,1620
"1242","FBgn0003009","2R",23271257,23275536,4279
"1243","FBgn0261429","2R",5363253,5367357,4104
"1244","FBgn0032640","2L",17471603,17474773,3170
"1245","FBgn0260470","2L",5037709,5040818,3109
"1246","FBgn0267474","3L",12380252,12381470,1218
"1247","FBgn0041246","2L",11114014,11115823,1809
"1248","FBgn0063385","2R",17699702,17699788,86
"1249","FBgn0020278","3R",22619968,22639387,19419
"1250","FBgn0265266","3R",24859900,24860366,466
"1251","FBgn0031574","2L",3862668,3867507,4839
"1252","FBgn0265894","3L",20626580,20628498,1918
"1253","FBgn0260859","3L",9438482,9442267,3785
"1254","FBgn0025720","2R",20254966,20257390,2424
"1255","FBgn0052368","3L",7915437,7915846,409
"1256","FBgn0036221","3L",11921513,11922599,1086
"1257","FBgn0035035","2R",24603572,24604670,1098
"1258","FBgn0264905","3R",21720967,21723234,2267
"1259","FBgn0038697","3R",19373757,19374789,1032
"1260","FBgn0086346","3R",27696466,27700110,3644
"1261","FBgn0010435","2R",24976456,24986070,9614
"1262","FBgn0283434","X",20212738,20217259,4521
"1263","FBgn0086698","2L",1711302,1715851,4549
"1264","FBgn0052350","3L",23147656,23150499,2843
"1265","FBgn0014076","2L",11171167,11171665,498
"1266","FBgn0039881","3R",31805468,31806769,1301
"1267","FBgn0053243","X",14051818,14052541,723
"1268","FBgn0267283","2L",6133258,6133674,416
"1269","FBgn0085271","3L",12533996,12534403,407
"1270","FBgn0004592","3L",15654472,15656010,1538
"1271","FBgn0033784","2R",12934234,12936535,2301
"1272","FBgn0051337","3R",13543966,13545400,1434
"1273","FBgn0037117","3L",21680050,21683231,3181
"1274","FBgn0085279","3L",17476222,17477103,881
"1275","FBgn0039756","3R",30196360,30202998,6638
"1276","FBgn0050460","2R",17065971,17087633,21662
"1277","FBgn0038612","3R",18385828,18386887,1059
"1278","FBgn0000492","3R",29556386,29565244,8858
"1279","FBgn0015803","2L",20350434,20365254,14820
"1280","FBgn0050081","2R",15207993,15209786,1793
"1281","FBgn0026570","3L",2169553,2170971,1418
"1282","FBgn0039469","3R",26994832,26996442,1610
"1283","FBgn0264365","2L",18805445,18806205,760
"1284","FBgn0033588","2R",11233995,11234465,470
"1285","FBgn0033520","2R",10424436,10425471,1035
"1286","FBgn0040723","2L",1200671,1201220,549
"1287","FBgn0038700","3R",19387861,19389866,2005
"1288","FBgn0259164","3L",6066296,6071545,5249
"1289","FBgn0033164","2R",7400743,7401482,739
"1290","FBgn0263603","3L",16106594,16112626,6032
"1291","FBgn0051892","2L",8482084,8482155,71
"1292","FBgn0038752","3R",19921744,19925371,3627
"1293","FBgn0264477","3L",19543100,19543622,522
"1294","FBgn0037934","3R",11680972,11684342,3370
"1295","FBgn0260434","3L",19728994,19730402,1408
"1296","FBgn0266875","2L",3210515,3211156,641
"1297","FBgn0053534","3R",17622546,17622618,72
"1298","FBgn0030731","X",16270951,16273815,2864
"1299","FBgn0032339","2L",11091444,11095096,3652
"1300","FBgn0004832","X",4102955,4104197,1242
"1301","FBgn0265296","3L",7159199,7189931,30732
"1302","FBgn0027280","X",7941478,7946908,5430
"1303","FBgn0038318","3R",15325325,15328269,2944
"1304","FBgn0036396","3L",13997900,13999251,1351
"1305","FBgn0034551","2R",20792982,20793795,813
"1306","FBgn0038198","3R",14089517,14092425,2908
"1307","FBgn0004580","2R",16973927,16996057,22130
"1308","FBgn0034093","2R",16223218,16230680,7462
"1309","FBgn0063384","2R",17700220,17700305,85
"1310","FBgn0002878","X",13722246,13727113,4867
"1311","FBgn0051128","3R",24469397,24470310,913
"1312","FBgn0250833","3L",8325859,8328307,2448
"1313","FBgn0000565","3L",15511052,15513202,2150
"1314","FBgn0031629","2L",4796600,4801923,5323
"1315","FBgn0027287","X",15486922,15511223,24301
"1316","FBgn0270924","2L",9758342,9762375,4033
"1317","FBgn0085280","3L",17671622,17683581,11959
"1318","FBgn0037108","3L",21625806,21628571,2765
"1319","FBgn0004777","3R",6686728,6688039,1311
"1320","FBgn0033936","2R",14420324,14424764,4440
"1321","FBgn0264828","3R",12239677,12240527,850
"1322","FBgn0264712","3R",5393922,5399510,5588
"1323","FBgn0264753","2R",19311148,19356525,45377
"1324","FBgn0050469","2R",15501820,15503610,1790
"1325","FBgn0030836","X",17280918,17282726,1808
"1326","FBgn0262814","2L",5884888,5885491,603
"1327","FBgn0004865","3L",21226609,21266503,39894
"1328","FBgn0085197","2L",16134714,16135272,558
"1329","FBgn0030520","X",13745577,13755406,9829
"1330","FBgn0085303","3R",15731746,15732694,948
"1331","FBgn0086058","3R",14371675,14371746,71
"1332","FBgn0265421","3R",7285230,7285595,365
"1333","FBgn0045843","3R",7285962,7287629,1667
"1334","FBgn0024364","X",1354014,1356473,2459
"1335","FBgn0031621","2L",4687511,4688956,1445
"1336","FBgn0036842","3L",19059400,19062816,3416
"1337","FBgn0035787","3L",7469502,7470302,800
"1338","FBgn0035167","3L",841451,843701,2250
"1339","FBgn0262836","2R",10351533,10352161,628
"1340","FBgn0033387","2R",9157907,9161436,3529
"1341","FBgn0037369","3R",5734698,5736355,1657
"1342","FBgn0033785","2R",12936891,12940412,3521
"1343","FBgn0259955","2L",3700195,3700658,463
"1344","FBgn0030706","X",15910870,15921013,10143
"1345","FBgn0051086","3R",26185251,26186227,976
"1346","FBgn0036306","3L",12753239,12754774,1535
"1347","FBgn0260764","2R",17685814,17686410,596
"1348","FBgn0266038","2L",21958463,21959111,648
"1349","FBgn0035139","3L",433146,433906,760
"1350","FBgn0038097","3R",12965938,12967712,1774
"1351","FBgn0053239","X",14056895,14057618,723
"1352","FBgn0035287","3L",1876551,1883041,6490
"1353","FBgn0038389","3R",15963884,15964761,877
"1354","FBgn0263608","3L",16237723,16239462,1739
"1355","FBgn0038147","3R",13389059,13395197,6138
"1356","FBgn0051126","3R",24659621,24660265,644
"1357","FBgn0035769","3L",7353578,7356713,3135
"1358","FBgn0031501","2L",3042551,3043593,1042
"1359","FBgn0032337","2L",11083459,11085229,1770
"1360","FBgn0038129","3R",13269137,13272011,2874
"1361","FBgn0011818","2L",2492955,2498846,5891
"1362","FBgn0262143","3R",21736513,21736849,336
"1363","FBgn0052010","4",12640,25054,12414
"1364","FBgn0030828","X",17215304,17217365,2061
"1365","FBgn0265467","3L",4377368,4377999,631
"1366","FBgn0032717","2L",18833710,18839679,5969
"1367","FBgn0031690","2L",5212395,5215081,2686
"1368","FBgn0037107","3L",21620000,21625647,5647
"1369","FBgn0002989","2L",2989594,2992759,3165
"1370","FBgn0029521","X",315123,316566,1443
"1371","FBgn0266176","3R",21355692,21359768,4076
"1372","FBgn0263578","X",9236460,9236518,58
"1373","FBgn0264885","2L",3815438,3815948,510
"1374","FBgn0263509","X",9727923,9728488,565
"1375","FBgn0053202","3R",6529169,6593330,64161
"1376","FBgn0266953","3L",11284731,11285180,449
"1377","FBgn0035568","3L",4688929,4690070,1141
"1378","FBgn0053639","X",18210812,18226076,15264
"1379","FBgn0266819","2R",9559255,9565190,5935
"1380","FBgn0002524","2L",15499127,15505018,5891
"1381","FBgn0036062","3L",9966603,9968317,1714
"1382","FBgn0025709","2R",9078721,9082374,3653
"1383","FBgn0031182","X",21517434,21519218,1784
"1384","FBgn0262460","2L",19569490,19569561,71
"1385","FBgn0266906","2L",357329,358174,845
"1386","FBgn0036136","3L",11121966,11123216,1250
"1387","FBgn0266700","3R",31588279,31590411,2132
"1388","FBgn0265831","X",13390235,13390560,325
"1389","FBgn0052857","X",21615449,21617617,2168
"1390","FBgn0261268","2L",15265245,15272024,6779
"1391","FBgn0085334","3R",4242785,4243146,361
"1392","FBgn0267427","Y",3376224,3376984,760
"1393","FBgn0030854","X",17633691,17636044,2353
"1394","FBgn0034789","2R",22874769,22881436,6667
"1395","FBgn0031894","2L",7185461,7190010,4549
"1396","FBgn0086779","2L",21740041,21757466,17425
"1397","FBgn0039054","3R",23070516,23112730,42214
"1398","FBgn0030673","X",15710647,15712309,1662
"1399","FBgn0265166","3R",12891911,12892467,556
"1400","FBgn0033397","2R",9242320,9244410,2090
"1401","FBgn0262353","2L",12507939,12508504,565
"1402","FBgn0262464","2R",19661003,19661084,81
"1403","FBgn0267549","3L",16042395,16042968,573
"1404","FBgn0028372","2R",19670618,19673477,2859
"1405","FBgn0051739","2L",16827078,16832093,5015
"1406","FBgn0267991","2L",490835,492649,1814
"1407","FBgn0030484","X",13404749,13409323,4574
"1408","FBgn0034966","2R",24055306,24057599,2293
"1409","FBgn0033982","2R",14898312,14903095,4783
"1410","FBgn0001321","3R",10122365,10125664,3299
"1411","FBgn0265844","2R",20090795,20091295,500
"1412","FBgn0260766","3R",6374475,6377348,2873
"1413","FBgn0082598","3L",7369843,7373711,3868
"1414","FBgn0001087","X",13727204,13736278,9074
"1415","FBgn0031252","2L",418434,419652,1218
"1416","FBgn0053366","2R",19761343,19761477,134
"1417","FBgn0030588","X",14851005,14853269,2264
"1418","FBgn0050413","2R",23329543,23330068,525
"1419","FBgn0033861","2R",13608673,13609178,505
"1420","FBgn0037782","3R",10055356,10056083,727
"1421","FBgn0266419","X",20739538,20740308,770
"1422","FBgn0266372","3R",10761148,10761797,649
"1423","FBgn0002044","2L",19493251,19497978,4727
"1424","FBgn0262536","X",6199216,6199891,675
"1425","FBgn0004867","2L",9896265,9897552,1287
"1426","FBgn0030788","X",16787283,16789644,2361
"1427","FBgn0036579","3L",16229100,16231139,2039
"1428","FBgn0265048","3R",15844466,15853581,9115
"1429","FBgn0031064","X",19718923,19730199,11276
"1430","FBgn0029897","X",6741537,6744238,2701
"1431","FBgn0052252","3L",4221704,4222734,1030
"1432","FBgn0053665","X",6478138,6478849,711
"1433","FBgn0031910","2L",7410909,7412229,1320
"1434","FBgn0036389","3L",13965203,13973067,7864
"1435","FBgn0053260","3L",14760520,14761844,1324
"1436","FBgn0051674","2L",20831262,20832859,1597
"1437","FBgn0000046","3R",13425983,13428375,2392
"1438","FBgn0037917","3R",11581576,11585305,3729
"1439","FBgn0262969","3L",18440730,18441871,1141
"1440","FBgn0265914","2R",21068260,21069445,1185
"1441","FBgn0052207","3L",19477329,19478720,1391
"1442","FBgn0037239","3R",4378600,4381210,2610
"1443","FBgn0040360","X",1184778,1188585,3807
"1444","FBgn0039886","3R",31978121,31990909,12788
"1445","FBgn0034002","2R",15218379,15224795,6416
"1446","FBgn0267556","3L",7510942,7513354,2412
"1447","FBgn0033753","2R",12566185,12569061,2876
"1448","FBgn0031914","2L",7437492,7445882,8390
"1449","FBgn0036299","3L",12530436,12533724,3288
"1450","FBgn0036695","3L",17042797,17044465,1668
"1451","FBgn0030361","X",12009711,12012211,2500
"1452","FBgn0038690","3R",19226903,19228180,1277
"1453","FBgn0086071","3L",3222263,3222329,66
"1454","FBgn0036246","3L",12088626,12089225,599
"1455","FBgn0035538","3L",4367649,4380387,12738
"1456","FBgn0032470","2L",13106807,13109468,2661
"1457","FBgn0028415","3L",18469378,18469618,240
"1458","FBgn0042083","2R",6746381,6748954,2573
"1459","FBgn0031458","2L",2766233,2767281,1048
"1460","FBgn0266639","2R",17697532,17698796,1264
"1461","FBgn0266263","X",5680627,5682127,1500
"1462","FBgn0039217","3R",24712780,24717430,4650
"1463","FBgn0266979","3L",22496342,22497114,772
"1464","FBgn0029965","X",7864948,7866968,2020
"1465","FBgn0262235","X",4368309,4368399,90
"1466","FBgn0261853","2R",12418797,12419395,598
"1467","FBgn0023541","X",2173415,2175315,1900
"1468","FBgn0267159","3R",15004281,15004942,661
"1469","FBgn0262002","2L",8389881,8392398,2517
"1470","FBgn0038300","3R",15209204,15211347,2143
"1471","FBgn0086671","X",17144831,17144970,139
"1472","FBgn0000037","2R",24378630,24390294,11664
"1473","FBgn0024556","2R",13507557,13509332,1775
"1474","FBgn0033951","2R",14645270,14646344,1074
"1475","FBgn0037535","3R",7999832,8001064,1232
"1476","FBgn0264697","3L",19405539,19406013,474
"1477","FBgn0263502","X",17378376,17379004,628
"1478","FBgn0051604","2L",8541552,8541623,71
"1479","FBgn0025620","X",787855,790089,2234
"1480","FBgn0031239","2L",259949,267505,7556
"1481","FBgn0051491","3R",7130947,7131018,71
"1482","FBgn0001961","2L",13827941,13829741,1800
"1483","FBgn0010113","3R",30277932,30372382,94450
"1484","FBgn0266117","3L",14560000,14560953,953
"1485","FBgn0039408","3R",26061268,26063011,1743
"1486","FBgn0036362","3L",13437954,13439009,1055
"1487","FBgn0050298","2R",7069970,7070043,73
"1488","FBgn0037081","3L",21420388,21433134,12746
"1489","FBgn0032363","2L",11508399,11517081,8682
"1490","FBgn0029952","X",7585303,7586131,828
"1491","FBgn0266316","2L",20874114,20875540,1426
"1492","FBgn0037068","3L",21294492,21296698,2206
"1493","FBgn0032945","2L",21371227,21377995,6768
"1494","FBgn0082928","2R",9095996,9096080,84
"1495","FBgn0053143","2R",22614328,22634084,19756
"1496","FBgn0040106","2L",620298,621201,903
"1497","FBgn0002535","2R",8437647,8438495,848
"1498","FBgn0036973","3L",20345736,20347942,2206
"1499","FBgn0034397","2R",18830331,18833241,2910
"1500","FBgn0053769","3L",22647927,22648519,592
"1501","FBgn0038870","3R",21219077,21222843,3766
"1502","FBgn0030778","X",16696131,16711145,15014
"1503","FBgn0024509","3R",23356278,23358531,2253
"1504","FBgn0029836","X",6067958,6069264,1306
"1505","FBgn0035283","3L",1857165,1859047,1882
"1506","FBgn0051852","2L",13367617,13369021,1404
"1507","FBgn0052103","3L",12402295,12414842,12547
"1508","FBgn0262029","2L",8466817,8488671,21854
"1509","FBgn0265363","2R",11844378,11845099,721
"1510","FBgn0033599","2R",11256507,11258767,2260
"1511","FBgn0036104","3L",10876315,10879037,2722
"1512","FBgn0266486","2R",9186670,9192096,5426
"1513","FBgn0025118","X",3827622,3827693,71
"1514","FBgn0003372","2L",4937409,4941423,4014
"1515","FBgn0036775","3L",18107848,18109574,1726
"1516","FBgn0036343","3L",13060522,13061394,872
"1517","FBgn0267428","2R",326768,705848,379080
"1518","FBgn0037899","3R",11430740,11431582,842
"1519","FBgn0037445","3R",6449944,6456676,6732
"1520","FBgn0037526","3R",7887045,7890150,3105
"1521","FBgn0034914","2R",23845001,23847024,2023
"1522","FBgn0016684","2R",14842720,14845874,3154
"1523","FBgn0029689","X",3965435,3968655,3220
"1524","FBgn0031306","2L",1134693,1141156,6463
"1525","FBgn0030420","X",12760642,12763611,2969
"1526","FBgn0031814","2L",6448464,6455929,7465
"1527","FBgn0034237","2R",17536213,17539142,2929
"1528","FBgn0267284","2L",4240014,4240820,806
"1529","FBgn0033005","2R",5090581,5095090,4509
"1530","FBgn0037603","3R",8652821,8653847,1026
"1531","FBgn0037677","3R",9329223,9330331,1108
"1532","FBgn0038359","3R",15779805,15781092,1287
"1533","FBgn0010359","2R",11349061,11349870,809
"1534","FBgn0263206","2L",13773997,13774355,358
"1535","FBgn0037468","3R",7074859,7077981,3122
"1536","FBgn0010516","2R",11688569,11690863,2294
"1537","FBgn0285911","3R",9267019,9270224,3205
"1538","FBgn0263290","2R",19144546,19145351,805
"1539","FBgn0053105","3R",9687402,9692794,5392
"1540","FBgn0034135","2R",16552258,16558486,6228
"1541","FBgn0015001","2R",11356720,11357537,817
"1542","FBgn0250867","2L",20965520,21052164,86644
"1543","FBgn0031682","2L",5093976,5095910,1934
"1544","FBgn0051119","3R",24854496,24856243,1747
"1545","FBgn0030981","X",19081665,19082566,901
"1546","FBgn0265948","2L",16195845,16196245,400
"1547","FBgn0262216","X",19551678,19551778,100
"1548","FBgn0053858","2L",21526459,21527481,1022
"1549","FBgn0015569","3R",7486583,7493845,7262
"1550","FBgn0028331","X",10348680,10366273,17593
"1551","FBgn0031522","2L",3330928,3332876,1948
"1552","FBgn0266205","2L",18185160,18185857,697
"1553","FBgn0265977","2R",22318995,22320895,1900
"1554","FBgn0263325","2L",18251381,18252697,1316
"1555","FBgn0000659","3R",28580976,28585264,4288
"1556","FBgn0266751","3R",22194979,22209477,14498
"1557","FBgn0043455","3R",24047790,24049168,1378
"1558","FBgn0000524","X",6533999,6538575,4576
"1559","FBgn0037466","3R",7067401,7071624,4223
"1560","FBgn0266943","3L",15457953,15458309,356
"1561","FBgn0051092","3R",25698727,25740465,41738
"1562","FBgn0036353","3L",13385946,13387907,1961
"1563","FBgn0039519","3R",27478675,27482904,4229
"1564","FBgn0050391","2R",21264805,21266342,1537
"1565","FBgn0033178","2R",7463504,7464987,1483
"1566","FBgn0264297","2R",24123167,24126630,3463
"1567","FBgn0264077","X",16522967,16525415,2448
"1568","FBgn0037312","3R",5353717,5354747,1030
"1569","FBgn0265274","3R",28853606,28859497,5891
"1570","FBgn0030774","X",16700446,16701972,1526
"1571","FBgn0053360","2R",19763544,19763678,134
"1572","FBgn0267707","3R",19921313,19921671,358
"1573","FBgn0266735","3R",25661712,25662663,951
"1574","FBgn0051334","3R",20891122,20891193,71
"1575","FBgn0266146","2L",14532484,14533471,987
"1576","FBgn0036702","3L",17238613,17242128,3515
"1577","FBgn0265041","3R",18208779,18209282,503
"1578","FBgn0003041","3L",7896109,7911954,15845
"1579","FBgn0030449","X",13107382,13108194,812
"1580","FBgn0037040","3L",20962655,20966762,4107
"1581","FBgn0040063","2R",23244044,23245399,1355
"1582","FBgn0036321","3L",12885039,12889244,4205
"1583","FBgn0267488","2L",8074117,8082982,8865
"1584","FBgn0031042","X",19618819,19621245,2426
"1585","FBgn0266667","3L",8411851,8415910,4059
"1586","FBgn0262368","3L",3251022,3251118,96
"1587","FBgn0259922","2L",15547519,15548243,724
"1588","FBgn0004394","2L",12657165,12686306,29141
"1589","FBgn0029093","2R",7815339,7823569,8230
"1590","FBgn0036030","3L",9683579,9696700,13121
"1591","FBgn0262621","2L",3701826,3702248,422
"1592","FBgn0052119","3L",13246864,13248702,1838
"1593","FBgn0052603","X",14184561,14185807,1246
"1594","FBgn0036520","3L",15610631,15612828,2197
"1595","FBgn0015774","X",14686038,14749376,63338
"1596","FBgn0263561","2L",8141540,8141662,122
"1597","FBgn0261361","3L",19745834,19749744,3910
"1598","FBgn0266365","2L",11835320,11835903,583
"1599","FBgn0003651","3R",12258737,12302785,44048
"1600","FBgn0028504","3L",2595842,2599579,3737
"1601","FBgn0011869","2R",20229481,20229551,70
"1602","FBgn0035383","3L",2981022,2983551,2529
"1603","FBgn0053107","3R",22583352,22584718,1366
"1604","FBgn0026197","3L",17400272,17401348,1076
"1605","FBgn0046706","2R",4014111,4049342,35231
"1606","FBgn0053736","2L",21488517,21488552,35
"1607","FBgn0004842","3R",26996980,27057935,60955
"1608","FBgn0267697","3L",16663903,16664913,1010
"1609","FBgn0012034","3L",21270722,21280243,9521
"1610","FBgn0032787","2L",19482232,19484705,2473
"1611","FBgn0265880","3L",18135786,18136231,445
"1612","FBgn0030792","X",16800930,16802000,1070
"1613","FBgn0003116","X",2181211,2182916,1705
"1614","FBgn0266965","3L",6883321,6883601,280
"1615","FBgn0001987","2L",15756002,15762758,6756
"1616","FBgn0264474","3L",4745911,4746632,721
"1617","FBgn0267100","X",9581493,9581917,424
"1618","FBgn0026577","2L",21221312,21232059,10747
"1619","FBgn0267872","Y",3084618,3085392,774
"1620","FBgn0045478","3L",4028605,4032032,3427
"1621","FBgn0031459","2L",2770135,2770904,769
"1622","FBgn0038199","3R",14092504,14096835,4331
"1623","FBgn0261929","3R",8578205,8629996,51791
"1624","FBgn0050054","2R",12623726,12625352,1626
"1625","FBgn0036518","3L",15588860,15609125,20265
"1626","FBgn0053463","2R",15895829,15896427,598
"1627","FBgn0038989","3R",22584773,22586209,1436
"1628","FBgn0003227","3R",15823019,15832632,9613
"1629","FBgn0036970","3L",20342634,20344319,1685
"1630","FBgn0261872","3L",17036859,17042574,5715
"1631","FBgn0011864","2L",14518621,14518691,70
"1632","FBgn0052212","3L",19487560,19488348,788
"1633","FBgn0030221","X",10622355,10623225,870
"1634","FBgn0035521","3L",4262705,4263464,759
"1635","FBgn0031492","2L",3023226,3026439,3213
"1636","FBgn0001218","X",11801696,11807117,5421
"1637","FBgn0086043","X",2101927,2102025,98
"1638","FBgn0011936","2R",6153506,6153579,73
"1639","FBgn0015795","3R",23993008,23995452,2444
"1640","FBgn0032707","2L",18714453,18732524,18071
"1641","FBgn0038102","3R",12987376,12988511,1135
"1642","FBgn0037534","3R",7981817,7995852,14035
"1643","FBgn0259720","3L",19263766,19266838,3072
"1644","FBgn0037892","3R",11407918,11408756,838
"1645","FBgn0003117","3R",16026079,16041796,15717
"1646","FBgn0265901","X",2175817,2180816,4999
"1647","FBgn0031460","2L",2770884,2771776,892
"1648","FBgn0013954","2R",19290109,19290962,853
"1649","FBgn0038653","3R",18799280,18849224,49944
"1650","FBgn0050467","2R",15538175,15540014,1839
"1651","FBgn0267523","X",23291549,23291671,122
"1652","FBgn0267089","X",7445387,7450119,4732
"1653","FBgn0025674","2L",22124285,22130142,5857
"1654","FBgn0264430","3R",13574825,13575479,654
"1655","FBgn0267690","3R",6306884,6309030,2146
"1656","FBgn0032965","2L",21896666,21898289,1623
"1657","FBgn0037240","3R",4381306,4387018,5712
"1658","FBgn0050509","2R",13437866,13437939,73
"1659","FBgn0038542","3R",17750129,17763188,13059
"1660","FBgn0037489","3R",7244232,7246969,2737
"1661","FBgn0038619","3R",18404940,18406002,1062
"1662","FBgn0003129","3R",8319025,8333792,14767
"1663","FBgn0263769","X",18369811,18370118,307
"1664","FBgn0040736","2R",18387895,18388734,839
"1665","FBgn0032704","2L",18704570,18705703,1133
"1666","FBgn0028541","2L",13746952,13773905,26953
"1667","FBgn0265925","3L",11246885,11247232,347
"1668","FBgn0036821","3L",18878250,18890483,12233
"1669","FBgn0053421","2R",19741040,19741174,134
"1670","FBgn0032499","2L",13286777,13289556,2779
"1671","FBgn0264438","2L",15011815,15012667,852
"1672","FBgn0036529","3L",15683872,15686598,2726
"1673","FBgn0266443","3R",30123801,30124735,934
"1674","FBgn0263850","2R",20778249,20779487,1238
"1675","FBgn0030352","X",11891732,11893745,2013
"1676","FBgn0030530","X",13826041,13830317,4276
"1677","FBgn0037038","3L",20960398,20961386,988
"1678","FBgn0039092","3R",23593625,23596273,2648
"1679","FBgn0037070","3L",21301785,21304658,2873
"1680","FBgn0034718","2R",22298214,22311937,13723
"1681","FBgn0051249","3R",17685689,17687071,1382
"1682","FBgn0010602","2L",540599,542580,1981
"1683","FBgn0035932","3L",8808544,8809307,763
"1684","FBgn0086442","2L",19034444,19041541,7097
"1685","FBgn0263132","X",10016845,10050803,33958
"1686","FBgn0039665","3R",29491524,29493518,1994
"1687","FBgn0010329","X",7995697,8027394,31697
"1688","FBgn0039718","3R",29903240,29903825,585
"1689","FBgn0053512","3R",11533483,11542949,9466
"1690","FBgn0033781","2R",12923904,12924664,760
"1691","FBgn0052507","X",20780150,20781220,1070
"1692","FBgn0263664","3R",22964038,22964630,592
"1693","FBgn0038246","3R",14609642,14618987,9345
"1694","FBgn0003507","3R",15986152,16004081,17929
"1695","FBgn0039323","3R",25314494,25316116,1622
"1696","FBgn0066293","2R",6943096,6943995,899
"1697","FBgn0023535","X",509435,528028,18593
"1698","FBgn0034194","2R",17108844,17114360,5516
"1699","FBgn0036707","3L",17322841,17324493,1652
"1700","FBgn0053629","3R",10061686,10062314,628
"1701","FBgn0267862","Y",3258406,3259223,817
"1702","FBgn0263501","3R",17287788,17288818,1030
"1703","FBgn0033265","2R",8124981,8127242,2261
"1704","FBgn0030541","X",14181028,14183315,2287
"1705","FBgn0263745","2L",16700940,16703197,2257
"1706","FBgn0033392","2R",9204410,9207124,2714
"1707","FBgn0030251","X",10927399,10929712,2313
"1708","FBgn0250830","2R",4785855,4788965,3110
"1709","FBgn0032088","2L",9012188,9014149,1961
"1710","FBgn0029816","X",5845280,5846106,826
"1711","FBgn0264906","3R",24054391,24055092,701
"1712","FBgn0262177","2L",857542,857632,90
"1713","FBgn0259785","3L",21286099,21290310,4211
"1714","FBgn0037015","3L",20712838,20719200,6362
"1715","FBgn0085736","3L",24927130,24927710,580
"1716","FBgn0264447","2L",9372102,9374004,1902
"1717","FBgn0026380","3R",9005313,9006226,913
"1718","FBgn0050428","2R",25251927,25254535,2608
"1719","FBgn0260480","3L",2525799,2526973,1174
"1720","FBgn0265995","2L",15160651,15161083,432
"1721","FBgn0050198","2R",25076005,25076076,71
"1722","FBgn0033097","2R",6718196,6719533,1337
"1723","FBgn0263867","2L",5432822,5433522,700
"1724","FBgn0037923","3R",11625051,11626638,1587
"1725","FBgn0039462","3R",26945534,26947248,1714
"1726","FBgn0053493","3L",10692530,10693167,637
"1727","FBgn0033872","2R",13826371,13833503,7132
"1728","FBgn0262215","2R",14145351,14145524,173
"1729","FBgn0013755","3L",1647869,1648612,743
"1730","FBgn0267160","3R",15136985,15140121,3136
"1731","FBgn0052177","3L",17647442,17654280,6838
"1732","FBgn0038204","3R",14111151,14112166,1015
"1733","FBgn0005558","4",697689,721173,23484
"1734","FBgn0265850","2R",20293895,20294695,800
"1735","FBgn0004903","3R",26872129,26875742,3613
"1736","FBgn0032194","2L",10211143,10213721,2578
"1737","FBgn0266279","X",6746399,6748020,1621
"1738","FBgn0015797","2L",12107221,12109116,1895
"1739","FBgn0031282","2L",815993,818096,2103
"1740","FBgn0034145","2R",16607654,16624894,17240
"1741","FBgn0031937","2L",7723045,7726298,3253
"1742","FBgn0020762","2L",4333913,4345776,11863
"1743","FBgn0030514","X",13718734,13721977,3243
"1744","FBgn0054054","2R",11409810,11410438,628
"1745","FBgn0262417","3L",21668714,21668802,88
"1746","FBgn0265543","2L",16947610,16950070,2460
"1747","FBgn0037428","3R",6330248,6331809,1561
"1748","FBgn0038078","3R",12694229,12694842,613
"1749","FBgn0033321","2R",8696428,8698583,2155
"1750","FBgn0034162","2R",16869402,16871851,2449
"1751","FBgn0264857","3R",16831116,16923231,92115
"1752","FBgn0036801","3L",18625959,18667177,41218
"1753","FBgn0264954","X",3802316,3811040,8724
"1754","FBgn0004362","2R",21701458,21716727,15269
"1755","FBgn0261568","2L",14842358,14843108,750
"1756","FBgn0083986","3R",24814262,24814930,668
"1757","FBgn0263998","2R",13142834,13152677,9843
"1758","FBgn0052281","3L",3169375,3170913,1538
"1759","FBgn0034052","2R",15940610,15941483,873
"1760","FBgn0035733","3L",7058930,7077462,18532
"1761","FBgn0263116","2R",19022325,19032642,10317
"1762","FBgn0052266","3L",3790804,3791560,756
"1763","FBgn0266859","2R",7451670,7452365,695
"1764","FBgn0001235","3R",10507561,10639568,132007
"1765","FBgn0266622","2R",7325896,7335195,9299
"1766","FBgn0032293","2L",10732653,10733307,654
"1767","FBgn0053827","2L",21474593,21475121,528
"1768","FBgn0003189","X",16655359,16668712,13353
"1769","FBgn0037916","3R",11578826,11581476,2650
"1770","FBgn0053169","3L",22863864,22864496,632
"1771","FBgn0264960","X",16815495,16815945,450
"1772","FBgn0264086","2L",325522,329761,4239
"1773","FBgn0053768","3L",22647187,22647748,561
"1774","FBgn0034825","2R",23128604,23130189,1585
"1775","FBgn0010383","X",18688538,18693042,4504
"1776","FBgn0030013","X",8157628,8159348,1720
"1777","FBgn0264273","2R",16386524,16431758,45234
"1778","FBgn0266870","2L",14974468,14975001,533
"1779","FBgn0002924","3R",29804290,29807127,2837
"1780","FBgn0051438","3R",21409123,21409924,801
"1781","FBgn0032171","2L",9956175,9957237,1062
"1782","FBgn0038415","3R",16325492,16327331,1839
"1783","FBgn0050438","2R",5496674,5549543,52869
"1784","FBgn0260440","3R",30476684,30478849,2165
"1785","FBgn0039464","3R",26949692,26958491,8799
"1786","FBgn0261016","2R",9587953,9599732,11779
"1787","FBgn0039688","3R",29725830,29735360,9530
"1788","FBgn0034464","2R",19662436,19663738,1302
"1789","FBgn0063373","2R",17702873,17702949,76
"1790","FBgn0034496","2R",20275973,20278915,2942
"1791","FBgn0030266","X",11112395,11124726,12331
"1792","FBgn0037432","3R",6343002,6343799,797
"1793","FBgn0031971","2L",7998869,7999676,807
"1794","FBgn0085491","3L",8328583,8330237,1654
"1795","FBgn0013681","mitochondrion_genome",5608,5961,353
"1796","FBgn0038407","3R",16198000,16203083,5083
"1797","FBgn0033602","2R",11265126,11266856,1730
"1798","FBgn0030093","X",9149309,9151976,2667
"1799","FBgn0039685","3R",29716254,29716896,642
"1800","FBgn0036522","3L",15619901,15624130,4229
"1801","FBgn0004593","3L",15656655,15657390,735
"1802","FBgn0267041","X",16307032,16308687,1655
"1803","FBgn0031597","2L",4380722,4382735,2013
"1804","FBgn0034440","2R",19380543,19384965,4422
"1805","FBgn0014465","X",8473837,8476071,2234
"1806","FBgn0032198","2L",10232507,10234450,1943
"1807","FBgn0033257","2R",8091696,8096948,5252
"1808","FBgn0038274","3R",14895703,14898372,2669
"1809","FBgn0053465","2R",15819114,15821114,2000
"1810","FBgn0260720","2R",21631421,21634040,2619
"1811","FBgn0004406","2L",13823980,13827772,3792
"1812","FBgn0265983","2R",22689095,22689395,300
"1813","FBgn0011581","3R",24341551,24343825,2274
"1814","FBgn0015777","2L",6789770,6798862,9092
"1815","FBgn0263503","X",18586223,18587219,996
"1816","FBgn0039189","3R",24358095,24360144,2049
"1817","FBgn0264864","2L",2083362,2084419,1057
"1818","FBgn0053244","X",14050549,14051272,723
"1819","FBgn0035969","3L",9211880,9215256,3376
"1820","FBgn0265536","2R",17140579,17141194,615
"1821","FBgn0262962","3R",24830301,24830973,672
"1822","FBgn0033391","2R",9186670,9192096,5426
"1823","FBgn0265072","2L",12931551,12932340,789
"1824","FBgn0267426","Y",3370887,3371602,715
"1825","FBgn0027872","2R",17695776,17698362,2586
"1826","FBgn0030874","X",17850460,17851889,1429
"1827","FBgn0031247","2L",292419,293222,803
"1828","FBgn0023509","X",1908239,1920318,12079
"1829","FBgn0037926","3R",11650971,11655691,4720
"1830","FBgn0024945","3L",203730,205309,1579
"1831","FBgn0250831","3R",25806445,25806961,516
"1832","FBgn0015623","2L",6338836,6346280,7444
"1833","FBgn0024227","2L",10856797,10858094,1297
"1834","FBgn0036309","3L",12768432,12773573,5141
"1835","FBgn0039428","3R",26456877,26457242,365
"1836","FBgn0053238","X",14058164,14058889,725
"1837","FBgn0052986","2L",8862776,8863743,967
"1838","FBgn0037842","3R",10853374,10854451,1077
"1839","FBgn0063127","3R",6699560,6700164,604
"1840","FBgn0267002","2R",16751503,16772671,21168
"1841","FBgn0262568","2R",17257156,17257886,730
"1842","FBgn0037248","3R",4422483,4429335,6852
"1843","FBgn0032813","2L",19582823,19583990,1167
"1844","FBgn0035785","3L",7456149,7458608,2459
"1845","FBgn0036638","3L",16544567,16545628,1061
"1846","FBgn0017567","3R",15836048,15837117,1069
"1847","FBgn0052647","X",12771844,12784958,13114
"1848","FBgn0266041","2R",23908474,23908875,401
"1849","FBgn0013733","2R",13864237,13942110,77873
"1850","FBgn0261617","X",9665442,9687066,21624
"1851","FBgn0039707","3R",29835950,29837447,1497
"1852","FBgn0259171","X",12785563,12897327,111764
"1853","FBgn0266404","3R",29031028,29034098,3070
"1854","FBgn0050394","2R",21320040,21323320,3280
"1855","FBgn0052572","X",16721183,16726948,5765
"1856","FBgn0003382","2R",11324314,11336463,12149
"1857","FBgn0053460","2R",15694092,15695232,1140
"1858","FBgn0031942","2L",7752170,7753186,1016
"1859","FBgn0035612","3L",5538411,5551159,12748
"1860","FBgn0053909","2L",21419531,21419943,412
"1861","FBgn0037436","3R",6349243,6350512,1269
"1862","FBgn0267904","Y",3252956,3253357,401
"1863","FBgn0002526","3L",6203831,6218022,14191
"1864","FBgn0031240","2L",269088,271626,2538
"1865","FBgn0260446","2L",15016331,15034704,18373
"1866","FBgn0261068","2L",16742315,16743100,785
"1867","FBgn0016650","3R",17725777,17733207,7430
"1868","FBgn0030030","X",8273412,8276450,3038
"1869","FBgn0038122","3R",13181304,13182154,850
"1870","FBgn0262317","2L",6045627,6045713,86
"1871","FBgn0266591","3L",22699433,22699870,437
"1872","FBgn0020618","2L",7825347,7827315,1968
"1873","FBgn0036206","3L",11790212,11793283,3071
"1874","FBgn0027101","4",1225089,1230713,5624
"1875","FBgn0037328","3R",5465630,5467101,1471
"1876","FBgn0039178","3R",24283955,24288617,4662
"1877","FBgn0052011","4",5829,11765,5936
"1878","FBgn0266043","2L",2082031,2082347,316
"1879","FBgn0020378","X",9729648,9756369,26721
"1880","FBgn0262532","3L",17868740,17870573,1833
"1881","FBgn0036159","3L",11445161,11446579,1418
"1882","FBgn0265928","3L",11248129,11251001,2872
"1883","FBgn0003254","2R",19270078,19281396,11318
"1884","FBgn0030286","X",11325385,11334071,8686
"1885","FBgn0025739","X",4636318,4639112,2794
"1886","FBgn0263035","3L",22503869,22504423,554
"1887","FBgn0032868","2L",20634515,20635167,652
"1888","FBgn0267077","X",14540747,14541997,1250
"1889","FBgn0029666","X",3485650,3490915,5265
"1890","FBgn0037205","3L",22901912,22905470,3558
"1891","FBgn0024245","2L",19338669,19363227,24558
"1892","FBgn0031270","2L",602813,604430,1617
"1893","FBgn0033048","2R",5960275,5966856,6581
"1894","FBgn0051809","2L",16853620,16858714,5094
"1895","FBgn0034327","2R",18302945,18303977,1032
"1896","FBgn0050403","2R",21709895,21711613,1718
"1897","FBgn0045498","2L",1789141,1790361,1220
"1898","FBgn0263477","3R",9713607,9713765,158
"1899","FBgn0011282","3R",7250725,7251957,1232
"1900","FBgn0031913","2L",7430530,7433516,2986
"1901","FBgn0265887","3L",19560820,19561190,370
"1902","FBgn0051789","2L",18605928,18606684,756
"1903","FBgn0085371","3L",5503528,5510860,7332
"1904","FBgn0004911","3L",3934718,3935992,1274
"1905","FBgn0266820","2L",12315777,12316122,345
"1906","FBgn0265262","2L",13000770,13004107,3337
"1907","FBgn0033853","2R",13537371,13547577,10206
"1908","FBgn0032809","2L",19563930,19565158,1228
"1909","FBgn0034907","2R",23804811,23806144,1333
"1910","FBgn0004436","3R",4948755,4952682,3927
"1911","FBgn0267685","3R",14527185,14527980,795
"1912","FBgn0266564","3R",18157693,18158297,604
"1913","FBgn0037012","3L",20527972,20540417,12445
"1914","FBgn0028691","3R",23731375,23733462,2087
"1915","FBgn0085227","2R",19682446,19682977,531
"1916","FBgn0085511","211000022279264",180,614,434
"1917","FBgn0039689","3R",29736965,29738070,1105
"1918","FBgn0050206","2R",21161063,21161134,71
"1919","FBgn0052546","X",18565764,18565835,71
"1920","FBgn0061188","2R",24498083,24498669,586
"1921","FBgn0265076","2L",20710096,20711006,910
"1922","FBgn0259821","3R",4077939,4104326,26387
"1923","FBgn0263241","3L",11070526,11073348,2822
"1924","FBgn0031634","2L",4830846,4835300,4454
"1925","FBgn0012010","3L",13433048,13433120,72
"1926","FBgn0039560","3R",27938245,27942778,4533
"1927","FBgn0262455","2L",20487441,20487531,90
"1928","FBgn0016054","2L",20643351,20645791,2440
"1929","FBgn0035833","3L",8087635,8091786,4151
"1930","FBgn0004171","3R",28292798,28293863,1065
"1931","FBgn0051533","3R",14154728,14157431,2703
"1932","FBgn0037836","3R",10794058,10803955,9897
"1933","FBgn0083032","2L",20419932,20420065,133
"1934","FBgn0026326","2R",9288957,9291565,2608
"1935","FBgn0036192","3L",11689631,11691399,1768
"1936","FBgn0034618","2R",21312399,21319569,7170
"1937","FBgn0003137","3R",28520665,28540324,19659
"1938","FBgn0259824","3L",15988236,15992464,4228
"1939","FBgn0265308","2R",8650697,8651496,799
"1940","FBgn0041234","2R",23542510,23543885,1375
"1941","FBgn0051784","2L",17123307,17125961,2654
"1942","FBgn0031184","X",22447183,22449491,2308
"1943","FBgn0035142","3L",543060,581099,38039
"1944","FBgn0261675","X",20934869,20939503,4634
"1945","FBgn0038149","3R",13398526,13401862,3336
"1946","FBgn0265377","3R",8287169,8287698,529
"1947","FBgn0261984","3R",19853908,19861291,7383
"1948","FBgn0037566","3R",8301440,8302770,1330
"1949","FBgn0265765","2R",19897495,19898695,1200
"1950","FBgn0062412","3R",8317612,8319205,1593
"1951","FBgn0053641","2L",13529042,13529821,779
"1952","FBgn0031877","2L",6960377,6961653,1276
"1953","FBgn0266397","3R",26001201,26002464,1263
"1954","FBgn0265605","2R",16107440,16110017,2577
"1955","FBgn0029170","3R",27049220,27051004,1784
"1956","FBgn0267661","3R",4395549,4397548,1999
"1957","FBgn0033380","2R",9114274,9116030,1756
"1958","FBgn0031992","2L",8161796,8162452,656
"1959","FBgn0034590","2R",21129463,21142261,12798
"1960","FBgn0263246","3L",3248015,3249044,1029
"1961","FBgn0051583","3R",8139533,8139606,73
"1962","FBgn0039808","3R",30877084,30881027,3943
"1963","FBgn0032620","2L",16900535,16902218,1683
"1964","FBgn0083961","2L",4965673,4966399,726
"1965","FBgn0005694","3L",21433422,21438639,5217
"1966","FBgn0044028","3L",16023480,16032752,9272
"1967","FBgn0266596","3L",9695043,9695650,607
"1968","FBgn0052343","3L",324985,327992,3007
"1969","FBgn0036619","3L",16365894,16367340,1446
"1970","FBgn0038927","3R",22032150,22034286,2136
"1971","FBgn0261454","3L",17628057,17628203,146
"1972","FBgn0263385","4",426067,426601,534
"1973","FBgn0031254","2L",421771,422489,718
"1974","FBgn0010415","2R",21392402,21481176,88774
"1975","FBgn0267900","Y",3236012,3237041,1029
"1976","FBgn0260942","3R",22550680,22556494,5814
"1977","FBgn0036958","3L",20233173,20241903,8730
"1978","FBgn0267350","X",2624804,2633672,8868
"1979","FBgn0029114","3L",15235619,15242832,7213
"1980","FBgn0259966","2R",15192628,15193228,600
"1981","FBgn0085664","2L",23415916,23416153,237
"1982","FBgn0261561","3R",5813609,5818820,5211
"1983","FBgn0261278","2L",16680054,16699926,19872
"1984","FBgn0032421","2L",12172981,12174091,1110
"1985","FBgn0265378","3R",26092850,26093722,872
"1986","FBgn0026376","3L",13906897,13925335,18438
"1987","FBgn0266033","2L",623900,624323,423
"1988","FBgn0016123","3R",31048929,31052540,3611
"1989","FBgn0038301","3R",15211277,15213658,2381
"1990","FBgn0036421","3L",14368925,14369707,782
"1991","FBgn0034066","2R",16016042,16017154,1112
"1992","FBgn0033902","2R",14163066,14164825,1759
"1993","FBgn0263556","3L",9144593,9144697,104
"1994","FBgn0011937","2R",6153186,6153259,73
"1995","FBgn0051065","3R",27163124,27165131,2007
"1996","FBgn0034380","2R",18708152,18710865,2713
"1997","FBgn0085307","3R",17120465,17120808,343
"1998","FBgn0036336","3L",13018266,13019687,1421
"1999","FBgn0026874","X",803424,804921,1497
"2000","FBgn0262027","3L",19424702,19424926,224
"2001","FBgn0013278","3R",12505793,12508139,2346
"2002","FBgn0052557","X",17852958,17856129,3171
"2003","FBgn0265808","2L",12571160,12571606,446
"2004","FBgn0085292","3L",265595,265908,313
"2005","FBgn0031135","X",20874941,20875303,362
"2006","FBgn0264491","3R",22042191,22079321,37130
"2007","FBgn0033640","2R",11654898,11655762,864
"2008","FBgn0035598","3L",5234483,5236631,2148
"2009","FBgn0046114","3R",22685006,22686510,1504
"2010","FBgn0027080","3L",16417349,16419302,1953
"2011","FBgn0029676","X",3789969,3792477,2508
"2012","FBgn0262794","3R",17630717,17645262,14545
"2013","FBgn0264980","2R",6068795,6069795,1000
"2014","FBgn0259916","3L",8154681,8158900,4219
"2015","FBgn0037448","3R",6478311,6495025,16714
"2016","FBgn0263874","2L",11307753,11308038,285
"2017","FBgn0030376","X",12107200,12113357,6157
"2018","FBgn0040009","2L",22537668,22540597,2929
"2019","FBgn0265667","2R",19604695,19605295,600
"2020","FBgn0082976","3R",28601698,28601847,149
"2021","FBgn0263829","X",22872812,22875367,2555
"2022","FBgn0041723","2L",10368025,10373900,5875
"2023","FBgn0267176","X",10891432,10891973,541
"2024","FBgn0031764","2L",6022951,6024539,1588
"2025","FBgn0016926","2L",1114654,1128953,14299
"2026","FBgn0030980","X",19077720,19078592,872
"2027","FBgn0086026","2R",21335383,21335456,73
"2028","FBgn0029708","X",4530231,4535464,5233
"2029","FBgn0038213","3R",14228018,14229145,1127
"2030","FBgn0030746","X",16399782,16405122,5340
"2031","FBgn0023216","X",3668837,3671502,2665
"2032","FBgn0263709","2R",17306759,17307302,543
"2033","FBgn0050177","2R",23801542,23803070,1528
"2034","FBgn0266262","X",4311989,4315059,3070
"2035","FBgn0052451","3L",22749444,22787631,38187
"2036","FBgn0261085","X",13359248,13368179,8931
"2037","FBgn0038658","3R",18904933,18905655,722
"2038","FBgn0031419","2L",2374713,2375697,984
"2039","FBgn0263552","X",1373623,1373755,132
"2040","FBgn0035415","3L",3197045,3197631,586
"2041","FBgn0031450","2L",2739986,2743377,3391
"2042","FBgn0035409","3L",3171614,3172545,931
"2043","FBgn0035162","3L",826720,833385,6665
"2044","FBgn0267988","3R",4235294,4235973,679
"2045","FBgn0267638","3L",17696391,17696967,576
"2046","FBgn0037356","3R",5637234,5638657,1423
"2047","FBgn0053970","3R",26318355,26362588,44233
"2048","FBgn0267087","X",6860339,6863235,2896
"2049","FBgn0250791","3L",20313632,20316577,2945
"2050","FBgn0086055","3R",11222405,11222489,84
"2051","FBgn0038804","3R",20562486,20564067,1581
"2052","FBgn0040299","2L",7666047,7689459,23412
"2053","FBgn0037730","3R",9681415,9684264,2849
"2054","FBgn0265794","2L",11318944,11319259,315
"2055","FBgn0040797","3L",16272909,16273608,699
"2056","FBgn0262546","2L",7839777,7840414,637
"2057","FBgn0040384","X",2782906,2790567,7661
"2058","FBgn0265080","2L",19262470,19263057,587
"2059","FBgn0036897","3L",19637207,19642816,5609
"2060","FBgn0035954","3L",9005196,9007249,2053
"2061","FBgn0036880","3L",19520945,19527272,6327
"2062","FBgn0267020","X",22806501,22807399,898
"2063","FBgn0030403","X",12592555,12595624,3069
"2064","FBgn0037998","3R",12213792,12219686,5894
"2065","FBgn0286006","2R",12170373,12170462,89
"2066","FBgn0053502","X",21609357,21611526,2169
"2067","FBgn0265101","3R",8304190,8305274,1084
"2068","FBgn0033359","2R",8969346,8985900,16554
"2069","FBgn0261985","3L",328097,356050,27953
"2070","FBgn0027950","3R",9559760,9561533,1773
"2071","FBgn0051215","3R",19790972,19791044,72
"2072","FBgn0032961","2L",21758010,21761000,2990
"2073","FBgn0033376","2R",9098539,9103153,4614
"2074","FBgn0034642","2R",21632007,21634362,2355
"2075","FBgn0045770","3L",10465187,10468974,3787
"2076","FBgn0001229","3L",9371511,9372497,986
"2077","FBgn0041712","2R",23378573,23380438,1865
"2078","FBgn0039419","3R",26230248,26234700,4452
"2079","FBgn0035248","3L",1645467,1645983,516
"2080","FBgn0051496","3R",7345069,7346354,1285
"2081","FBgn0085390","2R",7834812,7885982,51170
"2082","FBgn0010356","2R",10877312,10879673,2361
"2083","FBgn0266737","3L",19260040,19260895,855
"2084","FBgn0259203","3L",7329132,7333471,4339
"2085","FBgn0025878","2R",22379637,22382675,3038
"2086","FBgn0033055","2R",6042532,6044964,2432
"2087","FBgn0039172","3R",24228342,24230035,1693
"2088","FBgn0034391","2R",18783299,18794594,11295
"2089","FBgn0052676","X",10711163,10744943,33780
"2090","FBgn0050106","2R",17646848,17665068,18220
"2091","FBgn0265899","3L",22896127,22896619,492
"2092","FBgn0038262","3R",14801773,14804342,2569
"2093","FBgn0265591","2R",17954545,17955295,750
"2094","FBgn0051014","3R",30503665,30505661,1996
"2095","FBgn0038159","3R",13591632,13592657,1025
"2096","FBgn0263531","X",2544740,2544908,168
"2097","FBgn0038153","3R",13420279,13423140,2861
"2098","FBgn0264350","2L",16178318,16179188,870
"2099","FBgn0030715","X",15974425,15976706,2281
"2100","FBgn0034541","2R",20661585,20662595,1010
"2101","FBgn0031430","2L",2517102,2518037,935
"2102","FBgn0035073","2R",24871407,24874912,3505
"2103","FBgn0262743","2L",20734609,20750941,16332
"2104","FBgn0053701","3L",9513645,9513959,314
"2105","FBgn0029685","X",3932000,3936469,4469
"2106","FBgn0033636","2R",11577485,11616045,38560
"2107","FBgn0003321","X",10832752,10847092,14340
"2108","FBgn0259193","3R",23402808,23405139,2331
"2109","FBgn0051220","3R",19648487,19650586,2099
"2110","FBgn0267921","2L",22046601,22047243,642
"2111","FBgn0051897","2L",8442447,8445815,3368
"2112","FBgn0037414","3R",6248994,6251683,2689
"2113","FBgn0036377","3L",13516273,13519605,3332
"2114","FBgn0011705","2L",8985936,8989539,3603
"2115","FBgn0083967","3R",22362620,22364580,1960
"2116","FBgn0037885","3R",11235140,11236077,937
"2117","FBgn0266492","2L",16837972,16841884,3912
"2118","FBgn0266280","X",761976,762500,524
"2119","FBgn0029523","X",476857,479309,2452
"2120","FBgn0034425","2R",19281418,19283961,2543
"2121","FBgn0003377","3L",11509861,11510247,386
"2122","FBgn0040005","2R",4671853,4673639,1786
"2123","FBgn0039342","3R",25505191,25505931,740
"2124","FBgn0267180","X",7959274,7960898,1624
"2125","FBgn0039669","3R",29515717,29516527,810
"2126","FBgn0051740","2L",18008953,18009694,741
"2127","FBgn0267054","X",19941530,19942158,628
"2128","FBgn0043530","2R",15024375,15024839,464
"2129","FBgn0037344","3R",5579301,5588380,9079
"2130","FBgn0259878","2R",15223560,15241589,18029
"2131","FBgn0031873","2L",6949310,6950207,897
"2132","FBgn0030191","X",10330160,10331818,1658
"2133","FBgn0259229","2L",1219293,1229802,10509
"2134","FBgn0037549","3R",8122725,8125273,2548
"2135","FBgn0263567","X",133385,133502,117
"2136","FBgn0011741","X",15735774,15737120,1346
"2137","FBgn0058354","3L",25201942,25203341,1399
"2138","FBgn0267902","Y",3242065,3242646,581
"2139","FBgn0261290","3R",8204195,8204830,635
"2140","FBgn0262467","2L",4967832,4968935,1103
"2141","FBgn0011674","2R",20821262,20836028,14766
"2142","FBgn0031106","X",20392334,20393751,1417
"2143","FBgn0035482","3L",4003474,4006626,3152
"2144","FBgn0034866","2R",23472300,23473753,1453
"2145","FBgn0037753","3R",9780064,9783054,2990
"2146","FBgn0052288","3L",3095737,3095808,71
"2147","FBgn0030991","X",19180173,19182024,1851
"2148","FBgn0266053","3R",17043564,17048421,4857
"2149","FBgn0050493","2R",7699253,7703501,4248
"2150","FBgn0283531","2L",2815970,2830248,14278
"2151","FBgn0027568","2L",10358134,10362707,4573
"2152","FBgn0083038","2L",20418348,20418481,133
"2153","FBgn0013348","2R",5065237,5070210,4973
"2154","FBgn0053536","3R",24112964,24113047,83
"2155","FBgn0035111","3L",212709,216479,3770
"2156","FBgn0053481","4",247124,253329,6205
"2157","FBgn0012001","3R",7475903,7475975,72
"2158","FBgn0264084","2L",2271319,2279714,8395
"2159","FBgn0260857","3L",19261394,19262437,1043
"2160","FBgn0036489","3L",15160876,15163628,2752
"2161","FBgn0260644","3L",10629083,10630069,986
"2162","FBgn0038172","3R",13703084,13705402,2318
"2163","FBgn0011844","3L",13249547,13249618,71
"2164","FBgn0045497","2L",1784062,1785286,1224
"2165","FBgn0036643","3L",16586108,16587057,949
"2166","FBgn0264269","2L",9470326,9470861,535
"2167","FBgn0029707","X",4380758,4382466,1708
"2168","FBgn0037822","3R",10696647,10698976,2329
"2169","FBgn0036603","3L",16314285,16315149,864
"2170","FBgn0034748","2R",22634019,22635942,1923
"2171","FBgn0264554","3L",21496393,21498830,2437
"2172","FBgn0250822","2R",10319844,10320500,656
"2173","FBgn0033275","2R",8204888,8205706,818
"2174","FBgn0262539","3R",22769775,22770307,532
"2175","FBgn0261550","3R",20309344,20324196,14852
"2176","FBgn0037721","3R",9625157,9626930,1773
"2177","FBgn0032683","2L",18487747,18503978,16231
"2178","FBgn0030607","X",15067007,15069091,2084
"2179","FBgn0262567","2R",17140495,17140865,370
"2180","FBgn0263558","2R",7786322,7786443,121
"2181","FBgn0267673","3R",11354348,11355123,775
"2182","FBgn0033400","2R",9285310,9286634,1324
"2183","FBgn0063382","2R",17700976,17701062,86
"2184","FBgn0051198","3R",21754324,21757758,3434
"2185","FBgn0262821","2R",13477342,13478079,737
"2186","FBgn0039239","3R",24864191,24864732,541
"2187","FBgn0263802","2R",10760778,10761668,890
"2188","FBgn0283499","3R",21570248,21619321,49073
"2189","FBgn0261514","2L",13957539,13963381,5842
"2190","FBgn0041710","3R",12991449,12993201,1752
"2191","FBgn0052000","4",132220,143123,10903
"2192","FBgn0263199","3L",8982212,8986091,3879
"2193","FBgn0032821","2L",19774874,19791882,17008
"2194","FBgn0262560","2R",16345838,16347500,1662
"2195","FBgn0262181","X",19551152,19551242,90
"2196","FBgn0043900","3R",31575835,31580699,4864
"2197","FBgn0259711","2R",21666687,21667594,907
"2198","FBgn0014092","2L",16327069,16328131,1062
"2199","FBgn0032979","2L",22165720,22169143,3423
"2200","FBgn0031139","X",20930972,20933559,2587
"2201","FBgn0051004","3R",31178389,31195762,17373
"2202","FBgn0032818","2L",19757245,19758615,1370
"2203","FBgn0002973","2L",9437469,9464184,26715
"2204","FBgn0265754","3L",14245005,14245691,686
"2205","FBgn0028909","2L",14010565,14010636,71
"2206","FBgn0264512","3L",13302409,13302810,401
"2207","FBgn0000299","2L",5029609,5037279,7670
"2208","FBgn0029686","X",3936517,3940582,4065
"2209","FBgn0053400","2R",19748774,19748908,134
"2210","FBgn0038842","3R",20914296,20929213,14917
"2211","FBgn0032031","2L",8375502,8376797,1295
"2212","FBgn0036139","3L",11149578,11150785,1207
"2213","FBgn0038681","3R",19135158,19137136,1978
"2214","FBgn0050011","2R",10124293,10137472,13179
"2215","FBgn0003312","3R",11877235,11879754,2519
"2216","FBgn0039026","3R",22750901,22794030,43129
"2217","FBgn0259166","X",14228060,14234066,6006
"2218","FBgn0038401","3R",16147029,16149636,2607
"2219","FBgn0083988","2R",12199662,12199752,90
"2220","FBgn0085267","3L",10626499,10627439,940
"2221","FBgn0039969","2R",5603587,5604834,1247
"2222","FBgn0004242","2L",2772327,2799979,27652
"2223","FBgn0038098","3R",12967775,12977471,9696
"2224","FBgn0038596","3R",18282978,18283528,550
"2225","FBgn0053287","3L",20966766,20970663,3897
"2226","FBgn0036202","3L",11733589,11766182,32593
"2227","FBgn0029882","X",6653113,6654248,1135
"2228","FBgn0033130","2R",7035125,7036949,1824
"2229","FBgn0266222","2L",21855094,21869759,14665
"2230","FBgn0036248","3L",12118257,12119789,1532
"2231","FBgn0036953","3L",20221814,20223197,1383
"2232","FBgn0266441","3L",15105882,15110730,4848
"2233","FBgn0030716","X",15977967,15982944,4977
"2234","FBgn0039223","3R",24784552,24787421,2869
"2235","FBgn0031410","2L",2288503,2289416,913
"2236","FBgn0025335","2R",23862962,23865398,2436
"2237","FBgn0032666","2L",18119995,18129862,9867
"2238","FBgn0031940","2L",7743682,7744839,1157
"2239","FBgn0265714","3L",5713331,5714029,698
"2240","FBgn0050009","2R",10261315,10263827,2512
"2241","FBgn0032488","2L",13222587,13224545,1958
"2242","FBgn0053928","2L",17435891,17436600,709
"2243","FBgn0036039","3L",9726895,9729650,2755
"2244","FBgn0029873","X",6524464,6526342,1878
"2245","FBgn0039272","3R",25071126,25072712,1586
"2246","FBgn0037580","3R",8344400,8347465,3065
"2247","FBgn0036992","3L",20438166,20439872,1706
"2248","FBgn0266635","2R",13168500,13170745,2245
"2249","FBgn0038516","3R",17534815,17537136,2321
"2250","FBgn0036727","3L",17470127,17474517,4390
"2251","FBgn0044510","3L",24537236,24543534,6298
"2252","FBgn0029737","X",4918730,4921648,2918
"2253","FBgn0052273","3L",3121942,3122014,72
"2254","FBgn0027607","2R",8944298,8947344,3046
"2255","FBgn0030904","X",18240654,18243284,2630
"2256","FBgn0039480","3R",27083130,27087778,4648
"2257","FBgn0032490","2L",13227529,13228521,992
"2258","FBgn0010339","2R",12037298,12038851,1553
"2259","FBgn0022355","X",18387084,18390344,3260
"2260","FBgn0266407","3R",19907681,19908091,410
"2261","FBgn0259148","3L",19954547,19955799,1252
"2262","FBgn0266581","3R",22034298,22038925,4627
"2263","FBgn0031668","2L",5009931,5010834,903
"2264","FBgn0011848","2R",19727981,19728052,71
"2265","FBgn0260944","3R",10784383,10786465,2082
"2266","FBgn0266817","2R",12593195,12593827,632
"2267","FBgn0037622","3R",8732091,8735837,3746
"2268","FBgn0036563","3L",16083993,16085264,1271
"2269","FBgn0033693","2R",12182639,12185506,2867
"2270","FBgn0061360","2R",12634166,12636141,1975
"2271","FBgn0053357","2R",19764648,19764782,134
"2272","FBgn0031975","2L",8011405,8026898,15493
"2273","FBgn0036152","3L",11287936,11295919,7983
"2274","FBgn0053257","3L",16346323,16347620,1297
"2275","FBgn0264601","3L",16017165,16018317,1152
"2276","FBgn0026397","2L",1522697,1524257,1560
"2277","FBgn0039486","3R",27102988,27106184,3196
"2278","FBgn0039053","3R",23099533,23100983,1450
"2279","FBgn0026176","2R",12139295,12140229,934
"2280","FBgn0035689","3L",6174248,6178941,4693
"2281","FBgn0262332","2L",13747748,13747839,91
"2282","FBgn0033644","2R",11675935,11678014,2079
"2283","FBgn0032381","2L",11847226,11849169,1943
"2284","FBgn0040684","3R",5137057,5138989,1932
"2285","FBgn0264793","4",276523,278174,1651
"2286","FBgn0033272","2R",8161679,8163500,1821
"2287","FBgn0030105","X",9216872,9217466,594
"2288","FBgn0052251","3L",4313483,4318608,5125
"2289","FBgn0036990","3L",20435110,20436209,1099
"2290","FBgn0036787","3L",18461957,18463163,1206
"2291","FBgn0052797","X",2424925,2425855,930
"2292","FBgn0004620","2L",5555072,5558994,3922
"2293","FBgn0031695","2L",5268498,5270329,1831
"2294","FBgn0015776","2L",6778555,6786861,8306
"2295","FBgn0033185","2R",7513846,7516390,2544
"2296","FBgn0053833","2L",21484681,21485209,528
"2297","FBgn0027493","3R",20824667,20830580,5913
"2298","FBgn0086378","3R",3623143,3627690,4547
"2299","FBgn0038005","3R",12232794,12234684,1890
"2300","FBgn0028901","2L",15784085,15790146,6061
"2301","FBgn0037143","3L",21949825,21951550,1725
"2302","FBgn0264375","2L",19922964,19923574,610
"2303","FBgn0037702","3R",9516007,9527237,11230
"2304","FBgn0044020","2R",11652756,11679354,26598
"2305","FBgn0011932","2R",6162197,6162270,73
"2306","FBgn0029648","X",2948034,2949120,1086
"2307","FBgn0034763","2R",22670587,22673212,2625
"2308","FBgn0037296","3R",5217751,5219528,1777
"2309","FBgn0283509","2R",23985175,23988455,3280
"2310","FBgn0001134","3L",17823333,17839767,16434
"2311","FBgn0264511","3L",8569335,8569864,529
"2312","FBgn0263087","2L",11484707,11486949,2242
"2313","FBgn0082934","2R",24185087,24185169,82
"2314","FBgn0016715","3L",605165,606569,1404
"2315","FBgn0266324","2L",7220567,7221093,526
"2316","FBgn0264343","2L",7227734,7228641,907
"2317","FBgn0031044","X",19623114,19625729,2615
"2318","FBgn0259734","X",9030205,9054575,24370
"2319","FBgn0031626","2L",4732413,4734458,2045
"2320","FBgn0085210","2L",9367640,9368434,794
"2321","FBgn0011963","3R",8139951,8140023,72
"2322","FBgn0034389","2R",18761758,18774824,13066
"2323","FBgn0051999","4",215009,227748,12739
"2324","FBgn0033350","2R",8925671,8926890,1219
"2325","FBgn0036834","3L",18950629,18955406,4777
"2326","FBgn0030478","X",13370606,13380160,9554
"2327","FBgn0034737","2R",22562307,22563131,824
"2328","FBgn0051219","3R",19651018,19652430,1412
"2329","FBgn0038528","3R",17619100,17619688,588
"2330","FBgn0036328","3L",12972474,12973650,1176
"2331","FBgn0036516","3L",15585431,15588175,2744
"2332","FBgn0260972","2R",9135375,9137933,2558
"2333","FBgn0265761","X",12622212,12622771,559
"2334","FBgn0038871","3R",21220704,21223584,2880
"2335","FBgn0050183","2R",23690247,23697824,7577
"2336","FBgn0266908","2L",15834218,15834417,199
"2337","FBgn0267275","X",19132927,19133563,636
"2338","FBgn0064115","2L",13831482,13833105,1623
"2339","FBgn0267591","X",1900768,1901162,394
"2340","FBgn0031313","2L",1160290,1163886,3596
"2341","FBgn0037345","3R",5588873,5589703,830
"2342","FBgn0011954","X",21232091,21232163,72
"2343","FBgn0034109","2R",16292264,16294130,1866
"2344","FBgn0033138","2R",7062108,7063569,1461
"2345","FBgn0067861","X",20174217,20178638,4421
"2346","FBgn0259709","2R",21664126,21666108,1982
"2347","FBgn0001978","2L",15113480,15118069,4589
"2348","FBgn0053290","3L",21542359,21543012,653
"2349","FBgn0030307","X",11486546,11491573,5027
"2350","FBgn0267735","2L",21665849,21666851,1002
"2351","FBgn0264507","X",258465,267253,8788
"2352","FBgn0031941","2L",7747275,7747874,599
"2353","FBgn0052407","3L",5922055,5923567,1512
"2354","FBgn0034053","2R",15942864,15947266,4402
"2355","FBgn0034114","2R",16322186,16324801,2615
"2356","FBgn0004654","X",2145136,2148566,3430
"2357","FBgn0037110","3L",21635305,21636251,946
"2358","FBgn0085377","X",11339873,11344734,4861
"2359","FBgn0035371","3L",2768466,2772325,3859
"2360","FBgn0267751","3R",30135008,30137581,2573
"2361","FBgn0261507","3L",19952971,19953712,741
"2362","FBgn0034727","2R",22418937,22420376,1439
"2363","FBgn0045477","3L",4028605,4032032,3427
"2364","FBgn0022772","2R",7522437,7525716,3279
"2365","FBgn0037617","3R",8723174,8725357,2183
"2366","FBgn0036822","3L",18892383,18893278,895
"2367","FBgn0264817","2R",10481894,10485252,3358
"2368","FBgn0015773","X",14604012,14653928,49916
"2369","FBgn0051380","3R",25787997,25789455,1458
"2370","FBgn0030224","X",10672433,10673466,1033
"2371","FBgn0031818","2L",6474438,6476975,2537
"2372","FBgn0038734","3R",19783522,19785519,1997
"2373","FBgn0036890","3L",19601633,19604120,2487
"2374","FBgn0263929","3R",14741582,14795868,54286
"2375","FBgn0036986","3L",20424424,20426071,1647
"2376","FBgn0038420","3R",16350786,16357015,6229
"2377","FBgn0038589","3R",18251115,18251539,424
"2378","FBgn0038642","3R",18687556,18692719,5163
"2379","FBgn0051805","2L",16898175,16900473,2298
"2380","FBgn0050339","2R",9601431,9602901,1470
"2381","FBgn0266142","2L",13865992,13866690,698
"2382","FBgn0250838","2R",23385464,23386463,999
"2383","FBgn0267869","Y",3059061,3059480,419
"2384","FBgn0266331","2L",7994798,7996494,1696
"2385","FBgn0063485","3L",16676406,16711677,35271
"2386","FBgn0265956","2L",5287447,5288667,1220
"2387","FBgn0029665","X",3484605,3485378,773
"2388","FBgn0032804","2L",19540607,19541540,933
"2389","FBgn0052745","X",6280233,6280752,519
"2390","FBgn0052511","X",21156259,21156621,362
"2391","FBgn0040273","2R",19437483,19441898,4415
"2392","FBgn0267650","3R",21370918,21373575,2657
"2393","FBgn0036614","3L",16348747,16351951,3204
"2394","FBgn0037144","3L",21955110,21958041,2931
"2395","FBgn0039580","3R",28337019,28339765,2746
"2396","FBgn0034262","2R",17690275,17695353,5078
"2397","FBgn0266116","3L",1460703,1462801,2098
"2398","FBgn0032100","2L",9164235,9165426,1191
"2399","FBgn0284231","2R",17703335,17719346,16011
"2400","FBgn0052371","3L",7767269,7768352,1083
"2401","FBgn0002283","3L",16588475,16590132,1657
"2402","FBgn0033000","2R",4829246,4830587,1341
"2403","FBgn0051485","3R",6819266,6819338,72
"2404","FBgn0259195","X",15574947,15575683,736
"2405","FBgn0266361","X",23007672,23009452,1780
"2406","FBgn0260011","2L",14047582,14048863,1281
"2407","FBgn0039332","3R",25381065,25382781,1716
"2408","FBgn0039188","3R",24356070,24357938,1868
"2409","FBgn0033690","2R",12177430,12178553,1123
"2410","FBgn0262620","2L",21657625,21658249,624
"2411","FBgn0266201","X",2055948,2056425,477
"2412","FBgn0038451","3R",16620778,16622702,1924
"2413","FBgn0026390","2L",11937969,11939202,1233
"2414","FBgn0284420","3R",27999908,28001015,1107
"2415","FBgn0035209","3L",1331744,1332326,582
"2416","FBgn0259951","2L",3667977,3668551,574
"2417","FBgn0011881","2R",13430282,13430355,73
"2418","FBgn0051371","3R",30501124,30503506,2382
"2419","FBgn0011509","3L",8718949,8720225,1276
"2420","FBgn0265000","2L",16628752,16629173,421
"2421","FBgn0053689","3L",16200229,16200926,697
"2422","FBgn0036004","3L",9477038,9486530,9492
"2423","FBgn0038717","3R",19607254,19609322,2068
"2424","FBgn0266258","3R",29755190,29759040,3850
"2425","FBgn0083167","X",10460736,10461878,1142
"2426","FBgn0265157","3R",23040776,23041340,564
"2427","FBgn0051823","2L",15898879,15900524,1645
"2428","FBgn0033090","2R",6683186,6684710,1524
"2429","FBgn0053542","X",18277233,18284596,7363
"2430","FBgn0032354","2L",11179032,11180430,1398
"2431","FBgn0259143","X",12463528,12478431,14903
"2432","FBgn0260479","2L",7734415,7738809,4394
"2433","FBgn0283480","2R",22206005,22207987,1982
"2434","FBgn0040305","3L",9430312,9439490,9178
"2435","FBgn0030961","X",18806694,18812002,5308
"2436","FBgn0036094","3L",10643528,10644615,1087
"2437","FBgn0030794","X",16803650,16805754,2104
"2438","FBgn0029703","X",4300117,4302346,2229
"2439","FBgn0086370","3R",16186999,16197584,10585
"2440","FBgn0032453","2L",12707661,12708680,1019
"2441","FBgn0032949","2L",21573389,21577103,3714
"2442","FBgn0030506","X",13664584,13667811,3227
"2443","FBgn0086361","3R",29591831,29617157,25326
"2444","FBgn0037377","3R",5791879,5793383,1504
"2445","FBgn0020647","3R",23997538,24031827,34289
"2446","FBgn0023520","X",1937700,1940040,2340
"2447","FBgn0265632","2R",8249096,8249595,499
"2448","FBgn0037358","3R",5652640,5654861,2221
"2449","FBgn0034487","2R",20239936,20242873,2937
"2450","FBgn0266259","3R",30618626,30621906,3280
"2451","FBgn0034734","2R",22483303,22492033,8730
"2452","FBgn0267608","Y",335386,335911,525
"2453","FBgn0266129","2R",25085780,25139627,53847
"2454","FBgn0039443","3R",26636688,26637557,869
"2455","FBgn0086895","2R",14153153,14157106,3953
"2456","FBgn0032433","2L",12441401,12445924,4523
"2457","FBgn0283467","2L",15254819,15256304,1485
"2458","FBgn0000370","2L",21310866,21319527,8661
"2459","FBgn0050297","2R",8158455,8158528,73
"2460","FBgn0000355","3L",8728481,8729066,585
"2461","FBgn0261999","2L",16231475,16241527,10052
"2462","FBgn0263219","3L",8238647,8282398,43751
"2463","FBgn0260995","2R",3066499,3191011,124512
"2464","FBgn0263846","2L",3757256,3769525,12269
"2465","FBgn0261349","2L",18673363,18675094,1731
"2466","FBgn0033136","2R",7054717,7056576,1859
"2467","FBgn0259736","3R",22120061,22133367,13306
"2468","FBgn0003935","2L",13244848,13244974,126
"2469","FBgn0000384","2L",22981816,22992951,11135
"2470","FBgn0033344","2R",8909432,8910349,917
"2471","FBgn0000504","3R",7924323,7967408,43085
"2472","FBgn0024273","3R",28824506,28832024,7518
"2473","FBgn0264363","2L",3576210,3576623,413
"2474","FBgn0038391","3R",16009105,16019133,10028
"2475","FBgn0260936","3L",5769002,5776271,7269
"2476","FBgn0260026","3L",3184404,3186549,2145
"2477","FBgn0029518","X",265724,267028,1304
"2478","FBgn0033798","2R",13163363,13163948,585
"2479","FBgn0033423","2R",9561638,9563871,2233
"2480","FBgn0263237","X",5307465,5308983,1518
"2481","FBgn0266378","2R",15404696,15405095,399
"2482","FBgn0266415","3R",11310676,11311182,506
"2483","FBgn0267296","3L",19439927,19441195,1268
"2484","FBgn0265757","3L",17335921,17337097,1176
"2485","FBgn0038462","3R",16994542,16996071,1529
"2486","FBgn0035429","3L",3280239,3290896,10657
"2487","FBgn0032368","2L",11610510,11611772,1262
"2488","FBgn0265760","3L",17633040,17633317,277
"2489","FBgn0039149","3R",24109367,24110010,643
"2490","FBgn0025185","2R",7510622,7512749,2127
"2491","FBgn0004244","3L",9145838,9182149,36311
"2492","FBgn0266322","2L",71039,73836,2797
"2493","FBgn0261833","3R",26324499,26325294,795
"2494","FBgn0263547","3R",10513005,10513133,128
"2495","FBgn0264486","3L",12889770,12892162,2392
"2496","FBgn0085277","3L",16270369,16270902,533
"2497","FBgn0034884","2R",23605689,23606654,965
"2498","FBgn0032213","2L",10304069,10306594,2525
"2499","FBgn0023511","X",1903704,1908827,5123
"2500","FBgn0000279","3R",30216484,30216938,454
"2501","FBgn0266260","3R",10462387,10464978,2591
"2502","FBgn0034396","2R",18822188,18829699,7511
"2503","FBgn0265807","2L",12581445,12582858,1413
"2504","FBgn0086712","2R",11616869,11619023,2154
"2505","FBgn0051111","3R",25055076,25056177,1101
"2506","FBgn0024150","3L",21136447,21171930,35483
"2507","FBgn0082929","2R",14624007,14624091,84
"2508","FBgn0266083","2R",24186703,24195290,8587
"2509","FBgn0086368","X",784746,788215,3469
"2510","FBgn0029778","X",5616572,5618806,2234
"2511","FBgn0037492","3R",7249795,7251750,1955
"2512","FBgn0065083","2L",5193471,5193516,45
"2513","FBgn0035189","3L",1203316,1204795,1479
"2514","FBgn0030829","X",17218667,17219787,1120
"2515","FBgn0038485","3R",17137893,17138865,972
"2516","FBgn0028857","2L",15941441,15942854,1413
"2517","FBgn0035779","3L",7398285,7399912,1627
"2518","FBgn0040575","3R",20559708,20560280,572
"2519","FBgn0015359","3L",2257456,2258922,1466
"2520","FBgn0032362","2L",11501715,11508649,6934
"2521","FBgn0266687","3L",27091705,27092199,494
"2522","FBgn0267322","3L",22960930,22961668,738
"2523","FBgn0029714","X",4551973,4553006,1033
"2524","FBgn0259789","X",19766465,19783548,17083
"2525","FBgn0001992","2L",16294183,16296969,2786
"2526","FBgn0262719","3L",8472807,8507146,34339
"2527","FBgn0267039","X",4275234,4275964,730
"2528","FBgn0034299","2R",18093723,18094900,1177
"2529","FBgn0028563","2R",8082976,8087151,4175
"2530","FBgn0022338","3R",18980995,18982749,1754
"2531","FBgn0267117","3R",32015941,32026928,10987
"2532","FBgn0260648","2L",1728732,1729762,1030
"2533","FBgn0036804","3L",18681037,18681836,799
"2534","FBgn0015550","3L",17359682,17361811,2129
"2535","FBgn0037837","3R",10811581,10815047,3466
"2536","FBgn0037336","3R",5539510,5547775,8265
"2537","FBgn0026393","2R",7920835,7922604,1769
"2538","FBgn0031663","2L",4978484,4979379,895
"2539","FBgn0040056","3L",23737960,23749058,11098
"2540","FBgn0036945","3L",20188522,20189779,1257
"2541","FBgn0035076","2R",24888628,24891023,2395
"2542","FBgn0011232","2L",9431405,9435341,3936
"2543","FBgn0025615","X",4648592,4650032,1440
"2544","FBgn0037389","3R",5848953,5849688,735
"2545","FBgn0030996","X",19193555,19196037,2482
"2546","FBgn0266616","4",851174,851624,450
"2547","FBgn0266766","2R",19784294,19789736,5442
"2548","FBgn0262319","3R",25588859,25588958,99
"2549","FBgn0266180","X",3313333,3348400,35067
"2550","FBgn0039435","3R",26620608,26621364,756
"2551","FBgn0051044","3R",29214562,29219667,5105
"2552","FBgn0051494","3R",7129864,7129935,71
"2553","FBgn0267975","3R",19215434,19226651,11217
"2554","FBgn0038189","3R",13944654,13945812,1158
"2555","FBgn0266896","2L",16998327,16998551,224
"2556","FBgn0267064","X",21467983,21468479,496
"2557","FBgn0000047","3R",15439969,15442177,2208
"2558","FBgn0005391","X",10050951,10052636,1685
"2559","FBgn0036807","3L",18694187,18695648,1461
"2560","FBgn0025881","2L",9894795,9894907,112
"2561","FBgn0263217","3R",23390144,23390566,422
"2562","FBgn0034151","2R",16745223,16746579,1356
"2563","FBgn0032172","2L",9959248,9963949,4701
"2564","FBgn0037313","3R",5355092,5356748,1656
"2565","FBgn0051907","2L",7059214,7060851,1637
"2566","FBgn0003277","X",11562800,11570326,7526
"2567","FBgn0037241","3R",4390366,4392111,1745
"2568","FBgn0010438","3R",16204194,16205250,1056
"2569","FBgn0028577","3L",1496853,1502590,5737
"2570","FBgn0052686","X",10371717,10375316,3599
"2571","FBgn0028479","2L",9573563,9576769,3206
"2572","FBgn0030576","X",14757531,14765787,8256
"2573","FBgn0034802","2R",22934569,22937077,2508
"2574","FBgn0267535","3L",9890816,9892109,1293
"2575","FBgn0051601","2L",22040727,22043877,3150
"2576","FBgn0265823","2L",7142304,7145263,2959
"2577","FBgn0029899","X",6756322,6770712,14390
"2578","FBgn0003449","X",5309242,5310501,1259
"2579","FBgn0265695","X",7562905,7563485,580
"2580","FBgn0031653","2L",4949941,4950767,826
"2581","FBgn0267447","X",487898,488333,435
"2582","FBgn0010433","3R",8278052,8279274,1222
"2583","FBgn0284229","3R",26978541,26985706,7165
"2584","FBgn0039769","3R",30432064,30435139,3075
"2585","FBgn0036038","3L",9723423,9726706,3283
"2586","FBgn0039645","3R",29165643,29171508,5865
"2587","FBgn0022224","2R",6810011,6810530,519
"2588","FBgn0051735","2L",15895454,15897071,1617
"2589","FBgn0260771","X",9243817,9245925,2108
"2590","FBgn0266412","3R",31704781,31705498,717
"2591","FBgn0001227","3L",9377802,9379534,1732
"2592","FBgn0034407","2R",18867391,18867895,504
"2593","FBgn0030077","X",9054698,9067983,13285
"2594","FBgn0035170","3L",852720,857248,4528
"2595","FBgn0027657","3R",15896926,15904521,7595
"2596","FBgn0083969","3R",29869365,29875159,5794
"2597","FBgn0004598","X",16373086,16381782,8696
"2598","FBgn0027791","X",1464363,1465996,1633
"2599","FBgn0029573","X",1369249,1370176,927
"2600","FBgn0053814","2L",21452934,21453426,492
"2601","FBgn0033948","2R",14619798,14621320,1522
"2602","FBgn0265011","2R",8992945,9006587,13642
"2603","FBgn0037270","3R",4712882,4714182,1300
"2604","FBgn0051777","2L",3706551,3707063,512
"2605","FBgn0029603","X",2191639,2193909,2270
"2606","FBgn0031893","2L",7182234,7185529,3295
"2607","FBgn0033248","2R",7993798,7994968,1170
"2608","FBgn0031536","2L",3453697,3457064,3367
"2609","FBgn0034073","2R",16099306,16102608,3302
"2610","FBgn0026404","3L",9968479,9971002,2523
"2611","FBgn0010473","2L",4283148,4323781,40633
"2612","FBgn0039066","3R",23251563,23255071,3508
"2613","FBgn0032122","2L",9528515,9529648,1133
"2614","FBgn0065048","2R",17143521,17143693,172
"2615","FBgn0085464","X",5613325,5614467,1142
"2616","FBgn0039434","3R",26619118,26620224,1106
"2617","FBgn0037547","3R",8087252,8089526,2274
"2618","FBgn0013765","2R",13439314,13450475,11161
"2619","FBgn0266382","3R",20677080,20677858,778
"2620","FBgn0001308","2R",16266960,16271971,5011
"2621","FBgn0053513","X",1483625,1507809,24184
"2622","FBgn0259708","2R",21664126,21666108,1982
"2623","FBgn0038640","3R",18677818,18680321,2503
"2624","FBgn0032783","2L",19435850,19442727,6877
"2625","FBgn0038763","3R",20018269,20021338,3069
"2626","FBgn0028645","2L",15905134,15962435,57301
"2627","FBgn0037124","3L",21732806,21733487,681
"2628","FBgn0030349","X",11877737,11887162,9425
"2629","FBgn0051933","2L",1821256,1823331,2075
"2630","FBgn0032131","2L",9589476,9591783,2307
"2631","FBgn0058441","Y",1883796,1883972,176
"2632","FBgn0261791","X",16639810,16640419,609
"2633","FBgn0086917","3R",3322810,3354486,31676
"2634","FBgn0052198","3L",18526976,18527445,469
"2635","FBgn0030800","X",16882509,16884365,1856
"2636","FBgn0032406","2L",12076100,12077739,1639
"2637","FBgn0000964","2L",19464267,19467758,3491
"2638","FBgn0262722","3R",24825791,24826471,680
"2639","FBgn0266399","3R",26006502,26007073,571
"2640","FBgn0032055","2L",8519690,8521809,2119
"2641","FBgn0037082","3L",21438628,21441363,2735
"2642","FBgn0029501","2R",24494518,24497024,2506
"2643","FBgn0024991","X",2714079,2717654,3575
"2644","FBgn0028866","2L",14794516,14796642,2126
"2645","FBgn0263708","2R",17253156,17255104,1948
"2646","FBgn0262878","2L",20472793,20473385,592
"2647","FBgn0052283","3L",3314996,3315355,359
"2648","FBgn0038484","3R",17136111,17137195,1084
"2649","FBgn0000246","3R",15789473,15792579,3106
"2650","FBgn0052073","3L",11107008,11107582,574
"2651","FBgn0000564","3R",17446642,17448858,2216
"2652","FBgn0034897","2R",23713900,23734846,20946
"2653","FBgn0040253","3R",11164423,11166074,1651
"2654","FBgn0004514","3L",22035003,22065279,30276
"2655","FBgn0034674","2R",21973122,21976386,3264
"2656","FBgn0263563","X",7085737,7085853,116
"2657","FBgn0033100","2R",6756296,6757209,913
"2658","FBgn0051143","3R",23601333,23601455,122
"2659","FBgn0037891","3R",11244302,11246862,2560
"2660","FBgn0264449","X",808217,927975,119758
"2661","FBgn0085570","2R",3334854,3336160,1306
"2662","FBgn0010504","2R",8146918,8156654,9736
"2663","FBgn0011211","2R",22799099,22802180,3081
"2664","FBgn0053530","2R",16750776,16751495,719
"2665","FBgn0036581","3L",16232084,16232777,693
"2666","FBgn0040534","3R",9014972,9015341,369
"2667","FBgn0038809","3R",20581770,20585833,4063
"2668","FBgn0004370","X",11622015,11677338,55323
"2669","FBgn0033819","2R",13251852,13254337,2485
"2670","FBgn0037715","3R",9571911,9574211,2300
"2671","FBgn0027583","3R",29735269,29736745,1476
"2672","FBgn0000479","X",3176440,3343767,167327
"2673","FBgn0028662","3R",14902330,14904061,1731
"2674","FBgn0035888","3L",8396000,8402295,6295
"2675","FBgn0035649","3L",5917905,5921316,3411
"2676","FBgn0266578","3R",13132429,13155687,23258
"2677","FBgn0039977","3L",23715023,23716689,1666
"2678","FBgn0267659","2R",17262339,17262748,409
"2679","FBgn0053425","2R",19739570,19739704,134
"2680","FBgn0032636","2L",17433862,17435800,1938
"2681","FBgn0028426","2R",10307030,10309794,2764
"2682","FBgn0034974","2R",24081782,24086287,4505
"2683","FBgn0053246","X",14048011,14048734,723
"2684","FBgn0031107","X",20394395,20412247,17852
"2685","FBgn0263568","2L",18867046,18867161,115
"2686","FBgn0266677","3L",5918389,5919556,1167
"2687","FBgn0012025","3R",8668612,8668705,93
"2688","FBgn0051501","3R",7346730,7347836,1106
"2689","FBgn0265549","2L",17939019,17939715,696
"2690","FBgn0263976","2R",16285797,16286254,457
"2691","FBgn0001319","2R",14772650,14807061,34411
"2692","FBgn0266809","2R",12296495,12297805,1310
"2693","FBgn0003963","2L",476220,540560,64340
"2694","FBgn0033169","2R",7440706,7442885,2179
"2695","FBgn0266768","3L",14410117,14410698,581
"2696","FBgn0052218","3L",19895216,19896391,1175
"2697","FBgn0262786","2L",11657410,11657992,582
"2698","FBgn0003513","3R",16374434,16403690,29256
"2699","FBgn0267065","X",21479654,21479949,295
"2700","FBgn0038250","3R",14657447,14659228,1781
"2701","FBgn0029800","X",5753390,5754958,1568
"2702","FBgn0263355","2L",20426199,20447905,21706
"2703","FBgn0053526","2L",870465,877038,6573
"2704","FBgn0030776","X",16704081,16705278,1197
"2705","FBgn0060296","2R",24921505,24928275,6770
"2706","FBgn0263564","2L",2737568,2737661,93
"2707","FBgn0036844","3L",19066155,19086426,20271
"2708","FBgn0038914","3R",21883924,21884454,530
"2709","FBgn0029819","X",5877000,5879787,2787
"2710","FBgn0053309","2L",14810761,14812599,1838
"2711","FBgn0259839","211000022280494",1,1443,1442
"2712","FBgn0031571","2L",3787167,3802726,15559
"2713","FBgn0038143","3R",13373104,13379775,6671
"2714","FBgn0025109","2L",2988116,2990075,1959
"2715","FBgn0035009","2R",24475386,24476032,646
"2716","FBgn0000464","2L",19586623,19732069,145446
"2717","FBgn0263460","3R",20912733,20912879,146
"2718","FBgn0001255","3R",8028453,8029546,1093
"2719","FBgn0263572","2R",8015249,8015343,94
"2720","FBgn0266949","3L",127321,127666,345
"2721","FBgn0264904","3R",14568962,14569871,909
"2722","FBgn0033468","2R",9963835,9965067,1232
"2723","FBgn0259794","3L",16859080,16860529,1449
"2724","FBgn0035147","3L",648555,651311,2756
"2725","FBgn0036106","3L",10880699,10882386,1687
"2726","FBgn0267894","Y",3212762,3213536,774
"2727","FBgn0011861","2L",7872849,7872919,70
"2728","FBgn0263545","X",5790753,5790861,108
"2729","FBgn0034569","2R",20992276,20994381,2105
"2730","FBgn0033459","2R",9874889,9876242,1353
"2731","FBgn0041242","2R",10362185,10363584,1399
"2732","FBgn0035719","3L",6942856,6949313,6457
"2733","FBgn0263496","3L",3693752,3694227,475
"2734","FBgn0053364","2R",19762068,19762202,134
"2735","FBgn0062440","2R",18147297,18147997,700
"2736","FBgn0031561","2L",3696218,3696658,440
"2737","FBgn0030630","X",15342857,15344625,1768
"2738","FBgn0034197","2R",17128480,17130334,1854
"2739","FBgn0033463","2R",9882572,9891689,9117
"2740","FBgn0265449","3R",17518210,17519084,874
"2741","FBgn0034443","2R",19396215,19396772,557
"2742","FBgn0020261","X",19485759,19492011,6252
"2743","FBgn0002413","3R",31054085,31061210,7125
"2744","FBgn0031736","2L",5724656,5762420,37764
"2745","FBgn0039241","3R",24877045,24881478,4433
"2746","FBgn0266905","2L",8852009,8852664,655
"2747","FBgn0020764","2R",23964772,23966757,1985
"2748","FBgn0263506","X",4874000,4874382,382
"2749","FBgn0053158","3L",16419597,16496560,76963
"2750","FBgn0263233","2R",17455743,17456441,698
"2751","FBgn0035517","3L",4254776,4256053,1277
"2752","FBgn0053417","2R",19742503,19742637,134
"2753","FBgn0053770","3L",22648672,22649287,615
"2754","FBgn0038881","3R",21318300,21349601,31301
"2755","FBgn0025519","2R",16262284,16264619,2335
"2756","FBgn0263738","3R",18252843,18255487,2644
"2757","FBgn0015602","2R",14770469,14772630,2161
"2758","FBgn0033302","2R",8564187,8567202,3015
"2759","FBgn0267205","3R",21861377,21862080,703
"2760","FBgn0265098","2R",7429496,7429995,499
"2761","FBgn0002533","2R",8433797,8434785,988
"2762","FBgn0014133","X",11678970,11694740,15770
"2763","FBgn0267796","3L",9597764,9614001,16237
"2764","FBgn0261064","2L",8159832,8161800,1968
"2765","FBgn0032184","2L",10122129,10122771,642
"2766","FBgn0002922","3R",23712814,23718357,5543
"2767","FBgn0032430","2L",12428028,12430021,1993
"2768","FBgn0032633","2L",17367511,17384115,16604
"2769","FBgn0058191","2R",1264140,1267747,3607
"2770","FBgn0004053","3R",6752864,6754194,1330
"2771","FBgn0267805","3R",7315399,7315661,262
"2772","FBgn0035165","3L",837861,839931,2070
"2773","FBgn0265966","X",391835,393227,1392
"2774","FBgn0052333","3L",1275956,1295699,19743
"2775","FBgn0003366","X",11071441,11086299,14858
"2776","FBgn0259683","2L",22189526,22214376,24850
"2777","FBgn0013673","mitochondrion_genome",3907,4068,161
"2778","FBgn0266313","2L",19600697,19605490,4793
"2779","FBgn0036005","3L",9486448,9487790,1342
"2780","FBgn0053126","2L",1359837,1361821,1984
"2781","FBgn0039358","3R",25680845,25683780,2935
"2782","FBgn0065066","3R",29863299,29863344,45
"2783","FBgn0260475","2R",13412769,13414620,1851
"2784","FBgn0085413","3R",7814361,7855392,41031
"2785","FBgn0037719","3R",9589468,9591002,1534
"2786","FBgn0262854","3L",21258020,21258758,738
"2787","FBgn0038795","3R",20406615,20407871,1256
"2788","FBgn0266035","2L",7636951,7637324,373
"2789","FBgn0262739","2R",13943387,13958089,14702
"2790","FBgn0052651","X",12404616,12408477,3861
"2791","FBgn0052529","X",19866146,19908108,41962
"2792","FBgn0051908","2L",7024829,7027389,2560
"2793","FBgn0041096","3L",12008225,12064859,56634
"2794","FBgn0038810","3R",20588711,20591040,2329
"2795","FBgn0265645","2R",10656695,10657545,850
"2796","FBgn0004173","3R",7365160,7365627,467
"2797","FBgn0263051","2L",21166046,21168581,2535
"2798","FBgn0003016","2L",14599196,14689340,90144
"2799","FBgn0052176","3L",17433868,17437971,4103
"2800","FBgn0261401","3L",17820493,17822834,2341
"2801","FBgn0030620","X",15210386,15211467,1081
"2802","FBgn0011828","3L",2601455,2630064,28609
"2803","FBgn0267451","3L",21028959,21029701,742
"2804","FBgn0250835","2L",2591869,2592773,904
"2805","FBgn0036813","3L",18748687,18750483,1796
"2806","FBgn0267111","3R",8225279,8232178,6899
"2807","FBgn0037915","3R",11575901,11578745,2844
"2808","FBgn0267031","X",625247,625661,414
"2809","FBgn0038887","3R",21403735,21406690,2955
"2810","FBgn0037487","3R",7224414,7241138,16724
"2811","FBgn0261292","2R",16466709,16467522,813
"2812","FBgn0266833","2L",4256132,4256519,387
"2813","FBgn0038694","3R",19247052,19248136,1084
"2814","FBgn0038090","3R",12910120,12911292,1172
"2815","FBgn0035777","3L",7390742,7396013,5271
"2816","FBgn0011862","2L",14518091,14518161,70
"2817","FBgn0030555","X",14234413,14237923,3510
"2818","FBgn0267351","2R",18972612,18977262,4650
"2819","FBgn0263602","3L",16085221,16087525,2304
"2820","FBgn0033186","2R",7516923,7518936,2013
"2821","FBgn0267617","3L",21636643,21637314,671
"2822","FBgn0264747","3L",18070300,18072123,1823
"2823","FBgn0028520","2L",16094997,16095944,947
"2824","FBgn0036877","3L",19501010,19503870,2860
"2825","FBgn0038735","3R",19847311,19854403,7092
"2826","FBgn0052656","X",12059795,12065144,5349
"2827","FBgn0045852","2L",18762874,18792906,30032
"2828","FBgn0040929","X",8590775,8591729,954
"2829","FBgn0038592","3R",18267789,18271172,3383
"2830","FBgn0031548","2L",3525131,3527588,2457
"2831","FBgn0050480","2R",14674606,14678136,3530
"2832","FBgn0032651","2L",17589184,17591267,2083
"2833","FBgn0267038","X",4047596,4049204,1608
"2834","FBgn0032154","2L",9891255,9893446,2191
"2835","FBgn0031816","2L",6459015,6465669,6654
"2836","FBgn0014141","3R",17091533,17125389,33856
"2837","FBgn0031011","X",19281232,19298162,16930
"2838","FBgn0264696","3L",8725520,8725774,254
"2839","FBgn0025638","X",647304,648597,1293
"2840","FBgn0038422","3R",16360329,16368306,7977
"2841","FBgn0263996","2L",20871335,20918931,47596
"2842","FBgn0266721","3R",10120399,10121400,1001
"2843","FBgn0032896","2L",20856987,20857891,904
"2844","FBgn0032869","2L",20642306,20643244,938
"2845","FBgn0267766","3R",24924416,24925344,928
"2846","FBgn0038076","3R",12679279,12681375,2096
"2847","FBgn0061197","2R",12302544,12306269,3725
"2848","FBgn0034913","2R",23843483,23844763,1280
"2849","FBgn0031645","2L",4892112,4903889,11777
"2850","FBgn0037463","3R",7060767,7061919,1152
"2851","FBgn0035585","3L",5011444,5012133,689
"2852","FBgn0040496","2L",10677198,10679707,2509
"2853","FBgn0029596","X",2065273,2066359,1086
"2854","FBgn0031130","X",20744965,20745965,1000
"2855","FBgn0264983","3R",4436356,4437230,874
"2856","FBgn0053451","2R",19729921,19730055,134
"2857","FBgn0041623","3L",6327608,6329069,1461
"2858","FBgn0029696","X",4216873,4217394,521
"2859","FBgn0033868","2R",13778124,13780245,2121
"2860","FBgn0053859","2L",21528341,21528833,492
"2861","FBgn0003411","X",11321579,11322357,778
"2862","FBgn0027547","3L",1966725,1970079,3354
"2863","FBgn0267969","X",4062859,4064506,1647
"2864","FBgn0285952","2R",24057798,24059483,1685
"2865","FBgn0038649","3R",18744063,18746041,1978
"2866","FBgn0265315","3R",27538233,27539159,926
"2867","FBgn0015828","3L",11682038,11683805,1767
"2868","FBgn0046698","Y",3539437,3540722,1285
"2869","FBgn0265631","2R",5879196,5880395,1199
"2870","FBgn0038950","3R",22364573,22365983,1410
"2871","FBgn0264338","2R",23507078,23507832,754
"2872","FBgn0033316","2R",8627900,8630186,2286
"2873","FBgn0035661","3L",6033199,6034611,1412
"2874","FBgn0259936","2L",20647533,20648848,1315
"2875","FBgn0260795","3L",11123348,11134663,11315
"2876","FBgn0267497","rDNA",46771,49485,2714
"2877","FBgn0266868","2R",14823545,14824365,820
"2878","FBgn0016978","2L",6968711,6971737,3026
"2879","FBgn0263525","3R",15836287,15836354,67
"2880","FBgn0037783","3R",10060252,10061136,884
"2881","FBgn0030408","X",12616316,12621216,4900
"2882","FBgn0050421","2R",24743749,24756976,13227
"2883","FBgn0036714","3L",17351822,17358056,6234
"2884","FBgn0054008","3R",20580683,20581522,839
"2885","FBgn0262444","3R",30791636,30791696,60
"2886","FBgn0031610","2L",4463611,4465075,1464
"2887","FBgn0040832","3L",8215280,8216198,918
"2888","FBgn0262026","2R",16197042,16199378,2336
"2889","FBgn0261723","3L",1921307,1933602,12295
"2890","FBgn0033122","2R",6986043,6988922,2879
"2891","FBgn0031283","2L",816994,817950,956
"2892","FBgn0035106","3L",187207,199762,12555
"2893","FBgn0034567","2R",20983838,20986500,2662
"2894","FBgn0033673","2R",11989131,11992350,3219
"2895","FBgn0053986","3L",15524325,15525253,928
"2896","FBgn0053437","2R",19735141,19735275,134
"2897","FBgn0034442","2R",19390128,19391900,1772
"2898","FBgn0032169","2L",9954325,9956176,1851
"2899","FBgn0041087","2R",9414342,9417846,3504
"2900","FBgn0261287","3R",25591502,25609127,17625
"2901","FBgn0266099","3L",16390952,16400275,9323
"2902","FBgn0263353","3R",5802328,5813258,10930
"2903","FBgn0085419","2R",18539585,18548969,9384
"2904","FBgn0263778","X",8324491,8325189,698
"2905","FBgn0265735","3L",10236609,10236936,327
"2906","FBgn0037276","3R",4781120,4784722,3602
"2907","FBgn0000395","2R",21355015,21379464,24449
"2908","FBgn0053832","2L",21483227,21483719,492
"2909","FBgn0023023","3R",5571108,5579189,8081
"2910","FBgn0022935","3L",6185830,6189123,3293
"2911","FBgn0261608","2L",5070957,5072055,1098
"2912","FBgn0015790","3R",21111408,21116146,4738
"2913","FBgn0028704","2L",9711512,9746495,34983
"2914","FBgn0002789","2R",13246670,13248880,2210
"2915","FBgn0267827","2L",588048,588784,736
"2916","FBgn0000377","X",2247594,2249983,2389
"2917","FBgn0264677","X",22514453,22514891,438
"2918","FBgn0037610","3R",8676915,8678233,1318
"2919","FBgn0034408","2R",18878391,18959500,81109
"2920","FBgn0038225","3R",14380663,14381699,1036
"2921","FBgn0050101","2R",17408258,17410204,1946
"2922","FBgn0261530","3L",9720414,9723194,2780
"2923","FBgn0267649","3R",21354445,21359768,5323
"2924","FBgn0262838","2R",18381393,18381844,451
"2925","FBgn0260748","X",17107582,17135988,28406
"2926","FBgn0038468","3R",17028693,17030701,2008
"2927","FBgn0016660","2L",5404280,5416593,12313
"2928","FBgn0267252","2L",9256563,9302494,45931
"2929","FBgn0264551","3L",20913158,20913705,547
"2930","FBgn0036161","3L",11458490,11459625,1135
"2931","FBgn0263404","3R",12195294,12195574,280
"2932","FBgn0032170","2L",9957132,9960168,3036
"2933","FBgn0032023","2L",8338287,8342056,3769
"2934","FBgn0052163","3L",16587157,16588143,986
"2935","FBgn0013269","3R",15331584,15333133,1549
"2936","FBgn0265920","3L",4493734,4495215,1481
"2937","FBgn0266865","2R",23709177,23709947,770
"2938","FBgn0051814","2L",13676860,13717320,40460
"2939","FBgn0037481","3R",7154238,7155180,942
"2940","FBgn0031428","2L",2420830,2424647,3817
"2941","FBgn0264446","X",1902028,1903733,1705
"2942","FBgn0263553","3L",8354184,8354241,57
"2943","FBgn0015584","2R",16749803,16750335,532
"2944","FBgn0265957","2L",5258942,5259992,1050
"2945","FBgn0036436","3L",14674538,14678147,3609
"2946","FBgn0283440","2L",15061656,15072133,10477
"2947","FBgn0266685","3L",17841671,17842599,928
"2948","FBgn0030433","X",12907105,12907942,837
"2949","FBgn0000250","2L",16313036,16326207,13171
"2950","FBgn0005640","3L",3515751,3610521,94770
"2951","FBgn0263130","3R",21530987,21532986,1999
"2952","FBgn0030881","X",17883718,17885238,1520
"2953","FBgn0033925","2R",14355769,14357281,1512
"2954","FBgn0037410","3R",6209373,6213493,4120
"2955","FBgn0032530","2L",13541638,13542576,938
"2956","FBgn0263211","X",19939045,19939396,351
"2957","FBgn0261832","3L",20464714,20466041,1327
"2958","FBgn0000181","2R",12870249,12871794,1545
"2959","FBgn0032769","2L",19300255,19301600,1345
"2960","FBgn0083029","2L",20421928,20422063,135
"2961","FBgn0262945","X",5831898,5832215,317
"2962","FBgn0263089","2L",15202259,15203967,1708
"2963","FBgn0085476","2L",2418422,2420013,1591
"2964","FBgn0034094","2R",16226501,16229869,3368
"2965","FBgn0263527","3R",30506829,30506887,58
"2966","FBgn0029947","X",7358796,7360058,1262
"2967","FBgn0053886","2L",21492700,21493294,594
"2968","FBgn0015282","3R",23929873,23931558,1685
"2969","FBgn0261289","3R",28806702,28807501,799
"2970","FBgn0285970","X",21621541,21623750,2209
"2971","FBgn0052488","3L",3014761,3016069,1308
"2972","FBgn0011270","3R",12231645,12232729,1084
"2973","FBgn0259704","3R",19160099,19162300,2201
"2974","FBgn0053145","2R",11980577,11982956,2379
"2975","FBgn0031562","2L",3697242,3697872,630
"2976","FBgn0265077","2L",20711202,20712300,1098
"2977","FBgn0030850","X",17623221,17627895,4674
"2978","FBgn0261458","2L",1151678,1158262,6584
"2979","FBgn0267303","3L",4445996,4446395,399
"2980","FBgn0003997","3L",18167745,18185641,17896
"2981","FBgn0034605","2R",21215435,21217779,2344
"2982","FBgn0053851","2L",21515062,21515590,528
"2983","FBgn0267811","3R",5560472,5561573,1101
"2984","FBgn0031976","2L",8026914,8039788,12874
"2985","FBgn0032243","2L",10414017,10418991,4974
"2986","FBgn0262185","3R",20735923,20736012,89
"2987","FBgn0261294","3L",17719193,17719854,661
"2988","FBgn0052113","3L",12755049,12768605,13556
"2989","FBgn0259990","3R",27957356,27959245,1889
"2990","FBgn0263511","X",5594255,5612865,18610
"2991","FBgn0266925","2R",22201508,22203045,1537
"2992","FBgn0011676","2L",10804274,10837511,33237
"2993","FBgn0267376","3R",10863355,10868642,5287
"2994","FBgn0039007","3R",22700582,22702084,1502
"2995","FBgn0035724","3L",6965260,6967897,2637
"2996","FBgn0051431","3R",21870681,21873640,2959
"2997","FBgn0265169","3R",17126984,17127862,878
"2998","FBgn0026879","X",624757,625203,446
"2999","FBgn0000280","3R",30211527,30211753,226
"3000","FBgn0050232","2R",17391774,17391845,71
"3001","FBgn0030793","X",16801929,16803344,1415
"3002","FBgn0035501","3L",4148696,4152473,3777
"3003","FBgn0028497","2R",23389009,23396680,7671
"3004","FBgn0030316","X",11576883,11578806,1923
"3005","FBgn0039505","3R",27273705,27274565,860
"3006","FBgn0266178","3R",21354445,21359768,5323
"3007","FBgn0036406","3L",14052428,14053079,651
"3008","FBgn0051697","2L",19535448,19536104,656
"3009","FBgn0023215","X",3671801,3701672,29871
"3010","FBgn0014417","2L",8408888,8411868,2980
"3011","FBgn0033260","2R",8102260,8106318,4058
"3012","FBgn0053138","2R",13171401,13174796,3395
"3013","FBgn0260745","3R",11984862,11993315,8453
"3014","FBgn0267063","X",21467128,21467601,473
"3015","FBgn0028418","3L",14560139,14560764,625
"3016","FBgn0265800","2L",12046442,12046679,237
"3017","FBgn0038037","3R",12403340,12406028,2688
"3018","FBgn0035581","3L",4861269,4895749,34480
"3019","FBgn0033112","2R",6879285,6880770,1485
"3020","FBgn0035380","3L",2915024,2916654,1630
"3021","FBgn0003165","3R",9066343,9237682,171339
"3022","FBgn0030600","X",15010137,15063429,53292
"3023","FBgn0027844","2L",13803626,13809994,6368
"3024","FBgn0005624","2R",12965997,12980994,14997
"3025","FBgn0035021","2R",24533374,24556300,22926
"3026","FBgn0036908","3L",19803738,19805080,1342
"3027","FBgn0038903","3R",21777203,21777847,644
"3028","FBgn0250842","2R",12845544,12846596,1052
"3029","FBgn0035293","3L",1933633,1939103,5470
"3030","FBgn0033258","2R",8096792,8098484,1692
"3031","FBgn0037552","3R",8217957,8219734,1777
"3032","FBgn0013467","2R",15155437,15190292,34855
"3033","FBgn0037939","3R",11700614,11702720,2106
"3034","FBgn0032399","2L",12041054,12045200,4146
"3035","FBgn0036556","3L",15992669,16004736,12067
"3036","FBgn0011566","X",2606680,2608876,2196
"3037","FBgn0085253","2R",11237172,11237644,472
"3038","FBgn0039229","3R",24817464,24822350,4886
"3039","FBgn0267501","rDNA",67668,69662,1994
"3040","FBgn0261963","2L",5461639,5467610,5971
"3041","FBgn0033628","2R",11373607,11377109,3502
"3042","FBgn0037853","3R",10882433,10885001,2568
"3043","FBgn0050356","2R",8728964,8729501,537
"3044","FBgn0010909","3L",2554847,2586540,31693
"3045","FBgn0034539","2R",20655756,20656609,853
"3046","FBgn0003462","3L",11112281,11113740,1459
"3047","FBgn0265149","2L",248909,249812,903
"3048","FBgn0036066","3L",10086747,10089400,2653
"3049","FBgn0037429","3R",6335362,6337196,1834
"3050","FBgn0267112","3R",30528280,30531861,3581
"3051","FBgn0032919","2L",21143229,21145146,1917
"3052","FBgn0046878","3R",6108134,6109733,1599
"3053","FBgn0261243","3L",1502843,1523380,20537
"3054","FBgn0259146","3R",25970080,25982736,12656
"3055","FBgn0266876","2L",3260973,3261281,308
"3056","FBgn0062449","2R",11691285,11697785,6500
"3057","FBgn0030696","X",15809555,15810947,1392
"3058","FBgn0262435","2R",23993054,23993114,60
"3059","FBgn0082945","3L",1666665,1666745,80
"3060","FBgn0051603","2L",8541761,8541832,71
"3061","FBgn0033658","2R",11862537,11863252,715
"3062","FBgn0024986","X",1378885,1380480,1595
"3063","FBgn0032420","2L",12171204,12172586,1382
"3064","FBgn0011980","X",14025109,14025190,81
"3065","FBgn0262178","X",1788861,1788957,96
"3066","FBgn0010531","2R",10121486,10122574,1088
"3067","FBgn0020251","3L",6495680,6550104,54424
"3068","FBgn0034728","2R",22421013,22425482,4469
"3069","FBgn0029588","X",1692824,1693843,1019
"3070","FBgn0036351","3L",13380359,13381346,987
"3071","FBgn0037261","3R",4638010,4641838,3828
"3072","FBgn0053431","2R",19737355,19737489,134
"3073","FBgn0035587","3L",5141953,5144317,2364
"3074","FBgn0015591","3R",24760530,24765071,4541
"3075","FBgn0051798","2L",19394160,19396190,2030
"3076","FBgn0005626","3L",6713356,6719525,6169
"3077","FBgn0027619","2R",9968929,9970897,1968
"3078","FBgn0052463","2L",2238304,2239384,1080
"3079","FBgn0259192","2L",2032519,2036041,3522
"3080","FBgn0083972","2L",21096922,21098932,2010
"3081","FBgn0004589","3L",15649936,15650541,605
"3082","FBgn0051480","3R",20890698,20890769,71
"3083","FBgn0035082","2R",24939706,24940483,777
"3084","FBgn0050047","2R",12351793,12355413,3620
"3085","FBgn0083942","2L",17131024,17173118,42094
"3086","FBgn0270927","3R",31769293,31771848,2555
"3087","FBgn0259738","2R",16765361,16766000,639
"3088","FBgn0036227","3L",11949839,11952225,2386
"3089","FBgn0037422","3R",6291737,6293489,1752
"3090","FBgn0032922","2L",21157433,21158611,1178
"3091","FBgn0265039","3R",4660527,4660939,412
"3092","FBgn0039209","3R",24557368,24582864,25496
"3093","FBgn0261975","2R",13964653,13965455,802
"3094","FBgn0031068","X",19748314,19750167,1853
"3095","FBgn0037726","3R",9651179,9674643,23464
"3096","FBgn0263595","3R",16892410,16897861,5451
"3097","FBgn0051115","3R",25036944,25037982,1038
"3098","FBgn0267384","X",16593677,16595867,2190
"3099","FBgn0004687","X",5619136,5622539,3403
"3100","FBgn0053060","3L",16331040,16331767,727
"3101","FBgn0267490","Y",3284939,3285868,929
"3102","FBgn0053384","2R",19754665,19754799,134
"3103","FBgn0038286","3R",15079320,15095631,16311
"3104","FBgn0024184","X",17768569,17778708,10139
"3105","FBgn0031432","2L",2562483,2564830,2347
"3106","FBgn0250757","3R",25907022,25921046,14024
"3107","FBgn0051363","3R",11590386,11619906,29520
"3108","FBgn0067783","3R",20552385,20557667,5282
"3109","FBgn0259852","Y",906805,907496,691
"3110","FBgn0039294","3R",25224156,25232321,8165
"3111","FBgn0051718","2L",10405565,10408197,2632
"3112","FBgn0031957","2L",7857957,7860839,2882
"3113","FBgn0264810","2L",14416729,14417331,602
"3114","FBgn0063496","2R",18403248,18404086,838
"3115","FBgn0266030","2L",5615230,5615661,431
"3116","FBgn0259236","3L",15613184,15647762,34578
"3117","FBgn0032240","2L",10403197,10405203,2006
"3118","FBgn0032840","2L",20027915,20056373,28458
"3119","FBgn0038536","3R",17682669,17683773,1104
"3120","FBgn0262194","2L",13609974,13610068,94
"3121","FBgn0031273","2L",625652,628200,2548
"3122","FBgn0053813","2L",21451052,21452074,1022
"3123","FBgn0047135","3L",3197863,3199047,1184
"3124","FBgn0032104","2L",9250048,9251042,994
"3125","FBgn0267950","3L",10796802,10797361,559
"3126","FBgn0051950","2L",2878344,2879001,657
"3127","FBgn0036031","3L",9700517,9703595,3078
"3128","FBgn0031549","2L",3527387,3530317,2930
"3129","FBgn0040397","X",1073041,1134896,61855
"3130","FBgn0035150","3L",654363,657971,3608
"3131","FBgn0050364","2R",8359466,8362156,2690
"3132","FBgn0034697","2R",22124567,22127502,2935
"3133","FBgn0259863","Y",979530,980284,754
"3134","FBgn0261574","3L",20005301,20024607,19306
"3135","FBgn0053963","X",12659462,12660632,1170
"3136","FBgn0051716","2L",10396716,10403206,6490
"3137","FBgn0036354","3L",13388299,13390006,1707
"3138","FBgn0050225","2R",19414845,19414917,72
"3139","FBgn0052312","3L",1925641,1925712,71
"3140","FBgn0036311","3L",12781325,12784377,3052
"3141","FBgn0085638","2R",2770380,2846708,76328
"3142","FBgn0028538","2L",13793521,13799674,6153
"3143","FBgn0032450","2L",12700949,12704451,3502
"3144","FBgn0267418","Y",3297271,3298126,855
"3145","FBgn0039113","3R",23760737,23763263,2526
"3146","FBgn0266004","2L",6360403,6361385,982
"3147","FBgn0086065","3L",827764,827843,79
"3148","FBgn0032654","2L",17625746,17626381,635
"3149","FBgn0037342","3R",5567502,5568615,1113
"3150","FBgn0033548","2R",10810556,10810936,380
"3151","FBgn0032988","2L",22249876,22258260,8384
"3152","FBgn0035805","3L",7640798,7641648,850
"3153","FBgn0030571","X",14580600,14582174,1574
"3154","FBgn0266805","2R",8019176,8026595,7419
"3155","FBgn0283638","3L",22945116,22945207,91
"3156","FBgn0053702","3L",9512797,9513409,612
"3157","FBgn0265699","2R",19692214,19697195,4981
"3158","FBgn0085324","3R",28789617,28790483,866
"3159","FBgn0051342","3R",12986041,12991543,5502
"3160","FBgn0263518","2R",6707163,6707273,110
"3161","FBgn0027053","3R",16470099,16471406,1307
"3162","FBgn0052428","3L",20469674,20473723,4049
"3163","FBgn0038350","3R",15548628,15552833,4205
"3164","FBgn0034846","2R",23346635,23347768,1133
"3165","FBgn0031689","2L",5210460,5212445,1985
"3166","FBgn0037761","3R",9812747,9813939,1192
"3167","FBgn0013325","2R",19442342,19443825,1483
"3168","FBgn0052549","X",18390498,18410144,19646
"3169","FBgn0261238","3R",7094596,7124185,29589
"3170","FBgn0262845","2R",23601981,23602456,475
"3171","FBgn0265375","2R",12320594,12320912,318
"3172","FBgn0024250","X",7307939,7311132,3193
"3173","FBgn0040321","3L",8955021,8956551,1530
"3174","FBgn0040628","3R",31260247,31261667,1420
"3175","FBgn0265042","3R",23168317,23185642,17325
"3176","FBgn0050108","2R",17669395,17670000,605
"3177","FBgn0050215","2R",19715565,19715638,73
"3178","FBgn0039125","3R",23924399,23926436,2037
"3179","FBgn0035849","3L",8183361,8186671,3310
"3180","FBgn0040358","X",1199546,1203157,3611
"3181","FBgn0001150","X",2427113,2428967,1854
"3182","FBgn0050238","2R",16219374,16219445,71
"3183","FBgn0030999","X",19213254,19214938,1684
"3184","FBgn0087039","3L",8304157,8305325,1168
"3185","FBgn0267885","Y",3165390,3166079,689
"3186","FBgn0265803","2L",12085649,12086413,764
"3187","FBgn0032211","2L",10299977,10302018,2041
"3188","FBgn0034506","2R",20343845,20346018,2173
"3189","FBgn0267188","X",20090654,20090858,204
"3190","FBgn0040973","2L",13293009,13293415,406
"3191","FBgn0031676","2L",5052843,5054575,1732
"3192","FBgn0052351","3L",8619888,8622091,2203
"3193","FBgn0038742","3R",19877737,19879309,1572
"3194","FBgn0000575","3L",749400,753492,4092
"3195","FBgn0039196","3R",24373456,24375661,2205
"3196","FBgn0261277","X",11152484,11153990,1506
"3197","FBgn0266396","3L",11364683,11365897,1214
"3198","FBgn0038613","3R",18386841,18389805,2964
"3199","FBgn0267168","X",18310502,18311349,847
"3200","FBgn0266362","X",23010972,23011293,321
"3201","FBgn0029642","X",2935127,2935966,839
"3202","FBgn0034294","2R",18050019,18052107,2088
"3203","FBgn0263381","3L",17166863,17167542,679
"3204","FBgn0262872","2L",7037823,7056010,18187
"3205","FBgn0038099","3R",12978000,12980535,2535
"3206","FBgn0085244","2R",6831296,6831793,497
"3207","FBgn0265085","2L",15207850,15208768,918
"3208","FBgn0053815","2L",21454388,21454916,528
"3209","FBgn0261836","2L",5100877,5207002,106125
"3210","FBgn0035741","3L",7125905,7128118,2213
"3211","FBgn0058100","2R",2374631,2375134,503
"3212","FBgn0035677","3L",6082883,6092188,9305
"3213","FBgn0051224","3R",18650121,18659309,9188
"3214","FBgn0261649","3R",17811541,17872507,60966
"3215","FBgn0265146","3R",14153990,14154441,451
"3216","FBgn0003996","X",2790599,2796466,5867
"3217","FBgn0264834","2R",1348167,1349167,1000
"3218","FBgn0003934","2L",3048701,3048831,130
"3219","FBgn0261267","2R",8737370,8737790,420
"3220","FBgn0035589","3L",5139619,5140473,854
"3221","FBgn0003141","2L",20073719,20075458,1739
"3222","FBgn0083011","X",17146401,17146545,144
"3223","FBgn0267217","3R",25848098,25848454,356
"3224","FBgn0043364","2L",476446,479688,3242
"3225","FBgn0267513","X",23200802,23201056,254
"3226","FBgn0017579","3L",8601006,8602392,1386
"3227","FBgn0262457","3R",24339232,24339295,63
"3228","FBgn0267412","Y",3293606,3294480,874
"3229","FBgn0004117","3R",15310193,15315197,5004
"3230","FBgn0050499","2R",7564434,7565751,1317
"3231","FBgn0264506","2R",6532595,6533595,1000
"3232","FBgn0034942","2R",23961477,23962577,1100
"3233","FBgn0053440","2R",19734037,19734171,134
"3234","FBgn0267576","3L",19562636,19566533,3897
"3235","FBgn0267581","3L",17981321,17981841,520
"3236","FBgn0015625","3R",24867934,24870816,2882
"3237","FBgn0031559","2L",3692699,3693182,483
"3238","FBgn0035879","3L",8346561,8352279,5718
"3239","FBgn0032553","2L",14870371,14872022,1651
"3240","FBgn0262843","2R",23152748,23153318,570
"3241","FBgn0034071","2R",16047648,16060835,13187
"3242","FBgn0264914","2R",5031995,5032795,800
"3243","FBgn0032800","2L",19526686,19532985,6299
"3244","FBgn0037922","3R",11623339,11624948,1609
"3245","FBgn0261955","X",6350629,6361323,10694
"3246","FBgn0040730","2R",19680768,19681391,623
"3247","FBgn0032827","2L",19890201,19892550,2349
"3248","FBgn0033875","2R",13840053,13841743,1690
"3249","FBgn0038654","3R",18875528,18877204,1676
"3250","FBgn0263586","2R",6707306,6708960,1654
"3251","FBgn0051424","3R",22115471,22117249,1778
"3252","FBgn0039873","3R",31759404,31761579,2175
"3253","FBgn0039270","3R",25065791,25066718,927
"3254","FBgn0025777","2L",6719394,6723359,3965
"3255","FBgn0005427","X",268509,279718,11209
"3256","FBgn0032140","2L",9736645,9737949,1304
"3257","FBgn0086134","3R",12431321,12432556,1235
"3258","FBgn0025776","3L",15042799,15043924,1125
"3259","FBgn0051949","2L",2300103,2300888,785
"3260","FBgn0034460","2R",19636660,19637400,740
"3261","FBgn0260943","3L",17058774,17238212,179438
"3262","FBgn0266023","2L",2259396,2259730,334
"3263","FBgn0036557","3L",16005193,16006599,1406
"3264","FBgn0053795","3L",16170729,16171380,651
"3265","FBgn0024230","2L",19442833,19444750,1917
"3266","FBgn0039040","3R",23033284,23035563,2279
"3267","FBgn0038296","3R",15191058,15196210,5152
"3268","FBgn0267967","X",17629791,17632047,2256
"3269","FBgn0267873","Y",3074924,3075180,256
"3270","FBgn0053504","3L",3593823,3593893,70
"3271","FBgn0263214","X",19953659,19953882,223
"3272","FBgn0033924","2R",14352231,14355674,3443
"3273","FBgn0085316","3R",5853332,5854282,950
"3274","FBgn0034001","2R",15217024,15217617,593
"3275","FBgn0003721","3R",15281371,15308779,27408
"3276","FBgn0042186","2L",2251510,2252341,831
"3277","FBgn0028946","2L",15622068,15623558,1490
"3278","FBgn0040271","3R",16310542,16339575,29033
"3279","FBgn0039590","3R",28607939,28635099,27160
"3280","FBgn0263606","3L",16233127,16234165,1038
"3281","FBgn0267793","2R",16297449,16306695,9246
"3282","FBgn0053370","2R",19759842,19759976,134
"3283","FBgn0039086","3R",23534900,23536710,1810
"3284","FBgn0028692","3R",29153524,29157255,3731
"3285","FBgn0004595","3R",11328480,11407627,79147
"3286","FBgn0260798","2R",4322295,4471060,148765
"3287","FBgn0032039","2L",8396649,8397886,1237
"3288","FBgn0051578","3R",17645610,17645681,71
"3289","FBgn0036942","3L",20139210,20140607,1397
"3290","FBgn0266585","3L",22843264,22843346,82
"3291","FBgn0050099","2R",16288208,16288969,761
"3292","FBgn0053810","2L",21437011,21438033,1022
"3293","FBgn0028325","X",4702284,4705265,2981
"3294","FBgn0028979","2L",22019208,22025734,6526
"3295","FBgn0032050","2L",8509069,8511866,2797
"3296","FBgn0267788","3R",31570983,31571281,298
"3297","FBgn0265198","3R",17270290,17271027,737
"3298","FBgn0039398","3R",25959279,25961686,2407
"3299","FBgn0265836","2R",20235545,20235945,400
"3300","FBgn0052199","3L",18611900,18614004,2104
"3301","FBgn0266918","3L",3055908,3070839,14931
"3302","FBgn0051515","3R",23388373,23388898,525
"3303","FBgn0010350","3L",8127762,8131675,3913
"3304","FBgn0038167","3R",13676549,13679430,2881
"3305","FBgn0037162","3L",22454373,22455989,1616
"3306","FBgn0000063","3R",17671271,17673828,2557
"3307","FBgn0020546","3R",16850004,16856497,6493
"3308","FBgn0028581","X",17136578,17142990,6412
"3309","FBgn0031952","2L",7801668,7810703,9035
"3310","FBgn0020272","X",21388977,21391533,2556
"3311","FBgn0051591","3R",17629086,17629158,72
"3312","FBgn0039126","3R",23926372,23927634,1262
"3313","FBgn0003926","2L",1432711,1432921,210
"3314","FBgn0030082","X",9081063,9082746,1683
"3315","FBgn0051040","3R",29930551,29933057,2506
"3316","FBgn0267305","3L",5316213,5316451,238
"3317","FBgn0011725","3R",24196893,24221965,25072
"3318","FBgn0262984","3L",7475570,7476247,677
"3319","FBgn0267956","3R",30630387,30631430,1043
"3320","FBgn0001197","3R",26866929,26869220,2291
"3321","FBgn0036937","3L",20108484,20111534,3050
"3322","FBgn0023545","X",2007911,2009364,1453
"3323","FBgn0004414","3L",22082720,22083367,647
"3324","FBgn0083034","2L",20419456,20419585,129
"3325","FBgn0014019","2L",12008153,12009832,1679
"3326","FBgn0259993","X",762615,763810,1195
"3327","FBgn0030826","X",17209368,17209997,629
"3328","FBgn0264432","2L",13415431,13420645,5214
"3329","FBgn0267760","3R",23746311,23747148,837
"3330","FBgn0032217","2L",10314792,10317569,2777
"3331","FBgn0035876","3L",8339051,8340276,1225
"3332","FBgn0265805","2L",12092009,12092358,349
"3333","FBgn0050389","2R",21148265,21160545,12280
"3334","FBgn0262988","2R",8417176,8417706,530
"3335","FBgn0039774","3R",30459521,30465736,6215
"3336","FBgn0050110","2R",17880194,17882245,2051
"3337","FBgn0037601","3R",8643070,8645650,2580
"3338","FBgn0035154","3L",685942,687958,2016
"3339","FBgn0250819","4",1185768,1192985,7217
"3340","FBgn0003447","X",7964024,7986601,22577
"3341","FBgn0266145","2L",14355468,14356878,1410
"3342","FBgn0264879","2R",9636996,9637673,677
"3343","FBgn0267807","3R",6554317,6554999,682
"3344","FBgn0263240","2R",7490836,7492589,1753
"3345","FBgn0037555","3R",8236632,8240515,3883
"3346","FBgn0263339","2L",17893812,17894734,922
"3347","FBgn0026063","3R",11346294,11353131,6837
"3348","FBgn0037122","3L",21729675,21730454,779
"3349","FBgn0030803","X",16886818,16888729,1911
"3350","FBgn0025741","4",1009895,1027101,17206
"3351","FBgn0266389","3R",9876998,9878498,1500
"3352","FBgn0053285","3L",21088223,21088989,766
"3353","FBgn0050051","2R",12436120,12436990,870
"3354","FBgn0266851","2R",13361825,13362835,1010
"3355","FBgn0003964","X",2038798,2042311,3513
"3356","FBgn0015571","3R",7538972,7541631,2659
"3357","FBgn0260454","2L",10843014,10845664,2650
"3358","FBgn0046253","2R",23343405,23347641,4236
"3359","FBgn0053964","2R",12182639,12185506,2867
"3360","FBgn0036843","3L",19063165,19066151,2986
"3361","FBgn0004588","3L",15649126,15649661,535
"3362","FBgn0262300","2R",12158872,12158970,98
"3363","FBgn0030189","X",10326464,10328946,2482
"3364","FBgn0086704","3R",31158156,31169106,10950
"3365","FBgn0030927","X",18487450,18489620,2170
"3366","FBgn0004364","2R",20111511,20116932,5421
"3367","FBgn0043069","3R",16988814,16990419,1605
"3368","FBgn0036761","3L",17843725,17846501,2776
"3369","FBgn0033308","2R",8594031,8595001,970
"3370","FBgn0260639","2L",2972891,2974858,1967
"3371","FBgn0037561","3R",8267943,8269896,1953
"3372","FBgn0004782","3R",6701968,6702877,909
"3373","FBgn0263411","3R",25502785,25503221,436
"3374","FBgn0265276","3R",11765038,11779128,14090
"3375","FBgn0004655","X",2149936,2158983,9047
"3376","FBgn0027342","X",7106272,7110321,4049
"3377","FBgn0259962","2L",11754085,11754502,417
"3378","FBgn0034439","2R",19375313,19380174,4861
"3379","FBgn0051242","3R",18108637,18108708,71
"3380","FBgn0263340","2R",19939882,19940544,662
"3381","FBgn0266843","2L",5070887,5071109,222
"3382","FBgn0265721","3L",4801909,4802894,985
"3383","FBgn0034740","2R",22650556,22653595,3039
"3384","FBgn0085421","2R",6759715,6798941,39226
"3385","FBgn0035718","3L",6932926,6934824,1898
"3386","FBgn0263144","2R",6214568,6240602,26034
"3387","FBgn0040726","2R",20698483,20750442,51959
"3388","FBgn0027535","2R",19129589,19133706,4117
"3389","FBgn0034484","2R",20231829,20234927,3098
"3390","FBgn0031008","X",19266656,19268896,2240
"3391","FBgn0265904","2L",18291682,18292092,410
"3392","FBgn0039395","3R",25921042,25922634,1592
"3393","FBgn0037943","3R",11741890,11744027,2137
"3394","FBgn0085487","2R",16672033,16672889,856
"3395","FBgn0039733","3R",29997900,29999755,1855
"3396","FBgn0265450","3R",22823686,22827260,3574
"3397","FBgn0266709","3L",13024763,13026437,1674
"3398","FBgn0032065","2L",8752285,8753209,924
"3399","FBgn0266593","3L",527232,527578,346
"3400","FBgn0266782","3L",10816581,10817182,601
"3401","FBgn0053414","2R",19743629,19743763,134
"3402","FBgn0033844","2R",13486634,13494862,8228
"3403","FBgn0041252","X",4241887,4242826,939
"3404","FBgn0038894","3R",21664389,21666676,2287
"3405","FBgn0025629","X",2074795,2075900,1105
"3406","FBgn0032395","2L",12014304,12020960,6656
"3407","FBgn0011576","X",2176006,2178728,2722
"3408","FBgn0263771","2R",18402474,18402749,275
"3409","FBgn0030791","X",16796902,16800710,3808
"3410","FBgn0035866","3L",8298501,8299839,1338
"3411","FBgn0263143","3R",22742954,22745581,2627
"3412","FBgn0037360","3R",5656236,5659912,3676
"3413","FBgn0262837","2R",10352456,10353114,658
"3414","FBgn0086025","2R",21331573,21331679,106
"3415","FBgn0264505","2R",6158597,6159635,1038
"3416","FBgn0013576","3R",5270116,5350443,80327
"3417","FBgn0267294","2L",5297486,5297928,442
"3418","FBgn0015926","X",15328342,15331002,2660
"3419","FBgn0266139","2L",10208741,10209786,1045
"3420","FBgn0004168","2R",19067155,19121958,54803
"3421","FBgn0042182","3R",8244055,8248054,3999
"3422","FBgn0026309","2R",17786135,17788556,2421
"3423","FBgn0044051","3L",9798420,9799050,630
"3424","FBgn0259838","Y",892743,894201,1458
"3425","FBgn0037765","3R",9818914,9819877,963
"3426","FBgn0083008","X",17145730,17145880,150
"3427","FBgn0083018","2R",21330276,21330413,137
"3428","FBgn0030447","X",13094299,13095732,1433
"3429","FBgn0035926","3L",8788144,8788545,401
"3430","FBgn0000303","3R",18705501,18732344,26843
"3431","FBgn0003714","X",2442313,2443976,1663
"3432","FBgn0266208","2L",18523271,18523941,670
"3433","FBgn0039167","3R",24214631,24218718,4087
"3434","FBgn0042206","3R",12364776,12365735,959
"3435","FBgn0031059","X",19693977,19695250,1273
"3436","FBgn0263633","3R",15192297,15192357,60
"3437","FBgn0035421","3L",3219156,3220925,1769
"3438","FBgn0038811","3R",20591024,20592671,1647
"3439","FBgn0259702","3L",2022070,2023391,1321
"3440","FBgn0032187","2L",10144776,10156407,11631
"3441","FBgn0035280","3L",1832636,1835164,2528
"3442","FBgn0032516","2L",13385848,13387312,1464
"3443","FBgn0002573","3L",13396228,13401125,4897
"3444","FBgn0053844","2L",21503521,21504013,492
"3445","FBgn0032639","2L",17456670,17458044,1374
"3446","FBgn0266166","2L",9959248,9960232,984
"3447","FBgn0038450","3R",16617950,16619878,1928
"3448","FBgn0262983","3R",14234984,14244677,9693
"3449","FBgn0028978","3L",20396288,20401609,5321
"3450","FBgn0265879","3L",17784788,17785284,496
"3451","FBgn0040699","3L",4462974,4463823,849
"3452","FBgn0036735","3L",17525333,17529861,4528
"3453","FBgn0000036","3R",24393896,24457157,63261
"3454","FBgn0000116","3L",9048781,9066027,17246
"3455","FBgn0266881","2L",2840025,2840316,291
"3456","FBgn0264998","2L",9568155,9568785,630
"3457","FBgn0004875","3L",3818679,3842326,23647
"3458","FBgn0036345","3L",13086387,13087289,902
"3459","FBgn0259204","X",7011357,7012137,780
"3460","FBgn0053812","2L",21440187,21440715,528
"3461","FBgn0042187","2L",2253045,2253852,807
"3462","FBgn0033663","2R",11887568,11890979,3411
"3463","FBgn0030738","X",16309817,16313138,3321
"3464","FBgn0024992","X",2694392,2698211,3819
"3465","FBgn0031936","2L",7719847,7722823,2976
"3466","FBgn0034490","2R",20248130,20254670,6540
"3467","FBgn0034681","2R",22034844,22035666,822
"3468","FBgn0025592","3L",202098,205844,3746
"3469","FBgn0265650","2R",15091945,15092445,500
"3470","FBgn0035825","3L",7913664,7915120,1456
"3471","FBgn0035020","2R",24531594,24533391,1797
"3472","FBgn0267448","3R",21266255,21267794,1539
"3473","FBgn0037781","3R",10051508,10052869,1361
"3474","FBgn0003132","X",15359101,15361061,1960
"3475","FBgn0031229","2L",156029,157666,1637
"3476","FBgn0001330","X",2237858,2242035,4177
"3477","FBgn0262899","3R",7738965,7739563,598
"3478","FBgn0034418","2R",19133727,19137169,3442
"3479","FBgn0035544","3L",4436721,4438311,1590
"3480","FBgn0029175","2R",16145904,16148719,2815
"3481","FBgn0036361","3L",13435680,13437136,1456
"3482","FBgn0027054","2R",7972175,7974099,1924
"3483","FBgn0035120","3L",258176,259097,921
"3484","FBgn0052855","3R",16078980,16080992,2012
"3485","FBgn0039190","3R",24360705,24361683,978
"3486","FBgn0052129","3L",13211214,13211285,71
"3487","FBgn0262519","3L",19882051,19910215,28164
"3488","FBgn0036819","3L",18867771,18869219,1448
"3489","FBgn0015527","X",21346503,21349843,3340
"3490","FBgn0264700","3L",393594,394299,705
"3491","FBgn0032649","2L",17529311,17532234,2923
"3492","FBgn0036685","3L",17012886,17016180,3294
"3493","FBgn0037078","3L",21355100,21356495,1395
"3494","FBgn0042129","2L",19965664,19966510,846
"3495","FBgn0004646","X",6973620,6991318,17698
"3496","FBgn0001083","X",11992915,12003914,10999
"3497","FBgn0085455","3L",8802463,8803599,1136
"3498","FBgn0038435","3R",16472601,16475477,2876
"3499","FBgn0053508","2L",21086790,21088751,1961
"3500","FBgn0267886","Y",3167772,3168037,265
"3501","FBgn0085458","3L",13063046,13063929,883
"3502","FBgn0259973","3L",22080322,22080554,232
"3503","FBgn0041706","2R",24114398,24116359,1961
"3504","FBgn0034769","2R",22705872,22706678,806
"3505","FBgn0264442","2L",11210678,11261080,50402
"3506","FBgn0032603","2L",16791568,16793444,1876
"3507","FBgn0052329","3L",1380529,1380600,71
"3508","FBgn0003386","2L",3718185,3729145,10960
"3509","FBgn0032318","2L",10936662,10937931,1269
"3510","FBgn0264997","2L",7684482,7685341,859
"3511","FBgn0014026","X",6530897,6533348,2451
"3512","FBgn0038481","3R",17129339,17130426,1087
"3513","FBgn0263408","3R",22996454,22997785,1331
"3514","FBgn0026164","3R",6821789,6821861,72
"3515","FBgn0037964","3R",11931262,11933640,2378
"3516","FBgn0037602","3R",8651084,8651493,409
"3517","FBgn0011668","3R",25831575,25831899,324
"3518","FBgn0039801","3R",30745479,30746290,811
"3519","FBgn0038981","3R",22520087,22528663,8576
"3520","FBgn0013753","3L",1639711,1640952,1241
"3521","FBgn0034263","2R",17722339,17723381,1042
"3522","FBgn0039522","3R",27515911,27517257,1346
"3523","FBgn0004057","X",19667252,19672353,5101
"3524","FBgn0032486","2L",13219979,13221398,1419
"3525","FBgn0033867","2R",13769915,13787802,17887
"3526","FBgn0031322","2L",1185757,1196807,11050
"3527","FBgn0032193","2L",10209853,10210681,828
"3528","FBgn0267441","2L",4185268,4186093,825
"3529","FBgn0036363","3L",13439317,13440470,1153
"3530","FBgn0037882","3R",11230617,11231879,1262
"3531","FBgn0031600","2L",4392770,4393876,1106
"3532","FBgn0063380","2R",17701936,17702002,66
"3533","FBgn0003302","X",6035753,6037800,2047
"3534","FBgn0010342","2R",9590867,9592744,1877
"3535","FBgn0027836","2R",18168413,18172607,4194
"3536","FBgn0035016","2R",24521874,24526089,4215
"3537","FBgn0040524","3R",8008249,8009297,1048
"3538","FBgn0011935","2R",6190129,6190202,73
"3539","FBgn0052544","X",18860284,18861964,1680
"3540","FBgn0031005","X",19248639,19252045,3406
"3541","FBgn0286040","X",16612716,16613031,315
"3542","FBgn0020236","2R",15993531,16001290,7759
"3543","FBgn0039299","3R",25242020,25243262,1242
"3544","FBgn0266821","2L",12316272,12317313,1041
"3545","FBgn0028377","3L",15509445,15510837,1392
"3546","FBgn0262001","2L",8388728,8389331,603
"3547","FBgn0000412","3R",9238083,9240654,2571
"3548","FBgn0001099","3L",15509445,15511047,1602
"3549","FBgn0266196","X",496597,497374,777
"3550","FBgn0266972","2R",20221395,20222157,762
"3551","FBgn0034964","2R",24037943,24044458,6515
"3552","FBgn0011336","3R",25066712,25069637,2925
"3553","FBgn0036504","3L",15520620,15521653,1033
"3554","FBgn0263970","2R",8028929,8029935,1006
"3555","FBgn0032554","2L",14874376,14876333,1957
"3556","FBgn0004102","X",8630159,8650681,20522
"3557","FBgn0264484","3L",19239864,19240139,275
"3558","FBgn0053120","2L",18841400,18844579,3179
"3559","FBgn0013698","mitochondrion_genome",12670,12734,64
"3560","FBgn0032706","2L",18711071,18713748,2677
"3561","FBgn0267653","3R",27411671,27412297,626
"3562","FBgn0050271","2R",22816474,22822111,5637
"3563","FBgn0283468","3R",21119252,21127485,8233
"3564","FBgn0034834","2R",23210130,23211539,1409
"3565","FBgn0020277","3L",19604398,19606090,1692
"3566","FBgn0030465","X",13285707,13287741,2034
"3567","FBgn0051217","3R",16652446,16655662,3216
"3568","FBgn0085433","3R",15363786,15367665,3879
"3569","FBgn0033395","2R",9237512,9239831,2319
"3570","FBgn0259234","2R",9446046,9480076,34030
"3571","FBgn0028697","3L",27267255,27268445,1190
"3572","FBgn0034647","2R",21660967,21662995,2028
"3573","FBgn0005617","2L",18683720,18688800,5080
"3574","FBgn0039755","3R",30194790,30196228,1438
"3575","FBgn0039924","4",1192419,1196848,4429
"3576","FBgn0034143","2R",16595028,16604373,9345
"3577","FBgn0036438","3L",14691347,14691962,615
"3578","FBgn0085481","3L",15686352,15687902,1550
"3579","FBgn0040918","X",6257668,6267228,9560
"3580","FBgn0084008","2R",5253945,5255295,1350
"3581","FBgn0026375","X",17639147,17652562,13415
"3582","FBgn0003710","3L",4188499,4193788,5289
"3583","FBgn0013674","mitochondrion_genome",1474,3009,1535
"3584","FBgn0026872","X",1466134,1468692,2558
"3585","FBgn0028567","3L",1477619,1478369,750
"3586","FBgn0264705","3L",8081924,8083200,1276
"3587","FBgn0265595","X",11219379,11302783,83404
"3588","FBgn0026592","3L",3892574,3894833,2259
"3589","FBgn0037874","3R",11210247,11211898,1651
"3590","FBgn0086070","3L",3222050,3222116,66
"3591","FBgn0266459","2L",16042047,16048757,6710
"3592","FBgn0085352","X",12070437,12071263,826
"3593","FBgn0033450","2R",9838434,9839500,1066
"3594","FBgn0027565","3L",20382405,20384109,1704
"3595","FBgn0038532","3R",17647679,17669985,22306
"3596","FBgn0264488","3L",11976111,11983764,7653
"3597","FBgn0267522","X",23278007,23280010,2003
"3598","FBgn0029966","X",7874394,7876847,2453
"3599","FBgn0265793","2L",10785503,10786173,670
"3600","FBgn0036732","3L",17487118,17511693,24575
"3601","FBgn0034898","2R",23718798,23719936,1138
"3602","FBgn0023513","X",1868870,1872408,3538
"3603","FBgn0064227","3L",3825449,3828525,3076
"3604","FBgn0037063","3L",21266680,21268335,1655
"3605","FBgn0267680","3R",12532699,12533786,1087
"3606","FBgn0264902","3R",5659477,5660570,1093
"3607","FBgn0030262","X",11089290,11090219,929
"3608","FBgn0032393","2L",11999654,12001244,1590
"3609","FBgn0267021","X",20238383,20239117,734
"3610","FBgn0032400","2L",12045343,12046118,775
"3611","FBgn0034433","2R",19307447,19310665,3218
"3612","FBgn0031407","2L",2263442,2264241,799
"3613","FBgn0267675","3R",11702913,11703708,795
"3614","FBgn0050366","2R",8363272,8365345,2073
"3615","FBgn0264704","3L",15098534,15099502,968
"3616","FBgn0036479","3L",15113557,15116373,2816
"3617","FBgn0265784","X",18366357,18377864,11507
"3618","FBgn0053373","2R",19758735,19758869,134
"3619","FBgn0050372","2R",8114286,8123001,8715
"3620","FBgn0050296","2R",21017784,21024918,7134
"3621","FBgn0030780","X",16711303,16714372,3069
"3622","FBgn0259211","2R",17801132,17842820,41688
"3623","FBgn0036078","3L",10243320,10244706,1386
"3624","FBgn0034270","2R",17737622,17739685,2063
"3625","FBgn0032638","2L",17454263,17455923,1660
"3626","FBgn0040336","X",2619799,2622140,2341
"3627","FBgn0027793","X",1460807,1461676,869
"3628","FBgn0051706","2L",11529038,11531052,2014
"3629","FBgn0266618","4",380724,381275,551
"3630","FBgn0053823","2L",21468098,21468590,492
"3631","FBgn0020880","2L",7775804,7778029,2225
"3632","FBgn0052425","3L",20497323,20514107,16784
"3633","FBgn0026713","X",14201362,14224732,23370
"3634","FBgn0259834","X",19310513,19322106,11593
"3635","FBgn0284247","2L",640013,714983,74970
"3636","FBgn0266826","2L",5940033,5940250,217
"3637","FBgn0034173","2R",16958943,16960195,1252
"3638","FBgn0262540","3R",22770613,22770987,374
"3639","FBgn0085447","3L",5657913,5749599,91686
"3640","FBgn0020415","2L",16447330,16450508,3178
"3641","FBgn0063491","2R",18409048,18409835,787
"3642","FBgn0261709","2L",12543176,12544343,1167
"3643","FBgn0013307","2R",8004824,8006672,1848
"3644","FBgn0267235","3L",3708563,3708997,434
"3645","FBgn0267703","3R",17700741,17701873,1132
"3646","FBgn0036346","3L",13088581,13089969,1388
"3647","FBgn0039861","3R",31617977,31622217,4240
"3648","FBgn0036585","3L",16262740,16263247,507
"3649","FBgn0037093","3L",21516306,21522684,6378
"3650","FBgn0264832","3R",15320378,15320691,313
"3651","FBgn0259174","3L",17530081,17546660,16579
"3652","FBgn0030816","X",17091854,17098488,6634
"3653","FBgn0023143","2R",9688289,9693328,5039
"3654","FBgn0035572","3L",4757883,4758708,825
"3655","FBgn0262595","2R",18640194,18640802,608
"3656","FBgn0035772","3L",7364584,7369260,4676
"3657","FBgn0045980","3R",24822401,24825648,3247
"3658","FBgn0263654","2L",17485757,17486365,608
"3659","FBgn0263048","3R",22382035,22386548,4513
"3660","FBgn0053496","X",20186630,20187472,842
"3661","FBgn0284411","3L",20557218,20557810,592
"3662","FBgn0266020","2L",21319600,21320320,720
"3663","FBgn0035137","3L",361472,365681,4209
"3664","FBgn0003567","3R",14304455,14308589,4134
"3665","FBgn0029176","3R",29220172,29222109,1937
"3666","FBgn0039994","2R",4744348,4758048,13700
"3667","FBgn0003079","X",2295466,2343870,48404
"3668","FBgn0037323","3R",5400594,5404135,3541
"3669","FBgn0034058","2R",15991367,15992375,1008
"3670","FBgn0262580","3L",14381913,14383299,1386
"3671","FBgn0262624","3L",1885657,1891462,5805
"3672","FBgn0032285","2L",10692940,10694103,1163
"3673","FBgn0265182","2R",24876691,24881221,4530
"3674","FBgn0031719","2L",5551838,5552756,918
"3675","FBgn0035792","3L",7505540,7506217,677
"3676","FBgn0030103","X",9214876,9215699,823
"3677","FBgn0263415","X",6732717,6735917,3200
"3678","FBgn0030223","X",10657680,10660671,2991
"3679","FBgn0040212","3R",25485618,25490936,5318
"3680","FBgn0010042","3R",12377128,12377907,779
"3681","FBgn0025639","X",648483,656033,7550
"3682","FBgn0039075","3R",23375928,23384777,8849
"3683","FBgn0014388","3L",3401153,3424935,23782
"3684","FBgn0022361","4",558016,567257,9241
"3685","FBgn0028969","X",1859141,1861790,2649
"3686","FBgn0026401","2R",4691672,4729017,37345
"3687","FBgn0023076","3L",7763233,7775603,12370
"3688","FBgn0058470","3L",23839860,23986410,146550
"3689","FBgn0036505","3L",15521711,15524137,2426
"3690","FBgn0260466","3R",20042757,20048716,5959
"3691","FBgn0037470","3R",7083225,7086083,2858
"3692","FBgn0038282","3R",15054930,15077206,22276
"3693","FBgn0264467","3L",20315134,20317283,2149
"3694","FBgn0267732","2L",7567929,7568438,509
"3695","FBgn0266893","2L",15468944,15469527,583
"3696","FBgn0266968","3L",6369973,6370591,618
"3697","FBgn0037643","3R",8938724,8943027,4303
"3698","FBgn0032680","2L",18454649,18455419,770
"3699","FBgn0263337","2R",18814938,18815641,703
"3700","FBgn0053359","2R",19763913,19764047,134
"3701","FBgn0053426","2R",19739194,19739328,134
"3702","FBgn0034527","2R",20618503,20621081,2578
"3703","FBgn0262461","3L",18860971,18861054,83
"3704","FBgn0267674","3R",11356106,11356601,495
"3705","FBgn0035552","3L",4482809,4484370,1561
"3706","FBgn0085325","3R",29722538,29723013,475
"3707","FBgn0036639","3L",16556823,16557958,1135
"3708","FBgn0038652","3R",18759236,18795169,35933
"3709","FBgn0264721","3L",11163849,11164801,952
"3710","FBgn0003380","X",17924307,18063247,138940
"3711","FBgn0034946","2R",23970305,23972233,1928
"3712","FBgn0025740","4",32478,43778,11300
"3713","FBgn0030599","X",14954123,14955100,977
"3714","FBgn0262370","2R",20606067,20606154,87
"3715","FBgn0263081","2L",1200205,1200663,458
"3716","FBgn0030406","X",12609977,12611667,1690
"3717","FBgn0041630","3L",4288641,4291211,2570
"3718","FBgn0267996","2L",286383,288292,1909
"3719","FBgn0265923","X",21630936,21631433,497
"3720","FBgn0004367","X",16391698,16399850,8152
"3721","FBgn0051432","3R",12322563,12322634,71
"3722","FBgn0013695","mitochondrion_genome",8141,8206,65
"3723","FBgn0065096","2L",19403535,19403568,33
"3724","FBgn0039555","3R",27916908,27918248,1340
"3725","FBgn0038307","3R",15229665,15230516,851
"3726","FBgn0030974","X",18888978,18893636,4658
"3727","FBgn0267671","3R",11033380,11034203,823
"3728","FBgn0036996","3L",20460683,20462274,1591
"3729","FBgn0010772","3R",5665139,5669334,4195
"3730","FBgn0020910","3R",11221894,11225173,3279
"3731","FBgn0052751","X",6196580,6198654,2074
"3732","FBgn0035023","2R",24537421,24558961,21540
"3733","FBgn0082978","3R",5596526,5596658,132
"3734","FBgn0013756","2R",11852617,11861202,8585
"3735","FBgn0039554","3R",27913777,27916516,2739
"3736","FBgn0267794","3L",17934032,17946114,12082
"3737","FBgn0039830","3R",31216145,31219630,3485
"3738","FBgn0265871","2R",20722595,20723095,500
"3739","FBgn0261455","3R",22036343,22036443,100
"3740","FBgn0032260","2L",10489900,10491454,1554
"3741","FBgn0000560","3L",21808703,21817600,8897
"3742","FBgn0022027","2R",8625451,8626180,729
"3743","FBgn0037741","3R",9751088,9754686,3598
"3744","FBgn0039600","3R",28812102,28817354,5252
"3745","FBgn0263844","3L",20795019,20795678,659
"3746","FBgn0036947","3L",20200443,20201638,1195
"3747","FBgn0023523","X",2246231,2247567,1336
"3748","FBgn0036500","3L",15498959,15500561,1602
"3749","FBgn0040080","3R",27582840,27586376,3536
"3750","FBgn0260747","X",17149001,17150647,1646
"3751","FBgn0038499","3R",17374833,17391337,16504
"3752","FBgn0266711","2R",19445085,19446286,1201
"3753","FBgn0266772","3L",22420855,22421200,345
"3754","FBgn0034060","2R",16001181,16006901,5720
"3755","FBgn0035823","3L",7894880,7896009,1129
"3756","FBgn0034201","2R",17154589,17157125,2536
"3757","FBgn0039368","3R",25775288,25776237,949
"3758","FBgn0052202","3L",18682184,18682860,676
"3759","FBgn0032914","2L",21091227,21094864,3637
"3760","FBgn0037550","3R",8125290,8126357,1067
"3761","FBgn0051835","2L",14735843,14737067,1224
"3762","FBgn0036499","3L",15498202,15498821,619
"3763","FBgn0039198","3R",24386104,24390339,4235
"3764","FBgn0004380","3L",5356864,5359392,2528
"3765","FBgn0035578","3L",4837791,4840108,2317
"3766","FBgn0040031","X",23036066,23047678,11612
"3767","FBgn0000061","2L",378112,387439,9327
"3768","FBgn0267891","Y",3203123,3203840,717
"3769","FBgn0039872","3R",31751825,31754705,2880
"3770","FBgn0086047","X",12497701,12497808,107
"3771","FBgn0262023","3R",17418759,17419294,535
"3772","FBgn0285926","X",10787869,10824277,36408
"3773","FBgn0000317","2L",15044963,15057862,12899
"3774","FBgn0037490","3R",7247090,7248140,1050
"3775","FBgn0264262","2L",21894227,21895350,1123
"3776","FBgn0031327","2L",1240036,1243018,2982
"3777","FBgn0038326","3R",15357229,15359263,2034
"3778","FBgn0045473","3R",9995544,9996789,1245
"3779","FBgn0263980","2R",15401096,15471884,70788
"3780","FBgn0004643","X",2604197,2606824,2627
"3781","FBgn0259846","Y",1032220,1032946,726
"3782","FBgn0010398","2L",10517335,10519269,1934
"3783","FBgn0262572","2R",11249594,11249933,339
"3784","FBgn0032744","2L",19043535,19045148,1613
"3785","FBgn0063391","2L",9893946,9894026,80
"3786","FBgn0026250","3R",18274665,18283005,8340
"3787","FBgn0053124","2L",2206525,2209102,2577
"3788","FBgn0051516","3R",4218463,4220130,1667
"3789","FBgn0031608","2L",4459729,4461746,2017
"3790","FBgn0037419","3R",6278531,6282495,3964
"3791","FBgn0034580","2R",21061646,21063212,1566
"3792","FBgn0037612","3R",8712933,8715263,2330
"3793","FBgn0267708","3R",19058020,19058519,499
"3794","FBgn0011834","X",20962605,20963505,900
"3795","FBgn0264089","2R",15869495,15922118,52623
"3796","FBgn0040842","3L",5131545,5132127,582
"3797","FBgn0031832","2L",6559426,6562289,2863
"3798","FBgn0267819","3R",9795008,9796050,1042
"3799","FBgn0261801","3L",6400590,6485964,85374
"3800","FBgn0052099","3L",12149273,12150329,1056
"3801","FBgn0037412","3R",6218318,6221781,3463
"3802","FBgn0020300","3L",18139402,18145418,6016
"3803","FBgn0267101","X",9584177,9584575,398
"3804","FBgn0038593","3R",18271189,18274446,3257
"3805","FBgn0267013","2L",9327039,9327553,514
"3806","FBgn0033757","2R",12628697,12632378,3681
"3807","FBgn0035542","3L",4406943,4420648,13705
"3808","FBgn0266421","X",11615097,11615840,743
"3809","FBgn0052093","3L",11801471,11801542,71
"3810","FBgn0038056","3R",12458421,12460294,1873
"3811","FBgn0031871","2L",6943178,6945289,2111
"3812","FBgn0036183","3L",11624528,11626125,1597
"3813","FBgn0265806","2L",12582402,12583550,1148
"3814","FBgn0065097","3L",5567885,5567961,76
"3815","FBgn0040892","X",862608,863200,592
"3816","FBgn0036757","3L",17815570,17817921,2351
"3817","FBgn0037888","3R",11240041,11240991,950
"3818","FBgn0036302","3L",12537513,12572542,35029
"3819","FBgn0039510","3R",27294286,27322325,28039
"3820","FBgn0265918","X",18682143,18683303,1160
"3821","FBgn0028425","2L",12051755,12056042,4287
"3822","FBgn0003255","2L",13982743,14001248,18505
"3823","FBgn0035848","3L",8180923,8183369,2446
"3824","FBgn0284419","3R",13541913,13542314,401
"3825","FBgn0023388","2L",21134439,21142347,7908
"3826","FBgn0036783","3L",18252088,18252846,758
"3827","FBgn0041094","3L",11252307,11256172,3865
"3828","FBgn0262623","3L",13299841,13300152,311
"3829","FBgn0024321","3R",14329413,14372951,43538
"3830","FBgn0263323","2L",9364297,9364991,694
"3831","FBgn0030364","X",12018640,12020719,2079
"3832","FBgn0265659","2R",16845495,16845995,500
"3833","FBgn0261673","2R",12659497,12670219,10722
"3834","FBgn0040553","3R",13396694,13397140,446
"3835","FBgn0263018","3R",5195004,5195163,159
"3836","FBgn0024277","3L",995982,1034875,38893
"3837","FBgn0046323","Y",3561745,3618339,56594
"3838","FBgn0264944","2L",2555750,2556089,339
"3839","FBgn0265580","2L",10710101,10710733,632
"3840","FBgn0086900","3L",6147531,6147987,456
"3841","FBgn0053057","3L",8402168,8405277,3109
"3842","FBgn0031285","2L",821289,824337,3048
"3843","FBgn0016698","2L",3377002,3378590,1588
"3844","FBgn0082997","X",6743675,6743815,140
"3845","FBgn0262438","2L",16724795,16724858,63
"3846","FBgn0265912","2L",9887039,9887389,350
"3847","FBgn0003983","2L",13411141,13411631,490
"3848","FBgn0003742","2R",14602004,14604337,2333
"3849","FBgn0016126","4",445504,453947,8443
"3850","FBgn0031006","X",19252111,19261240,9129
"3851","FBgn0037347","3R",5601433,5603185,1752
"3852","FBgn0263395","2R",19178738,19227193,48455
"3853","FBgn0030859","X",17669208,17671888,2680
"3854","FBgn0086913","3L",21318774,21335027,16253
"3855","FBgn0267828","2L",10510672,10517218,6546
"3856","FBgn0002791","2R",23972431,23975408,2977
"3857","FBgn0038539","3R",17724410,17725063,653
"3858","FBgn0031261","2L",545129,547096,1967
"3859","FBgn0022359","3R",10876384,10878257,1873
"3860","FBgn0030790","X",16792119,16797742,5623
"3861","FBgn0266789","3L",13298211,13298719,508
"3862","FBgn0002571","2R",8455909,8457892,1983
"3863","FBgn0265427","2R",12985367,12985995,628
"3864","FBgn0004507","2L",2130813,2137296,6483
"3865","FBgn0038387","3R",15933847,15934940,1093
"3866","FBgn0000075","2L",19110154,19114110,3956
"3867","FBgn0030808","X",16943290,16956234,12944
"3868","FBgn0027930","3R",4307908,4309835,1927
"3869","FBgn0013432","X",2148463,2149647,1184
"3870","FBgn0250789","3L",1778485,1795328,16843
"3871","FBgn0265696","2R",19633195,19634595,1400
"3872","FBgn0030101","X",9194750,9196414,1664
"3873","FBgn0012028","3R",8642333,8642425,92
"3874","FBgn0036512","3L",15576570,15578674,2104
"3875","FBgn0265167","3R",12930734,12931327,593
"3876","FBgn0003575","X",635890,643760,7870
"3877","FBgn0264599","2R",9976996,9979584,2588
"3878","FBgn0265987","X",10744508,10745250,742
"3879","FBgn0000319","X",15827986,15835490,7504
"3880","FBgn0030417","X",12705854,12708841,2987
"3881","FBgn0026417","3R",4808336,4812096,3760
"3882","FBgn0265068","3R",25491285,25493262,1977
"3883","FBgn0032956","2L",21658735,21663698,4963
"3884","FBgn0035657","3L",6009446,6011021,1575
"3885","FBgn0038832","3R",20842140,20844981,2841
"3886","FBgn0031391","2L",2145297,2147275,1978
"3887","FBgn0032625","2L",17047161,17048281,1120
"3888","FBgn0038507","3R",17411108,17412680,1572
"3889","FBgn0267287","2L",19470065,19470724,659
"3890","FBgn0019660","X",11579065,11580432,1367
"3891","FBgn0267030","X",620282,620729,447
"3892","FBgn0063374","2R",17701689,17701764,75
"3893","FBgn0261381","3L",11708979,11710570,1591
"3894","FBgn0051522","3R",4441415,4462883,21468
"3895","FBgn0053710","3L",19951954,19952790,836
"3896","FBgn0264562","X",1941940,2007956,66016
"3897","FBgn0283429","X",20202076,20202922,846
"3898","FBgn0266230","3R",5965806,5966411,605
"3899","FBgn0039466","3R",26966930,26977878,10948
"3900","FBgn0029745","X",5131898,5132985,1087
"3901","FBgn0267321","3L",21961871,21962196,325
"3902","FBgn0085474","2R",22647892,22648478,586
"3903","FBgn0263082","2L",9349546,9349963,417
"3904","FBgn0029512","3R",12432533,12433822,1289
"3905","FBgn0053444","2R",19732550,19732684,134
"3906","FBgn0033214","2R",7709873,7711981,2108
"3907","FBgn0085242","2R",23967124,23967745,621
"3908","FBgn0038673","3R",19024092,19024853,761
"3909","FBgn0086357","2L",6477182,6480575,3393
"3910","FBgn0010352","3L",16954822,16968724,13902
"3911","FBgn0261680","3R",15348048,15350391,2343
"3912","FBgn0053144","2R",10740054,10798709,58655
"3913","FBgn0034423","2R",19259909,19262294,2385
"3914","FBgn0040510","2L",12921091,12925453,4362
"3915","FBgn0034903","2R",23753477,23798395,44918
"3916","FBgn0040075","3L",19255340,19257111,1771
"3917","FBgn0259949","2L",3387354,3387743,389
"3918","FBgn0023496","2L",10699408,10701544,2136
"3919","FBgn0053926","3L",9443232,9446388,3156
"3920","FBgn0052631","X",13556472,13557866,1394
"3921","FBgn0031497","2L",3035493,3037403,1910
"3922","FBgn0286007","2R",12170153,12170244,91
"3923","FBgn0053742","2L",21518794,21518829,35
"3924","FBgn0038381","3R",15908398,15910367,1969
"3925","FBgn0037446","3R",6457088,6458822,1734
"3926","FBgn0033056","2R",6057357,6059558,2201
"3927","FBgn0032924","2L",21160636,21163083,2447
"3928","FBgn0034999","2R",24294097,24298111,4014
"3929","FBgn0259727","2R",21667541,21669916,2375
"3930","FBgn0035727","3L",6971579,6972467,888
"3931","FBgn0053293","3R",5240014,5240735,721
"3932","FBgn0265589","2R",17766865,17767145,280
"3933","FBgn0082975","3R",28602340,28602489,149
"3934","FBgn0265636","2R",7134495,7135095,600
"3935","FBgn0030004","X",8132285,8134967,2682
"3936","FBgn0030753","X",16441433,16445367,3934
"3937","FBgn0052564","X",17206407,17207854,1447
"3938","FBgn0014022","3R",9513327,9514827,1500
"3939","FBgn0028955","2R",9138486,9141981,3495
"3940","FBgn0030298","X",11413467,11417422,3955
"3941","FBgn0039356","3R",25678683,25679529,846
"3942","FBgn0267049","X",19948079,19948873,794
"3943","FBgn0035817","3L",7754409,7755168,759
"3944","FBgn0267220","3L",2629834,2630693,859
"3945","FBgn0030993","X",19188035,19190193,2158
"3946","FBgn0286075","3R",12399011,12401839,2828
"3947","FBgn0029929","X",7013887,7015009,1122
"3948","FBgn0000032","3R",29991144,29993411,2267
"3949","FBgn0260750","2L",10270051,10271465,1414
"3950","FBgn0030504","X",13619276,13624408,5132
"3951","FBgn0013767","3R",14314854,14315716,862
"3952","FBgn0005660","2L",544925,552923,7998
"3953","FBgn0053547","3R",17872748,17916578,43830
"3954","FBgn0264291","3R",17149667,17150455,788
"3955","FBgn0264377","2R",15193996,15194505,509
"3956","FBgn0267936","3L",19248529,19249689,1160
"3957","FBgn0029935","X",7098578,7102300,3722
"3958","FBgn0003638","X",1012779,1046040,33261
"3959","FBgn0284442","X",5323855,5326738,2883
"3960","FBgn0053329","3R",14222074,14224155,2081
"3961","FBgn0086784","2R",8729502,8734304,4802
"3962","FBgn0259149","X",5773023,5776647,3624
"3963","FBgn0260398","2R",8129354,8131323,1969
"3964","FBgn0029789","X",5685253,5689473,4220
"3965","FBgn0015371","2R",15115236,15144783,29547
"3966","FBgn0041186","3R",29152074,29153266,1192
"3967","FBgn0035132","3L",332801,342915,10114
"3968","FBgn0023507","X",2141489,2144937,3448
"3969","FBgn0266950","3L",125009,125420,411
"3970","FBgn0039863","3R",31669465,31677971,8506
"3971","FBgn0053877","2L",21514466,21514878,412
"3972","FBgn0262680","3L",70851,71396,545
"3973","FBgn0011877","2R",12336733,12336804,71
"3974","FBgn0010173","3R",8262120,8264451,2331
"3975","FBgn0034655","2R",21688773,21690253,1480
"3976","FBgn0036750","3L",17745173,17746860,1687
"3977","FBgn0262996","2L",17541854,17542383,529
"3978","FBgn0040827","3L",9096877,9097494,617
"3979","FBgn0263562","3R",31051098,31051203,105
"3980","FBgn0267978","2R",5706202,5727525,21323
"3981","FBgn0053906","2L",21433122,21433716,594
"3982","FBgn0262100","3L",18120932,18121989,1057
"3983","FBgn0265674","2L",11665241,11665810,569
"3984","FBgn0266855","2R",16378815,16380135,1320
"3985","FBgn0035249","3L",1645931,1647464,1533
"3986","FBgn0037666","3R",9253545,9254683,1138
"3987","FBgn0037835","3R",10792904,10793643,739
"3988","FBgn0011994","3R",17624806,17624879,73
"3989","FBgn0284257","2R",18430315,18440475,10160
"3990","FBgn0265759","3L",17631390,17632253,863
"3991","FBgn0053642","2L",13529975,13530736,761
"3992","FBgn0052833","2R",22984273,22985334,1061
"3993","FBgn0039337","3R",25477003,25477745,742
"3994","FBgn0038412","3R",16305758,16308700,2942
"3995","FBgn0003430","2L",3825675,3827099,1424
"3996","FBgn0265451","3L",1773605,1775108,1503
"3997","FBgn0036536","3L",15832464,15833947,1483
"3998","FBgn0054012","3L",11108820,11109505,685
"3999","FBgn0064116","X",21317936,21319296,1360
"4000","FBgn0033042","2R",5795413,5796710,1297
"4001","FBgn0033292","2R",8439395,8442806,3411
"4002","FBgn0032329","2L",11009821,11011086,1265
"4003","FBgn0087008","X",19626548,19638369,11821
"4004","FBgn0026015","X",6284138,6287990,3852
"4005","FBgn0266710","X",14718273,14718942,669
"4006","FBgn0266863","2R",9988125,9989285,1160
"4007","FBgn0021814","2R",8078869,8080041,1172
"4008","FBgn0267992","2L",500873,502236,1363
"4009","FBgn0262204","2R",2552170,2552282,112
"4010","FBgn0038330","3R",15367816,15369945,2129
"4011","FBgn0259241","X",10967722,11039901,72179
"4012","FBgn0034837","2R",23246610,23247893,1283
"4013","FBgn0263106","3L",5750029,5752189,2160
"4014","FBgn0028900","2L",15834569,15835658,1089
"4015","FBgn0265656","2R",15217995,15218195,200
"4016","FBgn0086677","2R",12085194,12119340,34146
"4017","FBgn0033848","2R",13515259,13517452,2193
"4018","FBgn0085412","3R",13715207,13764667,49460
"4019","FBgn0002780","3R",32052060,32054974,2914
"4020","FBgn0261871","2L",10917015,10964153,47138
"4021","FBgn0037200","3L",22872200,22873702,1502
"4022","FBgn0243586","3R",26656440,26657531,1091
"4023","FBgn0265066","3R",14496378,14508987,12609
"4024","FBgn0011659","2R",8170274,8172401,2127
"4025","FBgn0051851","2L",13257477,13258644,1167
"4026","FBgn0267961","3L",12286342,12286683,341
"4027","FBgn0030863","X",17698917,17703024,4107
"4028","FBgn0022097","2R",15541435,15542498,1063
"4029","FBgn0029977","X",7918517,7920131,1614
"4030","FBgn0011882","2R",13430984,13431057,73
"4031","FBgn0266942","3L",17947192,17947700,508
"4032","FBgn0028399","3L",16412722,16415386,2664
"4033","FBgn0032812","2L",19580612,19582474,1862
"4034","FBgn0050052","2R",12690059,12690955,896
"4035","FBgn0035720","3L",6949491,6955904,6413
"4036","FBgn0033717","2R",12339610,12344617,5007
"4037","FBgn0051617","2L",21421855,21422877,1022
"4038","FBgn0260789","X",9236801,9243467,6666
"4039","FBgn0266886","2L",20562247,20575720,13473
"4040","FBgn0031785","2L",6139382,6145010,5628
"4041","FBgn0053282","2L",3327903,3329792,1889
"4042","FBgn0032259","2L",10488694,10490461,1767
"4043","FBgn0264723","3L",12245510,12246048,538
"4044","FBgn0053784","3R",10067905,10068572,667
"4045","FBgn0037251","3R",4436222,4437329,1107
"4046","FBgn0026192","X",17703352,17707096,3744
"4047","FBgn0011296","2R",23684651,23685543,892
"4048","FBgn0035553","3L",4485159,4490963,5804
"4049","FBgn0267478","3L",1963213,1963700,487
"4050","FBgn0263487","2R",14602986,14603124,138
"4051","FBgn0038058","3R",12462562,12465298,2736
"4052","FBgn0035335","3L",2372844,2373704,860
"4053","FBgn0265683","2L",10886454,10887199,745
"4054","FBgn0083031","2L",20421304,20421438,134
"4055","FBgn0263523","2L",3636967,3637073,106
"4056","FBgn0067407","3R",27845089,27845414,325
"4057","FBgn0037827","3R",10714798,10715901,1103
"4058","FBgn0000591","3R",26040240,26041008,768
"4059","FBgn0033973","2R",14855429,14857502,2073
"4060","FBgn0083936","2R",17133445,17133750,305
"4061","FBgn0264941","X",14517290,14519516,2226
"4062","FBgn0036815","3L",18821171,18822353,1182
"4063","FBgn0035294","3L",1941068,1942872,1804
"4064","FBgn0010621","2R",12174802,12177516,2714
"4065","FBgn0029154","2R",16414815,16419398,4583
"4066","FBgn0262102","2R",18687372,18688641,1269
"4067","FBgn0026582","2R",21146203,21147608,1405
"4068","FBgn0085480","3L",15688517,15692047,3530
"4069","FBgn0050076","2R",14544150,14546372,2222
"4070","FBgn0039641","3R",29145678,29146893,1215
"4071","FBgn0260967","3L",8068413,8069267,854
"4072","FBgn0002774","2R",5974857,5980778,5921
"4073","FBgn0037399","3R",6076804,6078283,1479
"4074","FBgn0038241","3R",14564323,14564805,482
"4075","FBgn0036816","3L",18828632,18846267,17635
"4076","FBgn0261060","3R",21735909,21736296,387
"4077","FBgn0266241","3R",8038250,8039626,1376
"4078","FBgn0263742","2R",20789295,20790201,906
"4079","FBgn0036919","3L",19924943,19927175,2232
"4080","FBgn0032253","2L",10452677,10457241,4564
"4081","FBgn0011715","3R",5470926,5472754,1828
"4082","FBgn0039771","3R",30444076,30445046,970
"4083","FBgn0034716","2R",22223681,22228574,4893
"4084","FBgn0040514","X",23084672,23085536,864
"4085","FBgn0034463","2R",19657573,19659599,2026
"4086","FBgn0032224","2L",10342594,10344223,1629
"4087","FBgn0263346","3R",4659579,4712193,52614
"4088","FBgn0040650","X",20426431,20427042,611
"4089","FBgn0266154","2L",15399560,15399858,298
"4090","FBgn0032506","2L",13349823,13355073,5250
"4091","FBgn0284083","2R",10351533,10352161,628
"4092","FBgn0039306","3R",25265844,25267757,1913
"4093","FBgn0040958","2L",8394446,8394940,494
"4094","FBgn0267554","3L",16353498,16353916,418
"4095","FBgn0033501","2R",10256686,10261276,4590
"4096","FBgn0085213","2R",14365656,14366658,1002
"4097","FBgn0266889","2R",24024098,24025777,1679
"4098","FBgn0035590","3L",5138652,5139395,743
"4099","FBgn0036588","3L",16269392,16269911,519
"4100","FBgn0052040","3L",9354033,9355457,1424
"4101","FBgn0036217","3L",11870457,11871305,848
"4102","FBgn0037844","3R",10856807,10858066,1259
"4103","FBgn0050290","2R",21691295,21692764,1469
"4104","FBgn0040717","2L",2008414,2009072,658
"4105","FBgn0051955","2L",3711881,3713105,1224
"4106","FBgn0050151","2R",20528503,20529464,961
"4107","FBgn0031374","2L",1884622,1944289,59667
"4108","FBgn0085211","2L",9436804,9437227,423
"4109","FBgn0086782","X",19886108,19890060,3952
"4110","FBgn0052437","3L",21357683,21359867,2184
"4111","FBgn0083016","2R",21330906,21331043,137
"4112","FBgn0267127","3R",29022478,29024217,1739
"4113","FBgn0035244","3L",1618414,1623413,4999
"4114","FBgn0033649","2R",11712263,11726345,14082
"4115","FBgn0036922","3L",19978713,19979812,1099
"4116","FBgn0034286","2R",17975122,18007902,32780
"4117","FBgn0261567","2L",14744421,14744817,396
"4118","FBgn0263546","2R",24294231,24294331,100
"4119","FBgn0032013","2L",8303429,8305376,1947
"4120","FBgn0036257","3L",12138868,12143380,4512
"4121","FBgn0041225","3R",23051689,23052903,1214
"4122","FBgn0036712","3L",17342050,17344696,2646
"4123","FBgn0085300","3L",6158075,6158630,555
"4124","FBgn0037583","3R",8359958,8362554,2596
"4125","FBgn0082994","3L",5763946,5764084,138
"4126","FBgn0086200","2L",18665132,18667548,2416
"4127","FBgn0014865","2R",15408846,15409113,267
"4128","FBgn0030012","X",8152948,8154533,1585
"4129","FBgn0039102","3R",23686255,23688147,1892
"4130","FBgn0040376","X",2580958,2583823,2865
"4131","FBgn0037350","3R",5622119,5624125,2006
"4132","FBgn0026319","2L",4361925,4380716,18791
"4133","FBgn0038032","3R",12390166,12395980,5814
"4134","FBgn0038877","3R",21271078,21273817,2739
"4135","FBgn0038833","3R",20847068,20847748,680
"4136","FBgn0050025","2R",11353564,11354373,809
"4137","FBgn0265715","3L",6263008,6263399,391
"4138","FBgn0053386","2R",19753927,19754061,134
"4139","FBgn0285937","3R",21266029,21269060,3031
"4140","FBgn0053645","2L",13532872,13533454,582
"4141","FBgn0263852","2L",8383612,8384137,525
"4142","FBgn0022029","2R",17420407,17425679,5272
"4143","FBgn0050033","2R",11292531,11293591,1060
"4144","FBgn0011928","3L",14674344,14674415,71
"4145","FBgn0033556","2R",10822400,10823372,972
"4146","FBgn0033891","2R",13983395,13984893,1498
"4147","FBgn0000618","X",11576118,11576620,502
"4148","FBgn0015721","2R",21101928,21123704,21776
"4149","FBgn0032078","2L",8943455,8951216,7761
"4150","FBgn0263488","3L",5764861,5765046,185
"4151","FBgn0003279","3R",27922821,27924888,2067
"4152","FBgn0035554","3L",4496883,4497777,894
"4153","FBgn0052200","3L",18618390,18618461,71
"4154","FBgn0032385","2L",11947941,11948803,862
"4155","FBgn0003076","3L",16126018,16128531,2513
"4156","FBgn0052191","3L",17806451,17809146,2695
"4157","FBgn0027592","2L",473013,476170,3157
"4158","FBgn0037911","3R",11557776,11559877,2101
"4159","FBgn0086605","3R",4398381,4402027,3646
"4160","FBgn0034982","2R",24135180,24138050,2870
"4161","FBgn0082924","X",7901062,7901203,141
"4162","FBgn0034010","2R",15325503,15326386,883
"4163","FBgn0053866","2L",21541153,21541681,528
"4164","FBgn0053487","X",20194360,20195206,846
"4165","FBgn0250825","3L",12127979,12128461,482
"4166","FBgn0036861","3L",19280120,19280800,680
"4167","FBgn0052115","3L",12912027,12913646,1619
"4168","FBgn0029839","X",6078708,6081372,2664
"4169","FBgn0033905","2R",14168786,14170233,1447
"4170","FBgn0053242","X",14053087,14053811,724
"4171","FBgn0263376","2R",14737578,14739242,1664
"4172","FBgn0003731","2R",21522420,21559977,37557
"4173","FBgn0039821","3R",31127965,31130666,2701
"4174","FBgn0011582","3R",14165379,14214810,49431
"4175","FBgn0035235","3L",1559813,1568608,8795
"4176","FBgn0016701","2R",17573462,17574979,1517
"4177","FBgn0085804","3R",722370,722621,251
"4178","FBgn0262531","3L",17645486,17646737,1251
"4179","FBgn0036710","3L",17337172,17339262,2090
"4180","FBgn0051634","2L",6625138,6632407,7269
"4181","FBgn0085288","3L",2026991,2028326,1335
"4182","FBgn0003683","3L",18592303,18593771,1468
"4183","FBgn0004892","2L",3578013,3580769,2756
"4184","FBgn0267553","3L",16343189,16345241,2052
"4185","FBgn0053796","3L",16169455,16170106,651
"4186","FBgn0030929","X",18493193,18494168,975
"4187","FBgn0000045","3L",21985210,21987190,1980
"4188","FBgn0024957","3R",10408618,10412869,4251
"4189","FBgn0032402","2L",12049418,12052049,2631
"4190","FBgn0036327","3L",12971214,12972359,1145
"4191","FBgn0004449","3L",22293044,22407863,114819
"4192","FBgn0015011","3R",16978439,16982158,3719
"4193","FBgn0035669","3L",6059658,6061378,1720
"4194","FBgn0262687","X",11919125,11919657,532
"4195","FBgn0032291","2L",10730255,10731356,1101
"4196","FBgn0034087","2R",16186584,16194277,7693
"4197","FBgn0034726","2R",22411789,22412582,793
"4198","FBgn0284226","3R",23173873,23185642,11769
"4199","FBgn0036514","3L",15580800,15583373,2573
"4200","FBgn0011891","2R",6142372,6142444,72
"4201","FBgn0033566","2R",10885019,10886375,1356
"4202","FBgn0030305","X",11483518,11485060,1542
"4203","FBgn0050048","2R",12394907,12399142,4235
"4204","FBgn0003371","X",2633952,2679553,45601
"4205","FBgn0030566","X",14380351,14381416,1065
"4206","FBgn0050067","2R",14370331,14371116,785
"4207","FBgn0053383","2R",19755034,19755168,134
"4208","FBgn0267879","Y",3113044,3113644,600
"4209","FBgn0040232","2L",11261026,11269002,7976
"4210","FBgn0000287","2L",11358873,11373636,14763
"4211","FBgn0037026","3L",20806868,20809272,2404
"4212","FBgn0032476","2L",13177150,13178978,1828
"4213","FBgn0037624","3R",8747798,8754104,6306
"4214","FBgn0036608","3L",16325083,16326757,1674
"4215","FBgn0267276","2L",2006867,2007688,821
"4216","FBgn0035498","3L",4103564,4107116,3552
"4217","FBgn0033235","2R",7936866,7939114,2248
"4218","FBgn0036212","3L",11820338,11822275,1937
"4219","FBgn0263027","2L",7013396,7014737,1341
"4220","FBgn0050284","2R",21650820,21651999,1179
"4221","FBgn0267047","X",19938232,19938994,762
"4222","FBgn0262811","X",353067,353317,250
"4223","FBgn0266773","3L",6640891,6641514,623
"4224","FBgn0030492","X",13528006,13529280,1274
"4225","FBgn0036909","3L",19805181,19806932,1751
"4226","FBgn0004650","X",1322513,1329438,6925
"4227","FBgn0050050","2R",12408954,12409735,781
"4228","FBgn0267240","3R",13617750,13618559,809
"4229","FBgn0008635","X",18381549,18385242,3693
"4230","FBgn0034242","2R",17564340,17565852,1512
"4231","FBgn0267008","2L",4633881,4634342,461
"4232","FBgn0043043","3R",12436248,12437857,1609
"4233","FBgn0028892","2L",15433309,15435304,1995
"4234","FBgn0011981","X",14104649,14104730,81
"4235","FBgn0262126","2L",2231106,2236844,5738
"4236","FBgn0262593","3L",2895017,2959579,64562
"4237","FBgn0038431","3R",16454492,16455797,1305
"4238","FBgn0033755","2R",12572068,12575299,3231
"4239","FBgn0262387","3L",8571799,8571898,99
"4240","FBgn0267113","3R",30530355,30532377,2022
"4241","FBgn0040528","3R",8248438,8250324,1886
"4242","FBgn0053469","2R",14605652,14606302,650
"4243","FBgn0033818","2R",13248894,13251724,2830
"4244","FBgn0010038","3R",12371971,12372704,733
"4245","FBgn0085198","2L",17173481,17174105,624
"4246","FBgn0039551","3R",27845950,27847260,1310
"4247","FBgn0085261","2R",12164909,12165812,903
"4248","FBgn0260447","X",7897250,7897987,737
"4249","FBgn0261055","2L",5942623,5943304,681
"4250","FBgn0265870","2R",20691995,20692495,500
"4251","FBgn0050363","2R",8363272,8365345,2073
"4252","FBgn0043783","3L",21636947,21639060,2113
"4253","FBgn0051687","2L",20450225,20456978,6753
"4254","FBgn0262450","2R",20584056,20584121,65
"4255","FBgn0038247","3R",14630478,14641776,11298
"4256","FBgn0040038","Unmapped_Scaffold_8_D1580_D1567",53442,85529,32087
"4257","FBgn0032870","2L",20645822,20647381,1559
"4258","FBgn0266669","3L",17421787,17425217,3430
"4259","FBgn0038957","3R",22389780,22392349,2569
"4260","FBgn0052563","X",17208436,17209063,627
"4261","FBgn0266641","2R",21029295,21030041,746
"4262","FBgn0034704","2R",22174922,22177428,2506
"4263","FBgn0033041","2R",5791441,5792967,1526
"4264","FBgn0262286","3R",27642466,27642555,89
"4265","FBgn0051528","3R",4416438,4417665,1227
"4266","FBgn0037895","3R",11416218,11418668,2450
"4267","FBgn0053294","3R",4186963,4196210,9247
"4268","FBgn0033010","2R",5144733,5154756,10023
"4269","FBgn0031856","2L",6757864,6759628,1764
"4270","FBgn0033587","2R",11233192,11233714,522
"4271","FBgn0039080","3R",23487501,23489180,1679
"4272","FBgn0261845","3R",21365609,21370249,4640
"4273","FBgn0037772","3R",9997163,10000314,3151
"4274","FBgn0266947","3L",14890090,14890503,413
"4275","FBgn0035786","3L",7465509,7468808,3299
"4276","FBgn0027496","2L",6489090,6490194,1104
"4277","FBgn0031896","2L",7194908,7204264,9356
"4278","FBgn0032816","2L",19736044,19737088,1044
"4279","FBgn0053381","2R",19755772,19755906,134
"4280","FBgn0038126","3R",13208754,13214465,5711
"4281","FBgn0265745","3L",12661826,12662247,421
"4282","FBgn0264978","2L",2488197,2492671,4474
"4283","FBgn0250907","2L",22999574,23025915,26341
"4284","FBgn0037520","3R",7802831,7804432,1601
"4285","FBgn0032136","2L",9634179,9656026,21847
"4286","FBgn0052720","X",7535625,7536959,1334
"4287","FBgn0020509","3L",2739750,2740228,478
"4288","FBgn0033062","2R",6080828,6085625,4797
"4289","FBgn0033092","2R",6675822,6693162,17340
"4290","FBgn0038240","3R",14562340,14562845,505
"4291","FBgn0083965","3R",26190234,26191205,971
"4292","FBgn0261647","2L",2365345,2370137,4792
"4293","FBgn0030085","X",9088367,9089314,947
"4294","FBgn0260224","3R",26057347,26058223,876
"4295","FBgn0034730","2R",22427479,22429584,2105
"4296","FBgn0036696","3L",17044401,17045038,637
"4297","FBgn0039064","3R",23227727,23248903,21176
"4298","FBgn0030276","X",11154421,11164670,10249
"4299","FBgn0031485","2L",2978411,2979288,877
"4300","FBgn0034377","2R",18696585,18697345,760
"4301","FBgn0260756","3L",835683,836770,1087
"4302","FBgn0028894","2L",16301656,16302954,1298
"4303","FBgn0041579","2R",13393705,13394667,962
"4304","FBgn0038934","3R",22211824,22217415,5591
"4305","FBgn0050008","2R",9889878,9891141,1263
"4306","FBgn0031010","X",19277176,19280349,3173
"4307","FBgn0015010","X",14784664,14786551,1887
"4308","FBgn0032671","2L",18157110,18159272,2162
"4309","FBgn0034158","2R",16783671,16792472,8801
"4310","FBgn0051715","2L",10341616,10342523,907
"4311","FBgn0038131","3R",13284946,13286529,1583
"4312","FBgn0262795","Y",3364463,3365197,734
"4313","FBgn0030063","X",8720520,8721503,983
"4314","FBgn0004635","3L",1463811,1468944,5133
"4315","FBgn0266229","3R",5724047,5725321,1274
"4316","FBgn0038095","3R",12963791,12965923,2132
"4317","FBgn0041174","2R",11279725,11281033,1308
"4318","FBgn0032264","2L",10527572,10531778,4206
"4319","FBgn0264336","2R",23476577,23477078,501
"4320","FBgn0260642","3R",6896253,6999228,102975
"4321","FBgn0025391","X",1735945,1754065,18120
"4322","FBgn0036476","3L",15090823,15094719,3896
"4323","FBgn0262203","2L",12460004,12460100,96
"4324","FBgn0262993","3R",9338223,9339992,1769
"4325","FBgn0052718","X",7778205,7779370,1165
"4326","FBgn0266171","3R",21362968,21365290,2322
"4327","FBgn0039002","3R",22686849,22687407,558
"4328","FBgn0034000","2R",15216207,15217070,863
"4329","FBgn0035325","3L",2266394,2267640,1246
"4330","FBgn0053262","3L",13136269,13137066,797
"4331","FBgn0037182","3L",22714313,22717577,3264
"4332","FBgn0260400","X",509235,523226,13991
"4333","FBgn0267143","3R",12329320,12330223,903
"4334","FBgn0263386","2L",11536145,11536844,699
"4335","FBgn0037183","3L",22721230,22722091,861
"4336","FBgn0004240","2R",18865765,18866260,495
"4337","FBgn0002576","X",9284649,9303636,18987
"4338","FBgn0037796","3R",10171156,10189603,18447
"4339","FBgn0052137","3L",13939250,13962647,23397
"4340","FBgn0035725","3L",6968035,6969048,1013
"4341","FBgn0051637","2L",6498647,6526996,28349
"4342","FBgn0266540","3L",11064991,11069025,4034
"4343","FBgn0259140","3L",11801951,11814755,12804
"4344","FBgn0033222","2R",7790368,7791170,802
"4345","FBgn0030686","X",15761248,15762663,1415
"4346","FBgn0041249","2L",1755253,1756451,1198
"4347","FBgn0046247","3R",27274794,27277418,2624
"4348","FBgn0063298","3R",9022057,9024018,1961
"4349","FBgn0085765","X",23205409,23205438,29
"4350","FBgn0004863","3R",21499986,21512814,12828
"4351","FBgn0030354","X",11899996,11905371,5375
"4352","FBgn0261992","2L",13459681,13460183,502
"4353","FBgn0267813","3R",4434624,4436101,1477
"4354","FBgn0052058","3L",10432384,10434105,1721
"4355","FBgn0263079","2L",18666892,18671246,4354
"4356","FBgn0045761","3R",25323156,25329316,6160
"4357","FBgn0016797","3L",19140975,19235373,94398
"4358","FBgn0267152","3R",16988590,16988884,294
"4359","FBgn0263526","2L",3463290,3463400,110
"4360","FBgn0086384","X",19689697,19693500,3803
"4361","FBgn0030711","X",15944897,15946249,1352
"4362","FBgn0053839","2L",21494875,21495403,528
"4363","FBgn0013684","mitochondrion_genome",6409,8125,1716
"4364","FBgn0029539","X",894482,895200,718
"4365","FBgn0031441","2L",2646577,2647720,1143
"4366","FBgn0266098","X",5085759,5254864,169105
"4367","FBgn0051383","3R",30247964,30248043,79
"4368","FBgn0263343","3R",4984498,4986120,1622
"4369","FBgn0017456","3R",7518820,7519456,636
"4370","FBgn0262187","X",12636336,12636430,94
"4371","FBgn0036291","3L",12501513,12502647,1134
"4372","FBgn0040237","3R",16261355,16264115,2760
"4373","FBgn0010590","2R",16013805,16014787,982
"4374","FBgn0266654","3L",19989706,19990739,1033
"4375","FBgn0036918","3L",19923671,19924688,1017
"4376","FBgn0039151","3R",24114043,24116322,2279
"4377","FBgn0047095","X",19171077,19174900,3823
"4378","FBgn0003388","3L",14614458,14622205,7747
"4379","FBgn0260793","3R",13121951,13155687,33736
"4380","FBgn0034265","2R",17725030,17726847,1817
"4381","FBgn0085753","rDNA",16936,22940,6004
"4382","FBgn0037992","3R",12121583,12128201,6618
"4383","FBgn0038590","3R",18251069,18252734,1665
"4384","FBgn0265974","2R",14526267,14587917,61650
"4385","FBgn0026371","3L",21512141,21515887,3746
"4386","FBgn0267643","3L",2621721,2622629,908
"4387","FBgn0262339","X",4365806,4365898,92
"4388","FBgn0037223","3R",4243606,4245511,1905
"4389","FBgn0027780","2L",8445861,8449576,3715
"4390","FBgn0000273","2L",9682315,9699297,16982
"4391","FBgn0040348","X",942474,945773,3299
"4392","FBgn0265001","2L",9765357,9770996,5639
"4393","FBgn0047178","3L",15143063,15144059,996
"4394","FBgn0010583","2L",825969,833241,7272
"4395","FBgn0266087","2R",24859260,24860177,917
"4396","FBgn0267914","X",8564408,8565178,770
"4397","FBgn0035455","3L",3653405,3654771,1366
"4398","FBgn0039681","3R",29680241,29682278,2037
"4399","FBgn0026873","X",1865909,1866887,978
"4400","FBgn0265862","2R",20531867,20532969,1102
"4401","FBgn0040089","X",19706418,19713045,6627
"4402","FBgn0033821","2R",13257886,13258477,591
"4403","FBgn0032724","2L",18948884,18950973,2089
"4404","FBgn0036356","3L",13411122,13412453,1331
"4405","FBgn0052196","3L",18459464,18461024,1560
"4406","FBgn0032465","2L",12993757,13000635,6878
"4407","FBgn0033984","2R",14935660,14940722,5062
"4408","FBgn0031879","2L",6972828,7010359,37531
"4409","FBgn0033549","2R",10811078,10812215,1137
"4410","FBgn0051609","2L",9097563,9098175,612
"4411","FBgn0016122","2L",8521933,8525740,3807
"4412","FBgn0038106","3R",12995620,12996925,1305
"4413","FBgn0266962","3L",6931023,6931950,927
"4414","FBgn0040010","2L",22550064,22556295,6231
"4415","FBgn0028903","2L",15852592,15854110,1518
"4416","FBgn0027356","2R",12593604,12612068,18464
"4417","FBgn0265045","2R",15946933,15989498,42565
"4418","FBgn0267266","2L",20513832,20514546,714
"4419","FBgn0031630","2L",4813009,4815891,2882
"4420","FBgn0038425","3R",16434899,16436066,1167
"4421","FBgn0003502","2L",8258373,8301079,42706
"4422","FBgn0047114","3R",23929243,23929988,745
"4423","FBgn0040345","X",928798,930098,1300
"4424","FBgn0262315","3R",15130754,15130859,105
"4425","FBgn0036410","3L",14083615,14086421,2806
"4426","FBgn0036766","3L",17883649,17884376,727
"4427","FBgn0086355","3R",30132981,30134599,1618
"4428","FBgn0030117","X",9260697,9261332,635
"4429","FBgn0028707","2L",12096525,12097687,1162
"4430","FBgn0035478","3L",3947891,3948687,796
"4431","FBgn0265689","2L",11588576,11589181,605
"4432","FBgn0030425","X",12801661,12804232,2571
"4433","FBgn0053847","2L",21508566,21509058,492
"4434","FBgn0083989","2R",12199183,12199273,90
"4435","FBgn0029713","X",4549883,4551878,1995
"4436","FBgn0264950","2L",8201557,8205298,3741
"4437","FBgn0032923","2L",21158847,21160903,2056
"4438","FBgn0034292","2R",18046386,18047484,1098
"4439","FBgn0023512","X",1920166,1922874,2708
"4440","FBgn0001248","3L",8356404,8360906,4502
"4441","FBgn0030309","X",11555050,11558654,3604
"4442","FBgn0011955","2R",6178584,6178656,72
"4443","FBgn0011952","X",14014814,14014886,72
"4444","FBgn0035356","3L",2600331,2601536,1205
"4445","FBgn0047000","3L",6220578,6220949,371
"4446","FBgn0032442","2L",12667248,12669714,2466
"4447","FBgn0053509","2L",21084605,21086506,1901
"4448","FBgn0033104","2R",6809044,6809766,722
"4449","FBgn0261437","2L",8364855,8365663,808
"4450","FBgn0265141","2R",10376238,10377540,1302
"4451","FBgn0030985","X",19135081,19135868,787
"4452","FBgn0085478","X",9324508,9356227,31719
"4453","FBgn0037024","3L",20798645,20800081,1436
"4454","FBgn0025394","X",1483479,1517615,34136
"4455","FBgn0051679","2L",2237076,2238251,1175
"4456","FBgn0003410","3L",16853751,16858712,4961
"4457","FBgn0011931","2R",6162519,6162592,73
"4458","FBgn0264939","X",5914363,5914649,286
"4459","FBgn0032348","2L",11130737,11136003,5266
"4460","FBgn0038196","3R",14035018,14036398,1380
"4461","FBgn0053098","3R",12387188,12388794,1606
"4462","FBgn0033668","2R",11939557,11967435,27878
"4463","FBgn0266037","2L",9348726,9349212,486
"4464","FBgn0053626","2R",12410079,12410696,617
"4465","FBgn0050410","2R",23355183,23356441,1258
"4466","FBgn0011966","3R",8861880,8861952,72
"4467","FBgn0002985","2L",3604224,3606756,2532
"4468","FBgn0265856","2R",20506195,20506895,700
"4469","FBgn0267521","X",23280998,23282931,1933
"4470","FBgn0052121","3L",13416576,13422336,5760
"4471","FBgn0003435","2R",19517864,19631508,113644
"4472","FBgn0053222","X",7898438,7901302,2864
"4473","FBgn0052392","3L",6756629,6763246,6617
"4474","FBgn0267518","X",23214040,23214069,29
"4475","FBgn0267286","2L",19469126,19469894,768
"4476","FBgn0267824","2R",14481187,14497312,16125
"4477","FBgn0027570","3R",4719458,4731878,12420
"4478","FBgn0029006","2R",17592791,17604461,11670
"4479","FBgn0010097","2L",19183863,19185726,1863
"4480","FBgn0050240","2R",16220052,16220123,71
"4481","FBgn0266572","X",471019,476579,5560
"4482","FBgn0034909","2R",23812185,23818327,6142
"4483","FBgn0052318","3L",1246073,1246923,850
"4484","FBgn0035838","3L",8121827,8123615,1788
"4485","FBgn0266448","3R",10773339,10777374,4035
"4486","FBgn0267689","2L",7754174,7765915,11741
"4487","FBgn0040798","3L",16265385,16265804,419
"4488","FBgn0040963","2L",8980659,8981432,773
"4489","FBgn0267193","3R",18850940,18851239,299
"4490","FBgn0029753","X",5313258,5315190,1932
"4491","FBgn0262333","2L",5641990,5642078,88
"4492","FBgn0034046","2R",15794000,15855645,61645
"4493","FBgn0035982","3L",9375430,9376293,863
"4494","FBgn0040793","3L",17425477,17426282,805
"4495","FBgn0264606","3L",2655415,2711690,56275
"4496","FBgn0039987","3R",1031171,1031354,183
"4497","FBgn0032086","2L",8994391,8995617,1226
"4498","FBgn0039431","3R",26470078,26535217,65139
"4499","FBgn0085468","2R",13158666,13160190,1524
"4500","FBgn0031183","X",22444227,22447808,3581
"4501","FBgn0265743","3L",12300980,12301942,962
"4502","FBgn0259228","X",6780790,6803593,22803
"4503","FBgn0030485","X",13409369,13413074,3705
"4504","FBgn0038760","3R",20008947,20011712,2765
"4505","FBgn0042201","3L",16318024,16318690,666
"4506","FBgn0265464","X",8154599,8157386,2787
"4507","FBgn0016983","3L",7381614,7385637,4023
"4508","FBgn0030976","X",18900410,18911843,11433
"4509","FBgn0260000","2L",20263419,20264424,1005
"4510","FBgn0051267","3R",17134197,17135283,1086
"4511","FBgn0035425","3L",3236805,3239578,2773
"4512","FBgn0020399","3R",16267012,16268433,1421
"4513","FBgn0037473","3R",7126271,7128027,1756
"4514","FBgn0034025","2R",15511710,15515597,3887
"4515","FBgn0000115","3L",15983135,15984362,1227
"4516","FBgn0004880","3L",3983896,3994003,10107
"4517","FBgn0267043","X",19914482,19915281,799
"4518","FBgn0033134","2R",7045769,7048538,2769
"4519","FBgn0263335","2R",16357737,16358481,744
"4520","FBgn0038447","3R",16594414,16597241,2827
"4521","FBgn0041250","2L",780482,782885,2403
"4522","FBgn0052029","3L",8640439,8643584,3145
"4523","FBgn0038128","3R",13262733,13264061,1328
"4524","FBgn0259239","3L",21183313,21193363,10050
"4525","FBgn0021875","2R",24133989,24135405,1416
"4526","FBgn0028940","2L",13977302,13979569,2267
"4527","FBgn0264485","3L",19229061,19230102,1041
"4528","FBgn0261536","3L",7465509,7468808,3299
"4529","FBgn0040341","X",875732,876612,880
"4530","FBgn0261831","2L",8144391,8145107,716
"4531","FBgn0031231","2L",203779,204782,1003
"4532","FBgn0033519","2R",10420414,10423650,3236
"4533","FBgn0263911","3L",21538859,21539447,588
"4534","FBgn0011569","3L",10263909,10267111,3202
"4535","FBgn0066101","3R",25741348,25763105,21757
"4536","FBgn0011592","2R",12529053,12564184,35131
"4537","FBgn0039650","3R",29201756,29202525,769
"4538","FBgn0261505","2R",1207416,1209312,1896
"4539","FBgn0262021","3L",11610135,11610386,251
"4540","FBgn0004055","2R",25012062,25031737,19675
"4541","FBgn0033672","2R",11986513,11988787,2274
"4542","FBgn0034232","2R",17518223,17519027,804
"4543","FBgn0041582","2R",24126638,24133551,6913
"4544","FBgn0020767","2R",14759646,14769423,9777
"4545","FBgn0267976","2L",23312465,23313578,1113
"4546","FBgn0266580","2R",5760862,5774324,13462
"4547","FBgn0037249","3R",4429798,4433895,4097
"4548","FBgn0259869","Y",1000076,1001264,1188
"4549","FBgn0085771","X",23239718,23240975,1257
"4550","FBgn0264890","2L",6812640,6813110,470
"4551","FBgn0053382","2R",19755403,19755537,134
"4552","FBgn0040367","X",1209970,1211853,1883
"4553","FBgn0010926","3R",17535533,17539963,4430
"4554","FBgn0267163","X",12274635,12275155,520
"4555","FBgn0003044","2R",18135426,18139990,4564
"4556","FBgn0053461","2R",15695386,15696478,1092
"4557","FBgn0041097","2L",1256417,1296596,40179
"4558","FBgn0030979","X",19056911,19067792,10881
"4559","FBgn0037814","3R",10402967,10407285,4318
"4560","FBgn0264552","3L",20897557,20898501,944
"4561","FBgn0266227","3R",4375084,4377600,2516
"4562","FBgn0038458","3R",16975204,16975697,493
"4563","FBgn0031513","2L",3269437,3271806,2369
"4564","FBgn0026388","2R",10139264,10142074,2810
"4565","FBgn0040679","3R",5960294,5960987,693
"4566","FBgn0267075","X",5506509,5507255,746
"4567","FBgn0051146","3R",7658247,7694874,36627
"4568","FBgn0034725","2R",22404177,22408540,4363
"4569","FBgn0028919","2L",13811522,13813316,1794
"4570","FBgn0278604","3R",9711142,9714675,3533
"4571","FBgn0267564","3R",6835869,6836358,489
"4572","FBgn0267104","3R",29256485,29257425,940
"4573","FBgn0021825","2R",8891832,8893339,1507
"4574","FBgn0011476","3R",15277981,15278668,687
"4575","FBgn0039869","3R",31743490,31744248,758
"4576","FBgn0020305","2L",868673,869857,1184
"4577","FBgn0030701","X",15870183,15875607,5424
"4578","FBgn0015039","2R",7130277,7132139,1862
"4579","FBgn0052673","X",10660955,10661843,888
"4580","FBgn0033665","2R",11899517,11901394,1877
"4581","FBgn0040906","X",4311279,4311799,520
"4582","FBgn0032290","2L",10728978,10730302,1324
"4583","FBgn0037406","3R",6173549,6174971,1422
"4584","FBgn0040828","3L",8749139,8749726,587
"4585","FBgn0031720","2L",5552843,5553850,1007
"4586","FBgn0030877","X",17858379,17860800,2421
"4587","FBgn0001147","2R",25040383,25052331,11948
"4588","FBgn0030431","X",12901353,12903516,2163
"4589","FBgn0033322","2R",8700692,8701794,1102
"4590","FBgn0010431","3L",8413012,8414103,1091
"4591","FBgn0033379","2R",9111505,9113951,2446
"4592","FBgn0053420","2R",19741406,19741540,134
"4593","FBgn0265059","2R",6979496,6980195,699
"4594","FBgn0033153","2R",7249161,7250655,1494
"4595","FBgn0036795","3L",18605472,18607349,1877
"4596","FBgn0036617","3L",16362603,16363750,1147
"4597","FBgn0051939","2L",2010646,2010717,71
"4598","FBgn0036977","3L",20358512,20359820,1308
"4599","FBgn0267067","X",21483082,21483519,437
"4600","FBgn0000392","2L",6663664,6674780,11116
"4601","FBgn0261363","2R",23064769,23067183,2414
"4602","FBgn0262456","2L",18472315,18472424,109
"4603","FBgn0039360","3R",25685236,25687370,2134
"4604","FBgn0259861","Y",916438,917820,1382
"4605","FBgn0265105","2R",9775110,9776370,1260
"4606","FBgn0031859","2L",6801358,6802840,1482
"4607","FBgn0038358","3R",15774416,15777640,3224
"4608","FBgn0034471","2R",19712345,19712932,587
"4609","FBgn0053908","2L",21428075,21428669,594
"4610","FBgn0034684","2R",22058904,22061517,2613
"4611","FBgn0035795","3L",7539060,7539836,776
"4612","FBgn0085222","2R",17508995,17511394,2399
"4613","FBgn0266111","2R",12344983,12351325,6342
"4614","FBgn0260643","3L",10630034,10630935,901
"4615","FBgn0037942","3R",11735447,11736877,1430
"4616","FBgn0023097","3R",20593139,20612540,19401
"4617","FBgn0029822","X",5908135,5913079,4944
"4618","FBgn0082923","3R",27923915,27924061,146
"4619","FBgn0043799","3R",24877045,24878827,1782
"4620","FBgn0025366","2L",10408352,10409610,1258
"4621","FBgn0053830","2L",21479636,21480164,528
"4622","FBgn0034904","2R",23790614,23791227,613
"4623","FBgn0033234","2R",7926653,7929922,3269
"4624","FBgn0264602","3L",16049235,16050303,1068
"4625","FBgn0002838","3R",26875852,26876562,710
"4626","FBgn0030344","X",11864651,11868893,4242
"4627","FBgn0030351","X",11888352,11889186,834
"4628","FBgn0032321","2L",10970443,10972093,1650
"4629","FBgn0263446","2R",12872756,12875087,2331
"4630","FBgn0030918","X",18415415,18416911,1496
"4631","FBgn0014906","2L",3163645,3169462,5817
"4632","FBgn0034051","2R",15935893,15940073,4180
"4633","FBgn0036184","3L",11626441,11627715,1274
"4634","FBgn0015000","2L",4945579,4948324,2745
"4635","FBgn0039073","3R",23361889,23363574,1685
"4636","FBgn0266732","3R",10060666,10061978,1312
"4637","FBgn0035715","3L",6754017,6756497,2480
"4638","FBgn0028506","2L",16352934,16354539,1605
"4639","FBgn0035157","3L",693083,699144,6061
"4640","FBgn0262610","X",5853761,5854464,703
"4641","FBgn0052939","3R",9693079,9694461,1382
"4642","FBgn0266586","2L",17583909,17584468,559
"4643","FBgn0039033","3R",22987281,22988503,1222
"4644","FBgn0037166","3L",22470556,22473509,2953
"4645","FBgn0033935","2R",14411825,14413851,2026
"4646","FBgn0035619","3L",5592741,5595272,2531
"4647","FBgn0266065","2L",5715678,5716426,748
"4648","FBgn0025558","3L",16612486,16612950,464
"4649","FBgn0033476","2R",10034595,10048619,14024
"4650","FBgn0005775","3L",4936758,5079033,142275
"4651","FBgn0053418","2R",19742137,19742271,134
"4652","FBgn0265050","2R",6682521,6683749,1228
"4653","FBgn0025613","X",4639259,4643987,4728
"4654","FBgn0051415","3R",9743517,9744662,1145
"4655","FBgn0025635","X",625542,628016,2474
"4656","FBgn0034122","2R",16363551,16365895,2344
"4657","FBgn0265787","2L",5810352,5810835,483
"4658","FBgn0000579","2L",1724768,1729636,4868
"4659","FBgn0011291","2L",9762424,9763262,838
"4660","FBgn0027794","X",1457175,1460617,3442
"4661","FBgn0260777","3L",15716453,15717749,1296
"4662","FBgn0015519","X",8276200,8367169,90969
"4663","FBgn0032124","2L",9540523,9542480,1957
"4664","FBgn0003744","3L",19830864,19834304,3440
"4665","FBgn0037338","3R",5555084,5557786,2702
"4666","FBgn0261988","3R",31405245,31457873,52628
"4667","FBgn0262869","3R",20378458,20484588,106130
"4668","FBgn0265511","2R",15915995,15916795,800
"4669","FBgn0267045","X",19928416,19929178,762
"4670","FBgn0266158","2L",15515821,15516727,906
"4671","FBgn0263387","3L",6983473,6984586,1113
"4672","FBgn0039780","3R",30496751,30500326,3575
"4673","FBgn0267962","X",14097599,14097965,366
"4674","FBgn0267959","3R",13864597,13865095,498
"4675","FBgn0051439","3R",25397788,25400645,2857
"4676","FBgn0038581","3R",18216142,18218014,1872
"4677","FBgn0037022","3L",20786340,20788137,1797
"4678","FBgn0033401","2R",9286827,9289026,2199
"4679","FBgn0032615","2L",16860029,16861489,1460
"4680","FBgn0011854","3L",1401440,1401511,71
"4681","FBgn0053445","2R",19732170,19732304,134
"4682","FBgn0030536","X",13955236,13956574,1338
"4683","FBgn0036993","3L",20442419,20450580,8161
"4684","FBgn0036679","3L",16938330,16938952,622
"4685","FBgn0031491","2L",3021309,3023141,1832
"4686","FBgn0040102","2L",4188123,4189284,1161
"4687","FBgn0038865","3R",21159238,21161092,1854
"4688","FBgn0035203","3L",1302944,1304717,1773
"4689","FBgn0267509","rDNA",16375,16497,122
"4690","FBgn0051779","2L",3693184,3693905,721
"4691","FBgn0083968","2L",7885503,7886109,606
"4692","FBgn0040505","2R",16625293,16640011,14718
"4693","FBgn0262227","2R",20585200,20585295,95
"4694","FBgn0053797","4",843274,843973,699
"4695","FBgn0260996","2L",22064604,22065343,739
"4696","FBgn0029851","X",6237315,6240558,3243
"4697","FBgn0267893","Y",3205803,3205967,164
"4698","FBgn0262330","3L",21574014,21574121,107
"4699","FBgn0061515","3L",14029579,14031706,2127
"4700","FBgn0039019","3R",22745620,22746605,985
"4701","FBgn0053341","3R",24368358,24369419,1061
"4702","FBgn0265763","2R",19859695,19860095,400
"4703","FBgn0261553","3L",11214505,11230745,16240
"4704","FBgn0265778","2L",6323767,6332789,9022
"4705","FBgn0011225","3R",24252826,24271233,18407
"4706","FBgn0267780","3R",30026218,30026872,654
"4707","FBgn0065071","X",6531635,6531701,66
"4708","FBgn0030041","X",8467443,8469012,1569
"4709","FBgn0034092","2R",16222112,16222627,515
"4710","FBgn0261706","2R",22985374,22986549,1175
"4711","FBgn0036220","3L",11887259,11888981,1722
"4712","FBgn0011879","2R",17392215,17392286,71
"4713","FBgn0259202","2R",18658418,18661548,3130
"4714","FBgn0265204","3R",29021284,29022180,896
"4715","FBgn0036360","3L",13428839,13435229,6390
"4716","FBgn0260759","3R",29933287,29934587,1300
"4717","FBgn0051549","3R",5632192,5633321,1129
"4718","FBgn0036143","3L",11173514,11176892,3378
"4719","FBgn0083124","2R",9095273,9097312,2039
"4720","FBgn0264083","2L",8295158,8295666,508
"4721","FBgn0267115","3R",31473041,31473738,697
"4722","FBgn0003023","X",8485008,8489535,4527
"4723","FBgn0259845","Y",1029772,1031619,1847
"4724","FBgn0050093","2R",15944028,15944567,539
"4725","FBgn0034885","2R",23607592,23614710,7118
"4726","FBgn0265083","3R",12996876,12997726,850
"4727","FBgn0267945","3R",7774029,7774583,554
"4728","FBgn0264838","3R",30049293,30052211,2918
"4729","FBgn0028902","2L",15854126,15856450,2324
"4730","FBgn0022382","2R",9993890,10026042,32152
"4731","FBgn0025839","X",2172526,2173432,906
"4732","FBgn0005411","X",16356696,16359039,2343
"4733","FBgn0263046","2R",7632841,7633880,1039
"4734","FBgn0036873","3L",19475017,19475578,561
"4735","FBgn0034693","2R",22091489,22099534,8045
"4736","FBgn0031033","X",19587348,19590170,2822
"4737","FBgn0000346","X",13259021,13262488,3467
"4738","FBgn0266489","2R",13580586,13593339,12753
"4739","FBgn0033512","2R",10354724,10355831,1107
"4740","FBgn0266887","2L",897453,898050,597
"4741","FBgn0029930","X",7021608,7066052,44444
"4742","FBgn0259223","X",18422413,18427001,4588
"4743","FBgn0265934","3L",11324326,11325000,674
"4744","FBgn0015360","3L",2258839,2262664,3825
"4745","FBgn0034132","2R",16491100,16493233,2133
"4746","FBgn0035198","3L",1252012,1255986,3974
"4747","FBgn0039807","3R",30874365,30876186,1821
"4748","FBgn0046214","3R",25123373,25125619,2246
"4749","FBgn0029067","X",21319791,21324009,4218
"4750","FBgn0033793","2R",13127915,13129052,1137
"4751","FBgn0054043","2L",10278951,10280872,1921
"4752","FBgn0033307","2R",8590497,8591948,1451
"4753","FBgn0052259","3L",4069369,4070281,912
"4754","FBgn0086039","2L",19008611,19008683,72
"4755","FBgn0040682","3R",5224139,5225542,1403
"4756","FBgn0265087","2L",13118872,13119288,416
"4757","FBgn0053516","2L",2058790,2109878,51088
"4758","FBgn0262979","X",7707775,7708587,812
"4759","FBgn0032563","2L",15360921,15361627,706
"4760","FBgn0015299","2L",8211347,8211938,591
"4761","FBgn0031318","2L",1173009,1177589,4580
"4762","FBgn0004054","3R",6743135,6744136,1001
"4763","FBgn0014879","3R",15263552,15265253,1701
"4764","FBgn0029740","X",4997441,4998388,947
"4765","FBgn0264878","2R",9610464,9615617,5153
"4766","FBgn0259700","X",16093059,16104946,11887
"4767","FBgn0034387","2R",18754995,18757083,2088
"4768","FBgn0011987","2R",11357564,11357650,86
"4769","FBgn0262858","3R",24634625,24635165,540
"4770","FBgn0030247","X",10899965,10901811,1846
"4771","FBgn0087013","3R",4649176,4654624,5448
"4772","FBgn0039219","3R",24717937,24719364,1427
"4773","FBgn0038046","3R",12427795,12429282,1487
"4774","FBgn0028381","3R",16499058,16501050,1992
"4775","FBgn0267327","2L",11591339,11591678,339
"4776","FBgn0011239","2L",15292468,15294136,1668
"4777","FBgn0027580","2R",9850703,9861543,10840
"4778","FBgn0052076","3L",11164971,11166620,1649
"4779","FBgn0040260","2L",16799025,16801584,2559
"4780","FBgn0053225","2R",21590275,21591584,1309
"4781","FBgn0051975","2L",138384,140992,2608
"4782","FBgn0052984","2L",8964982,8967035,2053
"4783","FBgn0262995","3R",8201480,8201994,514
"4784","FBgn0011863","2L",14518307,14518377,70
"4785","FBgn0266698","3R",4946078,4947278,1200
"4786","FBgn0082933","2R",24185323,24185405,82
"4787","FBgn0001276","2R",11359437,11360163,726
"4788","FBgn0263332","2L",18200336,18201135,799
"4789","FBgn0034948","2R",23975599,23977255,1656
"4790","FBgn0030770","X",16678265,16678945,680
"4791","FBgn0266363","2L",11834086,11834497,411
"4792","FBgn0052636","X",13332374,13333857,1483
"4793","FBgn0039773","3R",30456441,30459300,2859
"4794","FBgn0264750","2L",11841502,11842445,943
"4795","FBgn0030629","X",15340373,15342117,1744
"4796","FBgn0038251","3R",14659438,14661177,1739
"4797","FBgn0045469","3R",21844014,21845265,1251
"4798","FBgn0030310","X",11561643,11562779,1136
"4799","FBgn0267739","2L",12040782,12041515,733
"4800","FBgn0267868","X",4313626,4314216,590
"4801","FBgn0035138","3L",365664,366437,773
"4802","FBgn0262419","3R",10100022,10100121,99
"4803","FBgn0267792","2R",8600415,8612295,11880
"4804","FBgn0263596","3R",8049167,8049456,289
"4805","FBgn0035233","3L",1558228,1559863,1635
"4806","FBgn0001222","2R",18130303,18134634,4331
"4807","FBgn0031622","2L",4688965,4690702,1737
"4808","FBgn0031058","X",19687791,19688948,1157
"4809","FBgn0053147","2R",18718114,18754675,36561
"4810","FBgn0033607","2R",11280484,11283971,3487
"4811","FBgn0039180","3R",24293366,24294399,1033
"4812","FBgn0041224","3R",26965124,26966485,1361
"4813","FBgn0267755","3R",27503393,27504101,708
"4814","FBgn0032246","2L",10423291,10425482,2191
"4815","FBgn0030437","X",12950436,12957462,7026
"4816","FBgn0020248","3L",1475438,1489547,14109
"4817","FBgn0011826","X",16554627,16560016,5389
"4818","FBgn0267678","3R",12276604,12276932,328
"4819","FBgn0029949","X",7401698,7403174,1476
"4820","FBgn0003884","3R",7086599,7088839,2240
"4821","FBgn0265666","2R",19603295,19603895,600
"4822","FBgn0029843","X",6091205,6103971,12766
"4823","FBgn0051988","2L",21201493,21202802,1309
"4824","FBgn0039402","3R",26052821,26054128,1307
"4825","FBgn0042126","2L",12034190,12036131,1941
"4826","FBgn0032846","2L",20091435,20093152,1717
"4827","FBgn0264699","3L",23784231,23787405,3174
"4828","FBgn0039048","3R",23062713,23067259,4546
"4829","FBgn0261535","2L",14352594,14355085,2491
"4830","FBgn0039304","3R",25260963,25262498,1535
"4831","FBgn0010015","3R",31039374,31046821,7447
"4832","FBgn0032715","2L",18829012,18831153,2141
"4833","FBgn0265930","3L",11237302,11237620,318
"4834","FBgn0001226","3L",9384063,9385694,1631
"4835","FBgn0034399","2R",18835263,18836842,1579
"4836","FBgn0024555","3R",13683921,13693905,9984
"4837","FBgn0039311","3R",25275790,25277212,1422
"4838","FBgn0030240","X",10848757,10852327,3570
"4839","FBgn0036928","3L",20000644,20002446,1802
"4840","FBgn0085395","2L",9370309,9415156,44847
"4841","FBgn0050277","2R",22218456,22220905,2449
"4842","FBgn0032457","2L",12760346,12761840,1494
"4843","FBgn0037747","3R",9767834,9770027,2193
"4844","FBgn0266747","3R",2744304,2744800,496
"4845","FBgn0064126","3R",8244055,8248054,3999
"4846","FBgn0261811","X",19830215,19852059,21844
"4847","FBgn0266592","3L",527671,528129,458
"4848","FBgn0261993","3R",24366527,24367220,693
"4849","FBgn0037609","3R",8675283,8676613,1330
"4850","FBgn0043005","3R",23696372,23699027,2655
"4851","FBgn0010292","X",7901880,7903643,1763
"4852","FBgn0267737","3L",21333010,21333511,501
"4853","FBgn0086673","2L",16804884,16816069,11185
"4854","FBgn0037417","3R",6263976,6267395,3419
"4855","FBgn0010424","3L",17046063,17048390,2327
"4856","FBgn0034497","2R",20279066,20281127,2061
"4857","FBgn0259954","2L",3699464,3699826,362
"4858","FBgn0051100","3R",8995229,9003650,8421
"4859","FBgn0259822","2L",11156118,11203544,47426
"4860","FBgn0038224","3R",14326947,14327735,788
"4861","FBgn0051388","3R",11237815,11240114,2299
"4862","FBgn0036157","3L",11425158,11426395,1237
"4863","FBgn0037388","3R",5847220,5848177,957
"4864","FBgn0085380","2L",4694721,4722465,27744
"4865","FBgn0053494","3R",25493481,25495161,1680
"4866","FBgn0041233","2R",23541054,23542379,1325
"4867","FBgn0262483","3R",15374635,15402543,27908
"4868","FBgn0035539","3L",4384442,4403181,18739
"4869","FBgn0027598","3R",30808617,30827005,18388
"4870","FBgn0051682","2L",2239414,2240593,1179
"4871","FBgn0036767","3L",17885948,17886645,697
"4872","FBgn0039406","3R",26058420,26059267,847
"4873","FBgn0267903","Y",3215547,3215855,308
"4874","FBgn0032859","2L",20417057,20423027,5970
"4875","FBgn0033904","2R",14166982,14168233,1251
"4876","FBgn0036829","3L",18908260,18911182,2922
"4877","FBgn0260452","2L",6308819,6309475,656
"4878","FBgn0262376","3L",17315006,17315105,99
"4879","FBgn0032376","2L",11791025,11792365,1340
"4880","FBgn0020385","3R",10696534,10703316,6782
"4881","FBgn0040068","X",19261820,19273280,11460
"4882","FBgn0029587","X",1681566,1684891,3325
"4883","FBgn0032733","2L",18988268,18990233,1965
"4884","FBgn0033303","2R",8569137,8570306,1169
"4885","FBgn0032244","2L",10419190,10420612,1422
"4886","FBgn0265376","3R",4596283,4599749,3466
"4887","FBgn0085322","3R",27164708,27165575,867
"4888","FBgn0004143","X",7049476,7050321,845
"4889","FBgn0265955","2L",5287848,5288361,513
"4890","FBgn0265582","2L",17429706,17430157,451
"4891","FBgn0035435","3L",3318028,3319232,1204
"4892","FBgn0010294","X",3240026,3240571,545
"4893","FBgn0067311","2L",20816456,20817270,814
"4894","FBgn0052640","X",13178005,13178523,518
"4895","FBgn0038608","3R",18364244,18366162,1918
"4896","FBgn0021874","2L",566366,568121,1755
"4897","FBgn0267915","2L",7094515,7095248,733
"4898","FBgn0001122","2R",10437985,10465701,27716
"4899","FBgn0034415","2R",19055231,19055924,693
"4900","FBgn0243512","3R",8105332,8122294,16962
"4901","FBgn0016975","X",22980722,23004648,23926
"4902","FBgn0284080","2R",854814,855571,757
"4903","FBgn0039764","3R",30423032,30423929,897
"4904","FBgn0011951","X",14017212,14017284,72
"4905","FBgn0039213","3R",24625671,24634714,9043
"4906","FBgn0051418","3R",17283795,17284511,716
"4907","FBgn0039537","3R",27677522,27679013,1491
"4908","FBgn0019644","3L",9729999,9731224,1225
"4909","FBgn0031514","2L",3275800,3280534,4734
"4910","FBgn0262647","2L",11123777,11129335,5558
"4911","FBgn0082988","3R",5598423,5598566,143
"4912","FBgn0030067","X",8901699,8903761,2062
"4913","FBgn0035877","3L",8340785,8342876,2091
"4914","FBgn0029925","X",6972324,6973393,1069
"4915","FBgn0031351","2L",1611410,1612576,1166
"4916","FBgn0263201","2R",10080788,10080924,136
"4917","FBgn0260779","3R",19026174,19028857,2683
"4918","FBgn0267960","3L",11317704,11318357,653
"4919","FBgn0263577","2L",4817816,4817881,65
"4920","FBgn0030838","X",17282496,17305475,22979
"4921","FBgn0039175","3R",24250460,24252679,2219
"4922","FBgn0267550","3L",16302544,16303531,987
"4923","FBgn0264570","3L",23909119,23910123,1004
"4924","FBgn0266390","3R",29095368,29096487,1119
"4925","FBgn0053234","3L",2661622,2663622,2000
"4926","FBgn0264489","3L",9813847,9834345,20498
"4927","FBgn0283666","2R",24063051,24065405,2354
"4928","FBgn0037322","3R",5397643,5399196,1553
"4929","FBgn0032069","2L",8777661,8781252,3591
"4930","FBgn0004919","2R",25072627,25084347,11720
"4931","FBgn0032322","2L",10972280,10973408,1128
"4932","FBgn0259969","3L",6350276,6350829,553
"4933","FBgn0025684","2L",4446670,4448635,1965
"4934","FBgn0037170","3L",22550226,22552019,1793
"4935","FBgn0021765","X",18091259,18092853,1594
"4936","FBgn0002872","3L",1942734,1947475,4741
"4937","FBgn0263855","2R",5969099,5974385,5286
"4938","FBgn0086348","3L",8520552,8521489,937
"4939","FBgn0031277","2L",779173,779655,482
"4940","FBgn0033221","2R",7789206,7789988,782
"4941","FBgn0260634","3R",23808285,23819237,10952
"4942","FBgn0052726","X",7425220,7425743,523
"4943","FBgn0065109","2L",9771155,9775030,3875
"4944","FBgn0017430","3L",8599442,8600879,1437
"4945","FBgn0031523","2L",3332814,3334790,1976
"4946","FBgn0038067","3R",12634917,12636283,1366
"4947","FBgn0039199","3R",24390592,24391870,1278
"4948","FBgn0267249","3L",18979368,18979590,222
"4949","FBgn0011985","2L",3169582,3169663,81
"4950","FBgn0262480","2R",18863896,18864558,662
"4951","FBgn0020510","3R",14119262,14122420,3158
"4952","FBgn0035194","3L",1246986,1247677,691
"4953","FBgn0034893","2R",23698105,23699014,909
"4954","FBgn0030052","X",8574306,8588528,14222
"4955","FBgn0030100","X",9193898,9195333,1435
"4956","FBgn0261861","3R",26784338,26785753,1415
"4957","FBgn0053640","2L",13527841,13528537,696
"4958","FBgn0267307","3L",5377814,5378407,593
"4959","FBgn0020386","3L",129450,145895,16445
"4960","FBgn0050472","2R",15423185,15424139,954
"4961","FBgn0036237","3L",11991853,11993179,1326
"4962","FBgn0261588","2R",8327490,8396280,68790
"4963","FBgn0085212","2L",9890061,9890772,711
"4964","FBgn0052685","X",10071858,10082492,10634
"4965","FBgn0033913","2R",14219898,14230620,10722
"4966","FBgn0033653","2R",11825345,11827097,1752
"4967","FBgn0036860","3L",19275791,19279919,4128
"4968","FBgn0046886","3R",27544443,27545836,1393
"4969","FBgn0036462","3L",14997981,14999666,1685
"4970","FBgn0002641","X",20429675,20433210,3535
"4971","FBgn0034446","2R",19444179,19445058,879
"4972","FBgn0266680","3L",2517161,2518402,1241
"4973","FBgn0262604","3R",8819618,8821098,1480
"4974","FBgn0085786","2R",3524536,3526047,1511
"4975","FBgn0030672","X",15705806,15710539,4733
"4976","FBgn0036835","3L",18984961,18985634,673
"4977","FBgn0030411","X",12629878,12631111,1233
"4978","FBgn0267128","3R",29276376,29277108,732
"4979","FBgn0033457","2R",9865632,9867051,1419
"4980","FBgn0266408","3R",19908403,19910318,1915
"4981","FBgn0010803","3R",9265027,9266904,1877
"4982","FBgn0037873","3R",11208887,11209849,962
"4983","FBgn0065076","2R",19727098,19727152,54
"4984","FBgn0262384","3R",31753524,31753591,67
"4985","FBgn0030327","X",11706575,11709951,3376
"4986","FBgn0012018","2L",7711476,7711661,185
"4987","FBgn0034083","2R",16150123,16169519,19396
"4988","FBgn0036711","3L",17340279,17341316,1037
"4989","FBgn0040743","2R",16792642,16793179,537
"4990","FBgn0050231","2R",17604771,17604843,72
"4991","FBgn0042098","2R",21798017,21799195,1178
"4992","FBgn0039932","4",962341,978489,16148
"4993","FBgn0267863","Y",3264145,3264418,273
"4994","FBgn0024754","2R",15566271,15569404,3133
"4995","FBgn0267761","3R",23957305,23958388,1083
"4996","FBgn0020270","2L",11282090,11284335,2245
"4997","FBgn0046999","2R",16873015,16873755,740
"4998","FBgn0001223","3L",9372931,9374964,2033
"4999","FBgn0267162","X",10071391,10071734,343
"5000","FBgn0264896","3R",21845453,21846711,1258
"5001","FBgn0036678","3L",16928381,16935536,7155
"5002","FBgn0036878","3L",19517552,19518332,780
"5003","FBgn0037504","3R",7472458,7473781,1323
"5004","FBgn0026876","X",1236873,1239884,3011
"5005","FBgn0028980","3L",6055136,6057002,1866
"5006","FBgn0083068","3L",11096496,11098556,2060
"5007","FBgn0085228","2R",20287596,20288346,750
"5008","FBgn0030577","X",14775308,14776299,991
"5009","FBgn0265833","2R",19953795,19954645,850
"5010","FBgn0035240","3L",1602954,1617355,14401
"5011","FBgn0038210","3R",14162709,14163625,916
"5012","FBgn0031235","2L",232487,234208,1721
"5013","FBgn0038879","3R",21283197,21284050,853
"5014","FBgn0039751","3R",30175786,30177700,1914
"5015","FBgn0265541","2R",17135595,17136325,730
"5016","FBgn0037180","3L",22695953,22696435,482
"5017","FBgn0038353","3R",15695241,15697142,1901
"5018","FBgn0263049","2L",18455717,18473132,17415
"5019","FBgn0034883","2R",23603722,23616754,13032
"5020","FBgn0283651","2L",14104090,14160587,56497
"5021","FBgn0042125","2L",11997900,11999340,1440
"5022","FBgn0264386","X",6104085,6192483,88398
"5023","FBgn0262293","2L",23168825,23168899,74
"5024","FBgn0035608","3L",5497523,5498958,1435
"5025","FBgn0050251","2R",12334995,12335066,71
"5026","FBgn0028523","2L",16400175,16448469,48294
"5027","FBgn0035642","3L",5873311,5875466,2155
"5028","FBgn0038873","3R",21242618,21245418,2800
"5029","FBgn0036203","3L",11767299,11772157,4858
"5030","FBgn0038506","3R",17409619,17410840,1221
"5031","FBgn0265311","2R",9183395,9184495,1100
"5032","FBgn0267958","3R",12744672,12745388,716
"5033","FBgn0002783","3R",15968134,15972913,4779
"5034","FBgn0051156","3R",22608670,22613656,4986
"5035","FBgn0261797","3L",4807368,4825687,18319
"5036","FBgn0040342","X",930931,932475,1544
"5037","FBgn0036938","3L",20112265,20112847,582
"5038","FBgn0000137","X",460747,463176,2429
"5039","FBgn0029697","X",4218170,4223331,5161
"5040","FBgn0265922","X",21583802,21584575,773
"5041","FBgn0266162","2L",15912558,15913109,551
"5042","FBgn0039682","3R",29685736,29689311,3575
"5043","FBgn0266647","X",21146281,21147041,760
"5044","FBgn0267622","3L",22274083,22275716,1633
"5045","FBgn0043533","2R",19713395,19713976,581
"5046","FBgn0265668","2L",15882783,15883190,407
"5047","FBgn0263763","3L",15052998,15053351,353
"5048","FBgn0265638","2R",8242396,8243500,1104
"5049","FBgn0020620","2R",13984815,13990707,5892
"5050","FBgn0021979","2R",23067196,23071875,4679
"5051","FBgn0038473","3R",17070523,17072675,2152
"5052","FBgn0052412","3L",5900835,5902456,1621
"5053","FBgn0024194","3L",3162180,3163852,1672
"5054","FBgn0265694","X",7555778,7557844,2066
"5055","FBgn0263379","3L",12648907,12653090,4183
"5056","FBgn0035112","3L",218068,218663,595
"5057","FBgn0032969","2L",21974749,21992933,18184
"5058","FBgn0024732","2R",12044612,12050172,5560
"5059","FBgn0264390","X",20759736,20760953,1217
"5060","FBgn0032295","2L",10737345,10740762,3417
"5061","FBgn0265298","2L",12431075,12434665,3590
"5062","FBgn0003169","3R",14619030,14625703,6673
"5063","FBgn0035000","2R",24377831,24378740,909
"5064","FBgn0039783","3R",30510083,30512214,2131
"5065","FBgn0029974","X",7903704,7908286,4582
"5066","FBgn0264267","2L",1158576,1159355,779
"5067","FBgn0039310","3R",25273837,25275237,1400
"5068","FBgn0036262","3L",12184984,12187860,2876
"5069","FBgn0266384","3L",5780102,5780863,761
"5070","FBgn0267800","3R",8460241,8461200,959
"5071","FBgn0035504","3L",4174859,4178270,3411
"5072","FBgn0262213","2L",5068570,5068684,114
"5073","FBgn0037138","3L",21836665,21841356,4691
"5074","FBgn0003130","2R",15826693,15835055,8362
"5075","FBgn0038125","3R",13191599,13192509,910
"5076","FBgn0030805","X",16938244,16940873,2629
"5077","FBgn0034012","2R",15331325,15339384,8059
"5078","FBgn0267880","Y",3113685,3114094,409
"5079","FBgn0038771","3R",20056418,20059750,3332
"5080","FBgn0031504","2L",3128635,3129489,854
"5081","FBgn0037031","3L",20841987,20844340,2353
"5082","FBgn0010453","2L",7255419,7277171,21752
"5083","FBgn0029993","X",8075877,8078240,2363
"5084","FBgn0036641","3L",16580398,16581547,1149
"5085","FBgn0263538","X",16606108,16606194,86
"5086","FBgn0051064","3R",27229505,27239085,9580
"5087","FBgn0262905","X",19484858,19485423,565
"5088","FBgn0033851","2R",13525377,13526448,1071
"5089","FBgn0263999","2R",21935002,21936863,1861
"5090","FBgn0035312","3L",2172995,2174332,1337
"5091","FBgn0031664","2L",4979513,4981592,2079
"5092","FBgn0262150","2L",15810571,15812141,1570
"5093","FBgn0032694","2L",18617256,18661776,44520
"5094","FBgn0263873","2L",19796365,19958424,162059
"5095","FBgn0032648","2L",17525585,17529122,3537
"5096","FBgn0038426","3R",16436045,16436597,552
"5097","FBgn0038601","3R",18300195,18301728,1533
"5098","FBgn0028543","2L",13965012,13967018,2006
"5099","FBgn0033341","2R",8900566,8901375,809
"5100","FBgn0036153","3L",11311747,11313397,1650
"5101","FBgn0033128","2R",7028911,7033233,4322
"5102","FBgn0051008","3R",30989478,30990006,528
"5103","FBgn0032849","2L",20096329,20097253,924
"5104","FBgn0051352","3R",9694386,9705417,11031
"5105","FBgn0261245","X",16679297,16681784,2487
"5106","FBgn0034585","2R",21088386,21091004,2618
"5107","FBgn0038676","3R",19033538,19044693,11155
"5108","FBgn0038973","3R",22466034,22466679,645
"5109","FBgn0020309","2L",11794327,11809438,15111
"5110","FBgn0083028","2L",5202383,5202522,139
"5111","FBgn0265272","2R",13422978,13423647,669
"5112","FBgn0051668","2L",2203721,2206166,2445
"5113","FBgn0264959","2R",5981844,6012795,30951
"5114","FBgn0036272","3L",12271656,12277251,5595
"5115","FBgn0039015","3R",22732356,22733851,1495
"5116","FBgn0266683","3L",6666003,6666611,608
"5117","FBgn0004876","3R",19044882,19094270,49388
"5118","FBgn0038512","3R",17455890,17456776,886
"5119","FBgn0262222","X",13062072,13062167,95
"5120","FBgn0262098","2R",24809325,24810107,782
"5121","FBgn0264717","3L",18723807,18724312,505
"5122","FBgn0032891","2L",20832849,20835840,2991
"5123","FBgn0039264","3R",25046323,25047409,1086
"5124","FBgn0262354","2L",14352077,14352619,542
"5125","FBgn0035647","3L",5904211,5906699,2488
"5126","FBgn0267604","3L",20159990,20160486,496
"5127","FBgn0267716","3L",11474820,11475460,640
"5128","FBgn0033915","2R",14235787,14239703,3916
"5129","FBgn0038827","3R",20810804,20816190,5386
"5130","FBgn0052319","3L",1470850,1472060,1210
"5131","FBgn0033906","2R",14170462,14172998,2536
"5132","FBgn0267186","X",12914844,12915722,878
"5133","FBgn0267444","Y",1005991,1007312,1321
"5134","FBgn0034091","2R",16203329,16221793,18464
"5135","FBgn0267133","3R",31519878,31523278,3400
"5136","FBgn0039029","3R",22844093,22846302,2209
"5137","FBgn0035281","3L",1840281,1842084,1803
"5138","FBgn0053054","3L",21197411,21202882,5471
"5139","FBgn0025463","X",13157445,13159508,2063
"5140","FBgn0039509","3R",27287366,27288526,1160
"5141","FBgn0267641","3L",6505569,6506393,824
"5142","FBgn0053910","2L",21418112,21418706,594
"5143","FBgn0033246","2R",7974115,7991862,17747
"5144","FBgn0032282","2L",10683427,10684409,982
"5145","FBgn0038533","3R",17669144,17670895,1751
"5146","FBgn0266897","2L",16998683,16998941,258
"5147","FBgn0265878","2R",20837495,20838695,1200
"5148","FBgn0262416","2R",17783795,17783886,91
"5149","FBgn0266977","3L",22836555,22837070,515
"5150","FBgn0262817","2R",11085586,11088300,2714
"5151","FBgn0036443","3L",14732589,14733517,928
"5152","FBgn0085337","3R",13089242,13090081,839
"5153","FBgn0262636","4",375640,395605,19965
"5154","FBgn0086069","3L",3221771,3221847,76
"5155","FBgn0039013","3R",22724884,22726414,1530
"5156","FBgn0037351","3R",5624474,5625947,1473
"5157","FBgn0250786","2L",2979562,2987723,8161
"5158","FBgn0026386","2R",11250368,11251913,1545
"5159","FBgn0262105","3R",9824085,9824864,779
"5160","FBgn0032008","2L",8242486,8243426,940
"5161","FBgn0035515","3L",4240173,4242603,2430
"5162","FBgn0035160","3L",737680,755489,17809
"5163","FBgn0053385","2R",19754296,19754430,134
"5164","FBgn0265907","2L",18290427,18291236,809
"5165","FBgn0085194","2L",14713750,14714526,776
"5166","FBgn0262369","X",8993305,8993431,126
"5167","FBgn0036180","3L",11605436,11609465,4029
"5168","FBgn0038135","3R",13294748,13298288,3540
"5169","FBgn0085484","3L",9360316,9362042,1726
"5170","FBgn0034521","2R",20559156,20562331,3175
"5171","FBgn0033651","2R",11787808,11789493,1685
"5172","FBgn0263748","X",15779146,15780214,1068
"5173","FBgn0263351","3R",22462455,22464603,2148
"5174","FBgn0031895","2L",7190431,7194588,4157
"5175","FBgn0035217","3L",1416231,1417933,1702
"5176","FBgn0036825","3L",18898875,18900408,1533
"5177","FBgn0265103","2R",9766348,9767514,1166
"5178","FBgn0261997","3L",17791079,17791486,407
"5179","FBgn0266238","3R",7037878,7039678,1800
"5180","FBgn0027526","3R",23061493,23062751,1258
"5181","FBgn0028519","2L",14027001,14029368,2367
"5182","FBgn0264510","2R",12594392,12595649,1257
"5183","FBgn0024944","3R",20689018,20714577,25559
"5184","FBgn0035941","3L",8958857,8960921,2064
"5185","FBgn0029958","X",7731779,7734651,2872
"5186","FBgn0024975","X",2732469,2734402,1933
"5187","FBgn0038001","3R",12223991,12225019,1028
"5188","FBgn0030330","X",11720245,11723854,3609
"5189","FBgn0016075","2L",5012144,5028191,16047
"5190","FBgn0265947","2L",16195000,16195321,321
"5191","FBgn0032754","2L",19077276,19079028,1752
"5192","FBgn0038482","3R",17131211,17132198,987
"5193","FBgn0031279","2L",784336,788776,4440
"5194","FBgn0036364","3L",13440910,13442420,1510
"5195","FBgn0031062","X",19704176,19706417,2241
"5196","FBgn0052363","3L",8068208,8068290,82
"5197","FBgn0003464","X",21350280,21357912,7632
"5198","FBgn0259710","2R",21665940,21666579,639
"5199","FBgn0030724","X",16070365,16073568,3203
"5200","FBgn0030749","X",16416958,16422265,5307
"5201","FBgn0039147","3R",24107391,24108358,967
"5202","FBgn0267197","3R",16209425,16209833,408
"5203","FBgn0283550","2L",12724957,12725025,68
"5204","FBgn0030328","X",11710120,11715565,5445
"5205","FBgn0030121","X",9270434,9272960,2526
"5206","FBgn0265626","2R",18678680,18684198,5518
"5207","FBgn0085409","2L",6179133,6211114,31981
"5208","FBgn0039109","3R",23723331,23731499,8168
"5209","FBgn0267254","2L",10658281,10658559,278
"5210","FBgn0035951","3L",8986710,8989135,2425
"5211","FBgn0034894","2R",23698949,23702406,3457
"5212","FBgn0034272","2R",17744101,17746005,1904
"5213","FBgn0024887","3L",20356807,20358331,1524
"5214","FBgn0037181","3L",22712155,22713660,1505
"5215","FBgn0027087","X",18515428,18520445,5017
"5216","FBgn0051785","2L",18124098,18125749,1651
"5217","FBgn0264786","X",9691470,9692417,947
"5218","FBgn0264298","2R",24123167,24126630,3463
"5219","FBgn0063670","3L",27082091,27083906,1815
"5220","FBgn0267656","2R",16153906,16154551,645
"5221","FBgn0264348","2L",18773314,18773837,523
"5222","FBgn0267874","Y",3085424,3085676,252
"5223","FBgn0034971","2R",24068757,24073552,4795
"5224","FBgn0003515","3L",16497651,16500460,2809
"5225","FBgn0037993","3R",12138833,12158595,19762
"5226","FBgn0030671","X",15704125,15705806,1681
"5227","FBgn0033788","2R",13044695,13047256,2561
"5228","FBgn0042103","3R",7788282,7790187,1905
"5229","FBgn0259856","Y",1033831,1035493,1662
"5230","FBgn0027835","2R",18412027,18421124,9097
"5231","FBgn0036892","3L",19607857,19612199,4342
"5232","FBgn0265941","2L",14235318,14236307,989
"5233","FBgn0037408","3R",6187315,6195403,8088
"5234","FBgn0267814","3R",4393350,4394493,1143
"5235","FBgn0038693","3R",19230764,19246130,15366
"5236","FBgn0003374","X",3250089,3251040,951
"5237","FBgn0031732","2L",5718121,5720899,2778
"5238","FBgn0027549","3L",8110368,8113406,3038
"5239","FBgn0037940","3R",11711718,11712371,653
"5240","FBgn0023458","X",6240745,6255487,14742
"5241","FBgn0000283","3R",15270432,15275241,4809
"5242","FBgn0031417","2L",2370152,2371524,1372
"5243","FBgn0030582","X",14832647,14836262,3615
"5244","FBgn0267512","rDNA",46205,46327,122
"5245","FBgn0003416","X",16350315,16356482,6167
"5246","FBgn0036781","3L",18154897,18162522,7625
"5247","FBgn0261933","3L",12733364,12734611,1247
"5248","FBgn0264898","3R",21436351,21436701,350
"5249","FBgn0004183","3R",4947933,4948096,163
"5250","FBgn0051636","2L",6656459,6658152,1693
"5251","FBgn0031080","X",19958393,19959403,1010
"5252","FBgn0033279","2R",8260607,8261463,856
"5253","FBgn0033769","2R",12691308,12692690,1382
"5254","FBgn0050385","2R",7181326,7183020,1694
"5255","FBgn0035793","3L",7510986,7517316,6330
"5256","FBgn0022981","3R",4645981,4648884,2903
"5257","FBgn0031253","2L",420895,421450,555
"5258","FBgn0261682","3L",15526910,15527516,606
"5259","FBgn0027490","2L",8434058,8437365,3307
"5260","FBgn0033993","2R",15145825,15147824,1999
"5261","FBgn0051036","3R",29908107,29912892,4785
"5262","FBgn0035520","3L",4261297,4262470,1173
"5263","FBgn0050104","2R",17485002,17493169,8167
"5264","FBgn0030000","X",8119082,8121147,2065
"5265","FBgn0267299","3L",23188103,23188892,789
"5266","FBgn0050196","2R",22654805,22655392,587
"5267","FBgn0040967","2L",11034795,11035308,513
"5268","FBgn0038775","3R",20208201,20209791,1590
"5269","FBgn0286203","2R",5413744,5456095,42351
"5270","FBgn0036730","3L",17479096,17480141,1045
"5271","FBgn0030518","X",13737942,13739177,1235
"5272","FBgn0262509","3L",22998372,23040300,41928
"5273","FBgn0032485","2L",13216290,13219923,3633
"5274","FBgn0037788","3R",10112237,10120081,7844
"5275","FBgn0030932","X",18505883,18512521,6638
"5276","FBgn0086362","3R",31255127,31256659,1532
"5277","FBgn0017590","3R",22899284,22961731,62447
"5278","FBgn0267006","2L",3856478,3857172,694
"5279","FBgn0260451","2L",5037709,5040818,3109
"5280","FBgn0031865","2L",6860905,6870389,9484
"5281","FBgn0024361","X",1346553,1348143,1590
"5282","FBgn0261089","2L",17592260,17604387,12127
"5283","FBgn0266019","X",11816898,11837460,20562
"5284","FBgn0035107","3L",200174,202152,1978
"5285","FBgn0260388","3L",16491838,16496236,4398
"5286","FBgn0030073","X",8972908,8974255,1347
"5287","FBgn0261109","3L",15578769,15580537,1768
"5288","FBgn0034253","2R",17604951,17639138,34187
"5289","FBgn0267624","3L",22348168,22407547,59379
"5290","FBgn0053648","2L",14524312,14525656,1344
"5291","FBgn0263037","2L",14161144,14163222,2078
"5292","FBgn0030593","X",14901844,14905549,3705
"5293","FBgn0002183","3L",1871574,1876312,4738
"5294","FBgn0034304","2R",18148096,18151410,3314
"5295","FBgn0034289","2R",18020268,18022406,2138
"5296","FBgn0022936","3L",21821997,21823309,1312
"5297","FBgn0034416","2R",19059421,19061065,1644
"5298","FBgn0014020","2R",16102687,16107229,4542
"5299","FBgn0033863","2R",13665114,13667756,2642
"5300","FBgn0037421","3R",6287733,6289824,2091
"5301","FBgn0035532","3L",4321105,4322259,1154
"5302","FBgn0032681","2L",18472964,18484513,11549
"5303","FBgn0083228","X",18177612,18204407,26795
"5304","FBgn0027873","3R",29034573,29037062,2489
"5305","FBgn0052446","3L",21640995,21642599,1604
"5306","FBgn0063368","2L",23311700,23312464,764
"5307","FBgn0035024","2R",24561607,24565058,3451
"5308","FBgn0052638","X",13122876,13128794,5918
"5309","FBgn0262999","2L",5811574,5811925,351
"5310","FBgn0039027","3R",22804291,22807290,2999
"5311","FBgn0031103","X",20375764,20376522,758
"5312","FBgn0039768","3R",30428820,30431362,2542
"5313","FBgn0267280","2L",4891327,4891845,518
"5314","FBgn0264957","2R",5937400,5938994,1594
"5315","FBgn0053096","3R",25097672,25102146,4474
"5316","FBgn0037326","3R",5414527,5458394,43867
"5317","FBgn0259974","3R",7979588,7980322,734
"5318","FBgn0010041","3R",12375733,12376572,839
"5319","FBgn0034191","2R",17091984,17093070,1086
"5320","FBgn0033377","2R",9107151,9109718,2567
"5321","FBgn0250874","X",2730077,2732190,2113
"5322","FBgn0263995","3R",17919832,18018892,99060
"5323","FBgn0047199","3R",13948420,13949742,1322
"5324","FBgn0265585","2L",17606465,17607260,795
"5325","FBgn0030029","X",8272324,8273806,1482
"5326","FBgn0032482","2L",13203762,13210828,7066
"5327","FBgn0083023","2L",20419626,20419756,130
"5328","FBgn0039316","3R",25289889,25291366,1477
"5329","FBgn0069913","2R",24578247,24579827,1580
"5330","FBgn0031662","2L",4977312,4978567,1255
"5331","FBgn0037728","3R",9677927,9679658,1731
"5332","FBgn0259971","3L",13298797,13299023,226
"5333","FBgn0027085","3L",4825853,4829038,3185
"5334","FBgn0034447","2R",19452504,19455527,3023
"5335","FBgn0261822","2L",8083420,8116531,33111
"5336","FBgn0030943","X",18648182,18649489,1307
"5337","FBgn0267034","X",2009957,2010287,330
"5338","FBgn0031607","2L",4453169,4454453,1284
"5339","FBgn0033980","2R",14882118,14884046,1928
"5340","FBgn0261538","2R",15698726,15701696,2970
"5341","FBgn0085382","3R",27767966,27905843,137877
"5342","FBgn0027866","3R",4327814,4334071,6257
"5343","FBgn0259219","2R",13260101,13266336,6235
"5344","FBgn0031808","2L",6381266,6383419,2153
"5345","FBgn0082958","3R",28602147,28602286,139
"5346","FBgn0030048","X",8558879,8560192,1313
"5347","FBgn0035829","3L",7975438,7976154,716
"5348","FBgn0033608","2R",11284283,11285098,815
"5349","FBgn0011754","X",11695137,11704394,9257
"5350","FBgn0265646","2R",12839233,12839850,617
"5351","FBgn0030297","X",11411783,11413190,1407
"5352","FBgn0265837","2R",19925495,19925845,350
"5353","FBgn0265339","2R",9861145,9861545,400
"5354","FBgn0036531","3L",15808322,15808883,561
"5355","FBgn0262887","2L",23069005,23070724,1719
"5356","FBgn0264566","3L",21121653,21123415,1762
"5357","FBgn0267965","X",7134517,7135480,963
"5358","FBgn0262111","X",17232942,17280964,48022
"5359","FBgn0267688","3R",14840749,14841360,611
"5360","FBgn0033639","2R",11641477,11651616,10139
"5361","FBgn0039302","3R",25249348,25258672,9324
"5362","FBgn0030693","X",15793721,15796028,2307
"5363","FBgn0004854","X",17314581,17324175,9594
"5364","FBgn0264547","2L",5925205,5925961,756
"5365","FBgn0038959","3R",22402655,22405059,2404
"5366","FBgn0038180","3R",13767549,13770732,3183
"5367","FBgn0037683","3R",9363305,9364838,1533
"5368","FBgn0265596","X",15636308,15637014,706
"5369","FBgn0032699","2L",18690904,18695602,4698
"5370","FBgn0037045","3L",21030280,21031360,1080
"5371","FBgn0038049","3R",12434098,12435643,1545
"5372","FBgn0035069","2R",24798798,24800776,1978
"5373","FBgn0035685","3L",6156592,6157377,785
"5374","FBgn0002543","2L",1380086,1420453,40367
"5375","FBgn0032150","2L",9791961,9793107,1146
"5376","FBgn0040734","2R",18389959,18390242,283
"5377","FBgn0036538","3L",15835693,15837482,1789
"5378","FBgn0033405","2R",9309296,9389467,80171
"5379","FBgn0039828","3R",31213458,31214784,1326
"5380","FBgn0026141","2L",1344400,1345135,735
"5381","FBgn0033748","2R",12507896,12510615,2719
"5382","FBgn0037638","3R",8824411,8827279,2868
"5383","FBgn0041239","2R",21979860,21981099,1239
"5384","FBgn0011829","2L",21182446,21198762,16316
"5385","FBgn0261938","2L",1103254,1108373,5119
"5386","FBgn0051357","3R",24828279,24829959,1680
"5387","FBgn0263479","2R",5765180,5765319,139
"5388","FBgn0263481","2R",10536745,10536905,160
"5389","FBgn0034363","2R",18615988,18618317,2329
"5390","FBgn0051245","3R",19376195,19377225,1030
"5391","FBgn0051457","3R",23126581,23127981,1400
"5392","FBgn0037442","3R",6382914,6388304,5390
"5393","FBgn0051709","2L",9578120,9579638,1518
"5394","FBgn0265164","3R",12767178,12767468,290
"5395","FBgn0262463","2L",18471434,18471533,99
"5396","FBgn0038269","3R",14882498,14886246,3748
"5397","FBgn0086912","2L",271912,273715,1803
"5398","FBgn0035153","3L",682885,685549,2664
"5399","FBgn0265053","2R",23358478,23358961,483
"5400","FBgn0033903","2R",14165051,14166991,1940
"5401","FBgn0032452","2L",12706799,12707711,912
"5402","FBgn0039684","3R",29714505,29715004,499
"5403","FBgn0263705","X",10930840,10964046,33206
"5404","FBgn0030410","X",12628370,12629640,1270
"5405","FBgn0058005","2L",22949038,22950476,1438
"5406","FBgn0040649","X",20486180,20486588,408
"5407","FBgn0085512","2R",3647346,3647765,419
"5408","FBgn0005593","2L",10201004,10202321,1317
"5409","FBgn0045443","3R",10401032,10402966,1934
"5410","FBgn0023172","2R",17027190,17044653,17463
"5411","FBgn0262517","3L",19544345,19552290,7945
"5412","FBgn0262201","X",19551528,19551628,100
"5413","FBgn0266097","X",5188171,5188797,626
"5414","FBgn0264894","2L",13261008,13284043,23035
"5415","FBgn0028864","2L",15661041,15662753,1712
"5416","FBgn0015756","2L",11002758,11004189,1431
"5417","FBgn0016920","2L",5346200,5365760,19560
"5418","FBgn0264675","X",12043698,12116041,72343
"5419","FBgn0266161","2L",15911691,15912062,371
"5420","FBgn0283625","2R",10353368,10354389,1021
"5421","FBgn0032373","2L",11738948,11744524,5576
"5422","FBgn0038730","3R",19771382,19773225,1843
"5423","FBgn0024362","X",1342106,1344770,2664
"5424","FBgn0264471","3L",4703378,4703979,601
"5425","FBgn0000490","2L",2428372,2459823,31451
"5426","FBgn0034382","2R",18742517,18743626,1109
"5427","FBgn0261683","2L",6127872,6130651,2779
"5428","FBgn0011993","3R",17624565,17624638,73
"5429","FBgn0030740","X",16321431,16323231,1800
"5430","FBgn0005614","2R",9753697,9765518,11821
"5431","FBgn0038666","3R",18978980,18981324,2344
"5432","FBgn0037712","3R",9566195,9569189,2994
"5433","FBgn0283494","2R",24024207,24025877,1670
"5434","FBgn0031310","2L",1150766,1151764,998
"5435","FBgn0037447","3R",6468437,6471016,2579
"5436","FBgn0052420","3L",5356343,5356415,72
"5437","FBgn0003062","2R",23072909,23074725,1816
"5438","FBgn0038166","3R",13675092,13676681,1589
"5439","FBgn0038146","3R",13385648,13388709,3061
"5440","FBgn0053811","2L",21438893,21439225,332
"5441","FBgn0037439","3R",6368965,6371115,2150
"5442","FBgn0037099","3L",21555373,21558226,2853
"5443","FBgn0013701","mitochondrion_genome",6126,6190,64
"5444","FBgn0041105","3R",10071117,10073761,2644
"5445","FBgn0036176","3L",11589695,11589979,284
"5446","FBgn0051274","3R",16993016,16994532,1516
"5447","FBgn0005666","4",724400,776474,52074
"5448","FBgn0032644","2L",17484501,17485624,1123
"5449","FBgn0265534","X",15807453,15807949,496
"5450","FBgn0026379","2L",10256319,10261049,4730
"5451","FBgn0265816","2L",18003368,18003616,248
"5452","FBgn0035611","3L",5533968,5535759,1791
"5453","FBgn0053140","2R",7178390,7180730,2340
"5454","FBgn0004666","3R",13057755,13078124,20369
"5455","FBgn0262807","2R",10352456,10353114,658
"5456","FBgn0039357","3R",25679242,25680550,1308
"5457","FBgn0037843","3R",10854501,10856412,1911
"5458","FBgn0264358","2R",13783995,13784496,501
"5459","FBgn0053281","2L",3324237,3326637,2400
"5460","FBgn0030141","X",9601030,9604280,3250
"5461","FBgn0266883","2L",4001084,4001620,536
"5462","FBgn0053983","3L",15528265,15529243,978
"5463","FBgn0031392","2L",2151754,2155389,3635
"5464","FBgn0286070","2R",17413970,17420007,6037
"5465","FBgn0031762","2L",6007364,6012338,4974
"5466","FBgn0004554","3R",17610856,17611511,655
"5467","FBgn0025693","2R",5774776,5782858,8082
"5468","FBgn0262149","3R",7128087,7129067,980
"5469","FBgn0262885","2L",22131026,22131127,101
"5470","FBgn0051089","3R",25902643,25904178,1535
"5471","FBgn0035434","3L",3316781,3317144,363
"5472","FBgn0037591","3R",8511734,8513022,1288
"5473","FBgn0266539","3R",5472810,5474600,1790
"5474","FBgn0030799","X",16881347,16882790,1443
"5475","FBgn0000535","X",14955477,15009989,54512
"5476","FBgn0083971","3R",8749206,8768191,18985
"5477","FBgn0052301","3L",2244478,2248614,4136
"5478","FBgn0004860","X",2115727,2123286,7559
"5479","FBgn0038315","3R",15316471,15318285,1814
"5480","FBgn0264840","3R",20878405,20879384,979
"5481","FBgn0004924","X",15319479,15328029,8550
"5482","FBgn0036705","3L",17264416,17264986,570
"5483","FBgn0037197","3L",22860787,22861490,703
"5484","FBgn0262614","3R",8827068,8931896,104828
"5485","FBgn0034428","2R",19287983,19288995,1012
"5486","FBgn0033191","2R",7538232,7539696,1464
"5487","FBgn0266319","2L",4074279,4075952,1673
"5488","FBgn0030241","X",10852446,10854869,2423
"5489","FBgn0036210","3L",11815444,11816710,1266
"5490","FBgn0036796","3L",18607462,18609512,2050
"5491","FBgn0267126","3R",27924879,27925368,489
"5492","FBgn0025334","2R",23883136,23884440,1304
"5493","FBgn0267500","rDNA",58805,58834,29
"5494","FBgn0051660","2L",4852864,4876792,23928
"5495","FBgn0266149","2L",14560778,14561355,577
"5496","FBgn0085302","3R",14517042,14517487,445
"5497","FBgn0050235","2R",17145300,17145381,81
"5498","FBgn0266179","X",19786730,19788156,1426
"5499","FBgn0267632","3L",22879259,22880399,1140
"5500","FBgn0014469","2R",8444560,8447164,2604
"5501","FBgn0026666","X",15734270,15735780,1510
"5502","FBgn0085192","2L",11988270,11988801,531
"5503","FBgn0266307","2L",13288302,13289021,719
"5504","FBgn0053398","2R",19749512,19749646,134
"5505","FBgn0260753","X",2552206,2578640,26434
"5506","FBgn0040817","3L",11712229,11715285,3056
"5507","FBgn0047092","X",7145600,7149850,4250
"5508","FBgn0000229","2L",10247502,10250501,2999
"5509","FBgn0265827","2L",9121571,9121923,352
"5510","FBgn0024366","X",1329518,1341587,12069
"5511","FBgn0030137","X",9555607,9556544,937
"5512","FBgn0262415","3L",13620822,13620920,98
"5513","FBgn0261707","2L",11531966,11534547,2581
"5514","FBgn0026634","3R",15358481,15361657,3176
"5515","FBgn0031157","X",21104695,21106369,1674
"5516","FBgn0051754","2L",21405668,21405970,302
"5517","FBgn0034534","2R",20640976,20641668,692
"5518","FBgn0085274","3L",14893734,14894416,682
"5519","FBgn0050046","2R",12314117,12317573,3456
"5520","FBgn0030938","X",18528683,18529593,910
"5521","FBgn0263405","3R",19288357,19289296,939
"5522","FBgn0086054","3R",9355313,9355387,74
"5523","FBgn0037860","3R",11114671,11115706,1035
"5524","FBgn0065055","2L",8042189,8042350,161
"5525","FBgn0030951","X",18739216,18739895,679
"5526","FBgn0265381","3R",23372006,23372649,643
"5527","FBgn0029907","X",6823204,6824203,999
"5528","FBgn0039136","3R",23986642,23988738,2096
"5529","FBgn0040993","2L",18812648,18813941,1293
"5530","FBgn0028490","2L",11523021,11528205,5184
"5531","FBgn0052268","3L",3336032,3336418,386
"5532","FBgn0039183","3R",24333433,24337248,3815
"5533","FBgn0036752","3L",17751731,17764158,12427
"5534","FBgn0264544","2L",15675582,15676102,520
"5535","FBgn0038862","3R",21134262,21138214,3952
"5536","FBgn0262437","3L",11656918,11657017,99
"5537","FBgn0031568","2L",3730466,3754617,24151
"5538","FBgn0266630","2R",12783611,12799259,15648
"5539","FBgn0029997","X",8094250,8102095,7845
"5540","FBgn0034636","2R",21560246,21576035,15789
"5541","FBgn0031032","X",19583617,19587057,3440
"5542","FBgn0050481","2R",13954195,13955664,1469
"5543","FBgn0034671","2R",21954242,21954845,603
"5544","FBgn0047038","3L",10693184,10694108,924
"5545","FBgn0011976","X",14015445,14015526,81
"5546","FBgn0013700","mitochondrion_genome",171,239,68
"5547","FBgn0013680","mitochondrion_genome",240,1263,1023
"5548","FBgn0262992","3R",13827968,13828427,459
"5549","FBgn0025743","X",16610685,16614856,4171
"5550","FBgn0003890","3R",27967008,27988384,21376
"5551","FBgn0260941","3L",12206238,12266841,60603
"5552","FBgn0026083","X",4117020,4130016,12996
"5553","FBgn0028480","X",10368052,10384183,16131
"5554","FBgn0263662","3R",21592350,21594852,2502
"5555","FBgn0050375","2R",8265693,8267295,1602
"5556","FBgn0261881","2L",15006583,15007431,848
"5557","FBgn0052460","3L",22847725,22847796,71
"5558","FBgn0036316","3L",12824880,12843106,18226
"5559","FBgn0038529","3R",17621199,17622112,913
"5560","FBgn0037462","3R",6630151,6631184,1033
"5561","FBgn0036314","3L",12813028,12814019,991
"5562","FBgn0264383","X",7500443,7501383,940
"5563","FBgn0030088","X",9107069,9108354,1285
"5564","FBgn0286039","2R",6615752,6615923,171
"5565","FBgn0032577","2L",15916888,15917607,719
"5566","FBgn0032698","2L",18689528,18690906,1378
"5567","FBgn0036681","3L",16944361,16954942,10581
"5568","FBgn0032016","2L",8308427,8309961,1534
"5569","FBgn0266212","2L",20068793,20069318,525
"5570","FBgn0002863","3R",24228975,24229279,304
"5571","FBgn0024995","X",2706151,2707427,1276
"5572","FBgn0039424","3R",26401909,26403656,1747
"5573","FBgn0000150","3R",31745172,31746077,905
"5574","FBgn0023506","X",8461479,8463349,1870
"5575","FBgn0030081","X",9078823,9081057,2234
"5576","FBgn0037881","3R",11228158,11230600,2442
"5577","FBgn0261575","3R",25344761,25346921,2160
"5578","FBgn0035695","3L",6234323,6240068,5745
"5579","FBgn0037478","3R",7144724,7151270,6546
"5580","FBgn0085812","3R",4137894,4138652,758
"5581","FBgn0000024","3R",13222951,13259517,36566
"5582","FBgn0011956","2R",6169607,6169679,72
"5583","FBgn0036019","3L",9627316,9629193,1877
"5584","FBgn0265084","3L",7658409,7695654,37245
"5585","FBgn0038923","3R",22023527,22024341,814
"5586","FBgn0286038","2R",8231104,8231588,484
"5587","FBgn0036728","3L",17474761,17476124,1363
"5588","FBgn0267672","3R",11335551,11336307,756
"5589","FBgn0053379","2R",19756510,19756644,134
"5590","FBgn0032449","2L",12698918,12700746,1828
"5591","FBgn0039039","3R",23021222,23026713,5491
"5592","FBgn0265190","3R",24913216,24917864,4648
"5593","FBgn0032292","2L",10731400,10732423,1023
"5594","FBgn0053923","2L",1341365,1342095,730
"5595","FBgn0052270","3L",3206949,3208985,2036
"5596","FBgn0263514","X",19558370,19558496,126
"5597","FBgn0040813","3L",13356376,13357223,847
"5598","FBgn0053840","2L",21496586,21497608,1022
"5599","FBgn0033347","2R",8918940,8920368,1428
"5600","FBgn0260968","3L",8069453,8069960,507
"5601","FBgn0261627","2L",8781799,8782500,701
"5602","FBgn0031069","X",19750770,19759280,8510
"5603","FBgn0265096","2R",7394996,7396194,1198
"5604","FBgn0000064","3R",26254069,26261591,7522
"5605","FBgn0085318","3R",23506908,23507476,568
"5606","FBgn0039228","3R",24807621,24808677,1056
"5607","FBgn0283559","X",12665217,12665268,51
"5608","FBgn0031023","X",19495505,19518402,22897
"5609","FBgn0259935","3L",7423827,7454717,30890
"5610","FBgn0083963","3R",7570281,7639434,69153
"5611","FBgn0019828","3R",7059315,7060524,1209
"5612","FBgn0040382","X",759594,761939,2345
"5613","FBgn0266330","2L",10242685,10245977,3292
"5614","FBgn0262873","3R",29608477,29608854,377
"5615","FBgn0086028","2R",22606795,22606861,66
"5616","FBgn0267302","3L",4240069,4240505,436
"5617","FBgn0001078","3L",18750607,18801309,50702
"5618","FBgn0040297","2L",21104568,21134255,29687
"5619","FBgn0029507","2R",7009498,7011739,2241
"5620","FBgn0053454","2R",19251027,19251666,639
"5621","FBgn0022700","2R",21065379,21067087,1708
"5622","FBgn0053834","2L",21486496,21487518,1022
"5623","FBgn0266856","2R",16379295,16380195,900
"5624","FBgn0265789","2L",5888149,5888484,335
"5625","FBgn0267774","3R",28340412,28340800,388
"5626","FBgn0033301","2R",8551859,8552290,431
"5627","FBgn0032021","2L",8321280,8325409,4129
"5628","FBgn0263120","2R",8665813,8683022,17209
"5629","FBgn0031146","X",21039514,21040605,1091
"5630","FBgn0041721","3L",16653769,16654006,237
"5631","FBgn0029590","X",1821469,1822381,912
"5632","FBgn0028573","3L",11958872,11966131,7259
"5633","FBgn0052811","X",1297984,1298387,403
"5634","FBgn0265446","2L",17361039,17361511,472
"5635","FBgn0025644","X",2925884,2927258,1374
"5636","FBgn0030396","X",12497188,12516565,19377
"5637","FBgn0036995","3L",20454690,20464862,10172
"5638","FBgn0034008","2R",15309931,15311134,1203
"5639","FBgn0046873","3R",6549036,6549983,947
"5640","FBgn0031232","2L",204743,207297,2554
"5641","FBgn0260760","3R",29933287,29934587,1300
"5642","FBgn0001970","2L",14359252,14361411,2159
"5643","FBgn0267786","3R",30992803,30993615,812
"5644","FBgn0267620","3L",21776700,21777160,460
"5645","FBgn0032191","2L",10204757,10206961,2204
"5646","FBgn0053125","2L",2648360,2652414,4054
"5647","FBgn0058182","3R",2156916,2157206,290
"5648","FBgn0002174","2R",23706913,23709026,2113
"5649","FBgn0028931","2L",13790959,13793264,2305
"5650","FBgn0264303","3L",7333544,7335226,1682
"5651","FBgn0266160","2L",15748001,15748324,323
"5652","FBgn0086038","2L",16528823,16528922,99
"5653","FBgn0031344","2L",1500784,1502904,2120
"5654","FBgn0032101","2L",9165421,9166514,1093
"5655","FBgn0011895","2R",6949133,6949205,72
"5656","FBgn0053757","2R",9454297,9454948,651
"5657","FBgn0024806","3L",250229,257954,7725
"5658","FBgn0034951","2R",23992138,23995055,2917
"5659","FBgn0002736","2R",21128577,21129737,1160
"5660","FBgn0030834","X",17248372,17249502,1130
"5661","FBgn0065081","3L",9716803,9716875,72
"5662","FBgn0262214","3R",4295369,4295456,87
"5663","FBgn0035412","3L",3187563,3188106,543
"5664","FBgn0036646","3L",16600448,16602723,2275
"5665","FBgn0261054","2L",3670131,3670581,450
"5666","FBgn0026385","2R",11319710,11321312,1602
"5667","FBgn0040362","X",1180165,1181551,1386
"5668","FBgn0036606","3L",16319856,16320454,598
"5669","FBgn0266569","X",1046224,1047009,785
"5670","FBgn0031132","X",20822146,20825641,3495
"5671","FBgn0029728","X",4797231,4804862,7631
"5672","FBgn0267268","2L",21949849,21950521,672
"5673","FBgn0264794","4",427331,431769,4438
"5674","FBgn0037670","3R",9258964,9260400,1436
"5675","FBgn0036566","3L",16090454,16096151,5697
"5676","FBgn0262515","2R",9207561,9209774,2213
"5677","FBgn0032601","2L",16754336,16758283,3947
"5678","FBgn0010220","2R",9087834,9089802,1968
"5679","FBgn0264943","2L",2532999,2533569,570
"5680","FBgn0036179","3L",11597202,11605374,8172
"5681","FBgn0262124","2R",3900285,3949425,49140
"5682","FBgn0032772","2L",19380930,19383093,2163
"5683","FBgn0035694","3L",6231805,6232361,556
"5684","FBgn0001123","2R",23942538,23946936,4398
"5685","FBgn0034392","2R",18794618,18796678,2060
"5686","FBgn0052521","X",21205310,21281171,75861
"5687","FBgn0267503","rDNA",70540,70569,29
"5688","FBgn0267255","2L",17320250,17320712,462
"5689","FBgn0264695","2L",16766566,16788766,22200
"5690","FBgn0264751","3R",18396995,18400339,3344
"5691","FBgn0029712","X",4549070,4549957,887
"5692","FBgn0284413","2L",2639185,2640081,896
"5693","FBgn0031181","X",21477254,21478945,1691
"5694","FBgn0037109","3L",21628325,21634446,6121
"5695","FBgn0266994","3L",13018315,13019110,795
"5696","FBgn0051023","3R",30248616,30248695,79
"5697","FBgn0031853","2L",6732866,6736149,3283
"5698","FBgn0030786","X",16783933,16785092,1159
"5699","FBgn0032871","2L",20650189,20650898,709
"5700","FBgn0266434","X",14875370,14882586,7216
"5701","FBgn0029580","X",1467493,1470614,3121
"5702","FBgn0037880","3R",11226762,11228227,1465
"5703","FBgn0005536","3L",16051959,16082026,30067
"5704","FBgn0024291","2L",13165564,13169551,3987
"5705","FBgn0053411","2R",19744720,19744854,134
"5706","FBgn0267810","3R",5613280,5616308,3028
"5707","FBgn0011289","3R",27251112,27256463,5351
"5708","FBgn0001612","X",13736570,13744683,8113
"5709","FBgn0051642","2L",6118512,6120522,2010
"5710","FBgn0262220","2R",9313023,9313116,93
"5711","FBgn0032388","2L",11984327,11988039,3712
"5712","FBgn0051158","3R",22587755,22608842,21087
"5713","FBgn0028841","2L",16365903,16367039,1136
"5714","FBgn0035918","3L",8631509,8634069,2560
"5715","FBgn0053843","2L",21501633,21502655,1022
"5716","FBgn0051163","3R",22133830,22296126,162296
"5717","FBgn0266163","2L",15417929,15418361,432
"5718","FBgn0037759","3R",9801280,9803461,2181
"5719","FBgn0266798","2L",8862610,8867511,4901
"5720","FBgn0031039","X",19611526,19615617,4091
"5721","FBgn0034027","2R",15539554,15541363,1809
"5722","FBgn0022702","3L",1752328,1755934,3606
"5723","FBgn0085259","2R",11861310,11862015,705
"5724","FBgn0036118","3L",11061571,11062215,644
"5725","FBgn0030384","X",12373118,12374448,1330
"5726","FBgn0085190","2L",10580957,10581702,745
"5727","FBgn0015036","X",2179007,2180998,1991
"5728","FBgn0041709","3L",2269881,2272769,2888
"5729","FBgn0036519","3L",15608707,15610386,1679
"5730","FBgn0027660","3L",17396031,17421514,25483
"5731","FBgn0036145","3L",11199620,11200587,967
"5732","FBgn0028850","2L",15291426,15292239,813
"5733","FBgn0040064","2L",9915253,9917220,1967
"5734","FBgn0013707","mitochondrion_genome",9838,9903,65
"5735","FBgn0086667","X",5524302,5524465,163
"5736","FBgn0037906","3R",11452849,11460552,7703
"5737","FBgn0031717","2L",5547086,5549614,2528
"5738","FBgn0267090","X",7487552,7488336,784
"5739","FBgn0260012","2R",12027985,12033725,5740
"5740","FBgn0263447","3L",7250640,7252598,1958
"5741","FBgn0036746","3L",17659818,17669234,9416
"5742","FBgn0083141","2L",7581924,7583333,1409
"5743","FBgn0034069","2R",16028603,16030091,1488
"5744","FBgn0034096","2R",16234358,16234936,578
"5745","FBgn0045842","2L",15257267,15264692,7425
"5746","FBgn0004859","4",47710,57041,9331
"5747","FBgn0086371","3R",13361816,13366910,5094
"5748","FBgn0034651","2R",21671700,21672845,1145
"5749","FBgn0037621","3R",8729790,8731698,1908
"5750","FBgn0052736","X",7011357,7012137,780
"5751","FBgn0013981","3R",14625755,14626614,859
"5752","FBgn0263471","3L",1498872,1498996,124
"5753","FBgn0003071","2R",10109740,10117457,7717
"5754","FBgn0052287","3L",3096369,3096440,71
"5755","FBgn0039858","3R",31596642,31612664,16022
"5756","FBgn0035636","3L",5783215,5786718,3503
"5757","FBgn0084001","2L",22037860,22039772,1912
"5758","FBgn0031289","2L",860197,861806,1609
"5759","FBgn0082960","3R",28601529,28601668,139
"5760","FBgn0026088","X",1879019,1879774,755
"5761","FBgn0262882","2R",17205208,17205743,535
"5762","FBgn0015035","2L",9747839,9750071,2232
"5763","FBgn0263583","2L",20607043,20607847,804
"5764","FBgn0267505","rDNA",42623,49485,6862
"5765","FBgn0260869","X",20527631,20528043,412
"5766","FBgn0038683","3R",19154097,19159878,5781
"5767","FBgn0037970","3R",11971694,11972896,1202
"5768","FBgn0033079","2R",6642418,6645098,2680
"5769","FBgn0036469","3L",15053568,15054135,567
"5770","FBgn0036703","3L",17243436,17244746,1310
"5771","FBgn0010358","2R",11355319,11356128,809
"5772","FBgn0051165","3R",22396528,22396609,81
"5773","FBgn0036786","3L",18438561,18439942,1381
"5774","FBgn0033521","2R",10426880,10427915,1035
"5775","FBgn0031020","X",19479984,19484643,4659
"5776","FBgn0025573","2R",21881352,21882533,1181
"5777","FBgn0261526","3L",4501652,4508433,6781
"5778","FBgn0038674","3R",19025099,19026203,1104
"5779","FBgn0054031","3L",23174446,23185750,11304
"5780","FBgn0032867","2L",20614522,20615559,1037
"5781","FBgn0062413","X",6661647,6668258,6611
"5782","FBgn0036785","3L",18298742,18301260,2518
"5783","FBgn0024294","2R",7147692,7149289,1597
"5784","FBgn0265300","2R",8941595,8942495,900
"5785","FBgn0024833","3R",9557712,9559525,1813
"5786","FBgn0065080","3R",19586196,19586263,67
"5787","FBgn0262964","2R",15373890,15374721,831
"5788","FBgn0267657","X",14181113,14182716,1603
"5789","FBgn0034202","2R",17156534,17158316,1782
"5790","FBgn0265938","2R",21531595,21532195,600
"5791","FBgn0003733","2R",7705183,7709184,4001
"5792","FBgn0262880","2L",7693030,7693821,791
"5793","FBgn0266935","3L",19090583,19090975,392
"5794","FBgn0035146","3L",599094,604008,4914
"5795","FBgn0033313","2R",8614722,8625203,10481
"5796","FBgn0032346","2L",11122574,11123567,993
"5797","FBgn0038321","3R",15337908,15343256,5348
"5798","FBgn0028474","X",5666052,5670652,4600
"5799","FBgn0035577","3L",4829092,4833591,4499
"5800","FBgn0262820","2R",12035921,12037165,1244
"5801","FBgn0262866","X",22529964,22536371,6407
"5802","FBgn0032390","2L",11989936,11990979,1043
"5803","FBgn0264999","2L",9669640,9671070,1430
"5804","FBgn0266254","3R",25823706,25825211,1505
"5805","FBgn0030395","X",12494395,12496597,2202
"5806","FBgn0031519","2L",3316794,3319872,3078
"5807","FBgn0013710","mitochondrion_genome",1403,1468,65
"5808","FBgn0263569","3L",11552539,11552693,154
"5809","FBgn0043550","3L",13843656,13845316,1660
"5810","FBgn0031097","X",20239855,20243209,3354
"5811","FBgn0266914","2L",15400085,15400497,412
"5812","FBgn0030925","X",18479983,18483772,3789
"5813","FBgn0051140","3R",23963180,23983232,20052
"5814","FBgn0260722","3R",9548104,9551806,3702
"5815","FBgn0053390","2R",19752457,19752591,134
"5816","FBgn0038115","3R",13049398,13051453,2055
"5817","FBgn0283553","2R",13852845,13852901,56
"5818","FBgn0000546","2R",6087873,6169087,81214
"5819","FBgn0026741","2R",12756434,12757173,739
"5820","FBgn0051616","2L",21404181,21404495,314
"5821","FBgn0028685","X",6289470,6291245,1775
"5822","FBgn0040020","3L",25114924,25115946,1022
"5823","FBgn0025882","X",21386845,21386935,90
"5824","FBgn0040648","X",20984686,20985246,560
"5825","FBgn0051778","2L",3704106,3705488,1382
"5826","FBgn0034283","2R",17893682,17894342,660
"5827","FBgn0267887","Y",3185268,3185720,452
"5828","FBgn0266284","X",1461844,1464220,2376
"5829","FBgn0259213","2L",14907489,14972300,64811
"5830","FBgn0029644","X",2941408,2942329,921
"5831","FBgn0030001","X",8121280,8135713,14433
"5832","FBgn0051016","3R",30606189,30610456,4267
"5833","FBgn0265256","2L",20531066,20531833,767
"5834","FBgn0052274","3L",3335579,3335788,209
"5835","FBgn0053856","2L",21523498,21523990,492
"5836","FBgn0033427","2R",9581761,9584545,2784
"5837","FBgn0039405","3R",26057347,26058223,876
"5838","FBgn0264381","X",13755322,13756013,691
"5839","FBgn0038958","3R",22392189,22394104,1915
"5840","FBgn0052598","X",14316130,14317150,1020
"5841","FBgn0039558","3R",27921283,27922356,1073
"5842","FBgn0020645","3L",6151304,6151803,499
"5843","FBgn0053056","3L",21198261,21203232,4971
"5844","FBgn0260459","3L",13424571,13425671,1100
"5845","FBgn0261452","3R",24237166,24237284,118
"5846","FBgn0043362","2L",5907169,5922776,15607
"5847","FBgn0051658","2L",810577,811531,954
"5848","FBgn0024941","X",16838173,16844433,6260
"5849","FBgn0034398","2R",18833372,18834775,1403
"5850","FBgn0266679","3L",10850070,10850690,620
"5851","FBgn0028646","3R",30445635,30455867,10232
"5852","FBgn0052243","3L",4539302,4541244,1942
"5853","FBgn0262563","2R",17139450,17139931,481
"5854","FBgn0053548","X",2205515,2213809,8294
"5855","FBgn0265692","X",6013708,6014019,311
"5856","FBgn0085369","2L",3662745,3692114,29369
"5857","FBgn0029825","X",5942606,5945250,2644
"5858","FBgn0035390","3L",3044113,3046812,2699
"5859","FBgn0029706","X",4366417,4371136,4719
"5860","FBgn0086687","3R",12439600,12447616,8016
"5861","FBgn0036301","3L",12535426,12537315,1889
"5862","FBgn0066303","X",19744431,19745898,1467
"5863","FBgn0263330","2L",14613258,14613621,363
"5864","FBgn0040794","3L",16333313,16333782,469
"5865","FBgn0015316","2L",8998537,8999816,1279
"5866","FBgn0259098","X",7411267,7411906,639
"5867","FBgn0266228","3R",4718589,4719399,810
"5868","FBgn0082970","2R",21330127,21330259,132
"5869","FBgn0038257","3R",14745901,14751246,5345
"5870","FBgn0038404","3R",16171991,16180475,8484
"5871","FBgn0029688","X",3955543,3965327,9784
"5872","FBgn0259843","Y",984514,985930,1416
"5873","FBgn0030775","X",16702786,16703884,1098
"5874","FBgn0050503","2R",7443824,7445792,1968
"5875","FBgn0037685","3R",9398190,9399551,1361
"5876","FBgn0036052","3L",9857383,9859889,2506
"5877","FBgn0033865","2R",13691707,13693369,1662
"5878","FBgn0267940","3R",30904968,30905532,564
"5879","FBgn0041622","3L",12964360,12967733,3373
"5880","FBgn0040261","2L",16796595,16798273,1678
"5881","FBgn0035512","3L",4211964,4212915,951
"5882","FBgn0031702","2L",5330470,5338073,7603
"5883","FBgn0083024","2L",20419303,20419430,127
"5884","FBgn0025388","X",4631052,4636004,4952
"5885","FBgn0034939","2R",23954091,23956406,2315
"5886","FBgn0266491","2L",16837972,16841884,3912
"5887","FBgn0004228","3L",15517424,15519592,2168
"5888","FBgn0265653","2R",19868745,19869495,750
"5889","FBgn0031900","2L",7250607,7252982,2375
"5890","FBgn0053094","3R",20832799,20840118,7319
"5891","FBgn0026738","3L",15503600,15504894,1294
"5892","FBgn0038452","3R",16622735,16624717,1982
"5893","FBgn0265578","2L",16340392,16342324,1932
"5894","FBgn0034175","2R",16998610,17000126,1516
"5895","FBgn0028963","2R",12842665,12844704,2039
"5896","FBgn0033949","2R",14629910,14631023,1113
"5897","FBgn0267318","3L",16176810,16177256,446
"5898","FBgn0259740","3R",10849825,10851788,1963
"5899","FBgn0025631","X",2044292,2050120,5828
"5900","FBgn0034057","2R",15989683,15991286,1603
"5901","FBgn0036090","3L",10638146,10639678,1532
"5902","FBgn0033732","2R",12416044,12418231,2187
"5903","FBgn0051223","3R",20831127,20832455,1328
"5904","FBgn0033710","2R",12306528,12310412,3884
"5905","FBgn0033259","2R",8098684,8102306,3622
"5906","FBgn0043010","2R",13220939,13222459,1520
"5907","FBgn0050098","2R",16354224,16355215,991
"5908","FBgn0265510","2R",15691054,15693887,2833
"5909","FBgn0000667","X",2023822,2042311,18489
"5910","FBgn0285991","2L",9787294,9790745,3451
"5911","FBgn0031678","2L",5055982,5058248,2266
"5912","FBgn0054049","2L",2264231,2265321,1090
"5913","FBgn0051849","2L",13180398,13182596,2198
"5914","FBgn0036874","3L",19483826,19486498,2672
"5915","FBgn0039441","3R",26631869,26632956,1087
"5916","FBgn0265545","2L",17247161,17247656,495
"5917","FBgn0052174","3L",17428936,17433621,4685
"5918","FBgn0264482","3L",20290702,20291152,450
"5919","FBgn0029783","X",5664628,5665940,1312
"5920","FBgn0265508","2R",15226938,15232665,5727
"5921","FBgn0032643","2L",17481988,17484307,2319
"5922","FBgn0267247","3L",1807546,1807855,309
"5923","FBgn0038295","3R",15150375,15191242,40867
"5924","FBgn0260713","3R",7304592,7304954,362
"5925","FBgn0034315","2R",18182435,18184090,1655
"5926","FBgn0036467","3L",15050263,15050806,543
"5927","FBgn0264366","2L",12807643,12808340,697
"5928","FBgn0038108","3R",12998089,13008404,10315
"5929","FBgn0053732","2L",21468237,21468272,35
"5930","FBgn0037665","3R",9251843,9253514,1671
"5931","FBgn0004652","3R",18414273,18545586,131313
"5932","FBgn0038709","3R",19489570,19491115,1545
"5933","FBgn0035730","3L",7025801,7026794,993
"5934","FBgn0035947","3L",8975046,8977401,2355
"5935","FBgn0050077","2R",14601278,14602010,732
"5936","FBgn0063492","2R",18407834,18408955,1121
"5937","FBgn0265533","X",15796477,15796897,420
"5938","FBgn0086472","3R",11215028,11216287,1259
"5939","FBgn0033592","2R",11239494,11240114,620
"5940","FBgn0267105","3R",7552008,7552298,290
"5941","FBgn0267378","2L",2226342,2231099,4757
"5942","FBgn0031803","2L",6354956,6356672,1716
"5943","FBgn0261705","2R",23011078,23042943,31865
"5944","FBgn0038360","3R",15786703,15788339,1636
"5945","FBgn0037123","3L",21730725,21731550,825
"5946","FBgn0267408","3R",15532137,15537292,5155
"5947","FBgn0036398","3L",14002127,14020148,18021
"5948","FBgn0026597","3R",30022842,30035311,12469
"5949","FBgn0025697","2L",7445355,7451244,5889
"5950","FBgn0283426","2R",10544925,10547260,2335
"5951","FBgn0036848","3L",19096399,19097709,1310
"5952","FBgn0264844","3R",23706361,23707146,785
"5953","FBgn0033388","2R",9162037,9164967,2930
"5954","FBgn0266045","2R",24325027,24330277,5250
"5955","FBgn0042205","3R",11626889,11628452,1563
"5956","FBgn0283500","3L",1247817,1250451,2634
"5957","FBgn0036827","3L",18901594,18902952,1358
"5958","FBgn0002855","2L",5892883,5893896,1013
"5959","FBgn0264541","2R",17598845,17599253,408
"5960","FBgn0033149","2R",7175886,7178290,2404
"5961","FBgn0038965","3R",22421161,22423302,2141
"5962","FBgn0266352","X",16632490,16632839,349
"5963","FBgn0265078","2L",19217407,19218135,728
"5964","FBgn0032911","2L",21075405,21081053,5648
"5965","FBgn0034438","2R",19367248,19373702,6454
"5966","FBgn0083045","2R",21334145,21334299,154
"5967","FBgn0261358","2L",18007935,18008962,1027
"5968","FBgn0266701","3R",30664778,30666142,1364
"5969","FBgn0085462","3R",30649961,30650858,897
"5970","FBgn0037764","3R",9817428,9818395,967
"5971","FBgn0031390","2L",2137350,2145187,7837
"5972","FBgn0037978","3R",12007476,12010434,2958
"5973","FBgn0003741","3L",16590059,16591050,991
"5974","FBgn0031292","2L",877172,885141,7969
"5975","FBgn0031473","2L",2848989,2855778,6789
"5976","FBgn0259849","211000022278436",1551,2815,1264
"5977","FBgn0267173","X",18256609,18258007,1398
"5978","FBgn0031573","2L",3810801,3813410,2609
"5979","FBgn0014029","3R",20586129,20588356,2227
"5980","FBgn0265373","2R",12052944,12056547,3603
"5981","FBgn0030661","X",15587733,15589365,1632
"5982","FBgn0266791","2R",15025104,15025665,561
"5983","FBgn0052772","X",4909102,4915161,6059
"5984","FBgn0015558","X",21328613,21339676,11063
"5985","FBgn0250732","3R",7145880,7150968,5088
"5986","FBgn0037537","3R",8005924,8008110,2186
"5987","FBgn0266536","3L",13215267,13215699,432
"5988","FBgn0038320","3R",15333266,15338365,5099
"5989","FBgn0034986","2R",24173665,24174441,776
"5990","FBgn0263457","X",23090324,23093609,3285
"5991","FBgn0037985","3R",12033142,12035525,2383
"5992","FBgn0031476","2L",2869652,2870649,997
"5993","FBgn0052816","X",316576,470726,154150
"5994","FBgn0038118","3R",13088651,13163876,75225
"5995","FBgn0036471","3L",15061029,15061705,676
"5996","FBgn0031171","X",21307586,21317522,9936
"5997","FBgn0265305","2R",8768296,8768795,499
"5998","FBgn0011889","2R",6162681,6162753,72
"5999","FBgn0037750","3R",9771795,9774419,2624
"6000","FBgn0030071","X",8922888,8923687,799
"6001","FBgn0283555","3R",19621080,19621138,58
"6002","FBgn0267724","3R",21646301,21646603,302
"6003","FBgn0029830","X",5966279,5986699,20420
"6004","FBgn0037455","3R",6580784,6582271,1487
"6005","FBgn0035199","3L",1256449,1274498,18049
"6006","FBgn0085231","2R",20752586,20753739,1153
"6007","FBgn0263630","X",2171086,2171154,68
"6008","FBgn0264479","3L",11693135,11693661,526
"6009","FBgn0264427","3R",5522299,5523120,821
"6010","FBgn0086358","2R",19292529,19304508,11979
"6011","FBgn0039153","3R",24128049,24130255,2206
"6012","FBgn0262851","X",11589376,11591266,1890
"6013","FBgn0083006","2R",13557539,13557686,147
"6014","FBgn0266451","3R",10773197,10777374,4177
"6015","FBgn0036770","3L",17898889,17907812,8923
"6016","FBgn0001149","3R",12367817,12369268,1451
"6017","FBgn0085188","2L",10202520,10204317,1797
"6018","FBgn0267660","3L",16017537,16021582,4045
"6019","FBgn0038951","3R",22366080,22367373,1293
"6020","FBgn0260861","2L",8686231,8687052,821
"6021","FBgn0031456","2L",2759924,2763889,3965
"6022","FBgn0034998","2R",24267377,24269179,1802
"6023","FBgn0052783","X",3945043,3948460,3417
"6024","FBgn0266753","3R",26519580,26522279,2699
"6025","FBgn0014849","3L",15659707,15660351,644
"6026","FBgn0030181","X",10153612,10155009,1397
"6027","FBgn0031887","2L",7067983,7069546,1563
"6028","FBgn0028993","3L",24724162,24758036,33874
"6029","FBgn0260858","X",7920409,7921966,1557
"6030","FBgn0032312","2L",10887645,10888927,1282
"6031","FBgn0283637","X",11710252,11710301,49
"6032","FBgn0035486","3L",4032062,4035703,3641
"6033","FBgn0015929","2R",7496702,7500145,3443
"6034","FBgn0001324","3L",19836614,19844944,8330
"6035","FBgn0266411","3R",30058311,30121798,63487
"6036","FBgn0001168","3L",8675759,8679253,3494
"6037","FBgn0011950","X",14017010,14017082,72
"6038","FBgn0039511","3R",27329693,27330882,1189
"6039","FBgn0034290","2R",18042296,18043744,1448
"6040","FBgn0037956","3R",11822702,11869460,46758
"6041","FBgn0014863","3R",7112850,7117732,4882
"6042","FBgn0266861","2R",16358796,16359495,699
"6043","FBgn0031472","2L",2847632,2848997,1365
"6044","FBgn0039612","3R",28878024,28880122,2098
"6045","FBgn0000166","3R",6755842,6759466,3624
"6046","FBgn0050326","2R",19415271,19415343,72
"6047","FBgn0262189","3L",16998457,16998524,67
"6048","FBgn0031926","2L",7608389,7616533,8144
"6049","FBgn0038942","3R",22331991,22332559,568
"6050","FBgn0032451","2L",12704725,12706683,1958
"6051","FBgn0267587","2R",19396500,19396849,349
"6052","FBgn0037722","3R",9627321,9628676,1355
"6053","FBgn0033208","2R",7673721,7674400,679
"6054","FBgn0050343","2R",9252021,9253255,1234
"6055","FBgn0263207","X",19915332,19915685,353
"6056","FBgn0261599","3R",9778042,9779528,1486
"6057","FBgn0028875","2L",14040170,14094401,54231
"6058","FBgn0031837","2L",6617134,6621700,4566
"6059","FBgn0038719","3R",19613381,19615784,2403
"6060","FBgn0267157","3R",4279673,4280057,384
"6061","FBgn0035776","3L",7385648,7387914,2266
"6062","FBgn0051546","3R",5634626,5635624,998
"6063","FBgn0051071","3R",26947263,26947334,71
"6064","FBgn0266878","2L",65999,66242,243
"6065","FBgn0051477","3R",10121773,10122320,547
"6066","FBgn0038975","3R",22468512,22486969,18457
"6067","FBgn0262728","2R",23688077,23690838,2761
"6068","FBgn0031389","2L",2127309,2129237,1928
"6069","FBgn0083027","X",763083,763234,151
"6070","FBgn0029868","X",6349016,6350401,1385
"6071","FBgn0032700","2L",18695664,18698571,2907
"6072","FBgn0265496","2R",13574913,13577545,2632
"6073","FBgn0265079","2L",19269114,19272861,3747
"6074","FBgn0031128","X",20670832,20677063,6231
"6075","FBgn0267243","2L",13437895,13442410,4515
"6076","FBgn0033589","2R",11235252,11235755,503
"6077","FBgn0051446","3R",15693086,15694194,1108
"6078","FBgn0034296","2R",18056064,18057065,1001
"6079","FBgn0053817","2L",21457995,21458487,492
"6080","FBgn0030995","X",19192219,19193448,1229
"6081","FBgn0086076","3L",10151612,10151726,114
"6082","FBgn0051664","2L",1824172,1826500,2328
"6083","FBgn0028387","2L",7412417,7422736,10319
"6084","FBgn0261531","2L",18007360,18007842,482
"6085","FBgn0029924","X",6969918,6972265,2347
"6086","FBgn0053368","2R",19760591,19760725,134
"6087","FBgn0263258","X",17672458,17698730,26272
"6088","FBgn0030365","X",12021068,12022746,1678
"6089","FBgn0260430","3L",3188025,3189747,1722
"6090","FBgn0003747","X",5680617,5682488,1871
"6091","FBgn0053432","2R",19736986,19737120,134
"6092","FBgn0000709","X",21339741,21345088,5347
"6093","FBgn0262856","2L",17486564,17486801,237
"6094","FBgn0040651","X",20413652,20414199,547
"6095","FBgn0029905","X",6818178,6820919,2741
"6096","FBgn0050155","2R",20657891,20657962,71
"6097","FBgn0267430","3R",2554162,3263582,709420
"6098","FBgn0051481","3R",6707800,6742063,34263
"6099","FBgn0035830","3L",7976406,7977849,1443
"6100","FBgn0020376","2L",4120343,4121627,1284
"6101","FBgn0028920","2L",13843915,13845325,1410
"6102","FBgn0034928","2R",23903750,23905269,1519
"6103","FBgn0000562","2R",23734904,23746829,11925
"6104","FBgn0265980","2R",22373695,22374966,1271
"6105","FBgn0264815","2L",11814156,11928572,114416
"6106","FBgn0051998","4",196675,205945,9270
"6107","FBgn0039472","3R",27017180,27018287,1107
"6108","FBgn0023094","3L",19813770,19815938,2168
"6109","FBgn0050045","2R",12376626,12377378,752
"6110","FBgn0034331","2R",18384824,18385589,765
"6111","FBgn0035372","3L",2772560,2774007,1447
"6112","FBgn0039194","3R",24369568,24370731,1163
"6113","FBgn0262004","3R",17413901,17414607,706
"6114","FBgn0040357","X",1206737,1207555,818
"6115","FBgn0016032","2R",7049238,7051964,2726
"6116","FBgn0052679","X",10366402,10367472,1070
"6117","FBgn0083974","3R",19634949,19635879,930
"6118","FBgn0017556","2R",24500780,24502277,1497
"6119","FBgn0031909","2L",7408533,7409809,1276
"6120","FBgn0003719","3R",24749731,24753510,3779
"6121","FBgn0052865","3R",12475336,12478267,2931
"6122","FBgn0265731","3L",10205620,10206401,781
"6123","FBgn0026089","X",1876294,1877270,976
"6124","FBgn0267922","3R",12256936,12257638,702
"6125","FBgn0029932","X",7069413,7072689,3276
"6126","FBgn0040250","3R",11173441,11175408,1967
"6127","FBgn0267420","Y",3323143,3323855,712
"6128","FBgn0261952","3L",4282956,4283478,522
"6129","FBgn0033438","2R",9611139,9683858,72719
"6130","FBgn0011586","X",8904144,8906248,2104
"6131","FBgn0028953","2R",17457663,17465795,8132
"6132","FBgn0051358","3R",12027736,12031757,4021
"6133","FBgn0037035","3L",20927826,20929190,1364
"6134","FBgn0284230","2L",21314360,21319527,5167
"6135","FBgn0027790","3L",1810588,1822903,12315
"6136","FBgn0263782","3R",23733324,23750992,17668
"6137","FBgn0267990","2R",9578905,9579271,366
"6138","FBgn0037100","3L",21558974,21562181,3207
"6139","FBgn0036709","3L",17327733,17329169,1436
"6140","FBgn0003118","3R",23290231,23346167,55936
"6141","FBgn0004839","2R",12001473,12019846,18373
"6142","FBgn0041229","3R",21832503,21834013,1510
"6143","FBgn0033060","2R",6076910,6078088,1178
"6144","FBgn0032797","2L",19508953,19517204,8251
"6145","FBgn0032656","2L",17963379,17974868,11489
"6146","FBgn0034849","2R",23356372,23357565,1193
"6147","FBgn0033072","2R",6207219,6209468,2249
"6148","FBgn0050080","2R",15698726,15701696,2970
"6149","FBgn0261262","3R",18929196,18978088,48892
"6150","FBgn0052054","3L",10092768,10094738,1970
"6151","FBgn0004574","3L",4136359,4138996,2637
"6152","FBgn0263102","2R",10557888,10617280,59392
"6153","FBgn0266417","3L",16354746,16359428,4682
"6154","FBgn0002939","2L",18081628,18083608,1980
"6155","FBgn0267473","3L",8844944,8845814,870
"6156","FBgn0265263","2L",19181965,19182810,845
"6157","FBgn0036218","3L",11879115,11881182,2067
"6158","FBgn0010548","2R",7466879,7477162,10283
"6159","FBgn0039929","4",1029711,1031757,2046
"6160","FBgn0265857","2R",20508495,20508795,300
"6161","FBgn0040634","3L",20769586,20770138,552
"6162","FBgn0032609","2L",16802026,16821093,19067
"6163","FBgn0267174","X",11065860,11066377,517
"6164","FBgn0037889","3R",11241183,11242120,937
"6165","FBgn0004512","2R",12940323,12946347,6024
"6166","FBgn0284220","2L",19447365,19453490,6125
"6167","FBgn0027608","3R",5758680,5781076,22396
"6168","FBgn0037363","3R",5669713,5679930,10217
"6169","FBgn0266086","2R",24738777,24739377,600
"6170","FBgn0051752","2L",18839628,18841310,1682
"6171","FBgn0036941","3L",20132032,20133268,1236
"6172","FBgn0259705","3R",19161259,19162300,1041
"6173","FBgn0031148","X",21045138,21049096,3958
"6174","FBgn0029859","X",6293106,6294343,1237
"6175","FBgn0053517","X",20004680,20062706,58026
"6176","FBgn0038783","3R",20303955,20304954,999
"6177","FBgn0000721","2L",3622074,3656953,34879
"6178","FBgn0035495","3L",4087581,4092706,5125
"6179","FBgn0038805","3R",20575245,20577010,1765
"6180","FBgn0264444","X",20686819,20687653,834
"6181","FBgn0029964","X",7858173,7858794,621
"6182","FBgn0032732","2L",18987707,18988331,624
"6183","FBgn0050411","2R",23415939,23417238,1299
"6184","FBgn0036607","3L",16323672,16324308,636
"6185","FBgn0266051","X",6370578,6371026,448
"6186","FBgn0033688","2R",12154258,12162998,8740
"6187","FBgn0020887","3L",19918242,19923462,5220
"6188","FBgn0266649","3L",4345801,4347801,2000
"6189","FBgn0039877","3R",31790592,31793907,3315
"6190","FBgn0030653","X",15568993,15570369,1376
"6191","FBgn0050211","2R",20658104,20658175,71
"6192","FBgn0267213","3R",25843918,25844378,460
"6193","FBgn0265964","X",376987,377642,655
"6194","FBgn0261015","3R",8774286,8801176,26890
"6195","FBgn0033349","2R",8922785,8925346,2561
"6196","FBgn0266781","3L",10825144,10825601,457
"6197","FBgn0262606","X",15689490,15691146,1656
"6198","FBgn0039713","3R",29861582,29863902,2320
"6199","FBgn0028888","2L",15161882,15200459,38577
"6200","FBgn0264394","X",18460818,18462823,2005
"6201","FBgn0032906","2L",20924975,20926147,1172
"6202","FBgn0001112","3R",7252063,7265703,13640
"6203","FBgn0038646","3R",18727573,18728468,895
"6204","FBgn0043021","2L",19816414,19816540,126
"6205","FBgn0039631","3R",29055927,29059204,3277
"6206","FBgn0040356","X",2809881,2810846,965
"6207","FBgn0052479","3L",871899,895313,23414
"6208","FBgn0051901","2L",8352187,8355172,2985
"6209","FBgn0086916","3L",13174478,13176781,2303
"6210","FBgn0032664","2L",18096568,18098120,1552
"6211","FBgn0040653","2R",20868496,20869321,825
"6212","FBgn0035510","3L",4207838,4209178,1340
"6213","FBgn0040493","3R",12950042,12967712,17670
"6214","FBgn0036020","3L",9628676,9631795,3119
"6215","FBgn0030435","X",12909953,12912070,2117
"6216","FBgn0035144","3L",582824,589274,6450
"6217","FBgn0086664","3R",30206783,30206926,143
"6218","FBgn0053430","2R",19737724,19737858,134
"6219","FBgn0036623","3L",16381772,16385957,4185
"6220","FBgn0036886","3L",19552420,19554767,2347
"6221","FBgn0029672","X",3571456,3573622,2166
"6222","FBgn0051174","3R",21868681,21869514,833
"6223","FBgn0003346","2L",19441959,19447317,5358
"6224","FBgn0267438","3R",26610434,26610879,445
"6225","FBgn0014868","X",9156929,9158515,1586
"6226","FBgn0024238","X",17285704,17301929,16225
"6227","FBgn0003900","2R",22985374,23048325,62951
"6228","FBgn0085332","3R",10151153,10151697,544
"6229","FBgn0266969","3L",6302747,6303361,614
"6230","FBgn0038145","3R",13382106,13385283,3177
"6231","FBgn0032518","2L",13393687,13395131,1444
"6232","FBgn0033326","2R",8710398,8712913,2515
"6233","FBgn0028880","2L",15550372,15552029,1657
"6234","FBgn0036534","3L",15818734,15826423,7689
"6235","FBgn0031550","2L",3530789,3532678,1889
"6236","FBgn0283435","Y",3250355,3251252,897
"6237","FBgn0035257","3L",1694617,1696412,1795
"6238","FBgn0016930","2L",14184478,14234126,49648
"6239","FBgn0040964","2L",8997605,8998544,939
"6240","FBgn0003660","2R",10249435,10252417,2982
"6241","FBgn0265675","2L",9099397,9099770,373
"6242","FBgn0260439","2L",8366038,8370090,4052
"6243","FBgn0266245","3R",11084528,11085488,960
"6244","FBgn0033027","2R",5503437,5507866,4429
"6245","FBgn0260237","3R",9404385,9407857,3472
"6246","FBgn0266839","2L",3386863,3387278,415
"6247","FBgn0039450","3R",26717871,26719806,1935
"6248","FBgn0028974","X",17154110,17159306,5196
"6249","FBgn0024920","2L",2968293,2969638,1345
"6250","FBgn0032934","2L",21216004,21218544,2540
"6251","FBgn0035915","3L",8617235,8619474,2239
"6252","FBgn0266790","3L",13297649,13297944,295
"6253","FBgn0038082","3R",12739642,12741417,1775
"6254","FBgn0262890","3L",10771925,10773399,1474
"6255","FBgn0039730","3R",29993475,29995231,1756
"6256","FBgn0020440","2R",19430659,19437259,6600
"6257","FBgn0010258","3R",13654556,13656394,1838
"6258","FBgn0263831","3L",5149849,5152376,2527
"6259","FBgn0265982","2R",22673195,22673695,500
"6260","FBgn0034688","2R",22071234,22073443,2209
"6261","FBgn0035026","2R",24567987,24571821,3834
"6262","FBgn0040372","X",245978,254650,8672
"6263","FBgn0050456","2R",17100241,17107542,7301
"6264","FBgn0267259","2L",1646932,1647163,231
"6265","FBgn0266917","3R",16999384,17002355,2971
"6266","FBgn0000044","2R",20944021,20946431,2410
"6267","FBgn0051032","3R",29859041,29859865,824
"6268","FBgn0036463","3L",15001238,15014062,12824
"6269","FBgn0038003","3R",12229413,12230425,1012
"6270","FBgn0052272","3L",3096891,3096963,72
"6271","FBgn0261681","3L",15527620,15528196,576
"6272","FBgn0039678","3R",29671657,29672334,677
"6273","FBgn0085319","3R",24288553,24289818,1265
"6274","FBgn0030614","X",15095458,15096042,584
"6275","FBgn0036423","3L",14410626,14412732,2106
"6276","FBgn0036570","3L",16103432,16105627,2195
"6277","FBgn0053375","2R",19757993,19758127,134
"6278","FBgn0031478","2L",2874890,2877168,2278
"6279","FBgn0034824","2R",23123923,23126042,2119
"6280","FBgn0029756","X",5326675,5329347,2672
"6281","FBgn0039319","3R",25300891,25302317,1426
"6282","FBgn0004175","3R",7363307,7363773,466
"6283","FBgn0003065","3R",31763304,31764772,1468
"6284","FBgn0028746","X",3172268,3173140,872
"6285","FBgn0039627","3R",29049493,29050721,1228
"6286","FBgn0032214","2L",10306922,10308045,1123
"6287","FBgn0262223","3R",10408137,10408227,90
"6288","FBgn0052357","3L",16349917,16349989,72
"6289","FBgn0039081","3R",23513617,23519445,5828
"6290","FBgn0262619","2R",23890512,23893177,2665
"6291","FBgn0039170","3R",24227023,24228538,1515
"6292","FBgn0039163","3R",24187724,24188896,1172
"6293","FBgn0054047","3L",5098376,5099795,1419
"6294","FBgn0261953","3L",21586828,21613349,26521
"6295","FBgn0030457","X",13159604,13162854,3250
"6296","FBgn0264598","X",2367121,2387664,20543
"6297","FBgn0038630","3R",18598691,18600097,1406
"6298","FBgn0085358","X",19050442,19053160,2718
"6299","FBgn0261570","X",17710144,17752007,41863
"6300","FBgn0001180","3R",8690980,8697822,6842
"6301","FBgn0262030","3L",2003109,2005651,2542
"6302","FBgn0051453","3R",8559540,8561764,2224
"6303","FBgn0261823","2R",14503958,14512493,8535
"6304","FBgn0039734","3R",30000530,30003678,3148
"6305","FBgn0028988","2R",6883280,6884873,1593
"6306","FBgn0022987","2R",17469624,17475129,5505
"6307","FBgn0031266","2L",568340,572907,4567
"6308","FBgn0031735","2L",5746157,5747961,1804
"6309","FBgn0044508","X",1482492,1482590,98
"6310","FBgn0263584","2L",21952,24237,2285
"6311","FBgn0012011","3R",16321690,16321762,72
"6312","FBgn0032731","2L",18977519,18987280,9761
"6313","FBgn0262473","3R",26799041,26842403,43362
"6314","FBgn0027538","2R",14259030,14261150,2120
"6315","FBgn0039860","3R",31616303,31617837,1534
"6316","FBgn0030332","X",11763474,11764590,1116
"6317","FBgn0039195","3R",24370751,24372762,2011
"6318","FBgn0034570","2R",20996220,21007740,11520
"6319","FBgn0039158","3R",24161727,24163215,1488
"6320","FBgn0001323","3L",20597141,20620659,23518
"6321","FBgn0032210","2L",10295859,10299847,3988
"6322","FBgn0034786","2R",22847832,22853827,5995
"6323","FBgn0260964","2R",13513132,13534251,21119
"6324","FBgn0031540","2L",3467342,3470004,2662
"6325","FBgn0260442","3L",8545001,8574409,29408
"6326","FBgn0037870","3R",11196092,11197285,1193
"6327","FBgn0033367","2R",9042261,9044709,2448
"6328","FBgn0267776","3R",29054343,29055703,1360
"6329","FBgn0026395","2L",2654049,2655462,1413
"6330","FBgn0264887","2L",3861405,3862097,692
"6331","FBgn0016034","3L",22721203,22726234,5031
"6332","FBgn0038773","3R",20114838,20117139,2301
"6333","FBgn0010194","X",18501401,18505405,4004
"6334","FBgn0053690","3L",16201328,16202032,704
"6335","FBgn0266784","3L",10961500,10962141,641
"6336","FBgn0031055","X",19672312,19675891,3579
"6337","FBgn0259952","2L",3669261,3669775,514
"6338","FBgn0265729","3L",1939242,1940458,1216
"6339","FBgn0243513","2L",3038826,3039812,986
"6340","FBgn0052034","3L",8903349,8903422,73
"6341","FBgn0266248","3R",14375399,14377344,1945
"6342","FBgn0023167","2R",12168731,12170003,1272
"6343","FBgn0016756","3L",5752973,5761886,8913
"6344","FBgn0267058","X",22958076,22958827,751
"6345","FBgn0053448","2R",19731043,19731177,134
"6346","FBgn0036239","3L",11998398,12002915,4517
"6347","FBgn0034436","2R",19357532,19363124,5592
"6348","FBgn0264875","2L",2186975,2187970,995
"6349","FBgn0267647","3L",5142520,5142780,260
"6350","FBgn0050378","2R",7950339,7951492,1153
"6351","FBgn0034206","2R",17245769,17246277,508
"6352","FBgn0039085","3R",23532945,23534767,1822
"6353","FBgn0267059","X",19083739,19084017,278
"6354","FBgn0046697","Y",1636574,1884846,248272
"6355","FBgn0037577","3R",8324316,8325036,720
"6356","FBgn0033317","2R",8630207,8631962,1755
"6357","FBgn0086367","X",9217655,9223257,5602
"6358","FBgn0030010","X",8148783,8150686,1903
"6359","FBgn0038029","3R",12383336,12385624,2288
"6360","FBgn0033856","2R",13558545,13560768,2223
"6361","FBgn0034634","2R",21516774,21519125,2351
"6362","FBgn0033809","2R",13215659,13219247,3588
"6363","FBgn0033461","2R",9887648,9889485,1837
"6364","FBgn0262028","3R",16004321,16008073,3752
"6365","FBgn0025643","X",2919770,2924426,4656
"6366","FBgn0031043","X",19621451,19623074,1623
"6367","FBgn0267471","3L",4792615,4793717,1102
"6368","FBgn0039017","3R",22741150,22743081,1931
"6369","FBgn0030752","X",16438680,16441296,2616
"6370","FBgn0011840","3R",17620144,17620216,72
"6371","FBgn0052181","3L",17759697,17762904,3207
"6372","FBgn0028421","X",11334187,11340084,5897
"6373","FBgn0033970","2R",14832832,14833951,1119
"6374","FBgn0029791","X",5698557,5708633,10076
"6375","FBgn0036117","3L",11059437,11061224,1787
"6376","FBgn0050062","2R",13445700,13446309,609
"6377","FBgn0032350","2L",11151506,11155721,4215
"6378","FBgn0011910","2R",13432668,13432794,126
"6379","FBgn0035555","3L",4498856,4500500,1644
"6380","FBgn0026402","2R",17003563,17005149,1586
"6381","FBgn0039321","3R",25306407,25308391,1984
"6382","FBgn0267801","3R",8413803,8414185,382
"6383","FBgn0050202","2R",23072581,23072662,81
"6384","FBgn0038925","3R",22025975,22027480,1505
"6385","FBgn0259959","2L",5884350,5884774,424
"6386","FBgn0052221","3L",19834670,19836413,1743
"6387","FBgn0002577","X",11754273,11769508,15235
"6388","FBgn0036764","3L",17852624,17856794,4170
"6389","FBgn0012344","3R",9638182,9650706,12524
"6390","FBgn0050185","2R",23544024,23544901,877
"6391","FBgn0033794","2R",13129511,13132455,2944
"6392","FBgn0265967","X",16901767,16912724,10957
"6393","FBgn0263851","4",65577,65645,68
"6394","FBgn0031869","2L",6932545,6942814,10269
"6395","FBgn0029161","2L",6046516,6048706,2190
"6396","FBgn0082939","2R",14622330,14622409,79
"6397","FBgn0053306","2L",13842888,13843742,854
"6398","FBgn0019637","3R",5613358,5615939,2581
"6399","FBgn0031920","2L",7474704,7476952,2248
"6400","FBgn0030572","X",14582136,14582982,846
"6401","FBgn0030968","X",18855873,18857757,1884
"6402","FBgn0262290","3R",16856275,16856342,67
"6403","FBgn0265445","2L",17354877,17355523,646
"6404","FBgn0003559","X",23096771,23101431,4660
"6405","FBgn0031617","2L",4642972,4646562,3590
"6406","FBgn0052755","X",5950251,5951711,1460
"6407","FBgn0053745","2L",21533323,21533358,35
"6408","FBgn0264826","3R",21615020,21615740,720
"6409","FBgn0045502","X",11413467,11417422,3955
"6410","FBgn0265178","2R",16197042,16199555,2513
"6411","FBgn0050268","2R",22712701,22717247,4546
"6412","FBgn0266739","3R",16049031,16049421,390
"6413","FBgn0265177","2R",16196384,16196928,544
"6414","FBgn0039609","3R",28872905,28875031,2126
"6415","FBgn0267566","3R",7110012,7110264,252
"6416","FBgn0263076","2R",17557031,17563406,6375
"6417","FBgn0043903","X",19676061,19683518,7457
"6418","FBgn0003607","2L",8209626,8211122,1496
"6419","FBgn0031144","X",21028652,21031950,3298
"6420","FBgn0035379","3L",2883641,2892166,8525
"6421","FBgn0250850","2R",20633876,20640681,6805
"6422","FBgn0033864","2R",13667736,13671594,3858
"6423","FBgn0051206","3R",20106936,20107963,1027
"6424","FBgn0051773","2L",3911796,3914288,2492
"6425","FBgn0004908","3R",8341100,8341872,772
"6426","FBgn0085199","2L",17311468,17311820,352
"6427","FBgn0283437","2R",17887220,17889973,2753
"6428","FBgn0262174","3R",6776333,6776451,118
"6429","FBgn0032149","2L",9790882,9791958,1076
"6430","FBgn0030876","X",17856974,17858610,1636
"6431","FBgn0266828","2L",2188620,2189405,785
"6432","FBgn0014032","X",8463296,8464438,1142
"6433","FBgn0264866","2L",4185401,4186187,786
"6434","FBgn0260970","X",7935896,7953883,17987
"6435","FBgn0001179","3L",10631079,10633969,2890
"6436","FBgn0037975","3R",11983098,11984541,1443
"6437","FBgn0035010","2R",24455292,24490656,35364
"6438","FBgn0032955","2L",21614232,21624080,9848
"6439","FBgn0051386","3R",11269415,11305608,36193
"6440","FBgn0000097","2L",2156484,2178754,22270
"6441","FBgn0039023","3R",22761440,22763711,2271
"6442","FBgn0011273","3R",25811911,25813134,1223
"6443","FBgn0265927","3L",11250450,11250868,418
"6444","FBgn0262961","2R",17255241,17255737,496
"6445","FBgn0038327","3R",15361692,15362850,1158
"6446","FBgn0032916","2L",21102743,21104321,1578
"6447","FBgn0032691","2L",18609576,18612249,2673
"6448","FBgn0264480","3L",21735866,21736201,335
"6449","FBgn0052987","2L",8863811,8864847,1036
"6450","FBgn0028572","2L",5060815,5070750,9935
"6451","FBgn0053627","2R",12411011,12411678,667
"6452","FBgn0030409","X",12624292,12628445,4153
"6453","FBgn0037569","3R",8307473,8308645,1172
"6454","FBgn0264827","3R",9810020,9813929,3909
"6455","FBgn0039850","3R",31463301,31464134,833
"6456","FBgn0026718","2L",8449691,8463994,14303
"6457","FBgn0032022","2L",8327456,8332911,5455
"6458","FBgn0085362","X",2275822,2277781,1959
"6459","FBgn0264694","3R",11408792,11409875,1083
"6460","FBgn0265688","2L",11561201,11561966,765
"6461","FBgn0004577","3R",17014576,17027987,13411
"6462","FBgn0051648","2L",5526957,5527854,897
"6463","FBgn0040257","3R",11154626,11156513,1887
"6464","FBgn0031950","2L",7796314,7800058,3744
"6465","FBgn0267119","3R",6892918,6893462,544
"6466","FBgn0004050","X",2447769,2450550,2781
"6467","FBgn0036927","3L",19997714,20000686,2972
"6468","FBgn0038733","3R",19781246,19783145,1899
"6469","FBgn0051800","2L",19033657,19034576,919
"6470","FBgn0051639","2L",6153840,6155141,1301
"6471","FBgn0267085","X",5810492,5811006,514
"6472","FBgn0266849","2R",18226795,18228595,1800
"6473","FBgn0027868","2L",10733293,10736071,2778
"6474","FBgn0031740","2L",5802220,5804030,1810
"6475","FBgn0003086","X",3248600,3249289,689
"6476","FBgn0010269","X",9247342,9250037,2695
"6477","FBgn0262103","2R",18688132,18705805,17673
"6478","FBgn0033207","2R",7670327,7671103,776
"6479","FBgn0284436","2R",8904844,8906990,2146
"6480","FBgn0033051","2R",6020311,6023144,2833
"6481","FBgn0031275","2L",749945,762399,12454
"6482","FBgn0039897","4",230730,245903,15173
"6483","FBgn0037792","3R",10140103,10144184,4081
"6484","FBgn0266223","2L",21864946,21866291,1345
"6485","FBgn0261806","2L",18739320,18740110,790
"6486","FBgn0035924","3L",8755989,8757167,1178
"6487","FBgn0039355","3R",25677072,25678682,1610
"6488","FBgn0030186","X",10214858,10216642,1784
"6489","FBgn0038662","3R",18926996,18928659,1663
"6490","FBgn0061435","2R",22784304,22784932,628
"6491","FBgn0011762","3L",8340314,8344404,4090
"6492","FBgn0266197","X",498097,499456,1359
"6493","FBgn0025595","2L",6711286,6716186,4900
"6494","FBgn0030544","X",14191220,14192018,798
"6495","FBgn0033601","2R",11261079,11261806,727
"6496","FBgn0012036","2L",9387389,9391567,4178
"6497","FBgn0053734","2L",21478323,21478358,35
"6498","FBgn0039680","3R",29675651,29680257,4606
"6499","FBgn0024740","2L",10701940,10709453,7513
"6500","FBgn0039915","4",629691,635350,5659
"6501","FBgn0041775","3L",12515059,12520954,5895
"6502","FBgn0037644","3R",8942954,8945020,2066
"6503","FBgn0010470","2R",21487167,21497929,10762
"6504","FBgn0038858","3R",21127573,21129601,2028
"6505","FBgn0266832","2L",4255720,4256085,365
"6506","FBgn0259728","2R",9166566,9167508,942
"6507","FBgn0026144","X",7337352,7342731,5379
"6508","FBgn0264441","2L",11205528,11206092,564
"6509","FBgn0033609","2R",11285148,11289772,4624
"6510","FBgn0024983","X",527941,530291,2350
"6511","FBgn0038306","3R",15227605,15229408,1803
"6512","FBgn0004379","3L",9362636,9367046,4410
"6513","FBgn0032032","2L",8377035,8378206,1171
"6514","FBgn0083039","3R",20574906,20575043,137
"6515","FBgn0053498","X",20225137,20225979,842
"6516","FBgn0267664","3L",509297,509890,593
"6517","FBgn0265349","2L",11837243,11837486,243
"6518","FBgn0040236","X",9275318,9283117,7799
"6519","FBgn0051946","2L",2187007,2187079,72
"6520","FBgn0032513","2L",13374019,13376404,2385
"6521","FBgn0037067","3L",21291860,21292800,940
"6522","FBgn0261636","3L",615627,616646,1019
"6523","FBgn0032647","2L",17520892,17524549,3657
"6524","FBgn0030157","X",9878422,9879279,857
"6525","FBgn0083050","3R",30207493,30207630,137
"6526","FBgn0040322","3L",18673474,18675413,1939
"6527","FBgn0084017","3L",23136623,23138271,1648
"6528","FBgn0001977","2L",15036293,15038861,2568
"6529","FBgn0086078","3L",13023580,13023652,72
"6530","FBgn0250788","X",17657372,17669371,11999
"6531","FBgn0023095","3L",13228692,13279642,50950
"6532","FBgn0283547","2R",22946867,22946942,75
"6533","FBgn0051633","2L",6654760,6656321,1561
"6534","FBgn0052053","3L",10090170,10092346,2176
"6535","FBgn0035569","3L",4694205,4694845,640
"6536","FBgn0266024","2L",2601033,2601721,688
"6537","FBgn0001994","2L",16263556,16287730,24174
"6538","FBgn0036550","3L",15975368,15976428,1060
"6539","FBgn0283728","2L",21914269,21915358,1089
"6540","FBgn0265370","2L",3702614,3702947,333
"6541","FBgn0040907","X",4321764,4322231,467
"6542","FBgn0045064","2L",20066391,20073719,7328
"6543","FBgn0035358","3L",2642184,2643424,1240
"6544","FBgn0260456","2R",24666158,24668343,2185
"6545","FBgn0267925","2L",12767717,12768765,1048
"6546","FBgn0000639","3L",14094589,14098053,3464
"6547","FBgn0010278","2R",23806361,23809004,2643
"6548","FBgn0053777","3L",4554537,4555236,699
"6549","FBgn0034329","2R",18383949,18384378,429
"6550","FBgn0036427","3L",14519760,14521690,1930
"6551","FBgn0038565","3R",18023707,18025378,1671
"6552","FBgn0036466","3L",15049550,15050209,659
"6553","FBgn0267446","Y",1039234,1040412,1178
"6554","FBgn0266359","2L",9937232,9938833,1601
"6555","FBgn0085214","2R",14373829,14374395,566
"6556","FBgn0065070","3R",28812568,28812641,73
"6557","FBgn0032057","2L",8676777,8679812,3035
"6558","FBgn0002534","2R",8435310,8436095,785
"6559","FBgn0010747","3L",5152678,5154777,2099
"6560","FBgn0005778","2R",22041667,22042945,1278
"6561","FBgn0033578","2R",11135923,11139315,3392
"6562","FBgn0004407","2L",13831482,13833105,1623
"6563","FBgn0039835","3R",31252872,31253686,814
"6564","FBgn0259196","X",15555253,15556045,792
"6565","FBgn0039130","3R",23933912,23935964,2052
"6566","FBgn0034853","2R",23366866,23371459,4593
"6567","FBgn0030578","X",14776774,14777983,1209
"6568","FBgn0014184","2R",12166295,12174264,7969
"6569","FBgn0020641","3L",6143395,6144101,706
"6570","FBgn0034142","2R",16589518,16594646,5128
"6571","FBgn0029854","X",6274972,6276724,1752
"6572","FBgn0265939","2L",13642821,13643230,409
"6573","FBgn0267985","3L",27135184,27135726,542
"6574","FBgn0029874","X",6526106,6527888,1782
"6575","FBgn0032456","2L",12719045,12766546,47501
"6576","FBgn0036528","3L",15681633,15683445,1812
"6577","FBgn0266626","2R",10152717,10154345,1628
"6578","FBgn0261597","2L",18441335,18443277,1942
"6579","FBgn0261628","2L",13930322,13931362,1040
"6580","FBgn0052436","3L",21344033,21355049,11016
"6581","FBgn0029986","X",7953852,7955990,2138
"6582","FBgn0033652","2R",11756817,11814424,57607
"6583","FBgn0035831","3L",7977805,7978650,845
"6584","FBgn0031268","2L",574291,575734,1443
"6585","FBgn0063381","2R",17699208,17699276,68
"6586","FBgn0041336","2L",21282811,21284273,1462
"6587","FBgn0036470","3L",15054777,15055565,788
"6588","FBgn0037125","3L",21734099,21734788,689
"6589","FBgn0000228","2L",5271728,5278548,6820
"6590","FBgn0033108","2R",6828356,6838360,10004
"6591","FBgn0003978","2L",20064261,20065679,1418
"6592","FBgn0032494","2L",13239989,13241773,1784
"6593","FBgn0020626","3R",24934869,24938222,3353
"6594","FBgn0016696","3L",20771528,20776931,5403
"6595","FBgn0259210","2R",24415410,24428387,12977
"6596","FBgn0032303","2L",10819107,10820485,1378
"6597","FBgn0034271","2R",17739901,17743969,4068
"6598","FBgn0250824","2R",21317793,21320017,2224
"6599","FBgn0085207","2L",4433908,4435057,1149
"6600","FBgn0033283","2R",8358538,8359472,934
"6601","FBgn0250841","2L",2268106,2269140,1034
"6602","FBgn0023197","3L",17546739,17549127,2388
"6603","FBgn0041183","2L",15888640,15893811,5171
"6604","FBgn0264830","3R",12260969,12261230,261
"6605","FBgn0038761","3R",20011776,20013504,1728
"6606","FBgn0263762","3L",15050856,15051425,569
"6607","FBgn0002440","3L",6123934,6128807,4873
"6608","FBgn0266437","3L",3111233,3114467,3234
"6609","FBgn0038868","3R",21215079,21216226,1147
"6610","FBgn0051015","3R",30646106,30648551,2445
"6611","FBgn0034255","2R",17633797,17634167,370
"6612","FBgn0046687","X",5673830,5679977,6147
"6613","FBgn0036116","3L",11054035,11059659,5624
"6614","FBgn0036018","3L",9624237,9627321,3084
"6615","FBgn0262475","2L",12344219,12397528,53309
"6616","FBgn0033691","2R",12179483,12179902,419
"6617","FBgn0086695","3R",5372592,5374962,2370
"6618","FBgn0019662","3L",7348313,7353622,5309
"6619","FBgn0030895","X",18103653,18105393,1740
"6620","FBgn0033203","2R",7661855,7663408,1553
"6621","FBgn0040588","3R",22766732,22767699,967
"6622","FBgn0263344","4",867824,871426,3602
"6623","FBgn0027334","X",20391447,20392401,954
"6624","FBgn0263835","3R",22297548,22298051,503
"6625","FBgn0004629","3R",14569103,14569644,541
"6626","FBgn0029647","X",2947094,2947580,486
"6627","FBgn0085218","2R",16754444,16754925,481
"6628","FBgn0250746","3R",5357012,5358364,1352
"6629","FBgn0002592","3R",26016514,26017470,956
"6630","FBgn0052224","3L",20207866,20208801,935
"6631","FBgn0037672","3R",9262654,9264142,1488
"6632","FBgn0034411","2R",18977514,18979279,1765
"6633","FBgn0046874","3R",8774286,8801176,26890
"6634","FBgn0265185","2R",12950404,12952293,1889
"6635","FBgn0082974","3R",28603371,28603522,151
"6636","FBgn0267769","3R",25553703,25554335,632
"6637","FBgn0037215","3R",4197206,4204572,7366
"6638","FBgn0266736","3R",27109329,27111033,1704
"6639","FBgn0003861","3R",29914521,29920289,5768
"6640","FBgn0263334","2R",16078195,16078819,624
"6641","FBgn0034473","2R",19769461,19771233,1772
"6642","FBgn0266232","3R",5989227,5990341,1114
"6643","FBgn0034267","2R",17726914,17732987,6073
"6644","FBgn0040093","2R",9817300,9818535,1235
"6645","FBgn0263448","3R",15230836,15231503,667
"6646","FBgn0265049","2R",6681796,6682394,598
"6647","FBgn0261065","3R",18661121,18663552,2431
"6648","FBgn0028693","3L",16583028,16584022,994
"6649","FBgn0036075","3L",10215665,10216980,1315
"6650","FBgn0086608","3R",4391711,4394259,2548
"6651","FBgn0031077","X",19859743,19865524,5781
"6652","FBgn0263078","2L",18671604,18673285,1681
"6653","FBgn0015946","3L",18302719,18304417,1698
"6654","FBgn0038551","3R",17807407,17809222,1815
"6655","FBgn0028882","2L",14495878,14495949,71
"6656","FBgn0036235","3L",11984906,11990505,5599
"6657","FBgn0000594","3L",12190733,12192528,1795
"6658","FBgn0011851","3L",1397695,1397766,71
"6659","FBgn0040777","2R",8718017,8723839,5822
"6660","FBgn0035323","3L",2262919,2263615,696
"6661","FBgn0043536","2R",20548368,20550117,1749
"6662","FBgn0262446","2R",16065254,16065344,90
"6663","FBgn0030346","X",11871299,11872779,1480
"6664","FBgn0266945","3L",15142131,15142800,669
"6665","FBgn0053265","3L",11967343,11972979,5636
"6666","FBgn0037244","3R",4400510,4402017,1507
"6667","FBgn0010052","2R",16119793,16122773,2980
"6668","FBgn0004381","3L",11795614,11798875,3261
"6669","FBgn0262575","X",6065729,6066416,687
"6670","FBgn0034936","2R",23949201,23952459,3258
"6671","FBgn0261057","2L",18292522,18292833,311
"6672","FBgn0261835","X",9557539,9558466,927
"6673","FBgn0052573","X",16651376,16653275,1899
"6674","FBgn0010235","3L",12746616,12750056,3440
"6675","FBgn0264075","3R",9016773,9020022,3249
"6676","FBgn0263777","3R",23425602,23426029,427
"6677","FBgn0261850","2R",21171001,21174504,3503
"6678","FBgn0262432","2R",16831432,16831518,86
"6679","FBgn0035343","3L",2474667,2475614,947
"6680","FBgn0266702","3R",5835478,5836178,700
"6681","FBgn0036391","3L",13977905,13993400,15495
"6682","FBgn0266049","2R",24059477,24059913,436
"6683","FBgn0038397","3R",16060589,16067594,7005
"6684","FBgn0037464","3R",7062175,7064370,2195
"6685","FBgn0029701","X",4266097,4266669,572
"6686","FBgn0033351","2R",8927014,8928105,1091
"6687","FBgn0027569","3L",8282528,8289870,7342
"6688","FBgn0033960","2R",14753337,14756288,2951
"6689","FBgn0031435","2L",2577687,2579179,1492
"6690","FBgn0285993","3R",19326954,19327168,214
"6691","FBgn0035711","3L",6704860,6709000,4140
"6692","FBgn0267429","3L",25236940,25670980,434040
"6693","FBgn0010409","2R",17546406,17547462,1056
"6694","FBgn0266838","2L",3509099,3509440,341
"6695","FBgn0266940","3L",18074504,18075084,580
"6696","FBgn0262033","2L",9304437,9305007,570
"6697","FBgn0036214","3L",11829030,11830844,1814
"6698","FBgn0026169","2R",24176228,24176367,139
"6699","FBgn0021944","2L",6964421,6965887,1466
"6700","FBgn0030014","X",8160054,8161552,1498
"6701","FBgn0265932","3L",11323356,11323850,494
"6702","FBgn0266445","2L",6091412,6096498,5086
"6703","FBgn0040737","2R",18311822,18311998,176
"6704","FBgn0038828","3R",20816445,20818929,2484
"6705","FBgn0267170","X",20690320,20690633,313
"6706","FBgn0030148","X",9659095,9662903,3808
"6707","FBgn0031446","2L",2695330,2696437,1107
"6708","FBgn0003892","2R",8649649,8665223,15574
"6709","FBgn0267164","X",11089231,11095143,5912
"6710","FBgn0035601","3L",5362884,5366225,3341
"6711","FBgn0028999","3L",909112,912319,3207
"6712","FBgn0039993","2R",1590484,1596457,5973
"6713","FBgn0000053","2L",7014623,7023898,9275
"6714","FBgn0020906","2L",4954279,4955144,865
"6715","FBgn0032085","2L",8991735,8993632,1897
"6716","FBgn0265884","3L",18478822,18479223,401
"6717","FBgn0267417","Y",3349651,3350374,723
"6718","FBgn0285879","X",16118067,16148977,30910
"6719","FBgn0259953","2L",3668691,3669134,443
"6720","FBgn0266009","2R",23113577,23114377,800
"6721","FBgn0051961","2L",4186250,4187793,1543
"6722","FBgn0036135","3L",11120847,11122041,1194
"6723","FBgn0000163","X",17160006,17200728,40722
"6724","FBgn0265719","3L",8692703,8693191,488
"6725","FBgn0030897","X",18155369,18174744,19375
"6726","FBgn0262031","3L",19478284,19478670,386
"6727","FBgn0051926","2L",1495460,1497071,1611
"6728","FBgn0016120","3R",19095000,19096271,1271
"6729","FBgn0264945","2L",2226753,2227604,851
"6730","FBgn0002842","3L",21405425,21406738,1313
"6731","FBgn0083945","2L",10094088,10125736,31648
"6732","FBgn0035952","3L",8989069,8990228,1159
"6733","FBgn0052289","3L",3095991,3096062,71
"6734","FBgn0264989","2L",15694038,15694471,433
"6735","FBgn0050157","2R",6974038,6975133,1095
"6736","FBgn0265002","2L",10064121,10180256,116135
"6737","FBgn0039698","3R",29803196,29804389,1193
"6738","FBgn0263455","3R",4982265,4983904,1639
"6739","FBgn0031461","2L",2805261,2812376,7115
"6740","FBgn0034230","2R",17514217,17517445,3228
"6741","FBgn0267987","2L",54817,55767,950
"6742","FBgn0051465","3R",21880810,21883990,3180
"6743","FBgn0250851","2R",17773964,17781930,7966
"6744","FBgn0024558","3R",22582028,22583225,1197
"6745","FBgn0032484","2L",13212335,13215350,3015
"6746","FBgn0259731","3R",13813109,13814648,1539
"6747","FBgn0000358","3L",8729865,8730604,739
"6748","FBgn0263533","2L",20562298,20562448,150
"6749","FBgn0028965","2L",13019575,13021312,1737
"6750","FBgn0031498","2L",3037230,3038793,1563
"6751","FBgn0267178","X",11716063,11716720,657
"6752","FBgn0032361","2L",11496804,11498948,2144
"6753","FBgn0016047","2R",11310335,11318676,8341
"6754","FBgn0266844","2L",20721914,20722462,548
"6755","FBgn0033981","2R",14885264,14886947,1683
"6756","FBgn0083049","3R",30207322,30207458,136
"6757","FBgn0004103","3R",12423621,12425917,2296
"6758","FBgn0267928","2L",19215451,19215967,516
"6759","FBgn0015568","3R",7545733,7549124,3391
"6760","FBgn0036154","3L",11319642,11321719,2077
"6761","FBgn0052027","3L",18841579,18842786,1207
"6762","FBgn0261086","3R",4314455,4319069,4614
"6763","FBgn0034033","2R",15573144,15573991,847
"6764","FBgn0267310","3L",12195787,12196049,262
"6765","FBgn0010425","2R",11345237,11346066,829
"6766","FBgn0284252","2R",24509508,24515320,5812
"6767","FBgn0000928","X",2720468,2724158,3690
"6768","FBgn0003209","2L",8709880,8740660,30780
"6769","FBgn0039132","3R",23958651,23962555,3904
"6770","FBgn0038334","3R",15381407,15382951,1544
"6771","FBgn0032505","2L",13347773,13349020,1247
"6772","FBgn0011866","2L",14530854,14530924,70
"6773","FBgn0038237","3R",14513901,14558304,44403
"6774","FBgn0039169","3R",24223445,24226934,3489
"6775","FBgn0264746","3L",18072362,18073863,1501
"6776","FBgn0266394","3L",3815442,3815758,316
"6777","FBgn0033524","2R",10449350,10458892,9542
"6778","FBgn0264370","2L",3575350,3575806,456
"6779","FBgn0045442","3R",13353673,13355413,1740
"6780","FBgn0036648","3L",16608138,16609347,1209
"6781","FBgn0021768","3L",16804994,16819532,14538
"6782","FBgn0053423","2R",19740305,19740439,134
"6783","FBgn0050073","2R",14371186,14373006,1820
"6784","FBgn0259961","2L",11753640,11754022,382
"6785","FBgn0034833","2R",23183977,23185288,1311
"6786","FBgn0036725","3L",17439401,17457461,18060
"6787","FBgn0040235","X",9317915,9319223,1308
"6788","FBgn0267271","2L",20539393,20539974,581
"6789","FBgn0027259","X",11571383,11572442,1059
"6790","FBgn0030407","X",12611867,12615530,3663
"6791","FBgn0015034","2R",8447451,8449745,2294
"6792","FBgn0266706","3R",9228133,9230277,2144
"6793","FBgn0037937","3R",11693410,11694311,901
"6794","FBgn0036131","3L",11108235,11108732,497
"6795","FBgn0038179","3R",13765756,13767103,1347
"6796","FBgn0265310","2R",9161484,9161998,514
"6797","FBgn0267232","3L",11592447,11592790,343
"6798","FBgn0013691","mitochondrion_genome",3840,3906,66
"6799","FBgn0265341","2R",10044035,10045196,1161
"6800","FBgn0002466","3L",12507998,12514815,6817
"6801","FBgn0032208","2L",10281943,10292365,10422
"6802","FBgn0263080","2L",1199412,1199924,512
"6803","FBgn0262944","2L",1216854,1217785,931
"6804","FBgn0000635","X",4132887,4206093,73206
"6805","FBgn0024196","2R",17456472,17457129,657
"6806","FBgn0035008","2R",24474299,24475261,962
"6807","FBgn0086604","2R",20424338,20478951,54613
"6808","FBgn0037228","3R",4266770,4268316,1546
"6809","FBgn0039274","3R",25074877,25076382,1505
"6810","FBgn0052553","X",18124575,18127027,2452
"6811","FBgn0033749","2R",12511534,12515062,3528
"6812","FBgn0011836","3L",9884411,9888683,4272
"6813","FBgn0024293","2R",7151662,7153642,1980
"6814","FBgn0000463","3R",19302731,19326217,23486
"6815","FBgn0053339","3R",24361847,24363142,1295
"6816","FBgn0010391","X",11126877,11129087,2210
"6817","FBgn0261006","3R",6375359,6375498,139
"6818","FBgn0266450","2L",6082603,6096498,13895
"6819","FBgn0015268","2R",23905175,23907294,2119
"6820","FBgn0037232","3R",4311555,4315398,3843
"6821","FBgn0011915","2R",11652649,11652721,72
"6822","FBgn0050280","2R",22113589,22114841,1252
"6823","FBgn0037910","3R",11554145,11554869,724
"6824","FBgn0266066","2L",5690529,5691770,1241
"6825","FBgn0038191","3R",13960712,13964174,3462
"6826","FBgn0036925","3L",19986093,19988072,1979
"6827","FBgn0032374","2L",11788334,11789475,1141
"6828","FBgn0053554","2R",5177965,5251022,73057
"6829","FBgn0037635","3R",8807679,8813579,5900
"6830","FBgn0053733","2L",21473280,21473315,35
"6831","FBgn0265623","2R",12996501,13007911,11410
"6832","FBgn0031739","2L",5800517,5801975,1458
"6833","FBgn0053217","3L",23126025,23132209,6184
"6834","FBgn0262381","3L",10319785,10319883,98
"6835","FBgn0037988","3R",12061070,12062944,1874
"6836","FBgn0000281","3R",30212903,30213142,239
"6837","FBgn0043575","2R",8716950,8717695,745
"6838","FBgn0037299","3R",5226158,5227526,1368
"6839","FBgn0034750","2R",22638807,22640201,1394
"6840","FBgn0267291","2L",14876832,14877136,304
"6841","FBgn0035481","3L",3954251,3964771,10520
"6842","FBgn0004513","3L",6240500,6245746,5246
"6843","FBgn0261611","2R",12279771,12300795,21024
"6844","FBgn0265267","X",17212307,17213977,1670
"6845","FBgn0267537","3L",9999831,10000867,1036
"6846","FBgn0032894","2L",20849300,20850987,1687
"6847","FBgn0038279","3R",14918628,14923083,4455
"6848","FBgn0004387","3R",27547775,27559145,11370
"6849","FBgn0042092","2L",6906666,6907844,1178
"6850","FBgn0038723","3R",19646930,19648410,1480
"6851","FBgn0000826","X",1356488,1357601,1113
"6852","FBgn0065088","3L",17668588,17668730,142
"6853","FBgn0053531","2L",6253123,6323466,70343
"6854","FBgn0015376","2L",3707230,3711748,4518
"6855","FBgn0036923","3L",19981685,19984191,2506
"6856","FBgn0266216","2L",21178410,21179729,1319
"6857","FBgn0035754","3L",7249529,7250527,998
"6858","FBgn0034182","2R",17044743,17046768,2025
"6859","FBgn0036742","3L",17633449,17638001,4552
"6860","FBgn0035999","3L",9456318,9459370,3052
"6861","FBgn0029895","X",6699508,6719389,19881
"6862","FBgn0037305","3R",5255444,5256681,1237
"6863","FBgn0038948","3R",22360782,22362371,1589
"6864","FBgn0250731","X",23280155,23280277,122
"6865","FBgn0051130","3R",24265259,24265342,83
"6866","FBgn0053880","2L",21507843,21508437,594
"6867","FBgn0039687","3R",29724159,29724950,791
"6868","FBgn0010078","2R",22854383,22855694,1311
"6869","FBgn0030559","X",14264737,14266250,1513
"6870","FBgn0262409","X",15508959,15509046,87
"6871","FBgn0262148","2L",1989450,1990894,1444
"6872","FBgn0038909","3R",21866172,21867919,1747
"6873","FBgn0051164","3R",22113427,22115214,1787
"6874","FBgn0038163","3R",13631942,13634861,2919
"6875","FBgn0052982","2L",9125737,9163721,37984
"6876","FBgn0285951","3L",16348074,16348782,708
"6877","FBgn0034713","2R",22211371,22212704,1333
"6878","FBgn0030945","X",18650718,18653091,2373
"6879","FBgn0264994","2L",11736402,11737541,1139
"6880","FBgn0267069","X",18732813,18733673,860
"6881","FBgn0264360","2R",20264855,20265145,290
"6882","FBgn0265443","2R",13254495,13255496,1001
"6883","FBgn0041160","3L",15697594,15699850,2256
"6884","FBgn0264514","3L",13283663,13284496,833
"6885","FBgn0267086","X",6279680,6280012,332
"6886","FBgn0032709","2L",18740358,18740807,449
"6887","FBgn0030735","X",16296671,16303308,6637
"6888","FBgn0041188","3R",15408423,15417277,8854
"6889","FBgn0266730","3R",9483378,9484078,700
"6890","FBgn0261532","3R",18179275,18183479,4204
"6891","FBgn0028741","2R",17773964,17781930,7966
"6892","FBgn0085521","X",22143102,22143816,714
"6893","FBgn0029809","X",5789487,5790919,1432
"6894","FBgn0267952","3R",28638621,28639910,1289
"6895","FBgn0023519","X",1890256,1891482,1226
"6896","FBgn0051080","3R",26633732,26634714,982
"6897","FBgn0032703","2L",18703473,18704454,981
"6898","FBgn0035861","3L",8231814,8240601,8787
"6899","FBgn0051072","3R",26842462,26863130,20668
"6900","FBgn0051774","2L",3902928,3991713,88785
"6901","FBgn0052706","X",9087129,9088073,944
"6902","FBgn0034129","2R",16445986,16447512,1526
"6903","FBgn0040308","3L",3042359,3044174,1815
"6904","FBgn0004587","3R",13661311,13666891,5580
"6905","FBgn0038299","3R",15206703,15208762,2059
"6906","FBgn0262017","2L",17811953,17812672,719
"6907","FBgn0036331","3L",13008285,13009450,1165
"6908","FBgn0014340","X",5873840,5876853,3013
"6909","FBgn0027578","3R",28883693,28886015,2322
"6910","FBgn0050462","2R",16995991,16998594,2603
"6911","FBgn0037094","3L",21523186,21528163,4977
"6912","FBgn0085443","X",10490069,10585422,95353
"6913","FBgn0034602","2R",21193571,21199431,5860
"6914","FBgn0040942","X",10264233,10265263,1030
"6915","FBgn0259163","3L",9734012,9760395,26383
"6916","FBgn0031086","X",20091428,20092408,980
"6917","FBgn0085813","X",23211192,23213166,1974
"6918","FBgn0286031","3R",12645719,12646077,358
"6919","FBgn0030055","X",8677063,8680912,3849
"6920","FBgn0035558","3L",4542051,4553457,11406
"6921","FBgn0038524","3R",17606106,17608541,2435
"6922","FBgn0040666","2R",24762566,24763094,528
"6923","FBgn0027795","X",1455215,1457054,1839
"6924","FBgn0267210","3R",24767728,24768484,756
"6925","FBgn0259832","2R",11841608,11842164,556
"6926","FBgn0263410","3R",25501827,25502577,750
"6927","FBgn0011554","2R",11340513,11341423,910
"6928","FBgn0283546","3R",4748664,4748723,59
"6929","FBgn0051606","2L",8147611,8148356,745
"6930","FBgn0262425","2L",20618366,20618462,96
"6931","FBgn0266814","2R",12206092,12207196,1104
"6932","FBgn0032436","2L",12451945,12453242,1297
"6933","FBgn0026411","X",8756539,8805804,49265
"6934","FBgn0040104","2L",3716800,3717773,973
"6935","FBgn0005671","3R",12623762,12627829,4067
"6936","FBgn0011589","2R",17873939,17926695,52756
"6937","FBgn0086036","2L",11798105,11798195,90
"6938","FBgn0010223","3L",16662557,16667934,5377
"6939","FBgn0029920","X",6950510,6951266,756
"6940","FBgn0052570","X",16734947,16735980,1033
"6941","FBgn0038007","3R",12237138,12239266,2128
"6942","FBgn0039747","3R",30134856,30149606,14750
"6943","FBgn0035234","3L",1565392,1567802,2410
"6944","FBgn0032372","2L",11694804,11696107,1303
"6945","FBgn0031721","2L",5553897,5555137,1240
"6946","FBgn0039087","3R",23536993,23538908,1915
"6947","FBgn0025360","2R",8031283,8042529,11246
"6948","FBgn0036496","3L",15472197,15474110,1913
"6949","FBgn0263993","X",6863888,6881580,17692
"6950","FBgn0266311","2L",1708452,1709244,792
"6951","FBgn0263585","2L",6799196,6799600,404
"6952","FBgn0266021","2L",21819490,21822313,2823
"6953","FBgn0262316","2R",8444982,8445081,99
"6954","FBgn0267540","3L",11667278,11667898,620
"6955","FBgn0038830","3R",20823313,20824239,926
"6956","FBgn0266202","2L",1381211,1382796,1585
"6957","FBgn0034626","2R",21383227,21384391,1164
"6958","FBgn0038799","3R",20507392,20512468,5076
"6959","FBgn0264302","3L",7333544,7335226,1682
"6960","FBgn0266674","3R",21105046,21107972,2926
"6961","FBgn0039344","3R",25581223,25583179,1956
"6962","FBgn0051321","3R",14310362,14314412,4050
"6963","FBgn0029690","X",3968788,3971350,2562
"6964","FBgn0003357","3R",29922216,29923455,1239
"6965","FBgn0283439","3R",13028920,13030307,1387
"6966","FBgn0032397","2L",12035984,12038511,2527
"6967","FBgn0031443","2L",2655394,2657102,1708
"6968","FBgn0085294","3L",3268461,3268994,533
"6969","FBgn0051676","2L",20840750,20849182,8432
"6970","FBgn0011860","2L",2031692,2031762,70
"6971","FBgn0267483","3L",7350404,7350802,398
"6972","FBgn0036906","3L",19798975,19801291,2316
"6973","FBgn0267419","Y",3318599,3319442,843
"6974","FBgn0038767","3R",20029560,20031309,1749
"6975","FBgn0262611","X",5864550,5865151,601
"6976","FBgn0263653","3R",26020479,26021076,597
"6977","FBgn0041702","2R",18971309,18972537,1228
"6978","FBgn0063923","3L",216625,218058,1433
"6979","FBgn0000551","3L",21296763,21297803,1040
"6980","FBgn0085788","Y",3050502,3051290,788
"6981","FBgn0265711","3L",5499594,5500088,494
"6982","FBgn0053703","3L",9512008,9512660,652
"6983","FBgn0017418","X",18130392,18137784,7392
"6984","FBgn0011747","4",115074,129849,14775
"6985","FBgn0029828","X",5955629,5958283,2654
"6986","FBgn0019809","2L",9608562,9612706,4144
"6987","FBgn0025387","X",4627380,4630936,3556
"6988","FBgn0034047","2R",15855961,15857522,1561
"6989","FBgn0266752","3R",25675777,25676778,1001
"6990","FBgn0036110","3L",10894173,10894693,520
"6991","FBgn0000043","2R",6013910,6015689,1779
"6992","FBgn0036895","3L",19620502,19624309,3807
"6993","FBgn0000719","X",22824317,22855194,30877
"6994","FBgn0035346","3L",2488804,2492613,3809
"6995","FBgn0001281","3R",30037984,30038728,744
"6996","FBgn0083046","2R",21333934,21334092,158
"6997","FBgn0263621","3R",12676010,12676260,250
"6998","FBgn0032358","2L",11280298,11281920,1622
"6999","FBgn0053236","X",14060702,14061817,1115
"7000","FBgn0050491","2R",7655072,7656770,1698
"7001","FBgn0261584","2R",22941877,22945147,3270
"7002","FBgn0263548","X",15319954,15320037,83
"7003","FBgn0053270","3L",11578236,11578623,387
"7004","FBgn0020280","3R",4876005,4878533,2528
"7005","FBgn0259184","2R",14091031,14091814,783
"7006","FBgn0032289","2L",10724203,10728740,4537
"7007","FBgn0262570","2R",17477565,17486220,8655
"7008","FBgn0264841","3R",27260050,27261948,1898
"7009","FBgn0030511","X",13682952,13684616,1664
"7010","FBgn0034822","2R",23100057,23100478,421
"7011","FBgn0029167","3L",13846054,13860001,13947
"7012","FBgn0038984","3R",22543693,22547846,4153
"7013","FBgn0032489","2L",13224620,13225275,655
"7014","FBgn0035584","3L",4980003,4980769,766
"7015","FBgn0010770","3R",21116254,21117899,1645
"7016","FBgn0031401","2L",2220748,2225544,4796
"7017","FBgn0037467","3R",7071624,7074452,2828
"7018","FBgn0265824","2L",7177879,7178171,292
"7019","FBgn0014455","X",15450261,15453167,2906
"7020","FBgn0024943","X",8525387,8529698,4311
"7021","FBgn0263388","3R",28593488,28594283,795
"7022","FBgn0039655","3R",29226204,29227725,1521
"7023","FBgn0033721","2R",12375286,12375678,392
"7024","FBgn0266219","2L",6872714,6874378,1664
"7025","FBgn0000711","X",10385960,10409817,23857
"7026","FBgn0283461","3L",3369556,3369942,386
"7027","FBgn0031606","2L",4449295,4453038,3743
"7028","FBgn0032634","2L",17409698,17410406,708
"7029","FBgn0004510","3R",26910775,26912886,2111
"7030","FBgn0034141","2R",16587045,16589184,2139
"7031","FBgn0264835","2R",1368921,1371468,2547
"7032","FBgn0264492","3L",23097072,23103460,6388
"7033","FBgn0052707","X",9082931,9085867,2936
"7034","FBgn0285941","2R",12904545,12906237,1692
"7035","FBgn0036662","3L",16783010,16785246,2236
"7036","FBgn0031496","2L",3032210,3035348,3138
"7037","FBgn0261800","2L",7811438,7820771,9333
"7038","FBgn0037483","3R",7200970,7203450,2480
"7039","FBgn0266728","4",959224,959434,210
"7040","FBgn0266717","3R",10312039,10331353,19314
"7041","FBgn0266252","3R",20892591,20893771,1180
"7042","FBgn0265838","2R",19934495,19934995,500
"7043","FBgn0262839","3R",19354051,19354884,833
"7044","FBgn0034362","2R",18615060,18615999,939
"7045","FBgn0050058","2R",13209809,13212237,2428
"7046","FBgn0266157","2L",15463254,15463666,412
"7047","FBgn0035042","2R",24639688,24640756,1068
"7048","FBgn0027929","2L",13963507,13965088,1581
"7049","FBgn0034231","2R",17517261,17518186,925
"7050","FBgn0028400","3R",7266065,7270809,4744
"7051","FBgn0264701","3L",8915233,8915668,435
"7052","FBgn0267963","X",3363686,3364060,374
"7053","FBgn0062928","3L",19486745,19488439,1694
"7054","FBgn0036288","3L",12486668,12490676,4008
"7055","FBgn0040234","X",9319359,9324458,5099
"7056","FBgn0031868","2L",6908083,6911423,3340
"7057","FBgn0036225","3L",11943640,11944852,1212
"7058","FBgn0032533","2L",13812700,13813256,556
"7059","FBgn0267496","rDNA",46356,46385,29
"7060","FBgn0028525","2L",16303264,16305940,2676
"7061","FBgn0020429","2L",5559342,5563502,4160
"7062","FBgn0034733","2R",22478379,22483054,4675
"7063","FBgn0031646","2L",4903865,4906762,2897
"7064","FBgn0003174","2R",7282572,7300806,18234
"7065","FBgn0267486","2L",18180884,18185007,4123
"7066","FBgn0036028","3L",9679201,9681060,1859
"7067","FBgn0267489","Y",146092,192020,45928
"7068","FBgn0000533","3R",15328729,15330408,1679
"7069","FBgn0266317","2L",2374955,2375582,627
"7070","FBgn0038741","3R",19875974,19877514,1540
"7071","FBgn0263510","2R",10875748,10877296,1548
"7072","FBgn0262571","2R",19552071,19552672,601
"7073","FBgn0000640","2L",9426784,9427917,1133
"7074","FBgn0031299","2L",1083091,1102504,19413
"7075","FBgn0262123","2R",1349392,1443935,94543
"7076","FBgn0000083","3R",21065241,21070917,5676
"7077","FBgn0039448","3R",26692546,26693590,1044
"7078","FBgn0051872","2L",10639931,10643539,3608
"7079","FBgn0023528","X",2264657,2270761,6104
"7080","FBgn0250839","3R",4956999,4961351,4352
"7081","FBgn0053121","2L",7889288,7890594,1306
"7082","FBgn0032858","2L",20415173,20416918,1745
"7083","FBgn0051895","2L",8570888,8570960,72
"7084","FBgn0050502","2R",7446189,7451553,5364
"7085","FBgn0015765","3R",24150416,24152321,1905
"7086","FBgn0032515","2L",13382652,13385671,3019
"7087","FBgn0086049","X",21052283,21052361,78
"7088","FBgn0264946","2L",2236347,2237022,675
"7089","FBgn0034154","2R",16755101,16755823,722
"7090","FBgn0034437","2R",19363641,19367294,3653
"7091","FBgn0262382","3R",22292879,22292949,70
"7092","FBgn0052712","X",8433087,8433809,722
"7093","FBgn0035060","2R",24768314,24775265,6951
"7094","FBgn0032720","2L",18858028,18859248,1220
"7095","FBgn0038073","3R",12662831,12673959,11128
"7096","FBgn0052786","X",3940847,3944265,3418
"7097","FBgn0264299","2R",24123167,24126630,3463
"7098","FBgn0039508","3R",27283780,27287448,3668
"7099","FBgn0036461","3L",14992289,14997983,5694
"7100","FBgn0000259","X",11792533,11801587,9054
"7101","FBgn0030394","X",12486970,12489448,2478
"7102","FBgn0032618","2L",16879517,16886319,6802
"7103","FBgn0051464","3R",8291240,8292034,794
"7104","FBgn0050269","2R",22667155,22668848,1693
"7105","FBgn0052750","X",6194737,6196439,1702
"7106","FBgn0036612","3L",16339003,16345241,6238
"7107","FBgn0260049","3L",13412843,13416453,3610
"7108","FBgn0267456","3L",175138,176104,966
"7109","FBgn0030886","X",18005897,18007606,1709
"7110","FBgn0036577","3L",16213051,16217303,4252
"7111","FBgn0031012","X",19301330,19307925,6595
"7112","FBgn0004636","3L",1859115,1862239,3124
"7113","FBgn0032366","2L",11520358,11521285,927
"7114","FBgn0016675","2L",19417447,19418274,827
"7115","FBgn0030178","X",10084914,10086171,1257
"7116","FBgn0265897","3L",20887006,20888002,996
"7117","FBgn0013759","3R",21783400,21822674,39274
"7118","FBgn0029662","X",3465737,3474524,8787
"7119","FBgn0026079","X",4111156,4113734,2578
"7120","FBgn0029531","X",749241,751301,2060
"7121","FBgn0038386","3R",15932700,15933734,1034
"7122","FBgn0010416","X",16388820,16391438,2618
"7123","FBgn0030743","X",16331281,16333600,2319
"7124","FBgn0266403","3L",3522850,3523620,770
"7125","FBgn0283431","X",20217402,20218244,842
"7126","FBgn0034646","2R",21658770,21660007,1237
"7127","FBgn0038437","3R",16481861,16482452,591
"7128","FBgn0037518","3R",7794069,7796599,2530
"7129","FBgn0264342","2L",4647051,4647920,869
"7130","FBgn0036733","3L",17511855,17513912,2057
"7131","FBgn0032079","2L",8953481,8959051,5570
"7132","FBgn0020637","3L",6132990,6133593,603
"7133","FBgn0265916","X",18622466,18622706,240
"7134","FBgn0267121","3R",10969667,10970278,611
"7135","FBgn0267108","3R",27961443,27961821,378
"7136","FBgn0037288","3R",4953506,4955252,1746
"7137","FBgn0034354","2R",18503608,18505025,1417
"7138","FBgn0267957","2R",12900881,12901613,732
"7139","FBgn0036924","3L",19984426,19985868,1442
"7140","FBgn0267263","2L",17644448,17644844,396
"7141","FBgn0026878","X",2042730,2043818,1088
"7142","FBgn0031765","2L",6025870,6034423,8553
"7143","FBgn0030290","X",11348120,11348865,745
"7144","FBgn0283657","X",3720007,3789770,69763
"7145","FBgn0015772","2L",18957732,18968744,11012
"7146","FBgn0267156","3R",14288229,14288665,436
"7147","FBgn0031129","X",20734455,20735960,1505
"7148","FBgn0013799","3L",19818174,19830686,12512
"7149","FBgn0267602","3L",19033317,19033900,583
"7150","FBgn0266173","3R",21355692,21359768,4076
"7151","FBgn0052405","3L",6139223,6139974,751
"7152","FBgn0037713","3R",9569074,9570214,1140
"7153","FBgn0051054","3R",27960768,27961476,708
"7154","FBgn0263466","2R",10536495,10536660,165
"7155","FBgn0267722","3R",21632705,21633322,617
"7156","FBgn0260484","X",3799150,3801570,2420
"7157","FBgn0267195","3R",15697274,15697874,600
"7158","FBgn0053735","2L",21483366,21483401,35
"7159","FBgn0085819","X",23261772,23262666,894
"7160","FBgn0051259","3R",8523944,8526667,2723
"7161","FBgn0052808","X",1468693,1469817,1124
"7162","FBgn0261987","3R",17719454,17722955,3501
"7163","FBgn0038207","3R",14130680,14132072,1392
"7164","FBgn0051914","2L",5241106,5241177,71
"7165","FBgn0265724","3L",2882814,2883400,586
"7166","FBgn0024804","3L",27279316,27422159,142843
"7167","FBgn0085341","2R",13209809,13212237,2428
"7168","FBgn0051199","3R",20742800,20743869,1069
"7169","FBgn0053664","X",6384220,6384899,679
"7170","FBgn0035470","3L",3897444,3899156,1712
"7171","FBgn0261610","X",5764553,5789576,25023
"7172","FBgn0053199","2R",8947681,8951086,3405
"7173","FBgn0050053","2R",12688733,12689876,1143
"7174","FBgn0036332","3L",13009399,13011685,2286
"7175","FBgn0030359","X",11990118,11992768,2650
"7176","FBgn0031776","2L",6069079,6069838,759
"7177","FBgn0032261","2L",10507081,10508032,951
"7178","FBgn0032286","2L",10695000,10698043,3043
"7179","FBgn0034126","2R",16432244,16433183,939
"7180","FBgn0262714","3L",12805902,12813036,7134
"7181","FBgn0036259","3L",12157052,12163735,6683
"7182","FBgn0038110","3R",13008384,13011310,2926
"7183","FBgn0085265","2R",13604495,13605655,1160
"7184","FBgn0030187","X",10231002,10233080,2078
"7185","FBgn0020018","3R",24660197,24661851,1654
"7186","FBgn0284222","X",16826681,16835520,8839
"7187","FBgn0284409","2L",20550951,20551354,403
"7188","FBgn0053300","2L",9897820,9903128,5308
"7189","FBgn0035854","3L",8198207,8199491,1284
"7190","FBgn0042086","2R",6998848,6999848,1000
"7191","FBgn0036838","3L",18997875,19000608,2733
"7192","FBgn0264543","2L",6308377,6308751,374
"7193","FBgn0046258","3R",27685962,27692790,6828
"7194","FBgn0264362","2L",18804491,18805347,856
"7195","FBgn0034166","2R",16880713,16884695,3982
"7196","FBgn0263236","3R",29244961,29250451,5490
"7197","FBgn0053434","2R",19736248,19736382,134
"7198","FBgn0004783","3R",6704084,6704903,819
"7199","FBgn0051953","2L",3162515,3163289,774
"7200","FBgn0027779","2L",16722883,16727826,4943
"7201","FBgn0032483","2L",13210773,13211814,1041
"7202","FBgn0063379","2R",17702172,17702238,66
"7203","FBgn0085461","3R",30649151,30649873,722
"7204","FBgn0019972","3R",29799658,29801584,1926
"7205","FBgn0033890","2R",13980362,13983317,2955
"7206","FBgn0267242","3L",12491840,12493605,1765
"7207","FBgn0031388","2L",2079919,2081286,1367
"7208","FBgn0038526","3R",17613709,17614933,1224
"7209","FBgn0263663","3R",22777567,22781465,3898
"7210","FBgn0004647","X",3134870,3172221,37351
"7211","FBgn0051463","3R",8292335,8293609,1274
"7212","FBgn0051050","3R",28649909,28650480,571
"7213","FBgn0029890","X",6681767,6683696,1929
"7214","FBgn0082973","3L",832487,832639,152
"7215","FBgn0033928","2R",14361924,14362825,901
"7216","FBgn0263979","3R",15225576,15227564,1988
"7217","FBgn0038303","3R",15214762,15218874,4112
"7218","FBgn0051976","2L",138384,140992,2608
"7219","FBgn0267932","3L",10603772,10604509,737
"7220","FBgn0050407","2R",21843097,21843168,71
"7221","FBgn0027111","3L",267299,270336,3037
"7222","FBgn0262842","3L",16566750,16567300,550
"7223","FBgn0035964","3L",9134560,9135916,1356
"7224","FBgn0014189","2L",5539326,5542314,2988
"7225","FBgn0038105","3R",12993395,12995147,1752
"7226","FBgn0035405","3L",3159991,3162019,2028
"7227","FBgn0041243","2R",7390869,7393161,2292
"7228","FBgn0015037","2R",9240041,9242139,2098
"7229","FBgn0086855","2L",274740,278234,3494
"7230","FBgn0052086","3L",11582401,11584064,1663
"7231","FBgn0015521","2L",2856070,2857029,959
"7232","FBgn0031876","2L",6959099,6960328,1229
"7233","FBgn0041719","2L",5565619,5565766,147
"7234","FBgn0011945","3R",17619961,17620032,71
"7235","FBgn0267055","X",21155432,21156173,741
"7236","FBgn0050090","2R",15689826,15691014,1188
"7237","FBgn0031878","2L",6961516,6964074,2558
"7238","FBgn0024371","2L",21154293,21156749,2456
"7239","FBgn0267577","3R",25650572,25651557,985
"7240","FBgn0085386","3R",4491943,4558067,66124
"7241","FBgn0266692","3L",25843821,25844502,681
"7242","FBgn0013694","mitochondrion_genome",5543,5607,64
"7243","FBgn0030946","X",18653392,18657286,3894
"7244","FBgn0052087","3L",11732141,11733610,1469
"7245","FBgn0036007","3L",9494555,9505328,10773
"7246","FBgn0265710","X",9140242,9141965,1723
"7247","FBgn0034628","2R",21386309,21389276,2967
"7248","FBgn0259483","2R",6695114,6696661,1547
"7249","FBgn0042627","2L",3043947,3056143,12196
"7250","FBgn0052432","3L",20844332,20885188,40856
"7251","FBgn0069242","3R",9684469,9685476,1007
"7252","FBgn0260990","3R",29749219,29754528,5309
"7253","FBgn0028671","3R",29131193,29137980,6787
"7254","FBgn0051569","3R",17631042,17631114,72
"7255","FBgn0036310","3L",12778750,12781097,2347
"7256","FBgn0261373","2R",24668411,24669330,919
"7257","FBgn0083990","4",975168,977261,2093
"7258","FBgn0005695","2R",8724258,8728999,4741
"7259","FBgn0263868","2L",5433676,5434236,560
"7260","FBgn0026323","X",20515908,20524928,9020
"7261","FBgn0034683","2R",22056467,22057681,1214
"7262","FBgn0265900","3L",22898191,22898580,389
"7263","FBgn0003261","3R",6000426,6008579,8153
"7264","FBgn0053110","3R",22570188,22580392,10204
"7265","FBgn0086056","3R",11222841,11222924,83
"7266","FBgn0032966","2L",21902993,21903739,746
"7267","FBgn0033927","2R",14360433,14361780,1347
"7268","FBgn0266395","3L",22225520,22225878,358
"7269","FBgn0034356","2R",18527430,18535749,8319
"7270","FBgn0052039","3L",9358999,9359996,997
"7271","FBgn0032222","2L",10331471,10333129,1658
"7272","FBgn0033224","2R",7800785,7806385,5600
"7273","FBgn0065084","X",19301703,19301873,170
"7274","FBgn0266349","X",15334478,15335971,1493
"7275","FBgn0015829","3L",4287038,4288349,1311
"7276","FBgn0052602","X",14277735,14288161,10426
"7277","FBgn0267208","3R",22724348,22724678,330
"7278","FBgn0002566","2L",22924795,22943135,18340
"7279","FBgn0034105","2R",16281630,16282946,1316
"7280","FBgn0027615","3L",10884261,10886471,2210
"7281","FBgn0250868","2R",17572829,17573330,501
"7282","FBgn0026076","X",15849731,15853175,3444
"7283","FBgn0046756","3R",31767973,31769423,1450
"7284","FBgn0004087","3R",16481167,16481878,711
"7285","FBgn0267029","X",140973,142197,1224
"7286","FBgn0266152","2L",14761972,14762691,719
"7287","FBgn0052462","3L",22852270,22853512,1242
"7288","FBgn0265163","3R",12767627,12768357,730
"7289","FBgn0020269","2R",14671396,14713622,42226
"7290","FBgn0267919","3L",901888,902396,508
"7291","FBgn0004569","3L",16470386,16483650,13264
"7292","FBgn0285955","3R",14391683,14481713,90030
"7293","FBgn0033058","2R",6050949,6068680,17731
"7294","FBgn0031981","2L",8043471,8054326,10855
"7295","FBgn0037171","3L",22573114,22637916,64802
"7296","FBgn0265180","2R",21200483,21212969,12486
"7297","FBgn0051776","2L",3470182,3472364,2182
"7298","FBgn0001091","2R",7791901,7793380,1479
"7299","FBgn0030878","X",17861002,17862775,1773
"7300","FBgn0265584","2L",17588203,17588720,517
"7301","FBgn0082944","3L",1666437,1666522,85
"7302","FBgn0262824","2R",19944263,19945877,1614
"7303","FBgn0264448","2L",6004167,6006333,2166
"7304","FBgn0085426","2R",21255165,21280995,25830
"7305","FBgn0037819","3R",10677737,10680925,3188
"7306","FBgn0035422","3L",3220911,3222960,2049
"7307","FBgn0036656","3L",16724678,16726169,1491
"7308","FBgn0002931","2L",82421,87387,4966
"7309","FBgn0020312","2R",21123735,21128510,4775
"7310","FBgn0003187","2L",17486806,17497208,10402
"7311","FBgn0031639","2L",4849439,4850419,980
"7312","FBgn0063499","2R",18396638,18398519,1881
"7313","FBgn0265051","2R",6841545,6842094,549
"7314","FBgn0004779","3R",6690887,6691758,871
"7315","FBgn0085204","2L",3398023,3398684,661
"7316","FBgn0020622","2L",297880,305233,7353
"7317","FBgn0035797","3L",7555780,7560037,4257
"7318","FBgn0263329","2L",13632676,13633166,490
"7319","FBgn0035537","3L",4366494,4367458,964
"7320","FBgn0026257","3R",24221103,24223528,2425
"7321","FBgn0266705","3R",10876834,10877783,949
"7322","FBgn0032047","2L",8488981,8490546,1565
"7323","FBgn0036663","3L",16787573,16807731,20158
"7324","FBgn0011305","2L",10261795,10263554,1759
"7325","FBgn0264573","3L",20729274,20729656,382
"7326","FBgn0284228","X",15987166,15991974,4808
"7327","FBgn0266153","2L",15396334,15396934,600
"7328","FBgn0267573","2L",13745448,13747888,2440
"7329","FBgn0283626","3R",7318039,7318803,764
"7330","FBgn0266195","3R",18255530,18257677,2147
"7331","FBgn0267027","2R",4730481,4731395,914
"7332","FBgn0261396","2L",19051790,19053681,1891
"7333","FBgn0266802","2R",12179014,12179745,731
"7334","FBgn0259848","Y",1037852,1038828,976
"7335","FBgn0264340","2L",8482374,8483005,631
"7336","FBgn0035253","3L",1654247,1665064,10817
"7337","FBgn0085453","2R",23359215,23360266,1051
"7338","FBgn0037573","3R",8313208,8314864,1656
"7339","FBgn0052482","3L",743723,743794,71
"7340","FBgn0266835","2L",4811711,4811945,234
"7341","FBgn0039584","3R",28418208,28474814,56606
"7342","FBgn0037384","3R",5824615,5826576,1961
"7343","FBgn0265883","3L",18475298,18475679,381
"7344","FBgn0031999","2L",8206171,8209637,3466
"7345","FBgn0027948","3R",16050801,16060675,9874
"7346","FBgn0004780","3R",6692732,6693527,795
"7347","FBgn0034345","2R",18421413,18426221,4808
"7348","FBgn0052360","3L",8060674,8060756,82
"7349","FBgn0267181","X",12612108,12615780,3672
"7350","FBgn0267079","X",15691672,15692597,925
"7351","FBgn0261286","3R",16268329,16272415,4086
"7352","FBgn0011739","3R",30789625,30806619,16994
"7353","FBgn0038470","3R",17036394,17040203,3809
"7354","FBgn0015576","3R",7509343,7515670,6327
"7355","FBgn0002069","2R",12877004,12883168,6164
"7356","FBgn0038100","3R",12980792,12985488,4696
"7357","FBgn0029524","X",481862,482768,906
"7358","FBgn0030301","X",11454786,11459227,4441
"7359","FBgn0283680","X",13303633,13329303,25670
"7360","FBgn0264426","3R",21889539,21890171,632
"7361","FBgn0039694","3R",29779273,29780452,1179
"7362","FBgn0016691","3R",15265591,15266690,1099
"7363","FBgn0267695","3L",14424501,14425926,1425
"7364","FBgn0033454","2R",9848061,9850642,2581
"7365","FBgn0034498","2R",20281629,20287094,5465
"7366","FBgn0001258","3L",6259105,6262694,3589
"7367","FBgn0035344","3L",2476259,2478448,2189
"7368","FBgn0030345","X",11869170,11871168,1998
"7369","FBgn0263328","2L",11290632,11291077,445
"7370","FBgn0036264","3L",12197791,12199030,1239
"7371","FBgn0052100","3L",12267528,12269803,2275
"7372","FBgn0010387","3L",7131863,7133463,1600
"7373","FBgn0028475","3R",23754623,23758557,3934
"7374","FBgn0030066","X",8898554,8900264,1710
"7375","FBgn0037687","3R",9401495,9402618,1123
"7376","FBgn0043854","2L",6372388,6377284,4896
"7377","FBgn0261686","2R",10356171,10356800,629
"7378","FBgn0266025","2L",2598608,2599860,1252
"7379","FBgn0264085","2L",2283705,2285003,1298
"7380","FBgn0043884","3R",24230562,24250248,19686
"7381","FBgn0038943","3R",22333088,22334150,1062
"7382","FBgn0023489","2L",577486,579549,2063
"7383","FBgn0266074","2R",24237477,24238477,1000
"7384","FBgn0264473","3L",4755605,4756142,537
"7385","FBgn0266775","3L",15747403,15748699,1296
"7386","FBgn0034706","2R",22179695,22182642,2947
"7387","FBgn0020508","X",14782962,14784052,1090
"7388","FBgn0041156","3L",7948186,7951563,3377
"7389","FBgn0265380","3R",26260902,26261515,613
"7390","FBgn0263212","X",19944198,19944417,219
"7391","FBgn0262587","3R",28263871,28264773,902
"7392","FBgn0032637","2L",17452924,17458775,5851
"7393","FBgn0050286","2R",21535716,21536795,1079
"7394","FBgn0031758","2L",5969859,5971025,1166
"7395","FBgn0036747","3L",17723718,17729244,5526
"7396","FBgn0037949","3R",11781131,11787014,5883
"7397","FBgn0038416","3R",16327849,16329622,1773
"7398","FBgn0028562","2R",8087396,8089297,1901
"7399","FBgn0266574","2R",11405232,11405303,71
"7400","FBgn0051862","2L",12338848,12339477,629
"7401","FBgn0262960","2L",17914365,17915023,658
"7402","FBgn0086254","3L",11620535,11624381,3846
"7403","FBgn0266786","3L",11349395,11349743,348
"7404","FBgn0031108","X",20412341,20413581,1240
"7405","FBgn0034606","2R",21217856,21251150,33294
"7406","FBgn0085505","Y",1122988,1123872,884
"7407","FBgn0036590","3L",16277435,16278180,745
"7408","FBgn0031437","2L",2580292,2581423,1131
"7409","FBgn0011837","X",12659415,12682554,23139
"7410","FBgn0029799","X",5752249,5754041,1792
"7411","FBgn0039411","3R",26076592,26098711,22119
"7412","FBgn0051788","2L",18257494,18257978,484
"7413","FBgn0051611","2L",21424593,21425005,412
"7414","FBgn0026189","3L",3114450,3127724,13274
"7415","FBgn0051472","3R",7810532,7811912,1380
"7416","FBgn0260812","X",11724668,11729099,4431
"7417","FBgn0265205","3R",21223623,21224589,966
"7418","FBgn0032404","2L",12056326,12058251,1925
"7419","FBgn0038376","3R",15853868,15857470,3602
"7420","FBgn0051265","3R",17128212,17129120,908
"7421","FBgn0030026","X",8241501,8244016,2515
"7422","FBgn0035676","3L",6076722,6082491,5769
"7423","FBgn0034611","2R",21282298,21285679,3381
"7424","FBgn0035384","3L",2995172,2996155,983
"7425","FBgn0050083","2R",15711597,15712644,1047
"7426","FBgn0262879","2L",20476711,20478920,2209
"7427","FBgn0016984","2R",20827282,20836028,8746
"7428","FBgn0039902","4",310930,314087,3157
"7429","FBgn0038665","3R",18978273,18978809,536
"7430","FBgn0041205","2R",24785514,24787411,1897
"7431","FBgn0035140","3L",540851,542147,1296
"7432","FBgn0266410","3R",9340216,9362994,22778
"7433","FBgn0032763","2L",19179749,19181702,1953
"7434","FBgn0037972","3R",11975156,11977197,2041
"7435","FBgn0034900","2R",23750646,23751225,579
"7436","FBgn0039374","3R",25811911,25813134,1223
"7437","FBgn0015247","2R",15932170,15934825,2655
"7438","FBgn0004644","3R",23128169,23141906,13737
"7439","FBgn0020653","X",8242528,8248033,5505
"7440","FBgn0086906","3L",2039681,2115611,75930
"7441","FBgn0003942","2L",10408352,10410456,2104
"7442","FBgn0010488","2R",12915994,12923734,7740
"7443","FBgn0262574","2R",11310831,11311165,334
"7444","FBgn0263398","3R",24290172,24293371,3199
"7445","FBgn0032773","2L",19383138,19386205,3067
"7446","FBgn0034800","2R",22932035,22934077,2042
"7447","FBgn0051081","3R",26634885,26635998,1113
"7448","FBgn0267130","3R",30404429,30404989,560
"7449","FBgn0022213","2L",16821156,16825207,4051
"7450","FBgn0262848","X",11595655,11597545,1890
"7451","FBgn0045073","X",15934495,15940451,5956
"7452","FBgn0037279","3R",4811444,4816025,4581
"7453","FBgn0283472","3L",5797549,5810931,13382
"7454","FBgn0036832","3L",18919224,18920319,1095
"7455","FBgn0030562","X",14288084,14289393,1309
"7456","FBgn0026179","3L",21034535,21075444,40909
"7457","FBgn0037374","3R",5779315,5781308,1993
"7458","FBgn0042085","2R",6636512,6642358,5846
"7459","FBgn0053896","2L",21467375,21467969,594
"7460","FBgn0260965","3L",12814254,12824650,10396
"7461","FBgn0037826","3R",10709588,10711248,1660
"7462","FBgn0259855","Y",2593622,2595311,1689
"7463","FBgn0267203","3R",16223395,16223854,459
"7464","FBgn0050035","2R",11665768,11674782,9014
"7465","FBgn0050323","2R",17853295,17854296,1001
"7466","FBgn0035505","3L",4178980,4188023,9043
"7467","FBgn0039972","2L",22308755,22368796,60041
"7468","FBgn0044812","3R",20872988,20873580,592
"7469","FBgn0039851","3R",31499235,31506992,7757
"7470","FBgn0011999","3R",7451297,7451369,72
"7471","FBgn0053977","3R",13402559,13403051,492
"7472","FBgn0035151","3L",677879,680326,2447
"7473","FBgn0267636","3L",18303431,18304179,748
"7474","FBgn0037172","3L",22606369,22607126,757
"7475","FBgn0036046","3L",9799698,9800440,742
"7476","FBgn0033206","2R",7667248,7669029,1781
"7477","FBgn0266745","3R",15290309,15290799,490
"7478","FBgn0267053","X",19931714,19932342,628
"7479","FBgn0039479","3R",27075870,27082818,6948
"7480","FBgn0014903","X",1031496,1033165,1669
"7481","FBgn0037250","3R",4433965,4436175,2210
"7482","FBgn0085489","2R",16826872,16827755,883
"7483","FBgn0039654","3R",29223485,29226276,2791
"7484","FBgn0010287","2L",8072895,8073948,1053
"7485","FBgn0263626","3R",5045207,5045948,741
"7486","FBgn0033439","2R",9706267,9707580,1313
"7487","FBgn0085290","3L",21196831,21197738,907
"7488","FBgn0085327","3R",29999795,30000403,608
"7489","FBgn0035673","3L",6072139,6073539,1400
"7490","FBgn0035204","3L",1304850,1307418,2568
"7491","FBgn0040968","2L",11842828,11844012,1184
"7492","FBgn0262948","2R",7404035,7404441,406
"7493","FBgn0033052","2R",6026273,6036388,10115
"7494","FBgn0003975","2R",12884632,12899385,14753
"7495","FBgn0044872","X",23008766,23011303,2537
"7496","FBgn0028887","2L",14924590,14930565,5975
"7497","FBgn0264618","4",557025,557854,829
"7498","FBgn0034517","2R",20548368,20550117,1749
"7499","FBgn0265810","2L",13384822,13385403,581
"7500","FBgn0266813","2R",17585692,17586243,551
"7501","FBgn0032416","2L",12138008,12140392,2384
"7502","FBgn0036138","3L",11134987,11135480,493
"7503","FBgn0033598","2R",11255167,11255983,816
"7504","FBgn0043457","3R",20557930,20559760,1830
"7505","FBgn0035693","3L",6200473,6203776,3303
"7506","FBgn0063649","3R",16154982,16171766,16784
"7507","FBgn0034529","2R",20623547,20628315,4768
"7508","FBgn0265826","2L",9124032,9124500,468
"7509","FBgn0267278","X",18480072,18481132,1060
"7510","FBgn0029946","X",7346259,7347506,1247
"7511","FBgn0033491","2R",10142338,10146206,3868
"7512","FBgn0034758","2R",22657901,22661389,3488
"7513","FBgn0266141","2L",13784713,13785423,710
"7514","FBgn0030321","X",11611927,11615128,3201
"7515","FBgn0028516","2L",15228728,15247714,18986
"7516","FBgn0032018","2L",8311399,8317011,5612
"7517","FBgn0030718","X",15985473,15986808,1335
"7518","FBgn0263114","2R",17034045,17034609,564
"7519","FBgn0266688","3L",13557755,13558101,346
"7520","FBgn0037696","3R",9455517,9456546,1029
"7521","FBgn0030761","X",16595136,16599215,4079
"7522","FBgn0266885","2L",1214649,1215293,644
"7523","FBgn0262881","2R",14638538,14638935,397
"7524","FBgn0032409","2L",12097838,12100839,3001
"7525","FBgn0051855","2L",13369204,13370329,1125
"7526","FBgn0267939","3R",30715125,30716848,1723
"7527","FBgn0262583","2R",7402757,7403870,1113
"7528","FBgn0015574","3R",7524567,7528777,4210
"7529","FBgn0052111","3L",12627934,12648280,20346
"7530","FBgn0037379","3R",5794705,5799994,5289
"7531","FBgn0054051","2L",19960069,19961030,961
"7532","FBgn0034400","2R",18836821,18846619,9798
"7533","FBgn0037632","3R",8801564,8806234,4670
"7534","FBgn0038140","3R",13338330,13345106,6776
"7535","FBgn0011817","3L",7979046,8054147,75101
"7536","FBgn0033683","2R",12138695,12139324,629
"7537","FBgn0015570","3R",7541810,7545230,3420
"7538","FBgn0275433","3R",18719623,18719998,375
"7539","FBgn0267725","3R",15402982,15403707,725
"7540","FBgn0266811","2R",17131045,17131552,507
"7541","FBgn0267966","3L",9597171,9598375,1204
"7542","FBgn0004372","3L",3024129,3026521,2392
"7543","FBgn0026064","3R",11346294,11353131,6837
"7544","FBgn0063377","2R",17699932,17700004,72
"7545","FBgn0052160","3L",16308940,16311318,2378
"7546","FBgn0037620","3R",8728367,8729693,1326
"7547","FBgn0263618","3L",4929295,4931138,1843
"7548","FBgn0262406","2L",18472034,18472111,77
"7549","FBgn0040092","2R",9815510,9816600,1090
"7550","FBgn0050390","2R",21292239,21293646,1407
"7551","FBgn0036236","3L",11990736,11992000,1264
"7552","FBgn0013685","mitochondrion_genome",9971,10495,524
"7553","FBgn0014857","2L",5055058,5056149,1091
"7554","FBgn0026084","X",4106113,4110981,4868
"7555","FBgn0051647","2L",5435582,5439277,3695
"7556","FBgn0005642","3R",28807983,28811337,3354
"7557","FBgn0031257","2L",455531,458745,3214
"7558","FBgn0267787","3R",31345139,31345746,607
"7559","FBgn0033741","2R",12468651,12471722,3071
"7560","FBgn0028926","2L",15007813,15008538,725
"7561","FBgn0030675","X",15732178,15733663,1485
"7562","FBgn0267542","3L",11668211,11668877,666
"7563","FBgn0085444","2R",16948296,16955266,6970
"7564","FBgn0000416","3R",30883464,30889062,5598
"7565","FBgn0036440","3L",14697313,14701678,4365
"7566","FBgn0054011","2L",5716701,5718067,1366
"7567","FBgn0000592","3L",12188818,12190705,1887
"7568","FBgn0028734","3R",10101420,10110121,8701
"7569","FBgn0265662","X",790284,790566,282
"7570","FBgn0265890","3L",20104503,20105544,1041
"7571","FBgn0264309","X",19957548,19958342,794
"7572","FBgn0035957","3L",9047439,9048724,1285
"7573","FBgn0011771","3L",22284354,22288195,3841
"7574","FBgn0262170","2R",19587372,19587763,391
"7575","FBgn0037650","3R",8997697,8998678,981
"7576","FBgn0262200","2L",5641298,5641389,91
"7577","FBgn0052354","3L",8415857,8422205,6348
"7578","FBgn0266590","3L",6865449,6866439,990
"7579","FBgn0265786","2L",5809702,5810216,514
"7580","FBgn0085235","2R",22163738,22164594,856
"7581","FBgn0026259","3L",3428658,3460977,32319
"7582","FBgn0053853","2L",21518655,21519147,492
"7583","FBgn0030595","X",14909873,14910845,972
"7584","FBgn0034139","2R",16572082,16574154,2072
"7585","FBgn0013725","2R",14427336,14432337,5001
"7586","FBgn0039776","3R",30466050,30485799,19749
"7587","FBgn0010282","3R",6380467,6382604,2137
"7588","FBgn0037579","3R",8343669,8344310,641
"7589","FBgn0262412","2R",10885533,10885589,56
"7590","FBgn0265254","2L",23173073,23173465,392
"7591","FBgn0262260","3L",3412145,3412251,106
"7592","FBgn0264787","3R",6408978,6409578,600
"7593","FBgn0034291","2R",18044046,18045073,1027
"7594","FBgn0085260","2R",11986008,11987653,1645
"7595","FBgn0083036","2L",20418834,20418967,133
"7596","FBgn0020518","3L",22869545,22869622,77
"7597","FBgn0036985","3L",20413604,20424309,10705
"7598","FBgn0263774","2R",13389495,13393361,3866
"7599","FBgn0026252","3L",8116179,8121579,5400
"7600","FBgn0085311","3R",18695252,18695995,743
"7601","FBgn0011944","3R",17618110,17618181,71
"7602","FBgn0031589","2L",4189340,4198071,8731
"7603","FBgn0032719","2L",18845184,18855110,9926
"7604","FBgn0053849","2L",21511728,21512750,1022
"7605","FBgn0264435","2L",15119783,15120819,1036
"7606","FBgn0034476","2R",19826578,19832973,6395
"7607","FBgn0030742","X",16328437,16330759,2322
"7608","FBgn0260997","3L",26354140,26371356,17216
"7609","FBgn0263770","2R",18401846,18402297,451
"7610","FBgn0010786","3L",1334889,1339415,4526
"7611","FBgn0038325","3R",15353720,15356924,3204
"7612","FBgn0038281","3R",15037366,15038149,783
"7613","FBgn0259230","2L",2036409,2037265,856
"7614","FBgn0050222","2R",21583492,21585368,1876
"7615","FBgn0259841","Y",1016352,1017835,1483
"7616","FBgn0036889","3L",19589072,19590524,1452
"7617","FBgn0050267","2R",22756165,22758995,2830
"7618","FBgn0037731","3R",9685760,9687141,1381
"7619","FBgn0064119","3R",20042757,20048716,5959
"7620","FBgn0263377","2R",15682569,15684933,2364
"7621","FBgn0054003","2L",13967464,13967985,521
"7622","FBgn0052187","3L",17804916,17806365,1449
"7623","FBgn0035845","3L",8160315,8165518,5203
"7624","FBgn0013672","mitochondrion_genome",4062,4736,674
"7625","FBgn0250815","3L",6039155,6040135,980
"7626","FBgn0052361","3L",8065643,8065725,82
"7627","FBgn0260225","X",3793464,3794660,1196
"7628","FBgn0031694","2L",5266392,5268455,2063
"7629","FBgn0035640","3L",5812135,5813093,958
"7630","FBgn0033113","2R",6880995,6883407,2412
"7631","FBgn0024285","2L",9912911,9915044,2133
"7632","FBgn0034472","2R",19714076,19714868,792
"7633","FBgn0038890","3R",21520928,21528598,7670
"7634","FBgn0052847","3L",15121572,15122301,729
"7635","FBgn0040238","3R",10161464,10170487,9023
"7636","FBgn0284221","3L",12067511,12081830,14319
"7637","FBgn0082953","3L",9429374,9429518,144
"7638","FBgn0266598","3R",8000548,8001309,761
"7639","FBgn0286036","3R",4639789,4640004,215
"7640","FBgn0263449","3R",16168348,16169154,806
"7641","FBgn0010830","3L",22738602,22741388,2786
"7642","FBgn0004567","2L",3836840,3839185,2345
"7643","FBgn0011361","3L",1329949,1331631,1682
"7644","FBgn0030969","X",18858203,18860072,1869
"7645","FBgn0034990","2R",24202091,24208203,6112
"7646","FBgn0032434","2L",12446080,12448132,2052
"7647","FBgn0015575","3R",7519563,7523753,4190
"7648","FBgn0033770","2R",12700081,12700851,770
"7649","FBgn0033813","2R",13230583,13231663,1080
"7650","FBgn0031697","2L",5311311,5314895,3584
"7651","FBgn0033955","2R",14668391,14671675,3284
"7652","FBgn0051213","3R",19972898,19979569,6671
"7653","FBgn0037415","3R",6255175,6256602,1427
"7654","FBgn0032586","2L",16491540,16507621,16081
"7655","FBgn0033897","2R",14148263,14153123,4860
"7656","FBgn0033031","2R",5668383,5669986,1603
"7657","FBgn0032377","2L",11792412,11794086,1674
"7658","FBgn0261974","2R",24186062,24186152,90
"7659","FBgn0026533","2R",16856220,16861738,5518
"7660","FBgn0037773","3R",9999771,10001276,1505
"7661","FBgn0053798","2R",12993897,12994622,725
"7662","FBgn0039201","3R",24515278,24518128,2850
"7663","FBgn0003514","X",6223061,6225140,2079
"7664","FBgn0020646","3L",6148353,6148615,262
"7665","FBgn0033911","2R",14198478,14201249,2771
"7666","FBgn0267782","3R",30272762,30273555,793
"7667","FBgn0031902","2L",7333714,7352542,18828
"7668","FBgn0035875","3L",8336672,8338595,1923
"7669","FBgn0036494","3L",15336692,15344315,7623
"7670","FBgn0039461","3R",26876630,26880459,3829
"7671","FBgn0036831","3L",18917581,18919259,1678
"7672","FBgn0053380","2R",19756141,19756275,134
"7673","FBgn0015286","X",3704610,3719635,15025
"7674","FBgn0083013","X",6742852,6743001,149
"7675","FBgn0035056","2R",24757378,24760466,3088
"7676","FBgn0261556","3L",20149614,20198317,48703
"7677","FBgn0002525","2L",5542480,5546642,4162
"7678","FBgn0032072","2L",8866767,8867686,919
"7679","FBgn0010408","3L",9509793,9511531,1738
"7680","FBgn0031378","2L",1981176,1982099,923
"7681","FBgn0265546","2L",17245856,17246617,761
"7682","FBgn0051451","3R",23983503,23985065,1562
"7683","FBgn0004784","2R",16898535,16901575,3040
"7684","FBgn0050365","2R",8359466,8362156,2690
"7685","FBgn0261837","3R",21360176,21362131,1955
"7686","FBgn0036553","3L",15980100,15981888,1788
"7687","FBgn0263613","2R",15049775,15050355,580
"7688","FBgn0035508","3L",4200825,4204339,3514
"7689","FBgn0015032","3R",30894038,30900688,6650
"7690","FBgn0024987","X",1370580,1375257,4677
"7691","FBgn0000276","3R",30210874,30211273,399
"7692","FBgn0263658","2L",608340,609134,794
"7693","FBgn0259977","2R",6677001,6680391,3390
"7694","FBgn0031602","2L",4403992,4441282,37290
"7695","FBgn0035295","3L",1947565,1950262,2697
"7696","FBgn0260229","3R",25125632,25127359,1727
"7697","FBgn0086533","3L",27267954,27268023,69
"7698","FBgn0033069","2R",6200853,6201956,1103
"7699","FBgn0035255","3L",1668901,1670108,1207
"7700","FBgn0266200","X",6744879,6746423,1544
"7701","FBgn0015402","3R",5478390,5483906,5516
"7702","FBgn0036698","3L",17055613,17058533,2920
"7703","FBgn0037477","3R",7143729,7144295,566
"7704","FBgn0029552","X",1012035,1012624,589
"7705","FBgn0015075","3L",22263369,22266017,2648
"7706","FBgn0052026","3L",8836462,8838843,2381
"7707","FBgn0037684","3R",9365398,9367763,2365
"7708","FBgn0040801","3L",16259037,16259722,685
"7709","FBgn0030647","X",15476091,15481722,5631
"7710","FBgn0003475","2L",20311219,20348386,37167
"7711","FBgn0031431","2L",2551145,2552825,1680
"7712","FBgn0040732","2R",19500295,19501418,1123
"7713","FBgn0031312","2L",1158661,1160220,1559
"7714","FBgn0038047","3R",12429560,12431235,1675
"7715","FBgn0267984","3L",12806687,12808545,1858
"7716","FBgn0265835","2R",20234995,20235345,350
"7717","FBgn0013987","X",5759908,5764203,4295
"7718","FBgn0035933","3L",8810395,8811265,870
"7719","FBgn0038727","3R",19665007,19670827,5820
"7720","FBgn0053879","2L",21509422,21509834,412
"7721","FBgn0032863","2L",20459342,20461729,2387
"7722","FBgn0035260","3L",1674709,1715541,40832
"7723","FBgn0030830","X",17221442,17222651,1209
"7724","FBgn0033987","2R",14963292,14980795,17503
"7725","FBgn0261053","3R",10827079,10849030,21951
"7726","FBgn0031357","2L",1710462,1711465,1003
"7727","FBgn0267527","3L",8055801,8056208,407
"7728","FBgn0261848","X",7331265,7332191,926
"7729","FBgn0003867","3R",21778114,21782536,4422
"7730","FBgn0034755","2R",22648995,22649750,755
"7731","FBgn0028360","X",6654541,6659709,5168
"7732","FBgn0004190","3R",24557215,24557321,106
"7733","FBgn0263973","3L",6563197,6589479,26282
"7734","FBgn0040298","3L",5777476,5779591,2115
"7735","FBgn0052633","X",13561671,13563359,1688
"7736","FBgn0039008","3R",22702007,22704338,2331
"7737","FBgn0035916","3L",8622039,8623901,1862
"7738","FBgn0037395","3R",6010573,6011932,1359
"7739","FBgn0053422","2R",19740664,19740798,134
"7740","FBgn0085459","2R",7943442,7944475,1033
"7741","FBgn0033934","2R",14409295,14411572,2277
"7742","FBgn0262986","3L",11958291,11958909,618
"7743","FBgn0262000","2L",16241939,16245559,3620
"7744","FBgn0266690","3L",25708177,25709251,1074
"7745","FBgn0259918","X",11724668,11732770,8102
"7746","FBgn0065102","2R",21335510,21335544,34
"7747","FBgn0053543","2L",1997102,2006313,9211
"7748","FBgn0033889","2R",13972984,13980165,7181
"7749","FBgn0263560","2L",10840345,10840476,131
"7750","FBgn0003938","3L",3090801,3090923,122
"7751","FBgn0032879","2L",20727151,20730282,3131
"7752","FBgn0265945","2L",14428612,14430822,2210
"7753","FBgn0001092","X",15868145,15869661,1516
"7754","FBgn0016081","3L",9631834,9679103,47269
"7755","FBgn0031693","2L",5264001,5265899,1898
"7756","FBgn0030798","X",16844807,16876544,31737
"7757","FBgn0263470","3L",259970,260280,310
"7758","FBgn0036659","3L",16733546,16739364,5818
"7759","FBgn0035227","3L",1523414,1534034,10620
"7760","FBgn0053428","2R",19738452,19738586,134
"7761","FBgn0261839","3R",21365609,21368279,2670
"7762","FBgn0035551","3L",4480283,4481487,1204
"7763","FBgn0037235","3R",4337755,4339914,2159
"7764","FBgn0265625","2R",18684230,18686775,2545
"7765","FBgn0085790","Y",3026761,3028019,1258
"7766","FBgn0036441","3L",14705464,14706157,693
"7767","FBgn0036599","3L",16302490,16303178,688
"7768","FBgn0083992","3L",182522,184540,2018
"7769","FBgn0039030","3R",22923352,22924525,1173
"7770","FBgn0033998","2R",15206527,15213634,7107
"7771","FBgn0085206","2L",4433908,4435057,1149
"7772","FBgn0036446","3L",14762028,14767703,5675
"7773","FBgn0035149","3L",652987,654089,1102
"7774","FBgn0028517","2L",15670174,15671223,1049
"7775","FBgn0004618","3R",18367927,18372738,4811
"7776","FBgn0035267","3L",1746907,1752390,5483
"7777","FBgn0052082","3L",11136049,11163984,27935
"7778","FBgn0261854","2R",14944458,14962969,18511
"7779","FBgn0052667","X",11139762,11140263,501
"7780","FBgn0053871","2L",21529242,21529769,527
"7781","FBgn0085385","3L",9908120,9967298,59178
"7782","FBgn0003248","3R",18899423,18901019,1596
"7783","FBgn0002938","2L",7377702,7384344,6642
"7784","FBgn0052819","X",21617889,21621104,3215
"7785","FBgn0040395","X",2080610,2093948,13338
"7786","FBgn0265902","X",17828096,17831094,2998
"7787","FBgn0264903","3R",14576331,14576611,280
"7788","FBgn0031844","2L",6662061,6663612,1551
"7789","FBgn0014427","3R",29200454,29201770,1316
"7790","FBgn0031968","2L",7983946,7986785,2839
"7791","FBgn0003034","3L",13301635,13301922,287
"7792","FBgn0038214","3R",14244804,14245471,667
"7793","FBgn0051703","2L",22102626,22104401,1775
"7794","FBgn0263841","3L",21298675,21299063,388
"7795","FBgn0038079","3R",12695129,12697379,2250
"7796","FBgn0042146","X",990518,991184,666
"7797","FBgn0265414","2L",6985961,6986750,789
"7798","FBgn0037501","3R",7406869,7409384,2515
"7799","FBgn0035977","3L",9349609,9351489,1880
"7800","FBgn0002921","3R",20948714,20976239,27525
"7801","FBgn0042102","3R",7783843,7786119,2276
"7802","FBgn0039705","3R",29827281,29835101,7820
"7803","FBgn0015793","3L",8297018,8298506,1488
"7804","FBgn0085396","2L",10347851,10353905,6054
"7805","FBgn0003149","3L",8732858,8745310,12452
"7806","FBgn0026679","X",8555239,8558781,3542
"7807","FBgn0010265","2L",8363477,8364662,1185
"7808","FBgn0267312","3L",12889352,12889638,286
"7809","FBgn0038568","3R",18158701,18159471,770
"7810","FBgn0261041","2R",13805794,13819571,13777
"7811","FBgn0267803","3R",7537842,7541279,3437
"7812","FBgn0265614","2R",19258895,19259745,850
"7813","FBgn0053198","2R",18277439,18278762,1323
"7814","FBgn0033233","2R",7922775,7924988,2213
"7815","FBgn0267686","3R",14528386,14529056,670
"7816","FBgn0004926","3L",12525093,12526731,1638
"7817","FBgn0063386","2R",17703102,17703168,66
"7818","FBgn0266971","3L",3891646,3891963,317
"7819","FBgn0267578","2R",9310329,9313237,2908
"7820","FBgn0267923","2L",17450494,17452384,1890
"7821","FBgn0042199","3L",4697601,4698058,457
"7822","FBgn0037140","3L",21934704,21938636,3932
"7823","FBgn0038150","3R",13403423,13404870,1447
"7824","FBgn0030477","X",13368191,13370472,2281
"7825","FBgn0052441","3L",21574131,21575874,1743
"7826","FBgn0037188","3L",22741793,22748614,6821
"7827","FBgn0267495","X",10044909,10048156,3247
"7828","FBgn0263555","2L",16528375,16528491,116
"7829","FBgn0037556","3R",8240747,8243792,3045
"7830","FBgn0032833","2L",19958713,19960065,1352
"7831","FBgn0039261","3R",25033876,25039249,5373
"7832","FBgn0039366","3R",25773334,25775369,2035
"7833","FBgn0262990","X",4001210,4001607,397
"7834","FBgn0037294","3R",5159612,5160901,1289
"7835","FBgn0038290","3R",15135138,15137004,1866
"7836","FBgn0050289","2R",21520413,21521848,1435
"7837","FBgn0034128","2R",16443211,16444845,1634
"7838","FBgn0264296","2L",4008653,4009090,437
"7839","FBgn0263598","2L",12974322,12978607,4285
"7840","FBgn0267007","2L",3851951,3852604,653
"7841","FBgn0283501","3R",30697380,30704118,6738
"7842","FBgn0033166","2R",7396850,7407819,10969
"7843","FBgn0052262","3L",3809146,3810196,1050
"7844","FBgn0051010","3R",30704762,30706121,1359
"7845","FBgn0039648","3R",29197556,29199211,1655
"7846","FBgn0085234","2R",22130112,22131299,1187
"7847","FBgn0035104","3L",179923,182535,2612
"7848","FBgn0039107","3R",23711527,23713313,1786
"7849","FBgn0036015","3L",9600490,9601325,835
"7850","FBgn0263402","3R",30237094,30237734,640
"7851","FBgn0033038","2R",5758065,5760407,2342
"7852","FBgn0034901","2R",23751915,23752495,580
"7853","FBgn0265764","2R",19860195,19860695,500
"7854","FBgn0037671","3R",9260638,9262590,1952
"7855","FBgn0037236","3R",4334879,4337674,2795
"7856","FBgn0037714","3R",9570414,9571623,1209
"7857","FBgn0030949","X",18709865,18711638,1773
"7858","FBgn0028836","2R",8421033,8428577,7544
"7859","FBgn0010417","3L",19599088,19601382,2294
"7860","FBgn0052452","3L",22717728,22719943,2215
"7861","FBgn0053255","3L",19423758,19424146,388
"7862","FBgn0039802","3R",30807117,30807978,861
"7863","FBgn0029906","X",6821016,6822840,1824
"7864","FBgn0037167","3L",22474795,22475792,997
"7865","FBgn0028482","2L",4324554,4331830,7276
"7866","FBgn0003701","2R",17861273,17865963,4690
"7867","FBgn0036929","3L",20002736,20004834,2098
"7868","FBgn0285958","3L",11518798,11522713,3915
"7869","FBgn0262434","3R",21622497,21622571,74
"7870","FBgn0039396","3R",25923499,25956270,32771
"7871","FBgn0263484","3R",5559878,5560038,160
"7872","FBgn0051028","3R",30166631,30171207,4576
"7873","FBgn0031118","X",20469955,20510694,40739
"7874","FBgn0034694","2R",22103177,22105963,2786
"7875","FBgn0052644","X",12967888,12970056,2168
"7876","FBgn0029761","X",5340236,5405138,64902
"7877","FBgn0035856","3L",8202792,8203345,553
"7878","FBgn0263441","2L",2000058,2003935,3877
"7879","FBgn0036374","3L",13502707,13511541,8834
"7880","FBgn0039846","3R",31401560,31405452,3892
"7881","FBgn0266769","3L",18196172,18196932,760
"7882","FBgn0260987","3L",27136525,27157999,21474
"7883","FBgn0003011","3R",19659748,19663672,3924
"7884","FBgn0265712","3L",5501102,5501469,367
"7885","FBgn0038880","3R",21276664,21293998,17334
"7886","FBgn0039114","3R",23763857,23766662,2805
"7887","FBgn0052364","3L",8209577,8210743,1166
"7888","FBgn0263401","3R",27440312,27440845,533
"7889","FBgn0086679","3R",8660903,8670684,9781
"7890","FBgn0010412","X",16637894,16639249,1355
"7891","FBgn0083950","3R",10972381,11050175,77794
"7892","FBgn0029726","X",4782201,4782789,588
"7893","FBgn0266101","3L",9461050,9475475,14425
"7894","FBgn0267546","3L",13379142,13379654,512
"7895","FBgn0026573","2R",11970686,11977721,7035
"7896","FBgn0035028","2R",24574559,24577676,3117
"7897","FBgn0038872","3R",21223704,21229512,5808
"7898","FBgn0267385","3R",22367536,22372746,5210
"7899","FBgn0261704","3R",30418767,30422971,4204
"7900","FBgn0039182","3R",24328455,24333316,4861
"7901","FBgn0284084","2L",7307159,7316265,9106
"7902","FBgn0034548","2R",20773687,20775364,1677
"7903","FBgn0038846","3R",21015949,21017120,1171
"7904","FBgn0284250","2R",14435899,14465881,29982
"7905","FBgn0082932","2R",24185562,24185644,82
"7906","FBgn0265788","2L",5887204,5887989,785
"7907","FBgn0027335","X",18635642,18647648,12006
"7908","FBgn0027094","2L",8378262,8381764,3502
"7909","FBgn0040773","2R",10048353,10050066,1713
"7910","FBgn0030645","X",15472164,15472859,695
"7911","FBgn0267097","X",8835306,8836724,1418
"7912","FBgn0065108","2L",9771155,9775030,3875
"7913","FBgn0266749","3R",17638778,17639627,849
"7914","FBgn0266327","2L",8703475,8705450,1975
"7915","FBgn0052248","3L",4471749,4472438,689
"7916","FBgn0266207","2L",18278653,18279475,822
"7917","FBgn0031725","2L",5601723,5617946,16223
"7918","FBgn0003159","X",2344949,2366356,21407
"7919","FBgn0030215","X",10565842,10566591,749
"7920","FBgn0053902","2L",21452211,21452805,594
"7921","FBgn0032492","2L",13232039,13233058,1019
"7922","FBgn0032120","2L",9495474,9520696,25222
"7923","FBgn0011761","X",5312171,5313125,954
"7924","FBgn0265106","2R",9788539,9791295,2756
"7925","FBgn0025808","3R",14661176,14663197,2021
"7926","FBgn0031100","X",20302015,20330372,28357
"7927","FBgn0051331","3R",13798198,13798270,72
"7928","FBgn0036156","3L",11394690,11395673,983
"7929","FBgn0004177","2L",7827650,7833576,5926
"7930","FBgn0264270","X",7074550,7098053,23503
"7931","FBgn0037655","3R",9010282,9014909,4627
"7932","FBgn0027503","3R",8984718,8990649,5931
"7933","FBgn0036300","3L",12534590,12535513,923
"7934","FBgn0033879","2R",13852947,13854331,1384
"7935","FBgn0037009","3L",20521009,20522434,1425
"7936","FBgn0038342","3R",15481906,15482904,998
"7937","FBgn0261563","2L",14263027,14328262,65235
"7938","FBgn0051109","3R",25053369,25054653,1284
"7939","FBgn0267218","3L",12289304,12290161,857
"7940","FBgn0014366","3R",5589601,5591459,1858
"7941","FBgn0266725","4",175455,175874,419
"7942","FBgn0034245","2R",17572096,17572784,688
"7943","FBgn0267694","3R",16526931,16527416,485
"7944","FBgn0263764","2L",11387870,11392320,4450
"7945","FBgn0286222","X",6678424,6681845,3421
"7946","FBgn0266439","2R",24411870,24415295,3425
"7947","FBgn0266326","2L",8403447,8403924,477
"7948","FBgn0031635","2L",4835335,4837999,2664
"7949","FBgn0036495","3L",15407832,15408267,435
"7950","FBgn0086444","2L",19123998,19126976,2978
"7951","FBgn0035431","3L",3299336,3303112,3776
"7952","FBgn0032405","2L",12063457,12066775,3318
"7953","FBgn0051632","2L",6821934,6838995,17061
"7954","FBgn0001108","3L",13929387,13934656,5269
"7955","FBgn0037186","3L",22732013,22738420,6407
"7956","FBgn0261928","3R",10225690,10251277,25587
"7957","FBgn0052189","3L",17834745,17835174,429
"7958","FBgn0032810","2L",19565863,19567359,1496
"7959","FBgn0037676","3R",9293642,9328511,34869
"7960","FBgn0004591","3L",15652537,15653096,559
"7961","FBgn0037224","3R",4247020,4248313,1293
"7962","FBgn0037025","3L",20800410,20806853,6443
"7963","FBgn0011948","X",14016203,14016275,72
"7964","FBgn0065094","3R",12362916,12362989,73
"7965","FBgn0033648","2R",11700647,11702449,1802
"7966","FBgn0058198","3R",4160610,4162235,1625
"7967","FBgn0050145","2R",20547816,20548291,475
"7968","FBgn0031688","2L",5207267,5209345,2078
"7969","FBgn0039071","3R",23288217,23290189,1972
"7970","FBgn0086032","2L",4085890,4086005,115
"7971","FBgn0266911","2L",8343320,8345015,1695
"7972","FBgn0033573","2R",10909923,10910485,562
"7973","FBgn0004197","3R",27172090,27194267,22177
"7974","FBgn0005674","3R",23952136,23958391,6255
"7975","FBgn0028878","2L",15109405,15113092,3687
"7976","FBgn0038893","3R",21661186,21662972,1786
"7977","FBgn0033451","2R",9839776,9841163,1387
"7978","FBgn0267712","3R",21102008,21102889,881
"7979","FBgn0266629","2R",10853546,10854495,949
"7980","FBgn0284255","2L",6125132,6125911,779
"7981","FBgn0259712","2L",9925161,9930378,5217
"7982","FBgn0020307","2R",22243963,22286469,42506
"7983","FBgn0051229","3R",18667852,18669083,1231
"7984","FBgn0010228","2R",21697488,21707861,10373
"7985","FBgn0002521","4",1172469,1181628,9159
"7986","FBgn0020642","3L",6144819,6145393,574
"7987","FBgn0265525","2R",16581996,16583369,1373
"7988","FBgn0002869","3R",20503102,20503746,644
"7989","FBgn0265958","2L",5387551,5388632,1081
"7990","FBgn0052476","3L",247491,250305,2814
"7991","FBgn0261534","2L",14349020,14351513,2493
"7992","FBgn0013334","3R",15935100,15962124,27024
"7993","FBgn0053829","2L",21478184,21478676,492
"7994","FBgn0263997","X",10333652,10347794,14142
"7995","FBgn0012051","2R",19425113,19430564,5451
"7996","FBgn0265815","2L",18002847,18003083,236
"7997","FBgn0034741","2R",22597245,22600695,3450
"7998","FBgn0029877","X",6589290,6590646,1356
"7999","FBgn0035644","3L",5895691,5897435,1744
"8000","FBgn0051577","3R",17657145,17657217,72
"8001","FBgn0037130","3L",21745359,21770534,25175
"8002","FBgn0038725","3R",19652369,19657866,5497
"8003","FBgn0034803","2R",22937279,22939025,1746
"8004","FBgn0026148","2L",10987806,10989241,1435
"8005","FBgn0040392","X",2324748,2326217,1469
"8006","FBgn0036670","3L",16860622,16861838,1216
"8007","FBgn0028476","3R",29229161,29235302,6141
"8008","FBgn0000014","3R",16807214,16830049,22835
"8009","FBgn0034371","2R",18640862,18658222,17360
"8010","FBgn0039308","3R",25270209,25273267,3058
"8011","FBgn0034759","2R",22657901,22661389,3488
"8012","FBgn0031398","2L",2214972,2216311,1339
"8013","FBgn0036551","3L",15976870,15978435,1565
"8014","FBgn0264504","3R",23694006,23694688,682
"8015","FBgn0032796","2L",19502335,19508764,6429
"8016","FBgn0265738","3L",10789334,10789876,542
"8017","FBgn0000927","X",2724286,2726577,2291
"8018","FBgn0033137","2R",7054405,7057548,3143
"8019","FBgn0004870","3L",1036369,1101089,64720
"8020","FBgn0265672","2L",11661690,11662172,482
"8021","FBgn0028380","3L",19294564,19298830,4266
"8022","FBgn0267123","3R",26769078,26769828,750
"8023","FBgn0030483","X",13401839,13402863,1024
"8024","FBgn0039328","3R",25329530,25331203,1673
"8025","FBgn0044871","3R",18663738,18665307,1569
"8026","FBgn0262341","X",19558895,19558991,96
"8027","FBgn0034988","2R",24195498,24197027,1529
"8028","FBgn0004957","X",18377521,18379854,2333
"8029","FBgn0052302","3L",2268825,2269903,1078
"8030","FBgn0026086","X",1773725,1788065,14340
"8031","FBgn0034284","2R",17895078,17895578,500
"8032","FBgn0032132","2L",9598880,9600872,1992
"8033","FBgn0267916","3L",15758026,15759201,1175
"8034","FBgn0267738","2L",2517205,2518845,1640
"8035","FBgn0038889","3R",21482325,21487444,5119
"8036","FBgn0010247","3R",3461351,3587054,125703
"8037","FBgn0261503","3R",6808796,6816379,7583
"8038","FBgn0262508","3L",8576808,8599617,22809
"8039","FBgn0037513","3R",7747913,7750079,2166
"8040","FBgn0051205","3R",20731631,20732707,1076
"8041","FBgn0265184","2R",22066883,22068372,1489
"8042","FBgn0037059","3L",21208148,21210084,1936
"8043","FBgn0051523","3R",4465421,4479207,13786
"8044","FBgn0030832","X",17230275,17231044,769
"8045","FBgn0039427","3R",26452534,26454585,2051
"8046","FBgn0010051","3R",5517117,5539411,22294
"8047","FBgn0039257","3R",24984384,25022867,38483
"8048","FBgn0266655","3L",21268601,21269142,541
"8049","FBgn0035959","3L",9067195,9072731,5536
"8050","FBgn0038490","3R",17150587,17151630,1043
"8051","FBgn0033954","2R",14665641,14666817,1176
"8052","FBgn0026324","2L",2767286,2767845,559
"8053","FBgn0262371","3L",15843406,15843495,89
"8054","FBgn0020258","2L",14378218,14381172,2954
"8055","FBgn0040230","3L",15826888,15832004,5116
"8056","FBgn0024963","3R",19730715,19775231,44516
"8057","FBgn0017550","3R",5607275,5613112,5837
"8058","FBgn0060291","3L",8601948,8602031,83
"8059","FBgn0003218","X",13762752,13779488,16736
"8060","FBgn0263454","3R",12225324,12226249,925
"8061","FBgn0028375","2L",16296051,16299858,3807
"8062","FBgn0052037","3L",9489502,9492215,2713
"8063","FBgn0014010","2L",2359142,2365273,6131
"8064","FBgn0267714","3L",19474731,19475642,911
"8065","FBgn0266526","2R",7737019,7782637,45618
"8066","FBgn0267733","2R",4782890,4785362,2472
"8067","FBgn0050485","2R",13849882,13852983,3101
"8068","FBgn0032834","2L",19961758,19962352,594
"8069","FBgn0029785","X",5672401,5673547,1146
"8070","FBgn0032538","2L",13932559,13934692,2133
"8071","FBgn0053499","X",20220666,20225020,4354
"8072","FBgn0266671","2R",18625249,18627718,2469
"8073","FBgn0267209","3R",24463558,24464078,520
"8074","FBgn0036620","3L",16368389,16369518,1129
"8075","FBgn0261524","X",13091145,13093986,2841
"8076","FBgn0014135","3R",19794073,19836817,42744
"8077","FBgn0030280","X",11202248,11202806,558
"8078","FBgn0012037","2L",13905645,13909212,3567
"8079","FBgn0267609","Y",346620,347145,525
"8080","FBgn0003863","2R",11344260,11345119,859
"8081","FBgn0030648","X",15482374,15486612,4238
"8082","FBgn0085357","X",18399569,18400065,496
"8083","FBgn0033449","2R",9836985,9838481,1496
"8084","FBgn0262512","2R",15679426,15680084,658
"8085","FBgn0065099","3R",7474553,7474996,443
"8086","FBgn0029848","X",6217268,6219327,2059
"8087","FBgn0037106","3L",21617623,21619873,2250
"8088","FBgn0051713","2L",9938178,9938790,612
"8089","FBgn0031534","2L",3449683,3452106,2423
"8090","FBgn0032908","2L",20929456,20934113,4657
"8091","FBgn0035033","2R",24599947,24602367,2420
"8092","FBgn0030522","X",13782459,13783381,922
"8093","FBgn0264516","3L",3972899,3973784,885
"8094","FBgn0034324","2R",18297070,18297751,681
"8095","FBgn0043825","2L",10643971,10645891,1920
"8096","FBgn0243486","2L",18012380,18070246,57866
"8097","FBgn0031988","2L",8127001,8133989,6988
"8098","FBgn0051864","2L",11995740,11996723,983
"8099","FBgn0027329","X",15746648,15748971,2323
"8100","FBgn0038302","3R",15213974,15214845,871
"8101","FBgn0243516","2R",22106107,22122562,16455
"8102","FBgn0259215","3R",20851709,20859945,8236
"8103","FBgn0011455","3L",12137496,12138584,1088
"8104","FBgn0036449","3L",14776496,14786412,9916
"8105","FBgn0053062","3L",19441719,19446444,4725
"8106","FBgn0263239","3L",3626352,3653442,27090
"8107","FBgn0029736","X",4915280,4918447,3167
"8108","FBgn0024182","X",21363028,21373145,10117
"8109","FBgn0030806","X",16941086,16942871,1785
"8110","FBgn0263981","2R",16288927,16291474,2547
"8111","FBgn0010328","3R",27256595,27264055,7460
"8112","FBgn0039430","3R",26461527,26470008,8481
"8113","FBgn0040309","X",13329824,13331994,2170
"8114","FBgn0262449","2L",19570182,19570264,82
"8115","FBgn0039749","3R",30153022,30160473,7451
"8116","FBgn0030598","X",14919252,14923493,4241
"8117","FBgn0027341","3R",4126442,4137882,11440
"8118","FBgn0265869","X",14141729,14142111,382
"8119","FBgn0038705","3R",19409175,19411265,2090
"8120","FBgn0033572","2R",10903570,10905563,1993
"8121","FBgn0039674","3R",29619065,29620758,1693
"8122","FBgn0001253","3L",8372405,8391171,18766
"8123","FBgn0262256","2L",5640940,5641037,97
"8124","FBgn0037664","3R",9246649,9251431,4782
"8125","FBgn0000039","3R",24485428,24491147,5719
"8126","FBgn0266956","3L",9760900,9761354,454
"8127","FBgn0039202","3R",24522478,24523678,1200
"8128","FBgn0266957","3L",9222024,9222433,409
"8129","FBgn0004913","3R",4906622,4910081,3459
"8130","FBgn0260744","3R",11971007,11974910,3903
"8131","FBgn0250827","2R",8362359,8363218,859
"8132","FBgn0052732","X",6958032,6968750,10718
"8133","FBgn0037896","3R",11419376,11421693,2317
"8134","FBgn0004107","3R",20735623,20738414,2791
"8135","FBgn0259729","2R",24423926,24425102,1176
"8136","FBgn0034165","2R",16873772,16874977,1205
"8137","FBgn0266898","2L",17575152,17575490,338
"8138","FBgn0038892","3R",21567519,21569149,1630
"8139","FBgn0086045","X",10124347,10124445,98
"8140","FBgn0267057","X",19745936,19746487,551
"8141","FBgn0004893","2L",3771700,3784121,12421
"8142","FBgn0039286","3R",25184383,25192806,8423
"8143","FBgn0038016","3R",12352143,12356265,4122
"8144","FBgn0035196","3L",1250696,1251778,1082
"8145","FBgn0265911","2L",4350999,4351449,450
"8146","FBgn0035844","3L",8141868,8151813,9945
"8147","FBgn0263209","X",19929229,19929580,351
"8148","FBgn0030158","X",9879870,9880535,665
"8149","FBgn0039438","3R",26625932,26626738,806
"8150","FBgn0041245","2L",21367908,21369706,1798
"8151","FBgn0020414","2L",16450907,16455194,4287
"8152","FBgn0039016","3R",22734007,22741091,7084
"8153","FBgn0002868","3R",9783407,9784370,963
"8154","FBgn0034269","2R",17734419,17737269,2850
"8155","FBgn0002284","3L",16609400,16610418,1018
"8156","FBgn0034103","2R",16280015,16280470,455
"8157","FBgn0086253","3R",22749014,22750597,1583
"8158","FBgn0038686","3R",19178085,19180538,2453
"8159","FBgn0052423","3L",5155821,5277944,122123
"8160","FBgn0265537","2R",17185096,17185595,499
"8161","FBgn0037011","3L",20526576,20527910,1334
"8162","FBgn0037084","2R",11219539,11222480,2941
"8163","FBgn0031726","2L",5620615,5623762,3147
"8164","FBgn0263575","2L",4829980,4830039,59
"8165","FBgn0050409","2R",23354367,23355321,954
"8166","FBgn0030274","X",11149323,11152592,3269
"8167","FBgn0032612","2L",16832065,16834502,2437
"8168","FBgn0261453","3R",7921952,7922073,121
"8169","FBgn0040251","3R",11151026,11153849,2823
"8170","FBgn0040571","3R",20036421,20056097,19676
"8171","FBgn0265524","X",21119529,21120176,647
"8172","FBgn0261983","2L",11106943,11110851,3908
"8173","FBgn0037786","3R",10073821,10075373,1552
"8174","FBgn0267502","rDNA",70389,70511,122
"8175","FBgn0013300","2L",14879050,14881652,2602
"8176","FBgn0265946","2L",14409755,14410045,290
"8177","FBgn0013697","mitochondrion_genome",3768,3838,70
"8178","FBgn0037142","3L",21942221,21949866,7645
"8179","FBgn0267366","3R",27912447,27913785,1338
"8180","FBgn0019957","3R",22027709,22029393,1684
"8181","FBgn0004401","3L",17638103,17645036,6933
"8182","FBgn0031842","2L",6649388,6654574,5186
"8183","FBgn0011746","2R",9062295,9077554,15259
"8184","FBgn0032235","2L",10382263,10384723,2460
"8185","FBgn0036194","3L",11693879,11696963,3084
"8186","FBgn0086077","3L",11001409,11001489,80
"8187","FBgn0261554","2R",21295652,21310411,14759
"8188","FBgn0035085","2R",24945139,24946636,1497
"8189","FBgn0039738","3R",30015513,30022221,6708
"8190","FBgn0053826","2L",21473141,21473633,492
"8191","FBgn0261625","2R",12670483,12679593,9110
"8192","FBgn0261803","X",5296066,5306288,10222
"8193","FBgn0030195","X",10375374,10376628,1254
"8194","FBgn0029679","X",3828197,3831546,3349
"8195","FBgn0052801","X",1902082,1903177,1095
"8196","FBgn0039277","3R",25109226,25112516,3290
"8197","FBgn0052249","3L",4470001,4471012,1011
"8198","FBgn0030611","X",15085159,15085827,668
"8199","FBgn0037207","3L",22945657,22952248,6591
"8200","FBgn0032049","2L",8494893,8496307,1414
"8201","FBgn0033017","2R",5339706,5340995,1289
"8202","FBgn0030006","X",8142550,8143835,1285
"8203","FBgn0266032","2L",623107,623665,558
"8204","FBgn0010434","2R",19229063,19243751,14688
"8205","FBgn0036515","3L",15583638,15585347,1709
"8206","FBgn0030797","X",16826681,16835520,8839
"8207","FBgn0031474","2L",2857164,2868548,11384
"8208","FBgn0013770","2R",13960675,13967981,7306
"8209","FBgn0265994","2L",18735748,18736130,382
"8210","FBgn0011655","3R",31611046,31615375,4329
"8211","FBgn0267719","3R",17429762,17430106,344
"8212","FBgn0261509","2L",1555129,1608404,53275
"8213","FBgn0036592","3L",16281132,16281930,798
"8214","FBgn0040786","3L",19806811,19807199,388
"8215","FBgn0027537","X",13822826,13825910,3084
"8216","FBgn0004363","2L",10847227,10850848,3621
"8217","FBgn0267257","2L",14509913,14512083,2170
"8218","FBgn0265188","2R",23058248,23058793,545
"8219","FBgn0030507","X",13668014,13669573,1559
"8220","FBgn0032789","2L",19487490,19488691,1201
"8221","FBgn0262396","3L",11773012,11773101,89
"8222","FBgn0053109","3R",14220560,14221584,1024
"8223","FBgn0038660","3R",18911053,18912922,1869
"8224","FBgn0261858","3L",2389265,2389650,385
"8225","FBgn0267048","X",19943357,19944147,790
"8226","FBgn0012042","2R",14747362,14748215,853
"8227","FBgn0039152","3R",24113286,24128193,14907
"8228","FBgn0028867","2L",14781715,14783110,1395
"8229","FBgn0030259","X",11057545,11059619,2074
"8230","FBgn0037525","3R",7855582,7886733,31151
"8231","FBgn0039742","3R",30048635,30052112,3477
"8232","FBgn0031468","2L",2840124,2842638,2514
"8233","FBgn0263234","2L",12109417,12110664,1247
"8234","FBgn0038070","3R",12640163,12642482,2319
"8235","FBgn0040601","3R",24897685,24906004,8319
"8236","FBgn0260230","3R",12028070,12031757,3687
"8237","FBgn0002626","3R",30045229,30046161,932
"8238","FBgn0265898","3L",22029969,22030641,672
"8239","FBgn0053170","3L",22864600,22867535,2935
"8240","FBgn0267532","3L",9438984,9439450,466
"8241","FBgn0031649","2L",4933047,4936450,3403
"8242","FBgn0000567","3L",17558672,17619325,60653
"8243","FBgn0086068","3L",3221350,3221427,77
"8244","FBgn0053874","2L",21522775,21523369,594
"8245","FBgn0045476","3L",4032141,4035703,3562
"8246","FBgn0029643","X",2938856,2940527,1671
"8247","FBgn0263002","3R",25268009,25268464,455
"8248","FBgn0037850","3R",10878204,10879319,1115
"8249","FBgn0031284","2L",818079,819508,1429
"8250","FBgn0030839","X",17423591,17428735,5144
"8251","FBgn0030837","X",17283762,17284500,738
"8252","FBgn0031939","2L",7727157,7732670,5513
"8253","FBgn0029092","2R",9434669,9444937,10268
"8254","FBgn0042641","3L",17428936,17433190,4254
"8255","FBgn0036565","3L",16087627,16090392,2765
"8256","FBgn0265095","2R",7149795,7150094,299
"8257","FBgn0037008","3L",20519590,20520772,1182
"8258","FBgn0031159","X",21093844,21111417,17573
"8259","FBgn0263336","2R",16817519,16819240,1721
"8260","FBgn0086909","2L",18677221,18683715,6494
"8261","FBgn0027788","2R",7995438,7998278,2840
"8262","FBgn0263599","3L",15960836,15967872,7036
"8263","FBgn0263316","3R",11569250,11575937,6687
"8264","FBgn0031760","2L",6000228,6003738,3510
"8265","FBgn0010303","X",13079205,13090434,11229
"8266","FBgn0037661","3R",9065183,9066303,1120
"8267","FBgn0266852","2R",18054969,18055346,377
"8268","FBgn0003495","3R",27064990,27070070,5080
"8269","FBgn0083010","X",17146248,17146390,142
"8270","FBgn0086033","2L",5437634,5437749,115
"8271","FBgn0050376","2R",8263486,8264426,940
"8272","FBgn0265372","2R",12233995,12234595,600
"8273","FBgn0038821","3R",20737325,20739100,1775
"8274","FBgn0032899","2L",20865215,20867709,2494
"8275","FBgn0033645","2R",11684165,11686434,2269
"8276","FBgn0053895","2L",21468956,21469368,412
"8277","FBgn0039543","3R",27703379,27706751,3372
"8278","FBgn0033943","2R",14591203,14595617,4414
"8279","FBgn0263768","3R",7092347,7093707,1360
"8280","FBgn0038158","3R",13587997,13588725,728
"8281","FBgn0010622","2R",23061420,23062593,1173
"8282","FBgn0266568","X",362399,367072,4673
"8283","FBgn0004959","X",18685766,18688433,2667
"8284","FBgn0036666","3L",16842294,16844585,2291
"8285","FBgn0263321","2L",1442627,1443832,1205
"8286","FBgn0051423","3R",22117640,22119454,1814
"8287","FBgn0283627","3R",7418938,7420698,1760
"8288","FBgn0267293","2L",17280235,17280536,301
"8289","FBgn0010395","2L",21053033,21058044,5011
"8290","FBgn0026361","2R",7960133,7961921,1788
"8291","FBgn0030239","X",10847438,10848534,1096
"8292","FBgn0010296","X",3243954,3244220,266
"8293","FBgn0037036","3L",20955755,20956750,995
"8294","FBgn0034049","2R",15923040,15931935,8895
"8295","FBgn0039637","3R",29123370,29128247,4877
"8296","FBgn0037475","3R",7136206,7141972,5766
"8297","FBgn0051889","2L",8679116,8679187,71
"8298","FBgn0266729","2R",8897820,8898275,455
"8299","FBgn0036846","3L",19092670,19094760,2090
"8300","FBgn0270926","3L",21173118,21174973,1855
"8301","FBgn0013323","2L",575711,576896,1185
"8302","FBgn0031708","2L",5518893,5519896,1003
"8303","FBgn0085404","3R",23000139,23010562,10423
"8304","FBgn0027527","3R",6234708,6237181,2473
"8305","FBgn0031520","2L",3320245,3323141,2896
"8306","FBgn0052438","3L",21569176,21573523,4347
"8307","FBgn0264833","3R",30921682,30922383,701
"8308","FBgn0023515","X",1862009,1865835,3826
"8309","FBgn0034095","2R",16230198,16234087,3889
"8310","FBgn0037042","3L",20991673,20992930,1257
"8311","FBgn0039349","3R",25624805,25626924,2119
"8312","FBgn0267580","3L",21668035,21670043,2008
"8313","FBgn0038675","3R",19031503,19032409,906
"8314","FBgn0039200","3R",24392889,24393762,873
"8315","FBgn0052213","3L",19475839,19476423,584
"8316","FBgn0267569","3R",7159229,7162936,3707
"8317","FBgn0039492","3R",27124759,27151069,26310
"8318","FBgn0039748","3R",30152059,30153699,1640
"8319","FBgn0010397","2R",14570810,14575771,4961
"8320","FBgn0283430","X",20209746,20210592,846
"8321","FBgn0032725","2L",18951006,18951837,831
"8322","FBgn0035971","3L",9250225,9251338,1113
"8323","FBgn0030887","X",18023870,18028261,4391
"8324","FBgn0040385","X",2409365,2410901,1536
"8325","FBgn0259876","2R",13133142,13142820,9678
"8326","FBgn0051882","2L",9624452,9625285,833
"8327","FBgn0283536","3R",19643018,19644386,1368
"8328","FBgn0267129","3R",29713278,29713678,400
"8329","FBgn0054052","X",2321758,2322264,506
"8330","FBgn0039463","3R",26947830,26949682,1852
"8331","FBgn0038402","3R",16149369,16151312,1943
"8332","FBgn0034494","2R",20271653,20274499,2846
"8333","FBgn0036016","3L",9601523,9602548,1025
"8334","FBgn0053893","2L",21473999,21474411,412
"8335","FBgn0002887","2L",8438169,8442342,4173
"8336","FBgn0053820","2L",21463055,21463547,492
"8337","FBgn0285949","2R",9587193,9587989,796
"8338","FBgn0267551","3R",15802854,15803495,641
"8339","FBgn0035610","3L",5512421,5529341,16920
"8340","FBgn0265678","2L",3287822,3288591,769
"8341","FBgn0036956","3L",20231669,20233255,1586
"8342","FBgn0267799","3R",8612711,8613030,319
"8343","FBgn0050382","2R",7830413,7831771,1358
"8344","FBgn0085415","2R",18062415,18093628,31213
"8345","FBgn0083030","2L",20421617,20421752,135
"8346","FBgn0051921","2L",329910,332335,2425
"8347","FBgn0032435","2L",12448484,12452047,3563
"8348","FBgn0034887","2R",23681623,23682952,1329
"8349","FBgn0020388","3L",12521129,12524014,2885
"8350","FBgn0260762","2R",23599526,23600787,1261
"8351","FBgn0265755","3L",15190440,15190998,558
"8352","FBgn0013949","3R",24865350,24867651,2301
"8353","FBgn0000996","2R",15376619,15380988,4369
"8354","FBgn0040765","2R",10977956,11116378,138422
"8355","FBgn0053303","2L",10373369,10375757,2388
"8356","FBgn0033716","2R",12337797,12339544,1747
"8357","FBgn0085360","X",20122453,20125271,2818
"8358","FBgn0034599","2R",21168930,21170010,1080
"8359","FBgn0038708","3R",19461879,19463066,1187
"8360","FBgn0051570","3R",17619738,17619810,72
"8361","FBgn0038186","3R",13854599,13855454,855
"8362","FBgn0032774","2L",19387050,19390075,3025
"8363","FBgn0008636","2R",20954668,20960909,6241
"8364","FBgn0032549","2L",14773814,14774981,1167
"8365","FBgn0029942","X",7286358,7288117,1759
"8366","FBgn0267273","X",13345586,13346102,516
"8367","FBgn0032913","2L",21089375,21090999,1624
"8368","FBgn0264493","3R",13967061,14032057,64996
"8369","FBgn0028853","2L",15285000,15286047,1047
"8370","FBgn0039955","3R",3846729,3868401,21672
"8371","FBgn0010660","2R",22918937,22924742,5805
"8372","FBgn0033131","2R",7039130,7039813,683
"8373","FBgn0266042","2R",23812185,23814771,2586
"8374","FBgn0004656","X",8037808,8061436,23628
"8375","FBgn0035970","3L",9235150,9236648,1498
"8376","FBgn0026058","X",17791010,17814011,23001
"8377","FBgn0262142","2R",22666359,22666764,405
"8378","FBgn0031763","2L",6020835,6021718,883
"8379","FBgn0051602","2L",8620028,8620099,71
"8380","FBgn0023531","X",1673110,1692768,19658
"8381","FBgn0063495","2R",18404605,18405338,733
"8382","FBgn0086037","2L",16417750,16417884,134
"8383","FBgn0266068","2L",5661902,5662232,330
"8384","FBgn0026174","X",19812729,19813384,655
"8385","FBgn0053687","3L",16197868,16198852,984
"8386","FBgn0265642","2R",8310521,8311234,713
"8387","FBgn0263593","2R",8136986,8156654,19668
"8388","FBgn0053377","2R",19757255,19757389,134
"8389","FBgn0053987","2L",22019208,22020254,1046
"8390","FBgn0030015","X",8161540,8162792,1252
"8391","FBgn0027528","X",16727304,16751910,24606
"8392","FBgn0025807","3L",18870045,18872553,2508
"8393","FBgn0052740","X",6744471,6744543,72
"8394","FBgn0265644","2R",9214095,9215145,1050
"8395","FBgn0015582","2R",11290994,11293174,2180
"8396","FBgn0266256","3R",26607047,26608440,1393
"8397","FBgn0033443","2R",9793326,9798006,4680
"8398","FBgn0015834","2L",4966367,4967775,1408
"8399","FBgn0010414","2R",24404595,24411074,6479
"8400","FBgn0039568","3R",27989699,27990751,1052
"8401","FBgn0263594","3R",4403076,4407182,4106
"8402","FBgn0001104","3L",6972750,6980044,7294
"8403","FBgn0037807","3R",10307806,10311613,3807
"8404","FBgn0050424","2R",24965275,24967298,2023
"8405","FBgn0265942","2L",14273721,14274454,733
"8406","FBgn0051644","2L",5817890,5818443,553
"8407","FBgn0033374","2R",9092506,9094658,2152
"8408","FBgn0083121","3L",1666288,1667307,1019
"8409","FBgn0010741","3L",11073292,11074388,1096
"8410","FBgn0033139","2R",7064399,7066113,1714
"8411","FBgn0032006","2L",8220980,8239878,18898
"8412","FBgn0262451","3L",642208,642288,80
"8413","FBgn0038366","3R",15825747,15830321,4574
"8414","FBgn0015399","2L",12817000,12822787,5787
"8415","FBgn0036814","3L",18802265,18820675,18410
"8416","FBgn0035036","2R",24604595,24607023,2428
"8417","FBgn0040503","2R",11414510,11415462,952
"8418","FBgn0036980","3L",20376242,20382398,6156
"8419","FBgn0062442","3R",29222217,29223428,1211
"8420","FBgn0039329","3R",25331363,25335243,3880
"8421","FBgn0266221","2L",21999734,22000420,686
"8422","FBgn0038967","3R",22425214,22436150,10936
"8423","FBgn0085450","2L",7891187,7984196,93009
"8424","FBgn0085306","3R",5369540,5371744,2204
"8425","FBgn0058172","2L",20248928,20249722,794
"8426","FBgn0038173","3R",13706757,13709129,2372
"8427","FBgn0000307","2L",16342430,16352628,10198
"8428","FBgn0035440","3L",3333119,3334978,1859
"8429","FBgn0030617","X",15139937,15163225,23288
"8430","FBgn0283549","X",633691,633751,60
"8431","FBgn0003134","3R",24518270,24522331,4061
"8432","FBgn0259965","2L",15201613,15202092,479
"8433","FBgn0039159","3R",24162829,24163545,716
"8434","FBgn0019982","2L",4455137,4456807,1670
"8435","FBgn0038922","3R",22016391,22019382,2991
"8436","FBgn0010452","3L",13114271,13118077,3806
"8437","FBgn0053127","2L",322101,323091,990
"8438","FBgn0036527","3L",15679720,15681470,1750
"8439","FBgn0031640","2L",4850641,4852640,1999
"8440","FBgn0011204","3L",1503226,1517271,14045
"8441","FBgn0030493","X",13534400,13536202,1802
"8442","FBgn0031996","2L",8197193,8198813,1620
"8443","FBgn0082981","2R",9095372,9095526,154
"8444","FBgn0031987","2L",8125668,8126890,1222
"8445","FBgn0266401","3R",28237449,28238570,1121
"8446","FBgn0263096","2L",3694105,3694418,313
"8447","FBgn0025630","X",2072413,2074890,2477
"8448","FBgn0052105","3L",12329232,12335901,6669
"8449","FBgn0011281","3R",5972155,5975245,3090
"8450","FBgn0053894","2L",21472418,21473012,594
"8451","FBgn0263084","2R",23313017,23313854,837
"8452","FBgn0031098","X",20248309,20251093,2784
"8453","FBgn0003139","X",6371065,6372915,1850
"8454","FBgn0265767","X",23022898,23035550,12652
"8455","FBgn0015801","2R",24788008,24793410,5402
"8456","FBgn0031738","2L",5767002,5800253,33251
"8457","FBgn0265801","2L",12080805,12082074,1269
"8458","FBgn0035921","3L",8644916,8646822,1906
"8459","FBgn0037000","3L",20484293,20494921,10628
"8460","FBgn0039003","3R",22687542,22690380,2838
"8461","FBgn0263380","3L",14976626,14977631,1005
"8462","FBgn0264616","4",132674,132874,200
"8463","FBgn0004509","3R",25347431,25473058,125627
"8464","FBgn0259703","3L",2020554,2021958,1404
"8465","FBgn0003896","2L",18859507,18881261,21754
"8466","FBgn0040784","X",20110110,20110575,465
"8467","FBgn0037184","3L",22726234,22727789,1555
"8468","FBgn0265152","2L",228037,228588,551
"8469","FBgn0085374","2L",6623112,6625359,2247
"8470","FBgn0037220","3R",4230779,4232342,1563
"8471","FBgn0035032","2R",24599088,24599821,733
"8472","FBgn0027525","2R",10836570,10838727,2157
"8473","FBgn0011760","X",4687800,4702034,14234
"8474","FBgn0033557","2R",10823405,10827644,4239
"8475","FBgn0034841","2R",23284227,23285821,1594
"8476","FBgn0039639","3R",29137970,29138573,603
"8477","FBgn0051613","2L",21425193,21425721,528
"8478","FBgn0259722","X",254876,255524,648
"8479","FBgn0037574","3R",8314784,8316543,1759
"8480","FBgn0040637","3L",20905795,20906331,536
"8481","FBgn0004456","X",13214409,13258490,44081
"8482","FBgn0267026","2R",13410269,13410591,322
"8483","FBgn0051413","3R",23702761,23704542,1781
"8484","FBgn0036618","3L",16364899,16365707,808
"8485","FBgn0024984","X",2187820,2188919,1099
"8486","FBgn0040099","2L",7857077,7860120,3043
"8487","FBgn0030495","X",13552559,13555800,3241
"8488","FBgn0266115","X",18804840,18806363,1523
"8489","FBgn0030162","X",9908663,9911126,2463
"8490","FBgn0037920","3R",11620090,11621728,1638
"8491","FBgn0035246","3L",1625791,1628377,2586
"8492","FBgn0035059","2R",24763167,24766750,3583
"8493","FBgn0051638","2L",6491061,6496988,5927
"8494","FBgn0034402","2R",18850844,18851963,1119
"8495","FBgn0265744","3L",12302162,12302551,389
"8496","FBgn0262900","X",8923960,8924449,489
"8497","FBgn0050074","2R",14373108,14373808,700
"8498","FBgn0035736","3L",7087713,7088787,1074
"8499","FBgn0260428","2L",4762895,4763951,1056
"8500","FBgn0267764","3R",24607271,24607795,524
"8501","FBgn0035931","3L",8805811,8807213,1402
"8502","FBgn0086347","2L",10491814,10506779,14965
"8503","FBgn0054030","3L",7073476,7075247,1771
"8504","FBgn0260874","3L",19799278,19803427,4149
"8505","FBgn0266981","3L",21301477,21302159,682
"8506","FBgn0036035","3L",9717786,9719144,1358
"8507","FBgn0003527","2R",12570367,12571883,1516
"8508","FBgn0037980","3R",12014943,12017031,2088
"8509","FBgn0037709","3R",9555785,9557776,1991
"8510","FBgn0030421","X",12765266,12772851,7585
"8511","FBgn0266857","2R",11994995,11996194,1199
"8512","FBgn0038874","3R",21247011,21265134,18123
"8513","FBgn0036024","3L",9641013,9641913,900
"8514","FBgn0051922","2L",1170181,1170789,608
"8515","FBgn0265943","2L",14457113,14457338,225
"8516","FBgn0267930","X",16191134,16191631,497
"8517","FBgn0034659","2R",21773295,21774876,1581
"8518","FBgn0085734","3L",25403776,25405940,2164
"8519","FBgn0052238","3L",4648276,4650305,2029
"8520","FBgn0052694","X",9989690,10006882,17192
"8521","FBgn0263108","3L",3148646,3158408,9762
"8522","FBgn0033791","2R",13055246,13079539,24293
"8523","FBgn0026372","3L",1667192,1668654,1462
"8524","FBgn0011872","2R",21182856,21182926,70
"8525","FBgn0038547","3R",17798877,17801512,2635
"8526","FBgn0000439","3R",6791836,6802428,10592
"8527","FBgn0017545","4",65225,67207,1982
"8528","FBgn0010894","3L",5559470,5561598,2128
"8529","FBgn0001185","2L",16677185,16679691,2506
"8530","FBgn0267747","3R",28146392,28146962,570
"8531","FBgn0038165","3R",13667046,13674542,7496
"8532","FBgn0039831","3R",31220702,31231259,10557
"8533","FBgn0086666","X",763942,764086,144
"8534","FBgn0025692","2R",12875164,12876966,1802
"8535","FBgn0027945","3L",21280491,21281506,1015
"8536","FBgn0025382","X",1473884,1476974,3090
"8537","FBgn0037652","3R",9004017,9005331,1314
"8538","FBgn0063261","3R",16750741,16751334,593
"8539","FBgn0058068","2R",1618172,1618585,413
"8540","FBgn0034215","2R",17427795,17429315,1520
"8541","FBgn0037010","3L",20522440,20526174,3734
"8542","FBgn0267866","3R",12504977,12505250,273
"8543","FBgn0032139","2L",9729940,9730945,1005
"8544","FBgn0040377","X",2579091,2580560,1469
"8545","FBgn0267237","3L",20395394,20395851,457
"8546","FBgn0262112","3R",29794597,29795805,1208
"8547","FBgn0263750","3R",9355495,9359189,3694
"8548","FBgn0033687","2R",12153071,12154263,1192
"8549","FBgn0038043","3R",12422768,12423606,838
"8550","FBgn0015024","X",12653626,12657834,4208
"8551","FBgn0085252","2R",11235860,11236204,344
"8552","FBgn0036105","3L",10879085,10880188,1103
"8553","FBgn0085383","3R",28146880,28240526,93646
"8554","FBgn0038509","3R",17421690,17422202,512
"8555","FBgn0011890","2R",6171496,6171568,72
"8556","FBgn0033096","2R",6716342,6717707,1365
"8557","FBgn0001297","3R",29765995,29794113,28118
"8558","FBgn0004862","3R",21388880,21390449,1569
"8559","FBgn0036910","3L",19810403,19813339,2936
"8560","FBgn0026620","3R",4733654,4749056,15402
"8561","FBgn0013726","2R",8237271,8240297,3026
"8562","FBgn0041102","3R",30037003,30037730,727
"8563","FBgn0085245","2R",7703506,7705095,1589
"8564","FBgn0034351","2R",18451284,18452736,1452
"8565","FBgn0266976","3L",2317131,2317600,469
"8566","FBgn0032068","2L",8772946,8776263,3317
"8567","FBgn0086611","3L",6130386,6130989,603
"8568","FBgn0037962","3R",11892306,11893297,991
"8569","FBgn0286033","3L",18323584,18323985,401
"8570","FBgn0261380","3R",10782563,10784092,1529
"8571","FBgn0033442","2R",9756293,9758068,1775
"8572","FBgn0053801","2L",21416953,21417975,1022
"8573","FBgn0038931","3R",22103414,22105590,2176
"8574","FBgn0053099","3R",22528920,22530572,1652
"8575","FBgn0083021","2L",20421475,20421600,125
"8576","FBgn0024510","3L",1789631,1795328,5697
"8577","FBgn0035348","3L",2499372,2503606,4234
"8578","FBgn0030318","X",11599838,11606288,6450
"8579","FBgn0261794","2R",23907654,23925066,17412
"8580","FBgn0033971","2R",14846064,14848366,2302
"8581","FBgn0262302","4",626126,626212,86
"8582","FBgn0032943","2L",21344607,21358271,13664
"8583","FBgn0069938","X",22945321,22946339,1018
"8584","FBgn0031345","2L",1516795,1517478,683
"8585","FBgn0037994","3R",12192703,12195011,2308
"8586","FBgn0026399","3R",8634320,8635878,1558
"8587","FBgn0026199","4",690686,696055,5369
"8588","FBgn0040323","3L",18675800,18677876,2076
"8589","FBgn0011871","2R",21161356,21161426,70
"8590","FBgn0047334","3L",6232469,6233381,912
"8591","FBgn0032730","2L",18974710,18978187,3477
"8592","FBgn0263400","3R",20986504,20987936,1432
"8593","FBgn0015320","2L",10765010,10768006,2996
"8594","FBgn0260481","3L",22729766,22731600,1834
"8595","FBgn0045486","2L",17178772,17180064,1292
"8596","FBgn0033294","2R",8458815,8460884,2069
"8597","FBgn0027057","3L",18903057,18904930,1873
"8598","FBgn0260632","2L",17436830,17450364,13534
"8599","FBgn0038017","3R",12360008,12363255,3247
"8600","FBgn0264942","X",8919640,8920467,827
"8601","FBgn0265264","2L",10646415,10650152,3737
"8602","FBgn0013732","2R",6657326,6660624,3298
"8603","FBgn0036289","3L",12491830,12497216,5386
"8604","FBgn0030954","X",18764483,18774027,9544
"8605","FBgn0259170","X",10266792,10325958,59166
"8606","FBgn0085477","2L",2416792,2417965,1173
"8607","FBgn0052518","X",21231325,21231399,74
"8608","FBgn0013705","mitochondrion_genome",6191,6258,67
"8609","FBgn0025836","X",127449,140340,12891
"8610","FBgn0032448","2L",12696426,12697323,897
"8611","FBgn0265609","X",13528757,13529149,392
"8612","FBgn0053302","2L",10054213,10055935,1722
"8613","FBgn0038888","3R",21407445,21408324,879
"8614","FBgn0039498","3R",27241267,27242330,1063
"8615","FBgn0284235","2R",10124293,10137472,13179
"8616","FBgn0265419","3R",8112699,8114003,1304
"8617","FBgn0027500","3L",16591207,16595014,3807
"8618","FBgn0017577","3R",10788524,10791150,2626
"8619","FBgn0051698","2L",3173205,3173840,635
"8620","FBgn0045487","2L",17176618,17177921,1303
"8621","FBgn0032002","2L",8214045,8215239,1194
"8622","FBgn0030027","X",8252670,8272462,19792
"8623","FBgn0267560","3R",6858839,6859192,353
"8624","FBgn0267574","3R",13466495,13466722,227
"8625","FBgn0037543","3R",8030411,8032145,1734
"8626","FBgn0036211","3L",11816695,11822275,5580
"8627","FBgn0038768","3R",20031823,20034330,2507
"8628","FBgn0030090","X",9121973,9135099,13126
"8629","FBgn0038488","3R",17144475,17149412,4937
"8630","FBgn0035022","2R",24536190,24536791,601
"8631","FBgn0035592","3L",5135748,5136292,544
"8632","FBgn0002522","3R",6661427,6678590,17163
"8633","FBgn0032752","2L",19064832,19069851,5019
"8634","FBgn0026384","2R",23439868,23441065,1197
"8635","FBgn0022349","3R",31747643,31751894,4251
"8636","FBgn0030369","X",12032632,12035283,2651
"8637","FBgn0267221","3L",22909318,22909687,369
"8638","FBgn0029970","X",7889066,7891646,2580
"8639","FBgn0053442","2R",19733288,19733422,134
"8640","FBgn0030817","X",17091854,17104562,12708
"8641","FBgn0086757","2R",13450586,13453393,2807
"8642","FBgn0052382","3L",7439554,7440733,1179
"8643","FBgn0027513","2R",8898729,8900211,1482
"8644","FBgn0036818","3L",18866225,18867431,1206
"8645","FBgn0261566","2L",14587920,14588234,314
"8646","FBgn0266644","2R",22174951,22176707,1756
"8647","FBgn0039829","3R",31214776,31215942,1166
"8648","FBgn0267547","3L",14134722,14135102,380
"8649","FBgn0045495","2L",7454826,7462247,7421
"8650","FBgn0031546","2L",3519677,3522555,2878
"8651","FBgn0031831","2L",6559431,6560133,702
"8652","FBgn0040466","3R",4644649,4645655,1006
"8653","FBgn0028427","3L",21216901,21219240,2339
"8654","FBgn0036545","3L",15955096,15956465,1369
"8655","FBgn0034937","2R",23950647,23952096,1449
"8656","FBgn0034742","2R",22600405,22605667,5262
"8657","FBgn0036040","3L",9731238,9733807,2569
"8658","FBgn0261793","X",8409272,8433011,23739
"8659","FBgn0034958","2R",24019898,24022298,2400
"8660","FBgn0031395","2L",2189914,2192386,2472
"8661","FBgn0036411","3L",14103481,14108118,4637
"8662","FBgn0031766","2L",6036997,6037902,905
"8663","FBgn0265588","2L",8886134,8888028,1894
"8664","FBgn0264992","2L",11721286,11722098,812
"8665","FBgn0031698","2L",5315290,5326683,11393
"8666","FBgn0031861","2L",6804324,6805792,1468
"8667","FBgn0053503","2R",11123658,11125647,1989
"8668","FBgn0032701","2L",18698714,18700645,1931
"8669","FBgn0036868","3L",19387580,19390033,2453
"8670","FBgn0032631","2L",17286240,17287663,1423
"8671","FBgn0262395","X",15509473,15509546,73
"8672","FBgn0051943","2L",2009155,2009226,71
"8673","FBgn0020907","3R",16574543,16583663,9120
"8674","FBgn0266643","2R",21604195,21604786,591
"8675","FBgn0063498","2R",18399486,18400375,889
"8676","FBgn0263324","2R",21953615,21954095,480
"8677","FBgn0032788","2L",19484930,19486532,1602
"8678","FBgn0042110","3R",11690386,11691799,1413
"8679","FBgn0024993","X",2698701,2701033,2332
"8680","FBgn0265257","2L",6747421,6747914,493
"8681","FBgn0053449","2R",19730670,19730804,134
"8682","FBgn0030505","X",13624745,13664568,39823
"8683","FBgn0267051","X",19912655,19913283,628
"8684","FBgn0034931","2R",23925236,23926911,1675
"8685","FBgn0263392","3L",2786207,2879158,92951
"8686","FBgn0011294","2L",1329161,1329993,832
"8687","FBgn0037812","3R",10340949,10341668,719
"8688","FBgn0033429","2R",9586110,9586714,604
"8689","FBgn0262690","2R",20896994,20898629,1635
"8690","FBgn0050197","2R",14514030,14514992,962
"8691","FBgn0037519","3R",7799264,7802793,3529
"8692","FBgn0266114","X",13054218,13054689,471
"8693","FBgn0036567","3L",16095768,16097493,1725
"8694","FBgn0050489","2R",11117225,11121884,4659
"8695","FBgn0023517","X",1872400,1873565,1165
"8696","FBgn0083004","2R",22607232,22607372,140
"8697","FBgn0029646","X",2945403,2946589,1186
"8698","FBgn0036896","3L",19624406,19635783,11377
"8699","FBgn0082919","2R",14624253,14624330,77
"8700","FBgn0033699","2R",12199024,12200815,1791
"8701","FBgn0038294","3R",15170625,15181510,10885
"8702","FBgn0063387","2R",17702637,17702708,71
"8703","FBgn0260873","X",20139793,20140170,377
"8704","FBgn0053819","2L",21461173,21462195,1022
"8705","FBgn0266733","3R",15774076,15774715,639
"8706","FBgn0038570","3R",18165442,18167273,1831
"8707","FBgn0031854","2L",6736364,6740188,3824
"8708","FBgn0031770","2L",6054302,6060169,5867
"8709","FBgn0051055","3R",27685632,27688134,2502
"8710","FBgn0037339","3R",5557663,5563652,5989
"8711","FBgn0051282","3R",16431940,16432013,73
"8712","FBgn0002891","2R",7793625,7801044,7419
"8713","FBgn0033907","2R",14172986,14173596,610
"8714","FBgn0027375","3L",14628160,14632077,3917
"8715","FBgn0036809","3L",18721893,18723272,1379
"8716","FBgn0038371","3R",15838146,15839515,1369
"8717","FBgn0262827","X",7452694,7453336,642
"8718","FBgn0031575","2L",3867697,3871425,3728
"8719","FBgn0032398","2L",12038631,12040689,2058
"8720","FBgn0263249","3L",22029453,22029770,317
"8721","FBgn0267820","3R",9393890,9394737,847
"8722","FBgn0038722","3R",19645026,19646906,1880
"8723","FBgn0266657","3L",23149530,23150668,1138
"8724","FBgn0028622","2R",20563034,20583591,20557
"8725","FBgn0033697","2R",12190682,12192436,1754
"8726","FBgn0026602","2R",7243024,7245776,2752
"8727","FBgn0040751","2R",14157050,14157488,438
"8728","FBgn0033808","2R",13214706,13215760,1054
"8729","FBgn0034352","2R",18452737,18454462,1725
"8730","FBgn0027654","3R",30517059,30527037,9978
"8731","FBgn0041092","2L",9166778,9250211,83433
"8732","FBgn0051588","3R",13797953,13798025,72
"8733","FBgn0033095","2R",6699695,6715892,16197
"8734","FBgn0261814","3R",13438587,13439209,622
"8735","FBgn0262279","X",4368483,4368581,98
"8736","FBgn0031505","2L",3144953,3145848,895
"8737","FBgn0033855","2R",13555949,13557342,1393
"8738","FBgn0030676","X",15733222,15733996,774
"8739","FBgn0265428","X",19495284,19495896,612
"8740","FBgn0267475","3L",13550874,13551808,934
"8741","FBgn0265981","2R",22402895,22403195,300
"8742","FBgn0037963","3R",11893512,11949129,55617
"8743","FBgn0033473","2R",10026839,10030668,3829
"8744","FBgn0000658","2R",18232761,18236311,3550
"8745","FBgn0036134","3L",11114169,11120783,6614
"8746","FBgn0034535","2R",20641742,20642558,816
"8747","FBgn0261799","3L",16422795,16451958,29163
"8748","FBgn0028422","3R",20648595,20652450,3855
"8749","FBgn0264330","2R",16938696,16938995,299
"8750","FBgn0082990","2L",5187778,5187922,144
"8751","FBgn0036141","3L",11166620,11169625,3005
"8752","FBgn0013762","2R",15569528,15571417,1889
"8753","FBgn0262388","3R",25651398,25651497,99
"8754","FBgn0265610","X",13529656,13530249,593
"8755","FBgn0031209","2L",21823,25155,3332
"8756","FBgn0262411","3R",25646506,25646600,94
"8757","FBgn0267954","2R",18815654,18816452,798
"8758","FBgn0050042","2R",12378440,12379396,956
"8759","FBgn0050000","2R",9605988,9607184,1196
"8760","FBgn0031195","X",22515197,22542024,26827
"8761","FBgn0263005","X",13095571,13112462,16891
"8762","FBgn0265151","2L",219651,220050,399
"8763","FBgn0001228","3L",9372722,9374964,2242
"8764","FBgn0267177","X",10892261,10892748,487
"8765","FBgn0263208","X",19920486,19920708,222
"8766","FBgn0039581","3R",28340334,28345169,4835
"8767","FBgn0263109","2R",5893895,5931363,37468
"8768","FBgn0052495","X",17899702,17906025,6323
"8769","FBgn0266720","3R",9761305,9763150,1845
"8770","FBgn0267476","3L",1927623,1928152,529
"8771","FBgn0039116","3R",23767712,23768984,1272
"8772","FBgn0002565","3L",12129393,12131869,2476
"8773","FBgn0039848","3R",31458380,31459869,1489
"8774","FBgn0050088","2R",15691113,15692216,1103
"8775","FBgn0003557","2L",2037714,2044372,6658
"8776","FBgn0267590","2R",23850330,23851500,1170
"8777","FBgn0011260","2R",16500178,16533459,33281
"8778","FBgn0267499","rDNA",58654,58776,122
"8779","FBgn0086711","2L",14975747,14997559,21812
"8780","FBgn0267701","3R",17417502,17418019,517
"8781","FBgn0065053","2L",4457603,4457674,71
"8782","FBgn0034065","2R",16014908,16016050,1142
"8783","FBgn0037150","3L",22073068,22074523,1455
"8784","FBgn0250823","3R",16272452,16304768,32316
"8785","FBgn0020503","2L",17384700,17409698,24998
"8786","FBgn0260429","2R",15613854,15657214,43360
"8787","FBgn0259950","2L",3387882,3388496,614
"8788","FBgn0052064","3L",10490861,10492934,2073
"8789","FBgn0025865","3R",21061680,21064471,2791
"8790","FBgn0014009","2R",6696739,6699469,2730
"8791","FBgn0053410","2R",19745096,19745230,134
"8792","FBgn0031384","2L",2009859,2030788,20929
"8793","FBgn0015799","X",797090,801479,4389
"8794","FBgn0267876","Y",3093052,3093817,765
"8795","FBgn0266731","X",10794338,10796292,1954
"8796","FBgn0036419","3L",14329346,14329885,539
"8797","FBgn0051167","3R",22397180,22397261,81
"8798","FBgn0283557","4",400703,400765,62
"8799","FBgn0030944","X",18649396,18650444,1048
"8800","FBgn0015838","2R",9103238,9106796,3558
"8801","FBgn0030494","X",13543643,13544907,1264
"8802","FBgn0037317","3R",5375022,5376460,1438
"8803","FBgn0050103","2R",17493695,17495998,2303
"8804","FBgn0051419","3R",17284648,17285421,773
"8805","FBgn0264962","2R",14860936,14871071,10135
"8806","FBgn0266650","3L",13032396,13033070,674
"8807","FBgn0038313","3R",15275522,15276474,952
"8808","FBgn0032889","2L",20822828,20827744,4916
"8809","FBgn0038803","3R",20560865,20573000,12135
"8810","FBgn0051211","3R",11949680,11954038,4358
"8811","FBgn0263320","2L",1428474,1429159,685
"8812","FBgn0003676","3R",22489105,22491439,2334
"8813","FBgn0261954","X",2010860,2024647,13787
"8814","FBgn0033494","2R",10145897,10192394,46497
"8815","FBgn0260390","2R",8129354,8131323,1969
"8816","FBgn0031452","2L",2745098,2746944,1846
"8817","FBgn0040992","2L",18808694,18811252,2558
"8818","FBgn0040805","3L",15492964,15495549,2585
"8819","FBgn0028570","2L",2290224,2290738,514
"8820","FBgn0267616","3L",21413303,21413643,340
"8821","FBgn0030501","X",13612131,13613228,1097
"8822","FBgn0050159","2R",6992681,6994306,1625
"8823","FBgn0011983","X",14117729,14117810,81
"8824","FBgn0263289","3R",26536350,26604051,67701
"8825","FBgn0085407","2L",7098188,7157695,59507
"8826","FBgn0036482","3L",15127940,15131378,3438
"8827","FBgn0267080","X",15693068,15693967,899
"8828","FBgn0035998","3L",9456342,9457669,1327
"8829","FBgn0284408","X",2470460,2545410,74950
"8830","FBgn0002036","2L",19114401,19116570,2169
"8831","FBgn0262035","3L",230971,231604,633
"8832","FBgn0266951","3L",125421,125833,412
"8833","FBgn0028932","2L",13782231,13784338,2107
"8834","FBgn0032082","2L",8967535,8970627,3092
"8835","FBgn0021796","2L",13004480,13013197,8717
"8836","FBgn0085308","3R",17402362,17403288,926
"8837","FBgn0000251","2L",20770731,20783135,12404
"8838","FBgn0264468","3L",20265598,20266200,602
"8839","FBgn0265199","3R",17253581,17254129,548
"8840","FBgn0029752","X",5310581,5311888,1307
"8841","FBgn0261270","2R",14268772,14270658,1886
"8842","FBgn0262989","X",8724674,8725901,1227
"8843","FBgn0034180","2R",17007674,17015894,8220
"8844","FBgn0266845","2L",8751715,8752122,407
"8845","FBgn0034251","2R",17595267,17597409,2142
"8846","FBgn0031733","2L",5726415,5728811,2396
"8847","FBgn0259860","Y",2559809,2561503,1694
"8848","FBgn0266215","2L",21163871,21164271,400
"8849","FBgn0040366","X",1211989,1215156,3167
"8850","FBgn0036059","3L",9898703,9903031,4328
"8851","FBgn0259938","3R",10388258,10400752,12494
"8852","FBgn0039889","4",177348,179389,2041
"8853","FBgn0037678","3R",9330885,9331885,1000
"8854","FBgn0083040","X",17145210,17145349,139
"8855","FBgn0085264","2R",13209809,13212237,2428
"8856","FBgn0065064","3R",11223571,11223790,219
"8857","FBgn0052792","X",3557812,3572000,14188
"8858","FBgn0266785","3L",11342082,11342424,342
"8859","FBgn0029522","X",476984,478191,1207
"8860","FBgn0262733","3L",4592447,4626196,33749
"8861","FBgn0030467","X",13294473,13302415,7942
"8862","FBgn0033093","2R",6693430,6695187,1757
"8863","FBgn0267816","3R",3697234,3697640,406
"8864","FBgn0031609","2L",4461657,4463447,1790
"8865","FBgn0005672","2L",19567900,19577315,9415
"8866","FBgn0039260","3R",25029429,25033465,4036
"8867","FBgn0030474","X",13338318,13341009,2691
"8868","FBgn0030159","X",9881953,9883670,1717
"8869","FBgn0032467","2L",13013276,13019434,6158
"8870","FBgn0015477","2R",9167763,9177261,9498
"8871","FBgn0264600","3L",16020409,16021506,1097
"8872","FBgn0266003","2L",6358345,6359994,1649
"8873","FBgn0032157","2L",9908830,9912608,3778
"8874","FBgn0021995","2R",8163564,8167769,4205
"8875","FBgn0042189","2L",6799946,6800894,948
"8876","FBgn0023001","3L",7134516,7143074,8558
"8877","FBgn0037607","3R",8667868,8673702,5834
"8878","FBgn0053349","2R",6950385,6952158,1773
"8879","FBgn0050380","2R",7939201,7939659,458
"8880","FBgn0002542","3R",7920431,7924491,4060
"8881","FBgn0035251","3L",1651432,1652900,1468
"8882","FBgn0265457","X",7166451,7405797,239346
"8883","FBgn0030930","X",18495067,18499986,4919
"8884","FBgn0259989","2L",11843137,11844063,926
"8885","FBgn0013276","3R",11958535,11960909,2374
"8886","FBgn0002579","X",628338,629483,1145
"8887","FBgn0025712","3L",1648944,1651501,2557
"8888","FBgn0029976","X",7912089,7918444,6355
"8889","FBgn0261991","2L",13457497,13458073,576
"8890","FBgn0032997","2R",4619030,4620833,1803
"8891","FBgn0052380","3L",7374050,7381474,7424
"8892","FBgn0265137","2R",6875906,6878927,3021
"8893","FBgn0265960","2L",3563308,3563540,232
"8894","FBgn0042175","2L",20456847,20459075,2228
"8895","FBgn0035571","3L",4752393,4753738,1345
"8896","FBgn0020545","2L",852768,854539,1771
"8897","FBgn0028897","2L",16262141,16263483,1342
"8898","FBgn0267313","3L",13087491,13088588,1097
"8899","FBgn0037615","3R",8719198,8721320,2122
"8900","FBgn0033828","2R",13353638,13354499,861
"8901","FBgn0001189","X",1669570,1673608,4038
"8902","FBgn0039108","3R",23719343,23721625,2282
"8903","FBgn0038552","3R",17809401,17811134,1733
"8904","FBgn0264369","2L",2797832,2798321,489
"8905","FBgn0052369","3L",7777105,7809825,32720
"8906","FBgn0037229","3R",4269221,4277928,8707
"8907","FBgn0011916","2R",11660563,11660635,72
"8908","FBgn0039739","3R",30022345,30022648,303
"8909","FBgn0027052","2L",10437548,10439240,1692
"8910","FBgn0000644","X",3173376,3174474,1098
"8911","FBgn0262547","2R",15013047,15013522,475
"8912","FBgn0003598","3R",13264364,13270038,5674
"8913","FBgn0260871","X",20096162,20096474,312
"8914","FBgn0261552","3R",9417940,9455500,37560
"8915","FBgn0028507","2L",15764220,15766267,2047
"8916","FBgn0032153","2L",9890885,9891336,451
"8917","FBgn0036560","3L",16035485,16037227,1742
"8918","FBgn0264900","3R",31680596,31681019,423
"8919","FBgn0034858","2R",23386521,23389052,2531
"8920","FBgn0261522","X",9688189,9689295,1106
"8921","FBgn0031444","2L",2665062,2666265,1203
"8922","FBgn0039050","3R",23091724,23095441,3717
"8923","FBgn0051712","2L",9934767,9938134,3367
"8924","FBgn0261403","2R",5307288,5329555,22267
"8925","FBgn0052693","X",10061627,10062785,1158
"8926","FBgn0082938","2L",20647817,20647891,74
"8927","FBgn0052756","X",5945682,5948353,2671
"8928","FBgn0034515","2R",20539512,20540448,936
"8929","FBgn0034518","2R",20550334,20552090,1756
"8930","FBgn0262994","3R",8197320,8197711,391
"8931","FBgn0012017","2L",2459924,2460044,120
"8932","FBgn0053632","2R",12522023,12522731,708
"8933","FBgn0262612","X",7528304,7528796,492
"8934","FBgn0024989","X",279703,350504,70801
"8935","FBgn0051913","2L",5784031,5784893,862
"8936","FBgn0032370","2L",11651331,11652010,679
"8937","FBgn0005564","3L",19566851,19584568,17717
"8938","FBgn0261284","X",6986486,6987188,702
"8939","FBgn0002570","2R",8449664,8451904,2240
"8940","FBgn0034179","2R",17005451,17007501,2050
"8941","FBgn0036749","3L",17740540,17742540,2000
"8942","FBgn0038248","3R",14626676,14642563,15887
"8943","FBgn0035122","3L",264779,265932,1153
"8944","FBgn0044452","3L",2774338,2780677,6339
"8945","FBgn0036988","3L",20427962,20430475,2513
"8946","FBgn0263761","3L",15049179,15049495,316
"8947","FBgn0030855","X",17636281,17639003,2722
"8948","FBgn0262566","2R",25138627,25139627,1000
"8949","FBgn0034118","2R",16344377,16345828,1451
"8950","FBgn0036199","3L",11720934,11728118,7184
"8951","FBgn0044323","2L",8030721,8040826,10105
"8952","FBgn0002733","3R",26005046,26006023,977
"8953","FBgn0004179","3L",22267382,22273745,6363
"8954","FBgn0030434","X",12907986,12909622,1636
"8955","FBgn0004885","3R",24719697,24749125,29428
"8956","FBgn0053389","2R",19752816,19752950,134
"8957","FBgn0086447","2L",19133023,19135233,2210
"8958","FBgn0025838","X",2681987,2682932,945
"8959","FBgn0039941","X",23068301,23081144,12843
"8960","FBgn0032424","2L",12356441,12357906,1465
"8961","FBgn0267457","3L",599399,600914,1515
"8962","FBgn0041194","3L",6911999,6914876,2877
"8963","FBgn0052299","3L",2389583,2390989,1406
"8964","FBgn0085336","3R",11897582,11898419,837
"8965","FBgn0038508","3R",17415739,17416505,766
"8966","FBgn0286037","3L",22269932,22270220,288
"8967","FBgn0267679","3R",12370507,12371099,592
"8968","FBgn0032907","2L",20926319,20927860,1541
"8969","FBgn0283438","3R",13026283,13030659,4376
"8970","FBgn0264956","2R",5884894,5886495,1601
"8971","FBgn0085329","3R",30305808,30306640,832
"8972","FBgn0261990","2R",13573618,13574257,639
"8973","FBgn0053723","2L",9440011,9440740,729
"8974","FBgn0262003","3R",17413077,17413639,562
"8975","FBgn0267681","3R",12614392,12615200,808
"8976","FBgn0069056","2R",21538250,21539293,1043
"8977","FBgn0020655","3L",12415026,12417580,2554
"8978","FBgn0040904","X",4276493,4277000,507
"8979","FBgn0015295","2R",16199426,16202884,3458
"8980","FBgn0262967","X",7488953,7493276,4323
"8981","FBgn0034666","2R",21860825,21861994,1169
"8982","FBgn0035541","3L",4405127,4406059,932
"8983","FBgn0259685","3R",24295078,24314541,19463
"8984","FBgn0037165","3L",22468862,22469853,991
"8985","FBgn0086656","2R",9142146,9143914,1768
"8986","FBgn0262404","3R",29217184,29217280,96
"8987","FBgn0039710","3R",29854695,29857491,2796
"8988","FBgn0262364","3R",11750333,11750916,583
"8989","FBgn0031381","2L",1988290,1988940,650
"8990","FBgn0004425","3L",1207371,1207981,610
"8991","FBgn0031973","2L",8004548,8007210,2662
"8992","FBgn0050091","2R",15680545,15682477,1932
"8993","FBgn0013301","2L",14882101,14883721,1620
"8994","FBgn0267139","3R",11101180,11101684,504
"8995","FBgn0063449","2L",9893805,9895003,1198
"8996","FBgn0259817","211000022279188",1449,2180,731
"8997","FBgn0039741","3R",30046470,30048665,2195
"8998","FBgn0267146","3R",12661378,12662138,760
"8999","FBgn0033174","2R",7447473,7449995,2522
"9000","FBgn0037252","3R",4437387,4441328,3941
"9001","FBgn0259187","2R",24519423,24521147,1724
"9002","FBgn0031208","2L",7529,9484,1955
"9003","FBgn0034140","2R",16574579,16576586,2007
"9004","FBgn0053506","2R",14857447,14858640,1193
"9005","FBgn0034266","2R",17726914,17732987,6073
"9006","FBgn0038586","3R",18224902,18226082,1180
"9007","FBgn0266261","3R",12341674,12342373,699
"9008","FBgn0026755","2L",6225048,6226842,1794
"9009","FBgn0046885","3R",27546052,27547462,1410
"9010","FBgn0260743","3R",11967708,11971686,3978
"9011","FBgn0259209","2R",24074602,24078223,3621
"9012","FBgn0034076","2R",16117109,16119149,2040
"9013","FBgn0036760","3L",17841540,17843544,2004
"9014","FBgn0036677","3L",16923914,16927434,3520
"9015","FBgn0033437","2R",9608128,9610290,2162
"9016","FBgn0263628","X",2200623,2201857,1234
"9017","FBgn0035985","3L",9404797,9406174,1377
"9018","FBgn0038859","3R",21128950,21129717,767
"9019","FBgn0028990","2L",6671065,6673347,2282
"9020","FBgn0031469","2L",2842589,2844513,1924
"9021","FBgn0004872","2L",10982205,10987420,5215
"9022","FBgn0038356","3R",15763115,15763551,436
"9023","FBgn0033460","2R",9876232,9882357,6125
"9024","FBgn0266347","3L",23206669,23287448,80779
"9025","FBgn0264982","3R",15986181,15993665,7484
"9026","FBgn0032000","2L",8212039,8212902,863
"9027","FBgn0259183","2R",14090325,14090972,647
"9028","FBgn0016976","X",22980722,23004648,23926
"9029","FBgn0267601","3L",18772086,18801312,29226
"9030","FBgn0002121","2L",9839,21376,11537
"9031","FBgn0053356","2R",19765021,19765163,142
"9032","FBgn0022986","2R",22412556,22415518,2962
"9033","FBgn0036689","3L",17027515,17029814,2299
"9034","FBgn0053855","2L",21521616,21522638,1022
"9035","FBgn0036812","3L",18746611,18748367,1756
"9036","FBgn0011288","3L",24074180,24299205,225025
"9037","FBgn0034364","2R",18616692,18619328,2636
"9038","FBgn0052069","3L",11062131,11062614,483
"9039","FBgn0286034","3R",13459671,13466106,6435
"9040","FBgn0263988","3L",149679,152589,2910
"9041","FBgn0260971","X",4840833,4906575,65742
"9042","FBgn0037164","3L",22465619,22468076,2457
"9043","FBgn0267884","Y",3164949,3165401,452
"9044","FBgn0050487","2R",12937616,12938343,727
"9045","FBgn0051427","3R",29238830,29240308,1478
"9046","FBgn0010323","2L",583540,594685,11145
"9047","FBgn0000180","2L",9984645,9995538,10893
"9048","FBgn0039596","3R",28748384,28751661,3277
"9049","FBgn0038837","3R",20860187,20866231,6044
"9050","FBgn0051952","2L",3416693,3418068,1375
"9051","FBgn0011723","3L",11927693,11935919,8226
"9052","FBgn0262582","3R",20252770,20303942,51172
"9053","FBgn0259917","3R",16358144,16360108,1964
"9054","FBgn0037013","3L",20533709,20535335,1626
"9055","FBgn0053367","2R",19760967,19761101,134
"9056","FBgn0032588","2L",16549181,16549959,778
"9057","FBgn0267200","3R",16208673,16209054,381
"9058","FBgn0028487","3R",13695263,13700838,5575
"9059","FBgn0265841","2R",20016495,20017095,600
"9060","FBgn0085405","3R",22448099,22460749,12650
"9061","FBgn0267586","2R",9075158,9075951,793
"9062","FBgn0266036","2L",987807,991300,3493
"9063","FBgn0278599","2R",5957588,5959299,1711
"9064","FBgn0033997","2R",15204654,15206334,1680
"9065","FBgn0264888","2L",7399465,7399929,464
"9066","FBgn0086693","X",6813978,6818156,4178
"9067","FBgn0285994","3L",21576460,21576661,201
"9068","FBgn0033225","2R",7810068,7812028,1960
"9069","FBgn0004369","3R",29377646,29487131,109485
"9070","FBgn0036468","3L",15051931,15052490,559
"9071","FBgn0039593","3R",28670704,28672021,1317
"9072","FBgn0038309","3R",15247163,15249137,1974
"9073","FBgn0039376","3R",25815479,25816574,1095
"9074","FBgn0051627","2L",21173222,21174179,957
"9075","FBgn0028546","2L",13639447,13642602,3155
"9076","FBgn0260768","2R",22661934,22663241,1307
"9077","FBgn0031301","2L",1108540,1112694,4154
"9078","FBgn0267052","X",19917819,19918447,628
"9079","FBgn0034293","2R",18048804,18049922,1118
"9080","FBgn0259101","X",11096273,11108148,11875
"9081","FBgn0023174","3L",14999951,15001319,1368
"9082","FBgn0050184","2R",23563973,23564780,807
"9083","FBgn0259985","2R",12025614,12027707,2093
"9084","FBgn0012009","3L",13433646,13433718,72
"9085","FBgn0034218","2R",17440297,17442483,2186
"9086","FBgn0004227","X",16361569,16371547,9978
"9087","FBgn0039766","3R",30424499,30425162,663
"9088","FBgn0032446","2L",12693872,12694988,1116
"9089","FBgn0053346","3R",28669233,28670452,1219
"9090","FBgn0263648","2L",14291201,14291817,616
"9091","FBgn0050414","2R",23384200,23385468,1268
"9092","FBgn0054029","2R",21970767,21971285,518
"9093","FBgn0001230","3R",24055080,24057310,2230
"9094","FBgn0053738","2L",21498607,21498642,35
"9095","FBgn0267014","2L",14746807,14747080,273
"9096","FBgn0037115","3L",21672139,21674518,2379
"9097","FBgn0266633","2R",12867609,12869783,2174
"9098","FBgn0087007","3L",14412828,14536276,123448
"9099","FBgn0010905","3L",2505245,2554292,49047
"9100","FBgn0267260","2L",17319077,17319308,231
"9101","FBgn0034312","2R",18173669,18175725,2056
"9102","FBgn0027518","3R",29741972,29745092,3120
"9103","FBgn0034512","2R",20534245,20535835,1590
"9104","FBgn0263647","3L",12044579,12045356,777
"9105","FBgn0034172","2R",16957465,16958927,1462
"9106","FBgn0027544","3R",30418767,30422971,4204
"9107","FBgn0040337","X",1026791,1028290,1499
"9108","FBgn0042178","3L",16595181,16600459,5278
"9109","FBgn0035591","3L",5136376,5138679,2303
"9110","FBgn0053845","2L",21504973,21505501,528
"9111","FBgn0053746","2L",21538367,21538402,35
"9112","FBgn0041711","3R",13409543,13415286,5743
"9113","FBgn0028582","3L",7528780,7540012,11232
"9114","FBgn0003480","3R",14328051,14329608,1557
"9115","FBgn0262518","3L",19867488,19871078,3590
"9116","FBgn0038826","3R",20756729,20810726,53997
"9117","FBgn0085414","2R",5804712,5860831,56119
"9118","FBgn0039617","3R",28925004,28970372,45368
"9119","FBgn0034940","2R",23956335,23957405,1070
"9120","FBgn0000615","2R",20667427,20671083,3656
"9121","FBgn0046689","3R",20770828,20772601,1773
"9122","FBgn0053552","2L",16682503,16683290,787
"9123","FBgn0037875","3R",11212308,11214539,2231
"9124","FBgn0027599","2R",24946561,24948378,1817
"9125","FBgn0032415","2L",12130516,12133411,2895
"9126","FBgn0034199","2R",17136451,17136903,452
"9127","FBgn0266627","2R",10478043,10478795,752
"9128","FBgn0037283","3R",4829911,4830513,602
"9129","FBgn0032860","2L",20423106,20424660,1554
"9130","FBgn0053191","3R",8778379,8779923,1544
"9131","FBgn0052109","3L",12745344,12746770,1426
"9132","FBgn0050263","2R",21674901,21685000,10099
"9133","FBgn0052152","3L",16139501,16144036,4535
"9134","FBgn0039647","3R",29171191,29194994,23803
"9135","FBgn0033354","2R",8934576,8939789,5213
"9136","FBgn0038369","3R",15834648,15836021,1373
"9137","FBgn0261786","2R",23523856,23528260,4404
"9138","FBgn0053218","X",2330159,2330826,667
"9139","FBgn0033320","2R",8692796,8696245,3449
"9140","FBgn0263760","2R",20790245,20791147,902
"9141","FBgn0267060","X",20292047,20293407,1360
"9142","FBgn0037697","3R",9456815,9460652,3837
"9143","FBgn0083022","2L",20421151,20421274,123
"9144","FBgn0025742","2L",6034731,6037015,2284
"9145","FBgn0039709","3R",29841657,29854699,13042
"9146","FBgn0033820","2R",13256587,13257446,859
"9147","FBgn0011737","2L",6911090,6914138,3048
"9148","FBgn0037987","3R",12048253,12049213,960
"9149","FBgn0053900","2L",21457272,21457866,594
"9150","FBgn0034144","2R",16598748,16600411,1663
"9151","FBgn0016794","3L",2589414,2595590,6176
"9152","FBgn0037832","3R",10779569,10780825,1256
"9153","FBgn0037626","3R",8769394,8771150,1756
"9154","FBgn0267693","3R",16473229,16480850,7621
"9155","FBgn0264367","2L",17085650,17086419,769
"9156","FBgn0261285","3R",19139054,19147910,8856
"9157","FBgn0034054","2R",15955040,15956636,1596
"9158","FBgn0037809","3R",10331581,10332695,1114
"9159","FBgn0051997","4",154654,156060,1406
"9160","FBgn0263019","2L",11952200,11971094,18894
"9161","FBgn0266433","2R",22476385,22477295,910
"9162","FBgn0266934","3L",20345122,20345720,598
"9163","FBgn0267898","Y",3231310,3231723,413
"9164","FBgn0051145","3R",23605751,23669659,63908
"9165","FBgn0033368","2R",9044850,9060608,15758
"9166","FBgn0016693","3R",12697322,12704875,7553
"9167","FBgn0050381","2R",7929658,7931016,1358
"9168","FBgn0264560","2R",12326360,12333860,7500
"9169","FBgn0051189","3R",21044898,21045842,944
"9170","FBgn0039675","3R",29664779,29666783,2004
"9171","FBgn0014073","3L",4510698,4532145,21447
"9172","FBgn0032221","2L",10328200,10331116,2916
"9173","FBgn0263384","3R",31767124,31767790,666
"9174","FBgn0263452","3R",22628797,22629299,502
"9175","FBgn0031969","2L",7986786,7994184,7398
"9176","FBgn0038796","3R",20408265,20409243,978
"9177","FBgn0003353","2R",24047411,24053035,5624
"9178","FBgn0040256","3R",11126597,11128328,1731
"9179","FBgn0040368","X",1158599,1162389,3790
"9180","FBgn0034860","2R",23412320,23419684,7364
"9181","FBgn0039269","3R",25064418,25065591,1173
"9182","FBgn0033266","2R",8127575,8129476,1901
"9183","FBgn0030366","X",12022837,12029032,6195
"9184","FBgn0033713","2R",12322507,12326258,3751
"9185","FBgn0266636","2R",15676441,15676845,404
"9186","FBgn0025115","2L",13912083,13912652,569
"9187","FBgn0029911","X",6838174,6843921,5747
"9188","FBgn0036875","3L",19492053,19497723,5670
"9189","FBgn0265420","3R",7626882,7627290,408
"9190","FBgn0261934","3L",6728800,6743164,14364
"9191","FBgn0027070","2L",18826770,18829059,2289
"9192","FBgn0263444","2R",10139262,10142074,2812
"9193","FBgn0053654","3R",9582515,9583222,707
"9194","FBgn0020412","3L",11078752,11093193,14441
"9195","FBgn0265425","3R",7331500,7332002,502
"9196","FBgn0035333","3L",2367843,2371939,4096
"9197","FBgn0267018","2L",17017747,17018049,302
"9198","FBgn0034350","2R",18446548,18449420,2872
"9199","FBgn0037503","3R",7439760,7441976,2216
"9200","FBgn0035161","3L",803427,804051,624
"9201","FBgn0052690","X",10204400,10205289,889
"9202","FBgn0038902","3R",21776138,21777213,1075
"9203","FBgn0052568","X",16740906,16742918,2012
"9204","FBgn0031021","X",19492421,19493337,916
"9205","FBgn0265889","3L",19678921,19680121,1200
"9206","FBgn0263033","2R",17032487,17034012,1525
"9207","FBgn0083940","X",10086527,10148876,62349
"9208","FBgn0032030","2L",8374461,8375549,1088
"9209","FBgn0267136","3R",10488323,10490216,1893
"9210","FBgn0051038","3R",29877059,29903231,26172
"9211","FBgn0053333","3R",17417467,17418042,575
"9212","FBgn0031066","X",19740537,19744335,3798
"9213","FBgn0035445","3L",3378268,3380083,1815
"9214","FBgn0034462","2R",19646483,19647645,1162
"9215","FBgn0035666","3L",6052321,6053215,894
"9216","FBgn0001105","X",15860115,15866175,6060
"9217","FBgn0034654","2R",21685283,21686201,918
"9218","FBgn0030244","X",10869284,10870705,1421
"9219","FBgn0267890","Y",3191215,3191491,276
"9220","FBgn0053322","2L",20814337,20816240,1903
"9221","FBgn0265998","3R",28888073,28922772,34699
"9222","FBgn0261058","2L",20640917,20642216,1299
"9223","FBgn0265052","2R",23683377,23687980,4603
"9224","FBgn0035563","3L",4634436,4634789,353
"9225","FBgn0038854","3R",21098229,21101718,3489
"9226","FBgn0263468","2L",12432798,12432950,152
"9227","FBgn0032690","2L",18606832,18609550,2718
"9228","FBgn0002563","2L",898500,901316,2816
"9229","FBgn0051013","3R",30643767,30645880,2113
"9230","FBgn0250910","3R",12511570,12548229,36659
"9231","FBgn0032130","2L",9568890,9573572,4682
"9232","FBgn0031307","2L",1143201,1147395,4194
"9233","FBgn0025879","3R",10203875,10213007,9132
"9234","FBgn0085208","2L",6046651,6048706,2055
"9235","FBgn0266771","3L",22121932,22122746,814
"9236","FBgn0033760","2R",12640690,12648224,7534
"9237","FBgn0262022","3L",20200093,20200487,394
"9238","FBgn0025627","X",2068592,2069688,1096
"9239","FBgn0029963","X",7852481,7854244,1763
"9240","FBgn0044047","X",2331493,2334658,3165
"9241","FBgn0083975","3R",20204809,20245473,40664
"9242","FBgn0051410","3R",10053332,10054348,1016
"9243","FBgn0085249","2R",10041065,10043507,2442
"9244","FBgn0015321","3L",9698336,9700481,2145
"9245","FBgn0040602","3R",25850410,25851291,881
"9246","FBgn0035519","3L",4259430,4261643,2213
"9247","FBgn0013696","mitochondrion_genome",1,65,64
"9248","FBgn0034612","2R",21285248,21290343,5095
"9249","FBgn0010520","2L",9895287,9896104,817
"9250","FBgn0015586","3L",19050757,19052026,1269
"9251","FBgn0027621","X",19495505,19509350,13845
"9252","FBgn0034564","2R",20977056,20977600,544
"9253","FBgn0259735","2L",16545016,16663218,118202
"9254","FBgn0267683","3R",13105070,13105491,421
"9255","FBgn0035473","3L",3907852,3909931,2079
"9256","FBgn0267526","3L",7629991,7630508,517
"9257","FBgn0035800","3L",7588608,7590998,2390
"9258","FBgn0036082","3L",10412818,10414774,1956
"9259","FBgn0036063","3L",9971151,9972054,903
"9260","FBgn0034687","2R",22069725,22071286,1561
"9261","FBgn0265159","3R",8754064,8755916,1852
"9262","FBgn0058002","3L",24976254,24977118,864
"9263","FBgn0260755","3L",834093,835515,1422
"9264","FBgn0050223","2R",19506339,19506410,71
"9265","FBgn0039501","3R",27248234,27251007,2773
"9266","FBgn0037718","3R",9586942,9589581,2639
"9267","FBgn0026060","X",6082709,6091471,8762
"9268","FBgn0266278","X",14293465,14294044,579
"9269","FBgn0013679","mitochondrion_genome",11721,12659,938
"9270","FBgn0267504","rDNA",70955,74924,3969
"9271","FBgn0031187","X",22455803,22470146,14343
"9272","FBgn0053905","2L",21434703,21435115,412
"9273","FBgn0262356","2L",17627859,17628389,530
"9274","FBgn0265102","3L",8407268,8412825,5557
"9275","FBgn0031654","2L",4952243,4953136,893
"9276","FBgn0260450","X",16325763,16328523,2760
"9277","FBgn0038349","3R",15542748,15548188,5440
"9278","FBgn0264702","3L",15108001,15108935,934
"9279","FBgn0037646","3R",8980860,8982793,1933
"9280","FBgn0267711","3R",20588003,20588549,546
"9281","FBgn0015240","3R",25025235,25029351,4116
"9282","FBgn0034721","2R",22348307,22348875,568
"9283","FBgn0033631","2R",11380347,11384114,3767
"9284","FBgn0267106","3R",29369338,29369777,439
"9285","FBgn0051935","2L",1594822,1611157,16335
"9286","FBgn0011666","3R",25516118,25608423,92305
"9287","FBgn0065058","3L",5763345,5763422,77
"9288","FBgn0053003","2L",4400953,4403142,2189
"9289","FBgn0036428","3L",14540937,14550975,10038
"9290","FBgn0265685","2L",10942358,10942949,591
"9291","FBgn0266069","2L",5631624,5632660,1036
"9292","FBgn0011958","2R",6142165,6142237,72
"9293","FBgn0031585","2L",4149279,4151203,1924
"9294","FBgn0036433","3L",14622796,14628174,5378
"9295","FBgn0040529","3R",8339944,8341043,1099
"9296","FBgn0283551","2L",10751877,10751938,61
"9297","FBgn0265751","3L",13324274,13324959,685
"9298","FBgn0036213","3L",11822851,11824211,1360
"9299","FBgn0266402","3L",4034030,4034750,720
"9300","FBgn0032535","2L",13909333,13911719,2386
"9301","FBgn0031488","2L",2999286,3016069,16783
"9302","FBgn0267666","3L",10306678,10320600,13922
"9303","FBgn0033330","2R",8792633,8793773,1140
"9304","FBgn0040843","3L",5132796,5133220,424
"9305","FBgn0267520","X",23270802,23271158,356
"9306","FBgn0033610","2R",11289688,11291096,1408
"9307","FBgn0001313","Y",573088,664173,91085
"9308","FBgn0028550","X",1242740,1275284,32544
"9309","FBgn0261790","2L",7884930,7885450,520
"9310","FBgn0039737","3R",30010476,30015284,4808
"9311","FBgn0052493","X",3427452,3427523,71
"9312","FBgn0261573","X",19521929,19530896,8967
"9313","FBgn0032160","2L",9918618,9920120,1502
"9314","FBgn0261710","X",10461865,10474675,12810
"9315","FBgn0286032","3R",5042652,5043025,373
"9316","FBgn0003249","3R",20081060,20082450,1390
"9317","FBgn0025355","3L",11064991,11069025,4034
"9318","FBgn0266686","3L",20439600,20439921,321
"9319","FBgn0001565","X",21385518,21387946,2428
"9320","FBgn0030338","X",11837543,11838026,483
"9321","FBgn0261479","3R",31746445,31747558,1113
"9322","FBgn0053388","2R",19753189,19753323,134
"9323","FBgn0051813","2L",13736138,13737030,892
"9324","FBgn0016974","X",6361496,6363310,1814
"9325","FBgn0040347","X",941075,943229,2154
"9326","FBgn0267865","3R",14598223,14598517,294
"9327","FBgn0031466","2L",2834887,2837833,2946
"9328","FBgn0266846","2R",8558415,8558924,509
"9329","FBgn0086075","3L",9510720,9510807,87
"9330","FBgn0266138","2L",16006300,16006713,413
"9331","FBgn0024187","3L",7916650,7936120,19470
"9332","FBgn0260482","X",14243686,14246514,2828
"9333","FBgn0266346","2R",21692691,21697152,4461
"9334","FBgn0028491","X",3868973,3880379,11406
"9335","FBgn0039640","3R",29138662,29145787,7125
"9336","FBgn0259221","2R",13414978,13439051,24073
"9337","FBgn0031500","2L",3039976,3041890,1914
"9338","FBgn0032025","2L",8346620,8351112,4492
"9339","FBgn0020304","2L",833584,851071,17487
"9340","FBgn0004855","3R",14309089,14310178,1089
"9341","FBgn0053446","2R",19731768,19731902,134
"9342","FBgn0053666","X",6476243,6476967,724
"9343","FBgn0015520","3R",16640205,16643112,2907
"9344","FBgn0050212","2R",20000296,20000368,72
"9345","FBgn0082993","2R",11588183,11588331,148
"9346","FBgn0039259","3R",25024473,25025017,544
"9347","FBgn0038478","3R",17088280,17091938,3658
"9348","FBgn0031145","X",21035469,21041467,5998
"9349","FBgn0037565","3R",8293843,8300978,7135
"9350","FBgn0265727","X",9314685,9315171,486
"9351","FBgn0037801","3R",10251518,10255268,3750
"9352","FBgn0034277","2R",17764574,17767070,2496
"9353","FBgn0267035","X",2173480,2175855,2375
"9354","FBgn0031049","X",19643327,19644518,1191
"9355","FBgn0262251","X",19559022,19559120,98
"9356","FBgn0035528","3L",4291208,4292246,1038
"9357","FBgn0037777","3R",10044596,10045542,946
"9358","FBgn0030581","X",14826867,14832033,5166
"9359","FBgn0262420","3R",10408302,10408369,67
"9360","FBgn0040098","2L",8393489,8394280,791
"9361","FBgn0031467","2L",2838411,2839547,1136
"9362","FBgn0031298","2L",1080911,1085380,4469
"9363","FBgn0083047","3R",30206976,30207112,136
"9364","FBgn0260635","3L",16038410,16051034,12624
"9365","FBgn0035852","3L",8191522,8193116,1594
"9366","FBgn0266873","2L",21929064,21931698,2634
"9367","FBgn0003885","3R",7530753,7532732,1979
"9368","FBgn0259718","2R",16291453,16292269,816
"9369","FBgn0002914","X",15854832,15857823,2991
"9370","FBgn0030898","X",18178526,18179472,946
"9371","FBgn0033931","2R",14374462,14375385,923
"9372","FBgn0037630","3R",8794684,8796966,2282
"9373","FBgn0038788","3R",20328465,20330915,2450
"9374","FBgn0003922","2L",19815614,19815805,191
"9375","FBgn0265798","2L",12024056,12025202,1146
"9376","FBgn0264775","3R",15508896,15509917,1021
"9377","FBgn0053519","2R",23995543,24014254,18711
"9378","FBgn0069923","3R",3750363,3752353,1990
"9379","FBgn0028663","3L",21539862,21541215,1353
"9380","FBgn0267864","Y",3272835,3273532,697
"9381","FBgn0267892","Y",3203881,3204640,759
"9382","FBgn0038498","3R",17320004,17366119,46115
"9383","FBgn0027951","3R",5638655,5648738,10083
"9384","FBgn0262010","3R",23373703,23374245,542
"9385","FBgn0022960","2R",6975285,6985712,10427
"9386","FBgn0029529","X",620717,621215,498
"9387","FBgn0004575","3R",10190689,10222442,31753
"9388","FBgn0266900","2L",20487976,20488777,801
"9389","FBgn0263601","3L",16006552,16011812,5260
"9390","FBgn0265664","X",5433439,5435797,2358
"9391","FBgn0036334","3L",13016050,13016903,853
"9392","FBgn0039671","3R",29588993,29589762,769
"9393","FBgn0045479","3L",4026769,4028600,1831
"9394","FBgn0029148","3L",14801328,14802168,840
"9395","FBgn0053363","2R",19762427,19762570,143
"9396","FBgn0263622","3R",25791642,25792384,742
"9397","FBgn0037802","3R",10255349,10261849,6500
"9398","FBgn0051957","2L",3871271,3872458,1187
"9399","FBgn0036193","3L",11691571,11692757,1186
"9400","FBgn0265722","3L",4168239,4168846,607
"9401","FBgn0038834","3R",20850516,20851427,911
"9402","FBgn0050265","2R",22832456,22834580,2124
"9403","FBgn0262903","3R",19329736,19330836,1100
"9404","FBgn0263543","2R",23734033,23734141,108
"9405","FBgn0033431","2R",9589050,9590443,1393
"9406","FBgn0020638","3L",6134697,6135274,577
"9407","FBgn0031465","2L",2823546,2825506,1960
"9408","FBgn0037482","3R",7184101,7186673,2572
"9409","FBgn0026630","3L",19257282,19260679,3397
"9410","FBgn0053436","2R",19735510,19735644,134
"9411","FBgn0052255","3L",4035799,4037575,1776
"9412","FBgn0026317","3R",24130307,24134654,4347
"9413","FBgn0264791","3R",24519625,24520078,453
"9414","FBgn0266165","2L",16135365,16136204,839
"9415","FBgn0036093","3L",10641889,10643009,1120
"9416","FBgn0033985","2R",14942398,14944469,2071
"9417","FBgn0262609","X",4248377,4248657,280
"9418","FBgn0016013","3L",4072032,4073954,1922
"9419","FBgn0035375","3L",2782255,2786010,3755
"9420","FBgn0029504","X",7682338,7709385,27047
"9421","FBgn0285925","3R",16625238,16639771,14533
"9422","FBgn0034572","2R",21011970,21015628,3658
"9423","FBgn0051467","3R",10705170,10706863,1693
"9424","FBgn0033247","2R",7988462,7991283,2821
"9425","FBgn0016697","2R",17412767,17413769,1002
"9426","FBgn0039613","3R",28880792,28882945,2153
"9427","FBgn0050362","2R",8365550,8366688,1138
"9428","FBgn0267684","3R",14264829,14265535,706
"9429","FBgn0261261","3R",5685855,5712837,26982
"9430","FBgn0034968","2R",24060378,24061860,1482
"9431","FBgn0002715","2R",22122101,22124566,2465
"9432","FBgn0036688","3L",17024328,17027117,2789
"9433","FBgn0285963","3R",26915761,26945309,29548
"9434","FBgn0263536","2L",21263933,21264034,101
"9435","FBgn0032614","2L",16842300,16848716,6416
"9436","FBgn0053988","2R",24695378,24736657,41279
"9437","FBgn0036905","3L",19760409,19761817,1408
"9438","FBgn0040388","X",2444167,2470043,25876
"9439","FBgn0035475","3L",3936060,3937992,1932
"9440","FBgn0263650","3R",13815279,13815778,499
"9441","FBgn0011669","3R",25830720,25830914,194
"9442","FBgn0035714","3L",6752913,6754029,1116
"9443","FBgn0037116","3L",21674394,21679755,5361
"9444","FBgn0033735","2R",12425483,12426975,1492
"9445","FBgn0263667","2R",23898561,23903661,5100
"9446","FBgn0263607","3L",16234140,16236999,2859
"9447","FBgn0039663","3R",29484783,29489265,4482
"9448","FBgn0262891","3L",14536634,14537272,638
"9449","FBgn0051201","3R",20644154,20648716,4562
"9450","FBgn0024314","2L",1167172,1170365,3193
"9451","FBgn0037589","3R",8419822,8420597,775
"9452","FBgn0051538","3R",5275678,5277835,2157
"9453","FBgn0039473","3R",27018608,27019751,1143
"9454","FBgn0250908","3R",26645282,26681966,36684
"9455","FBgn0026370","2R",15380724,15387851,7127
"9456","FBgn0266321","2L",5947647,5948397,750
"9457","FBgn0004397","X",2214347,2222567,8220
"9458","FBgn0032751","2L",19064929,19069673,4744
"9459","FBgn0030350","X",11887284,11888240,956
"9460","FBgn0040609","3R",27291535,27292209,674
"9461","FBgn0266420","2R",18275607,18277177,1570
"9462","FBgn0039656","3R",29235322,29238723,3401
"9463","FBgn0263971","2L",11075513,11075962,449
"9464","FBgn0285938","3R",27366658,27368717,2059
"9465","FBgn0035316","3L",2210873,2212503,1630
"9466","FBgn0037310","3R",5300145,5301186,1041
"9467","FBgn0036402","3L",14031450,14034909,3459
"9468","FBgn0037057","3L",21202920,21208092,5172
"9469","FBgn0265635","2R",6820560,6822596,2036
"9470","FBgn0034528","2R",20620914,20623429,2515
"9471","FBgn0050461","2R",16995991,16998594,2603
"9472","FBgn0085436","2R",9566146,9579007,12861
"9473","FBgn0031057","X",19683808,19687658,3850
"9474","FBgn0033579","2R",11139304,11172206,32902
"9475","FBgn0266224","2L",21866854,21868020,1166
"9476","FBgn0033584","2R",11222871,11226746,3875
"9477","FBgn0036857","3L",19266473,19268913,2440
"9478","FBgn0261387","2R",4815426,4824319,8893
"9479","FBgn0039056","3R",23118400,23124217,5817
"9480","FBgn0030343","X",11855022,11864754,9732
"9481","FBgn0263322","2L",2620187,2620782,595
"9482","FBgn0266834","2L",4256798,4257295,497
"9483","FBgn0039795","3R",30690642,30692768,2126
"9484","FBgn0052600","X",14322226,14462351,140125
"9485","FBgn0051661","2L",1497243,1498583,1340
"9486","FBgn0035468","3L",3894999,3896603,1604
"9487","FBgn0265959","3L",20248080,20265554,17474
"9488","FBgn0039218","3R",24717511,24717998,487
"9489","FBgn0034184","2R",17048875,17053855,4980
"9490","FBgn0010263","2L",2954762,2968434,13672
"9491","FBgn0038952","3R",22372835,22375579,2744
"9492","FBgn0000606","2R",9979319,9980795,1476
"9493","FBgn0013720","X",1470666,1472325,1659
"9494","FBgn0267757","3R",22928593,22929129,536
"9495","FBgn0267592","Y",3649996,3666928,16932
"9496","FBgn0086073","3L",5720290,5720421,131
"9497","FBgn0283428","2R",18541144,18542454,1310
"9498","FBgn0050401","2R",21985626,21986938,1312
"9499","FBgn0038924","3R",22024259,22025506,1247
"9500","FBgn0039712","3R",29860055,29861494,1439
"9501","FBgn0030099","X",9192669,9193620,951
"9502","FBgn0266371","3R",10756673,10758280,1607
"9503","FBgn0259175","3L",14672839,14747868,75029
"9504","FBgn0039576","3R",28294048,28294550,502
"9505","FBgn0032178","2L",10060816,10063925,3109
"9506","FBgn0264475","3L",820759,821512,753
"9507","FBgn0266177","3R",21355692,21359768,4076
"9508","FBgn0014396","2L",3493986,3508119,14133
"9509","FBgn0265047","Y",3022289,3024024,1735
"9510","FBgn0086707","2L",18444507,18448957,4450
"9511","FBgn0265734","3L",10242799,10243242,443
"9512","FBgn0261838","3R",21360176,21362131,1955
"9513","FBgn0031174","X",21324046,21328150,4104
"9514","FBgn0038365","3R",15802275,15803653,1378
"9515","FBgn0267676","3R",12221039,12221630,591
"9516","FBgn0083956","X",21123634,21140951,17317
"9517","FBgn0036967","3L",20299410,20309511,10101
"9518","FBgn0026378","2R",19492087,19494125,2038
"9519","FBgn0029645","X",2943386,2944569,1183
"9520","FBgn0000173","X",13996345,13999805,3460
"9521","FBgn0032144","2L",9769060,9770409,1349
"9522","FBgn0264385","X",6995882,6997799,1917
"9523","FBgn0004428","3L",1212827,1213406,579
"9524","FBgn0033963","2R",14757907,14759602,1695
"9525","FBgn0038486","3R",17138999,17141168,2169
"9526","FBgn0003517","X",1481797,1483413,1616
"9527","FBgn0051721","2L",10544883,10628054,83171
"9528","FBgn0036726","3L",17465945,17466768,823
"9529","FBgn0033154","2R",7258867,7261269,2402
"9530","FBgn0265594","2R",18257096,18257595,499
"9531","FBgn0034505","2R",20341993,20342749,756
"9532","FBgn0037921","3R",11621466,11625644,4178
"9533","FBgn0026418","3L",14037019,14043686,6667
"9534","FBgn0262791","2R",10351533,10352161,628
"9535","FBgn0039006","3R",22698319,22700307,1988
"9536","FBgn0285892","2R",9891955,9898513,6558
"9537","FBgn0266727","4",776475,777146,671
"9538","FBgn0260776","3L",15717819,15720073,2254
"9539","FBgn0283432","X",20197319,20201933,4614
"9540","FBgn0027083","3R",14249043,14259991,10948
"9541","FBgn0051226","3R",18851305,18851798,493
"9542","FBgn0037734","3R",9705996,9711037,5041
"9543","FBgn0263522","2R",18720169,18720287,118
"9544","FBgn0034456","2R",19508167,19509653,1486
"9545","FBgn0022764","2R",12575240,12592917,17677
"9546","FBgn0053863","2L",21534636,21535164,528
"9547","FBgn0038755","3R",19929277,20008512,79235
"9548","FBgn0034921","2R",23888764,23890276,1512
"9549","FBgn0031734","2L",5733675,5741244,7569
"9550","FBgn0034365","2R",18621541,18622986,1445
"9551","FBgn0267431","3R",567076,2532932,1965856
"9552","FBgn0050278","2R",22217285,22218500,1215
"9553","FBgn0036442","3L",14728760,14729343,583
"9554","FBgn0052449","3L",21854094,21854165,71
"9555","FBgn0024491","3R",16186156,16189564,3408
"9556","FBgn0259742","2R",24607267,24610847,3580
"9557","FBgn0267493","Y",3336400,3337123,723
"9558","FBgn0050384","2R",7182997,7185298,2301
"9559","FBgn0264487","3L",21813005,21813698,693
"9560","FBgn0036497","3L",15484396,15485402,1006
"9561","FBgn0051221","3R",19412689,19460311,47622
"9562","FBgn0004188","3R",24556088,24556194,106
"9563","FBgn0035540","3L",4403487,4405168,1681
"9564","FBgn0027572","2R",17760940,17764541,3601
"9565","FBgn0086665","3R",30207745,30207883,138
"9566","FBgn0035945","3L",8968528,8971752,3224
"9567","FBgn0029994","X",8078350,8081605,3255
"9568","FBgn0033323","2R",8701835,8704502,2667
"9569","FBgn0052571","X",16731091,16732630,1539
"9570","FBgn0038919","3R",21913747,21915546,1799
"9571","FBgn0263741","2R",20788195,20789217,1022
"9572","FBgn0265737","3L",10784590,10785360,770
"9573","FBgn0031170","X",21292308,21306665,14357
"9574","FBgn0050250","2R",12334234,12334305,71
"9575","FBgn0263383","3R",6778117,6778952,835
"9576","FBgn0259246","2R",9503765,9541565,37800
"9577","FBgn0263389","3R",9652659,9653228,569
"9578","FBgn0035617","3L",5583669,5590390,6721
"9579","FBgn0039343","3R",25506275,25508279,2004
"9580","FBgn0026190","3R",30491813,30496153,4340
"9581","FBgn0031484","2L",2977122,2978500,1378
"9582","FBgn0262430","2L",16697924,16698015,91
"9583","FBgn0050359","2R",8462753,8465092,2339
"9584","FBgn0034925","2R",23896896,23898246,1350
"9585","FBgn0262579","3L",8063874,8108897,45023
"9586","FBgn0250862","X",13115131,13123066,7935
"9587","FBgn0265314","3R",27318328,27319246,918
"9588","FBgn0022724","X",18101970,18103482,1512
"9589","FBgn0036204","3L",11774060,11774501,441
"9590","FBgn0263093","4",905179,907924,2745
"9591","FBgn0003053","X",4617564,4627206,9642
"9592","FBgn0036372","3L",13483533,13486280,2747
"9593","FBgn0265313","2R",9138486,9141981,3495
"9594","FBgn0032336","2L",11076165,11081399,5234
"9595","FBgn0050419","2R",24212491,24229795,17304
"9596","FBgn0038234","3R",14511838,14512691,853
"9597","FBgn0000500","3R",4189692,4190260,568
"9598","FBgn0003313","2L",11484707,11486949,2242
"9599","FBgn0032176","2L",10026676,10029298,2622
"9600","FBgn0262172","2R",9621234,9621353,119
"9601","FBgn0052815","X",932466,939424,6958
"9602","FBgn0030737","X",16306912,16308667,1755
"9603","FBgn0263412","3R",31132330,31133050,720
"9604","FBgn0035812","3L",7719899,7726473,6574
"9605","FBgn0032075","2L",8937390,8939743,2353
"9606","FBgn0003448","2L",15476593,15478260,1667
"9607","FBgn0033659","2R",11864112,11866383,2271
"9608","FBgn0011300","2R",8952339,8962796,10457
"9609","FBgn0264329","2R",16937597,16938011,414
"9610","FBgn0037979","3R",12010772,12015059,4287
"9611","FBgn0039282","3R",25131306,25136709,5403
"9612","FBgn0025336","2R",23880817,23882927,2110
"9613","FBgn0262867","2R",6181748,6196320,14572
"9614","FBgn0014037","3L",19889120,19909410,20290
"9615","FBgn0264428","3R",22851088,22851804,716
"9616","FBgn0262233","3R",16618766,16618882,116
"9617","FBgn0266693","2L",19933636,19934317,681
"9618","FBgn0035318","3L",2235284,2237076,1792
"9619","FBgn0267137","3R",10896479,10897181,702
"9620","FBgn0028833","3R",26054237,26055438,1201
"9621","FBgn0035678","3L",6092188,6093313,1125
"9622","FBgn0259179","2R",22821430,22828903,7473
"9623","FBgn0263200","2L",6666264,6668033,1769
"9624","FBgn0043865","3L",1434336,1437872,3536
"9625","FBgn0264722","3L",10411907,10412377,470
"9626","FBgn0266901","2L",20484399,20487548,3149
"9627","FBgn0037780","3R",10049199,10051527,2328
"9628","FBgn0259676","3L",20359833,20361585,1752
"9629","FBgn0026563","3R",7054586,7058671,4085
"9630","FBgn0263534","X",569903,570003,100
"9631","FBgn0039165","3R",24193832,24196880,3048
"9632","FBgn0030638","X",15453471,15455551,2080
"9633","FBgn0035901","3L",8510003,8513007,3004
"9634","FBgn0051155","3R",15222251,15223180,929
"9635","FBgn0265168","3R",14109286,14110726,1440
"9636","FBgn0263001","3L",21829254,21830219,965
"9637","FBgn0062565","X",20094398,20095767,1369
"9638","FBgn0042137","3L",16369826,16370945,1119
"9639","FBgn0036621","3L",16370938,16378566,7628
"9640","FBgn0052687","X",10482028,10487205,5177
"9641","FBgn0038266","3R",14845043,14846737,1694
"9642","FBgn0263588","3R",29534636,29535354,718
"9643","FBgn0262682","X",12973825,12974615,790
"9644","FBgn0038558","3R",17906445,17907451,1006
"9645","FBgn0267514","X",23205258,23205380,122
"9646","FBgn0033268","2R",8134170,8135315,1145
"9647","FBgn0265194","2R",15262808,15309368,46560
"9648","FBgn0267183","X",12742547,12742926,379
"9649","FBgn0035388","3L",3035196,3040469,5273
"9650","FBgn0037185","3L",22728111,22733446,5335
"9651","FBgn0264261","2L",15522002,15523993,1991
"9652","FBgn0038631","3R",18616754,18617511,757
"9653","FBgn0263530","X",14199545,14199621,76
"9654","FBgn0025724","2L",13378902,13382382,3480
"9655","FBgn0265500","2R",14408453,14408960,507
"9656","FBgn0265903","X",17496669,17497388,719
"9657","FBgn0002622","3R",23358812,23360207,1395
"9658","FBgn0265374","2R",12246695,12246995,300
"9659","FBgn0085693","X",22251626,22252340,714
"9660","FBgn0262485","X",15220271,15221176,905
"9661","FBgn0038239","3R",14560935,14561521,586
"9662","FBgn0038789","3R",20338973,20343902,4929
"9663","FBgn0000253","2R",12259398,12278809,19411
"9664","FBgn0035499","3L",4114289,4122388,8099
"9665","FBgn0267033","X",13846116,13990527,144411
"9666","FBgn0264483","3L",16213928,16214376,448
"9667","FBgn0024177","3L",6604366,6606032,1666
"9668","FBgn0052150","3L",15837773,15844062,6289
"9669","FBgn0000018","2L",10973443,10975293,1850
"9670","FBgn0267017","2L",13104719,13105263,544
"9671","FBgn0038454","3R",16645072,16647004,1932
"9672","FBgn0085791","Y",3034052,3035310,1258
"9673","FBgn0000559","2L",21677913,21682164,4251
"9674","FBgn0026181","X",16624012,16637414,13402
"9675","FBgn0031317","2L",1170753,1172805,2052
"9676","FBgn0035909","3L",8534977,8538013,3036
"9677","FBgn0004427","3L",1210717,1211196,479
"9678","FBgn0016970","2R",9399080,9399899,819
"9679","FBgn0262398","2L",17566370,17566469,99
"9680","FBgn0022343","2R",24938181,24939769,1588
"9681","FBgn0031637","2L",4841482,4847295,5813
"9682","FBgn0052548","X",18435719,18440581,4862
"9683","FBgn0039500","3R",27246403,27247992,1589
"9684","FBgn0024958","3R",22721320,22724587,3267
"9685","FBgn0036549","3L",15968204,15969902,1698
"9686","FBgn0035413","3L",3189978,3190623,645
"9687","FBgn0031533","2L",3445992,3447589,1597
"9688","FBgn0010226","2R",17093246,17099501,6255
"9689","FBgn0051942","2L",1965426,1965498,72
"9690","FBgn0036125","3L",11093371,11096245,2874
"9691","FBgn0085313","3R",18902338,18902933,595
"9692","FBgn0030622","X",15228744,15229875,1131
"9693","FBgn0035753","3L",7240203,7241351,1148
"9694","FBgn0032521","2L",13398991,13411047,12056
"9695","FBgn0037280","3R",4816318,4817776,1458
"9696","FBgn0052383","3L",7438421,7439405,984
"9697","FBgn0031601","2L",4403251,4403955,704
"9698","FBgn0010877","3R",18288866,18298879,10013
"9699","FBgn0039859","3R",31615284,31616160,876
"9700","FBgn0262688","2L",20639015,20639578,563
"9701","FBgn0050069","2R",14185204,14198368,13164
"9702","FBgn0033141","2R",7070495,7074152,3657
"9703","FBgn0030441","X",13022198,13022949,751
"9704","FBgn0030486","X",13413242,13421024,7782
"9705","FBgn0284418","3R",11307669,11307886,217
"9706","FBgn0027590","2R",24766718,24768172,1454
"9707","FBgn0027364","3L",20788886,20792777,3891
"9708","FBgn0263649","2L",14293275,14295394,2119
"9709","FBgn0010620","2R",17394593,17405171,10578
"9710","FBgn0266796","2L",19327367,19327963,596
"9711","FBgn0022959","3L",12121274,12125150,3876
"9712","FBgn0267138","3R",10897985,10898581,596
"9713","FBgn0263092","2R",5081884,5082431,547
"9714","FBgn0266684","3L",23690626,23691668,1042
"9715","FBgn0262886","2L",22131221,22132435,1214
"9716","FBgn0267598","3L",18243700,18244239,539
"9717","FBgn0286199","3R",24279572,24281576,2004
"9718","FBgn0039629","3R",29052680,29053913,1233
"9719","FBgn0039673","3R",29598670,29600862,2192
"9720","FBgn0043470","2R",11336840,11337791,951
"9721","FBgn0040373","X",243954,245856,1902
"9722","FBgn0263498","3R",6127229,6127955,726
"9723","FBgn0035102","3L",175112,176228,1116
"9724","FBgn0051910","2L",6744663,6745622,959
"9725","FBgn0028530","2L",14347239,14348790,1551
"9726","FBgn0051469","3R",13709159,13709939,780
"9727","FBgn0263930","3L",8827505,8891192,63687
"9728","FBgn0024698","2R",14497347,14503488,6141
"9729","FBgn0004611","2L",305935,355566,49631
"9730","FBgn0263382","3R",26428590,26429173,583
"9731","FBgn0028743","2R",17792870,17800677,7807
"9732","FBgn0027539","3R",24805445,24814012,8567
"9733","FBgn0034592","2R",21142368,21143261,893
"9734","FBgn0028416","3L",18472143,18472384,241
"9735","FBgn0051098","3R",25291370,25292977,1607
"9736","FBgn0267543","3L",11667284,11667825,541
"9737","FBgn0030156","X",9874493,9876672,2179
"9738","FBgn0260938","X",15876368,15887311,10943
"9739","FBgn0266824","2L",2471644,2472978,1334
"9740","FBgn0040752","2R",14060456,14140902,80446
"9741","FBgn0264433","2L",2647886,2648361,475
"9742","FBgn0037705","3R",9535625,9551806,16181
"9743","FBgn0011883","2R",13431285,13431358,73
"9744","FBgn0033458","2R",9871470,9873646,2176
"9745","FBgn0041337","2L",2564886,2573037,8151
"9746","FBgn0028436","3R",5856585,5857914,1329
"9747","FBgn0283521","2R",10481894,10543291,61397
"9748","FBgn0265885","3L",18707933,18708692,759
"9749","FBgn0039965","X",23013495,23016586,3091
"9750","FBgn0001148","2R",25061964,25064643,2679
"9751","FBgn0052554","X",17851869,17852685,816
"9752","FBgn0013718","3L",14190870,14233250,42380
"9753","FBgn0265455","3L",12310805,12311961,1156
"9754","FBgn0030356","X",11917806,11918678,872
"9755","FBgn0265253","3R",24912995,24913685,690
"9756","FBgn0030914","X",18358881,18362527,3646
"9757","FBgn0260004","3R",21165167,21168205,3038
"9758","FBgn0051702","2L",22071144,22072902,1758
"9759","FBgn0032901","2L",20871335,20918931,47596
"9760","FBgn0039854","3R",31588673,31590392,1719
"9761","FBgn0031090","X",20155766,20159872,4106
"9762","FBgn0261112","3L",11098412,11100578,2166
"9763","FBgn0266183","X",19712934,19713821,887
"9764","FBgn0260742","3R",11964674,11967691,3017
"9765","FBgn0034097","2R",16236715,16237479,764
"9766","FBgn0035436","3L",3319555,3322489,2934
"9767","FBgn0000084","X",20171445,20173514,2069
"9768","FBgn0053875","2L",21519556,21520083,527
"9769","FBgn0031633","2L",4829214,4830693,1479
"9770","FBgn0011763","2R",13222433,13228202,5769
"9771","FBgn0038427","3R",16436880,16441661,4781
"9772","FBgn0032042","2L",8412144,8415256,3112
"9773","FBgn0024998","X",2711756,2713960,2204
"9774","FBgn0036178","3L",11599636,11599947,311
"9775","FBgn0029766","X",5429571,5432526,2955
"9776","FBgn0004914","2L",8687226,8709611,22385
"9777","FBgn0010651","2R",18796975,18803727,6752
"9778","FBgn0039686","3R",29718663,29722388,3725
"9779","FBgn0030160","X",9884442,9885044,602
"9780","FBgn0039676","3R",29666814,29668877,2063
"9781","FBgn0029719","X",4651955,4654497,2542
"9782","FBgn0043471","2R",11337797,11338733,936
"9783","FBgn0051797","2L",19259432,19262240,2808
"9784","FBgn0031977","2L",8029462,8030565,1103
"9785","FBgn0082959","3R",28601877,28602016,139
"9786","FBgn0003145","2L",12082995,12085827,2832
"9787","FBgn0027453","2L",10854435,10856644,2209
"9788","FBgn0267785","3R",30984809,30985135,326
"9789","FBgn0053922","2L",1343443,1344171,728
"9790","FBgn0039592","3R",28641585,28642891,1306
"9791","FBgn0033389","2R",9165632,9167670,2038
"9792","FBgn0029968","X",7884660,7886976,2316
"9793","FBgn0039326","3R",25321053,25322757,1704
"9794","FBgn0031948","2L",7786160,7790557,4397
"9795","FBgn0037606","3R",8664115,8667772,3657
"9796","FBgn0010380","X",19731004,19734581,3577
"9797","FBgn0015544","2R",24159384,24161503,2119
"9798","FBgn0029514","3L",1351116,1352853,1737
"9799","FBgn0050458","2R",17158325,17159038,713
"9800","FBgn0038968","3R",22440152,22446587,6435
"9801","FBgn0027086","3L",22288665,22292810,4145
"9802","FBgn0037894","3R",11412522,11416142,3620
"9803","FBgn0038455","3R",16651217,16652319,1102
"9804","FBgn0000055","2L",14615552,14618902,3350
"9805","FBgn0031990","2L",8134247,8159638,25391
"9806","FBgn0034379","2R",18705977,18708226,2249
"9807","FBgn0037449","3R",6527508,6528674,1166
"9808","FBgn0053867","2L",21539129,21541127,1998
"9809","FBgn0050457","2R",17160122,17160829,707
"9810","FBgn0005655","2R",20261754,20262883,1129
"9811","FBgn0032175","2L",10013227,10017463,4236
"9812","FBgn0039816","3R",31090712,31097321,6609
"9813","FBgn0266314","2L",19642330,19642601,271
"9814","FBgn0039254","3R",24945237,24947400,2163
"9815","FBgn0051099","3R",25309429,25310943,1514
"9816","FBgn0032058","2L",8681325,8684376,3051
"9817","FBgn0261804","2L",18159811,18275770,115959
"9818","FBgn0043025","3L",17754936,17764158,9222
"9819","FBgn0266837","2L",3508598,3509036,438
"9820","FBgn0034022","2R",15485953,15497231,11278
"9821","FBgn0012058","3L",7245481,7249340,3859
"9822","FBgn0267023","2R",9881396,9882605,1209
"9823","FBgn0041210","X",13262687,13285632,22945
"9824","FBgn0259875","Y",1007917,1009359,1442
"9825","FBgn0051867","2L",11144579,11145417,838
"9826","FBgn0036394","3L",13987878,13988626,748
"9827","FBgn0016685","3R",30004785,30010352,5567
"9828","FBgn0040022","3L",25107594,25115180,7586
"9829","FBgn0000277","3R",30212156,30212568,412
"9830","FBgn0266980","3L",22498310,22498839,529
"9831","FBgn0004426","3L",1210485,1210726,241
"9832","FBgn0264078","X",14839376,14933946,94570
"9833","FBgn0034670","2R",21951592,21952562,970
"9834","FBgn0267878","Y",3110839,3111104,265
"9835","FBgn0259099","3L",14903805,14942907,39102
"9836","FBgn0051912","2L",5769752,5771537,1785
"9837","FBgn0082979","3R",5596697,5596831,134
"9838","FBgn0031217","2L",102380,104142,1762
"9839","FBgn0266414","3R",10083381,10090525,7144
"9840","FBgn0034217","2R",17431032,17432219,1187
"9841","FBgn0034323","2R",18295928,18296656,728
"9842","FBgn0037039","3L",20961537,20962555,1018
"9843","FBgn0052404","3L",6141903,6142413,510
"9844","FBgn0037686","3R",9400237,9401226,989
"9845","FBgn0040391","X",2327128,2328941,1813
"9846","FBgn0025393","X",1512227,1512803,576
"9847","FBgn0011927","3L",14673942,14674013,71
"9848","FBgn0000337","2R",7782797,7785067,2270
"9849","FBgn0031947","2L",7782865,7786061,3196
"9850","FBgn0033155","2R",7272275,7278101,5826
"9851","FBgn0034310","2R",18164694,18167140,2446
"9852","FBgn0034295","2R",18052550,18054066,1516
"9853","FBgn0032650","2L",17554354,17555765,1411
"9854","FBgn0029913","X",6847877,6849517,1640
"9855","FBgn0051017","3R",30604181,30606144,1963
"9856","FBgn0265499","2R",14168844,14170917,2073
"9857","FBgn0262577","3R",26454794,26455112,318
"9858","FBgn0043001","X",12017225,12017961,736
"9859","FBgn0029971","X",7893053,7893798,745
"9860","FBgn0264988","2L",2424797,2425041,244
"9861","FBgn0265301","2R",8943495,8944295,800
"9862","FBgn0008651","3R",21409979,21434133,24154
"9863","FBgn0031463","2L",2814336,2815760,1424
"9864","FBgn0050082","2R",15685004,15686082,1078
"9865","FBgn0015283","3L",21537000,21538582,1582
"9866","FBgn0032166","2L",9938863,9943058,4195
"9867","FBgn0036769","3L",17891820,17895862,4042
"9868","FBgn0267585","2R",4621118,4622481,1363
"9869","FBgn0264266","2L",9848289,9848794,505
"9870","FBgn0039115","3R",23766519,23767488,969
"9871","FBgn0053489","3L",11574764,11577044,2280
"9872","FBgn0050087","2R",15692448,15693751,1303
"9873","FBgn0041248","2L",2669823,2672186,2363
"9874","FBgn0266240","3R",7740178,7740778,600
"9875","FBgn0036142","3L",11169817,11172411,2594
"9876","FBgn0004607","4",501810,540874,39064
"9877","FBgn0035704","3L",6491230,6495297,4067
"9878","FBgn0039068","3R",23258365,23260602,2237
"9879","FBgn0267244","2L",13458290,13458605,315
"9880","FBgn0035953","3L",8998184,9002566,4382
"9881","FBgn0262970","2R",4780311,4783646,3335
"9882","FBgn0030304","X",11477058,11483233,6175
"9883","FBgn0037493","3R",7271592,7272509,917
"9884","FBgn0030136","X",9554623,9555661,1038
"9885","FBgn0262598","2L",8316889,8319908,3019
"9886","FBgn0033919","2R",14261206,14267919,6713
"9887","FBgn0020279","2R",8067977,8078815,10838
"9888","FBgn0036395","3L",13997191,13998055,864
"9889","FBgn0266882","2L",8394429,8395332,903
"9890","FBgn0038337","3R",15402598,15407070,4472
"9891","FBgn0260005","3R",7891331,7901147,9816
"9892","FBgn0010762","3L",10664739,10690734,25995
"9893","FBgn0036934","3L",20058511,20089007,30496
"9894","FBgn0052023","3L",8803602,8804182,580
"9895","FBgn0035839","3L",8123612,8124531,919
"9896","FBgn0029866","X",6337762,6343731,5969
"9897","FBgn0043535","2R",20505150,20505758,608
"9898","FBgn0039595","3R",28737109,28744782,7673
"9899","FBgn0264743","2L",5043270,5048365,5095
"9900","FBgn0024994","X",2701124,2703852,2728
"9901","FBgn0033686","2R",12145710,12152752,7042
"9902","FBgn0037898","3R",11430061,11430762,701
"9903","FBgn0031729","2L",5678582,5679499,917
"9904","FBgn0265138","2L",1790617,1791823,1206
"9905","FBgn0051278","3R",10707398,10708340,942
"9906","FBgn0267706","3R",19191981,19193028,1047
"9907","FBgn0047205","3L",6976322,6979222,2900
"9908","FBgn0263022","3R",15833462,15834425,963
"9909","FBgn0026433","X",15468281,15472119,3838
"9910","FBgn0035216","3L",1411088,1413089,2001
"9911","FBgn0035904","3L",8518885,8520295,1410
"9912","FBgn0030039","X",8441247,8442348,1101
"9913","FBgn0032188","2L",10172702,10174090,1388
"9914","FBgn0066365","3L",4294004,4307718,13714
"9915","FBgn0011998","3R",7452060,7452132,72
"9916","FBgn0053178","X",15082827,15084017,1190
"9917","FBgn0267748","3R",28152964,28153752,788
"9918","FBgn0262510","2L",454754,455313,559
"9919","FBgn0053156","2R",13548244,13553240,4996
"9920","FBgn0034776","2R",22763706,22765422,1716
"9921","FBgn0036969","3L",20320952,20322358,1406
"9922","FBgn0031258","2L",458876,472200,13324
"9923","FBgn0003391","2R",21049654,21057197,7543
"9924","FBgn0050479","2R",14674465,14678136,3671
"9925","FBgn0039124","3R",23891597,23893383,1786
"9926","FBgn0051781","2L",16869346,16878300,8954
"9927","FBgn0039832","3R",31231685,31232336,651
"9928","FBgn0265633","4",44774,46074,1300
"9929","FBgn0038852","3R",21076862,21080926,4064
"9930","FBgn0033777","2R",12849358,12869423,20065
"9931","FBgn0050241","2R",14984327,14984408,81
"9932","FBgn0024973","X",2717638,2720327,2689
"9933","FBgn0012024","3R",8669081,8669174,93
"9934","FBgn0050039","2R",12050977,12051755,778
"9935","FBgn0266416","3R",11535495,11536273,778
"9936","FBgn0011284","3L",13041756,13044234,2478
"9937","FBgn0050109","2R",17670082,17670748,666
"9938","FBgn0265859","2R",20511095,20511595,500
"9939","FBgn0032162","2L",9921633,9922860,1227
"9940","FBgn0284444","3L",317084,317789,705
"9941","FBgn0040606","3R",26424698,26425105,407
"9942","FBgn0264961","2R",6047170,6047738,568
"9943","FBgn0053969","3L",20391685,20393553,1868
"9944","FBgn0267555","3L",16587111,16587805,694
"9945","FBgn0266235","3R",6765485,6766709,1224
"9946","FBgn0085644","Y",3265434,3266598,1164
"9947","FBgn0036661","3L",16780100,16782419,2319
"9948","FBgn0266409","3R",22726967,22732362,5395
"9949","FBgn0050488","2R",12846848,12848004,1156
"9950","FBgn0267809","3R",5662901,5665032,2131
"9951","FBgn0033352","2R",8928169,8933103,4934
"9952","FBgn0267236","3R",11418885,11419295,410
"9953","FBgn0051327","3R",14157560,14160278,2718
"9954","FBgn0085285","3L",18988736,18989815,1079
"9955","FBgn0032600","2L",16743405,16753704,10299
"9956","FBgn0025608","2L",18706010,18708688,2678
"9957","FBgn0266436","3L",3110128,3111227,1099
"9958","FBgn0004066","X",16276270,16277587,1317
"9959","FBgn0040513","2R",7443824,7445792,1968
"9960","FBgn0053416","2R",19742876,19743018,142
"9961","FBgn0036481","3L",15119878,15125321,5443
"9962","FBgn0283510","2R",9959549,9963853,4304
"9963","FBgn0032338","2L",11086721,11090973,4252
"9964","FBgn0029849","X",6219957,6222719,2762
"9965","FBgn0034956","2R",24014917,24017198,2281
"9966","FBgn0039518","3R",27464189,27467080,2891
"9967","FBgn0266070","2L",6231807,6232160,353
"9968","FBgn0042630","3L",14112405,14131324,18919
"9969","FBgn0039065","3R",23249443,23251477,2034
"9970","FBgn0267947","3L",22708936,22709918,982
"9971","FBgn0052285","3L",3096604,3096676,72
"9972","FBgn0033469","2R",9967231,9968388,1157
"9973","FBgn0027512","3R",23689007,23694983,5976
"9974","FBgn0050227","2R",18639557,18639628,71
"9975","FBgn0038034","3R",12396007,12398929,2922
"9976","FBgn0000404","3L",11826719,11833578,6859
"9977","FBgn0010314","2L",9330763,9331981,1218
"9978","FBgn0053850","2L",21513610,21514102,492
"9979","FBgn0053767","3L",22646307,22646959,652
"9980","FBgn0082931","2R",14623517,14623607,90
"9981","FBgn0037521","3R",7804665,7810014,5349
"9982","FBgn0266174","3R",21355692,21359768,4076
"9983","FBgn0031337","2L",1367996,1369050,1054
"9984","FBgn0035887","3L",8392820,8393649,829
"9985","FBgn0263095","2L",19517992,19518632,640
"9986","FBgn0086372","3R",7186994,7200941,13947
"9987","FBgn0011570","2L",1704902,1706962,2060
"9988","FBgn0051542","3R",5369540,5371744,2204
"9989","FBgn0035031","2R",24597995,24599091,1096
"9990","FBgn0019929","X",9865233,9867070,1837
"9991","FBgn0045800","2R",17699097,17703344,4247
"9992","FBgn0034455","2R",19503068,19504594,1526
"9993","FBgn0000119","2R",13453640,13483229,29589
"9994","FBgn0035868","3L",8302364,8304059,1695
"9995","FBgn0037981","3R",12017156,12018550,1394
"9996","FBgn0000394","X",5690002,5693084,3082
"9997","FBgn0267883","Y",3137617,3138026,409
"9998","FBgn0031961","2L",7883282,7887513,4231
"9999","FBgn0034099","2R",16240936,16241934,998
"10000","FBgn0265203","3R",31758710,31759360,650
"10001","FBgn0030107","X",9225437,9226688,1251
"10002","FBgn0031800","2L",6346430,6348427,1997
"10003","FBgn0053978","4",157575,175639,18064
"10004","FBgn0033047","2R",5957621,5960183,2562
"10005","FBgn0011849","2R",19727460,19727531,71
"10006","FBgn0011596","3R",23201644,23204034,2390
"10007","FBgn0051296","3R",15530072,15531473,1401
"10008","FBgn0010316","2R",9712321,9716256,3935
"10009","FBgn0004915","2L",10431338,10433116,1778
"10010","FBgn0035252","3L",1652750,1654238,1488
"10011","FBgn0000568","3L",17950953,18064696,113743
"10012","FBgn0030692","X",15786047,15788288,2241
"10013","FBgn0033926","2R",14357927,14360297,2370
"10014","FBgn0051266","3R",17132662,17133719,1057
"10015","FBgn0267432","Y",336381,563165,226784
"10016","FBgn0061209","2L",21423014,21423608,594
"10017","FBgn0267572","3L",18858690,18866107,7417
"10018","FBgn0030375","X",12102944,12103840,896
"10019","FBgn0051344","3R",15223378,15225329,1951
"10020","FBgn0266818","2R",7254602,7256696,2094
"10021","FBgn0262453","2L",7425795,7425892,97
"10022","FBgn0259842","211000022280481",1230,2419,1189
"10023","FBgn0040660","2R",23377866,23383424,5558
"10024","FBgn0021856","2L",21261168,21262411,1243
"10025","FBgn0035949","3L",8981795,8983212,1417
"10026","FBgn0031094","X",20170222,20171526,1304
"10027","FBgn0266973","3L",3244906,3245340,434
"10028","FBgn0028687","2R",7652440,7653954,1514
"10029","FBgn0036676","3L",16923252,16923994,742
"10030","FBgn0082937","2L",20648051,20648125,74
"10031","FBgn0051824","2L",15887905,15888583,678
"10032","FBgn0033087","2R",6670154,6673372,3218
"10033","FBgn0037668","3R",9256689,9257716,1027
"10034","FBgn0031661","2L",4975300,4977023,1723
"10035","FBgn0040343","X",846171,847157,986
"10036","FBgn0260659","3R",15196598,15203074,6476
"10037","FBgn0267696","3L",14420602,14421294,692
"10038","FBgn0259194","3R",23405509,23407402,1893
"10039","FBgn0002031","2L",19121345,19123869,2524
"10040","FBgn0040755","2R",12806614,12807811,1197
"10041","FBgn0051347","3R",12691733,12692597,864
"10042","FBgn0035050","2R",24691422,24694386,2964
"10043","FBgn0283471","X",18105568,18116922,11354
"10044","FBgn0035134","3L",356422,357664,1242
"10045","FBgn0262901","2R",5127249,5129296,2047
"10046","FBgn0034919","2R",23865414,23866654,1240
"10047","FBgn0011959","3R",8140970,8141042,72
"10048","FBgn0259994","X",5625676,5648487,22811
"10049","FBgn0032378","2L",11810092,11813780,3688
"10050","FBgn0052703","X",9261376,9267698,6322
"10051","FBgn0061359","2R",12634166,12636141,1975
"10052","FBgn0262139","3L",366524,392633,26109
"10053","FBgn0065035","X",15858134,15859487,1353
"10054","FBgn0267605","3L",20838313,20838700,387
"10055","FBgn0266211","2L",19740839,19742506,1667
"10056","FBgn0023542","X",2182818,2184668,1850
"10057","FBgn0025936","4",610684,622470,11786
"10058","FBgn0264819","4",395396,395954,558
"10059","FBgn0263550","3R",8308431,8308485,54
"10060","FBgn0263121","2R",7827303,7828678,1375
"10061","FBgn0052944","3R",4407227,4419578,12351
"10062","FBgn0032632","2L",17291075,17292202,1127
"10063","FBgn0039237","3R",24861659,24862165,506
"10064","FBgn0038084","3R",12746036,12783192,37156
"10065","FBgn0000459","X",16210598,16216750,6152
"10066","FBgn0051663","2L",1858609,1881480,22871
"10067","FBgn0265679","2L",18400462,18401232,770
"10068","FBgn0022238","2R",18154095,18158192,4097
"10069","FBgn0001133","2R",21009764,21011921,2157
"10070","FBgn0000286","2L",4876891,4883107,6216
"10071","FBgn0027546","X",5997508,6000797,3289
"10072","FBgn0053630","3R",10062624,10063327,703
"10073","FBgn0259176","2L",12455540,12546611,91071
"10074","FBgn0067622","2L",10403197,10405203,2006
"10075","FBgn0034300","2R",18094940,18101031,6091
"10076","FBgn0034712","2R",22208464,22210765,2301
"10077","FBgn0261239","2L",21237250,21259675,22425
"10078","FBgn0038731","3R",19775459,19777280,1821
"10079","FBgn0278608","X",16333612,16340624,7012
"10080","FBgn0286204","3R",8950246,8963037,12791
"10081","FBgn0264001","3L",13521907,13803400,281493
"10082","FBgn0027514","3R",6377349,6380328,2979
"10083","FBgn0283525","2L",1147822,1149449,1627
"10084","FBgn0032974","2L",22121338,22126614,5276
"10085","FBgn0083981","X",20590252,20623773,33521
"10086","FBgn0033159","2R",7317924,7381899,63975
"10087","FBgn0263539","2R",14005860,14006006,146
"10088","FBgn0030893","X",18093145,18097413,4268
"10089","FBgn0037667","3R",9255052,9256731,1679
"10090","FBgn0044811","2L",19911815,19912377,562
"10091","FBgn0082930","2R",14623764,14623850,86
"10092","FBgn0037973","3R",11978574,11980390,1816
"10093","FBgn0265863","2R",20540695,20541295,600
"10094","FBgn0037149","3L",22065907,22067216,1309
"10095","FBgn0030183","X",10205292,10212374,7082
"10096","FBgn0030846","X",17588865,17591706,2841
"10097","FBgn0033028","2R",5640915,5652815,11900
"10098","FBgn0010348","3L",22868380,22872231,3851
"10099","FBgn0010043","3R",12378500,12379255,755
"10100","FBgn0054024","3R",25931401,25932016,615
"10101","FBgn0264790","3R",8934279,8935287,1008
"10102","FBgn0051200","3R",20744234,20745338,1104
"10103","FBgn0037647","3R",8982732,8984315,1583
"10104","FBgn0261885","3R",17687818,17718350,30532
"10105","FBgn0052194","3L",18085305,18087058,1753
"10106","FBgn0035152","3L",680436,682470,2034
"10107","FBgn0003339","3R",6823120,6849981,26861
"10108","FBgn0014380","3R",9497101,9502581,5480
"10109","FBgn0262987","3L",16105852,16106428,576
"10110","FBgn0039160","3R",24167675,24169562,1887
"10111","FBgn0015831","3R",7528864,7530241,1377
"10112","FBgn0082926","2R",14622570,14622649,79
"10113","FBgn0052376","3L",7541582,7542457,875
"10114","FBgn0053882","2L",21502798,21503392,594
"10115","FBgn0051202","3R",29928701,29930386,1685
"10116","FBgn0036181","3L",11610578,11620101,9523
"10117","FBgn0034467","2R",19685614,19688078,2464
"10118","FBgn0035735","3L",7086003,7086608,605
"10119","FBgn0082986","3R",20822926,20823060,134
"10120","FBgn0267304","3L",4799989,4800330,341
"10121","FBgn0019940","3R",15483158,15484699,1541
"10122","FBgn0264264","2L",15295636,15297699,2063
"10123","FBgn0033624","2R",11357902,11359176,1274
"10124","FBgn0037912","3R",11559896,11567054,7158
"10125","FBgn0266670","2L",3457302,3460367,3065
"10126","FBgn0032408","2L",12095176,12096511,1335
"10127","FBgn0284251","2L",21094966,21102429,7463
"10128","FBgn0029768","X",5446656,5494012,47356
"10129","FBgn0033117","2R",6923366,6924929,1563
"10130","FBgn0086668","X",6742686,6742826,140
"10131","FBgn0037131","3L",21757157,21758046,889
"10132","FBgn0037578","3R",8341661,8343516,1855
"10133","FBgn0259162","X",20538497,20567097,28600
"10134","FBgn0031544","2L",3514872,3517264,2392
"10135","FBgn0034804","2R",22938987,22941169,2182
"10136","FBgn0259237","3R",21758764,21769301,10537
"10137","FBgn0051816","2L",16542546,16543263,717
"10138","FBgn0267487","3L",1342493,1475257,132764
"10139","FBgn0053371","2R",19759474,19759610,136
"10140","FBgn0033194","2R",7566809,7580675,13866
"10141","FBgn0053409","2R",19745462,19745596,134
"10142","FBgn0036083","3L",10429689,10431983,2294
"10143","FBgn0023407","2L",13500624,13549328,48704
"10144","FBgn0032127","2L",9545811,9547424,1613
"10145","FBgn0259233","3R",24772181,24784562,12381
"10146","FBgn0002707","X",4314230,4318801,4571
"10147","FBgn0051294","3R",15715505,15716585,1080
"10148","FBgn0032517","2L",13387571,13393959,6388
"10149","FBgn0052024","3L",8807601,8808407,806
"10150","FBgn0039904","4",359938,375554,15616
"10151","FBgn0035083","2R",24940625,24942413,1788
"10152","FBgn0037698","3R",9461084,9493677,32593
"10153","FBgn0267993","2L",721985,724833,2848
"10154","FBgn0264379","2R",15159196,15159545,349
"10155","FBgn0031150","X",21053963,21082391,28428
"10156","FBgn0036871","3L",19466567,19467079,512
"10157","FBgn0031127","X",20661917,20669669,7752
"10158","FBgn0086601","3L",13043371,13043510,139
"10159","FBgn0266743","3R",24835604,24836238,634
"10160","FBgn0051635","2L",6632798,6649114,16316
"10161","FBgn0034063","2R",16008339,16013815,5476
"10162","FBgn0266392","2R",13673970,13674633,663
"10163","FBgn0058461","2R",3590030,3590420,390
"10164","FBgn0034417","2R",19122231,19129300,7069
"10165","FBgn0028424","2R",16289320,16291333,2013
"10166","FBgn0266381","3R",20358839,20360281,1442
"10167","FBgn0029751","X",5306261,5307417,1156
"10168","FBgn0266722","3R",15350345,15350995,650
"10169","FBgn0082954","3R",5597596,5597739,143
"10170","FBgn0000543","3L",2263581,2265857,2276
"10171","FBgn0053299","2L",9656600,9657424,824
"10172","FBgn0263023","3R",15832708,15833432,724
"10173","FBgn0063667","3L",1201871,1203036,1165
"10174","FBgn0033990","2R",14992332,14993835,1503
"10175","FBgn0039111","3R",23758339,23759606,1267
"10176","FBgn0036949","3L",20204309,20206046,1737
"10177","FBgn0085473","2R",14369217,14370326,1109
"10178","FBgn0038332","3R",15370036,15372212,2176
"10179","FBgn0265855","2R",20505895,20506395,500
"10180","FBgn0051804","2L",17363496,17364351,855
"10181","FBgn0036186","3L",11642906,11646033,3127
"10182","FBgn0262788","3L",8888145,8888633,488
"10183","FBgn0033170","2R",7442864,7443827,963
"10184","FBgn0032315","2L",10910051,10910648,597
"10185","FBgn0032161","2L",9920160,9921459,1299
"10186","FBgn0036856","3L",19263766,19266838,3072
"10187","FBgn0025686","2L",287252,289144,1892
"10188","FBgn0260453","2L",10843014,10845664,2650
"10189","FBgn0053310","2L",15026882,15029513,2631
"10190","FBgn0265847","2R",20137894,20138245,351
"10191","FBgn0030813","X",17078836,17081237,2401
"10192","FBgn0039338","3R",25477868,25482834,4966
"10193","FBgn0262976","X",8408008,8411658,3650
"10194","FBgn0034229","2R",17511513,17513855,2342
"10195","FBgn0266909","2L",628729,629052,323
"10196","FBgn0266858","2R",11992565,11996095,3530
"10197","FBgn0265338","2R",9708696,9710496,1800
"10198","FBgn0028429","3L",9834367,9836805,2438
"10199","FBgn0053372","2R",19759101,19759235,134
"10200","FBgn0085425","2R",21092222,21101453,9231
"10201","FBgn0032095","2L",9084107,9089440,5333
"10202","FBgn0267204","3R",21860748,21860978,230
"10203","FBgn0030684","X",15756318,15757767,1449
"10204","FBgn0039838","3R",31257599,31260049,2450
"10205","FBgn0267012","2L",9325845,9326721,876
"10206","FBgn0025574","3R",23860162,23890052,29890
"10207","FBgn0037529","3R",7889277,7902667,13390
"10208","FBgn0040733","2R",18390353,18390629,276
"10209","FBgn0083991","3R",30554554,30560199,5645
"10210","FBgn0265965","X",385558,386274,716
"10211","FBgn0053816","2L",21456113,21457135,1022
"10212","FBgn0032074","2L",8933962,8936096,2134
"10213","FBgn0051506","3R",20604749,20604832,83
"10214","FBgn0038679","3R",19096961,19131929,34968
"10215","FBgn0051231","3R",18665361,18667733,2372
"10216","FBgn0037762","3R",9814161,9815158,997
"10217","FBgn0265161","3R",10682632,10684424,1792
"10218","FBgn0265697","2R",19659645,19661847,2202
"10219","FBgn0267539","3L",10127635,10128618,983
"10220","FBgn0267289","2L",11074471,11074898,427
"10221","FBgn0267219","3L",22840293,22841302,1009
"10222","FBgn0039507","3R",27277249,27282661,5412
"10223","FBgn0283479","3L",21442227,21444819,2592
"10224","FBgn0262955","3R",14125791,14130111,4320
"10225","FBgn0266034","2L",7636113,7636608,495
"10226","FBgn0264540","2R",14553765,14554309,544
"10227","FBgn0050105","2R",17591804,17592509,705
"10228","FBgn0264872","2L",7369646,7370503,857
"10229","FBgn0003888","2R",24305881,24313099,7218
"10230","FBgn0051131","3R",27961992,27963219,1227
"10231","FBgn0030768","X",16653220,16655015,1795
"10232","FBgn0019661","X",3857230,3862697,5467
"10233","FBgn0030858","X",17652761,17656818,4057
"10234","FBgn0263582","2L",20437264,20438701,1437
"10235","FBgn0031701","2L",5329857,5330464,607
"10236","FBgn0267109","3R",8233228,8233962,734
"10237","FBgn0034997","2R",24258013,24265213,7200
"10238","FBgn0267510","rDNA",16526,16555,29
"10239","FBgn0037794","3R",10159144,10161331,2187
"10240","FBgn0083053","2R",18143000,18143142,142
"10241","FBgn0260499","2R",11442505,11451604,9099
"10242","FBgn0000241","2R",23527805,23538499,10694
"10243","FBgn0030283","X",11248236,11248885,649
"10244","FBgn0051105","3R",24857585,24859801,2216
"10245","FBgn0267815","3R",4309944,4310869,925
"10246","FBgn0011802","3L",10459081,10463101,4020
"10247","FBgn0001079","X",18657755,18661204,3449
"10248","FBgn0031611","2L",4465174,4468022,2848
"10249","FBgn0082983","3R",30207898,30208039,141
"10250","FBgn0085342","2L",16879517,16886319,6802
"10251","FBgn0040206","3R",32045314,32051993,6679
"10252","FBgn0267172","X",21372593,21373553,960
"10253","FBgn0000071","3R",6762593,6765261,2668
"10254","FBgn0029922","X",6908277,6968829,60552
"10255","FBgn0267158","3R",14923203,14923761,558
"10256","FBgn0020443","2L",12434452,12441279,6827
"10257","FBgn0033767","2R",12686249,12688786,2537
"10258","FBgn0030025","X",8240684,8241483,799
"10259","FBgn0266894","2L",16534057,16534488,431
"10260","FBgn0031529","2L",3375832,3376737,905
"10261","FBgn0036278","3L",12339116,12351544,12428
"10262","FBgn0051579","3R",17646368,17646440,72
"10263","FBgn0002941","3R",21548661,21557182,8521
"10264","FBgn0266170","3R",21362968,21365290,2322
"10265","FBgn0039266","3R",25049616,25053074,3458
"10266","FBgn0263986","3R",22694959,22697990,3031
"10267","FBgn0038217","3R",14260208,14261213,1005
"10268","FBgn0017457","2L",292959,294681,1722
"10269","FBgn0264431","3R",15667978,15668676,698
"10270","FBgn0264788","3R",10639279,10645773,6494
"10271","FBgn0035547","3L",4459193,4460317,1124
"10272","FBgn0039487","3R",27108467,27112270,3803
"10273","FBgn0267498","rDNA",55965,57959,1994
"10274","FBgn0262379","3R",26861349,26861407,58
"10275","FBgn0031462","2L",2812437,2814429,1992
"10276","FBgn0052206","3L",19340321,19412912,72591
"10277","FBgn0036274","3L",12290956,12296123,5167
"10278","FBgn0264565","2L",11839298,11839660,362
"10279","FBgn0264567","3L",21576033,21577219,1186
"10280","FBgn0033403","2R",9309296,9351655,42359
"10281","FBgn0003278","2L",404285,407969,3684
"10282","FBgn0030587","X",14846472,14848808,2336
"10283","FBgn0030011","X",8150731,8152275,1544
"10284","FBgn0265629","X",13201170,13202262,1092
"10285","FBgn0051300","3R",25283620,25285224,1604
"10286","FBgn0005355","3R",12689873,12691468,1595
"10287","FBgn0031598","2L",4382925,4386062,3137
"10288","FBgn0051151","3R",22710883,22721150,10267
"10289","FBgn0262985","3L",6185189,6185853,664
"10290","FBgn0262372","2R",19661595,19661663,68
"10291","FBgn0027291","X",19518428,19521810,3382
"10292","FBgn0004198","X",7608428,7678859,70431
"10293","FBgn0037298","3R",5221632,5223365,1733
"10294","FBgn0037570","3R",8308881,8310778,1897
"10295","FBgn0030109","X",9228796,9232378,3582
"10296","FBgn0061362","2R",20642466,20643785,1319
"10297","FBgn0031249","2L",320279,321248,969
"10298","FBgn0030432","X",12903745,12906018,2273
"10299","FBgn0032670","2L",18156043,18157162,1119
"10300","FBgn0265074","2L",135402,136128,726
"10301","FBgn0267339","3R",24149020,24150203,1183
"10302","FBgn0034959","2R",24022343,24023981,1638
"10303","FBgn0002633","3R",26037038,26038019,981
"10304","FBgn0267986","2L",23239253,23240411,1158
"10305","FBgn0032471","2L",13130591,13134804,4213
"10306","FBgn0052066","3L",10640286,10661013,20727
"10307","FBgn0264308","2L",13301814,13331121,29307
"10308","FBgn0030643","X",15467891,15468303,412
"10309","FBgn0030529","X",13812971,13822307,9336
"10310","FBgn0085353","X",13456534,13457663,1129
"10311","FBgn0259242","X",6423123,6524323,101200
"10312","FBgn0261020","2L",8301345,8302985,1640
"10313","FBgn0037485","3R",7214339,7217083,2744
"10314","FBgn0015396","3R",10350182,10361612,11430
"10315","FBgn0038467","3R",17018780,17021120,2340
"10316","FBgn0032753","2L",19071131,19074149,3018
"10317","FBgn0015778","3R",13647004,13654527,7523
"10318","FBgn0086690","3L",15066081,15094724,28643
"10319","FBgn0030277","X",11169811,11170678,867
"10320","FBgn0034923","2R",23893066,23894987,1921
"10321","FBgn0039252","3R",24932010,24934919,2909
"10322","FBgn0037572","3R",8312188,8313097,909
"10323","FBgn0037431","3R",6341968,6342873,905
"10324","FBgn0020372","2R",23878197,23880860,2663
"10325","FBgn0267492","Y",3327556,3328279,723
"10326","FBgn0038645","3R",18725399,18726434,1035
"10327","FBgn0032382","2L",11849958,11852881,2923
"10328","FBgn0010638","2R",14618771,14619681,910
"10329","FBgn0051940","2L",2010869,2010940,71
"10330","FBgn0083120","3L",20453293,20454731,1438
"10331","FBgn0040688","3L",97628,98375,747
"10332","FBgn0025678","2L",16354886,16356735,1849
"10333","FBgn0039417","3R",26187018,26188807,1789
"10334","FBgn0085282","3L",18086674,18087320,646
"10335","FBgn0029715","X",4553117,4554398,1281
"10336","FBgn0003328","2R",15248784,15258498,9714
"10337","FBgn0027359","X",11368445,11369283,838
"10338","FBgn0264268","X",16888842,16889635,793
"10339","FBgn0262140","2L",19961224,19961685,461
"10340","FBgn0027784","3R",19029968,19031271,1303
"10341","FBgn0030348","X",11875306,11877168,1862
"10342","FBgn0035751","3L",7236800,7238122,1322
"10343","FBgn0267634","3L",22197783,22198241,458
"10344","FBgn0266620","2R",6508895,6510295,1400
"10345","FBgn0031955","2L",7844905,7855475,10570
"10346","FBgn0267779","3R",29774324,29775051,727
"10347","FBgn0038647","3R",18732681,18733034,353
"10348","FBgn0038344","3R",15486050,15493310,7260
"10349","FBgn0036417","3L",14236635,14238272,1637
"10350","FBgn0034540","2R",20646360,20661070,14710
"10351","FBgn0032740","2L",19022417,19023646,1229
"10352","FBgn0034624","2R",21348945,21350578,1633
"10353","FBgn0031194","X",22534831,22540383,5552
"10354","FBgn0263845","3L",20795916,20796502,586
"10355","FBgn0037139","3L",21841808,21842386,578
"10356","FBgn0085202","2L",22053834,22054302,468
"10357","FBgn0014024","X",5318928,5322696,3768
"10358","FBgn0262896","3L",20758883,20759192,309
"10359","FBgn0050249","2R",12333926,12333997,71
"10360","FBgn0264272","3L",1200786,1232700,31914
"10361","FBgn0265193","2R",24870108,24871509,1401
"10362","FBgn0042180","2R",21613845,21616907,3062
"10363","FBgn0261844","3R",21365609,21370249,4640
"10364","FBgn0028526","2L",14108057,14109447,1390
"10365","FBgn0004597","3R",14889004,14890205,1201
"10366","FBgn0260486","2L",7472513,7496307,23794
"10367","FBgn0025634","X",644761,646386,1625
"10368","FBgn0035630","3L",5761963,5765702,3739
"10369","FBgn0263657","2L",605914,606412,498
"10370","FBgn0036022","3L",9638112,9639021,909
"10371","FBgn0265673","2L",11662002,11662404,402
"10372","FBgn0034920","2R",23886973,23888777,1804
"10373","FBgn0032780","2L",19424050,19430270,6220
"10374","FBgn0053221","X",3797497,3799028,1531
"10375","FBgn0035041","2R",24615423,24638588,23165
"10376","FBgn0029158","3L",20430605,20432361,1756
"10377","FBgn0042207","3R",12633359,12634670,1311
"10378","FBgn0262581","3L",14671935,14672437,502
"10379","FBgn0039296","3R",25233636,25235529,1893
"10380","FBgn0263615","3L",11898605,11900431,1826
"10381","FBgn0030061","X",8714936,8717065,2129
"10382","FBgn0028991","2R",13176553,13190086,13533
"10383","FBgn0082967","3L",13042767,13042906,139
"10384","FBgn0086768","3R",5552823,5554316,1493
"10385","FBgn0265362","X",6686963,6687420,457
"10386","FBgn0030440","X",13003955,13004879,924
"10387","FBgn0030163","X",9963453,9964878,1425
"10388","FBgn0031757","2L",5968566,5969761,1195
"10389","FBgn0032138","2L",9708921,9711271,2350
"10390","FBgn0265703","3L",69138,69894,756
"10391","FBgn0041004","2L",22844220,22854541,10321
"10392","FBgn0034657","2R",21720495,21724055,3560
"10393","FBgn0029700","X",4251870,4252790,920
"10394","FBgn0262605","3R",5108678,5109178,500
"10395","FBgn0033378","2R",9110799,9111578,779
"10396","FBgn0028944","2L",15612494,15613335,841
"10397","FBgn0050158","2R",6891760,6922613,30853
"10398","FBgn0267667","3L",6125405,6129890,4485
"10399","FBgn0037378","3R",5793308,5794317,1009
"10400","FBgn0264502","X",10905767,10923436,17669
"10401","FBgn0001995","2L",16328059,16329132,1073
"10402","FBgn0034335","2R",18398393,18399223,830
"10403","FBgn0037017","3L",20768207,20769482,1275
"10404","FBgn0028935","2L",15876938,15880156,3218
"10405","FBgn0044419","3L",5780051,5784685,4634
"10406","FBgn0030374","X",12086469,12087025,556
"10407","FBgn0031304","2L",1129316,1132411,3095
"10408","FBgn0053679","2L",15058303,15059120,817
"10409","FBgn0029979","X",7922158,7931382,9224
"10410","FBgn0003390","X",6771463,6779659,8196
"10411","FBgn0052569","X",16738178,16738868,690
"10412","FBgn0035101","3L",152884,174517,21633
"10413","FBgn0038769","3R",20033881,20036056,2175
"10414","FBgn0266877","2L",3261638,3262007,369
"10415","FBgn0050029","2R",11246105,11246654,549
"10416","FBgn0011770","X",10328877,10329872,995
"10417","FBgn0265089","3L",8229224,8230568,1344
"10418","FBgn0260653","3L",19700977,19708015,7038
"10419","FBgn0031791","2L",6255859,6256822,963
"10420","FBgn0028981","2R",19414598,19414679,81
"10421","FBgn0083058","3L",833062,833209,147
"10422","FBgn0030574","X",14584733,14602580,17847
"10423","FBgn0267066","X",21480757,21481124,367
"10424","FBgn0030293","X",11350608,11355539,4931
"10425","FBgn0034381","2R",18727817,18730281,2464
"10426","FBgn0265064","3R",19326816,19327560,744
"10427","FBgn0040636","3L",20837488,20838839,1351
"10428","FBgn0000206","3R",25961994,25966948,4954
"10429","FBgn0033775","2R",12840813,12842558,1745
"10430","FBgn0266281","X",765288,766100,812
"10431","FBgn0263611","2L",19978829,19979723,894
"10432","FBgn0265316","3R",27535831,27537903,2072
"10433","FBgn0003257","3R",21070557,21073319,2762
"10434","FBgn0038151","3R",13405109,13406998,1889
"10435","FBgn0034546","2R",20727829,20730610,2781
"10436","FBgn0031364","2L",1752308,1752848,540
"10437","FBgn0036987","3L",20426199,20427666,1467
"10438","FBgn0029681","X",3884168,3890486,6318
"10439","FBgn0051974","2L",141077,143091,2014
"10440","FBgn0035546","3L",4457177,4458163,986
"10441","FBgn0028473","2R",9396265,9398734,2469
"10442","FBgn0266358","2L",1345965,1346331,366
"10443","FBgn0039232","3R",24833952,24840488,6536
"10444","FBgn0030892","X",18088725,18090509,1784
"10445","FBgn0051373","3R",10708487,10709364,877
"10446","FBgn0003654","X",20227961,20236382,8421
"10447","FBgn0037085","3L",21484891,21490586,5695
"10448","FBgn0260487","3R",27340622,27372574,31952
"10449","FBgn0030584","X",14837471,14838198,727
"10450","FBgn0005561","4",1088798,1113317,24519
"10451","FBgn0267741","X",20359752,20360046,294
"10452","FBgn0266656","3L",22738708,22739434,726
"10453","FBgn0032281","2L",10681902,10682528,626
"10454","FBgn0038740","3R",19865417,19875678,10261
"10455","FBgn0032729","2L",18971993,18974448,2455
"10456","FBgn0266797","2L",799856,800323,467
"10457","FBgn0053113","2L",4992808,5009720,16912
"10458","FBgn0051548","3R",5635901,5636852,951
"10459","FBgn0052671","X",10950160,10951030,870
"10460","FBgn0266031","2L",5619794,5620280,486
"10461","FBgn0025682","3L",1298672,1300389,1717
"10462","FBgn0267849","3L",21445834,21448128,2294
"10463","FBgn0026562","3R",26869238,26871995,2757
"10464","FBgn0263482","2R",10536950,10537120,170
"10465","FBgn0000636","2L",18320102,18393441,73339
"10466","FBgn0029088","3R",5849697,5856311,6614
"10467","FBgn0266955","3L",9875731,9876406,675
"10468","FBgn0063376","2R",17700741,17700813,72
"10469","FBgn0053806","2L",21430255,21430783,528
"10470","FBgn0086042","X",1482559,1482629,70
"10471","FBgn0266694","3L",826720,830190,3470
"10472","FBgn0265608","X",20978286,20978868,582
"10473","FBgn0038087","3R",12840560,12848419,7859
"10474","FBgn0029606","X",2223754,2224969,1215
"10475","FBgn0264445","X",151691,152279,588
"10476","FBgn0011230","2L",8054322,8071624,17302
"10477","FBgn0023179","3R",26697697,26714159,16462
"10478","FBgn0038721","3R",19633418,19642722,9304
"10479","FBgn0039110","3R",23750937,23752834,1897
"10480","FBgn0034372","2R",18658418,18661548,3130
"10481","FBgn0036789","3L",18485137,18502557,17420
"10482","FBgn0035173","3L",877291,882013,4722
"10483","FBgn0035299","3L",1970191,1971200,1009
"10484","FBgn0013676","mitochondrion_genome",4736,5524,788
"10485","FBgn0086051","3R",5625367,5625441,74
"10486","FBgn0028970","2L",2879112,2880708,1596
"10487","FBgn0067779","2L",66482,71390,4908
"10488","FBgn0051643","2L",6038117,6041283,3166
"10489","FBgn0035997","3L",9452803,9456281,3478
"10490","FBgn0036964","3L",20295802,20296971,1169
"10491","FBgn0039601","3R",28817342,28819668,2326
"10492","FBgn0003124","3L",20309654,20313466,3812
"10493","FBgn0032026","2L",8355678,8362469,6791
"10494","FBgn0038839","3R",20894452,20897320,2868
"10495","FBgn0262117","2R",4235779,4242934,7155
"10496","FBgn0039354","3R",25665809,25677214,11405
"10497","FBgn0262373","3L",19565131,19565208,77
"10498","FBgn0285913","3R",14289071,14302276,13205
"10499","FBgn0027786","3L",184626,186310,1684
"10500","FBgn0030707","X",15921955,15924558,2603
"10501","FBgn0267231","3L",11593447,11593709,262
"10502","FBgn0259482","2L",10265336,10266570,1234
"10503","FBgn0028327","X",9551140,9553750,2610
"10504","FBgn0024326","3R",8646172,8650796,4624
"10505","FBgn0267621","3L",21904173,21904862,689
"10506","FBgn0030443","X",13052847,13055328,2481
"10507","FBgn0038394","3R",16043498,16044832,1334
"10508","FBgn0033802","2R",13176094,13190086,13992
"10509","FBgn0039451","3R",26719847,26725216,5369
"10510","FBgn0260953","2L",14739914,14741138,1224
"10511","FBgn0031399","2L",2217290,2220625,3335
"10512","FBgn0085494","211000022278449",528,1635,1107
"10513","FBgn0032663","2L",18090737,18092256,1519
"10514","FBgn0262874","X",18138542,18139000,458
"10515","FBgn0035193","3L",1237133,1238319,1186
"10516","FBgn0250847","2L",5215189,5216542,1353
"10517","FBgn0028398","2L",2767890,2768612,722
"10518","FBgn0032419","2L",12170550,12171232,682
"10519","FBgn0086365","3R",24273029,24275728,2699
"10520","FBgn0029755","X",5317409,5319071,1662
"10521","FBgn0039630","3R",29054347,29055837,1490
"10522","FBgn0029589","X",1819495,1820341,846
"10523","FBgn0085437","X",10220110,10230088,9978
"10524","FBgn0267545","3L",11687344,11688390,1046
"10525","FBgn0000153","2L",13821248,13823979,2731
"10526","FBgn0267941","3R",6037787,6038372,585
"10527","FBgn0033371","2R",9082395,9085717,3322
"10528","FBgn0267032","X",968496,968741,245
"10529","FBgn0035665","3L",6050757,6051690,933
"10530","FBgn0033337","2R",8888404,8891401,2997
"10531","FBgn0030294","X",11359236,11360929,1693
"10532","FBgn0039444","3R",26640025,26641054,1029
"10533","FBgn0035586","3L",5144082,5146063,1981
"10534","FBgn0037368","3R",5733513,5734702,1189
"10535","FBgn0036598","3L",16301453,16302027,574
"10536","FBgn0085411","3L",9878985,9884493,5508
"10537","FBgn0052205","3L",19420390,19424183,3793
"10538","FBgn0053092","3R",21877936,21880696,2760
"10539","FBgn0262524","3L",12523987,12525150,1163
"10540","FBgn0042712","3L",1862881,1865240,2359
"10541","FBgn0034869","2R",23499651,23500702,1051
"10542","FBgn0053061","3L",16329795,16331227,1432
"10543","FBgn0265953","2L",18945700,18946154,454
"10544","FBgn0265038","3R",4646433,4648242,1809
"10545","FBgn0041150","2L",4908581,4932384,23803
"10546","FBgn0020513","X",12757036,12760617,3581
"10547","FBgn0030545","X",14200178,14200907,729
"10548","FBgn0036830","3L",18908260,18914150,5890
"10549","FBgn0015924","2L",448254,453024,4770
"10550","FBgn0267050","X",19952814,19953608,794
"10551","FBgn0038218","3R",14261391,14262418,1027
"10552","FBgn0263391","2R",19397032,19424903,27871
"10553","FBgn0031751","2L",5922876,5923653,777
"10554","FBgn0033724","2R",12383045,12384520,1475
"10555","FBgn0031530","2L",3404460,3426719,22259
"10556","FBgn0039028","3R",22814483,22816178,1695
"10557","FBgn0051524","3R",30512325,30514355,2030
"10558","FBgn0037538","3R",8009400,8011018,1618
"10559","FBgn0086081","3L",18002978,18003078,100
"10560","FBgn0267082","X",15694127,15694382,255
"10561","FBgn0267135","3R",8545685,8546049,364
"10562","FBgn0259850","Y",903088,904499,1411
"10563","FBgn0053470","2R",13411739,13413085,1346
"10564","FBgn0262594","2R",9748800,9749389,589
"10565","FBgn0053233","3L",2659639,2661501,1862
"10566","FBgn0052642","X",12959220,12960790,1570
"10567","FBgn0035709","3L",6664224,6665641,1417
"10568","FBgn0030563","X",14314623,14315583,960
"10569","FBgn0039059","3R",23160477,23161338,861
"10570","FBgn0053286","3L",20970812,20974700,3888
"10571","FBgn0033733","2R",12420475,12422535,2060
"10572","FBgn0011660","2R",15368074,15371520,3446
"10573","FBgn0263342","3L",637486,638568,1082
"10574","FBgn0053301","2L",10049580,10051201,1621
"10575","FBgn0262448","3R",29215585,29215684,99
"10576","FBgn0038188","3R",13942238,13943460,1222
"10577","FBgn0031315","2L",1166506,1167211,705
"10578","FBgn0004052","3L",15509061,15509513,452
"10579","FBgn0033950","2R",14640214,14640626,412
"10580","FBgn0038978","3R",22491829,22492381,552
"10581","FBgn0035317","3L",2229646,2235253,5607
"10582","FBgn0052588","X",15205807,15206636,829
"10583","FBgn0264678","X",12717624,12730953,13329
"10584","FBgn0031422","2L",2383202,2384747,1545
"10585","FBgn0032582","2L",16292010,16293025,1015
"10586","FBgn0259896","2L",13973158,13976769,3611
"10587","FBgn0034973","2R",24080925,24081424,499
"10588","FBgn0264991","3R",13312855,13313188,333
"10589","FBgn0027074","2L",18819344,18822573,3229
"10590","FBgn0010382","2L",15727581,15748150,20569
"10591","FBgn0040281","3L",1196317,1199339,3022
"10592","FBgn0001316","3L",434083,540614,106531
"10593","FBgn0031722","2L",5579580,5581116,1536
"10594","FBgn0263250","2R",22089423,22090691,1268
"10595","FBgn0085356","X",17222968,17223815,847
"10596","FBgn0038597","3R",18283660,18286624,2964
"10597","FBgn0024807","X",21624796,21630148,5352
"10598","FBgn0051390","3R",10760071,10761032,961
"10599","FBgn0040725","2L",776536,776941,405
"10600","FBgn0267772","3R",28302913,28303571,658
"10601","FBgn0011591","3L",20925891,20949512,23621
"10602","FBgn0262024","3R",17420638,17420989,351
"10603","FBgn0267611","2L",9948908,9951122,2214
"10604","FBgn0039598","3R",28756999,28758234,1235
"10605","FBgn0053523","3L",5923862,5930120,6258
"10606","FBgn0031860","2L",6803011,6804372,1361
"10607","FBgn0266967","3L",6608770,6609238,468
"10608","FBgn0053696","3L",9644109,9659433,15324
"10609","FBgn0266244","3R",10461028,10462078,1050
"10610","FBgn0266210","2L",19108785,19109883,1098
"10611","FBgn0004606","3R",30765926,30789202,23276
"10612","FBgn0013675","mitochondrion_genome",3083,3767,684
"10613","FBgn0011768","3R",10870906,10872381,1475
"10614","FBgn0260862","3L",691486,692919,1433
"10615","FBgn0027554","3L",7972449,7974991,2542
"10616","FBgn0038702","3R",19393360,19395188,1828
"10617","FBgn0034459","2R",19593790,19596866,3076
"10618","FBgn0020643","3L",6146674,6147089,415
"10619","FBgn0028537","2L",14737090,14737769,679
"10620","FBgn0259823","3R",15250094,15257765,7671
"10621","FBgn0263476","3L",890270,890490,220
"10622","FBgn0050154","2R",20533359,20533934,575
"10623","FBgn0032125","2L",9542878,9543658,780
"10624","FBgn0030700","X",15853421,15854970,1549
"10625","FBgn0026059","3R",16068523,16098761,30238
"10626","FBgn0033679","2R",12064565,12079543,14978
"10627","FBgn0264711","3L",21644958,21666306,21348
"10628","FBgn0267175","X",12455771,12456258,487
"10629","FBgn0035742","3L",7127913,7128264,351
"10630","FBgn0250753","3R",5595364,5601136,5772
"10631","FBgn0028515","2L",16257688,16259511,1823
"10632","FBgn0283548","3R",23983496,23983569,73
"10633","FBgn0250849","3L",6983473,6984586,1113
"10634","FBgn0031213","2L",71757,76211,4454
"10635","FBgn0051820","2L",16005789,16006279,490
"10636","FBgn0032001","2L",8212959,8214135,1176
"10637","FBgn0001187","2R",15218837,15220329,1492
"10638","FBgn0003046","2L",7021682,7022470,788
"10639","FBgn0031191","X",22482082,22487458,5376
"10640","FBgn0262375","2L",4343696,4343756,60
"10641","FBgn0267383","3R",13717454,13718176,722
"10642","FBgn0031359","2L",1716244,1724388,8144
"10643","FBgn0052846","3L",2950174,2951618,1444
"10644","FBgn0050338","2R",9594045,9599505,5460
"10645","FBgn0259831","3R",13372630,13373326,696
"10646","FBgn0005771","2L",14490859,14494019,3160
"10647","FBgn0033698","2R",12192374,12198854,6480
"10648","FBgn0262025","3R",20139148,20139921,773
"10649","FBgn0265693","X",7460409,7461088,679
"10650","FBgn0051948","2L",2415359,2416720,1361
"10651","FBgn0035890","3L",8405454,8407354,1900
"10652","FBgn0038355","3R",15744654,15746411,1757
"10653","FBgn0058064","Y",702430,704048,1618
"10654","FBgn0261700","2R",18377487,18378196,709
"10655","FBgn0033447","2R",9823082,9827206,4124
"10656","FBgn0030631","X",15345169,15350021,4852
"10657","FBgn0265416","X",13445903,13527282,81379
"10658","FBgn0031741","2L",5805395,5809063,3668
"10659","FBgn0050044","2R",12495672,12501459,5787
"10660","FBgn0001216","3L",13974061,13977761,3700
"10661","FBgn0035004","2R",24431344,24432733,1389
"10662","FBgn0266829","2L",5060473,5060806,333
"10663","FBgn0031409","2L",2285163,2285926,763
"10664","FBgn0051510","3R",25117218,25122920,5702
"10665","FBgn0010309","2L",19186043,19189938,3895
"10666","FBgn0264836","3R",16321838,16322189,351
"10667","FBgn0027095","3R",16349404,16350801,1397
"10668","FBgn0266446","3R",10768001,10777374,9373
"10669","FBgn0263345","3L",22850111,22854434,4323
"10670","FBgn0027093","X",15841769,15844145,2376
"10671","FBgn0030899","X",18204403,18205144,741
"10672","FBgn0264745","2L",3171035,3172799,1764
"10673","FBgn0036333","3L",13011976,13015332,3356
"10674","FBgn0264305","3L",8932235,8954272,22037
"10675","FBgn0002932","3R",9020348,9039471,19123
"10676","FBgn0028947","2L",15616997,15617915,918
"10677","FBgn0002716","2R",19456170,19459523,3353
"10678","FBgn0031784","2L",6131023,6132484,1461
"10679","FBgn0260397","3L",20226381,20230250,3869
"10680","FBgn0266537","3L",13218203,13218864,661
"10681","FBgn0004781","3R",6695148,6696271,1123
"10682","FBgn0031805","2L",6367882,6370190,2308
"10683","FBgn0267534","3L",9510017,9510889,872
"10684","FBgn0085475","2R",22647458,22647807,349
"10685","FBgn0033210","2R",7675362,7676362,1000
"10686","FBgn0034013","2R",15340472,15368300,27828
"10687","FBgn0034649","2R",21667541,21669916,2375
"10688","FBgn0032967","2L",21906289,21908319,2030
"10689","FBgn0035003","2R",24429578,24430699,1121
"10690","FBgn0030870","X",17830828,17841705,10877
"10691","FBgn0035258","3L",1700956,1702407,1451
"10692","FBgn0262823","3R",18564264,18565173,909
"10693","FBgn0262741","3R",28586048,28591386,5338
"10694","FBgn0038656","3R",18901663,18902264,601
"10695","FBgn0039341","3R",25491460,25493262,1802
"10696","FBgn0032898","2L",20862547,20863775,1228
"10697","FBgn0000449","3L",4062292,4064551,2259
"10698","FBgn0026566","3R",6656030,6657442,1412
"10699","FBgn0037623","3R",8735879,8747675,11796
"10700","FBgn0033019","2R",5350477,5351972,1495
"10701","FBgn0051097","3R",25296128,25297778,1650
"10702","FBgn0029827","X",5952565,5954046,1481
"10703","FBgn0013699","mitochondrion_genome",3012,3077,65
"10704","FBgn0037737","3R",9740899,9742844,1945
"10705","FBgn0003941","2L",4227699,4228561,862
"10706","FBgn0038190","3R",13949454,13951138,1684
"10707","FBgn0085422","2L",3175112,3200496,25384
"10708","FBgn0026391","2L",11936181,11937501,1320
"10709","FBgn0267559","3R",7000492,7001423,931
"10710","FBgn0040729","2R",19690798,19691078,280
"10711","FBgn0033712","2R",12321238,12322797,1559
"10712","FBgn0003482","3R",27165716,27167122,1406
"10713","FBgn0027561","2R",9123304,9132030,8726
"10714","FBgn0031078","X",19852214,19859379,7165
"10715","FBgn0085431","3R",12386249,12402902,16653
"10716","FBgn0028407","2R",12055089,12062866,7777
"10717","FBgn0026756","2L",20372409,20374083,1674
"10718","FBgn0037637","3R",8822849,8824177,1328
"10719","FBgn0036177","3L",11590872,11591231,359
"10720","FBgn0266557","2L",210735,250823,40088
"10721","FBgn0015031","2L",5327227,5327969,742
"10722","FBgn0051742","2L",17990418,17991951,1533
"10723","FBgn0259998","2L",20255988,20257192,1204
"10724","FBgn0041238","2R",21978215,21979677,1462
"10725","FBgn0032437","2L",12453664,12454951,1287
"10726","FBgn0031142","X",21023390,21025888,2498
"10727","FBgn0031683","2L",5096227,5099294,3067
"10728","FBgn0265663","X",2682829,2683845,1016
"10729","FBgn0265952","2L",18899564,18900494,930
"10730","FBgn0262801","3R",6657882,6659442,1560
"10731","FBgn0261461","X",19136107,19167082,30975
"10732","FBgn0034419","2R",19137372,19141034,3662
"10733","FBgn0021895","2R",23847161,23851480,4319
"10734","FBgn0040011","2L",22579072,22585843,6771
"10735","FBgn0037050","3L",21131446,21133310,1864
"10736","FBgn0014143","3L",21474133,21476479,2346
"10737","FBgn0035690","3L",6178677,6181829,3152
"10738","FBgn0265852","2R",20303195,20303595,400
"10739","FBgn0050412","2R",23318189,23319348,1159
"10740","FBgn0263413","3R",10093761,10101356,7595
"10741","FBgn0027581","2R",13580313,13593339,13026
"10742","FBgn0011297","2R",23705439,23709792,4353
"10743","FBgn0040353","X",2875428,2876533,1105
"10744","FBgn0061469","3L",11206422,11210583,4161
"10745","FBgn0086708","3L",13477541,13483515,5974
"10746","FBgn0266442","3R",30122023,30123263,1240
"10747","FBgn0033574","2R",10938425,10941738,3313
"10748","FBgn0262991","X",15662289,15665707,3418
"10749","FBgn0028911","2L",14599396,14599467,71
"10750","FBgn0265978","2R",22387395,22387895,500
"10751","FBgn0046880","2R",19698714,19699346,632
"10752","FBgn0032335","2L",11071027,11071532,505
"10753","FBgn0051989","2L",5525905,5535958,10053
"10754","FBgn0033860","2R",13596677,13598750,2073
"10755","FBgn0027343","X",769945,784222,14277
"10756","FBgn0025352","2R",23866648,23868603,1955
"10757","FBgn0265592","2R",18005395,18005995,600
"10758","FBgn0085297","3L",500965,501400,435
"10759","FBgn0026431","2L",10483295,10485857,2562
"10760","FBgn0036595","3L",16287580,16288422,842
"10761","FBgn0267150","3R",13785806,13786583,777
"10762","FBgn0027376","3R",25340252,25344838,4586
"10763","FBgn0000442","2L",786153,790798,4645
"10764","FBgn0035767","3L",7341884,7345183,3299
"10765","FBgn0031163","X",21193253,21194521,1268
"10766","FBgn0016036","3L",7244388,7245383,995
"10767","FBgn0086659","2R",23839911,23840064,153
"10768","FBgn0029837","X",6069131,6074857,5726
"10769","FBgn0031332","2L",1351728,1352868,1140
"10770","FBgn0034736","2R",22550094,22552113,2019
"10771","FBgn0029568","X",1203777,1205433,1656
"10772","FBgn0031048","X",19641191,19642869,1678
"10773","FBgn0264821","4",879374,884752,5378
"10774","FBgn0263631","X",5622280,5622416,136
"10775","FBgn0024728","4",663621,669884,6263
"10776","FBgn0051615","2L",21404963,21405277,314
"10777","FBgn0039483","3R",27094533,27095856,1323
"10778","FBgn0053860","2L",21529795,21530323,528
"10779","FBgn0038964","3R",22419095,22421068,1973
"10780","FBgn0035543","3L",4421662,4426621,4959
"10781","FBgn0053803","2L",21420129,21420657,528
"10782","FBgn0085315","3R",19715186,19715927,741
"10783","FBgn0082942","2R",9096506,9096582,76
"10784","FBgn0003015","3R",8935126,8938395,3269
"10785","FBgn0264710","3L",21678002,21679713,1711
"10786","FBgn0041585","2R",17843442,17860582,17140
"10787","FBgn0032115","2L",9396999,9397988,989
"10788","FBgn0027589","2R",9766364,9806875,40511
"10789","FBgn0040096","2L",11002072,11002738,666
"10790","FBgn0267797","3R",1865108,1866008,900
"10791","FBgn0030573","X",14583677,14584616,939
"10792","FBgn0085219","2R",16946455,16947554,1099
"10793","FBgn0035479","3L",3948699,3949305,606
"10794","FBgn0082952","2R",14623042,14623117,75
"10795","FBgn0015381","2L",5925937,5939261,13324
"10796","FBgn0000499","X",11355881,11358724,2843
"10797","FBgn0262275","2L",1831685,1831799,114
"10798","FBgn0051445","3R",29240580,29244827,4247
"10799","FBgn0020521","2R",24581245,24597862,16617
"10800","FBgn0266518","2R",6660645,6662118,1473
"10801","FBgn0011852","3L",1397932,1398003,71
"10802","FBgn0029898","X",6747544,6755752,8208
"10803","FBgn0284236","3L",5664121,5749599,85478
"10804","FBgn0029914","X",6849770,6851884,2114
"10805","FBgn0035094","2R",25183628,25255318,71690
"10806","FBgn0011638","2L",20348393,20350012,1619
"10807","FBgn0036887","3L",19585093,19586003,910
"10808","FBgn0263451","3R",22629575,22630671,1096
"10809","FBgn0052821","X",19910168,19910521,353
"10810","FBgn0038273","3R",14894784,14896446,1662
"10811","FBgn0050031","2R",11350811,11351621,810
"10812","FBgn0034739","2R",22594677,22596348,1671
"10813","FBgn0038072","3R",12654577,12660860,6283
"10814","FBgn0266929","3L",3329281,3329597,316
"10815","FBgn0083001","X",17144435,17144574,139
"10816","FBgn0025616","X",801669,803470,1801
"10817","FBgn0025186","2R",22212835,22217264,4429
"10818","FBgn0012004","3R",19790122,19790194,72
"10819","FBgn0082950","2R",14622802,14622877,75
"10820","FBgn0028868","2L",14765908,14767225,1317
"10821","FBgn0261592","X",7899624,7901331,1707
"10822","FBgn0034899","2R",23747560,23748477,917
"10823","FBgn0051690","2L",2677734,2719431,41697
"10824","FBgn0264000","3L",9251978,9288522,36544
"10825","FBgn0039150","3R",24109944,24112389,2445
"10826","FBgn0034477","2R",19878836,19880920,2084
"10827","FBgn0038285","3R",15078530,15079285,755
"10828","FBgn0035858","3L",8218232,8218983,751
"10829","FBgn0085349","X",1163620,1164105,485
"10830","FBgn0027575","3R",21770333,21775840,5507
"10831","FBgn0054056","3L",895951,897364,1413
"10832","FBgn0037225","3R",4248723,4251341,2618
"10833","FBgn0046763","3R",21021044,21024163,3119
"10834","FBgn0265713","3L",5493415,5494740,1325
"10835","FBgn0266928","3L",3863704,3864424,720
"10836","FBgn0261456","2R",19493996,19496856,2860
"10837","FBgn0262426","X",15507956,15508055,99
"10838","FBgn0066292","2R",6944614,6971637,27023
"10839","FBgn0037297","3R",5219657,5221548,1891
"10840","FBgn0033729","2R",12405932,12407045,1113
"10841","FBgn0265749","X",11492337,11492998,661
"10842","FBgn0015298","3L",7347310,7348034,724
"10843","FBgn0266376","X",13304005,13308004,3999
"10844","FBgn0264503","X",10158434,10195337,36903
"10845","FBgn0014869","3R",29148248,29149901,1653
"10846","FBgn0053688","3L",16199220,16199926,706
"10847","FBgn0265252","X",11570455,11571358,903
"10848","FBgn0053740","2L",21508705,21508740,35
"10849","FBgn0032749","2L",19059129,19063132,4003
"10850","FBgn0036447","3L",14767703,14769283,1580
"10851","FBgn0034582","2R",21067992,21069286,1294
"10852","FBgn0263467","2L",6917210,6917310,100
"10853","FBgn0034829","2R",23153854,23162077,8223
"10854","FBgn0267568","3R",7074776,7075487,711
"10855","FBgn0020391","2R",13160063,13163484,3421
"10856","FBgn0266703","3R",16371578,16372778,1200
"10857","FBgn0083042","X",17145903,17146041,138
"10858","FBgn0051088","3R",15950201,15951088,887
"10859","FBgn0033133","2R",7042656,7044710,2054
"10860","FBgn0038956","3R",22386489,22389714,3225
"10861","FBgn0264545","2L",15710579,15711099,520
"10862","FBgn0003205","3R",9510561,9513067,2506
"10863","FBgn0262427","2R",14233130,14233187,57
"10864","FBgn0031566","2L",3713360,3716810,3450
"10865","FBgn0035582","3L",4896864,4898470,1606
"10866","FBgn0001234","3R",21296127,21317836,21709
"10867","FBgn0037284","3R",4830849,4831297,448
"10868","FBgn0030167","X",9978153,9980564,2411
"10869","FBgn0031360","2L",1729887,1731070,1183
"10870","FBgn0039101","3R",23682503,23683980,1477
"10871","FBgn0031815","2L",6456052,6459008,2956
"10872","FBgn0267720","3R",17432381,17432870,489
"10873","FBgn0019643","2R",24139563,24157762,18199
"10874","FBgn0265637","2R",7621887,7622695,808
"10875","FBgn0027548","2R",7962463,7969805,7342
"10876","FBgn0030313","X",11572707,11573640,933
"10877","FBgn0267934","3L",16759393,16762683,3290
"10878","FBgn0030833","X",17240468,17245001,4533
"10879","FBgn0037797","3R",10222698,10223745,1047
"10880","FBgn0065104","2L",5206205,5206361,156
"10881","FBgn0034643","2R",21634679,21638399,3720
"10882","FBgn0035034","2R",24602472,24603488,1016
"10883","FBgn0036126","3L",11097446,11098186,740
"10884","FBgn0030108","X",9227137,9228827,1690
"10885","FBgn0263757","3R",18252843,18255487,2644
"10886","FBgn0036222","3L",11922610,11924757,2147
"10887","FBgn0265575","X",3862966,3871939,8973
"10888","FBgn0264603","3L",6036490,6036915,425
"10889","FBgn0024889","3L",19807232,19810398,3166
"10890","FBgn0003231","2L",19542468,19545548,3080
"10891","FBgn0000017","3L",16615866,16647882,32016
"10892","FBgn0261849","X",7382733,7382990,257
"10893","FBgn0038348","3R",15537713,15542414,4701
"10894","FBgn0264605","3L",16676406,16711677,35271
"10895","FBgn0267190","3R",16406641,16407107,466
"10896","FBgn0264987","3R",13376903,13377395,492
"10897","FBgn0015714","2R",14873953,14875739,1786
"10898","FBgn0052774","X",4244095,4246139,2044
"10899","FBgn0028408","2R",9291856,9302821,10965
"10900","FBgn0033426","2R",9577427,9581847,4420
"10901","FBgn0035483","3L",4021457,4023501,2044
"10902","FBgn0262904","3R",25902846,25906766,3920
"10903","FBgn0032014","2L",8305586,8306741,1155
"10904","FBgn0032805","2L",19545376,19546959,1583
"10905","FBgn0266406","3R",21878672,21884101,5429
"10906","FBgn0083962","2L",4981614,4992702,11088
"10907","FBgn0039474","3R",27020238,27021378,1140
"10908","FBgn0053730","2L",21458134,21458169,35
"10909","FBgn0035208","3L",1321792,1322806,1014
"10910","FBgn0266351","X",15926787,15927082,295
"10911","FBgn0036191","3L",11683980,11690155,6175
"10912","FBgn0030306","X",11485250,11486566,1316
"10913","FBgn0033404","2R",9345349,9348863,3514
"10914","FBgn0038714","3R",19597502,19598955,1453
"10915","FBgn0035942","3L",8961274,8964769,3495
"10916","FBgn0267631","3L",22871813,22872107,294
"10917","FBgn0042198","2R",20347041,20347589,548
"10918","FBgn0034850","2R",23357660,23358508,848
"10919","FBgn0034645","2R",21658078,21658777,699
"10920","FBgn0085457","3L",13061879,13062687,808
"10921","FBgn0031134","X",20867989,20869397,1408
"10922","FBgn0034933","2R",23937077,23939754,2677
"10923","FBgn0267731","3R",26241291,26241802,511
"10924","FBgn0038732","3R",19778750,19780727,1977
"10925","FBgn0000182","2L",16042047,16048757,6710
"10926","FBgn0266974","3L",2503789,2504397,608
"10927","FBgn0034468","2R",19697723,19698508,785
"10928","FBgn0264546","2L",13176423,13176888,465
"10929","FBgn0034330","2R",18384567,18384911,344
"10930","FBgn0031673","2L",5040648,5044712,4064
"10931","FBgn0030933","X",18512829,18514867,2038
"10932","FBgn0037386","3R",5831639,5838782,7143
"10933","FBgn0267326","2L",7710880,7713991,3111
"10934","FBgn0262487","X",17067304,17068523,1219
"10935","FBgn0030720","X",15997016,15999698,2682
"10936","FBgn0032200","2L",10254610,10255891,1281
"10937","FBgn0034595","2R",21147478,21148153,675
"10938","FBgn0035064","2R",24781726,24783500,1774
"10939","FBgn0053392","2R",19751727,19751861,134
"10940","FBgn0039120","3R",23774225,23781621,7396
"10941","FBgn0000179","X",4412856,4485647,72791
"10942","FBgn0035357","3L",2631715,2641984,10269
"10943","FBgn0266039","2L",21959599,21959980,381
"10944","FBgn0033241","2R",7958207,7960015,1808
"10945","FBgn0046301","3L",21830544,21832253,1709
"10946","FBgn0265708","3L",5369365,5370312,947
"10947","FBgn0004868","2L",9491176,9494876,3700
"10948","FBgn0052660","X",11920004,11920574,570
"10949","FBgn0033761","2R",12651301,12652487,1186
"10950","FBgn0030659","X",15580930,15582874,1944
"10951","FBgn0041621","3R",4256972,4258444,1472
"10952","FBgn0024249","2R",16277685,16278396,711
"10953","FBgn0050395","2R",21765489,21770196,4707
"10954","FBgn0032587","2L",16508078,16532877,24799
"10955","FBgn0001077","3R",6864324,6866244,1920
"10956","FBgn0263497","3R",6126476,6127152,676
"10957","FBgn0005648","2R",8131431,8134374,2943
"10958","FBgn0033422","2R",9559598,9561068,1470
"10959","FBgn0265444","2R",17386841,17389081,2240
"10960","FBgn0026737","3R",15362796,15363857,1061
"10961","FBgn0053538","2R",20000819,20000891,72
"10962","FBgn0038678","3R",19094394,19094905,511
"10963","FBgn0267398","2R",1343403,1345119,1716
"10964","FBgn0266959","3L",7222717,7223898,1181
"10965","FBgn0264955","X",17578689,17579135,446
"10966","FBgn0037500","3R",7361368,7362123,755
"10967","FBgn0035155","3L",690517,691951,1434
"10968","FBgn0029955","X",7712783,7717932,5149
"10969","FBgn0050010","2R",9863564,9864576,1012
"10970","FBgn0024811","4",210224,213165,2941
"10971","FBgn0050085","2R",15864309,15869147,4838
"10972","FBgn0051269","3R",17127126,17128201,1075
"10973","FBgn0002709","X",17135985,17142990,7005
"10974","FBgn0053354","2R",19765775,19765909,134
"10975","FBgn0037301","3R",5232543,5236288,3745
"10976","FBgn0034788","2R",22871190,22874427,3237
"10977","FBgn0264740","3R",23927728,23929000,1272
"10978","FBgn0040959","2L",8395665,8396096,431
"10979","FBgn0011710","X",21358286,21361688,3402
"10980","FBgn0038519","3R",17545222,17546531,1309
"10981","FBgn0004888","3L",3814211,3818383,4172
"10982","FBgn0283473","X",18788464,18806057,17593
"10983","FBgn0037324","3R",5407183,5412406,5223
"10984","FBgn0267365","2L",10311050,10312099,1049
"10985","FBgn0054027","3R",25103670,25109032,5362
"10986","FBgn0015019","3R",16647605,16649978,2373
"10987","FBgn0085287","3L",19951235,19951968,733
"10988","FBgn0053644","2L",13532085,13532636,551
"10989","FBgn0013548","2R",23702477,23705403,2926
"10990","FBgn0030028","X",8269898,8271409,1511
"10991","FBgn0029838","X",6076072,6077786,1714
"10992","FBgn0032856","2L",20376981,20382356,5375
"10993","FBgn0033551","2R",10813405,10815781,2376
"10994","FBgn0265382","3R",23399239,23399778,539
"10995","FBgn0260817","2L",3159950,3162399,2449
"10996","FBgn0038695","3R",19256777,19260132,3355
"10997","FBgn0034502","2R",20317323,20319039,1716
"10998","FBgn0038680","3R",19132648,19134704,2056
"10999","FBgn0036723","3L",17434472,17436431,1959
"11000","FBgn0000114","2L",12175004,12313438,138434
"11001","FBgn0051719","2L",10463340,10474349,11009
"11002","FBgn0085470","2L",8524999,8528618,3619
"11003","FBgn0053965","3L",1232882,1234015,1133
"11004","FBgn0267458","3L",553216,553739,523
"11005","FBgn0033054","2R",6036557,6040647,4090
"11006","FBgn0011661","X",8873012,8898332,25320
"11007","FBgn0037242","3R",4395979,4397875,1896
"11008","FBgn0262442","3L",8111107,8111177,70
"11009","FBgn0083985","3R",22380128,22381253,1125
"11010","FBgn0028837","3R",22580773,22582033,1260
"11011","FBgn0032660","2L",18009643,18011475,1832
"11012","FBgn0037121","3L",21728932,21729694,762
"11013","FBgn0259858","Y",939936,940435,499
"11014","FBgn0003091","2R",16924655,16945126,20471
"11015","FBgn0261059","3L",21683098,21684042,944
"11016","FBgn0037974","3R",11980704,11982622,1918
"11017","FBgn0031367","2L",1831627,1832565,938
"11018","FBgn0034545","2R",20692829,20693739,910
"11019","FBgn0032755","2L",19102044,19102909,865
"11020","FBgn0035001","2R",24392129,24402680,10551
"11021","FBgn0023415","2L",11015620,11016571,951
"11022","FBgn0085427","2L",8898786,8933594,34808
"11023","FBgn0266213","2L",20000122,20000448,326
"11024","FBgn0029996","X",8087544,8094064,6520
"11025","FBgn0050065","2R",13433028,13433760,732
"11026","FBgn0001263","2R",22855688,22858794,3106
"11027","FBgn0260238","X",16651376,16653275,1899
"11028","FBgn0264922","2L",6966780,6967644,864
"11029","FBgn0024836","2R",10673345,10721138,47793
"11030","FBgn0030556","X",14240266,14242822,2556
"11031","FBgn0028500","3L",22257749,22262921,5172
"11032","FBgn0032843","2L",20070081,20072195,2114
"11033","FBgn0034629","2R",21389405,21392439,3034
"11034","FBgn0029896","X",6720004,6739986,19982
"11035","FBgn0265640","2R",8304495,8305095,600
"11036","FBgn0266812","2R",17584095,17584495,400
"11037","FBgn0267484","3L",1784395,1784800,405
"11038","FBgn0051365","3R",23123962,23126422,2460
"11039","FBgn0052481","3L",770363,770462,99
"11040","FBgn0026374","X",15788897,15793632,4735
"11041","FBgn0033135","2R",7052747,7054399,1652
"11042","FBgn0020930","2R",12757546,12759724,2178
"11043","FBgn0034276","2R",17753555,17756422,2867
"11044","FBgn0004837","2L",15039488,15043334,3846
"11045","FBgn0013810","2L",17501401,17525515,24114
"11046","FBgn0001325","2R",25226611,25231394,4783
"11047","FBgn0264949","X",3802067,3802494,427
"11048","FBgn0000376","X",2734248,2738773,4525
"11049","FBgn0036032","3L",9704331,9710329,5998
"11050","FBgn0039251","3R",24925216,24927085,1869
"11051","FBgn0267728","2R",12023146,12025272,2126
"11052","FBgn0033482","2R",10070981,10075645,4664
"11053","FBgn0054041","3R",30508023,30510146,2123
"11054","FBgn0004573","3R",30968236,31016875,48639
"11055","FBgn0001285","2R",8691448,8692844,1396
"11056","FBgn0261581","2R",19945731,19946814,1083
"11057","FBgn0025632","X",2041868,2055414,13546
"11058","FBgn0001145","X",11422832,11430197,7365
"11059","FBgn0053240","X",14055626,14056349,723
"11060","FBgn0015513","3R",23781765,23801634,19869
"11061","FBgn0039089","3R",23557412,23580077,22665
"11062","FBgn0266310","2L",16697344,16697761,417
"11063","FBgn0041111","2L",2885929,2954406,68477
"11064","FBgn0011870","2R",20232797,20232867,70
"11065","FBgn0051070","3R",26947512,26947583,71
"11066","FBgn0053296","2L",7713998,7716645,2647
"11067","FBgn0001125","2L",1984512,1987758,3246
"11068","FBgn0085482","3L",232480,233351,871
"11069","FBgn0051324","3R",26106868,26130674,23806
"11070","FBgn0262613","3R",27501366,27502025,659
"11071","FBgn0037669","3R",9257727,9258501,774
"11072","FBgn0001098","3R",23935958,23943101,7143
"11073","FBgn0027611","2L",10457658,10462472,4814
"11074","FBgn0053362","2R",19762802,19762936,134
"11075","FBgn0053276","3L",7639811,7640446,635
"11076","FBgn0053427","2R",19738818,19738952,134
"11077","FBgn0037023","3L",20797241,20798375,1134
"11078","FBgn0025390","X",1523554,1668788,145234
"11079","FBgn0030679","X",15739230,15740417,1187
"11080","FBgn0266570","X",4319438,4321745,2307
"11081","FBgn0262269","3L",3299055,3299151,96
"11082","FBgn0024319","2R",16653205,16655046,1841
"11083","FBgn0034510","2R",20512697,20513169,472
"11084","FBgn0004638","2R",13495222,13502841,7619
"11085","FBgn0264822","4",959675,962692,3017
"11086","FBgn0001120","3L",14802380,14803360,980
"11087","FBgn0040877","X",17422320,17443994,21674
"11088","FBgn0004400","2R",17628491,17633516,5025
"11089","FBgn0030958","X",18785805,18786210,405
"11090","FBgn0031596","2L",4352975,4354034,1059
"11091","FBgn0051704","2L",11840691,11841204,513
"11092","FBgn0051166","3R",22397572,22397653,81
"11093","FBgn0000578","2R",19141632,19163705,22073
"11094","FBgn0267336","3R",9874681,9995364,120683
"11095","FBgn0266136","3L",19750943,19793569,42626
"11096","FBgn0031436","2L",2579201,2580172,971
"11097","FBgn0086031","2L",865366,865493,127
"11098","FBgn0086661","3L",18896189,18896456,267
"11099","FBgn0053403","2R",19747677,19747811,134
"11100","FBgn0263620","3R",4452705,4454295,1590
"11101","FBgn0050037","2R",11979094,11980538,1444
"11102","FBgn0034568","2R",20986833,20991171,4338
"11103","FBgn0013709","mitochondrion_genome",1264,1329,65
"11104","FBgn0035169","3L",851346,852673,1327
"11105","FBgn0046296","3L",12132146,12133834,1688
"11106","FBgn0052185","3L",17494880,17495300,420
"11107","FBgn0032249","2L",10432687,10435656,2969
"11108","FBgn0037153","3L",22136090,22247702,111612
"11109","FBgn0052055","3L",10218504,10220164,1660
"11110","FBgn0004778","3R",6689602,6690239,637
"11111","FBgn0082968","2R",21330736,21330867,131
"11112","FBgn0052652","X",12411018,12412181,1163
"11113","FBgn0267468","3L",1796854,1797272,418
"11114","FBgn0029888","X",6677262,6679118,1856
"11115","FBgn0032094","2L",9077121,9077988,867
"11116","FBgn0030763","X",16615028,16621589,6561
"11117","FBgn0033497","2R",10205454,10234607,29153
"11118","FBgn0267995","2L",283807,284255,448
"11119","FBgn0030357","X",11920004,11924662,4658
"11120","FBgn0260935","3R",9240757,9245869,5112
"11121","FBgn0037897","3R",11422092,11429969,7877
"11122","FBgn0026760","2L",13435622,13439930,4308
"11123","FBgn0259791","3L",18622692,18624751,2059
"11124","FBgn0037405","3R",6167483,6170309,2826
"11125","FBgn0029747","X",5180182,5182369,2187
"11126","FBgn0000576","3R",13901853,13904620,2767
"11127","FBgn0053888","2L",21487655,21488249,594
"11128","FBgn0262441","2R",20584190,20584260,70
"11129","FBgn0051176","3R",21672303,21719660,47357
"11130","FBgn0014006","3R",19879719,19886030,6311
"11131","FBgn0283477","3R",16338943,16341988,3045
"11132","FBgn0032900","2L",20869854,20871565,1711
"11133","FBgn0063494","2R",18406011,18406761,750
"11134","FBgn0028942","2L",13540751,13541646,895
"11135","FBgn0039523","3R",27520866,27533934,13068
"11136","FBgn0032815","2L",19732080,19735980,3900
"11137","FBgn0032271","2L",10629352,10638471,9119
"11138","FBgn0033499","2R",10247814,10249404,1590
"11139","FBgn0037548","3R",8094124,8105083,10959
"11140","FBgn0261873","X",8178549,8240474,61925
"11141","FBgn0000520","X",2727698,2730042,2344
"11142","FBgn0267469","3L",3137599,3138012,413
"11143","FBgn0032779","2L",19424050,19429224,5174
"11144","FBgn0004584","2L",2969773,2972508,2735
"11145","FBgn0026255","2L",21206493,21211818,5325
"11146","FBgn0266432","2R",22472995,22476314,3319
"11147","FBgn0000473","2R",6779749,6781491,1742
"11148","FBgn0053391","2R",19752096,19752229,133
"11149","FBgn0263766","2L",9961018,9962104,1086
"11150","FBgn0034258","2R",17665678,17669275,3597
"11151","FBgn0032593","2L",16663454,16676701,13247
"11152","FBgn0028518","2L",15630002,15634987,4985
"11153","FBgn0027655","3R",28696242,28734816,38574
"11154","FBgn0029526","X",479864,481826,1962
"11155","FBgn0050095","2R",16123484,16124577,1093
"11156","FBgn0036330","3L",13006817,13007881,1064
"11157","FBgn0015338","2L",16305801,16307298,1497
"11158","FBgn0263407","3R",21465701,21466492,791
"11159","FBgn0035110","3L",211636,212687,1051
"11160","FBgn0028394","2L",8529141,8541439,12298
"11161","FBgn0004552","3L",4141467,4142070,603
"11162","FBgn0025679","X",4770557,4771588,1031
"11163","FBgn0262937","3L",1295913,1298497,2584
"11164","FBgn0262428","2L",9950418,9950516,98
"11165","FBgn0085446","X",6540771,6589173,48402
"11166","FBgn0037411","3R",6215832,6218199,2367
"11167","FBgn0029717","X",4570991,4571929,938
"11168","FBgn0265910","2L",4349172,4349685,513
"11169","FBgn0028983","2R",18126347,18128210,1863
"11170","FBgn0039928","4",1112874,1123357,10483
"11171","FBgn0039812","3R",30959700,30962307,2607
"11172","FBgn0031314","2L",1164443,1166425,1982
"11173","FBgn0036373","3L",13486797,13502492,15695
"11174","FBgn0039765","3R",30423974,30424556,582
"11175","FBgn0041181","2L",7702805,7710690,7885
"11176","FBgn0033199","2R",7651625,7655302,3677
"11177","FBgn0033720","2R",12371594,12375081,3487
"11178","FBgn0267594","211000022278279",11634,12709,1075
"11179","FBgn0035604","3L",5378786,5382821,4035
"11180","FBgn0053914","2R",7036768,7039050,2282
"11181","FBgn0053258","3L",16082551,16083638,1087
"11182","FBgn0262738","X",4322626,4365408,42782
"11183","FBgn0029094","3L",19618894,19620398,1504
"11184","FBgn0016694","3L",7811458,7867369,55911
"11185","FBgn0039155","3R",24141395,24147490,6095
"11186","FBgn0029939","X",7137723,7241932,104209
"11187","FBgn0031974","2L",8008302,8009477,1175
"11188","FBgn0085326","3R",6747068,6748007,939
"11189","FBgn0053825","2L",21471259,21472281,1022
"11190","FBgn0267154","3R",13630873,13631379,506
"11191","FBgn0036537","3L",15833795,15835388,1593
"11192","FBgn0036738","3L",17549826,17550980,1154
"11193","FBgn0031769","2L",6050800,6053877,3077
"11194","FBgn0031248","2L",318362,319259,897
"11195","FBgn0038715","3R",19600635,19602629,1994
"11196","FBgn0010315","X",15906822,15909676,2854
"11197","FBgn0015033","3L",7493557,7496179,2622
"11198","FBgn0030245","X",10870594,10877893,7299
"11199","FBgn0053848","2L",21510018,21510546,528
"11200","FBgn0069973","X",22960609,22962360,1751
"11201","FBgn0000140","3R",24753849,24760513,6664
"11202","FBgn0030268","X",11129362,11137118,7756
"11203","FBgn0085276","3L",16261185,16261605,420
"11204","FBgn0034326","2R",18299317,18300072,755
"11205","FBgn0050423","2R",24874976,24875865,889
"11206","FBgn0010044","3R",12380008,12380815,807
"11207","FBgn0031829","2L",6555717,6557502,1785
"11208","FBgn0032445","2L",12692993,12693939,946
"11209","FBgn0038641","3R",18680604,18686739,6135
"11210","FBgn0266637","2R",17036695,17037982,1287
"11211","FBgn0003330","3R",27680431,27682029,1598
"11212","FBgn0028397","X",16074717,16091495,16778
"11213","FBgn0039531","3R",27634625,27636060,1435
"11214","FBgn0082935","2R",24184840,24184923,83
"11215","FBgn0031245","2L",283385,291795,8410
"11216","FBgn0051323","3R",26170847,26187307,16460
"11217","FBgn0038579","3R",18191244,18191967,723
"11218","FBgn0267896","Y",3228674,3229392,718
"11219","FBgn0267637","3L",18302801,18303341,540
"11220","FBgn0033627","2R",11366710,11370287,3577
"11221","FBgn0038449","3R",16615309,16617154,1845
"11222","FBgn0064117","X",21317936,21319296,1360
"11223","FBgn0266249","3R",15038338,15039812,1474
"11224","FBgn0034842","2R",23308654,23309816,1162
"11225","FBgn0265949","2L",16203110,16203476,366
"11226","FBgn0260658","X",3891497,3930578,39081
"11227","FBgn0036057","3L",9893188,9894743,1555
"11228","FBgn0260437","2R",11866943,11867579,636
"11229","FBgn0085438","3R",9742877,9746367,3490
"11230","FBgn0267199","3R",16208192,16208935,743
"11231","FBgn0082585","2R",11384743,11397432,12689
"11232","FBgn0039744","3R",30055957,30056603,646
"11233","FBgn0031737","2L",5762553,5766142,3589
"11234","FBgn0026313","X",17599608,17606879,7271
"11235","FBgn0266318","2L",3845130,3845716,586
"11236","FBgn0026576","3R",24050783,24053592,2809
"11237","FBgn0259201","2L",18812648,18813941,1293
"11238","FBgn0037883","3R",11231912,11232539,627
"11239","FBgn0263020","2R",12241218,12241872,654
"11240","FBgn0086034","2L",6745000,6745078,78
"11241","FBgn0064123","X",21093844,21111417,17573
"11242","FBgn0039806","3R",30870939,30872351,1412
"11243","FBgn0033539","2R",10641818,10645427,3609
"11244","FBgn0003865","X",11988062,11988948,886
"11245","FBgn0004811","2L",19792773,19795851,3078
"11246","FBgn0002354","3R",13030913,13031598,685
"11247","FBgn0036422","3L",14400769,14402725,1956
"11248","FBgn0263651","3R",13816231,13817127,896
"11249","FBgn0029826","X",5948160,5950208,2048
"11250","FBgn0005619","2R",10237988,10246077,8089
"11251","FBgn0037133","3L",21769815,21771321,1506
"11252","FBgn0262530","3L",15650852,15651392,540
"11253","FBgn0015524","2R",20883625,20903414,19789
"11254","FBgn0002962","3R",19157238,19160202,2964
"11255","FBgn0038127","3R",13219644,13220578,934
"11256","FBgn0262527","3R",15793782,15802102,8320
"11257","FBgn0265607","2L",17131024,17173118,42094
"11258","FBgn0028579","2R",6741899,6746141,4242
"11259","FBgn0266456","3L",19266061,19266838,777
"11260","FBgn0025626","X",2062313,2065142,2829
"11261","FBgn0033734","2R",12422931,12425459,2528
"11262","FBgn0052359","3L",8060451,8060533,82
"11263","FBgn0000581","2R",11452043,11465270,13227
"11264","FBgn0004181","2R",25175126,25176715,1589
"11265","FBgn0263492","3L",9378160,9381119,2959
"11266","FBgn0265935","2R",6862001,6872718,10717
"11267","FBgn0019985","4",936819,949441,12622
"11268","FBgn0267010","2L",10872014,10872384,370
"11269","FBgn0262323","3R",13464219,13464311,92
"11270","FBgn0052625","X",13756164,13756826,662
"11271","FBgn0264891","2L",7519679,7520082,403
"11272","FBgn0021764","X",686834,749496,62662
"11273","FBgn0033523","2R",10436598,10437382,784
"11274","FBgn0267826","X",16645867,16646167,300
"11275","FBgn0039900","4",278685,306481,27796
"11276","FBgn0040324","4",571755,580122,8367
"11277","FBgn0053808","2L",21433862,21434337,475
"11278","FBgn0003520","2R",18117896,18125779,7883
"11279","FBgn0030331","X",11724246,11736617,12371
"11280","FBgn0038419","3R",16345825,16349226,3401
"11281","FBgn0051320","3R",14358356,14361786,3430
"11282","FBgn0014269","2R",18969404,18971133,1729
"11283","FBgn0034614","2R",21294402,21295588,1186
"11284","FBgn0052719","X",7508651,7547992,39341
"11285","FBgn0050125","2R",19094267,19096174,1907
"11286","FBgn0013811","3L",1759172,1771758,12586
"11287","FBgn0265535","X",11131340,11132412,1072
"11288","FBgn0040087","X",7894031,7896991,2960
"11289","FBgn0033715","2R",12335316,12336205,889
"11290","FBgn0004648","X",496446,509072,12626
"11291","FBgn0035798","3L",7562610,7569499,6889
"11292","FBgn0037427","3R",6311772,6327308,15536
"11293","FBgn0039283","3R",25138072,25139903,1831
"11294","FBgn0031703","2L",5339132,5342234,3102
"11295","FBgn0023212","3R",20578222,20579850,1628
"11296","FBgn0040763","2R",11293776,11294586,810
"11297","FBgn0004187","3R",23826334,23826497,163
"11298","FBgn0265687","2L",11548640,11550035,1395
"11299","FBgn0051356","3R",12206575,12206646,71
"11300","FBgn0037175","3L",22686360,22687087,727
"11301","FBgn0027556","X",16913180,16938209,25029
"11302","FBgn0033366","2R",9039728,9042142,2414
"11303","FBgn0034761","2R",22663692,22664474,782
"11304","FBgn0036096","3L",10661475,10663157,1682
"11305","FBgn0260794","3R",4786284,4812096,25812
"11306","FBgn0030670","X",15701451,15703770,2319
"11307","FBgn0035232","3L",1555363,1558484,3121
"11308","FBgn0032371","2L",11652448,11654164,1716
"11309","FBgn0039942","X",23080759,23082709,1950
"11310","FBgn0284233","X",14261223,14264844,3621
"11311","FBgn0036569","3L",16100280,16103482,3202
"11312","FBgn0267088","X",7120374,7120741,367
"11313","FBgn0053743","2L",21523637,21523672,35
"11314","FBgn0261508","3R",7492961,7493271,310
"11315","FBgn0265458","X",11079291,11079772,481
"11316","FBgn0000028","X",15350239,15379064,28825
"11317","FBgn0086676","2R",16124981,16138238,13257
"11318","FBgn0262397","3R",15417744,15417845,101
"11319","FBgn0266364","2L",11834608,11834874,266
"11320","FBgn0086057","3R",11224308,11224400,92
"11321","FBgn0086408","2R",22807860,22815993,8133
"11322","FBgn0086710","2L",19008031,19009306,1275
"11323","FBgn0052225","3L",20304310,20306283,1973
"11324","FBgn0037890","3R",11242208,11243999,1791
"11325","FBgn0061356","2R",10883547,10884936,1389
"11326","FBgn0267463","3L",1549448,1549900,452
"11327","FBgn0267663","3L",6104850,6105198,348
"11328","FBgn0024251","X",21363028,21373145,10117
"11329","FBgn0003300","X",20690670,20697321,6651
"11330","FBgn0005658","3L",6097617,6123913,26296
"11331","FBgn0021738","X",3793223,3797339,4116
"11332","FBgn0023214","2R",18667527,18673536,6009
"11333","FBgn0039044","3R",23049657,23054082,4425
"11334","FBgn0038505","3R",17407876,17409460,1584
"11335","FBgn0029944","X",7324214,7328806,4592
"11336","FBgn0265061","2R",7023396,7024096,700
"11337","FBgn0031908","2L",7405227,7408600,3373
"11338","FBgn0038203","3R",14109445,14110823,1378
"11339","FBgn0034906","2R",23804315,23806249,1934
"11340","FBgn0028531","2L",14338240,14340080,1840
"11341","FBgn0267524","X",23291700,23291729,29
"11342","FBgn0034454","2R",19497752,19500372,2620
"11343","FBgn0033886","2R",13958545,13960404,1859
"11344","FBgn0036208","3L",11798948,11800861,1913
"11345","FBgn0039088","3R",23554323,23556943,2620
"11346","FBgn0033129","2R",7033562,7034920,1358
"11347","FBgn0029861","X",6295389,6298970,3581
"11348","FBgn0031650","2L",4942742,4944305,1563
"11349","FBgn0032229","2L",10356795,10358078,1283
"11350","FBgn0267861","2R",1512810,1527095,14285
"11351","FBgn0040077","3R",13710017,13711835,1818
"11352","FBgn0033972","2R",14853863,14855048,1185
"11353","FBgn0260474","2R",9704384,9706147,1763
"11354","FBgn0038850","3R",21050014,21050943,929
"11355","FBgn0262889","2R",12243999,12244701,702
"11356","FBgn0265418","3R",8089757,8090285,528
"11357","FBgn0032242","2L",10410537,10413463,2926
"11358","FBgn0052536","X",19275004,19276898,1894
"11359","FBgn0040890","X",19494420,19494992,572
"11360","FBgn0042711","3R",26449079,26450585,1506
"11361","FBgn0004101","2R",24342861,24376473,33612
"11362","FBgn0065051","3L",15134550,15134660,110
"11363","FBgn0039882","3R",31806867,31810186,3319
"11364","FBgn0266549","X",3701857,3703285,1428
"11365","FBgn0040582","3R",22087075,22088501,1426
"11366","FBgn0031670","2L",5010922,5012127,1205
"11367","FBgn0035311","3L",2171644,2172773,1129
"11368","FBgn0026430","X",19559431,19565764,6333
"11369","FBgn0034598","2R",21161713,21168659,6946
"11370","FBgn0086657","2L",20676045,20678979,2934
"11371","FBgn0265979","2R",22312876,22316604,3728
"11372","FBgn0035308","3L",2153201,2163863,10662
"11373","FBgn0034390","2R",18775669,18776978,1309
"11374","FBgn0054015","X",16447568,16448302,734
"11375","FBgn0053406","2R",19746574,19746708,134
"11376","FBgn0262367","3R",15417408,15417475,67
"11377","FBgn0030207","X",10477260,10478493,1233
"11378","FBgn0265892","3L",20633020,20633484,464
"11379","FBgn0263505","X",2750919,2751416,497
"11380","FBgn0016726","2R",21293768,21294404,636
"11381","FBgn0031883","2L",7032721,7037878,5157
"11382","FBgn0267870","Y",3061391,3062109,718
"11383","FBgn0262564","2R",16736813,16737885,1072
"11384","FBgn0050291","2R",21007755,21009576,1821
"11385","FBgn0028583","X",21396727,21397316,589
"11386","FBgn0263848","2R",20775795,20776409,614
"11387","FBgn0086904","2R",12759693,12760999,1306
"11388","FBgn0264825","3R",21534429,21535367,938
"11389","FBgn0023181","2R",24795740,24797414,1674
"11390","FBgn0039303","3R",25258898,25260759,1861
"11391","FBgn0039041","3R",23042241,23042669,428
"11392","FBgn0036393","3L",13986620,13987184,564
"11393","FBgn0036911","3L",19816085,19817967,1882
"11394","FBgn0011974","X",14070641,14070722,81
"11395","FBgn0000489","3L",15925805,15954797,28992
"11396","FBgn0086059","3R",24723826,24723920,94
"11397","FBgn0036870","3L",19464049,19464759,710
"11398","FBgn0033075","2R",6242004,6255266,13262
"11399","FBgn0259212","3R",5170004,5217456,47452
"11400","FBgn0033544","2R",10731335,10738370,7035
"11401","FBgn0263983","3R",18950196,18976557,26361
"11402","FBgn0261580","2R",19944263,19945877,1614
"11403","FBgn0267756","3R",27999622,28000302,680
"11404","FBgn0000157","2R",24814822,24835667,20845
"11405","FBgn0041624","3L",6325612,6327049,1437
"11406","FBgn0265906","2L",18310103,18310502,399
"11407","FBgn0000529","2L",19765776,19769067,3291
"11408","FBgn0263740","3R",15257844,15263458,5614
"11409","FBgn0051436","3R",25304137,25305651,1514
"11410","FBgn0086674","X",13563823,13593224,29401
"11411","FBgn0036593","3L",16282809,16283921,1112
"11412","FBgn0034950","2R",23988738,23992049,3311
"11413","FBgn0051053","3R",27927357,27928174,817
"11414","FBgn0038840","3R",20901956,20908263,6307
"11415","FBgn0265630","X",13195499,13211674,16175
"11416","FBgn0259721","3R",13779624,13780795,1171
"11417","FBgn0085410","2L",5824004,5856767,32763
"11418","FBgn0027574","3R",27112566,27115126,2560
"11419","FBgn0036826","3L",18900595,18901554,959
"11420","FBgn0262998","3L",18294604,18295800,1196
"11421","FBgn0011934","2R",6190372,6190445,73
"11422","FBgn0053539","2R",21181284,21181355,71
"11423","FBgn0031227","2L",153539,155305,1766
"11424","FBgn0035756","3L",7266192,7312896,46704
"11425","FBgn0011694","2R",25173568,25174230,662
"11426","FBgn0267258","2L",15841010,15841427,417
"11427","FBgn0264517","3L",3940519,3941301,782
"11428","FBgn0005585","3R",9628691,9630851,2160
"11429","FBgn0035168","3L",843926,851080,7154
"11430","FBgn0003499","3R",18090803,18135583,44780
"11431","FBgn0031190","X",22474851,22482357,7506
"11432","FBgn0039787","3R",30579429,30582117,2688
"11433","FBgn0040097","2L",9254076,9254854,778
"11434","FBgn0051225","3R",23481865,23483541,1676
"11435","FBgn0266198","X",15641558,15642108,550
"11436","FBgn0034160","2R",16816589,16817577,988
"11437","FBgn0050156","2R",6981446,6985712,4266
"11438","FBgn0041604","3L",14632601,14671609,39008
"11439","FBgn0265340","2R",10026356,10026758,402
"11440","FBgn0039184","3R",24336922,24340645,3723
"11441","FBgn0039784","3R",30514777,30516980,2203
"11442","FBgn0037488","3R",7241760,7244006,2246
"11443","FBgn0029153","2R",16414815,16419398,4583
"11444","FBgn0031347","2L",1584866,1587155,2289
"11445","FBgn0267548","3L",14661455,14661946,491
"11446","FBgn0051133","3R",24147436,24148967,1531
"11447","FBgn0038897","3R",21740105,21744431,4326
"11448","FBgn0262813","3L",13837756,13838080,324
"11449","FBgn0011708","2L",16307346,16309274,1928
"11450","FBgn0034878","2R",23548967,23554712,5745
"11451","FBgn0026428","X",15333310,15340360,7050
"11452","FBgn0051292","3R",15906240,15906750,510
"11453","FBgn0004838","2L",6920704,6932057,11353
"11454","FBgn0035014","2R",24506870,24507706,836
"11455","FBgn0040923","X",7452209,7452643,434
"11456","FBgn0052668","X",11156676,11159760,3084
"11457","FBgn0261395","3R",31122527,31123415,888
"11458","FBgn0032847","2L",20093088,20093849,761
"11459","FBgn0267445","Y",1003209,1004639,1430
"11460","FBgn0266168","2L",10051362,10052289,927
"11461","FBgn0037491","3R",7248151,7249738,1587
"11462","FBgn0036667","3L",16844568,16844991,423
"11463","FBgn0031074","X",19823368,19824080,712
"11464","FBgn0263354","2L",13415431,13500427,84996
"11465","FBgn0034278","2R",17767165,17767786,621
"11466","FBgn0029694","X",4101318,4102995,1677
"11467","FBgn0261547","3L",16970013,16994388,24375
"11468","FBgn0033145","2R",7149174,7149677,503
"11469","FBgn0035097","3L",73945,75332,1387
"11470","FBgn0264324","3R",28845270,28870439,25169
"11471","FBgn0035760","3L",7320068,7321211,1143
"11472","FBgn0032033","2L",8381821,8382807,986
"11473","FBgn0265950","2L",18893611,18896798,3187
"11474","FBgn0267317","3L",13286388,13287186,798
"11475","FBgn0017414","2R",10893034,10894414,1380
"11476","FBgn0034196","2R",17126410,17127023,613
"11477","FBgn0033677","2R",12033946,12036260,2314
"11478","FBgn0031052","X",19652305,19659407,7102
"11479","FBgn0032884","2L",20787656,20789098,1442
"11480","FBgn0086448","X",16359143,16361275,2132
"11481","FBgn0266007","2R",22957177,22957377,200
"11482","FBgn0020644","3L",6149548,6149960,412
"11483","FBgn0053450","2R",19730304,19730438,134
"11484","FBgn0053237","X",14059434,14060157,723
"11485","FBgn0051626","2L",21232495,21236733,4238
"11486","FBgn0036576","3L",16137802,16164701,26899
"11487","FBgn0008646","3R",13867345,13874916,7571
"11488","FBgn0032851","2L",20103386,20104150,764
"11489","FBgn0259725","2R",21667541,21669916,2375
"11490","FBgn0263085","2L",18308088,18308684,596
"11491","FBgn0040233","2L",11269780,11277846,8066
"11492","FBgn0015221","3R",30387804,30390584,2780
"11493","FBgn0266488","2R",18536767,18539416,2649
"11494","FBgn0263975","3L",16581637,16582767,1130
"11495","FBgn0033363","2R",9014368,9017195,2827
"11496","FBgn0038930","3R",22085374,22086397,1023
"11497","FBgn0053082","X",1030758,1033119,2361
"11498","FBgn0032971","2L",22079632,22080738,1106
"11499","FBgn0037222","3R",4241045,4242717,1672
"11500","FBgn0085291","3L",21959254,21960503,1249
"11501","FBgn0036837","3L",18990026,18998283,8257
"11502","FBgn0264720","3L",72196,73101,905
"11503","FBgn0035734","3L",7066314,7069463,3149
"11504","FBgn0264550","3L",20921182,20921749,567
"11505","FBgn0032204","2L",10266703,10268748,2045
"11506","FBgn0032147","2L",9782384,9788499,6115
"11507","FBgn0082941","2R",14623276,14623346,70
"11508","FBgn0267888","Y",3185709,3186398,689
"11509","FBgn0030102","X",9206126,9210887,4761
"11510","FBgn0032479","2L",13183849,13191979,8130
"11511","FBgn0038421","3R",16357535,16359466,1931
"11512","FBgn0265866","X",13990733,13991420,687
"11513","FBgn0025628","X",2066435,2073483,7048
"11514","FBgn0039370","3R",25777268,25778305,1037
"11515","FBgn0042693","3R",18167757,18180049,12292
"11516","FBgn0038575","3R",18183656,18185715,2059
"11517","FBgn0030500","X",13609671,13612062,2391
"11518","FBgn0266465","3R",17085513,17087988,2475
"11519","FBgn0038986","3R",22558342,22562572,4230
"11520","FBgn0036335","3L",13017149,13017867,718
"11521","FBgn0086610","3R",24376865,24377705,840
"11522","FBgn0029687","X",3948975,3955442,6467
"11523","FBgn0053809","2L",21435299,21435827,528
"11524","FBgn0030756","X",16539153,16540852,1699
"11525","FBgn0259840","211000022280494",2048,3374,1326
"11526","FBgn0085289","3L",20714100,20715158,1058
"11527","FBgn0031244","2L",281670,283269,1599
"11528","FBgn0027584","3R",11161207,11163498,2291
"11529","FBgn0085263","2R",12486719,12487378,659
"11530","FBgn0022943","3R",18164661,18165439,778
"11531","FBgn0053537","2R",24374063,24374136,73
"11532","FBgn0036317","3L",12844254,12850117,5863
"11533","FBgn0013563","3L",14071892,14076123,4231
"11534","FBgn0039790","3R",30592971,30601489,8518
"11535","FBgn0053361","2R",19763175,19763309,134
"11536","FBgn0028996","4",598555,607649,9094
"11537","FBgn0267481","3L",5767321,5768704,1383
"11538","FBgn0032748","2L",19054078,19058821,4743
"11539","FBgn0028533","2L",13847925,13849223,1298
"11540","FBgn0028936","2L",13970177,13972173,1996
"11541","FBgn0267775","3R",28427094,28427990,896
"11542","FBgn0032394","2L",12001234,12002266,1032
"11543","FBgn0000320","2L",6527447,6546976,19529
"11544","FBgn0265371","2R",11929244,11929796,552
"11545","FBgn0034259","2R",17671309,17672640,1331
"11546","FBgn0266239","3R",7467940,7468662,722
"11547","FBgn0011853","3L",1398169,1398240,71
"11548","FBgn0025802","3R",11789293,11796948,7655
"11549","FBgn0264339","2R",23444137,23491997,47860
"11550","FBgn0053775","2R",12564224,12564901,677
"11551","FBgn0267758","3R",23052916,23057984,5068
"11552","FBgn0265143","2R",19652495,19652995,500
"11553","FBgn0264436","2L",15129701,15130205,504
"11554","FBgn0259238","2R",11294536,11297520,2984
"11555","FBgn0035131","3L",329822,332309,2487
"11556","FBgn0053365","2R",19761702,19761836,134
"11557","FBgn0017448","3R",31755356,31758637,3281
"11558","FBgn0037798","3R",10223440,10224725,1285
"11559","FBgn0036341","3L",13044434,13046894,2460
"11560","FBgn0053340","3R",24363138,24364289,1151
"11561","FBgn0036187","3L",11646234,11648474,2240
"11562","FBgn0052250","3L",4318755,4321109,2354
"11563","FBgn0262954","2R",15144968,15145519,551
"11564","FBgn0033315","2R",8626181,8627611,1430
"11565","FBgn0016687","2R",24558967,24561087,2120
"11566","FBgn0031451","2L",2743375,2744934,1559
"11567","FBgn0029818","X",5870841,5873357,2516
"11568","FBgn0051896","2L",8481777,8481848,71
"11569","FBgn0002593","2L",419952,420864,912
"11570","FBgn0263341","2R",22291717,22292395,678
"11571","FBgn0039387","3R",25897476,25899744,2268
"11572","FBgn0267781","3R",30106997,30107532,535
"11573","FBgn0034938","2R",23952513,23954048,1535
"11574","FBgn0002631","3R",26028854,26029735,881
"11575","FBgn0037746","3R",9763650,9766135,2485
"11576","FBgn0041707","3R",5376780,5377975,1195
"11577","FBgn0052365","3L",7869042,7894814,25772
"11578","FBgn0033623","2R",11356114,11356600,486
"11579","FBgn0261638","3R",6767050,6779728,12678
"11580","FBgn0036780","3L",18148923,18153807,4884
"11581","FBgn0035983","3L",9386827,9399227,12400
"11582","FBgn0031397","2L",2209574,2212571,2997
"11583","FBgn0038168","3R",13679440,13687210,7770
"11584","FBgn0031518","2L",3304100,3317418,13318
"11585","FBgn0039454","3R",26737610,26738593,983
"11586","FBgn0036285","3L",12422510,12432668,10158
"11587","FBgn0035781","3L",7402332,7404181,1849
"11588","FBgn0026261","2R",22637770,22638868,1098
"11589","FBgn0036240","3L",12003155,12008051,4896
"11590","FBgn0037027","3L",20809669,20813332,3663
"11591","FBgn0010401","3R",7978959,7979614,655
"11592","FBgn0058439","2L",22797519,22798276,757
"11593","FBgn0005659","3R",27736538,27748366,11828
"11594","FBgn0050484","2R",13846393,13849832,3439
"11595","FBgn0014391","X",15847859,15849258,1399
"11596","FBgn0053452","2R",19729562,19729696,134
"11597","FBgn0033979","2R",14877786,14879752,1966
"11598","FBgn0262405","3R",21621879,21622021,142
"11599","FBgn0264873","2L",1500830,1504204,3374
"11600","FBgn0267519","X",23214452,23217140,2688
"11601","FBgn0032407","2L",12091822,12095250,3428
"11602","FBgn0053475","2R",10410770,10411213,443
"11603","FBgn0031772","2L",6062989,6063671,682
"11604","FBgn0261090","3L",15014695,15064977,50282
"11605","FBgn0050089","2R",15727381,15762044,34663
"11606","FBgn0038357","3R",15766246,15767438,1192
"11607","FBgn0053727","2L",21423876,21423911,35
"11608","FBgn0036029","3L",9685171,9686250,1079
"11609","FBgn0262104","3R",9820514,9821191,677
"11610","FBgn0265606","3R",20748184,20749074,890
"11611","FBgn0031169","X",21285301,21292458,7157
"11612","FBgn0039494","3R",27157948,27159781,1833
"11613","FBgn0263627","X",12970476,12973213,2737
"11614","FBgn0264948","X",3792974,3793401,427
"11615","FBgn0035807","3L",7651866,7654752,2886
"11616","FBgn0051262","3R",17217116,17223074,5958
"11617","FBgn0002933","X",3242412,3242934,522
"11618","FBgn0053667","X",6471673,6472378,705
"11619","FBgn0265682","2L",18313521,18314051,530
"11620","FBgn0263458","2L",12508108,12508254,146
"11621","FBgn0267926","3R",31131542,31132033,491
"11622","FBgn0034859","2R",23396770,23402309,5539
"11623","FBgn0033806","2R",13206745,13210469,3724
"11624","FBgn0022787","3R",15973298,15983451,10153
"11625","FBgn0052655","X",12234562,12235877,1315
"11626","FBgn0033355","2R",8940415,8941136,721
"11627","FBgn0028982","X",6267797,6274984,7187
"11628","FBgn0000146","2L",10997819,11001476,3657
"11629","FBgn0033754","2R",12569014,12569847,833
"11630","FBgn0033744","2R",12474424,12487986,13562
"11631","FBgn0083984","3R",21877870,21878686,816
"11632","FBgn0039214","3R",24635270,24650043,14773
"11633","FBgn0025571","3R",17540421,17545148,4727
"11634","FBgn0028789","3L",9041375,9045042,3667
"11635","FBgn0035702","3L",6486167,6488424,2257
"11636","FBgn0054057","3L",897380,898772,1392
"11637","FBgn0038632","3R",18629151,18641457,12306
"11638","FBgn0267668","3L",10323501,10367450,43949
"11639","FBgn0038912","3R",21875293,21877788,2495
"11640","FBgn0037461","3R",6628204,6629321,1117
"11641","FBgn0265271","3R",11696509,11698327,1818
"11642","FBgn0031849","2L",6684842,6686712,1870
"11643","FBgn0051815","2L",16605822,16607321,1499
"11644","FBgn0031296","2L",1037246,1038685,1439
"11645","FBgn0031882","2L",7030493,7032606,2113
"11646","FBgn0031219","2L",115365,116488,1123
"11647","FBgn0032105","2L",9251472,9253118,1646
"11648","FBgn0051361","3R",12094876,12111420,16544
"11649","FBgn0000247","3R",29806811,29815047,8236
"11650","FBgn0037931","3R",11674920,11678116,3196
"11651","FBgn0032624","2L",17011476,17014700,3224
"11652","FBgn0032509","2L",13366447,13367410,963
"11653","FBgn0031851","2L",6717625,6719389,1764
"11654","FBgn0043532","2R",19864717,19868714,3997
"11655","FBgn0050324","2R",16287586,16288233,647
"11656","FBgn0031220","2L",116970,121754,4784
"11657","FBgn0010105","3L",15721511,15728430,6919
"11658","FBgn0029943","X",7314622,7323770,9148
"11659","FBgn0034081","2R",16148812,16149795,983
"11660","FBgn0262321","2L",5641063,5641155,92
"11661","FBgn0266356","2L",20664882,20668605,3723
"11662","FBgn0035428","3L",3271036,3276255,5219
"11663","FBgn0038054","3R",12452464,12453196,732
"11664","FBgn0030634","X",15380371,15385441,5070
"11665","FBgn0039203","3R",24524794,24527533,2739
"11666","FBgn0261353","3L",11708979,11710570,1591
"11667","FBgn0083983","2R",16098948,16099337,389
"11668","FBgn0284412","3L",20558197,20558520,323
"11669","FBgn0034427","2R",19285395,19286730,1335
"11670","FBgn0266830","2L",19011902,19012254,352
"11671","FBgn0265158","3R",8684793,8685176,383
"11672","FBgn0028647","3R",25335257,25340088,4831
"11673","FBgn0032117","2L",9428669,9431052,2383
"11674","FBgn0050200","2R",25077048,25077119,71
"11675","FBgn0260477","2R",21539584,21540573,989
"11676","FBgn0033250","2R",8009119,8013755,4636
"11677","FBgn0051870","2L",10790222,10791450,1228
"11678","FBgn0029702","X",4268701,4271083,2382
"11679","FBgn0046776","2L",5242699,5244239,1540
"11680","FBgn0033932","2R",14378097,14385359,7262
"11681","FBgn0267949","2R",10671648,10672622,974
"11682","FBgn0032010","2L",8244160,8257502,13342
"11683","FBgn0038651","3R",18750436,18758873,8437
"11684","FBgn0040965","2L",9983671,9984743,1072
"11685","FBgn0263131","3L",16491838,16543370,51532
"11686","FBgn0034542","2R",20662474,20667306,4832
"11687","FBgn0031980","2L",8041873,8042909,1036
"11688","FBgn0266676","3L",1322877,1324221,1344
"11689","FBgn0031512","2L",3173972,3174504,532
"11690","FBgn0038820","3R",20676224,20677351,1127
"11691","FBgn0015789","X",20251338,20254691,3353
"11692","FBgn0042138","3L",11628037,11630749,2712
"11693","FBgn0033893","2R",14028620,14029096,476
"11694","FBgn0037530","3R",7903030,7907363,4333
"11695","FBgn0052061","3L",10463816,10464635,819
"11696","FBgn0037689","3R",9404385,9407857,3472
"11697","FBgn0003301","X",14787478,14826073,38595
"11698","FBgn0086669","2R",21327056,21327199,143
"11699","FBgn0262114","2R",10429708,10436581,6873
"11700","FBgn0051807","2L",16681819,16684008,2189
"11701","FBgn0085217","2R",15427091,15428023,932
"11702","FBgn0033774","2R",12762113,12763825,1712
"11703","FBgn0264271","2R",11432650,11433298,648
"11704","FBgn0038564","3R",18021600,18023689,2089
"11705","FBgn0263333","2L",20296643,20297299,656
"11706","FBgn0038292","3R",15139958,15141715,1757
"11707","FBgn0013308","2R",8007246,8009062,1816
"11708","FBgn0030242","X",10855000,10857413,2413
"11709","FBgn0267791","2R",20587551,20606854,19303
"11710","FBgn0036629","3L",16415292,16417177,1885
"11711","FBgn0050454","2R",19728188,19728259,71
"11712","FBgn0262622","3L",13282393,13283410,1017
"11713","FBgn0032839","2L",20024975,20025811,836
"11714","FBgn0039767","3R",30425427,30428276,2849
"11715","FBgn0267557","3L",16700829,16701469,640
"11716","FBgn0284227","X",13563823,13590570,26747
"11717","FBgn0250848","3L",13994231,13996571,2340
"11718","FBgn0085246","2R",8227990,8228727,737
"11719","FBgn0085296","3L",500014,500451,437
"11720","FBgn0034530","2R",20628186,20633506,5320
"11721","FBgn0033912","2R",14215096,14216627,1531
"11722","FBgn0265864","2R",20562245,20562695,450
"11723","FBgn0035674","3L",6073490,6075245,1755
"11724","FBgn0036509","3L",15560726,15563065,2339
"11725","FBgn0028369","X",2740384,3134532,394148
"11726","FBgn0030217","X",10596122,10599169,3047
"11727","FBgn0032280","2L",10681030,10681775,745
"11728","FBgn0036207","3L",11793514,11795418,1904
"11729","FBgn0086915","3L",20816901,20818027,1126
"11730","FBgn0034692","2R",22085782,22088727,2945
"11731","FBgn0036706","3L",17319969,17320811,842
"11732","FBgn0020621","2R",9252310,9285097,32787
"11733","FBgn0265017","2L",2181962,2185495,3533
"11734","FBgn0262576","3R",25995879,25996996,1117
"11735","FBgn0005386","3L",19590773,19598755,7982
"11736","FBgn0030086","X",9089513,9092826,3313
"11737","FBgn0030941","X",18624042,18634908,10866
"11738","FBgn0033504","2R",10269016,10307024,38008
"11739","FBgn0065032","X",17104571,17105852,1281
"11740","FBgn0267917","3L",5085580,5086229,649
"11741","FBgn0013773","2R",14871366,14873705,2339
"11742","FBgn0264679","2R",18775411,18777166,1755
"11743","FBgn0004133","2R",7580488,7587079,6591
"11744","FBgn0036729","3L",17477795,17478926,1131
"11745","FBgn0025800","X",8137041,8142279,5238
"11746","FBgn0038929","3R",22080382,22083473,3091
"11747","FBgn0027562","3R",16597073,16604861,7788
"11748","FBgn0264389","X",15064836,15066432,1596
"11749","FBgn0027600","2L",10032690,10038954,6264
"11750","FBgn0039779","3R",30490074,30491987,1913
"11751","FBgn0014342","3R",5548115,5551168,3053
"11752","FBgn0051525","3R",4427030,4428200,1170
"11753","FBgn0262533","3L",17874715,17876573,1858
"11754","FBgn0050120","2R",18446548,18449420,2872
"11755","FBgn0265317","3R",27438871,27440944,2073
"11756","FBgn0261616","X",7413869,7414662,793
"11757","FBgn0264364","2L",16004325,16005461,1136
"11758","FBgn0033814","2R",13231758,13235296,3538
"11759","FBgn0052654","X",12596047,12609910,13863
"11760","FBgn0035290","3L",1893408,1910197,16789
"11761","FBgn0034068","2R",16024628,16028161,3533
"11762","FBgn0013272","2R",22317662,22329416,11754
"11763","FBgn0003483","3R",15837419,15844415,6996
"11764","FBgn0061196","X",4959929,4961128,1199
"11765","FBgn0267078","X",14786412,14787897,1485
"11766","FBgn0032853","2L",20133755,20134923,1168
"11767","FBgn0039836","3R",31253659,31254900,1241
"11768","FBgn0264508","2R",11616195,11616694,499
"11769","FBgn0035523","3L",4277962,4281585,3623
"11770","FBgn0027552","3L",3941008,3942465,1457
"11771","FBgn0052123","3L",13279776,13279828,52
"11772","FBgn0260223","2R",21690215,21691139,924
"11773","FBgn0261266","2L",11988735,11989882,1147
"11774","FBgn0266046","2R",24351477,24369689,18212
"11775","FBgn0036195","3L",11697126,11699263,2137
"11776","FBgn0035726","3L",6969658,6971666,2008
"11777","FBgn0036891","3L",19606208,19608368,2160
"11778","FBgn0039293","3R",25221589,25224118,2529
"11779","FBgn0016031","3L",5343619,5355923,12304
"11780","FBgn0034318","2R",18188978,18189654,676
"11781","FBgn0037976","3R",11994175,12005473,11298
"11782","FBgn0265963","2R",21727495,21728195,700
"11783","FBgn0033286","2R",8368344,8370038,1694
"11784","FBgn0020407","3R",16264271,16266891,2620
"11785","FBgn0267905","Y",3263180,3263488,308
"11786","FBgn0260860","3R",30180232,30181486,1254
"11787","FBgn0263551","2R",22985211,22985319,108
"11788","FBgn0036888","3L",19586253,19589111,2858
"11789","FBgn0283649","3L",15956550,15958433,1883
"11790","FBgn0266438","2R",24411870,24415295,3425
"11791","FBgn0039642","3R",29147016,29148172,1156
"11792","FBgn0065057","X",21051686,21051734,48
"11793","FBgn0038440","3R",16497817,16498959,1142
"11794","FBgn0264572","3L",20389853,20391387,1534
"11795","FBgn0037179","3L",22694083,22694648,565
"11796","FBgn0026754","2R",16843296,16845038,1742
"11797","FBgn0267789","3R",31568103,31569097,994
"11798","FBgn0039521","3R",27502090,27502956,866
"11799","FBgn0266251","3R",18374536,18376497,1961
"11800","FBgn0065098","3R",23730048,23730429,381
"11801","FBgn0032066","2L",8765273,8768710,3437
"11802","FBgn0003444","2L",277582,282167,4585
"11803","FBgn0038515","3R",17532325,17534587,2262
"11804","FBgn0267633","3L",22176423,22177599,1176
"11805","FBgn0085506","211000022278760",562,879,317
"11806","FBgn0000715","2R",9906294,9910457,4163
"11807","FBgn0050468","2R",15504201,15506000,1799
"11808","FBgn0265660","2R",16849095,16849895,800
"11809","FBgn0038945","3R",22341236,22342251,1015
"11810","FBgn0028852","2L",15297808,15299367,1559
"11811","FBgn0045471","3R",20121060,20122277,1217
"11812","FBgn0267459","3L",961769,962471,702
"11813","FBgn0032077","2L",8941945,8943257,1312
"11814","FBgn0027082","3L",2650161,2651850,1689
"11815","FBgn0039589","3R",28606079,28608372,2293
"11816","FBgn0050360","2R",8465158,8467595,2437
"11817","FBgn0261046","3R",17473935,17505667,31732
"11818","FBgn0263039","3L",628435,643900,15465
"11819","FBgn0265174","2R",16955458,16957308,1850
"11820","FBgn0261385","2R",7590119,7595242,5123
"11821","FBgn0266617","4",42774,43374,600
"11822","FBgn0011726","2R",24044453,24046805,2352
"11823","FBgn0053194","2L",8477349,8478088,739
"11824","FBgn0058469","X",122493,122706,213
"11825","FBgn0053325","3R",8678954,8680034,1080
"11826","FBgn0267579","2L",17560813,17566551,5738
"11827","FBgn0026175","X",19816072,19816700,628
"11828","FBgn0039557","3R",27919844,27921089,1245
"11829","FBgn0025373","2R",11305511,11307528,2017
"11830","FBgn0267642","3L",6376706,6377197,491
"11831","FBgn0051093","3R",25789819,25790471,652
"11832","FBgn0003250","3L",16852527,16862517,9990
"11833","FBgn0038466","3R",17008269,17012533,4264
"11834","FBgn0264715","2R",21762995,21763994,999
"11835","FBgn0260645","3R",6377797,6378233,436
"11836","FBgn0005654","2R",13202728,13206547,3819
"11837","FBgn0085312","3R",18721967,18722590,623
"11838","FBgn0261817","3R",10143070,10143483,413
"11839","FBgn0085361","X",20141010,20141476,466
"11840","FBgn0267282","2L",7753183,7753383,200
"11841","FBgn0263632","3L",11629505,11629580,75
"11842","FBgn0037744","3R",9759622,9761208,1586
"11843","FBgn0260746","3R",11999278,12003516,4238
"11844","FBgn0039691","3R",29745337,29747513,2176
"11845","FBgn0000557","3R",31738468,31743306,4838
"11846","FBgn0042111","3R",27242335,27245249,2914
"11847","FBgn0039489","3R",27116745,27118532,1787
"11848","FBgn0003345","X",15804370,15827682,23312
"11849","FBgn0022344","3R",16613398,16614391,993
"11850","FBgn0263478","3L",17528700,17528840,140
"11851","FBgn0036624","3L",16386327,16390816,4489
"11852","FBgn0034819","2R",23085881,23086268,387
"11853","FBgn0264341","2L",4000018,4000806,788
"11854","FBgn0020392","3L",8176135,8178429,2294
"11855","FBgn0013690","mitochondrion_genome",1322,1383,61
"11856","FBgn0011555","2R",11341714,11342760,1046
"11857","FBgn0051141","3R",23923300,23924319,1019
"11858","FBgn0032414","2L",12114360,12129896,15536
"11859","FBgn0266631","2R",9868219,9869159,940
"11860","FBgn0262782","2L",10393774,10396332,2558
"11861","FBgn0030278","X",11182931,11183476,545
"11862","FBgn0052182","3L",17758112,17759553,1441
"11863","FBgn0030642","X",15466184,15467757,1573
"11864","FBgn0031875","2L",6957008,6959104,2096
"11865","FBgn0035534","3L",4364550,4365243,693
"11866","FBgn0039879","3R",31800963,31802774,1811
"11867","FBgn0037857","3R",10950284,10951797,1513
"11868","FBgn0037562","3R",8287876,8288613,737
"11869","FBgn0266930","3L",22643881,22644470,589
"11870","FBgn0034221","2R",17453399,17455729,2330
"11871","FBgn0003882","3R",4387742,4389813,2071
"11872","FBgn0030452","X",13129018,13134839,5821
"11873","FBgn0259226","2R",8573368,8584779,11411
"11874","FBgn0266827","2L",5941995,5942584,589
"11875","FBgn0263036","3L",22502978,22503830,852
"11876","FBgn0037852","3R",10879572,10882188,2616
"11877","FBgn0039702","3R",29814921,29816451,1530
"11878","FBgn0035025","2R",24565554,24568082,2528
"11879","FBgn0035686","3L",6160814,6161589,775
"11880","FBgn0035355","3L",2599297,2600242,945
"11881","FBgn0267595","211000022280341",1,740,739
"11882","FBgn0262699","X",4667290,4679537,12247
"11883","FBgn0030510","X",13677899,13680500,2601
"11884","FBgn0036763","3L",17849727,17852453,2726
"11885","FBgn0032814","2L",19584235,19586440,2205
"11886","FBgn0004864","X",11360930,11368098,7168
"11887","FBgn0033408","2R",9395330,9396206,876
"11888","FBgn0263612","2L",9584670,9586044,1374
"11889","FBgn0037291","3R",4981999,4984232,2233
"11890","FBgn0032803","2L",19538425,19539740,1315
"11891","FBgn0265269","2L",4257572,4258425,853
"11892","FBgn0261641","3R",6361672,6368288,6616
"11893","FBgn0037325","3R",5425369,5427257,1888
"11894","FBgn0031115","X",20427411,20429673,2262
"11895","FBgn0285947","X",19598031,19599806,1775
"11896","FBgn0264829","3R",12258737,12262879,4142
"11897","FBgn0262543","2L",19910648,19911811,1163
"11898","FBgn0086048","X",21050898,21050978,80
"11899","FBgn0030777","X",16705971,16706874,903
"11900","FBgn0053401","2R",19748405,19748539,134
"11901","FBgn0267901","Y",3241623,3242076,453
"11902","FBgn0033285","2R",8367163,8367927,764
"11903","FBgn0013693","mitochondrion_genome",6344,6408,64
"11904","FBgn0031545","2L",3517273,3519651,2378
"11905","FBgn0261565","3L",16865295,16922487,57192
"11906","FBgn0013812","3R",21024580,21042499,17919
"11907","FBgn0034583","2R",21070368,21072789,2421
"11908","FBgn0264911","2R",4895730,4907685,11955
"11909","FBgn0029724","X",4768727,4770137,1410
"11910","FBgn0058178","3L",25798441,26014112,215671
"11911","FBgn0029137","2L",12100765,12103285,2520
"11912","FBgn0267798","3R",1366234,1366601,367
"11913","FBgn0053315","2L",19074992,19075412,420
"11914","FBgn0261549","X",8907068,9029476,122408
"11915","FBgn0046294","2R",17246530,17247383,853
"11916","FBgn0052733","X",6952336,6952809,473
"11917","FBgn0000274","3R",30695537,30697138,1601
"11918","FBgn0026263","3L",8054333,8058713,4380
"11919","FBgn0263000","2R",20562463,20563001,538
"11920","FBgn0262828","X",7450383,7452199,1816
"11921","FBgn0001257","3L",4224006,4236147,12141
"11922","FBgn0264909","2R",4507995,4508445,450
"11923","FBgn0032473","2L",13160527,13163153,2626
"11924","FBgn0052445","3L",21639359,21640710,1351
"11925","FBgn0264478","3L",8159361,8159774,413
"11926","FBgn0034307","2R",18158257,18160310,2053
"11927","FBgn0266941","3L",18077581,18078103,522
"11928","FBgn0266937","3L",18852573,18861363,8790
"11929","FBgn0040705","2L",4454626,4455207,581
"11930","FBgn0020370","2R",13152885,13159141,6256
"11931","FBgn0030940","X",18606610,18617589,10979
"11932","FBgn0039638","3R",29128584,29130972,2388
"11933","FBgn0039817","3R",31098868,31101169,2301
"11934","FBgn0250844","2L",14547498,14549109,1611
"11935","FBgn0266220","2L",6871335,6872536,1201
"11936","FBgn0265821","2L",7174368,7174790,422
"11937","FBgn0035622","3L",5601096,5603979,2883
"11938","FBgn0086532","2R",13168498,13170744,2246
"11939","FBgn0028534","2L",13846752,13847799,1047
"11940","FBgn0030597","X",14916756,14918800,2044
"11941","FBgn0266233","3R",5994791,5995817,1026
"11942","FBgn0036687","3L",17020348,17022856,2508
"11943","FBgn0038354","3R",15704676,15708434,3758
"11944","FBgn0264326","3R",23348128,23355163,7035
"11945","FBgn0011695","2R",24026172,24027518,1346
"11946","FBgn0267267","2L",21950874,21951163,289
"11947","FBgn0262982","3R",7348849,7349552,703
"11948","FBgn0038272","3R",14892392,14893954,1562
"11949","FBgn0032297","2L",10744075,10756325,12250
"11950","FBgn0053551","3R",8862933,8863005,72
"11951","FBgn0039559","3R",27932982,27937853,4871
"11952","FBgn0036168","3L",11513705,11518904,5199
"11953","FBgn0032090","2L",9024320,9031836,7516
"11954","FBgn0267140","3R",4896417,4897287,870
"11955","FBgn0259682","2R",18757074,18761082,4008
"11956","FBgn0015572","3R",7536687,7538615,1928
"11957","FBgn0259678","2R",9716348,9748121,31773
"11958","FBgn0033871","2R",13824858,13825572,714
"11959","FBgn0036850","3L",19099123,19100363,1240
"11960","FBgn0031335","2L",1354911,1355924,1013
"11961","FBgn0005677","2L",16466512,16485998,19486
"11962","FBgn0029948","X",7378140,7378953,813
"11963","FBgn0030009","X",8147949,8148705,756
"11964","FBgn0263257","X",15386038,15441252,55214
"11965","FBgn0267046","X",19933541,19934294,753
"11966","FBgn0267040","X",4373981,4377716,3735
"11967","FBgn0010280","3L",16113212,16121651,8439
"11968","FBgn0035068","2R",24797925,24798613,688
"11969","FBgn0035789","3L",7485967,7487918,1951
"11970","FBgn0040809","3L",14943730,14944331,601
"11971","FBgn0051404","3R",19375043,19376023,980
"11972","FBgn0031333","2L",1352970,1354109,1139
"11973","FBgn0039864","3R",31678147,31679880,1733
"11974","FBgn0034717","2R",22293400,22296955,3555
"11975","FBgn0266823","2L",16965475,16965767,292
"11976","FBgn0031161","X",21117159,21120444,3285
"11977","FBgn0032017","2L",8309876,8311195,1319
"11978","FBgn0265200","3R",7720049,7721124,1075
"11979","FBgn0052528","X",19746041,19748458,2417
"11980","FBgn0000008","2R",22136968,22172834,35866
"11981","FBgn0262272","2L",13747609,13747697,88
"11982","FBgn0030218","X",10598146,10602714,4568
"11983","FBgn0031756","2L",5965391,5967752,2361
"11984","FBgn0051191","3R",20909213,20945530,36317
"11985","FBgn0283712","X",12584385,12592193,7808
"11986","FBgn0053505","2R",14858845,14860758,1913
"11987","FBgn0030766","X",16640968,16650309,9341
"11988","FBgn0039670","3R",29587237,29588104,867
"11989","FBgn0260436","2R",11864161,11864941,780
"11990","FBgn0053752","2R",12545689,12546301,612
"11991","FBgn0266678","3L",12514605,12515009,404
"11992","FBgn0039305","3R",25262741,25263292,551
"11993","FBgn0267477","3L",1963143,1964285,1142
"11994","FBgn0262108","X",13744928,13745476,548
"11995","FBgn0033635","2R",11436243,11442216,5973
"11996","FBgn0012016","2L",2462593,2462686,93
"11997","FBgn0086350","2R",17054546,17056835,2289
"11998","FBgn0001137","2L",8431086,8433598,2512
"11999","FBgn0050431","2R",6202725,6205224,2499
"12000","FBgn0052192","3L",18040317,18041738,1421
"12001","FBgn0266874","2L",22032625,22033798,1173
"12002","FBgn0264568","3L",21594597,21595460,863
"12003","FBgn0040507","3L",2237608,2243719,6111
"12004","FBgn0031320","2L",1182297,1184020,1723
"12005","FBgn0264090","X",18930335,19028629,98294
"12006","FBgn0044817","X",14000210,14000889,679
"12007","FBgn0038584","3R",18221522,18223682,2160
"12008","FBgn0030725","X",16083232,16085751,2519
"12009","FBgn0266762","2R",3468952,3470223,1271
"12010","FBgn0033961","2R",14756516,14757072,556
"12011","FBgn0004034","X",356509,361245,4736
"12012","FBgn0030462","X",13257392,13258495,1103
"12013","FBgn0264869","2L",850702,851163,461
"12014","FBgn0053476","2R",10409985,10410570,585
"12015","FBgn0035449","3L",3468023,3471309,3286
"12016","FBgn0035656","3L",5967545,5976007,8462
"12017","FBgn0038423","3R",16368855,16370533,1678
"12018","FBgn0261019","3R",18255530,18257677,2147
"12019","FBgn0051888","2L",8683806,8683877,71
"12020","FBgn0004191","2L",13211925,13212116,191
"12021","FBgn0262721","2L",3694431,3695020,589
"12022","FBgn0032156","2L",9903279,9908633,5354
"12023","FBgn0038582","3R",18220526,18221473,947
"12024","FBgn0050016","2R",10874892,10875392,500
"12025","FBgn0265707","3L",705330,705723,393
"12026","FBgn0085317","3R",22446763,22447263,500
"12027","FBgn0085233","2R",21796395,21796941,546
"12028","FBgn0038448","3R",16611419,16613400,1981
"12029","FBgn0036762","3L",17846916,17849601,2685
"12030","FBgn0020306","2R",21323430,21341847,18417
"12031","FBgn0035620","3L",5595542,5597422,1880
"12032","FBgn0265577","2R",17671068,17671295,227
"12033","FBgn0033373","2R",9089774,9092893,3119
"12034","FBgn0027296","X",2260207,2262515,2308
"12035","FBgn0032123","2L",9521210,9540060,18850
"12036","FBgn0000477","3R",18019375,18021161,1786
"12037","FBgn0261635","3L",16320830,16321272,442
"12038","FBgn0266040","2R",23840577,23840777,200
"12039","FBgn0266862","2R",17189305,17189945,640
"12040","FBgn0265088","2L",13146636,13146908,272
"12041","FBgn0036228","3L",11952301,11953317,1016
"12042","FBgn0033708","2R",12298747,12302240,3493
"12043","FBgn0264985","3R",30624829,30625592,763
"12044","FBgn0051717","2L",10250737,10251714,977
"12045","FBgn0031813","2L",6426724,6448403,21679
"12046","FBgn0029693","X",4097592,4101031,3439
"12047","FBgn0052590","X",14838352,14839106,754
"12048","FBgn0052303","3L",2273744,2273815,71
"12049","FBgn0034435","2R",19341809,19345754,3945
"12050","FBgn0035625","3L",5630983,5652094,21111
"12051","FBgn0035944","3L",8966829,8968171,1342
"12052","FBgn0266096","X",4956646,5063868,107222
"12053","FBgn0004581","2R",23853270,23858921,5651
"12054","FBgn0261434","3R",4345015,4346646,1631
"12055","FBgn0014850","3L",15660549,15661015,466
"12056","FBgn0285944","X",16455027,16533096,78069
"12057","FBgn0259984","2L",13550139,13639411,89272
"12058","FBgn0037717","3R",9581306,9586648,5342
"12059","FBgn0267132","3R",31491078,31492678,1600
"12060","FBgn0261596","2R",22640526,22641419,893
"12061","FBgn0030096","X",9160124,9162090,1966
"12062","FBgn0035057","2R",24760664,24762605,1941
"12063","FBgn0037440","3R",6371026,6376044,5018
"12064","FBgn0030200","X",10417429,10418219,790
"12065","FBgn0035091","2R",24986044,24990489,4445
"12066","FBgn0264837","3R",30034540,30034907,367
"12067","FBgn0263091","2L",22340622,22341291,669
"12068","FBgn0085452","2R",23358612,23359204,592
"12069","FBgn0032455","2L",12713276,12721843,8567
"12070","FBgn0035374","3L",2780899,2782105,1206
"12071","FBgn0036952","3L",20218500,20220420,1920
"12072","FBgn0085370","2L",18532025,18590342,58317
"12073","FBgn0026438","2L",737212,744395,7183
"12074","FBgn0052601","X",14378806,14379826,1020
"12075","FBgn0039290","3R",25199818,25214255,14437
"12076","FBgn0031085","X",20051294,20052519,1225
"12077","FBgn0030615","X",15113302,15116542,3240
"12078","FBgn0035063","2R",24780917,24781779,862
"12079","FBgn0032857","2L",20385293,20414800,29507
"12080","FBgn0267206","3R",22539996,22541279,1283
"12081","FBgn0264842","3L",15884593,15885747,1154
"12082","FBgn0266952","3L",10240093,10240511,418
"12083","FBgn0035179","3L",993983,995703,1720
"12084","FBgn0024733","3L",23093190,23095471,2281
"12085","FBgn0039429","3R",26458249,26460981,2732
"12086","FBgn0050354","2R",8677219,8677661,442
"12087","FBgn0040764","2R",11154896,11155293,397
"12088","FBgn0250903","2L",8524999,8528618,3619
"12089","FBgn0040153","X",14203961,14211457,7496
"12090","FBgn0034187","2R",17062775,17066546,3771
"12091","FBgn0038453","3R",16643605,16645171,1566
"12092","FBgn0029174","2L",9888005,9890119,2114
"12093","FBgn0053387","2R",19753558,19753692,134
"12094","FBgn0035393","3L",3055079,3055842,763
"12095","FBgn0050121","2R",18739131,18741658,2527
"12096","FBgn0267279","2L",17497011,17497697,686
"12097","FBgn0026398","2L",1520491,1522156,1665
"12098","FBgn0024330","3R",9766031,9768984,2953
"12099","FBgn0014870","2R",16861321,16867714,6393
"12100","FBgn0043792","2R",24928747,24937477,8730
"12101","FBgn0053805","2L",21428850,21429289,439
"12102","FBgn0039703","3R",29816738,29817764,1026
"12103","FBgn0037230","3R",4292274,4294840,2566
"12104","FBgn0266355","X",21409402,21410546,1144
"12105","FBgn0031238","2L",252589,271744,19155
"12106","FBgn0037560","3R",8260706,8261898,1192
"12107","FBgn0025825","3R",5472810,5474600,1790
"12108","FBgn0260991","2R",7278467,7281795,3328
"12109","FBgn0034665","2R",21837605,21838798,1193
"12110","FBgn0030230","X",10749077,10757666,8589
"12111","FBgn0053263","3L",13423320,13424168,848
"12112","FBgn0037743","3R",9756491,9759313,2822
"12113","FBgn0015300","2R",24499243,24500267,1024
"12114","FBgn0265270","2L",17353730,17354668,938
"12115","FBgn0027602","X",17413267,17422145,8878
"12116","FBgn0038243","3R",14567611,14568847,1236
"12117","FBgn0011584","2L",10009381,10013170,3789
"12118","FBgn0035639","3L",5810973,5812228,1255
"12119","FBgn0015229","3R",21850694,21856266,5572
"12120","FBgn0040900","X",2186855,2187741,886
"12121","FBgn0031260","2L",542786,544653,1867
"12122","FBgn0052112","3L",12741718,12745154,3436
"12123","FBgn0027107","X",20267821,20269769,1948
"12124","FBgn0038691","3R",19228217,19229276,1059
"12125","FBgn0034282","2R",17866178,17872015,5837
"12126","FBgn0083938","2L",4641296,4642872,1576
"12127","FBgn0034495","2R",20274597,20276142,1545
"12128","FBgn0019925","3R",15343653,15346176,2523
"12129","FBgn0085488","2R",16824664,16826648,1984
"12130","FBgn0058045","3L",24028515,24035859,7344
"12131","FBgn0051454","3R",8521658,8523520,1862
"12132","FBgn0035923","3L",8721324,8726108,4784
"12133","FBgn0265812","2L",15822296,15822942,646
"12134","FBgn0037213","3R",4174632,4186751,12119
"12135","FBgn0031164","X",21202499,21203341,842
"12136","FBgn0083044","3L",5762860,5763000,140
"12137","FBgn0038701","3R",19390270,19392132,1862
"12138","FBgn0037090","3L",21501421,21503959,2538
"12139","FBgn0267691","2R",12419702,12420291,589
"12140","FBgn0037636","3R",8813490,8820682,7192
"12141","FBgn0010422","2L",15058919,15060757,1838
"12142","FBgn0023518","X",1881313,1889950,8637
"12143","FBgn0002609","3R",26021823,26023127,1304
"12144","FBgn0034729","2R",22425733,22426977,1244
"12145","FBgn0039723","3R",29927255,29928766,1511
"12146","FBgn0036716","3L",17380026,17382728,2702
"12147","FBgn0051559","3R",6150116,6157235,7119
"12148","FBgn0064225","2L",22532279,22536884,4605
"12149","FBgn0040658","2R",22669145,22670622,1477
"12150","FBgn0033188","2R",7526118,7532981,6863
"12151","FBgn0036913","3L",19871139,19881783,10644
"12152","FBgn0035980","3L",9364350,9365240,890
"12153","FBgn0040070","2L",9613166,9616404,3238
"12154","FBgn0053721","3R",22331069,22331801,732
"12155","FBgn0010238","2R",12453190,12465630,12440
"12156","FBgn0260399","3R",18746370,18750360,3990
"12157","FBgn0052226","3L",20297129,20302141,5012
"12158","FBgn0032387","2L",11981591,11984380,2789
"12159","FBgn0267098","X",9069741,9070087,346
"12160","FBgn0031619","2L",4651403,4652892,1489
"12161","FBgn0266726","4",597624,598274,650
"12162","FBgn0031768","2L",6048002,6050474,2472
"12163","FBgn0264698","3L",23183599,23183913,314
"12164","FBgn0003060","3R",13611583,13612433,850
"12165","FBgn0262592","3L",10624728,10625599,871
"12166","FBgn0267763","3R",24573770,24574304,534
"12167","FBgn0041231","3L",11751305,11752474,1169
"12168","FBgn0024985","X",1393054,1397337,4283
"12169","FBgn0010549","2R",9390165,9395281,5116
"12170","FBgn0261924","2L",15863200,15863663,463
"12171","FBgn0035229","3L",1537137,1544823,7686
"12172","FBgn0051869","2L",10772038,10801109,29071
"12173","FBgn0264472","3L",7945713,7946322,609
"12174","FBgn0038424","3R",16432998,16434740,1742
"12175","FBgn0051860","2L",12164241,12166704,2463
"12176","FBgn0011274","2L",17413248,17433161,19913
"12177","FBgn0015905","2L",1077948,1080803,2855
"12178","FBgn0038966","3R",22423316,22424929,1613
"12179","FBgn0266653","3L",5135542,5136224,682
"12180","FBgn0029867","X",6347103,6349236,2133
"12181","FBgn0266169","2L",10053604,10054100,496
"12182","FBgn0032793","2L",19491647,19493253,1606
"12183","FBgn0050361","2R",8473956,8532294,58338
"12184","FBgn0038057","3R",12460414,12462418,2004
"12185","FBgn0086061","3R",29862626,29862717,91
"12186","FBgn0265915","2R",21070749,21071895,1146
"12187","FBgn0037383","3R",5822026,5824532,2506
"12188","FBgn0032262","2L",10507859,10510453,2594
"12189","FBgn0266867","2R",22596486,22597125,639
"12190","FBgn0038808","3R",20580115,20580764,649
"12191","FBgn0053842","2L",21499920,21500448,528
"12192","FBgn0028670","3R",18390323,18399169,8846
"12193","FBgn0040506","2L",12925611,12929823,4212
"12194","FBgn0010222","3R",9042508,9050555,8047
"12195","FBgn0000810","X",2242138,2246041,3903
"12196","FBgn0038045","3R",12426578,12427877,1299
"12197","FBgn0032957","2L",21663806,21677530,13724
"12198","FBgn0267227","X",7679331,7679621,290
"12199","FBgn0085243","2R",24665427,24666022,595
"12200","FBgn0058160","3L",26215815,26229433,13618
"12201","FBgn0053196","2L",4477462,4614300,136838
"12202","FBgn0034563","2R",20972916,20974017,1101
"12203","FBgn0013972","3R",29682503,29685758,3255
"12204","FBgn0267309","3L",10978011,10978302,291
"12205","FBgn0036920","3L",19927194,19928508,1314
"12206","FBgn0052074","3L",11131883,11132322,439
"12207","FBgn0041191","3R",5568921,5570491,1570
"12208","FBgn0032878","2L",20724209,20726551,2342
"12209","FBgn0038751","3R",19918507,19920584,2077
"12210","FBgn0051459","3R",19840845,19842040,1195
"12211","FBgn0262421","X",9091230,9091299,69
"12212","FBgn0001250","X",16752189,16783434,31245
"12213","FBgn0262730","X",6225647,6236218,10571
"12214","FBgn0034313","2R",18175255,18180197,4942
"12215","FBgn0082922","2R",17616756,17616917,161
"12216","FBgn0265661","2R",18805595,18807195,1600
"12217","FBgn0003933","X",16254008,16254117,109
"12218","FBgn0038621","3R",18410080,18411631,1551
"12219","FBgn0264995","2L",20794806,20795255,449
"12220","FBgn0265651","2R",15371695,15372595,900
"12221","FBgn0034854","2R",23371360,23377045,5685
"12222","FBgn0032491","2L",13229832,13230549,717
"12223","FBgn0037779","3R",10047252,10048797,1545
"12224","FBgn0035044","2R",24661503,24662409,906
"12225","FBgn0267399","3R",5890842,5891926,1084
"12226","FBgn0037540","3R",8013791,8016610,2819
"12227","FBgn0259214","4",328193,358917,30724
"12228","FBgn0040467","X",9158622,9159375,753
"12229","FBgn0053783","3R",10066770,10067567,797
"12230","FBgn0030502","X",13613193,13616586,3393
"12231","FBgn0263461","3L",891250,891475,225
"12232","FBgn0037102","3L",21568059,21568898,839
"12233","FBgn0036337","3L",13019715,13022688,2973
"12234","FBgn0038638","3R",18669390,18674679,5289
"12235","FBgn0030438","X",12970711,12973967,3256
"12236","FBgn0259862","Y",2562678,2563924,1246
"12237","FBgn0033988","2R",14981263,14991336,10073
"12238","FBgn0030691","X",15780398,15783710,3312
"12239","FBgn0030674","X",15712628,15731935,19307
"12240","FBgn0039620","3R",28992977,29020406,27429
"12241","FBgn0039870","3R",31744282,31745178,896
"12242","FBgn0037420","3R",6284462,6285200,738
"12243","FBgn0266681","3L",10893646,10894743,1097
"12244","FBgn0082987","2R",19443127,19443256,129
"12245","FBgn0267918","3R",14911205,14911982,777
"12246","FBgn0001208","3L",7760453,7763166,2713
"12247","FBgn0031047","X",19638767,19640746,1979
"12248","FBgn0031287","2L",851251,852730,1479
"12249","FBgn0037413","3R",6227512,6228828,1316
"12250","FBgn0050379","2R",7939956,7941870,1914
"12251","FBgn0033168","2R",7427905,7428593,688
"12252","FBgn0053193","3R",23058609,23061304,2695
"12253","FBgn0051827","2L",15705171,15706220,1049
"12254","FBgn0030809","X",16956232,16968679,12447
"12255","FBgn0283659","2L",15008489,15009724,1235
"12256","FBgn0264571","3L",20439954,20440563,609
"12257","FBgn0027934","3R",7526369,7528068,1699
"12258","FBgn0032266","2L",10534322,10536587,2265
"12259","FBgn0030937","X",18526862,18528266,1404
"12260","FBgn0043853","3R",7472907,7473222,315
"12261","FBgn0038617","3R",18400373,18402716,2343
"12262","FBgn0037430","3R",6340095,6341424,1329
"12263","FBgn0038018","3R",12363667,12364680,1013
"12264","FBgn0285976","rDNA",70290,70358,68
"12265","FBgn0051909","2L",7257512,7258198,686
"12266","FBgn0053669","X",6399455,6400100,645
"12267","FBgn0010333","3L",1300879,1302683,1804
"12268","FBgn0032233","2L",10376168,10379905,3737
"12269","FBgn0031081","X",19961297,19969323,8026
"12270","FBgn0267882","Y",3136899,3137576,677
"12271","FBgn0015664","2L",9964147,9967229,3082
"12272","FBgn0051669","2L",2013179,2013250,71
"12273","FBgn0265691","X",6001511,6005713,4202
"12274","FBgn0036405","3L",14051206,14052469,1263
"12275","FBgn0030326","X",11704310,11705300,990
"12276","FBgn0040754","2R",13220283,13221015,732
"12277","FBgn0262127","3R",14697689,14724261,26572
"12278","FBgn0083009","X",17146074,17146215,141
"12279","FBgn0086129","2R",24086604,24092014,5410
"12280","FBgn0035626","3L",5654681,5657384,2703
"12281","FBgn0266323","2L",710568,715307,4739
"12282","FBgn0053467","2R",15055503,15056241,738
"12283","FBgn0264693","3L",4122907,4134550,11643
"12284","FBgn0260386","3R",8250497,8260718,10221
"12285","FBgn0029594","X",1880282,1881432,1150
"12286","FBgn0002578","3R",26014721,26016487,1766
"12287","FBgn0030814","X",17081447,17083356,1909
"12288","FBgn0259847","Y",1035827,1036823,996
"12289","FBgn0027499","2R",10800420,10808938,8518
"12290","FBgn0263327","2L",18256531,18257174,643
"12291","FBgn0029725","X",4775984,4777375,1391
"12292","FBgn0039301","3R",25247658,25249100,1442
"12293","FBgn0031652","2L",4948206,4949784,1578
"12294","FBgn0032727","2L",18955481,18957311,1830
"12295","FBgn0040922","X",7424527,7424842,315
"12296","FBgn0011481","3R",18192494,18199595,7101
"12297","FBgn0039197","3R",24382920,24385052,2132
"12298","FBgn0034783","2R",22837361,22839291,1930
"12299","FBgn0034225","2R",17478158,17482118,3960
"12300","FBgn0003950","X",21111414,21116914,5500
"12301","FBgn0264513","3L",13287769,13291770,4001
"12302","FBgn0033597","2R",11251751,11253398,1647
"12303","FBgn0037046","3L",21033554,21034203,649
"12304","FBgn0034910","2R",23823357,23824868,1511
"12305","FBgn0265832","X",13395830,13396361,531
"12306","FBgn0029801","X",5755574,5759751,4177
"12307","FBgn0283554","3R",9989120,9989180,60
"12308","FBgn0052713","X",8456837,8457632,795
"12309","FBgn0261269","2R",14270729,14275495,4766
"12310","FBgn0267330","2L",10426887,10428632,1745
"12311","FBgn0033195","2R",7587773,7590109,2336
"12312","FBgn0021761","2L",11004820,11010921,6101
"12313","FBgn0259964","2L",11839912,11840329,417
"12314","FBgn0035239","3L",1602954,1617355,14401
"12315","FBgn0266954","3L",11231307,11231588,281
"12316","FBgn0053907","2L",21429655,21430066,411
"12317","FBgn0030008","X",8145839,8147855,2016
"12318","FBgn0085432","4",69326,114270,44944
"12319","FBgn0260008","3L",25120709,25126171,5462
"12320","FBgn0267575","3R",6810819,6811246,427
"12321","FBgn0261808","3R",11197592,11208633,11041
"12322","FBgn0267071","X",4775033,4775232,199
"12323","FBgn0029157","3R",24938710,24944956,6246
"12324","FBgn0003429","3R",24662491,24711595,49104
"12325","FBgn0283508","2R",17502354,17508645,6291
"12326","FBgn0004378","3L",1241568,1245910,4342
"12327","FBgn0050018","2R",10791459,10793109,1650
"12328","FBgn0010317","3L",3466428,3468098,1670
"12329","FBgn0015331","3R",4233047,4235041,1994
"12330","FBgn0266892","2L",14021583,14022033,450
"12331","FBgn0266932","3L",20901854,20902524,670
"12332","FBgn0029823","X",5913067,5916797,3730
"12333","FBgn0030051","X",8571099,8573593,2494
"12334","FBgn0051075","3R",26985624,26988517,2893
"12335","FBgn0036380","3L",13840197,13842240,2043
"12336","FBgn0031031","X",19580350,19581981,1631
"12337","FBgn0266836","2L",2044517,2045381,864
"12338","FBgn0032040","2L",8399021,8400078,1057
"12339","FBgn0000117","X",1891401,1900646,9245
"12340","FBgn0265304","2R",8744045,8744376,331
"12341","FBgn0034486","2R",20238495,20239429,934
"12342","FBgn0034566","2R",20978901,20984043,5142
"12343","FBgn0029705","X",4327080,4329457,2377
"12344","FBgn0036680","3L",16939100,16957689,18589
"12345","FBgn0002899","3L",8137808,8142014,4206
"12346","FBgn0263624","3R",25794066,25794421,355
"12347","FBgn0065087","3R",12413388,12413446,58
"12348","FBgn0005616","2L",3462218,3466112,3894
"12349","FBgn0042105","3R",7786170,7787923,1753
"12350","FBgn0003319","3R",16116161,16145284,29123
"12351","FBgn0000052","2L",6041181,6046050,4869
"12352","FBgn0033240","2R",7956150,7958254,2104
"12353","FBgn0028871","2L",14424315,14425189,874
"12354","FBgn0032135","2L",9616469,9623109,6640
"12355","FBgn0015925","2R",16264652,16266959,2307
"12356","FBgn0032003","2L",8215915,8216901,986
"12357","FBgn0034538","2R",20652557,20655096,2539
"12358","FBgn0267713","3R",21401654,21402289,635
"12359","FBgn0050220","2R",19728887,19728958,71
"12360","FBgn0051029","3R",30129279,30132395,3116
"12361","FBgn0025454","2R",12185667,12188431,2764
"12362","FBgn0053490","3L",11572797,11574663,1866
"12363","FBgn0000447","3R",8651391,8652916,1525
"12364","FBgn0264344","2L",7232165,7232813,648
"12365","FBgn0039849","3R",31459822,31463037,3215
"12366","FBgn0019890","2L",13898828,13904661,5833
"12367","FBgn0265726","X",13692292,13717835,25543
"12368","FBgn0053269","3L",11581415,11582197,782
"12369","FBgn0036226","3L",11947675,11949248,1573
"12370","FBgn0250869","X",6330842,6333028,2186
"12371","FBgn0036198","3L",11710507,11711386,879
"12372","FBgn0028374","3R",12526188,12529076,2888
"12373","FBgn0033996","2R",15201253,15204466,3213
"12374","FBgn0035889","3L",8402168,8405277,3109
"12375","FBgn0031379","2L",1982217,1984514,2297
"12376","FBgn0033580","2R",11146289,11147128,839
"12377","FBgn0039594","3R",28675041,28695939,20898
"12378","FBgn0032723","2L",18916347,18943960,27613
"12379","FBgn0037742","3R",9754735,9756510,1775
"12380","FBgn0029664","X",3482965,3484555,1590
"12381","FBgn0036147","3L",11198166,11206016,7850
"12382","FBgn0267288","2L",10903731,10903959,228
"12383","FBgn0264984","3R",11977640,11978178,538
"12384","FBgn0036224","3L",11941912,11943485,1573
"12385","FBgn0015737","3R",27288769,27291592,2823
"12386","FBgn0015543","2R",11893123,11893195,72
"12387","FBgn0030694","X",15799426,15800961,1535
"12388","FBgn0052241","3L",4465105,4466630,1525
"12389","FBgn0086024","2R",21328263,21328371,108
"12390","FBgn0004907","2R",10099677,10109687,10010
"12391","FBgn0260467","3R",22362620,22364580,1960
"12392","FBgn0036382","3L",13878994,13883056,4062
"12393","FBgn0264674","X",10256629,10261804,5175
"12394","FBgn0267808","3R",5858195,5858894,699
"12395","FBgn0052698","X",9783223,9855449,72226
"12396","FBgn0083026","2L",20418523,20418654,131
"12397","FBgn0267202","3R",16213488,16213787,299
"12398","FBgn0033085","2R",6668150,6668738,588
"12399","FBgn0032750","2L",19063295,19064726,1431
"12400","FBgn0053116","2L",19533479,19537363,3884
"12401","FBgn0052826","X",20025099,20025170,71
"12402","FBgn0031778","2L",6078453,6079736,1283
"12403","FBgn0052704","X",9232726,9236585,3859
"12404","FBgn0038414","3R",16323415,16325128,1713
"12405","FBgn0021750","3R",15340667,15343218,2551
"12406","FBgn0259715","2L",6395853,6397249,1396
"12407","FBgn0267628","3L",22424469,22424909,440
"12408","FBgn0267692","3R",15922929,15924187,1258
"12409","FBgn0030795","X",16806068,16808515,2447
"12410","FBgn0035458","3L",3753693,3755201,1508
"12411","FBgn0020249","3R",8356978,8359964,2986
"12412","FBgn0033600","2R",11259106,11259976,870
"12413","FBgn0031718","2L",5549709,5550835,1126
"12414","FBgn0035410","3L",3172817,3178580,5763
"12415","FBgn0031904","2L",7384486,7388253,3767
"12416","FBgn0265347","2R",10786195,10786493,298
"12417","FBgn0029894","X",6695866,6698567,2701
"12418","FBgn0265365","2R",12015095,12015895,800
"12419","FBgn0285910","X",3880748,3882967,2219
"12420","FBgn0003310","2L",1049674,1077815,28141
"12421","FBgn0265530","2R",16814395,16815495,1100
"12422","FBgn0033730","2R",12407793,12408523,730
"12423","FBgn0032209","2L",10292679,10295385,2706
"12424","FBgn0043012","3R",21269209,21270075,866
"12425","FBgn0039520","3R",27487927,27489968,2041
"12426","FBgn0033816","2R",13237256,13239468,2212
"12427","FBgn0267229","3R",28970541,28972750,2209
"12428","FBgn0040996","2L",20294693,20295804,1111
"12429","FBgn0263916","2L",6562325,6564709,2384
"12430","FBgn0037254","3R",4480812,4484215,3403
"12431","FBgn0267821","2L",10388105,10393228,5123
"12432","FBgn0000042","X",5900861,5905399,4538
"12433","FBgn0262182","3L",22518196,22518291,95
"12434","FBgn0285969","2R",8230532,8231065,533
"12435","FBgn0260855","X",806076,808200,2124
"12436","FBgn0034214","2R",17425670,17427511,1841
"12437","FBgn0036249","3L",12120019,12121185,1166
"12438","FBgn0250755","3R",31799634,31805278,5644
"12439","FBgn0015351","3R",16649981,16651157,1176
"12440","FBgn0037127","3L",21739479,21740309,830
"12441","FBgn0265795","2L",11331889,11332736,847
"12442","FBgn0264883","2L",1840070,1840808,738
"12443","FBgn0266100","3L",11850645,11938872,88227
"12444","FBgn0039798","3R",30729837,30731165,1328
"12445","FBgn0029860","X",6294517,6295345,828
"12446","FBgn0031002","X",19236059,19241840,5781
"12447","FBgn0004622","3R",29950796,29969447,18651
"12448","FBgn0032910","2L",21057706,21071502,13796
"12449","FBgn0043534","2R",20504251,20505136,885
"12450","FBgn0083041","X",17145557,17145695,138
"12451","FBgn0033480","2R",10066650,10067242,592
"12452","FBgn0053958","2R",18184382,18192851,8469
"12453","FBgn0069969","2R",924636,951252,26616
"12454","FBgn0265954","2L",18954584,18954970,386
"12455","FBgn0086446","2L",19132323,19133097,774
"12456","FBgn0265717","X",10893189,10893676,487
"12457","FBgn0053348","2R",6949482,6950284,802
"12458","FBgn0085310","3R",17612887,17613404,517
"12459","FBgn0000318","2L",5520135,5521382,1247
"12460","FBgn0030719","X",15987008,15991974,4966
"12461","FBgn0035965","3L",9135709,9137181,1472
"12462","FBgn0259173","3L",7142991,7157073,14082
"12463","FBgn0030678","X",15737493,15738954,1461
"12464","FBgn0038876","3R",21270126,21271408,1282
"12465","FBgn0040351","X",1013984,1026703,12719
"12466","FBgn0015553","2L",18679631,18682075,2444
"12467","FBgn0266982","3L",19861458,19861869,411
"12468","FBgn0264351","2L",10862194,10864697,2503
"12469","FBgn0053835","2L",21488378,21488870,492
"12470","FBgn0086251","2L",21145137,21148546,3409
"12471","FBgn0032314","2L",10906270,10908893,2623
"12472","FBgn0033742","2R",12471915,12474021,2106
"12473","FBgn0017578","3L",19262232,19264184,1952
"12474","FBgn0026314","3R",11168503,11170246,1743
"12475","FBgn0050497","2R",7737019,7782637,45618
"12476","FBgn0260444","3R",12630647,12633188,2541
"12477","FBgn0013435","2R",10067217,10068702,1485
"12478","FBgn0040823","3L",9974651,10139360,164709
"12479","FBgn0261634","3L",16032762,16033190,428
"12480","FBgn0005390","X",5958207,5964247,6040
"12481","FBgn0037217","3R",4204493,4215314,10821
"12482","FBgn0043796","X",6299054,6301285,2231
"12483","FBgn0260763","2R",17684855,17685548,693
"12484","FBgn0032475","2L",13169649,13176785,7136
"12485","FBgn0029121","3L",5563774,5565103,1329
"12486","FBgn0053307","2L",13839262,13841520,2258
"12487","FBgn0032525","2L",13447538,13449497,1959
"12488","FBgn0052214","3L",19467346,19468160,814
"12489","FBgn0266815","2R",14433430,14433895,465
"12490","FBgn0037076","3L",21344768,21349288,4520
"12491","FBgn0039225","3R",24788054,24797955,9901
"12492","FBgn0261679","3R",15348048,15350391,2343
"12493","FBgn0262482","3L",21065852,21066238,386
"12494","FBgn0026619","2R",12753026,12756414,3388
"12495","FBgn0030482","X",13396899,13401224,4325
"12496","FBgn0030097","X",9189326,9190605,1279
"12497","FBgn0265040","3R",4673977,4674610,633
"12498","FBgn0035522","3L",4263719,4277778,14059
"12499","FBgn0033021","2R",5360331,5363104,2773
"12500","FBgn0267770","3R",25657393,25658274,881
"12501","FBgn0266231","3R",5969983,5970598,615
"12502","FBgn0038610","3R",18378124,18381178,3054
"12503","FBgn0053108","3R",23995659,23997544,1885
"12504","FBgn0019938","2R",14595611,14601216,5605
"12505","FBgn0050404","2R",21716780,21719963,3183
"12506","FBgn0028499","3R",18199857,18215001,15144
"12507","FBgn0010240","X",15925105,15928529,3424
"12508","FBgn0261108","3R",8349815,8352817,3002
"12509","FBgn0262812","2R",8592195,8592969,774
"12510","FBgn0011975","X",14015045,14015126,81
"12511","FBgn0010612","2L",10975522,10976399,877
"12512","FBgn0011888","2R",6164876,6164948,72
"12513","FBgn0266234","3R",6101958,6104863,2905
"12514","FBgn0035914","3L",8604657,8617074,12417
"12515","FBgn0264253","2L",14345915,14346688,773
"12516","FBgn0266225","2L",21869956,21870652,696
"12517","FBgn0039852","3R",31543032,31566165,23133
"12518","FBgn0023090","2L",21361216,21367288,6072
"12519","FBgn0039862","3R",31622136,31664646,42510
"12520","FBgn0264744","2L",3169820,3171092,1272
"12521","FBgn0265447","3L",10803997,10805934,1937
"12522","FBgn0032364","2L",11517391,11519783,2392
"12523","FBgn0051683","2L",20447734,20449964,2230
"12524","FBgn0002673","2L",16259414,16261877,2463
"12525","FBgn0039538","3R",27679291,27680336,1045
"12526","FBgn0053230","3L",1618414,1620397,1983
"12527","FBgn0035254","3L",1665138,1666594,1456
"12528","FBgn0028668","3L",11474958,11475552,594
"12529","FBgn0038256","3R",14724760,14731509,6749
"12530","FBgn0263847","2L",3046765,3046880,115
"12531","FBgn0036323","3L",12892658,12894758,2100
"12532","FBgn0052761","X",5832298,5832368,70
"12533","FBgn0004192","2L",13215839,13216030,191
"12534","FBgn0053408","2R",19745828,19745962,134
"12535","FBgn0266738","3R",15811648,15811908,260
"12536","FBgn0032511","2L",13370103,13371110,1007
"12537","FBgn0065107","2L",5196035,5196097,62
"12538","FBgn0052829","2L",6915581,6916445,864
"12539","FBgn0024689","2L",17478442,17481029,2587
"12540","FBgn0264785","3R",5257037,5269507,12470
"12541","FBgn0087011","2R",1649061,1778937,129876
"12542","FBgn0036085","3L",10557023,10559082,2059
"12543","FBgn0263489","2L",8485725,8485925,200
"12544","FBgn0267812","3R",4737500,4737908,408
"12545","FBgn0036915","3L",19910300,19912504,2204
"12546","FBgn0024909","3R",7907333,7909721,2388
"12547","FBgn0052945","3R",4577939,4578644,705
"12548","FBgn0263077","2R",7623242,7651787,28545
"12549","FBgn0027081","2L",12103751,12107170,3419
"12550","FBgn0034870","2R",23502946,23503815,869
"12551","FBgn0032429","2L",12426631,12427709,1078
"12552","FBgn0000536","X",16278328,16285618,7290
"12553","FBgn0028343","X",17571854,17579229,7375
"12554","FBgn0037841","3R",10852724,10853644,920
"12555","FBgn0052484","3L",3047087,3050159,3072
"12556","FBgn0023529","X",2271008,2275068,4060
"12557","FBgn0037618","3R",8725479,8726730,1251
"12558","FBgn0033448","2R",9828104,9836642,8538
"12559","FBgn0266884","2L",857403,860079,2676
"12560","FBgn0259152","3R",25127502,25131155,3653
"12561","FBgn0062411","3R",30963290,30964320,1030
"12562","FBgn0267596","211000022280703",699,1770,1071
"12563","FBgn0004698","2R",15311510,15318239,6729
"12564","FBgn0046225","3R",11437785,11467372,29587
"12565","FBgn0025809","X",15784009,15785583,1574
"12566","FBgn0036836","3L",18985905,18988323,2418
"12567","FBgn0032341","2L",11100963,11106645,5682
"12568","FBgn0016762","2R",23694003,23695232,1229
"12569","FBgn0036155","3L",11361986,11364885,2899
"12570","FBgn0031775","2L",6067668,6068594,926
"12571","FBgn0045501","2L",1793668,1794917,1249
"12572","FBgn0263030","2R",22655549,22657135,1586
"12573","FBgn0035956","3L",9012686,9019246,6560
"12574","FBgn0261529","2L",14328429,14333860,5431
"12575","FBgn0031638","2L",4847766,4849499,1733
"12576","FBgn0039415","3R",26133154,26137148,3994
"12577","FBgn0259982","2L",15256581,15257642,1061
"12578","FBgn0265189","3R",24915840,24917864,2024
"12579","FBgn0040396","X",3175018,3176223,1205
"12580","FBgn0260463","3R",9687060,9692775,5715
"12581","FBgn0036811","3L",18745856,18746623,767
"12582","FBgn0031377","2L",1975463,1980755,5292
"12583","FBgn0026143","X",1028291,1030556,2265
"12584","FBgn0039488","3R",27115152,27116707,1555
"12585","FBgn0266938","3L",18596322,18596792,470
"12586","FBgn0261830","2L",8143401,8144047,646
"12587","FBgn0052133","3L",14020315,14029121,8806
"12588","FBgn0036999","3L",20474466,20477003,2537
"12589","FBgn0038531","3R",17627127,17629012,1885
"12590","FBgn0034915","2R",23849246,23850301,1055
"12591","FBgn0031707","2L",5517737,5518949,1212
"12592","FBgn0033032","2R",5671741,5672800,1059
"12593","FBgn0011279","3L",12396171,12396957,786
"12594","FBgn0264865","2L",21106805,21107306,501
"12595","FBgn0052126","3L",13212365,13212436,71
"12596","FBgn0033783","2R",12930912,12934045,3133
"12597","FBgn0052985","2L",8962533,8964620,2087
"12598","FBgn0083055","3R",20822610,20822749,139
"12599","FBgn0266984","3L",18583437,18584235,798
"12600","FBgn0086064","3L",827537,827620,83
"12601","FBgn0082966","3L",13042944,13043083,139
"12602","FBgn0261399","Y",9833,10786,953
"12603","FBgn0036975","3L",20353449,20356632,3183
"12604","FBgn0039161","3R",24172628,24184144,11516
"12605","FBgn0000629","3L",10634575,10638130,3555
"12606","FBgn0035241","3L",1610696,1615801,5105
"12607","FBgn0036849","3L",19097999,19099064,1065
"12608","FBgn0039561","3R",27942796,27948021,5225
"12609","FBgn0030912","X",18314124,18321193,7069
"12610","FBgn0265913","3L",14885341,14886183,842
"12611","FBgn0015230","3R",16788311,16790021,1710
"12612","FBgn0053995","2L",5043270,5048365,5095
"12613","FBgn0000147","3R",11963124,11964826,1702
"12614","FBgn0260468","3R",30056859,30058131,1272
"12615","FBgn0263529","2R",7406733,7406837,104
"12616","FBgn0028992","3R",17391594,17393020,1426
"12617","FBgn0040066","X",2585980,2588217,2237
"12618","FBgn0262484","3L",3483832,3484653,821
"12619","FBgn0050192","2R",23138589,23139085,496
"12620","FBgn0040607","3R",26726133,26726681,548
"12621","FBgn0039528","3R",27597563,27607396,9833
"12622","FBgn0026162","3R",6819894,6819966,72
"12623","FBgn0250821","3R",4251894,4253043,1149
"12624","FBgn0031951","2L",7800147,7802098,1951
"12625","FBgn0033869","2R",13794777,13805231,10454
"12626","FBgn0031817","2L",6466217,6467698,1481
"12627","FBgn0031426","2L",2410624,2415322,4698
"12628","FBgn0027055","3L",20839096,20841576,2480
"12629","FBgn0261113","3R",18914968,18926989,12021
"12630","FBgn0053459","2R",16488053,16489182,1129
"12631","FBgn0085354","X",16714449,16721411,6962
"12632","FBgn0265065","3R",14421751,14422549,798
"12633","FBgn0260719","2L",21589784,21590593,809
"12634","FBgn0019952","3R",24276260,24278792,2532
"12635","FBgn0051161","3R",22616511,22618300,1789
"12636","FBgn0266214","2L",20583656,20626206,42550
"12637","FBgn0013997","3L",12146519,12156990,10471
"12638","FBgn0033723","2R",12379614,12380426,812
"12639","FBgn0030521","X",13779847,13782170,2323
"12640","FBgn0039566","3R",27963415,27966958,3543
"12641","FBgn0035570","3L",4709209,4709890,681
"12642","FBgn0041247","2L",7452520,7454212,1692
"12643","FBgn0035865","3L",8290286,8295327,5041
"12644","FBgn0040255","3R",11166177,11167981,1804
"12645","FBgn0029804","X",5765855,5770780,4925
"12646","FBgn0026077","3R",6088799,6100887,12088
"12647","FBgn0262840","2R",12430595,12431296,701
"12648","FBgn0038749","3R",19914396,19915412,1016
"12649","FBgn0260464","3R",13779624,13780795,1171
"12650","FBgn0261703","X",15297766,15319074,21308
"12651","FBgn0266831","2L",15485697,15485951,254
"12652","FBgn0266329","2L",16490224,16490890,666
"12653","FBgn0000427","X",7867161,7873222,6061
"12654","FBgn0267977","X",15472804,15475400,2596
"12655","FBgn0262683","2L",11521765,11522776,1011
"12656","FBgn0013689","mitochondrion_genome",5983,6047,64
"12657","FBgn0262559","3R",18226396,18228718,2322
"12658","FBgn0052639","X",13235925,13236566,641
"12659","FBgn0037935","3R",11684672,11688133,3461
"12660","FBgn0004430","3L",1227747,1228238,491
"12661","FBgn0036691","3L",17035668,17036865,1197
"12662","FBgn0035285","3L",1865430,1869491,4061
"12663","FBgn0030204","X",10458186,10459676,1490
"12664","FBgn0027507","2R",5653676,5656778,3102
"12665","FBgn0015805","3L",4626734,4629467,2733
"12666","FBgn0005633","3L",19989551,19991220,1669
"12667","FBgn0085367","X",7768737,7769161,424
"12668","FBgn0264725","3L",12032557,12032999,442
"12669","FBgn0001089","2L",6003574,6006827,3253
"12670","FBgn0030936","X",18521074,18522445,1371
"12671","FBgn0033187","2R",7519280,7522541,3261
"12672","FBgn0028509","2L",13835564,13898712,63148
"12673","FBgn0262211","2R",20584709,20584820,111
"12674","FBgn0030317","X",11581957,11584175,2218
"12675","FBgn0037385","3R",5830062,5831785,1723
"12676","FBgn0266255","3R",26070378,26071578,1200
"12677","FBgn0266400","3R",26015516,26016487,971
"12678","FBgn0032598","2L",16738850,16742610,3760
"12679","FBgn0030757","X",16542124,16547520,5396
"12680","FBgn0030269","X",11137859,11139689,1830
"12681","FBgn0033340","2R",8900241,8900617,376
"12682","FBgn0031771","2L",6060842,6062757,1915
"12683","FBgn0039726","3R",29934582,29935888,1306
"12684","FBgn0036544","3L",15900156,15924861,24705
"12685","FBgn0032223","2L",10333734,10339185,5451
"12686","FBgn0004374","2L",20075757,20089698,13941
"12687","FBgn0032964","2L",21782046,21784065,2019
"12688","FBgn0033364","2R",9017815,9019032,1217
"12689","FBgn0028737","2R",16868222,16869280,1058
"12690","FBgn0267005","2L",3854288,3854994,706
"12691","FBgn0085440","X",13161714,13189164,27450
"12692","FBgn0260780","X",11893943,11899920,5977
"12693","FBgn0004858","2L",14390628,14409549,18921
"12694","FBgn0262097","2L",5379095,5381074,1979
"12695","FBgn0017551","2L",6852315,6853866,1551
"12696","FBgn0038068","3R",12636540,12637976,1436
"12697","FBgn0050506","2R",11399770,11399841,71
"12698","FBgn0034168","2R",16945555,16947231,1676
"12699","FBgn0266879","2L",66318,66524,206
"12700","FBgn0053822","2L",21466216,21467238,1022
"12701","FBgn0266869","2L",13241807,13244724,2917
"12702","FBgn0037913","3R",11559896,11567054,7158
"12703","FBgn0263581","2L",20316005,20317623,1618
"12704","FBgn0263464","2R",19414355,19414490,135
"12705","FBgn0024188","2R",11360706,11361871,1165
"12706","FBgn0262263","X",18124357,18124450,93
"12707","FBgn0026239","3R",18984025,19022436,38411
"12708","FBgn0032652","2L",17591315,17592299,984
"12709","FBgn0029733","X",4906900,4908821,1921
"12710","FBgn0035402","3L",3145405,3148358,2953
"12711","FBgn0082925","2R",22607544,22607678,134
"12712","FBgn0033518","2R",10418718,10419761,1043
"12713","FBgn0030329","X",11716756,11719894,3138
"12714","FBgn0030747","X",16405509,16414651,9142
"12715","FBgn0010411","2R",20263979,20264848,869
"12716","FBgn0037703","3R",9516007,9520938,4931
"12717","FBgn0026085","X",4113701,4114929,1228
"12718","FBgn0265303","2R",8241596,8242017,421
"12719","FBgn0267019","2L",6480661,6480930,269
"12720","FBgn0260969","3R",29835610,29836288,678
"12721","FBgn0034021","2R",15472175,15482834,10659
"12722","FBgn0051244","3R",19397430,19398567,1137
"12723","FBgn0038744","3R",19890689,19898738,8049
"12724","FBgn0038829","3R",20819129,20821848,2719
"12725","FBgn0037120","3L",21724326,21728806,4480
"12726","FBgn0014002","3L",15137738,15142840,5102
"12727","FBgn0085792","Y",3041350,3042787,1437
"12728","FBgn0263213","X",19948924,19949147,223
"12729","FBgn0039868","3R",31737035,31737999,964
"12730","FBgn0039335","3R",25473490,25475756,2266
"12731","FBgn0031276","2L",773547,774017,470
"12732","FBgn0041720","2L",13244370,13244561,191
"12733","FBgn0039599","3R",28790522,28791461,939
"12734","FBgn0035264","3L",1730993,1735767,4774
"12735","FBgn0035490","3L",4046596,4059660,13064
"12736","FBgn0037074","3L",21337681,21343716,6035
"12737","FBgn0030558","X",14261223,14265379,4156
"12738","FBgn0032668","2L",18153123,18154516,1393
"12739","FBgn0034523","2R",20586222,20587238,1016
"12740","FBgn0034957","2R",24017421,24019896,2475
"12741","FBgn0265940","2L",14234754,14235156,402
"12742","FBgn0264672","2L",2381097,2383073,1976
"12743","FBgn0265551","3R",20485778,20486679,901
"12744","FBgn0032365","2L",11519832,11521444,1612
"12745","FBgn0030087","X",9093612,9103739,10127
"12746","FBgn0037320","3R",5386717,5387664,947
"12747","FBgn0086072","3L",3222475,3222541,66
"12748","FBgn0267804","3R",7544843,7545250,407
"12749","FBgn0260393","3L",20223932,20225324,1392
"12750","FBgn0034346","2R",18426421,18430333,3912
"12751","FBgn0030913","X",18322958,18356191,33233
"12752","FBgn0036460","3L",14982835,14984486,1651
"12753","FBgn0033952","2R",14656798,14658755,1957
"12754","FBgn0035382","3L",2961534,2963788,2254
"12755","FBgn0051076","3R",26989035,26989852,817
"12756","FBgn0031455","2L",2758427,2759677,1250
"12757","FBgn0030479","X",13380166,13384877,4711
"12758","FBgn0032635","2L",17410641,17413499,2858
"12759","FBgn0032819","2L",19758879,19760986,2107
"12760","FBgn0265796","2L",11338551,11338920,369
"12761","FBgn0033465","2R",9910893,9913488,2595
"12762","FBgn0087005","3R",5236092,5237315,1223
"12763","FBgn0051928","2L",1492295,1493859,1564
"12764","FBgn0262980","X",4213025,4213421,396
"12765","FBgn0033917","2R",14243778,14246066,2288
"12766","FBgn0038472","3R",17041896,17043136,1240
"12767","FBgn0033763","2R",12655954,12659341,3387
"12768","FBgn0263623","3R",25792600,25793303,703
"12769","FBgn0031424","2L",2391660,2410662,19002
"12770","FBgn0086898","2R",10816037,10819884,3847
"12771","FBgn0034403","2R",18851907,18853043,1136
"12772","FBgn0019830","2L",2768590,2770069,1479
"12773","FBgn0000351","2L",6674682,6676635,1953
"12774","FBgn0053904","2L",21438170,21438764,594
"12775","FBgn0035462","3L",3806710,3809090,2380
"12776","FBgn0031945","2L",7767628,7775033,7405
"12777","FBgn0265544","2L",17175763,17176385,622
"12778","FBgn0031413","2L",2308761,2357356,48595
"12779","FBgn0036734","3L",17514298,17524740,10442
"12780","FBgn0035286","3L",1870019,1871564,1545
"12781","FBgn0045038","2L",7864642,7871432,6790
"12782","FBgn0262486","X",15222657,15223582,925
"12783","FBgn0011919","3R",6496039,6496111,72
"12784","FBgn0052260","3L",4142364,4145966,3602
"12785","FBgn0038039","3R",12408316,12411768,3452
"12786","FBgn0263985","2L",9251138,9251459,321
"12787","FBgn0030114","X",9250420,9255953,5533
"12788","FBgn0051866","2L",11992902,11994054,1152
"12789","FBgn0259112","2R",14769599,14771295,1696
"12790","FBgn0035159","3L",710820,711850,1030
"12791","FBgn0040735","2R",18388995,18389443,448
"12792","FBgn0050446","2R",6684745,6689974,5229
"12793","FBgn0264993","2L",11743746,11744422,676
"12794","FBgn0043806","3L",9093053,9094856,1803
"12795","FBgn0266623","2R",7578665,7579929,1264
"12796","FBgn0267262","2L",17579478,17580006,528
"12797","FBgn0038053","3R",12449296,12456355,7059
"12798","FBgn0263088","2L",12174090,12174638,548
"12799","FBgn0039544","3R",27707100,27710857,3757
"12800","FBgn0034007","2R",15296764,15298329,1565
"12801","FBgn0034785","2R",22845977,22847911,1934
"12802","FBgn0028912","2L",14598859,14598930,71
"12803","FBgn0262732","3L",16574436,16576871,2435
"12804","FBgn0052264","3L",3714826,3806459,91633
"12805","FBgn0036600","3L",16305225,16305870,645
"12806","FBgn0033486","2R",10117694,10121451,3757
"12807","FBgn0052576","X",16285953,16288533,2580
"12808","FBgn0022740","2R",17757405,17760517,3112
"12809","FBgn0035663","3L",6037111,6038188,1077
"12810","FBgn0262414","2R",19661289,19661369,80
"12811","FBgn0266282","3R",24189050,24193423,4373
"12812","FBgn0086672","2R",9095685,9095832,147
"12813","FBgn0260856","3L",5366455,5367381,926
"12814","FBgn0264884","2L",1872693,1873511,818
"12815","FBgn0036487","3L",15159100,15161138,2038
"12816","FBgn0028694","2L",5058404,5059790,1386
"12817","FBgn0030789","X",16789405,16791266,1861
"12818","FBgn0262511","2R",16324813,16336637,11824
"12819","FBgn0029893","X",6689296,6695007,5711
"12820","FBgn0038588","3R",18239420,18242159,2739
"12821","FBgn0052328","3L",1380238,1380309,71
"12822","FBgn0052473","3R",13302648,13312785,10137
"12823","FBgn0035687","3L",6163127,6164682,1555
"12824","FBgn0030900","X",18209427,18210741,1314
"12825","FBgn0264328","2R",24630901,24632932,2031
"12826","FBgn0052487","3L",3016150,3017256,1106
"12827","FBgn0262888","2R",21607687,21608477,790
"12828","FBgn0035621","3L",5598557,5599692,1135
"12829","FBgn0036708","3L",17324618,17325518,900
"12830","FBgn0267652","3R",21370918,21373575,2657
"12831","FBgn0031997","2L",8198882,8200652,1770
"12832","FBgn0259970","3L",13296530,13296860,330
"12833","FBgn0030931","X",18500127,18501258,1131
"12834","FBgn0053399","2R",19749143,19749277,134
"12835","FBgn0053704","2R",20950102,20951094,992
"12836","FBgn0037206","3L",22910491,22923532,13041
"12837","FBgn0263197","2R",17519024,17535866,16842
"12838","FBgn0027841","3R",18659618,18661126,1508
"12839","FBgn0033190","2R",7535919,7538297,2378
"12840","FBgn0039626","3R",29037058,29039071,2013
"12841","FBgn0029629","X",2609247,2610336,1089
"12842","FBgn0039079","3R",23483863,23485500,1637
"12843","FBgn0023171","2R",7931054,7932380,1326
"12844","FBgn0263050","2L",21166046,21168581,2535
"12845","FBgn0039582","3R",28352242,28353620,1378
"12846","FBgn0266124","3L",9451876,9452790,914
"12847","FBgn0083994","X",22917105,22917498,393
"12848","FBgn0085225","2R",18109985,18110494,509
"12849","FBgn0267074","X",5516993,5517500,507
"12850","FBgn0083054","2R",18142802,18142938,136
"12851","FBgn0034489","2R",20245760,20247624,1864
"12852","FBgn0035588","3L",5140440,5141646,1206
"12853","FBgn0046332","3R",31372427,31374198,1771
"12854","FBgn0020389","3L",19845293,19860925,15632
"12855","FBgn0270928","3R",18705501,18718916,13415
"12856","FBgn0036162","3L",11463570,11465864,2294
"12857","FBgn0037073","3L",21335215,21338232,3017
"12858","FBgn0030989","X",19168777,19170883,2106
"12859","FBgn0283451","X",1575132,1664869,89737
"12860","FBgn0262740","X",11430523,11454386,23863
"12861","FBgn0030970","X",18861197,18863776,2579
"12862","FBgn0011745","3R",12691743,12694232,2489
"12863","FBgn0052075","3L",11062726,11064941,2215
"12864","FBgn0267062","X",21187979,21188759,780
"12865","FBgn0039240","3R",24871202,24876654,5452
"12866","FBgn0035696","3L",6245933,6256665,10732
"12867","FBgn0034432","2R",19305172,19307445,2273
"12868","FBgn0030998","X",19208694,19212082,3388
"12869","FBgn0039959","3L",27967244,28012599,45355
"12870","FBgn0086040","2L",20353482,20353582,100
"12871","FBgn0262601","2L",10425483,10426627,1144
"12872","FBgn0265652","2R",15372045,15372345,300
"12873","FBgn0034826","2R",23139080,23140577,1497
"12874","FBgn0014859","2L",20683462,20714588,31126
"12875","FBgn0025683","2L",122624,130791,8167
"12876","FBgn0023479","3L",9074643,9092131,17488
"12877","FBgn0035231","3L",1553493,1555315,1822
"12878","FBgn0262377","2L",19569897,19569972,75
"12879","FBgn0035398","3L",3090985,3106958,15973
"12880","FBgn0029807","X",5777195,5781620,4425
"12881","FBgn0038685","3R",19177000,19177986,986
"12882","FBgn0035443","3L",3374282,3376649,2367
"12883","FBgn0038161","3R",13615917,13616492,575
"12884","FBgn0039022","3R",22758810,22761076,2266
"12885","FBgn0037941","3R",11721734,11732479,10745
"12886","FBgn0037553","3R",8220146,8222188,2042
"12887","FBgn0266534","3R",25102553,25103617,1064
"12888","FBgn0038361","3R",15788521,15789494,973
"12889","FBgn0267103","X",9595082,9595467,385
"12890","FBgn0031954","2L",7840452,7841262,810
"12891","FBgn0053394","2R",19750989,19751123,134
"12892","FBgn0035902","3L",8513874,8514921,1047
"12893","FBgn0034731","2R",22454741,22472995,18254
"12894","FBgn0261356","3R",10780965,10782267,1302
"12895","FBgn0031684","2L",5099177,5100288,1111
"12896","FBgn0086908","2R",24775534,24779901,4367
"12897","FBgn0066114","X",4131211,4132833,1622
"12898","FBgn0035722","3L",6956946,6958108,1162
"12899","FBgn0052582","X",15835601,15836923,1322
"12900","FBgn0267597","3L",18230629,18231056,427
"12901","FBgn0265156","3R",23011921,23012360,439
"12902","FBgn0085250","2R",10197136,10199711,2575
"12903","FBgn0036586","3L",16263343,16264151,808
"12904","FBgn0261439","2R",19391863,19395971,4108
"12905","FBgn0053247","X",14046772,14047495,723
"12906","FBgn0265766","2R",19909795,19911495,1700
"12907","FBgn0086691","2L",15274181,15275091,910
"12908","FBgn0264868","2L",4246209,4249676,3467
"12909","FBgn0039271","3R",25069927,25070914,987
"12910","FBgn0052670","X",10951609,10952486,877
"12911","FBgn0003210","X",4535635,4540626,4991
"12912","FBgn0037416","3R",6260211,6262105,1894
"12913","FBgn0267212","3R",25808044,25808679,635
"12914","FBgn0262599","2L",10850141,10854604,4463
"12915","FBgn0051793","2L",19003367,19008234,4867
"12916","FBgn0265670","2L",11663259,11663872,613
"12917","FBgn0052117","3L",12902925,12903711,786
"12918","FBgn0085456","3L",8804764,8805812,1048
"12919","FBgn0031295","2L",1026105,1026897,792
"12920","FBgn0029870","X",6365949,6370924,4975
"12921","FBgn0029729","X",4825974,4826833,859
"12922","FBgn0037958","3R",11879702,11882534,2832
"12923","FBgn0260458","3L",5780051,5784685,4634
"12924","FBgn0030884","X",17911462,17924163,12701
"12925","FBgn0039235","3R",24856383,24857559,1176
"12926","FBgn0263456","3L",9137860,9145693,7833
"12927","FBgn0000078","2R",17124764,17126369,1605
"12928","FBgn0020908","2R",2932595,2968052,35457
"12929","FBgn0035477","3L",3942710,3947278,4568
"12930","FBgn0028740","2R",17770405,17772552,2147
"12931","FBgn0065105","3R",27560928,27560970,42
"12932","FBgn0050285","2R",21687903,21688545,642
"12933","FBgn0038089","3R",12891956,12893158,1202
"12934","FBgn0033834","2R",13394615,13399368,4753
"12935","FBgn0037862","3R",11137177,11139742,2565
"12936","FBgn0032658","2L",17986399,17988619,2220
"12937","FBgn0034248","2R",17585195,17586294,1099
"12938","FBgn0036916","3L",19912405,19913715,1310
"12939","FBgn0267337","3R",7272617,7309629,37012
"12940","FBgn0032343","2L",11110557,11113061,2504
"12941","FBgn0053912","3L",20754976,20755685,709
"12942","FBgn0033273","2R",8167948,8170089,2141
"12943","FBgn0035019","2R",24529554,24531272,1718
"12944","FBgn0037372","3R",5753318,5754774,1456
"12945","FBgn0052767","X",5071027,5084768,13741
"12946","FBgn0038504","3R",17395199,17402515,7316
"12947","FBgn0082961","3R",5596201,5596340,139
"12948","FBgn0267570","3R",25586442,25589179,2737
"12949","FBgn0024997","X",2708684,2711668,2984
"12950","FBgn0021872","2R",21143545,21145750,2205
"12951","FBgn0038400","3R",16144401,16146855,2454
"12952","FBgn0051769","2L",14109597,14110739,1142
"12953","FBgn0053497","X",20181590,20186487,4897
"12954","FBgn0267068","X",18730421,18731243,822
"12955","FBgn0266236","3R",6877678,6885278,7600
"12956","FBgn0266866","2R",22378263,22379007,744
"12957","FBgn0034200","2R",17137240,17139595,2355
"12958","FBgn0263528","2L",10741885,10741987,102
"12959","FBgn0038208","3R",14148508,14151940,3432
"12960","FBgn0030455","X",13153461,13154924,1463
"12961","FBgn0035206","3L",1311719,1313377,1658
"12962","FBgn0052278","3L",3169286,3171767,2481
"12963","FBgn0000455","3R",12411809,12413759,1950
"12964","FBgn0025781","3R",23281201,23284123,2922
"12965","FBgn0085232","2R",21281063,21281656,593
"12966","FBgn0266931","3L",22473952,22474431,479
"12967","FBgn0053278","3L",7450853,7452159,1306
"12968","FBgn0036492","3L",15300915,15302785,1870
"12969","FBgn0034827","2R",23141999,23144497,2498
"12970","FBgn0266780","3L",10386450,10387797,1347
"12971","FBgn0034994","2R",24249055,24251303,2248
"12972","FBgn0266985","3L",17275050,17275549,499
"12973","FBgn0039797","3R",30726087,30728052,1965
"12974","FBgn0003396","2R",11159086,11217394,58308
"12975","FBgn0038980","3R",22497215,22520078,22863
"12976","FBgn0262808","3R",14256108,14256930,822
"12977","FBgn0035811","3L",7719350,7721472,2122
"12978","FBgn0029722","X",4705309,4707504,2195
"12979","FBgn0033287","2R",8371073,8372142,1069
"12980","FBgn0036793","3L",18600150,18617943,17793
"12981","FBgn0030347","X",11873319,11875346,2027
"12982","FBgn0002917","X",14266367,14277416,11049
"12983","FBgn0028544","2L",13944756,13947476,2720
"12984","FBgn0001224","3L",9381882,9382765,883
"12985","FBgn0038002","3R",12225282,12226339,1057
"12986","FBgn0262883","3R",30746685,30747172,487
"12987","FBgn0266723","2R",14757064,14757846,782
"12988","FBgn0031089","X",20148124,20155514,7390
"12989","FBgn0032202","2L",10264125,10265229,1104
"12990","FBgn0035873","3L",8320763,8322280,1517
"12991","FBgn0000360","X",8481837,8483311,1474
"12992","FBgn0053658","3R",24840509,24841163,654
"12993","FBgn0033089","2R",6675028,6676001,973
"12994","FBgn0038088","3R",12855544,12859246,3702
"12995","FBgn0267245","3L",4980832,4981599,767
"12996","FBgn0031925","2L",7605600,7607701,2101
"12997","FBgn0033264","2R",8123036,8125058,2022
"12998","FBgn0034537","2R",20644036,20645865,1829
"12999","FBgn0033916","2R",14239932,14243655,3723
"13000","FBgn0037613","3R",8712906,8718456,5550
"13001","FBgn0050163","2R",24662682,24663406,724
"13002","FBgn0050172","2R",24030546,24031427,881
"13003","FBgn0031730","2L",5706374,5713791,7417
"13004","FBgn0032693","2L",18651058,18653010,1952
"13005","FBgn0033921","2R",14300103,14302353,2250
"13006","FBgn0034663","2R",21834230,21835047,817
"13007","FBgn0033140","2R",7068572,7069896,1324
"13008","FBgn0261632","2R",14639361,14639762,401
"13009","FBgn0265383","3R",23485481,23486085,604
"13010","FBgn0283561","2L",21238301,21238361,60
"13011","FBgn0039139","3R",24032157,24034257,2100
"13012","FBgn0267270","2L",3264168,3265714,1546
"13013","FBgn0040318","3L",14583222,14599540,16318
"13014","FBgn0044011","2R",7153738,7155424,1686
"13015","FBgn0000239","2L",21174182,21179683,5501
"13016","FBgn0270925","3R",20013872,20018248,4376
"13017","FBgn0037679","3R",9332064,9334714,2650
"13018","FBgn0011885","2R",13432093,13432166,73
"13019","FBgn0262737","3L",21844788,21932702,87914
"13020","FBgn0040045","3L",24534090,24535468,1378
"13021","FBgn0001991","2L",16165831,16190540,24709
"13022","FBgn0028986","2L",20836621,20837985,1364
"13023","FBgn0086445","2L",19127260,19129326,2066
"13024","FBgn0034503","2R",20325844,20326806,962
"13025","FBgn0042185","3L",6550738,6593940,43202
"13026","FBgn0002781","3R",21350846,21377401,26555
"13027","FBgn0034485","2R",20236235,20239200,2965
"13028","FBgn0267511","rDNA",35941,38740,2799
"13029","FBgn0001942","2L",5981764,5985909,4145
"13030","FBgn0032883","2L",20754579,20757985,3406
"13031","FBgn0263616","3L",15437201,15437713,512
"13032","FBgn0035181","3L",1034697,1036298,1601
"13033","FBgn0034641","2R",21625030,21631422,6392
"13034","FBgn0265676","2L",9071032,9071607,575
"13035","FBgn0035392","3L",3052514,3054906,2392
"13036","FBgn0086558","X",6276876,6279647,2771
"13037","FBgn0039425","3R",26414088,26416192,2104
"13038","FBgn0002787","2R",24400028,24404527,4499
"13039","FBgn0038523","3R",17594386,17595057,671
"13040","FBgn0039827","3R",31196916,31203722,6806
"13041","FBgn0050075","2R",14375921,14376677,756
"13042","FBgn0037950","3R",11787176,11789393,2217
"13043","FBgn0038946","3R",22351696,22356264,4568
"13044","FBgn0267567","3R",7085660,7086140,480
"13045","FBgn0263512","X",5528927,5560183,31256
"13046","FBgn0036219","3L",11881384,11883546,2162
"13047","FBgn0264863","X",11139608,11141238,1630
"13048","FBgn0035228","3L",1534929,1536835,1906
"13049","FBgn0020556","3R",16742125,16773189,31064
"13050","FBgn0031918","2L",7466543,7472493,5950
"13051","FBgn0267571","3R",15417320,15420710,3390
"13052","FBgn0000426","2R",12183844,12184310,466
"13053","FBgn0052643","X",12984524,12985071,547
"13054","FBgn0037619","3R",8726854,8728370,1516
"13055","FBgn0035331","3L",2322693,2345799,23106
"13056","FBgn0000022","X",370031,370947,916
"13057","FBgn0030341","X",11850909,11852530,1621
"13058","FBgn0053433","2R",19736617,19736751,134
"13059","FBgn0265073","2L",19019396,19019871,475
"13060","FBgn0039348","3R",25611013,25624662,13649
"13061","FBgn0036817","3L",18863647,18865514,1867
"13062","FBgn0260462","3R",5237651,5251745,14094
"13063","FBgn0034766","2R",22702695,22703786,1091
"13064","FBgn0034882","2R",23602585,23603641,1056
"13065","FBgn0036008","3L",9506818,9509583,2765
"13066","FBgn0050471","2R",15533520,15537782,4262
"13067","FBgn0038474","3R",17072732,17073795,1063
"13068","FBgn0042119","3L",6131242,6132109,867
"13069","FBgn0013746","2L",8993818,8997379,3561
"13070","FBgn0033271","2R",8159406,8161565,2159
"13071","FBgn0051759","2L",12207709,12210110,2401
"13072","FBgn0261393","3R",7533496,7536390,2894
"13073","FBgn0003965","X",10923972,10925631,1659
"13074","FBgn0031696","2L",5278865,5283283,4418
"13075","FBgn0038109","3R",13009895,13011086,1191
"13076","FBgn0038869","3R",21217268,21218791,1523
"13077","FBgn0264481","3L",19909365,19910203,838
"13078","FBgn0035799","3L",7583454,7587248,3794
"13079","FBgn0002905","3R",12705523,12712299,6776
"13080","FBgn0266435","X",14875370,14882586,7216
"13081","FBgn0035334","3L",2372199,2372876,677
"13082","FBgn0265917","2L",15128559,15128971,412
"13083","FBgn0267308","3L",6162695,6163102,407
"13084","FBgn0283462","2R",13407011,13408358,1347
"13085","FBgn0262116","2R",4186835,4188127,1292
"13086","FBgn0002306","3R",7162808,7183702,20894
"13087","FBgn0266305","2L",12840895,12841323,428
"13088","FBgn0032284","2L",10688734,10689271,537
"13089","FBgn0031651","2L",4944256,4945361,1105
"13090","FBgn0051230","3R",18671679,18672094,415
"13091","FBgn0267166","X",18122123,18122919,796
"13092","FBgn0003886","3R",9731221,9733250,2029
"13093","FBgn0036805","3L",18682895,18684061,1166
"13094","FBgn0000577","2R",11524006,11528210,4204
"13095","FBgn0053920","3R",31044391,31045105,714
"13096","FBgn0265342","2R",10050348,10050874,526
"13097","FBgn0015872","2R",11411203,11429645,18442
"13098","FBgn0032015","2L",8306696,8308192,1496
"13099","FBgn0033812","2R",13228276,13230234,1958
"13100","FBgn0037020","3L",20778799,20780378,1579
"13101","FBgn0040780","2R",7832171,7835518,3347
"13102","FBgn0283658","2L",7426866,7430329,3463
"13103","FBgn0000339","2L",16309292,16310726,1434
"13104","FBgn0023213","4",915297,930715,15418
"13105","FBgn0260243","3R",8990645,8992949,2304
"13106","FBgn0030997","X",19196058,19201979,5921
"13107","FBgn0040107","2L",624617,625556,939
"13108","FBgn0266719","3R",25056286,25064348,8062
"13109","FBgn0262360","2R",13600645,13601099,454
"13110","FBgn0011880","2R",6166151,6166224,73
"13111","FBgn0022800","3R",25197571,25208283,10712
"13112","FBgn0052017","4",1137830,1162158,24328
"13113","FBgn0053093","3R",22530694,22531922,1228
"13114","FBgn0010750","3R",4750035,4777490,27455
"13115","FBgn0039805","3R",30867521,30869184,1663
"13116","FBgn0052081","3L",11027579,11029444,1865
"13117","FBgn0028962","3L",5146098,5149852,3754
"13118","FBgn0046297","2R",21803402,21804338,936
"13119","FBgn0054034","3R",21738345,21739110,765
"13120","FBgn0032059","2L",8684823,8685955,1132
"13121","FBgn0261260","X",9358496,9500129,141633
"13122","FBgn0030685","X",15751674,15760733,9059
"13123","FBgn0053884","2L",21497745,21498339,594
"13124","FBgn0033029","2R",5656406,5663222,6816
"13125","FBgn0052708","X",9085932,9086864,932
"13126","FBgn0037037","3L",20956934,20960660,3726
"13127","FBgn0086856","2L",273836,274766,930
"13128","FBgn0027106","X",6991612,6993612,2000
"13129","FBgn0000617","X",17842161,17843348,1187
"13130","FBgn0036349","3L",13378583,13379190,607
"13131","FBgn0001259","3L",20367198,20370259,3061
"13132","FBgn0013277","3R",12465453,12467776,2323
"13133","FBgn0261258","3L",21382501,21424416,41915
"13134","FBgn0004429","3L",1218082,1218696,614
"13135","FBgn0051665","2L",1836538,1858550,22012
"13136","FBgn0035439","3L",3330063,3333181,3118
"13137","FBgn0051102","3R",25293458,25295594,2136
"13138","FBgn0037375","3R",5781762,5787465,5703
"13139","FBgn0030773","X",16699152,16700170,1018
"13140","FBgn0041103","2L",15317954,15318901,947
"13141","FBgn0040069","X",6200188,6202559,2371
"13142","FBgn0039588","3R",28542274,28544817,2543
"13143","FBgn0031004","X",19245158,19247250,2092
"13144","FBgn0261537","3L",7465509,7468808,3299
"13145","FBgn0036940","3L",20130451,20131743,1292
"13146","FBgn0034195","2R",17122898,17124237,1339
"13147","FBgn0033375","2R",9096931,9098525,1594
"13148","FBgn0085692","211000022280328",7386,9527,2141
"13149","FBgn0067312","2L",20817815,20818532,717
"13150","FBgn0262249","3L",22669289,22669380,91
"13151","FBgn0036771","3L",17908143,17909683,1540
"13152","FBgn0036263","3L",12190696,12193688,2992
"13153","FBgn0030654","X",15570380,15572149,1769
"13154","FBgn0039727","3R",29935978,29948207,12229
"13155","FBgn0265905","2L",18309629,18310010,381
"13156","FBgn0085485","3L",9362108,9362734,626
"13157","FBgn0011758","X",17397478,17403278,5800
"13158","FBgn0052190","3L",17797738,17802279,4541
"13159","FBgn0034030","2R",15544316,15549984,5668
"13160","FBgn0035533","3L",4322491,4364102,41611
"13161","FBgn0036053","3L",9860217,9864349,4132
"13162","FBgn0039104","3R",23695221,23696245,1024
"13163","FBgn0011905","3R",12131356,12131427,71
"13164","FBgn0263532","X",3777382,3777505,123
"13165","FBgn0266651","3L",11632705,11633303,598
"13166","FBgn0028948","2L",15615357,15616351,994
"13167","FBgn0266840","2L",14885105,14885411,306
"13168","FBgn0031970","2L",7994388,7998151,3763
"13169","FBgn0259979","2R",5697872,5700212,2340
"13170","FBgn0038268","3R",14879457,14882631,3174
"13171","FBgn0086359","3R",10144668,10159134,14466
"13172","FBgn0263747","X",15773171,15778703,5532
"13173","FBgn0029661","X",3462474,3464044,1570
"13174","FBgn0263486","3L",21006379,21006520,141
"13175","FBgn0085328","3R",30249583,30250661,1078
"13176","FBgn0030542","X",14187253,14187841,588
"13177","FBgn0263215","X",11741001,11742477,1476
"13178","FBgn0030668","X",15697494,15700034,2540
"13179","FBgn0053873","2L",21524399,21524926,527
"13180","FBgn0086758","2L",1651258,1704682,53424
"13181","FBgn0267011","2L",19537965,19538223,258
"13182","FBgn0053223","X",8465690,8483885,18195
"13183","FBgn0052748","X",6516974,6517046,72
"13184","FBgn0037227","3R",4254708,4255833,1125
"13185","FBgn0052201","3L",18609620,18611862,2242
"13186","FBgn0263849","2R",20776727,20777749,1022
"13187","FBgn0031786","2L",6160400,6161309,909
"13188","FBgn0000662","2R",13819624,13824553,4929
"13189","FBgn0037996","3R",12208159,12210360,2201
"13190","FBgn0053474","2R",10421706,10422989,1283
"13191","FBgn0051826","2L",15771263,15773113,1850
"13192","FBgn0002564","3L",66430,68995,2565
"13193","FBgn0036774","3L",18106579,18107499,920
"13194","FBgn0034507","2R",20354108,20355067,959
"13195","FBgn0083033","2L",20419774,20419908,134
"13196","FBgn0263743","2R",20791462,20792192,730
"13197","FBgn0266847","2R",9213125,9213744,619
"13198","FBgn0052079","3L",11025561,11027332,1771
"13199","FBgn0263866","2L",5431842,5432604,762
"13200","FBgn0085320","3R",26425290,26425781,491
"13201","FBgn0040370","X",283186,294962,11776
"13202","FBgn0040007","2R",4515388,4516458,1070
"13203","FBgn0051272","3R",10756296,10759398,3102
"13204","FBgn0260396","3L",10623066,10623576,510
"13205","FBgn0266853","2R",18057915,18059075,1160
"13206","FBgn0284245","2R",11891135,11895762,4627
"13207","FBgn0036397","3L",13999380,14001880,2500
"13208","FBgn0028872","2L",14029262,14031539,2277
"13209","FBgn0051526","3R",4533248,4533940,692
"13210","FBgn0003360","X",10780893,10786958,6065
"13211","FBgn0040208","3R",5227289,5232209,4920
"13212","FBgn0029095","2L",861849,868354,6505
"13213","FBgn0038275","3R",14898739,14899617,878
"13214","FBgn0263463","2R",8724905,8725065,160
"13215","FBgn0259716","2L",6383435,6385512,2077
"13216","FBgn0051924","2L",1354101,1354919,818
"13217","FBgn0033232","2R",7915027,7916478,1451
"13218","FBgn0264952","2L",8205778,8206044,266
"13219","FBgn0052396","3L",6530729,6532429,1700
"13220","FBgn0036858","3L",19269772,19270642,870
"13221","FBgn0266071","2L",6138867,6139309,442
"13222","FBgn0004185","3R",23859467,23859630,163
"13223","FBgn0035271","3L",1777010,1777411,401
"13224","FBgn0035593","3L",5133871,5135670,1799
"13225","FBgn0052817","X",479066,480166,1100
"13226","FBgn0015618","3L",9837080,9838670,1590
"13227","FBgn0263251","3L",9972312,9974023,1711
"13228","FBgn0040747","2R",14933515,14933913,398
"13229","FBgn0085283","3L",18680409,18680779,370
"13230","FBgn0262408","2R",19661158,19661226,68
"13231","FBgn0053245","X",14049280,14050003,723
"13232","FBgn0046302","2L",18993360,18995934,2574
"13233","FBgn0037382","3R",5818794,5821440,2646
"13234","FBgn0032987","2L",22247111,22247875,764
"13235","FBgn0053533","2L",19419075,19419767,692
"13236","FBgn0033127","2R",7025010,7028082,3072
"13237","FBgn0083976","3L",182522,184424,1902
"13238","FBgn0039215","3R",24655160,24659379,4219
"13239","FBgn0015615","X",16588996,16593439,4443
"13240","FBgn0035273","3L",1797305,1798610,1305
"13241","FBgn0261994","3R",24367360,24368164,804
"13242","FBgn0003048","X",2225296,2238045,12749
"13243","FBgn0037611","3R",8676915,8678955,2040
"13244","FBgn0266902","2L",21889758,21891095,1337
"13245","FBgn0001220","2R",14252598,14256192,3594
"13246","FBgn0053868","2L",21537505,21538099,594
"13247","FBgn0032514","2L",13376455,13378538,2083
"13248","FBgn0040551","3R",13260356,13262227,1871
"13249","FBgn0001114","2L",8672698,8676804,4106
"13250","FBgn0261631","3L",6233491,6234056,565
"13251","FBgn0053876","2L",21517932,21518526,594
"13252","FBgn0267790","3R",9505853,9510324,4471
"13253","FBgn0037260","3R",4541356,4543215,1859
"13254","FBgn0259933","3L",3319555,3322489,2934
"13255","FBgn0267277","2L",21232745,21234035,1290
"13256","FBgn0030508","X",13669699,13676232,6533
"13257","FBgn0266350","X",3373159,3522787,149628
"13258","FBgn0014454","2L",7740562,7741537,975
"13259","FBgn0037234","3R",4319683,4326379,6696
"13260","FBgn0026207","3R",12676487,12679052,2565
"13261","FBgn0053117","2L",19912938,19913516,578
"13262","FBgn0036820","3L",18869230,18870057,827
"13263","FBgn0015904","3L",12580672,12596018,15346
"13264","FBgn0263605","3L",16226126,16228737,2611
"13265","FBgn0267538","3L",10048302,10048927,625
"13266","FBgn0034045","2R",15842760,15847362,4602
"13267","FBgn0063383","2R",17700472,17700559,87
"13268","FBgn0085321","3R",27062216,27063059,843
"13269","FBgn0052695","X",9872382,9874057,1675
"13270","FBgn0052823","X",20189440,20194227,4787
"13271","FBgn0030594","X",14906334,14909708,3374
"13272","FBgn0040268","2L",19498168,19502268,4100
"13273","FBgn0037365","3R",5690891,5693286,2395
"13274","FBgn0022984","2R",22409208,22411545,2337
"13275","FBgn0262819","2R",11844378,11845099,721
"13276","FBgn0265368","2L",3562038,3563118,1080
"13277","FBgn0030802","X",16885546,16886560,1014
"13278","FBgn0011832","2L",2250431,2251275,844
"13279","FBgn0031471","2L",2845926,2847212,1286
"13280","FBgn0266308","2L",13582569,13583033,464
"13281","FBgn0016672","3R",13958789,13960474,1685
"13282","FBgn0004118","3R",24509228,24515106,5878
"13283","FBgn0017572","3L",16613218,16615472,2254
"13284","FBgn0022985","2R",22415560,22419001,3441
"13285","FBgn0043791","3R",9494801,9496723,1922
"13286","FBgn0039635","3R",29113071,29116197,3126
"13287","FBgn0030880","X",17888177,17889404,1227
"13288","FBgn0264876","2R",24775711,24779987,4276
"13289","FBgn0015949","2R",19663919,19669832,5913
"13290","FBgn0050015","2R",10839102,10874771,35669
"13291","FBgn0011648","2L",3146056,3159643,13587
"13292","FBgn0039212","3R",24623802,24625562,1760
"13293","FBgn0038626","3R",18559869,18561353,1484
"13294","FBgn0031724","2L",5596833,5598636,1803
"13295","FBgn0037304","3R",5253153,5255403,2250
"13296","FBgn0082927","2R",9096763,9096844,81
"13297","FBgn0267096","X",8163301,8163580,279
"13298","FBgn0267347","2L",16680054,16681653,1599
"13299","FBgn0050043","2R",12359436,12363165,3729
"13300","FBgn0262853","X",11586228,11586944,716
"13301","FBgn0038585","3R",18223722,18224942,1220
"13302","FBgn0065095","X",1558349,1558400,51
"13303","FBgn0012003","3R",19672277,19672349,72
"13304","FBgn0030033","X",8385781,8389504,3723
"13305","FBgn0035697","3L",6257423,6258760,1337
"13306","FBgn0024542","3L",7241628,7243139,1511
"13307","FBgn0053272","3L",11510323,11510589,266
"13308","FBgn0034430","2R",19291105,19292196,1091
"13309","FBgn0283560","3R",8348702,8348778,76
"13310","FBgn0266615","3R",13044157,13044529,372
"13311","FBgn0267120","3R",7387444,7388319,875
"13312","FBgn0039482","3R",27093143,27094224,1081
"13313","FBgn0262307","2R",16895223,16895308,85
"13314","FBgn0035857","3L",8211890,8213622,1732
"13315","FBgn0259923","X",16684216,16695173,10957
"13316","FBgn0069354","2L",10845788,10847044,1256
"13317","FBgn0030003","X",8129812,8131783,1971
"13318","FBgn0040060","3L",6035216,6036175,959
"13319","FBgn0029639","X",2885186,2885914,728
"13320","FBgn0264895","2L",7497805,7578980,81175
"13321","FBgn0030891","X",18085761,18088418,2657
"13322","FBgn0028664","3L",4186018,4186865,847
"13323","FBgn0036230","3L",11956708,11957765,1057
"13324","FBgn0267515","X",23205822,23206525,703
"13325","FBgn0000588","2L",11827204,11829405,2201
"13326","FBgn0027783","2R",14848621,14852653,4032
"13327","FBgn0261792","3R",18982964,18983650,686
"13328","FBgn0250843","2L",10221351,10222546,1195
"13329","FBgn0033421","2R",9541947,9548135,6188
"13330","FBgn0264466","3L",17259661,17260449,788
"13331","FBgn0041789","2L",19400753,19426596,25843
"13332","FBgn0004921","2R",8901404,8904791,3387
"13333","FBgn0031830","2L",6557800,6559308,1508
"13334","FBgn0035491","3L",4046988,4047735,747
"13335","FBgn0086602","X",6742349,6742491,142
"13336","FBgn0031713","2L",5530620,5532223,1603
"13337","FBgn0036381","3L",13860027,13866905,6878
"13338","FBgn0262952","mitochondrion_genome",8207,9545,1338
"13339","FBgn0259972","3L",20896268,20897417,1149
"13340","FBgn0265452","2L",9025634,9031836,6202
"13341","FBgn0262383","3R",12551515,12551614,99
"13342","FBgn0015583","2L",8392456,8393222,766
"13343","FBgn0038107","3R",12996876,12997726,850
"13344","FBgn0264855","2L",408030,414777,6747
"13345","FBgn0265150","2L",262203,263003,800
"13346","FBgn0267662","3L",6981212,6981703,491
"13347","FBgn0036058","3L",9894807,9898575,3768
"13348","FBgn0261602","3L",2587456,2588883,1427
"13349","FBgn0030894","X",18097558,18101314,3756
"13350","FBgn0261446","X",258335,263999,5664
"13351","FBgn0053838","2L",21493423,21493915,492
"13352","FBgn0038548","3R",17801542,17803260,1718
"13353","FBgn0011217","3R",14732414,14741319,8905
"13354","FBgn0267806","3R",6585431,6586105,674
"13355","FBgn0031905","2L",7388508,7390902,2394
"13356","FBgn0026389","2R",7232840,7234913,2073
"13357","FBgn0266304","2L",122837,124031,1194
"13358","FBgn0033750","2R",12515375,12517284,1909
"13359","FBgn0027601","X",14933670,14953532,19862
"13360","FBgn0000038","3L",4429349,4435993,6644
"13361","FBgn0037370","3R",5736748,5738013,1265
"13362","FBgn0011970","3R",10278054,10278135,81
"13363","FBgn0267989","2L",13174227,13175365,1138
"13364","FBgn0025455","3L",17551004,17557788,6784
"13365","FBgn0053878","2L",21512887,21513481,594
"13366","FBgn0051675","2L",20867755,20869650,1895
"13367","FBgn0033121","2R",6971996,6975026,3030
"13368","FBgn0024360","X",1344872,1349357,4485
"13369","FBgn0265162","3R",12727759,12728459,700
"13370","FBgn0050161","2R",24663532,24664377,845
"13371","FBgn0052758","X",5719374,5738031,18657
"13372","FBgn0040928","X",8397157,8398298,1141
"13373","FBgn0035438","3L",3326265,3328626,2361
"13374","FBgn0267248","3L",17366775,17367365,590
"13375","FBgn0036808","3L",18696402,18698412,2010
"13376","FBgn0031494","2L",3029253,3030616,1363
"13377","FBgn0015754","2R",16178826,16185103,6277
"13378","FBgn0266936","3L",18854317,18854622,305
"13379","FBgn0266487","2R",12612740,12619820,7080
"13380","FBgn0038429","3R",16443207,16445010,1803
"13381","FBgn0026369","2R",21481927,21487107,5180
"13382","FBgn0265417","X",5812273,5812977,704
"13383","FBgn0263872","2L",308537,309348,811
"13384","FBgn0025625","X",2055310,2061915,6605
"13385","FBgn0025835","X",142731,148426,5695
"13386","FBgn0032048","2L",8491868,8506845,14977
"13387","FBgn0053881","2L",21504377,21504789,412
"13388","FBgn0265822","2L",7078895,7079399,504
"13389","FBgn0263515","2R",19637414,19637521,107
"13390","FBgn0031281","2L",813314,815950,2636
"13391","FBgn0033278","2R",8259841,8260483,642
"13392","FBgn0262252","2L",243035,243141,106
"13393","FBgn0011604","2R",12636671,12640628,3957
"13394","FBgn0032850","2L",20097581,20103375,5794
"13395","FBgn0040694","3L",3620433,3621032,599
"13396","FBgn0053438","2R",19734772,19734906,134
"13397","FBgn0036851","3L",19105381,19138975,33594
"13398","FBgn0030054","X",8602137,8606304,4167
"13399","FBgn0265931","3L",11273960,11274562,602
"13400","FBgn0033196","2R",7595265,7620711,25446
"13401","FBgn0031143","X",21026125,21028361,2236
"13402","FBgn0024222","3R",16046347,16049421,3074
"13403","FBgn0052324","3L",1398406,1398477,71
"13404","FBgn0001320","3L",20692330,20695378,3048
"13405","FBgn0032799","2L",19525434,19526368,934
"13406","FBgn0264393","X",18439667,18440076,409
"13407","FBgn0265540","2R",17023652,17026993,3341
"13408","FBgn0038918","3R",21911816,21913591,1775
"13409","FBgn0032734","2L",18991020,18992409,1389
"13410","FBgn0045470","3R",21842521,21843765,1244
"13411","FBgn0038014","3R",12350815,12352079,1264
"13412","FBgn0262810","X",350566,351133,567
"13413","FBgn0038123","3R",13185526,13186496,970
"13414","FBgn0014007","3L",12734945,12741568,6623
"13415","FBgn0051414","3R",23704804,23708512,3708
"13416","FBgn0032474","2L",13163209,13166072,2863
"13417","FBgn0032248","2L",10429920,10430918,998
"13418","FBgn0052141","3L",14203323,14204294,971
"13419","FBgn0262857","2L",17485757,17486365,608
"13420","FBgn0003486","3L",5590083,5592571,2488
"13421","FBgn0037472","3R",7124548,7126503,1955
"13422","FBgn0035976","3L",9338810,9348336,9526
"13423","FBgn0035886","3L",8391540,8392377,837
"13424","FBgn0264748","3L",18068728,18070150,1422
"13425","FBgn0037817","3R",10434789,10436704,1915
"13426","FBgn0264742","2L",5043270,5048365,5095
"13427","FBgn0065059","2R",20945970,20946065,95
"13428","FBgn0023000","3L",343378,346957,3579
"13429","FBgn0262431","3R",24658605,24658660,55
"13430","FBgn0044823","3R",5616644,5624125,7481
"13431","FBgn0033543","2R",10729578,10731528,1950
"13432","FBgn0043456","2L",10003832,10008889,5057
"13433","FBgn0033297","2R",8471954,8473961,2007
"13434","FBgn0086356","2R",13856150,13858689,2539
"13435","FBgn0043070","2R",21502097,21517241,15144
"13436","FBgn0032051","2L",8512174,8514868,2694
"13437","FBgn0052271","3L",3202238,3203162,924
"13438","FBgn0039367","3R",25773334,25775369,2035
"13439","FBgn0266763","2R",10946309,10947095,786
"13440","FBgn0010355","3R",6646889,6656048,9159
"13441","FBgn0052330","3L",1379934,1380005,71
"13442","FBgn0033726","2R",12390896,12391699,803
"13443","FBgn0051495","3R",13838240,13839934,1694
"13444","FBgn0046879","2R",19699995,19701124,1129
"13445","FBgn0039118","3R",23772998,23774127,1129
"13446","FBgn0033995","2R",15199065,15201200,2135
"13447","FBgn0264494","2L",1732524,1750612,18088
"13448","FBgn0035197","3L",1252012,1255986,3974
"13449","FBgn0038236","3R",14521049,14523064,2015
"13450","FBgn0037516","3R",7770860,7771756,896
"13451","FBgn0265155","2L",10506301,10507015,714
"13452","FBgn0031365","2L",1758286,1759093,807
"13453","FBgn0036170","3L",11518798,11522713,3915
"13454","FBgn0038395","3R",16044747,16046130,1383
"13455","FBgn0029002","3L",271200,275018,3818
"13456","FBgn0261648","2L",11434311,11445614,11303
"13457","FBgn0035574","3L",4692783,4796253,103470
"13458","FBgn0031592","2L",4277696,4281324,3628
"13459","FBgn0041195","2L",12398274,12402023,3749
"13460","FBgn0264912","3R",5368481,5368806,325
"13461","FBgn0262429","3R",15417542,15417616,74
"13462","FBgn0037101","3L",21565426,21567785,2359
"13463","FBgn0030745","X",16385278,16388702,3424
"13464","FBgn0265529","2R",16812245,16812791,546
"13465","FBgn0030815","X",17080423,17087675,7252
"13466","FBgn0263133","2L",7220369,7223081,2712
"13467","FBgn0033740","2R",12465678,12471775,6097
"13468","FBgn0011016","3L",16129617,16130983,1366
"13469","FBgn0285912","3R",24947632,24949539,1907
"13470","FBgn0266850","2R",18227495,18231228,3733
"13471","FBgn0032940","2L",21286078,21310050,23972
"13472","FBgn0005696","3R",27239163,27241228,2065
"13473","FBgn0060292","3L",8601473,8601552,79
"13474","FBgn0051286","3R",6641232,6643346,2114
"13475","FBgn0265909","2L",4348318,4348678,360
"13476","FBgn0264434","2L",2646030,2646281,251
"13477","FBgn0033515","2R",10377128,10380109,2981
"13478","FBgn0039777","3R",30487016,30487928,912
"13479","FBgn0031604","2L",4444732,4446765,2033
"13480","FBgn0263977","3R",3734855,3745306,10451
"13481","FBgn0039909","4",568296,571554,3258
"13482","FBgn0034543","2R",20670636,20673495,2859
"13483","FBgn0038194","3R",14029228,14031483,2255
"13484","FBgn0266776","3L",16670355,16670741,386
"13485","FBgn0052269","3L",3206949,3208985,2036
"13486","FBgn0032192","2L",10207085,10209744,2659
"13487","FBgn0031692","2L",5216701,5219053,2352
"13488","FBgn0052803","X",1900699,1901911,1212
"13489","FBgn0261986","3R",25661795,25665640,3845
"13490","FBgn0053510","2L",21082643,21084326,1683
"13491","FBgn0040905","X",4277547,4277961,414
"13492","FBgn0267298","3L",20920802,20921073,271
"13493","FBgn0025633","X",585081,620195,35114
"13494","FBgn0011706","3L",18397535,18398435,900
"13495","FBgn0053680","2R",25249007,25250316,1309
"13496","FBgn0263519","X",8965801,8965912,111
"13497","FBgn0030466","X",13288051,13294433,6382
"13498","FBgn0029762","X",5405238,5410849,5611
"13499","FBgn0052983","2L",8865850,8866670,820
"13500","FBgn0037675","3R",9321770,9322361,591
"13501","FBgn0035526","3L",4283851,4286865,3014
"13502","FBgn0021776","3R",19931799,19935120,3321
"13503","FBgn0266916","3R",8564105,8569248,5143
"13504","FBgn0086694","3L",5789831,5794192,4361
"13505","FBgn0058263","2R",2494742,2565385,70643
"13506","FBgn0050187","2R",22916843,22918790,1947
"13507","FBgn0259245","X",21422115,21457738,35623
"13508","FBgn0032181","2L",10091208,10092389,1181
"13509","FBgn0022699","3L",6182176,6184920,2744
"13510","FBgn0028886","2L",14844993,14851749,6756
"13511","FBgn0034622","2R",21341972,21345608,3636
"13512","FBgn0045483","2R",23080561,23081725,1164
"13513","FBgn0033792","2R",13110769,13126014,15245
"13514","FBgn0052311","3L",2117466,2151700,34234
"13515","FBgn0033661","2R",11867876,11885585,17709
"13516","FBgn0034470","2R",19702924,19703915,991
"13517","FBgn0039938","4",800436,834393,33957
"13518","FBgn0031538","2L",3460322,3461952,1630
"13519","FBgn0035648","3L",5907381,5917540,10159
"13520","FBgn0265186","2R",12948348,12952293,3945
"13521","FBgn0267319","3L",16177345,16177635,290
"13522","FBgn0051288","3R",25297960,25299557,1597
"13523","FBgn0034902","2R",23752754,23753515,761
"13524","FBgn0003870","3R",31713867,31735392,21525
"13525","FBgn0261671","2L",16888490,16917052,28562
"13526","FBgn0264501","2R",12259409,12260813,1404
"13527","FBgn0275432","2L",11070785,11071466,681
"13528","FBgn0001169","3R",20621938,20628915,6977
"13529","FBgn0038205","3R",14112451,14118450,5999
"13530","FBgn0052358","3L",8060214,8060296,82
"13531","FBgn0020416","2L",16445278,16446793,1515
"13532","FBgn0265306","2R",8542796,8543542,746
"13533","FBgn0259244","3R",16502770,16571363,68593
"13534","FBgn0262378","3R",10091126,10091217,91
"13535","FBgn0260431","3L",9433686,9435399,1713
"13536","FBgn0031700","2L",5327975,5328879,904
"13537","FBgn0030257","X",11044756,11049540,4784
"13538","FBgn0014395","X",22449737,22451463,1726
"13539","FBgn0013771","2R",14879356,14881372,2016
"13540","FBgn0263863","3R",22618492,22619826,1334
"13541","FBgn0264741","3R",23927728,23929000,1272
"13542","FBgn0037469","3R",7082182,7083251,1069
"13543","FBgn0029857","X",6288100,6289562,1462
"13544","FBgn0034452","2R",19487046,19491846,4800
"13545","FBgn0053772","3L",22651855,22652525,670
"13546","FBgn0039403","3R",26055657,26056547,890
"13547","FBgn0085451","X",18843663,18855858,12195
"13548","FBgn0267494","Y",3331980,3332699,719
"13549","FBgn0035768","3L",7345698,7347123,1425
"13550","FBgn0083978","3L",13028962,13036504,7542
"13551","FBgn0036124","3L",11074769,11078736,3967
"13552","FBgn0265739","3L",10794964,10795175,211
"13553","FBgn0263992","2R",22707777,22708542,765
"13554","FBgn0037884","3R",11232429,11235013,2584
"13555","FBgn0035816","3L",7747344,7750552,3208
"13556","FBgn0053899","2L",21458853,21459265,412
"13557","FBgn0028688","3R",22460662,22462054,1392
"13558","FBgn0053337","3R",23590141,23592769,2628
"13559","FBgn0003720","3R",30852315,30854400,2085
"13560","FBgn0037846","3R",10860531,10862988,2457
"13561","FBgn0263655","2R",7018760,7019390,630
"13562","FBgn0267607","3L",21119413,21119801,388
"13563","FBgn0032116","2L",9416588,9426342,9754
"13564","FBgn0038465","3R",17002875,17007208,4333
"13565","FBgn0010407","2L",10251843,10254686,2843
"13566","FBgn0031356","2L",1707132,1710421,3289
"13567","FBgn0267635","3L",20404270,20407558,3288
"13568","FBgn0034153","2R",16748815,16749460,645
"13569","FBgn0085254","2R",11245406,11245995,589
"13570","FBgn0036939","3L",20124298,20127381,3083
"13571","FBgn0267734","4",228576,229112,536
"13572","FBgn0266175","3R",21355692,21359768,4076
"13573","FBgn0030056","X",8681252,8688760,7508
"13574","FBgn0265961","2R",21663160,21663925,765
"13575","FBgn0001981","2L",15333866,15336138,2272
"13576","FBgn0033261","2R",8106385,8113949,7564
"13577","FBgn0265985","2R",22690495,22691895,1400
"13578","FBgn0034249","2R",17586425,17590884,4459
"13579","FBgn0264870","2L",912981,913305,324
"13580","FBgn0038206","3R",14122654,14124474,1820
"13581","FBgn0003748","2R",21074018,21088945,14927
"13582","FBgn0263544","3R",31219274,31219372,98
"13583","FBgn0039789","3R",30584020,30587302,3282
"13584","FBgn0264561","3L",21497549,21507538,9989
"13585","FBgn0035987","3L",9411038,9413835,2797
"13586","FBgn0023129","3L",9423253,9424781,1528
"13587","FBgn0002865","3R",28291338,28292656,1318
"13588","FBgn0033590","2R",11236203,11236686,483
"13589","FBgn0035484","3L",4022700,4026011,3311
"13590","FBgn0032447","2L",12695033,12698917,3884
"13591","FBgn0053841","2L",21498468,21498960,492
"13592","FBgn0010812","3R",8033301,8037403,4102
"13593","FBgn0035464","3L",3811263,3813958,2695
"13594","FBgn0030451","X",13128952,13134565,5613
"13595","FBgn0032083","2L",8970520,8975428,4908
"13596","FBgn0034156","2R",16766804,16769238,2434
"13597","FBgn0013688","mitochondrion_genome",14131,14916,785
"13598","FBgn0263520","3R",11442192,11442306,114
"13599","FBgn0038787","3R",20324274,20328003,3729
"13600","FBgn0028700","2L",11128932,11130645,1713
"13601","FBgn0025700","2L",9917221,9918330,1109
"13602","FBgn0266960","3L",714216,714530,314
"13603","FBgn0053100","3R",24063077,24108960,45883
"13604","FBgn0085229","2R",5757662,5758067,405
"13605","FBgn0031881","2L",7027526,7028959,1433
"13606","FBgn0019624","3R",11819359,11820299,940
"13607","FBgn0053993","3L",5933036,5950658,17622
"13608","FBgn0035943","3L",8964912,8966374,1462
"13609","FBgn0011670","3R",25829321,25829698,377
"13610","FBgn0262631","2L",21624679,21626190,1511
"13611","FBgn0027498","X",11092492,11094947,2455
"13612","FBgn0265201","3R",9407694,9408169,475
"13613","FBgn0264081","2L",2389578,2390689,1111
"13614","FBgn0265999","2L",6079764,6080128,364
"13615","FBgn0037581","3R",8347579,8349296,1717
"13616","FBgn0264714","2R",21763995,21764695,700
"13617","FBgn0283545","X",2726678,2727568,890
"13618","FBgn0023175","2R",9846636,9847836,1200
"13619","FBgn0038983","3R",22532174,22539919,7745
"13620","FBgn0035675","3L",6075536,6076258,722
"13621","FBgn0034844","2R",23323659,23326745,3086
"13622","FBgn0030339","X",11839608,11841503,1895
"13623","FBgn0083977","2R",9260278,9263971,3693
"13624","FBgn0259701","3L",2037371,2038224,853
"13625","FBgn0032252","2L",10442534,10450080,7546
"13626","FBgn0266582","3L",3158485,3159578,1093
"13627","FBgn0037176","3L",22687222,22688288,1066
"13628","FBgn0030370","X",12055338,12056635,1297
"13629","FBgn0039857","3R",31594792,31596204,1412
"13630","FBgn0263118","3R",26440778,26448991,8213
"13631","FBgn0265820","2L",4619587,4620918,1331
"13632","FBgn0051874","2L",10189820,10191496,1676
"13633","FBgn0030851","X",17628164,17629492,1328
"13634","FBgn0053200","2R",22408525,22409342,817
"13635","FBgn0037900","3R",11431738,11433543,1805
"13636","FBgn0038901","3R",21769518,21770279,761
"13637","FBgn0015279","3R",20628972,20634732,5760
"13638","FBgn0267983","3L",27364828,27365990,1162
"13639","FBgn0031517","2L",3309222,3311682,2460
"13640","FBgn0266872","2L",17902778,17903073,295
"13641","FBgn0035262","3L",1720616,1723153,2537
"13642","FBgn0040941","X",10217913,10219139,1226
"13643","FBgn0039307","3R",25268661,25269965,1304
"13644","FBgn0037418","3R",6267591,6268757,1166
"13645","FBgn0044030","X",19479382,19480238,856
"13646","FBgn0261587","2R",18611645,18612730,1085
"13647","FBgn0034667","2R",21864870,21866859,1989
"13648","FBgn0262818","2R",11086245,11086845,600
"13649","FBgn0004516","3L",4074077,4088744,14667
"13650","FBgn0267599","3L",18234246,18234760,514
"13651","FBgn0031216","2L",94739,102086,7347
"13652","FBgn0033845","2R",13500621,13506011,5390
"13653","FBgn0266964","3L",6935608,6935903,295
"13654","FBgn0035802","3L",7593091,7639573,46482
"13655","FBgn0033428","2R",9584643,9586126,1483
"13656","FBgn0035158","3L",705948,708205,2257
"13657","FBgn0267715","3L",19294727,19295198,471
"13658","FBgn0012026","3R",8668116,8668208,92
"13659","FBgn0260933","2L",553742,560310,6568
"13660","FBgn0264691","X",9604154,9605969,1815
"13661","FBgn0028532","2L",13849400,13850329,929
"13662","FBgn0015622","3R",29315254,29319644,4390
"13663","FBgn0265762","2R",19842495,19843668,1173
"13664","FBgn0012027","3R",8642701,8642793,92
"13665","FBgn0039920","4",671142,690650,19508
"13666","FBgn0035205","3L",1307224,1311805,4581
"13667","FBgn0265590","2R",17869027,17869857,830
"13668","FBgn0038571","3R",18165442,18167273,1831
"13669","FBgn0050342","2R",9143956,9145151,1195
"13670","FBgn0037908","3R",11499984,11505951,5967
"13671","FBgn0039788","3R",30582198,30583697,1499
"13672","FBgn0267185","X",12912560,12913009,449
"13673","FBgn0051694","2L",2868627,2874489,5862
"13674","FBgn0033205","2R",7665828,7667343,1515
"13675","FBgn0038197","3R",14056945,14087978,31033
"13676","FBgn0038774","3R",20169435,20174872,5437
"13677","FBgn0024734","2L",16245835,16257606,11771
"13678","FBgn0262616","2L",6972243,6972796,553
"13679","FBgn0029975","X",7908931,7911885,2954
"13680","FBgn0264542","X",12516634,12568452,51818
"13681","FBgn0042131","3L",4806053,4807406,1353
"13682","FBgn0031414","2L",2311680,2358944,47264
"13683","FBgn0003093","3R",29039156,29049148,9992
"13684","FBgn0034814","2R",23062747,23064260,1513
"13685","FBgn0266806","2R",22655635,22656496,861
"13686","FBgn0004391","X",15455544,15462441,6897
"13687","FBgn0036158","3L",11434695,11435476,781
"13688","FBgn0264263","2L",15846954,15847381,427
"13689","FBgn0039740","3R",30035240,30036870,1630
"13690","FBgn0037648","3R",8993253,8995212,1959
"13691","FBgn0265671","2L",18145098,18145499,401
"13692","FBgn0050100","2R",16291453,16292269,816
"13693","FBgn0034708","2R",22185972,22189886,3914
"13694","FBgn0260455","2R",23600914,23601773,859
"13695","FBgn0004795","2R",23632610,23654820,22210
"13696","FBgn0004396","3L",15535395,15553214,17819
"13697","FBgn0263107","2L",11953410,11953503,93
"13698","FBgn0051973","2L",25402,65404,40002
"13699","FBgn0262410","2R",19660869,19660942,73
"13700","FBgn0031001","X",19220622,19235910,15288
"13701","FBgn0267187","X",18494719,18494926,207
"13702","FBgn0082949","3L",20454007,20454085,78
"13703","FBgn0016919","2L",21578292,21589423,11131
"13704","FBgn0265295","3L",14034531,14036836,2305
"13705","FBgn0051345","3R",12811145,12817029,5884
"13706","FBgn0023178","3R",26455462,26456141,679
"13707","FBgn0038396","3R",16049670,16050693,1023
"13708","FBgn0010039","3R",12373068,12373813,745
"13709","FBgn0015903","2R",23564891,23599526,34635
"13710","FBgn0036654","3L",16704973,16706428,1455
"13711","FBgn0035272","3L",1777439,1778347,908
"13712","FBgn0030583","X",14836725,14837330,605
"13713","FBgn0042213","3R",29725027,29725690,663
"13714","FBgn0046887","3R",27542497,27543888,1391
"13715","FBgn0025827","2R",16872250,16872906,656
"13716","FBgn0028496","2R",18456602,18498026,41424
"13717","FBgn0267003","2L",13096994,13097298,304
"13718","FBgn0261274","3L",4170404,4173789,3385
"13719","FBgn0061198","2R",24027717,24028789,1072
"13720","FBgn0082943","2R",9096237,9096313,76
"13721","FBgn0267530","3L",8184252,8185221,969
"13722","FBgn0037727","3R",9675523,9677778,2255
"13723","FBgn0023534","X",494614,496369,1755
"13724","FBgn0262057","3L",20317190,20320116,2926
"13725","FBgn0264307","3L",8937100,8954463,17363
"13726","FBgn0039908","4",469409,488994,19585
"13727","FBgn0039077","3R",23402608,23403728,1120
"13728","FBgn0035401","3L",3143808,3145284,1476
"13729","FBgn0037134","3L",21823461,21824571,1110
"13730","FBgn0267042","X",19909318,19910117,799
"13731","FBgn0051992","4",649041,663103,14062
"13732","FBgn0036668","3L",16845386,16852350,6964
"13733","FBgn0032256","2L",10477073,10482975,5902
"13734","FBgn0023510","X",1908920,1916825,7905
"13735","FBgn0011906","2R",8683215,8683297,82
"13736","FBgn0038339","3R",15421108,15434738,13630
"13737","FBgn0036584","3L",16255852,16257191,1339
"13738","FBgn0034059","2R",15992408,15993707,1299
"13739","FBgn0085343","2L",2573436,2575052,1616
"13740","FBgn0038682","3R",19148632,19153686,5054
"13741","FBgn0086451","2L",6854142,6860849,6707
"13742","FBgn0034863","2R",23458065,23458759,694
"13743","FBgn0062517","3L",2595781,2596998,1217
"13744","FBgn0263031","2R",22655549,22656998,1449
"13745","FBgn0031302","2L",1112941,1114138,1197
"13746","FBgn0044809","3R",20877736,20878363,627
"13747","FBgn0262822","X",20864813,20865731,918
"13748","FBgn0263982","2L",19102044,19102909,865
"13749","FBgn0030499","X",13605681,13609529,3848
"13750","FBgn0262402","2R",20583877,20583960,83
"13751","FBgn0262331","3R",21798227,21798331,104
"13752","FBgn0263029","2R",17563606,17564351,745
"13753","FBgn0265723","3L",2975518,2976203,685
"13754","FBgn0267565","3R",6836666,6837608,942
"13755","FBgn0266156","2L",15441601,15442314,713
"13756","FBgn0037955","3R",11820381,11822493,2112
"13757","FBgn0035872","3L",8310493,8315502,5009
"13758","FBgn0038038","3R",12406532,12408107,1575
"13759","FBgn0266910","2L",7604243,7604563,320
"13760","FBgn0039359","3R",25683623,25685051,1428
"13761","FBgn0011656","2R",9913496,9958858,45362
"13762","FBgn0033033","2R",5676750,5691723,14973
"13763","FBgn0036872","3L",19472491,19473145,654
"13764","FBgn0052832","2L",16878326,16879290,964
"13765","FBgn0013973","3R",31134392,31178278,43886
"13766","FBgn0010198","X",13335637,13337705,2068
"13767","FBgn0051954","2L",3509058,3510102,1044
"13768","FBgn0034578","2R",21059780,21060547,767
"13769","FBgn0266566","3R",15910372,15918007,7635
"13770","FBgn0085239","2R",23351518,23352144,626
"13771","FBgn0085201","2L",2192525,2197912,5387
"13772","FBgn0267238","3L",19933720,19934201,481
"13773","FBgn0265043","3R",17391502,17392173,671
"13774","FBgn0011692","3L",4242734,4246233,3499
"13775","FBgn0013692","mitochondrion_genome",6259,6325,66
"13776","FBgn0052835","2R",22951148,22953800,2652
"13777","FBgn0053284","3L",21123753,21124884,1131
"13778","FBgn0029003","X",6008183,6013181,4998
"13779","FBgn0266073","2R",24138629,24139127,498
"13780","FBgn0034918","2R",23855954,23856936,982
"13781","FBgn0035268","3L",1756159,1759208,3049
"13782","FBgn0033226","2R",7812504,7815486,2982
"13783","FBgn0034768","2R",22704704,22705639,935
"13784","FBgn0067782","3R",20552635,20554400,1765
"13785","FBgn0015509","2R",7916856,7921579,4723
"13786","FBgn0261279","3R",22411301,22419051,7750
"13787","FBgn0031092","X",20166673,20168080,1407
"13788","FBgn0037141","3L",21938634,21941812,3178
"13789","FBgn0037856","3R",10885540,10896418,10878
"13790","FBgn0260934","2R",19456170,19485686,29516
"13791","FBgn0028406","2L",13283912,13286462,2550
"13792","FBgn0039249","3R",24918106,24922385,4279
"13793","FBgn0002926","3L",6593938,6603366,9428
"13794","FBgn0266756","3R",14804092,14875488,71396
"13795","FBgn0036271","3L",12269452,12271345,1893
"13796","FBgn0031848","2L",6676649,6677625,976
"13797","FBgn0053824","2L",21469550,21470078,528
"13798","FBgn0264553","3L",3814698,3815240,542
"13799","FBgn0035699","3L",6329324,6352390,23066
"13800","FBgn0026761","2R",6633647,6636262,2615
"13801","FBgn0036791","3L",18588759,18590165,1406
"13802","FBgn0267265","2L",19964045,19964347,302
"13803","FBgn0265649","2R",23128077,23128477,400
"13804","FBgn0003378","3L",11508967,11509394,427
"13805","FBgn0040354","X",2882226,2883661,1435
"13806","FBgn0038977","3R",22488033,22488955,922
"13807","FBgn0026427","2R",14607154,14618118,10964
"13808","FBgn0030234","X",10772541,10778981,6440
"13809","FBgn0265154","2R",24521369,24521829,460
"13810","FBgn0038148","3R",13397835,13398583,748
"13811","FBgn0284248","2L",16719932,16722644,2712
"13812","FBgn0033274","2R",8172364,8173613,1249
"13813","FBgn0035049","2R",24671294,24688184,16890
"13814","FBgn0038130","3R",13279721,13284527,4806
"13815","FBgn0004898","3R",25095012,25096099,1087
"13816","FBgn0266744","3R",24229898,24231364,1466
"13817","FBgn0023130","X",1693615,1695889,2274
"13818","FBgn0033183","2R",7493806,7496466,2660
"13819","FBgn0028916","2L",14334158,14345795,11637
"13820","FBgn0003285","X",2950399,2973834,23435
"13821","FBgn0036121","3L",11069043,11069864,821
"13822","FBgn0250834","2L",14802334,14803293,959
"13823","FBgn0053435","2R",19735879,19736013,134
"13824","FBgn0264816","3R",18403026,18404726,1700
"13825","FBgn0036950","3L",20207534,20209600,2066
"13826","FBgn0267153","3R",6761513,6763478,1965
"13827","FBgn0052056","3L",10220483,10225240,4757
"13828","FBgn0265881","3L",18456399,18456800,401
"13829","FBgn0262210","X",15965947,15966038,91
"13830","FBgn0082995","3L",5764113,5764249,136
"13831","FBgn0265539","2R",17188796,17189095,299
"13832","FBgn0039925","4",1147466,1169239,21773
"13833","FBgn0031515","2L",3291245,3294706,3461
"13834","FBgn0037811","3R",10338342,10340872,2530
"13835","FBgn0037114","3L",21666452,21666980,528
"13836","FBgn0028467","2L",6658517,6662033,3516
"13837","FBgn0036111","3L",10894776,10899123,4347
"13838","FBgn0003334","3R",9633359,9637611,4252
"13839","FBgn0259927","X",18813297,18830406,17109
"13840","FBgn0262163","X",15576355,15576964,609
"13841","FBgn0264265","2L",22239183,22239713,530
"13842","FBgn0262362","3R",8041224,8055970,14746
"13843","FBgn0030358","X",11926424,11930850,4426
"13844","FBgn0053635","2L",157836,158664,828
"13845","FBgn0025621","X",793147,797061,3914
"13846","FBgn0263378","2R",19399769,19401335,1566
"13847","FBgn0036254","3L",12133771,12136706,2935
"13848","FBgn0024956","2R",10738617,10739829,1212
"13849","FBgn0025381","X",1478552,1481420,2868
"13850","FBgn0000003","3R",6822498,6822796,298
"13851","FBgn0031088","X",20133579,20138878,5299
"13852","FBgn0261787","2L",20650755,20656178,5423
"13853","FBgn0036686","3L",17016536,17020270,3734
"13854","FBgn0265071","2L",11280057,11280577,520
"13855","FBgn0033124","2R",7006442,7008622,2180
"13856","FBgn0266990","3L",6059041,6059448,407
"13857","FBgn0038209","3R",14152885,14153829,944
"13858","FBgn0037707","3R",9552034,9553747,1713
"13859","FBgn0039504","3R",27265457,27266423,966
"13860","FBgn0036839","3L",19000985,19003252,2267
"13861","FBgn0029765","X",5427517,5428217,700
"13862","FBgn0266724","3L",16131001,16131632,631
"13863","FBgn0037690","3R",9410329,9412293,1964
"13864","FBgn0036146","3L",11201351,11202158,807
"13865","FBgn0050122","2R",18632328,18639270,6942
"13866","FBgn0035594","3L",5129674,5130240,566
"13867","FBgn0038602","3R",18302170,18302849,679
"13868","FBgn0265860","2R",20511895,20512095,200
"13869","FBgn0040398","X",1051525,1052631,1106
"13870","FBgn0267465","3L",1648628,1649699,1071
"13871","FBgn0015577","3R",7493921,7505098,11177
"13872","FBgn0264569","3L",23881735,23883142,1407
"13873","FBgn0000482","X",1665052,1668451,3399
"13874","FBgn0046113","2L",914086,917805,3719
"13875","FBgn0268063","3L",7518997,7528013,9016
"13876","FBgn0032790","2L",19488682,19490104,1422
"13877","FBgn0052532","X",19531851,19547482,15631
"13878","FBgn0263499","3R",19743789,19744477,688
"13879","FBgn0027603","X",19202103,19208187,6084
"13880","FBgn0266044","2L",22169668,22170204,536
"13881","FBgn0265684","2L",10894644,10895344,700
"13882","FBgn0037960","3R",11883938,11887168,3230
"13883","FBgn0033101","2R",6757601,6758903,1302
"13884","FBgn0011769","3L",9370195,9371238,1043
"13885","FBgn0030503","X",13616989,13619207,2218
"13886","FBgn0038160","3R",13607078,13609246,2168
"13887","FBgn0035444","3L",3376757,3377992,1235
"13888","FBgn0034577","2R",21057787,21059883,2096
"13889","FBgn0003042","3L",21306138,21318020,11882
"13890","FBgn0037999","3R",12219881,12221464,1583
"13891","FBgn0029912","X",6844341,6847847,3506
"13892","FBgn0031070","X",19759173,19764874,5701
"13893","FBgn0054040","2R",21832501,21833551,1050
"13894","FBgn0267768","3R",25262182,25262636,454
"13895","FBgn0265448","3L",9741403,9744403,3000
"13896","FBgn0035511","3L",4210880,4211540,660
"13897","FBgn0051077","3R",26999752,27002961,3209
"13898","FBgn0039467","3R",26978541,26985706,7165
"13899","FBgn0035995","3L",9446864,9450785,3921
"13900","FBgn0042133","2L",20648912,20650079,1167
"13901","FBgn0036810","3L",18744488,18745699,1211
"13902","FBgn0004623","3L",19687637,19689992,2355
"13903","FBgn0032811","2L",19579093,19580351,1258
"13904","FBgn0051562","3R",6184455,6185629,1174
"13905","FBgn0032439","2L",12610517,12646356,35839
"13906","FBgn0035713","3L",6744426,6752752,8326
"13907","FBgn0050357","2R",8720100,8721624,1524
"13908","FBgn0043002","2L",8437405,8437996,591
"13909","FBgn0262454","X",21296385,21296449,64
"13910","FBgn0259956","2L",3700674,3701092,418
"13911","FBgn0053739","2L",21503660,21503695,35
"13912","FBgn0029770","X",5501476,5502782,1306
"13913","FBgn0019932","2L",10339457,10341503,2046
"13914","FBgn0052102","3L",12469072,12469784,712
"13915","FBgn0000411","3L",14175610,14178620,3010
"13916","FBgn0050374","2R",8157257,8157914,657
"13917","FBgn0265044","2R",6216197,6218619,2422
"13918","FBgn0031580","2L",4006041,4006606,565
"13919","FBgn0035124","3L",275155,276667,1512
"13920","FBgn0029999","X",8117012,8119130,2118
"13921","FBgn0028689","2R",14750166,14752910,2744
"13922","FBgn0004373","3L",305393,319884,14491
"13923","FBgn0024921","3L",6193480,6200385,6905
"13924","FBgn0020255","X",11144852,11148716,3864
"13925","FBgn0262963","2L",17918552,17919131,579
"13926","FBgn0000808","X",11985154,11987764,2610
"13927","FBgn0020660","3L",27842669,27858271,15602
"13928","FBgn0085376","3R",31311157,31371748,60591
"13929","FBgn0031030","X",19569721,19579800,10079
"13930","FBgn0266758","3R",24544719,24556549,11830
"13931","FBgn0265356","2R",18987344,19008944,21600
"13932","FBgn0027073","2R",21212880,21214972,2092
"13933","FBgn0036403","3L",14034776,14036751,1975
"13934","FBgn0004403","X",7933742,7934677,935
"13935","FBgn0034560","2R",20909704,20910801,1097
"13936","FBgn0027932","2L",8415690,8431297,15607
"13937","FBgn0030683","X",15749166,15751737,2571
"13938","FBgn0038304","3R",15219256,15222371,3115
"13939","FBgn0030367","X",12029754,12031465,1711
"13940","FBgn0036484","3L",15144355,15146379,2024
"13941","FBgn0030468","X",13297082,13299910,2828
"13942","FBgn0264464","3L",20299410,20302295,2885
"13943","FBgn0037592","3R",8517868,8521378,3510
"13944","FBgn0263869","2L",4582250,4582968,718
"13945","FBgn0267144","3R",12327347,12328003,656
"13946","FBgn0038258","3R",14751748,14754460,2712
"13947","FBgn0267024","2R",12848139,12849295,1156
"13948","FBgn0030311","X",11570621,11571718,1097
"13949","FBgn0036601","3L",16306600,16307205,605
"13950","FBgn0052127","3L",13214109,13214233,124
"13951","FBgn0039238","3R",24862931,24864216,1285
"13952","FBgn0038235","3R",14512639,14513637,998
"13953","FBgn0050022","2R",11387160,11388779,1619
"13954","FBgn0039840","3R",31300918,31305384,4466
"13955","FBgn0036921","3L",19928743,19932930,4187
"13956","FBgn0039297","3R",25237614,25238895,1281
"13957","FBgn0085454","3R",4504612,4506365,1753
"13958","FBgn0266095","X",5790952,5791536,584
"13959","FBgn0037004","3L",20504186,20505700,1514
"13960","FBgn0030853","X",17632089,17633509,1420
"13961","FBgn0038716","3R",19603375,19606475,3100
"13962","FBgn0265307","2R",8277345,8277995,650
"13963","FBgn0038033","3R",12390166,12395980,5814
"13964","FBgn0002638","3L",5930262,5932773,2511
"13965","FBgn0053441","2R",19733671,19733805,134
"13966","FBgn0016080","X",17151231,17154592,3361
"13967","FBgn0052831","2L",11278021,11279982,1961
"13968","FBgn0033244","2R",7968129,7972003,3874
"13969","FBgn0039273","3R",25072729,25074607,1878
"13970","FBgn0011236","2R",23870273,23877442,7169
"13971","FBgn0052173","3L",17339909,17339980,71
"13972","FBgn0065047","2R",17145654,17145826,172
"13973","FBgn0031885","2L",7056301,7063586,7285
"13974","FBgn0086785","3L",13511646,13513112,1466
"13975","FBgn0033842","2R",13483512,13485391,1879
"13976","FBgn0267875","Y",3091730,3091891,161
"13977","FBgn0002909","3L",7329132,7333471,4339
"13978","FBgn0000216","3L",14972667,14973198,531
"13979","FBgn0053471","2R",11699092,11700317,1225
"13980","FBgn0041100","3L",21194754,21196853,2099
"13981","FBgn0053818","2L",21459447,21459975,528
"13982","FBgn0262282","X",4368646,4368735,89
"13983","FBgn0033830","2R",13375975,13377731,1756
"13984","FBgn0033866","2R",13753964,13758971,5007
"13985","FBgn0036597","3L",16294711,16295547,836
"13986","FBgn0028410","2L",13158810,13160173,1363
"13987","FBgn0039207","3R",24536204,24543914,7710
"13988","FBgn0021847","2R",6209782,6214122,4340
"13989","FBgn0027279","X",22487180,22508129,20949
"13990","FBgn0085309","3R",17403272,17403718,446
"13991","FBgn0034924","2R",23895063,23896997,1934
"13992","FBgn0264346","2L",17042481,17043165,684
"13993","FBgn0266050","X",9445815,9446212,397
"13994","FBgn0259714","2L",6377771,6411326,33555
"13995","FBgn0261640","3L",24549636,24550445,809
"13996","FBgn0034879","2R",23555018,23556217,1199
"13997","FBgn0037071","3L",21304697,21306197,1500
"13998","FBgn0034661","2R",21799330,21800904,1574
"13999","FBgn0266803","2R",10237744,10238145,401
"14000","FBgn0040333","X",2622069,2624575,2506
"14001","FBgn0266740","3R",16992778,16994041,1263
"14002","FBgn0267223","3L",16318941,16319263,322
"14003","FBgn0032507","2L",13359901,13361565,1664
"14004","FBgn0263396","3R",13634862,13646304,11442
"14005","FBgn0037544","3R",8031130,8033009,1879
"14006","FBgn0034493","2R",20264920,20270994,6074
"14007","FBgn0035427","3L",3257878,3268184,10306
"14008","FBgn0266199","X",10114340,10208574,94234
"14009","FBgn0029987","X",7956064,7956702,638
"14010","FBgn0000405","2R",22803521,22806948,3427
"14011","FBgn0040814","3L",13329135,13329699,564
"14012","FBgn0265996","2L",15159508,15160126,618
"14013","FBgn0266383","3L",14322552,14326251,3699
"14014","FBgn0267462","3L",1494499,1495119,620
"14015","FBgn0038311","3R",15266684,15268538,1854
"14016","FBgn0051619","2L",21684106,21729051,44945
"14017","FBgn0085387","X",20761071,20927050,165979
"14018","FBgn0034029","2R",15542661,15544409,1748
"14019","FBgn0033356","2R",8948113,8951086,2973
"14020","FBgn0028863","2L",15644183,15718272,74089
"14021","FBgn0284232","3R",24712780,24717430,4650
"14022","FBgn0262301","X",19561837,19561931,94
"14023","FBgn0040796","3L",16280404,16280860,456
"14024","FBgn0034401","2R",18846858,18850599,3741
"14025","FBgn0051460","3R",8562673,8563445,772
"14026","FBgn0284223","2L",21104568,21132909,28341
"14027","FBgn0267897","Y",3229424,3230181,757
"14028","FBgn0267745","3R",28140480,28141378,898
"14029","FBgn0286004","X",19558607,19558693,86
"14030","FBgn0265097","2R",7422496,7422994,498
"14031","FBgn0265613","X",21043550,21044024,474
"14032","FBgn0040931","X",9159514,9160052,538
"14033","FBgn0013303","3L",19991887,19997568,5681
"14034","FBgn0030844","X",17566552,17569228,2676
"14035","FBgn0015393","2L",9699791,9700459,668
"14036","FBgn0267823","2R",22887574,22888857,1283
"14037","FBgn0261523","2L",2287025,2287933,908
"14038","FBgn0083020","2L",20421781,20421909,128
"14039","FBgn0283558","3R",6451551,6451609,58
"14040","FBgn0031286","2L",824329,825861,1532
"14041","FBgn0032464","2L",12978786,12981293,2507
"14042","FBgn0266393","3R",5269081,5269507,426
"14043","FBgn0031542","2L",3480755,3491071,10316
"14044","FBgn0086683","2L",23066874,23068386,1512
"14045","FBgn0259748","3L",11973085,11973790,705
"14046","FBgn0000261","3L",18822604,18828188,5584
"14047","FBgn0039117","3R",23768399,23772859,4460
"14048","FBgn0265951","2L",18906124,18906747,623
"14049","FBgn0065101","X",13128596,13128630,34
"14050","FBgn0083005","2R",22607085,22607220,135
"14051","FBgn0036260","3L",12164205,12175482,11277
"14052","FBgn0039752","3R",30177877,30180178,2301
"14053","FBgn0051971","2L",5240766,5240837,71
"14054","FBgn0263504","X",22487854,22490872,3018
"14055","FBgn0265790","2L",5899949,5900380,431
"14056","FBgn0011704","2R",11983145,11985393,2248
"14057","FBgn0259967","2R",16744295,16745114,819
"14058","FBgn0262731","4",467497,471476,3979
"14059","FBgn0052843","2R",13267798,13295927,28129
"14060","FBgn0035088","2R",24969678,24970855,1177
"14061","FBgn0004828","X",9152523,9156669,4146
"14062","FBgn0029113","3L",8125327,8127818,2491
"14063","FBgn0011822","X",436139,437448,1309
"14064","FBgn0035903","3L",8512767,8518738,5971
"14065","FBgn0028382","2R",17545222,17546400,1178
"14066","FBgn0034965","2R",24052917,24057137,4220
"14067","FBgn0264443","2L",19968684,20017282,48598
"14068","FBgn0010421","3R",10766622,10767804,1182
"14069","FBgn0266696","3L",2377655,2499226,121571
"14070","FBgn0038766","3R",20028058,20029561,1503
"14071","FBgn0003716","2L",5219000,5271384,52384
"14072","FBgn0052418","3L",5776324,5777333,1009
"14073","FBgn0030270","X",11140474,11141835,1361
"14074","FBgn0264899","3R",17433991,17434430,439
"14075","FBgn0013678","mitochondrion_genome",10499,11635,1136
"14076","FBgn0027843","3L",12177601,12183347,5746
"14077","FBgn0032481","2L",13197102,13203295,6193
"14078","FBgn0036583","3L",16249560,16252355,2795
"14079","FBgn0034499","2R",20288371,20291945,3574
"14080","FBgn0030807","X",16947964,16948471,507
"14081","FBgn0031016","X",19353181,19471914,118733
"14082","FBgn0259926","X",5683240,5684456,1216
"14083","FBgn0035557","3L",4533170,4539270,6100
"14084","FBgn0265758","3L",17460109,17460496,387
"14085","FBgn0283476","X",18064483,18078472,13989
"14086","FBgn0040349","X",946662,947500,838
"14087","FBgn0038886","3R",21397781,21399742,1961
"14088","FBgn0033942","2R",14512559,14515211,2652
"14089","FBgn0033086","2R",6669024,6670076,1052
"14090","FBgn0053514","3L",4365434,4366671,1237
"14091","FBgn0032877","2L",20682368,20683629,1261
"14092","FBgn0053355","2R",19765409,19765543,134
"14093","FBgn0051958","2L",3785738,3786343,605
"14094","FBgn0283741","X",1773719,1853667,79948
"14095","FBgn0262538","3R",22768883,22769667,784
"14096","FBgn0263838","2L",19023671,19024440,769
"14097","FBgn0035006","2R",24451084,24453040,1956
"14098","FBgn0266742","3R",8316984,8318006,1022
"14099","FBgn0002772","3R",27657078,27660177,3099
"14100","FBgn0038737","3R",19861610,19862600,990
"14101","FBgn0040340","X",935232,937822,2590
"14102","FBgn0020381","X",633622,635545,1923
"14103","FBgn0266452","3L",15097914,15113003,15089
"14104","FBgn0052203","3L",19128450,19129665,1215
"14105","FBgn0029969","X",7887130,7888785,1655
"14106","FBgn0035518","3L",4255991,4259152,3161
"14107","FBgn0082831","3R",12413828,12421251,7423
"14108","FBgn0029105","2R",23957842,23961631,3789
"14109","FBgn0261989","2R",13570595,13572759,2164
"14110","FBgn0034501","2R",20308777,20316917,8140
"14111","FBgn0063924","3L",216625,216931,306
"14112","FBgn0034945","2R",23968941,23970073,1132
"14113","FBgn0013305","2R",12877094,12880230,3136
"14114","FBgn0030841","X",17448990,17452543,3553
"14115","FBgn0259216","4",254997,265574,10577
"14116","FBgn0028893","2L",16211459,16213304,1845
"14117","FBgn0036731","3L",17480129,17486230,6101
"14118","FBgn0000356","3L",8731944,8732599,655
"14119","FBgn0031036","X",19599803,19601851,2048
"14120","FBgn0031053","X",19659442,19663971,4529
"14121","FBgn0036575","3L",16136487,16137879,1392
"14122","FBgn0040339","X",928139,928860,721
"14123","FBgn0262401","3L",11946093,11946191,98
"14124","FBgn0029795","X",5732740,5734614,1874
"14125","FBgn0263021","2R",12242546,12243273,727
"14126","FBgn0051106","3R",25216297,25218708,2411
"14127","FBgn0265487","2R",17216549,17379376,162827
"14128","FBgn0030889","X",18044071,18048720,4649
"14129","FBgn0266242","3R",8683578,8686187,2609
"14130","FBgn0033540","2R",10645735,10648634,2899
"14131","FBgn0038134","3R",13292052,13293198,1146
"14132","FBgn0037659","3R",9052495,9063245,10750
"14133","FBgn0036900","3L",19683941,19687353,3412
"14134","FBgn0032781","2L",19430643,19432444,1801
"14135","FBgn0033357","2R",8951595,8952242,647
"14136","FBgn0039760","3R",30250928,30252830,1902
"14137","FBgn0039025","3R",22750901,22776374,25473
"14138","FBgn0028949","2L",15613905,15614828,923
"14139","FBgn0031037","X",19605199,19611413,6214
"14140","FBgn0030164","X",9965241,9966959,1718
"14141","FBgn0017429","3L",8602411,8604149,1738
"14142","FBgn0086778","X",19327075,19348447,21372
"14143","FBgn0267702","3R",17703695,17705581,1886
"14144","FBgn0040294","2R",17568732,17572322,3590
"14145","FBgn0267015","2L",14745871,14746176,305
"14146","FBgn0015278","3L",11774650,11790013,15363
"14147","FBgn0000183","2L",17459605,17473215,13610
"14148","FBgn0261789","3R",6345000,6345911,911
"14149","FBgn0033209","2R",7674450,7675362,912
"14150","FBgn0028884","2L",16133508,16134412,904
"14151","FBgn0264845","2L",19558047,19563049,5002
"14152","FBgn0051025","3R",30125633,30129119,3486
"14153","FBgn0033725","2R",12386666,12390057,3391
"14154","FBgn0029878","X",6590776,6596954,6178
"14155","FBgn0052280","3L",3165181,3169080,3899
"14156","FBgn0034662","2R",21820662,21831409,10747
"14157","FBgn0051915","2L",5528123,5530682,2559
"14158","FBgn0264349","2L",14840434,14842209,1775
"14159","FBgn0036609","3L",16326057,16326762,705
"14160","FBgn0024183","2L",15062931,15070316,7385
"14161","FBgn0266822","2L",14032006,14038306,6300
"14162","FBgn0036448","3L",14769341,14776129,6788
"14163","FBgn0039966","X",23012140,23013409,1269
"14164","FBgn0038510","3R",17438968,17440728,1760
"14165","FBgn0266002","2L",6551854,6552436,582
"14166","FBgn0266247","3R",12618876,12619428,552
"14167","FBgn0267363","4",879,5039,4160
"14168","FBgn0265192","2R",22060950,22069757,8807
"14169","FBgn0031263","2L",559612,560523,911
"14170","FBgn0250826","2L",10579753,10580324,571
"14171","FBgn0036501","3L",15500938,15503769,2831
"14172","FBgn0004169","X",13593474,13602578,9104
"14173","FBgn0034519","2R",20550334,20552090,1756
"14174","FBgn0034839","2R",23270477,23271059,582
"14175","FBgn0039597","3R",28755484,28756979,1495
"14176","FBgn0265429","2R",13103895,13104895,1000
"14177","FBgn0267582","3L",18037723,18038280,557
"14178","FBgn0260960","3L",16648442,16661615,13173
"14179","FBgn0035103","3L",176306,178963,2657
"14180","FBgn0053271","3L",11577006,11577495,489
"14181","FBgn0051871","2L",10662081,10671487,9406
"14182","FBgn0032061","2L",8705572,8707527,1955
"14183","FBgn0042173","2R",7829062,7830429,1367
"14184","FBgn0052834","2R",22982542,22984293,1751
"14185","FBgn0039804","3R",30827819,30842034,14215
"14186","FBgn0032688","2L",18590891,18595429,4538
"14187","FBgn0028997","3R",9679939,9681502,1563
"14188","FBgn0025726","4",867824,912331,44507
"14189","FBgn0263537","3R",21316716,21316865,149
"14190","FBgn0033020","2R",5353994,5354723,729
"14191","FBgn0264382","X",8484194,8484580,386
"14192","FBgn0261444","X",1215289,1236684,21395
"14193","FBgn0032197","2L",10227760,10231692,3932
"14194","FBgn0051780","2L",15696038,15697750,1712
"14195","FBgn0039346","3R",25613666,25614451,785
"14196","FBgn0015269","3R",25983013,25995737,12724
"14197","FBgn0028938","2L",13920707,13923553,2846
"14198","FBgn0263271","2R",10354724,10355831,1107
"14199","FBgn0051103","3R",25219318,25221444,2126
"14200","FBgn0028870","2L",14760767,14761924,1157
"14201","FBgn0039439","3R",26627885,26628724,839
"14202","FBgn0053831","2L",21481345,21482367,1022
"14203","FBgn0034136","2R",16558567,16565238,6671
"14204","FBgn0052110","3L",12808721,12810096,1375
"14205","FBgn0052459","3L",22854583,22856059,1476
"14206","FBgn0031099","X",20254692,20257199,2507
"14207","FBgn0031620","2L",4682677,4687232,4555
"14208","FBgn0038976","3R",22487039,22488110,1071
"14209","FBgn0030994","X",19190214,19191029,815
"14210","FBgn0263542","X",2029004,2029094,90
"14211","FBgn0262849","X",11593562,11595452,1890
"14212","FBgn0034963","2R",24036720,24037915,1195
"14213","FBgn0265574","3L",357851,361383,3532
"14214","FBgn0051116","3R",11797244,11813207,15963
"14215","FBgn0259224","3L",3472447,3510895,38448
"14216","FBgn0264357","3R",21140739,21214269,73530
"14217","FBgn0030050","X",8570208,8570948,740
"14218","FBgn0053160","3L",3205539,3206363,824
"14219","FBgn0038211","3R",14215459,14217882,2423
"14220","FBgn0037307","3R",5258336,5262692,4356
"14221","FBgn0010225","3R",4235217,4241057,5840
"14222","FBgn0037454","3R",6558618,6560351,1733
"14223","FBgn0030018","X",8170229,8177185,6956
"14224","FBgn0015781","3R",19028931,19030159,1228
"14225","FBgn0011206","3L",9097629,9134405,36776
"14226","FBgn0264509","X",11837633,11838026,393
"14227","FBgn0052071","3L",11103421,11103873,452
"14228","FBgn0000451","3L",10190276,10201837,11561
"14229","FBgn0005198","3L",20129181,20139010,9829
"14230","FBgn0265991","2R",15762565,15817004,54439
"14231","FBgn0051561","3R",6305247,6306366,1119
"14232","FBgn0260226","3R",14152211,14152650,439
"14233","FBgn0050350","2R",8826391,8827755,1364
"14234","FBgn0267491","Y",3354105,3354870,765
"14235","FBgn0023096","2L",17962625,17982472,19847
"14236","FBgn0085241","2R",6049874,6050286,412
"14237","FBgn0266388","3R",18668572,18669482,910
"14238","FBgn0032968","2L",21916300,21920324,4024
"14239","FBgn0034422","2R",19227344,19228613,1269
"14240","FBgn0034553","2R",20850146,20852125,1979
"14241","FBgn0085673","Y",896183,897725,1542
"14242","FBgn0001624","X",11369665,11409776,40111
"14243","FBgn0004878","3R",5712975,5716805,3830
"14244","FBgn0266599","3R",15242687,15246614,3927
"14245","FBgn0032523","2L",13413783,13414575,792
"14246","FBgn0036745","3L",17654617,17655645,1028
"14247","FBgn0267425","2L",11011162,11012135,973
"14248","FBgn0033810","2R",13219396,13220251,855
"14249","FBgn0033918","2R",14256493,14258787,2294
"14250","FBgn0014127","2L",20058163,20061370,3207
"14251","FBgn0031531","2L",3410560,3411199,639
"14252","FBgn0267749","3R",28153301,28153759,458
"14253","FBgn0265648","2R",23127604,23128077,473
"14254","FBgn0053821","2L",21464507,21465035,528
"14255","FBgn0035012","2R",24493256,24493948,692
"14256","FBgn0004897","3R",25082684,25084878,2194
"14257","FBgn0051614","2L",21542864,21543688,824
"14258","FBgn0029117","3L",6958346,6959586,1240
"14259","FBgn0082998","X",17143934,17144068,134
"14260","FBgn0267044","X",19919641,19920435,794
"14261","FBgn0259188","X",7881939,7884026,2087
"14262","FBgn0051184","3R",23996262,23997017,755
"14263","FBgn0030695","X",15801153,15803880,2727
"14264","FBgn0261860","3R",26783609,26784208,599
"14265","FBgn0014033","2L",4121702,4124153,2451
"14266","FBgn0036978","3L",20361843,20366724,4881
"14267","FBgn0010406","3L",7970588,7972449,1861
"14268","FBgn0040778","2R",8066274,8067655,1381
"14269","FBgn0263026","2L",7012262,7012803,541
"14270","FBgn0034943","2R",23962956,23964641,1685
"14271","FBgn0262146","3R",20534021,20534704,683
"14272","FBgn0023180","2R",9845458,9846485,1027
"14273","FBgn0085330","3R",8773435,8773810,375
"14274","FBgn0265046","2R",22090795,22091395,600
"14275","FBgn0085423","2L",3358640,3373372,14732
"14276","FBgn0262445","2L",20616617,20616714,97
"14277","FBgn0039625","3R",29032660,29034008,1348
"14278","FBgn0005631","2R",22692524,22700970,8446
"14279","FBgn0027090","3R",25263267,25265721,2454
"14280","FBgn0032089","2L",9012885,9014068,1183
"14281","FBgn0040850","X",10839230,10839895,665
"14282","FBgn0037680","3R",9335170,9337459,2289
"14283","FBgn0027508","3R",25653091,25661286,8195
"14284","FBgn0051301","3R",15346205,15348012,1807
"14285","FBgn0032596","2L",16731180,16732133,953
"14286","FBgn0030291","X",11349049,11349847,798
"14287","FBgn0052298","3L",2389583,2390989,1406
"14288","FBgn0267184","X",10824269,10824627,358
"14289","FBgn0054021","2R",12336890,12337718,828
"14290","FBgn0031155","X",21095680,21102206,6526
"14291","FBgn0034631","2R",21498903,21501732,2829
"14292","FBgn0034817","2R",23076688,23079038,2350
"14293","FBgn0035145","3L",593246,599239,5993
"14294","FBgn0031560","2L",3695032,3695411,379
"14295","FBgn0033440","2R",9707536,9708722,1186
"14296","FBgn0033464","2R",9899018,9903287,4269
"14297","FBgn0040565","3R",17596536,17598453,1917
"14298","FBgn0011701","3R",18236192,18239602,3410
"14299","FBgn0044324","3L",22873702,22878984,5282
"14300","FBgn0035824","3L",7912463,7913763,1300
"14301","FBgn0083012","X",17146612,17146759,147
"14302","FBgn0039778","3R",30488963,30489895,932
"14303","FBgn0032163","2L",9922737,9924865,2128
"14304","FBgn0266315","2L",20464502,20484702,20200
"14305","FBgn0261445","3L",6959554,6964758,5204
"14306","FBgn0259699","X",16093059,16104946,11887
"14307","FBgn0001341","X",629773,633633,3860
"14308","FBgn0086029","2R",24251269,24251384,115
"14309","FBgn0264889","2L",4259946,4261101,1155
"14310","FBgn0033999","2R",15214060,15215686,1626
"14311","FBgn0030623","X",15243859,15244913,1054
"14312","FBgn0037756","3R",9791483,9793098,1615
"14313","FBgn0262972","3R",11247631,11256123,8492
"14314","FBgn0263570","3L",16031189,16031291,102
"14315","FBgn0034301","2R",18101061,18108389,7328
"14316","FBgn0266764","2R",20150683,20150945,262
"14317","FBgn0040719","2L",1945150,1945709,559
"14318","FBgn0036101","3L",10694360,10696877,2517
"14319","FBgn0038993","3R",22609485,22610715,1230
"14320","FBgn0031834","2L",6564112,6566181,2069
"14321","FBgn0266783","3L",10959231,10960005,774
"14322","FBgn0267151","3R",13425833,13426178,345
"14323","FBgn0265834","2R",19956195,19957004,809
"14324","FBgn0036485","3L",15147137,15154395,7258
"14325","FBgn0038527","3R",17618281,17618799,518
"14326","FBgn0050229","2R",18770131,18770212,81
"14327","FBgn0037151","3L",22075056,22075756,700
"14328","FBgn0013751","3L",3846206,3861692,15486
"14329","FBgn0050160","2R",7005157,7006136,979
"14330","FBgn0265753","3L",14245993,14247011,1018
"14331","FBgn0030017","X",8165833,8170266,4433
"14332","FBgn0262855","3L",21220400,21223118,2718
"14333","FBgn0038092","3R",12916056,12934813,18757
"14334","FBgn0033629","2R",11377193,11379177,1984
"14335","FBgn0265962","2R",21708945,21709595,650
"14336","FBgn0039083","3R",23520146,23521583,1437
"14337","FBgn0030074","X",8983634,8984190,556
"14338","FBgn0030078","X",9069599,9071408,1809
"14339","FBgn0265853","2R",20315295,20315995,700
"14340","FBgn0039371","3R",25786329,25787298,969
"14341","FBgn0037855","3R",10889768,10893531,3763
"14342","FBgn0032345","2L",11120642,11121714,1072
"14343","FBgn0029945","X",7329046,7331255,2209
"14344","FBgn0000308","2L",5972115,5981018,8903
"14345","FBgn0011982","X",14025566,14025647,81
"14346","FBgn0032084","2L",8977834,8984872,7038
"14347","FBgn0002945","3L",19003741,19045449,41708
"14348","FBgn0261714","3R",12162887,12166186,3299
"14349","FBgn0265593","2R",18246127,18246763,636
"14350","FBgn0002937","3R",13700565,13703164,2599
"14351","FBgn0032824","2L",19813704,19814532,828
"14352","FBgn0266646","2R",23638377,23639094,717
"14353","FBgn0039946","X",23106003,23108331,2328
"14354","FBgn0031250","2L",355565,357874,2309
"14355","FBgn0036847","3L",19094890,19096217,1327
"14356","FBgn0039280","3R",25125632,25127359,1727
"14357","FBgn0026439","2L",9333567,9341925,8358
"14358","FBgn0035236","3L",1569181,1576330,7149
"14359","FBgn0063388","2R",17701229,17701297,68
"14360","FBgn0266226","3R",6053028,6053528,500
"14361","FBgn0004110","3R",21378977,21381970,2993
"14362","FBgn0265725","X",9162092,9163153,1061
"14363","FBgn0267281","2L",1142869,1143216,347
"14364","FBgn0035996","3L",9450545,9451572,1027
"14365","FBgn0263576","2R",15945887,15945946,59
"14366","FBgn0035086","2R",24948645,24955677,7032
"14367","FBgn0262981","X",18621498,18621877,379
"14368","FBgn0039914","4",623219,626031,2812
"14369","FBgn0033591","2R",11238108,11238995,887
"14370","FBgn0033508","2R",10311172,10312023,851
"14371","FBgn0030739","X",16313709,16317750,4041
"14372","FBgn0082963","2R",21329698,21329847,149
"14373","FBgn0011244","2L",728362,730564,2202
"14374","FBgn0027889","3R",26864605,26866807,2202
"14375","FBgn0035988","3L",9415755,9417388,1633
"14376","FBgn0052702","X",9558665,9571308,12643
"14377","FBgn0264374","2L",16003756,16004292,536
"14378","FBgn0026415","X",9927973,9930948,2975
"14379","FBgn0036899","3L",19650506,19664104,13598
"14380","FBgn0050203","2R",12310689,12313834,3145
"14381","FBgn0265422","3R",7312338,7312858,520
"14382","FBgn0266206","2L",18261073,18262298,1225
"14383","FBgn0028987","2L",8240414,8241800,1386
"14384","FBgn0024191","2L",5721051,5723944,2893
"14385","FBgn0031228","2L",114726,156030,41304
"14386","FBgn0023081","2R",24092079,24098636,6557
"14387","FBgn0085398","2R",21964173,21970664,6491
"14388","FBgn0035337","3L",2376484,2377556,1072
"14389","FBgn0086655","2R",6502006,6621792,119786
"14390","FBgn0032935","2L",21212322,21220572,8250
"14391","FBgn0028844","2L",14450282,14450922,640
"14392","FBgn0002862","3R",13827151,13828008,857
"14393","FBgn0039051","3R",23095690,23097240,1550
"14394","FBgn0267225","X",7681002,7681278,276
"14395","FBgn0030882","X",17889547,17898603,9056
"14396","FBgn0001128","2L",5943643,5948968,5325
"14397","FBgn0051551","3R",5627852,5632033,4181
"14398","FBgn0033836","2R",13408042,13409887,1845
"14399","FBgn0260749","2L",10272325,10278811,6486
"14400","FBgn0265895","3L",20623851,20624491,640
"14401","FBgn0051960","2L",3784947,3785622,675
"14402","FBgn0040001","3L",25752859,25762779,9920
"14403","FBgn0027587","3L",207184,211457,4273
"14404","FBgn0263004","3L",22501600,22502417,817
"14405","FBgn0030539","X",14174756,14175670,914
"14406","FBgn0038569","3R",18161392,18164397,3005
"14407","FBgn0265839","2R",20007095,20007645,550
"14408","FBgn0030038","X",8437057,8441264,4207
"14409","FBgn0264820","4",637333,637787,454
"14410","FBgn0039350","3R",25637843,25651874,14031
"14411","FBgn0033088","2R",6673604,6675061,1457
"14412","FBgn0032512","2L",13371427,13373890,2463
"14413","FBgn0052574","X",16742847,16744365,1518
"14414","FBgn0034500","2R",20304517,20308671,4154
"14415","FBgn0284225","2L",16245835,16251788,5953
"14416","FBgn0020493","3R",17054007,17070408,16401
"14417","FBgn0039413","3R",26126659,26127868,1209
"14418","FBgn0002569","2R",8453627,8455782,2155
"14419","FBgn0034159","2R",16793119,16796407,3288
"14420","FBgn0053869","2L",21534085,21534610,525
"14421","FBgn0039704","3R",29819131,29825800,6669
"14422","FBgn0050383","2R",7823943,7825141,1198
"14423","FBgn0039347","3R",25618414,25621838,3424
"14424","FBgn0264515","3L",13216103,13217527,1424
"14425","FBgn0040365","X",1145644,1146132,488
"14426","FBgn0267226","X",7679968,7680520,552
"14427","FBgn0035638","3L",5794405,5796543,2138
"14428","FBgn0264703","3L",15100054,15102040,1986
"14429","FBgn0261816","3L",14567440,14568133,693
"14430","FBgn0027579","3R",27925191,27933077,7886
"14431","FBgn0086130","2L",811584,813380,1796
"14432","FBgn0053374","2R",19758362,19758496,134
"14433","FBgn0038244","3R",14570472,14575887,5415
"14434","FBgn0041237","2R",21976662,21977957,1295
"14435","FBgn0000257","X",19566019,19569401,3382
"14436","FBgn0285950","2R",24967877,24969547,1670
"14437","FBgn0283681","3L",16351991,16353286,1295
"14438","FBgn0000278","3R",30213315,30213797,482
"14439","FBgn0036931","3L",20024687,20027835,3148
"14440","FBgn0035087","2R",24959841,24965076,5235
"14441","FBgn0284082","2L",18946305,18947082,777
"14442","FBgn0028561","2R",8089482,8091297,1815
"14443","FBgn0026160","3L",10857889,10876496,18607
"14444","FBgn0266987","3L",4626602,4626903,301
"14445","FBgn0085479","X",9329016,9330487,1471
"14446","FBgn0083949","3R",5862865,5959555,96690
"14447","FBgn0000552","3R",6684445,6685157,712
"14448","FBgn0266405","3R",17667577,17667825,248
"14449","FBgn0022160","2R",15857752,15862755,5003
"14450","FBgn0030688","X",15765470,15766445,975
"14451","FBgn0030089","X",9108691,9117744,9053
"14452","FBgn0029649","X",3066615,3067562,947
"14453","FBgn0030246","X",10894747,10899302,4555
"14454","FBgn0263500","3R",17286242,17287238,996
"14455","FBgn0262876","2L",17704681,17706142,1461
"14456","FBgn0087002","4",1060969,1077273,16304
"14457","FBgn0035922","3L",8647145,8651011,3866
"14458","FBgn0034658","2R",21757345,21757913,568
"14459","FBgn0029508","2R",6992676,7004259,11583
"14460","FBgn0052282","3L",3315620,3315942,322
"14461","FBgn0053177","X",15081367,15082369,1002
"14462","FBgn0263755","3R",15259864,15263458,3594
"14463","FBgn0031093","X",20168042,20169981,1939
"14464","FBgn0261582","2L",14008101,14008820,719
"14465","FBgn0284224","2L",13461774,13500427,38653
"14466","FBgn0031782","2L",6125879,6127775,1896
"14467","FBgn0036107","3L",10882890,10883573,683
"14468","FBgn0000121","3L",8647261,8648936,1675
"14469","FBgn0265196","3R",17371271,17371757,486
"14470","FBgn0265854","2R",20490896,20492295,1399
"14471","FBgn0011653","3L",4161666,4167464,5798
"14472","FBgn0266912","2L",3475365,3476058,693
"14473","FBgn0038071","3R",12648058,12652910,4852
"14474","FBgn0267423","Y",3345247,3345950,703
"14475","FBgn0003373","3L",11512221,11513402,1181
"14476","FBgn0266645","2R",22415795,22416462,667
"14477","FBgn0026400","3R",28598059,28599288,1229
"14478","FBgn0039690","3R",29738275,29741952,3677
"14479","FBgn0266430","X",9868068,9868568,500
"14480","FBgn0011894","2R",6948284,6948356,72
"14481","FBgn0259730","3R",13813109,13814648,1539
"14482","FBgn0265858","2R",20509395,20509695,300
"14483","FBgn0003512","3R",30043341,30044886,1545
"14484","FBgn0015038","2R",7127838,7129808,1970
"14485","FBgn0052448","3L",21827774,21828480,706
"14486","FBgn0262314","X",19561236,19561327,91
"14487","FBgn0266237","3R",6895178,6896128,950
"14488","FBgn0261930","X",582121,598151,16030
"14489","FBgn0038806","3R",20577053,20578131,1078
"14490","FBgn0030040","X",8458494,8460898,2404
"14491","FBgn0052845","3L",271420,273391,1971
"14492","FBgn0259741","X",9575126,9576247,1121
"14493","FBgn0265830","X",12751867,12754571,2704
"14494","FBgn0267211","3R",25503378,25504478,1100
"14495","FBgn0266008","2R",23109977,23111177,1200
"14496","FBgn0267022","X",20656891,20657678,787
"14497","FBgn0264617","4",56497,63124,6627
"14498","FBgn0030955","X",18775228,18781345,6117
"14499","FBgn0003392","X",15892116,15906716,14600
"14500","FBgn0032298","2L",10768234,10769952,1718
"14501","FBgn0034050","2R",15934825,15935938,1113
"14502","FBgn0028708","3R",9048645,9052231,3586
"14503","FBgn0053758","2R",9453409,9454055,646
"14504","FBgn0035813","3L",7727804,7732191,4387
"14505","FBgn0039470","3R",27003236,27005469,2233
"14506","FBgn0053887","2L",21489234,21489646,412
"14507","FBgn0034639","2R",21608393,21613071,4678
"14508","FBgn0286028","3L",22570364,22572033,1669
"14509","FBgn0087035","3L",15554113,15561042,6929
"14510","FBgn0030243","X",10857655,10866246,8591
"14511","FBgn0032771","2L",19370445,19372711,2266
"14512","FBgn0028683","2R",12633589,12634172,583
"14513","FBgn0013813","3R",28486953,28519398,32445
"14514","FBgn0030319","X",11603243,11604194,951
"14515","FBgn0024841","3R",29723163,29724226,1063
"14516","FBgn0038170","3R",13694053,13695513,1460
"14517","FBgn0259717","2L",2216503,2217246,743
"14518","FBgn0040697","3L",4182645,4184663,2018
"14519","FBgn0262534","X",14702358,14703654,1296
"14520","FBgn0030787","X",16785115,16787008,1893
"14521","FBgn0033074","2R",6225634,6226884,1250
"14522","FBgn0051416","3R",24915060,24915131,71
"14523","FBgn0039818","3R",31106362,31109191,2829
"14524","FBgn0032080","2L",8959255,8962354,3099
"14525","FBgn0038814","3R",20611251,20616901,5650
"14526","FBgn0267449","Y",2273422,2487777,214355
"14527","FBgn0050495","2R",7656895,7659061,2166
"14528","FBgn0034558","2R",20879930,20882663,2733
"14529","FBgn0035426","3L",3243274,3244294,1020
"14530","FBgn0283652","2L",251039,252373,1334
"14531","FBgn0011227","2R",12757133,12757529,396
"14532","FBgn0267125","3R",31689128,31689878,750
"14533","FBgn0034660","2R",21789623,21791580,1957
"14534","FBgn0264460","3L",12498487,12500307,1820
"14535","FBgn0041184","2L",18138675,18152417,13742
"14536","FBgn0031903","2L",7363379,7377528,14149
"14537","FBgn0031897","2L",7204538,7220033,15495
"14538","FBgn0030823","X",17200726,17202598,1872
"14539","FBgn0001983","2L",15423297,15425580,2283
"14540","FBgn0267452","3L",2118498,2119567,1069
"14541","FBgn0039944","X",23084960,23096735,11775
"14542","FBgn0264327","2R",21656310,21657180,870
"14543","FBgn0261402","3L",17818073,17820193,2120
"14544","FBgn0267482","3L",7037825,7038347,522
"14545","FBgn0042135","2R",7716807,7735622,18815
"14546","FBgn0264563","3R",27065436,27065807,371
"14547","FBgn0034838","2R",23264269,23265543,1274
"14548","FBgn0266457","X",21496526,21520017,23491
"14549","FBgn0052669","X",10842697,10845081,2384
"14550","FBgn0024236","3L",8525244,8534503,9259
"14551","FBgn0032880","2L",20730416,20734309,3893
"14552","FBgn0243511","3R",20021704,20026482,4778
"14553","FBgn0037724","3R",9644978,9646154,1176
"14554","FBgn0027084","X",9606363,9608884,2521
"14555","FBgn0035928","3L",8798730,8800532,1802
"14556","FBgn0066304","X",19744431,19745898,1467
"14557","FBgn0266948","3L",14238607,14239440,833
"14558","FBgn0261609","X",16445176,16446993,1817
"14559","FBgn0042094","3R",10887345,10889588,2243
"14560","FBgn0011867","2R",16968008,16968078,70
"14561","FBgn0266380","2R",18074172,18074489,317
"14562","FBgn0024244","2L",3539247,3548423,9176
"14563","FBgn0034328","2R",18382704,18383235,531
"14564","FBgn0034723","2R",22383134,22394015,10881
"14565","FBgn0266668","3R",26049731,26052257,2526
"14566","FBgn0033165","2R",7401859,7402364,505
"14567","FBgn0039258","3R",25023256,25024482,1226
"14568","FBgn0266312","2L",19157868,19159299,1431
"14569","FBgn0037533","3R",7974409,7978428,4019
"14570","FBgn0040715","2L",2216503,2217246,743
"14571","FBgn0037263","3R",4641963,4644636,2673
"14572","FBgn0032477","2L",13179247,13183495,4248
"14573","FBgn0029723","X",4707916,4729487,21571
"14574","FBgn0267025","2R",22874578,22875172,594
"14575","FBgn0041581","2R",14749223,14750165,942
"14576","FBgn0033167","2R",7408371,7409385,1014
"14577","FBgn0035737","3L",7093204,7093841,637
"14578","FBgn0035300","3L",1971638,1974285,2647
"14579","FBgn0260767","2R",22657901,22661389,3488
"14580","FBgn0002856","2L",5892298,5892862,564
"14581","FBgn0001202","2L",19030844,19033498,2654
"14582","FBgn0026320","3L",14969344,14970306,962
"14583","FBgn0085240","2R",6047195,6047392,197
"14584","FBgn0040984","2L",16329925,16330521,596
"14585","FBgn0266800","2L",9261820,9262804,984
"14586","FBgn0283478","2L",9763369,9765338,1969
"14587","FBgn0038746","3R",19903665,19904868,1203
"14588","FBgn0053771","3L",22649396,22649988,592
"14589","FBgn0028856","2L",15957858,15959431,1573
"14590","FBgn0016131","2R",16579470,16585448,5978
"14591","FBgn0032119","2L",9435399,9436842,1443
"14592","FBgn0259680","X",12432224,12453650,21426
"14593","FBgn0286030","3R",9283875,9284525,650
"14594","FBgn0011961","3R",8140476,8140548,72
"14595","FBgn0002901","3L",18109814,18112847,3033
"14596","FBgn0286071","3R",15442246,15476193,33947
"14597","FBgn0003326","2R",12780541,12802010,21469
"14598","FBgn0259963","2L",11837713,11838049,336
"14599","FBgn0028699","3L",4910368,4920198,9830
"14600","FBgn0025642","X",1287290,1288945,1655
"14601","FBgn0263933","2L",415067,418536,3469
"14602","FBgn0030641","X",15462722,15466812,4090
"14603","FBgn0264716","2R",21764996,21765295,299
"14604","FBgn0039186","3R",24343895,24348791,4896
"14605","FBgn0034070","2R",16031930,16047243,15313
"14606","FBgn0038541","3R",17736611,17747470,10859
"14607","FBgn0036365","3L",13442594,13449245,6651
"14608","FBgn0267453","3L",21950101,21951548,1447
"14609","FBgn0032265","2L",10531821,10533647,1826
"14610","FBgn0264726","3L",12027801,12028153,352
"14611","FBgn0038242","3R",14565927,14566513,586
"14612","FBgn0039156","3R",24152347,24154896,2549
"14613","FBgn0031321","2L",1184065,1185698,1633
"14614","FBgn0265747","3L",13101499,13101950,451
"14615","FBgn0033727","2R",12393483,12394842,1359
"14616","FBgn0052219","3L",19950023,19951135,1112
"14617","FBgn0050418","2R",24243255,24255094,11839
"14618","FBgn0267533","3L",9456339,9457296,957
"14619","FBgn0031643","2L",4883298,4885669,2371
"14620","FBgn0038753","3R",19926322,19928644,2322
"14621","FBgn0085612","3L",26165235,26178793,13558
"14622","FBgn0262036","2L",9427870,9428740,870
"14623","FBgn0086060","3R",26804512,26804626,114
"14624","FBgn0034724","2R",22393876,22402059,8183
"14625","FBgn0040531","3R",8528423,8528877,454
"14626","FBgn0040775","2R",9362574,9362906,332
"14627","FBgn0265868","X",14114141,14116889,2748
"14628","FBgn0038012","3R",12323521,12325210,1689
"14629","FBgn0031675","2L",5047818,5051062,3244
"14630","FBgn0038013","3R",12348987,12350644,1657
"14631","FBgn0028667","3L",11473291,11473972,681
"14632","FBgn0035978","3L",9350867,9358935,8068
"14633","FBgn0031361","2L",1731033,1732356,1323
"14634","FBgn0031141","X",20964527,20965419,892
"14635","FBgn0064237","2R",18393666,18395282,1616
"14636","FBgn0266691","3L",27135424,27136049,625
"14637","FBgn0034023","2R",15499632,15501431,1799
"14638","FBgn0039157","3R",24154826,24161498,6672
"14639","FBgn0027596","2R",14901475,14928425,26950
"14640","FBgn0040477","2R",13485617,13486631,1014
"14641","FBgn0032881","2L",20750934,20752341,1407
"14642","FBgn0035065","2R",24783555,24785542,1987
"14643","FBgn0267752","3R",26509539,26510100,561
"14644","FBgn0002906","3R",11736810,11741783,4973
"14645","FBgn0035855","3L",8201078,8202417,1339
"14646","FBgn0262452","2L",16698554,16698650,96
"14647","FBgn0046222","3R",5660635,5665169,4534
"14648","FBgn0038144","3R",13379842,13381509,1667
"14649","FBgn0261995","3R",27227070,27228561,1491
"14650","FBgn0267182","X",18227476,18228449,973
"14651","FBgn0036684","3L",16994717,17012565,17848
"14652","FBgn0053052","3L",17427305,17428836,1531
"14653","FBgn0259968","2R",25172245,25172695,450
"14654","FBgn0053207","3R",15666183,15690513,24330
"14655","FBgn0001296","3R",12682186,12689367,7181
"14656","FBgn0036089","3L",10627680,10628484,804
"14657","FBgn0040837","3L",7158099,7158874,775
"14658","FBgn0029817","X",5869095,5870266,1171
"14659","FBgn0028341","X",9626294,9659145,32851
"14660","FBgn0035667","3L",6053493,6054443,950
"14661","FBgn0086613","3R",19368995,19403153,34158
"14662","FBgn0264986","3R",11637177,11638553,1376
"14663","FBgn0261061","3R",25830061,25830228,167
"14664","FBgn0032713","2L",18823548,18826716,3168
"14665","FBgn0086052","3R",8075631,8075726,95
"14666","FBgn0037265","3R",4654800,4657985,3185
"14667","FBgn0001491","X",11324294,11325308,1014
"14668","FBgn0016061","3R",27375088,27437482,62394
"14669","FBgn0034828","2R",23157577,23158185,608
"14670","FBgn0053872","2L",21527618,21528212,594
"14671","FBgn0033204","2R",7663786,7665269,1483
"14672","FBgn0031233","2L",207179,210725,3546
"14673","FBgn0039309","3R",25270209,25273267,3058
"14674","FBgn0035867","3L",8300064,8302341,2277
"14675","FBgn0027949","2L",19577701,19579131,1430
"14676","FBgn0004189","3R",24556692,24556798,106
"14677","FBgn0025821","3R",11704030,11704916,886
"14678","FBgn0050094","2R",16142202,16142935,733
"14679","FBgn0035575","3L",4803077,4805274,2197
"14680","FBgn0036454","3L",14805136,14882224,77088
"14681","FBgn0035420","3L",3210992,3218920,7928
"14682","FBgn0039331","3R",25358285,25360034,1749
"14683","FBgn0264953","2L",8163073,8190137,27064
"14684","FBgn0261571","2L",14724617,14730177,5560
"14685","FBgn0266927","3L",392006,393255,1249
"14686","FBgn0038915","3R",21884728,21885550,822
"14687","FBgn0034532","2R",20636392,20638423,2031
"14688","FBgn0051471","3R",19802690,19802763,73
"14689","FBgn0035917","3L",8624371,8638813,14442
"14690","FBgn0037177","3L",22691674,22692528,854
"14691","FBgn0031495","2L",3030539,3032300,1761
"14692","FBgn0265351","3R",8302686,8304023,1337
"14693","FBgn0034865","2R",23470165,23471775,1610
"14694","FBgn0002773","3R",30171438,30174551,3113
"14695","FBgn0003977","2R",23360192,23366355,6163
"14696","FBgn0053885","2L",21494279,21494691,412
"14697","FBgn0038291","3R",15137148,15139007,1859
"14698","FBgn0038156","3R",13450590,13464184,13594
"14699","FBgn0031516","2L",3294926,3303130,8204
"14700","FBgn0259992","3R",8653802,8654766,964
"14701","FBgn0035853","3L",8195847,8197987,2140
"14702","FBgn0267750","3R",15275601,15276217,616
"14703","FBgn0263248","3L",11580829,11581019,190
"14704","FBgn0030116","X",9259218,9260522,1304
"14705","FBgn0267726","2L",19183093,19183787,694
"14706","FBgn0036102","3L",10801190,10802350,1160
"14707","FBgn0052547","X",18443027,18479487,36460
"14708","FBgn0036547","3L",15958843,15960609,1766
"14709","FBgn0000547","2L",4031377,4115749,84372
"14710","FBgn0003463","X",15603283,15633434,30151
"14711","FBgn0029835","X",6050828,6065646,14818
"14712","FBgn0261111","3L",7238542,7240245,1703
"14713","FBgn0025624","X",2076966,2078455,1489
"14714","FBgn0015766","3L",5566919,5577348,10429
"14715","FBgn0265799","2L",12013528,12013899,371
"14716","FBgn0033650","2R",11768453,11769561,1108
"14717","FBgn0250906","2L",2746880,2753068,6188
"14718","FBgn0053283","3L",20978765,20979650,885
"14719","FBgn0038139","3R",13329070,13334166,5096
"14720","FBgn0037292","3R",4986500,5011031,24531
"14721","FBgn0267470","3L",3555631,3556299,668
"14722","FBgn0266750","3R",17646903,17653478,6575
"14723","FBgn0015600","2L",3068345,3144786,76441
"14724","FBgn0030007","X",8143904,8145602,1698
"14725","FBgn0262478","2R",15185158,15185952,794
"14726","FBgn0026751","X",5329876,5332435,2559
"14727","FBgn0052523","X",21217878,21218835,957
"14728","FBgn0036229","3L",11954083,11956780,2697
"14729","FBgn0266777","3L",10269482,10270353,871
"14730","FBgn0039782","3R",30505987,30507977,1990
"14731","FBgn0037290","3R",4965445,4968485,3040
"14732","FBgn0086079","3L",13024226,13024298,72
"14733","FBgn0031677","2L",5054579,5055016,437
"14734","FBgn0286213","3L",13023352,13024762,1410
"14735","FBgn0038818","3R",20652567,20659904,7337
"14736","FBgn0011556","2R",11339186,11340132,946
"14737","FBgn0051121","3R",24881466,24894605,13139
"14738","FBgn0051204","3R",31391894,31393527,1633
"14739","FBgn0053017","2R",16272114,16277655,5541
"14740","FBgn0262440","2R",8298106,8298200,94
"14741","FBgn0037195","3L",22837068,22838170,1102
"14742","FBgn0039336","3R",25475636,25476915,1279
"14743","FBgn0264337","2R",23477078,23477477,399
"14744","FBgn0050432","2R",6197387,6198266,879
"14745","FBgn0042132","X",19741224,19744335,3111
"14746","FBgn0262283","X",16191254,16191339,85
"14747","FBgn0036882","3L",19538425,19544172,5747
"14748","FBgn0034743","2R",22605745,22607995,2250
"14749","FBgn0036350","3L",13377957,13380380,2423
"14750","FBgn0265312","2R",9605639,9605870,231
"14751","FBgn0266325","2L",7708100,7710456,2356
"14752","FBgn0265641","2R",8309495,8310245,750
"14753","FBgn0267274","X",18676168,18676761,593
"14754","FBgn0266000","X",4926664,4938105,11441
"14755","FBgn0011640","3L",7339266,7341893,2627
"14756","FBgn0038928","3R",22034455,22035617,1162
"14757","FBgn0262617","3R",10264306,10308467,44161
"14758","FBgn0085223","2R",17544190,17545045,855
"14759","FBgn0085200","2L",18378591,18379909,1318
"14760","FBgn0263934","2R",7086316,7127868,41552
"14761","FBgn0036242","3L",12042387,12044217,1830
"14762","FBgn0038578","3R",18189072,18191265,2193
"14763","FBgn0030092","X",9148080,9149071,991
"14764","FBgn0267316","3L",13285265,13285835,570
"14765","FBgn0034796","2R",22894435,22895745,1310
"14766","FBgn0013279","3R",12509076,12511461,2385
"14767","FBgn0033412","2R",9421972,9423688,1716
"14768","FBgn0030592","X",14885952,14896891,10939
"14769","FBgn0053668","X",6418760,6419434,674
"14770","FBgn0038784","3R",20306216,20307537,1321
"14771","FBgn0004896","2R",22868159,22870706,2547
"14772","FBgn0037001","3L",20492082,20497084,5002
"14773","FBgn0052107","3L",12857282,12861305,4023
"14774","FBgn0029147","2R",22127808,22130184,2376
"14775","FBgn0051406","3R",10348761,10350010,1249
"14776","FBgn0030628","X",15330784,15333154,2370
"14777","FBgn0022770","X",20244647,20248203,3556
"14778","FBgn0264359","2R",13791946,13792587,641
"14779","FBgn0037262","3R",4641963,4643292,1329
"14780","FBgn0039106","3R",23710158,23711338,1180
"14781","FBgn0267528","3L",8057501,8058093,592
"14782","FBgn0036325","3L",12952686,12954647,1961
"14783","FBgn0037989","3R",12068375,12090612,22237
"14784","FBgn0033498","2R",10246071,10247560,1489
"14785","FBgn0011293","3L",17023123,17023741,618
"14786","FBgn0039045","3R",23054410,23058958,4548
"14787","FBgn0052683","X",10410391,10454895,44504
"14788","FBgn0259958","2L",4441429,4442060,631
"14789","FBgn0034084","2R",16169600,16170861,1261
"14790","FBgn0051382","3R",24914834,24914905,71
"14791","FBgn0036824","3L",18893120,18898293,5173
"14792","FBgn0035171","3L",865396,871701,6305
"14793","FBgn0267472","3L",7355717,7356598,881
"14794","FBgn0031324","2L",1204215,1205250,1035
"14795","FBgn0015288","X",762560,765130,2570
"14796","FBgn0036828","3L",18905372,18908974,3602
"14797","FBgn0054045","2R",19330889,19335188,4299
"14798","FBgn0034113","2R",16316313,16320732,4419
"14799","FBgn0000352","2R",7382176,7387115,4939
"14800","FBgn0085230","2R",20750914,20752135,1221
"14801","FBgn0267480","3L",4655405,4656330,925
"14802","FBgn0015336","X",16660898,16664455,3557
"14803","FBgn0053407","2R",19746201,19746335,134
"14804","FBgn0052370","3L",8028546,8028618,72
"14805","FBgn0004049","3R",13428867,13434984,6117
"14806","FBgn0036290","3L",12498106,12501311,3205
"14807","FBgn0013983","2R",18409796,18413599,3803
"14808","FBgn0263507","X",6758610,6759491,881
"14809","FBgn0037625","3R",8749206,8768200,18994
"14810","FBgn0265733","3L",10247805,10248588,783
"14811","FBgn0261386","Unmapped_Scaffold_8_D1580_D1567",3093,3576,483
"14812","FBgn0086030","2R",24628627,24628744,117
"14813","FBgn0035750","3L",7234512,7235965,1453
"14814","FBgn0004465","3L",16610662,16612199,1537
"14815","FBgn0030796","X",16811699,16826494,14795
"14816","FBgn0267091","X",8084256,8085765,1509
"14817","FBgn0037879","3R",11225520,11226681,1161
"14818","FBgn0260660","3L",6998843,7053499,54656
"14819","FBgn0052220","3L",19988027,19988947,920
"14820","FBgn0037086","3L",21491399,21492773,1374
"14821","FBgn0001256","3L",13382765,13383999,1234
"14822","FBgn0034110","2R",16294400,16297232,2832
"14823","FBgn0265888","3L",19555533,19557202,1669
"14824","FBgn0001247","3L",20371672,20375896,4224
"14825","FBgn0264990","2L",15659041,15659474,433
"14826","FBgn0083000","X",17144283,17144420,137
"14827","FBgn0003295","3L",1370628,1387437,16809
"14828","FBgn0052814","X",1019795,1026700,6905
"14829","FBgn0019968","2R",15515778,15532259,16481
"14830","FBgn0030104","X",9215785,9216540,755
"14831","FBgn0034976","2R",24107087,24114292,7205
"14832","FBgn0265469","3L",11397542,11397865,323
"14833","FBgn0033081","2R",6655463,6656594,1131
"14834","FBgn0261813","3L",11382808,11384258,1450
"14835","FBgn0051326","3R",14218136,14220205,2069
"14836","FBgn0037657","3R",9038760,9042349,3589
"14837","FBgn0266588","3L",6305671,6306164,493
"14838","FBgn0039758","3R",30241268,30243312,2044
"14839","FBgn0025469","2R",8080559,8083357,2798
"14840","FBgn0032258","2L",10485538,10488622,3084
"14841","FBgn0004172","3R",7365850,7366262,412
"14842","FBgn0031779","2L",6096698,6098966,2268
"14843","FBgn0031820","2L",6480929,6487576,6647
"14844","FBgn0039731","3R",29995357,29997034,1677
"14845","FBgn0026056","3R",21017684,21020753,3069
"14846","FBgn0267603","3L",19183998,19184726,728
"14847","FBgn0266454","3R",17124477,17124786,309
"14848","FBgn0050496","2R",7699500,7701878,2378
"14849","FBgn0032287","2L",10703621,10704930,1309
"14850","FBgn0038312","3R",15268662,15270532,1870
"14851","FBgn0267817","3R",7997606,7998352,746
"14852","FBgn0004132","2R",7565873,7566738,865
"14853","FBgn0040502","2R",6179726,6180356,630
"14854","FBgn0250832","3R",29715068,29715377,309
"14855","FBgn0032276","2L",10651613,10654499,2886
"14856","FBgn0025837","X",124370,126714,2344
"14857","FBgn0267744","2R",6501032,6501772,740
"14858","FBgn0259991","3R",25483098,25485481,2383
"14859","FBgn0051148","3R",23700621,23702605,1984
"14860","FBgn0023477","2R",23940410,23942114,1704
"14861","FBgn0266933","3L",20836112,20837135,1023
"14862","FBgn0017558","2R",9426439,9434638,8199
"14863","FBgn0032052","2L",8515096,8516755,1659
"14864","FBgn0030228","X",10768537,10772154,3617
"14865","FBgn0039636","3R",29116391,29118390,1999
"14866","FBgn0051876","2L",9932272,9933163,891
"14867","FBgn0264301","2L",13305920,13306755,835
"14868","FBgn0038853","3R",21083043,21097827,14784
"14869","FBgn0266429","X",3574536,3666724,92188
"14870","FBgn0045482","2R",23082203,23083366,1163
"14871","FBgn0037498","3R",7315724,7317207,1483
"14872","FBgn0010288","2L",2212738,2214211,1473
"14873","FBgn0031453","2L",2752445,2757975,5530
"14874","FBgn0267552","3L",12132455,12133605,1150
"14875","FBgn0263042","3L",620695,622316,1621
"14876","FBgn0029962","X",7826197,7842679,16482
"14877","FBgn0002723","X",11616124,11621280,5156
"14878","FBgn0053172","X",15769664,15772985,3321
"14879","FBgn0086600","2R",18143179,18143324,145
"14880","FBgn0040071","3R",16225651,16260329,34678
"14881","FBgn0039800","3R",30744605,30745263,658
"14882","FBgn0040350","X",948585,951900,3315
"14883","FBgn0039799","3R",30742880,30744474,1594
"14884","FBgn0030206","X",10473938,10477201,3263
"14885","FBgn0034565","2R",20977595,20978818,1223
"14886","FBgn0031986","2L",8124329,8125799,1470
"14887","FBgn0039291","3R",25214325,25215188,863
"14888","FBgn0263661","3L",13081299,13082652,1353
"14889","FBgn0033558","2R",10827430,10835709,8279
"14890","FBgn0032167","2L",9940773,9947648,6875
"14891","FBgn0036480","3L",15116737,15128029,11292
"14892","FBgn0039659","3R",29293743,29297180,3437
"14893","FBgn0082951","2R",14621782,14621881,99
"14894","FBgn0036459","3L",14979620,14982432,2812
"14895","FBgn0021760","3L",21172853,21183278,10425
"14896","FBgn0267517","X",23213889,23214011,122
"14897","FBgn0023514","X",1877317,1879077,1760
"14898","FBgn0010379","3R",16099228,16105670,6442
"14899","FBgn0085295","3L",4677832,4678233,401
"14900","FBgn0039204","3R",24528047,24529815,1768
"14901","FBgn0037901","3R",11433488,11435703,2215
"14902","FBgn0053836","2L",21489830,21490358,528
"14903","FBgn0032034","2L",8382861,8383657,796
"14904","FBgn0038438","3R",16482694,16484223,1529
"14905","FBgn0267192","3R",21823692,21824086,394
"14906","FBgn0028513","2L",13595503,13597186,1683
"14907","FBgn0260867","X",20259239,20259656,417
"14908","FBgn0259975","3R",12273126,12273521,395
"14909","FBgn0085346","3R",30056859,30058131,1272
"14910","FBgn0266673","3R",24134831,24137538,2707
"14911","FBgn0266306","2L",12841517,12841895,378
"14912","FBgn0027529","2R",20319180,20325973,6793
"14913","FBgn0028913","2L",14563015,14563726,711
"14914","FBgn0052666","X",11493135,11555045,61910
"14915","FBgn0250820","3R",21138270,21140365,2095
"14916","FBgn0003931","2L",19810734,19810875,141
"14917","FBgn0032216","2L",10312265,10314396,2131
"14918","FBgn0261502","3R",7391413,7392280,867
"14919","FBgn0038460","3R",16983510,16987732,4222
"14920","FBgn0039084","3R",23522264,23530986,8722
"14921","FBgn0037315","3R",5358873,5368306,9433
"14922","FBgn0026150","2L",16908229,16910418,2189
"14923","FBgn0035989","3L",9413596,9426758,13162
"14924","FBgn0028738","2R",24794670,24795482,812
"14925","FBgn0086675","X",12917477,12950417,32940
"14926","FBgn0263834","3R",22296870,22297544,674
"14927","FBgn0003943","3L",3899259,3903184,3925
"14928","FBgn0030060","X",8712472,8714924,2452
"14929","FBgn0036072","3L",10165809,10167023,1214
"14930","FBgn0040859","X",12091264,12092272,1008
"14931","FBgn0036437","3L",14684768,14685842,1074
"14932","FBgn0267196","3R",15698281,15698506,225
"14933","FBgn0061200","X",16599241,16610459,11218
"14934","FBgn0040074","3L",16331933,16332789,856
"14935","FBgn0265576","2R",17616499,17617895,1396
"14936","FBgn0011896","2R",13536045,13536117,72
"14937","FBgn0053804","2L",21426916,21427938,1022
"14938","FBgn0037178","3L",22693324,22693812,488
"14939","FBgn0025640","X",623468,624765,1297
"14940","FBgn0003317","2R",7806484,7810067,3583
"14941","FBgn0262243","2L",5642102,5642201,99
"14942","FBgn0031811","2L",6412315,6415335,3020
"14943","FBgn0265542","2L",16888507,16889530,1023
"14944","FBgn0038790","3R",20360308,20360634,326
"14945","FBgn0028695","3L",19915051,19918160,3109
"14946","FBgn0030261","X",11066552,11068379,1827
"14947","FBgn0050114","2R",18207755,18208978,1223
"14948","FBgn0026373","2L",13833337,13834306,969
"14949","FBgn0030459","X",13189643,13191883,2240
"14950","FBgn0262847","X",11597748,11599638,1890
"14951","FBgn0052856","3R",15964678,15965351,673
"14952","FBgn0052296","3L",2717615,2766536,48921
"14953","FBgn0052179","3L",17649562,17654280,4718
"14954","FBgn0023091","2L",21331756,21342155,10399
"14955","FBgn0034552","2R",20847980,20849939,1959
"14956","FBgn0036318","3L",12850165,12853169,3004
"14957","FBgn0267261","2L",17547185,17547849,664
"14958","FBgn0025680","3R",19212154,19215442,3288
"14959","FBgn0037398","3R",6054712,6057536,2824
"14960","FBgn0013703","mitochondrion_genome",97,165,68
"14961","FBgn0031716","2L",5536850,5539196,2346
"14962","FBgn0052277","3L",3204600,3205449,849
"14963","FBgn0051885","2L",9236521,9236594,73
"14964","FBgn0019990","3R",31395660,31402013,6353
"14965","FBgn0038566","3R",18081048,18082583,1535
"14966","FBgn0042179","3L",4059770,4061923,2153
"14967","FBgn0039856","3R",31592803,31594719,1916
"14968","FBgn0085802","rDNA",43484,45478,1994
"14969","FBgn0263521","3R",21798514,21798671,157
"14970","FBgn0000611","X",15992468,15996509,4041
"14971","FBgn0036596","3L",16289712,16290950,1238
"14972","FBgn0039759","3R",30243978,30246703,2725
"14973","FBgn0053396","2R",19750251,19750385,134
"14974","FBgn0028527","2L",13665525,13672967,7442
"14975","FBgn0267867","3R",12508260,12508533,273
"14976","FBgn0267935","3L",18428524,18429255,731
"14977","FBgn0030460","X",13193094,13194551,1457
"14978","FBgn0264325","3R",24049180,24050782,1602
"14979","FBgn0262007","3L",10095754,10098115,2361
"14980","FBgn0036287","3L",12474418,12485035,10617
"14981","FBgn0261562","3L",1803107,1806920,3813
"14982","FBgn0266418","3R",22639808,22683827,44019
"14983","FBgn0032503","2L",13304788,13307807,3019
"14984","FBgn0033528","2R",10479011,10480111,1100
"14985","FBgn0034426","2R",19284551,19285219,668
"14986","FBgn0028899","2L",16330560,16337885,7325
"14987","FBgn0262736","2R",6625242,6633090,7848
"14988","FBgn0001280","3R",30038622,30039533,911
"14989","FBgn0032986","2L",22239916,22246988,7072
"14990","FBgn0262413","2L",16698744,16698834,90
"14991","FBgn0262607","X",18129585,18130178,593
"14992","FBgn0036451","3L",14789935,14801089,11154
"14993","FBgn0266455","3R",13318991,13319270,279
"14994","FBgn0054046","3R",31709275,31709788,513
"14995","FBgn0030528","X",13811684,13812870,1186
"14996","FBgn0034985","2R",24162489,24173660,11171
"14997","FBgn0261014","2R",9989159,9993559,4400
"14998","FBgn0037660","3R",9063132,9065078,1946
"14999","FBgn0024912","3R",6658806,6660100,1294
"15000","FBgn0027524","3R",10043270,10044606,1336
"15001","FBgn0030391","X",12459796,12463112,3316
"15002","FBgn0039043","3R",23044664,23048214,3550
"15003","FBgn0265297","2R",18140078,18147191,7113
"15004","FBgn0264709","3L",21684000,21684951,951
"15005","FBgn0032702","2L",18700606,18703105,2499
"15006","FBgn0024365","X",1349623,1353981,4358
"15007","FBgn0265523","X",12684203,12742618,58415
"15008","FBgn0263974","3R",18591027,18650137,59110
"15009","FBgn0265736","3L",10410872,10411240,368
"15010","FBgn0030260","X",11062027,11063170,1143
"15011","FBgn0033381","2R",9122125,9123309,1184
"15012","FBgn0267507","rDNA",66807,74924,8117
"15013","FBgn0263472","2R",13557700,13557850,150
"15014","FBgn0001206","X",10590920,10595855,4935
"15015","FBgn0030640","X",15462722,15466812,4090
"15016","FBgn0020639","3L",6136215,6136791,576
"15017","FBgn0036298","3L",12527215,12530171,2956
"15018","FBgn0053483","3R",30900718,30902161,1443
"15019","FBgn0030657","X",15576986,15578171,1185
"15020","FBgn0085193","2L",12056348,12058251,1903
"15021","FBgn0267485","3L",7361639,7363598,1959
"15022","FBgn0041147","3L",3905344,3907813,2469
"15023","FBgn0032801","2L",19526910,19530305,3395
"15024","FBgn0260770","2R",24157668,24159312,1644
"15025","FBgn0030869","X",17820764,17827564,6800
"15026","FBgn0039916","4",636131,646556,10425
"15027","FBgn0016754","3R",23894174,23922973,28799
"15028","FBgn0265686","2L",10943272,10943622,350
"15029","FBgn0259996","2L",20248039,20248872,833
"15030","FBgn0260228","2L",18808694,18811252,2558
"15031","FBgn0039244","3R",24894742,24897613,2871
"15032","FBgn0265547","2L",17950115,17951740,1625
"15033","FBgn0013953","3R",24841935,24850412,8477
"15034","FBgn0083048","3R",30207156,30207291,135
"15035","FBgn0267323","3L",6786660,6787105,445
"15036","FBgn0034689","2R",22073538,22075308,1770
"15037","FBgn0266988","3L",5983670,5983870,200
"15038","FBgn0264975","X",8517373,8555170,37797
"15039","FBgn0030362","X",12012377,12017375,4998
"15040","FBgn0032822","2L",19792104,19792782,678
"15041","FBgn0278600","3R",10428137,10428424,287
"15042","FBgn0040465","2R",18128494,18130246,1752
"15043","FBgn0053288","3L",21427790,21433066,5276
"15044","FBgn0262846","3R",18564264,18565173,909
"15045","FBgn0260657","3L",4556087,4592295,36208
"15046","FBgn0038201","3R",14099832,14103122,3290
"15047","FBgn0262459","3R",10100936,10101034,98
"15048","FBgn0085483","3L",231681,232350,669
"15049","FBgn0040972","2L",13143214,13143622,408
"15050","FBgn0038271","3R",14890231,14892387,2156
"15051","FBgn0031874","2L",6954357,6956950,2593
"15052","FBgn0283562","3R",15221795,15221855,60
"15053","FBgn0035432","3L",3303708,3314009,10301
"15054","FBgn0000152","X",16680089,16683895,3806
"15055","FBgn0040363","X",1173877,1176035,2158
"15056","FBgn0032835","2L",19962679,19963844,1165
"15057","FBgn0001225","3L",9376418,9377427,1009
"15058","FBgn0021800","2L",3803545,3810671,7126
"15059","FBgn0265944","2L",14486040,14486752,712
"15060","FBgn0266309","2L",15746257,15747000,743
"15061","FBgn0052579","X",16323286,16325768,2482
"15062","FBgn0267413","Y",3301827,3302701,874
"15063","FBgn0037876","3R",11216535,11217898,1363
"15064","FBgn0259200","3L",2652088,2655455,3367
"15065","FBgn0264893","X",6983971,6984498,527
"15066","FBgn0035113","3L",217932,223069,5137
"15067","FBgn0003002","3R",4852813,4869979,17166
"15068","FBgn0265197","3R",17265278,17265821,543
"15069","FBgn0264708","3L",21667424,21668057,633
"15070","FBgn0026147","2L",10989401,10997897,8496
"15071","FBgn0052645","X",13139199,13153462,14263
"15072","FBgn0267107","3R",29356148,29356771,623
"15073","FBgn0053837","2L",21491541,21492563,1022
"15074","FBgn0038917","3R",21887029,21907182,20153
"15075","FBgn0053828","2L",21476302,21477324,1022
"15076","FBgn0003415","3L",20992814,21027434,34620
"15077","FBgn0051005","3R",31236035,31252608,16573
"15078","FBgn0264824","3R",21498632,21499405,773
"15079","FBgn0036490","3L",15207844,15208586,742
"15080","FBgn0005632","3R",31777020,31790681,13661
"15081","FBgn0026136","2R",20289545,20290550,1005
"15082","FBgn0003308","3R",13032528,13038020,5492
"15083","FBgn0033547","2R",10809397,10810655,1258
"15084","FBgn0037571","3R",8311203,8312137,934
"15085","FBgn0033160","2R",7387187,7391023,3836
"15086","FBgn0030519","X",13739744,13741952,2208
"15087","FBgn0033296","2R",8468646,8471663,3017
"15088","FBgn0035603","3L",5367341,5368008,667
"15089","FBgn0051216","3R",19671450,19698742,27292
"15090","FBgn0054033","2R",9820563,9821186,623
"15091","FBgn0030699","X",15844476,15847858,3382
"15092","FBgn0004368","X",4939128,4955916,16788
"15093","FBgn0035790","3L",7491864,7493484,1620
"15094","FBgn0051007","3R",30991700,30992457,757
"15095","FBgn0038838","3R",20873938,20874522,584
"15096","FBgn0037061","3L",21215995,21216839,844
"15097","FBgn0040346","X",939170,940805,1635
"15098","FBgn0029750","X",5302988,5305691,2703
"15099","FBgn0054028","X",9511524,9512162,638
"15100","FBgn0034908","2R",23809236,23811398,2162
"15101","FBgn0014368","3L",11130835,11131402,567
"15102","FBgn0035710","3L",6689327,6703521,14194
"15103","FBgn0034840","2R",23282743,23284113,1370
"15104","FBgn0265643","2R",8311645,8311945,300
"15105","FBgn0037064","3L",21268392,21270580,2188
"15106","FBgn0023537","X",490787,493495,2708
"15107","FBgn0038738","3R",19862517,19864393,1876
"15108","FBgn0264874","2L",2190191,2191272,1081
"15109","FBgn0265730","3L",813300,814487,1187
"15110","FBgn0030926","X",18484487,18486921,2434
"15111","FBgn0039385","3R",25893495,25895026,1531
"15112","FBgn0032269","2L",10575860,10577792,1932
"15113","FBgn0032551","2L",14783301,14784598,1297
"15114","FBgn0082936","2L",20648282,20648356,74
"15115","FBgn0264792","3R",29458779,29459278,499
"15116","FBgn0263210","X",19934345,19934565,220
"15117","FBgn0032250","2L",10435995,10437316,1321
"15118","FBgn0020379","3R",10361760,10378068,16308
"15119","FBgn0261545","2R",12705172,12751545,46373
"15120","FBgn0031528","2L",3373567,3375711,2144
"15121","FBgn0030608","X",15069127,15076220,7093
"15122","FBgn0039004","3R",22690607,22694772,4165
"15123","FBgn0039611","3R",28875621,28877805,2184
"15124","FBgn0021795","2R",11370300,11371335,1035
"15125","FBgn0033015","2R",5259004,5295965,36961
"15126","FBgn0031119","X",20511544,20515828,4284
"15127","FBgn0036972","3L",20322377,20323209,832
"15128","FBgn0262115","2R",4130974,4133484,2510
"15129","FBgn0031251","2L",396595,402198,5603
"15130","FBgn0266978","3L",22510266,22511067,801
"15131","FBgn0262897","3R",6903442,6904682,1240
"15132","FBgn0264907","3R",4750409,4773197,22788
"15133","FBgn0032726","2L",18952206,18954431,2225
"15134","FBgn0036991","3L",20436250,20438370,2120
"15135","FBgn0263968","X",6824496,6838122,13626
"15136","FBgn0039644","3R",29158122,29164966,6844
"15137","FBgn0036014","3L",9598988,9600341,1353
"15138","FBgn0266741","3R",25266813,25270007,3194
"15139","FBgn0035211","3L",1333239,1335359,2120
"15140","FBgn0043022","2L",19811948,19812074,126
"15141","FBgn0025583","2R",18386602,18387030,428
"15142","FBgn0013343","3R",24101600,24105763,4163
"15143","FBgn0267618","3L",21642654,21644202,1548
"15144","FBgn0263660","2R",9552844,9553940,1096
"15145","FBgn0032972","2L",22106862,22107304,442
"15146","FBgn0003612","2R",9116122,9122000,5878
"15147","FBgn0029658","X",3434943,3435807,864
"15148","FBgn0034137","2R",16566023,16570120,4097
"15149","FBgn0038639","3R",18674626,18677539,2913
"15150","FBgn0011259","2L",8542147,8672041,129894
"15151","FBgn0285917","2R",18278198,18357296,79098
"15152","FBgn0259108","X",1409069,1453686,44617
"15153","FBgn0053358","2R",19764289,19764423,134
"15154","FBgn0033132","2R",7040136,7042762,2626
"15155","FBgn0036366","3L",13449187,13450283,1096
"15156","FBgn0038260","3R",14796305,14798474,2169
"15157","FBgn0039339","3R",25483098,25485855,2757
"15158","FBgn0265681","2L",18433459,18434096,637
"15159","FBgn0259677","X",22832399,22885541,53142
"15160","FBgn0260940","3R",21865168,21866238,1070
"15161","FBgn0085420","3L",5424109,5442399,18290
"15162","FBgn0264947","2L",8194509,8197049,2540
"15163","FBgn0260435","2L",23320508,23324192,3684
"15164","FBgn0285959","3R",5609245,5609611,366
"15165","FBgn0033933","2R",14390696,14392209,1513
"15166","FBgn0023508","X",1922981,1927524,4543
"15167","FBgn0010607","2L",4970135,4973921,3786
"15168","FBgn0030697","X",15837830,15841160,3330
"15169","FBgn0266525","2R",6699695,6715892,16197
"15170","FBgn0050257","2R",11394353,11394424,71
"15171","FBgn0035624","3L",5607162,5608300,1138
"15172","FBgn0027616","3L",3370451,3374170,3719
"15173","FBgn0034962","2R",24033974,24036707,2733
"15174","FBgn0037238","3R",4359883,4366855,6972
"15175","FBgn0267004","2L",17105145,17105687,542
"15176","FBgn0026721","2R",17054002,17059299,5297
"15177","FBgn0267753","3R",26541292,26543209,1917
"15178","FBgn0038181","3R",13771495,13779317,7822
"15179","FBgn0266757","3L",8905918,8912671,6753
"15180","FBgn0036876","3L",19498197,19500798,2601
"15181","FBgn0265742","3L",11444472,11445104,632
"15182","FBgn0262689","3L",15520318,15521554,1236
"15183","FBgn0026206","X",9163255,9189309,26054
"15184","FBgn0259726","2R",21667541,21669916,2375
"15185","FBgn0266666","2L",7063986,7064467,481
"15186","FBgn0262418","2R",19660716,19660795,79
"15187","FBgn0030161","X",9887972,9899585,11613
"15188","FBgn0036173","3L",11561996,11564312,2316
"15189","FBgn0035089","2R",24970843,24973207,2364
"15190","FBgn0032929","2L",21179933,21182812,2879
"15191","FBgn0028968","3R",31572143,31575707,3564
"15192","FBgn0052791","X",3507245,3571649,64404
"15193","FBgn0030864","X",17707401,17709653,2252
"15194","FBgn0037739","3R",9746167,9747744,1577
"15195","FBgn0051875","2L",9995561,10002736,7175
"15196","FBgn0086663","3R",9778398,9778537,139
"15197","FBgn0029937","X",7104885,7106345,1460
"15198","FBgn0261615","X",7412668,7413296,628
"15199","FBgn0037766","3R",9826081,9868120,42039
"15200","FBgn0032946","2L",21380000,21393319,13319
"15201","FBgn0264908","3L",15848578,15899029,50451
"15202","FBgn0031745","2L",5859769,5879498,19729
"15203","FBgn0034204","2R",17165084,17166643,1559
"15204","FBgn0051812","2L",16729777,16731199,1422
"15205","FBgn0011878","2R",12336418,12336489,71
"15206","FBgn0044511","3R",13381276,13381809,533
"15207","FBgn0267460","3L",962756,963099,343
"15208","FBgn0052009","4",27020,31633,4613
"15209","FBgn0030300","X",11442539,11446012,3473
"15210","FBgn0051228","3R",18628467,18628538,71
"15211","FBgn0038418","3R",16342318,16345829,3511
"15212","FBgn0039666","3R",29493852,29494267,415
"15213","FBgn0013763","2R",16691022,16693751,2729
"15214","FBgn0262844","3R",13303426,13303856,430
"15215","FBgn0011743","2R",16774246,16775676,1430
"15216","FBgn0051865","2L",11996809,11997965,1156
"15217","FBgn0031998","2L",8200465,8205132,4667
"15218","FBgn0004395","3R",23149653,23157862,8209
"15219","FBgn0262443","2R",19661422,19661521,99
"15220","FBgn0085203","2L",2214266,2215167,901
"15221","FBgn0025578","2R",24779979,24780428,449
"15222","FBgn0030320","X",11606290,11611652,5362
"15223","FBgn0039711","3R",29857652,29858936,1284
"15224","FBgn0262458","2L",7425972,7426044,72
"15225","FBgn0031979","2L",8041106,8041879,773
"15226","FBgn0038704","3R",19403455,19406294,2839
"15227","FBgn0037163","3L",22458816,22461131,2315
"15228","FBgn0267640","3L",14949884,14950703,819
"15229","FBgn0027865","3R",25872900,25881427,8527
"15230","FBgn0267593","Y",2266650,2267259,609
"15231","FBgn0266182","X",15497523,15497862,339
"15232","FBgn0031372","2L",1869803,1871032,1229
"15233","FBgn0036043","3L",9763544,9786466,22922
"15234","FBgn0033569","2R",10894459,10897222,2763
"15235","FBgn0035266","3L",1738407,1745421,7014
"15236","FBgn0038916","3R",21885676,21887355,1679
"15237","FBgn0050288","2R",21519243,21520393,1150
"15238","FBgn0035607","3L",5479790,5483663,3873
"15239","FBgn0050055","2R",12589239,12591395,2156
"15240","FBgn0264429","3R",25796591,25797778,1187
"15241","FBgn0041171","3L",4246343,4254306,7963
"15242","FBgn0267454","3L",9693821,9694705,884
"15243","FBgn0016977","2L",159032,203397,44365
"15244","FBgn0002590","X",17143588,17148264,4676
"15245","FBgn0032493","2L",13233798,13234660,862
"15246","FBgn0027066","2R",6749227,6756300,7073
"15247","FBgn0053424","2R",19739936,19740070,134
"15248","FBgn0053744","2L",21528480,21528515,35
"15249","FBgn0265067","3R",21088792,21095744,6952
"15250","FBgn0011909","2R",13430695,13430815,120
"15251","FBgn0260461","3L",19545110,19547293,2183
"15252","FBgn0262205","2L",6902062,6902152,90
"15253","FBgn0265750","3L",13302741,13303151,410
"15254","FBgn0262436","2R",20583752,20583840,88
"15255","FBgn0036784","3L",18292125,18294262,2137
"15256","FBgn0267479","3L",2267722,2268560,838
"15257","FBgn0035480","3L",3951193,3952550,1357
"15258","FBgn0003423","X",21374002,21385159,11157
"15259","FBgn0267301","3L",3394088,3394607,519
"15260","FBgn0031288","2L",855337,856639,1302
"15261","FBgn0265706","3L",609179,609620,441
"15262","FBgn0001965","2L",13813816,13819824,6008
"15263","FBgn0038609","3R",18366638,18367913,1275
"15264","FBgn0050274","2R",22825093,22828903,3810
"15265","FBgn0265165","3R",12850380,12850668,288
"15266","FBgn0036386","3L",13925882,13929000,3118
"15267","FBgn0029152","3L",21529959,21533713,3754
"15268","FBgn0004106","2L",10384739,10386262,1523
"15269","FBgn0267818","3R",7995985,7997435,1450
"15270","FBgn0003889","3R",9408383,9410282,1899
"15271","FBgn0053229","3L",223852,225605,1753
"15272","FBgn0033884","2R",13861997,13864156,2159
"15273","FBgn0266147","2L",14550395,14550960,565
"15274","FBgn0004583","2L",431227,448701,17474
"15275","FBgn0037608","3R",8674109,8675196,1087
"15276","FBgn0031406","2L",2254176,2255050,874
"15277","FBgn0036862","3L",19281364,19292766,11402
"15278","FBgn0261049","3R",9563924,9566092,2168
"15279","FBgn0031442","2L",2653046,2653926,880
"15280","FBgn0037371","3R",5738178,5742476,4298
"15281","FBgn0267084","X",5755492,5756710,1218
"15282","FBgn0025820","3L",1802008,1802856,848
"15283","FBgn0053080","X",5708559,5717778,9219
"15284","FBgn0035936","3L",8912499,8932065,19566
"15285","FBgn0267762","3R",24318816,24319782,966
"15286","FBgn0034573","2R",21015594,21017446,1852
"15287","FBgn0051792","2L",18997448,19002713,5265
"15288","FBgn0034104","2R",16280950,16281629,679
"15289","FBgn0011858","3R",16321403,16321475,72
"15290","FBgn0264877","2R",8157161,8158260,1099
"15291","FBgn0028411","2R",23811321,23811974,653
"15292","FBgn0085350","X",11726390,11731765,5375
"15293","FBgn0039945","X",23084960,23092631,7671
"15294","FBgn0038953","3R",22375923,22379955,4032
"15295","FBgn0034458","2R",19511673,19513571,1898
"15296","FBgn0003862","3R",14263358,14286903,23545
"15297","FBgn0265639","2R",8245795,8246295,500
"15298","FBgn0038363","3R",15792688,15793487,799
"15299","FBgn0023522","X",1927683,1930517,2834
"15300","FBgn0039067","3R",23255070,23258087,3017
"15301","FBgn0039481","3R",27089704,27091130,1426
"15302","FBgn0023525","X",2250145,2251993,1848
"15303","FBgn0052320","3L",1398586,1401612,3026
"15304","FBgn0050148","2R",20546595,20547658,1063
"15305","FBgn0265992","2L",17993539,17994283,744
"15306","FBgn0051287","3R",16203371,16204961,1590
"15307","FBgn0050441","2R",5351717,5352122,405
"15308","FBgn0264548","2L",22751304,22751795,491
"15309","FBgn0032422","2L",12175451,12177886,2435
"15310","FBgn0053111","3R",23801714,23819237,17523
"15311","FBgn0036773","3L",18088417,18106149,17732
"15312","FBgn0023524","X",2254403,2259863,5460
"15313","FBgn0263565","3R",7451452,7451543,91
"15314","FBgn0053741","2L",21513749,21513784,35
"15315","FBgn0027378","3R",15276440,15278109,1669
"15316","FBgn0030334","X",11787381,11792253,4872
"15317","FBgn0011897","2R",19802591,19802663,72
"15318","FBgn0259178","3R",25040427,25045151,4724
"15319","FBgn0044328","3L",9787046,9808713,21667
"15320","FBgn0028984","3R",15203069,15206447,3378
"15321","FBgn0265846","2R",20137398,20137616,218
"15322","FBgn0037060","3L",21210215,21216051,5836
"15323","FBgn0267629","3L",22607749,22608370,621
"15324","FBgn0262806","2R",10408556,10408774,218
"15325","FBgn0032111","2L",9350470,9350996,526
"15326","FBgn0038445","3R",16571515,16573158,1643
"15327","FBgn0265680","2L",18403948,18404600,652
"15328","FBgn0031104","X",20390096,20390806,710
"15329","FBgn0032626","2L",17087641,17089186,1545
"15330","FBgn0031065","X",19735570,19740456,4886
"15331","FBgn0037128","3L",21741534,21742441,907
"15332","FBgn0283427","2L",3056598,3068177,11579
"15333","FBgn0037218","3R",4211783,4227518,15735
"15334","FBgn0035166","3L",839980,841360,1380
"15335","FBgn0053051","3L",17426286,17427130,844
"15336","FBgn0015808","2L",18831229,18833630,2401
"15337","FBgn0264996","2L",3030412,3030903,491
"15338","FBgn0264979","2L",2242378,2245274,2896
"15339","FBgn0001186","X",9585675,9589813,4138
"15340","FBgn0262422","3R",20853305,20853358,53
"15341","FBgn0004882","3R",23260610,23280856,20246
"15342","FBgn0261698","2R",10322195,10416996,94801
"15343","FBgn0010385","2R",10054178,10054576,398
"15344","FBgn0034509","2R",20503584,20504202,618
"15345","FBgn0265929","3L",11236500,11237620,1120
"15346","FBgn0039839","3R",31265730,31268511,2781
"15347","FBgn0010197","2L",11138759,11149101,10342
"15348","FBgn0039129","3R",23932729,23933530,801
"15349","FBgn0040359","X",1191308,1196660,5352
"15350","FBgn0026163","3R",6821068,6821140,72
"15351","FBgn0022942","X",4650015,4658259,8244
"15352","FBgn0003866","2L",21828593,21837011,8418
"15353","FBgn0051673","2L",20829609,20831161,1552
"15354","FBgn0052551","X",18438868,18439260,392
"15355","FBgn0039141","3R",24038215,24042982,4767
"15356","FBgn0267600","3L",18753797,18754085,288
"15357","FBgn0052068","3L",10663376,10664435,1059
"15358","FBgn0266320","2L",5326504,5326832,328
"15359","FBgn0031603","2L",4442320,4442985,665
"15360","FBgn0003891","2R",21183322,21192913,9591
"15361","FBgn0013347","3R",23890388,23891060,672
"15362","FBgn0053353","2R",19766144,19766278,134
"15363","FBgn0266774","3L",6642250,6642842,592
"15364","FBgn0028430","2L",13972096,13972947,851
"15365","FBgn0261504","3R",6820133,6820431,298
"15366","FBgn0086266","2L",5958005,5958631,626
"15367","FBgn0017482","2R",22329726,22332072,2346
"15368","FBgn0032096","2L",9111814,9113285,1471
"15369","FBgn0037021","3L",20780350,20786197,5847
"15370","FBgn0267929","2L",7176037,7176624,587
"15371","FBgn0031657","2L",4969004,4970216,1212
"15372","FBgn0010313","3R",5077779,5087072,9293
"15373","FBgn0085732","2R",1211067,1213666,2599
"15374","FBgn0050272","2R",22829644,22831877,2233
"15375","FBgn0267729","3R",26124809,26125423,614
"15376","FBgn0015296","3L",9427010,9428671,1661
"15377","FBgn0000454","3R",13782288,13785676,3388
"15378","FBgn0031403","2L",2225545,2226294,749
"15379","FBgn0010241","2R",14246966,14252597,5631
"15380","FBgn0261996","3R",27228673,27229468,795
"15381","FBgn0028858","2L",15979486,15981455,1969
"15382","FBgn0036426","3L",14517825,14518475,650
"15383","FBgn0031470","2L",2844601,2845734,1133
"15384","FBgn0010053","2R",18853434,18855087,1653
"15385","FBgn0267639","3L",15629293,15629693,400
"15386","FBgn0265748","3L",13303371,13303946,575
"15387","FBgn0040364","X",1170828,1173797,2969
"15388","FBgn0000330","X",7009006,7011145,2139
"15389","FBgn0013717","3L",18618305,18622129,3824
"15390","FBgn0003067","2R",18536767,18539416,2649
"15391","FBgn0034638","2R",21605676,21608125,2449
"15392","FBgn0035141","3L",542122,542931,809
"15393","FBgn0029840","X",6082634,6090201,7567
"15394","FBgn0031041","X",19616663,19618537,1874
"15395","FBgn0266303","2L",10297730,10298413,683
"15396","FBgn0036329","3L",12995135,12997418,2283
"15397","FBgn0024315","2R",16655323,16667675,12352
"15398","FBgn0037514","3R",7758122,7759677,1555
"15399","FBgn0267704","X",21631891,21790731,158840
"15400","FBgn0262169","2R",10052541,10063712,11171
"15401","FBgn0039937","4",836986,844529,7543
"15402","FBgn0011902","2L",8290727,8290799,72
"15403","FBgn0086658","2R",11591341,11591485,144
"15404","FBgn0051821","2L",15900935,15902410,1475
"15405","FBgn0037536","3R",8001562,8006033,4471
"15406","FBgn0266958","3L",8309351,8310512,1161
"15407","FBgn0025641","X",1289713,1322362,32649
"15408","FBgn0262544","3L",3659068,3659724,656
"15409","FBgn0020294","3L",21075581,21131159,55578
"15410","FBgn0083979","X",11308533,11311208,2675
"15411","FBgn0031418","2L",2372455,2374627,2172
"15412","FBgn0031018","X",19475063,19476055,992
"15413","FBgn0038142","3R",13369648,13370346,698
"15414","FBgn0030596","X",14911781,14913812,2031
"15415","FBgn0053267","3L",11564483,11572796,8313
"15416","FBgn0035968","3L",9203065,9208853,5788
"15417","FBgn0266648","3L",10029408,10030138,730
"15418","FBgn0035583","3L",4898900,4900869,1969
"15419","FBgn0011573","3L",1795392,1797307,1915
"15420","FBgn0262338","X",19557008,19557103,95
"15421","FBgn0266276","X",15315056,15317967,2911
"15422","FBgn0265728","3L",2008722,2010751,2029
"15423","FBgn0038446","3R",16573179,16573752,573
"15424","FBgn0034075","2R",16110331,16116996,6665
"15425","FBgn0029798","X",5747747,5752077,4330
"15426","FBgn0053415","2R",19743253,19743387,134
"15427","FBgn0029931","X",7040603,7041769,1166
"15428","FBgn0011693","3L",16353233,16354297,1064
"15429","FBgn0039478","3R",27057908,27064199,6291
"15430","FBgn0262297","X",2010300,2010417,117
"15431","FBgn0036697","3L",17049512,17055454,5942
"15432","FBgn0267443","3R",5263757,5264511,754
"15433","FBgn0264556","2L",21290734,21297686,6952
"15434","FBgn0267148","3R",5053181,5053738,557
"15435","FBgn0035815","3L",7733250,7743041,9791
"15436","FBgn0086681","2L",18675183,18676998,1815
"15437","FBgn0261291","3R",11144346,11145235,889
"15438","FBgn0051450","3R",8561917,8562593,676
"15439","FBgn0029887","X",6668539,6673973,5434
"15440","FBgn0262327","3R",14396399,14396501,102
"15441","FBgn0023530","X",1668406,1669297,891
"15442","FBgn0051162","3R",22396799,22396880,81
"15443","FBgn0085224","2R",17733238,17734483,1245
"15444","FBgn0039034","3R",22989295,22990568,1273
"15445","FBgn0000092","X",2692732,2693886,1154
"15446","FBgn0267207","3R",22543278,22543578,300
"15447","FBgn0029833","X",6037892,6039576,1684
"15448","FBgn0085305","3R",15925629,15927577,1948
"15449","FBgn0085460","2R",7944526,7947076,2550
"15450","FBgn0003206","3L",4139076,4141398,2322
"15451","FBgn0037051","3L",21133250,21136353,3103
"15452","FBgn0041780","3R",29030951,29032642,1691
"15453","FBgn0023441","2R",15657318,15676669,19351
"15454","FBgn0052240","3L",4380864,4381629,765
"15455","FBgn0051144","3R",11222414,11223029,615
"15456","FBgn0033696","2R",12188338,12190377,2039
"15457","FBgn0003479","3R",30054696,30056037,1341
"15458","FBgn0013702","mitochondrion_genome",9904,9964,60
"15459","FBgn0283450","2R",7393546,7395932,2386
"15460","FBgn0030952","X",18746367,18748306,1939
"15461","FBgn0015663","2L",3619097,3621573,2476
"15462","FBgn0039820","3R",31126149,31127335,1186
"15463","FBgn0015277","2R",23560492,23564045,3553
"15464","FBgn0034753","2R",22644646,22646344,1698
"15465","FBgn0053137","2R",13175395,13176075,680
"15466","FBgn0027515","2L",7821151,7825350,4199
"15467","FBgn0267081","X",5689852,5691172,1320
"15468","FBgn0037997","3R",12214501,12215659,1158
"15469","FBgn0266903","2L",4361689,4371303,9614
"15470","FBgn0035934","3L",8894404,8904790,10386
"15471","FBgn0039246","3R",24901116,24903048,1932
"15472","FBgn0262125","3R",5649065,5652629,3564
"15473","FBgn0011722","2L",6415179,6423310,8131
"15474","FBgn0036320","3L",12861717,12862920,1203
"15475","FBgn0265702","2R",19712095,19712849,754
"15476","FBgn0262358","2L",4437787,4438201,414
"15477","FBgn0038540","3R",17733598,17734381,783
"15478","FBgn0020506","2R",16651095,16652699,1604
"15479","FBgn0265075","2L",136144,136701,557
"15480","FBgn0051343","3R",21745266,21749003,3737
"15481","FBgn0035315","3L",2197013,2198089,1076
"15482","FBgn0001217","3R",13044759,13047388,2629
"15483","FBgn0085400","2R",23163012,23203973,40961
"15484","FBgn0037129","3L",21743248,21744269,1021
"15485","FBgn0266619","4",459768,461413,1645
"15486","FBgn0042177","3L",16603053,16608146,5093
"15487","FBgn0011984","2L",3173003,3173084,81
"15488","FBgn0266787","2R",24975377,24975887,510
"15489","FBgn0027108","X",6998672,7004151,5479
"15490","FBgn0034061","2R",16006893,16007667,774
"15491","FBgn0262681","3L",157818,158211,393
"15492","FBgn0083007","X",17145384,17145534,150
"15493","FBgn0032205","2L",10268872,10269904,1032
"15494","FBgn0040361","X",1181620,1183502,1882
"15495","FBgn0261932","3R",17406678,17407534,856
"15496","FBgn0266028","2L",5525738,5526943,1205
"15497","FBgn0259957","2L",3701290,3701699,409
"15498","FBgn0030603","X",15044123,15051842,7719
"15499","FBgn0003090","2R",7150703,7223378,72675
"15500","FBgn0010100","2L",21168570,21173185,4615
"15501","FBgn0051810","2L",16849018,16852368,3350
"15502","FBgn0067905","2R",20870392,20870678,286
"15503","FBgn0266490","X",7893053,7893798,745
"15504","FBgn0052406","3L",5997208,6026317,29109
"15505","FBgn0265968","2L",5009931,5010834,903
"15506","FBgn0264823","4",1027863,1029359,1496
"15507","FBgn0019650","4",989725,1007922,18197
"15508","FBgn0263600","3L",15984322,15987815,3493
"15509","FBgn0085599","3L",26298455,26305572,7117
"15510","FBgn0040696","3L",4173884,4192968,19084
"15511","FBgn0050416","2R",23321481,23323399,1918
"15512","FBgn0262974","3R",23825352,23825907,555
"15513","FBgn0003175","2R",22494297,22562065,67768
"15514","FBgn0039020","3R",22746446,22747599,1153
"15515","FBgn0028379","3L",8109132,8110043,911
"15516","FBgn0083987","3L",3893056,3893330,274
"15517","FBgn0031590","2L",4224650,4227097,2447
"15518","FBgn0054039","3L",14560000,14562613,2613
"15519","FBgn0036352","3L",13384789,13385925,1136
"15520","FBgn0031554","2L",3621110,3621704,594
"15521","FBgn0004419","2L",10239341,10242172,2831
"15522","FBgn0037409","3R",6198811,6207678,8867
"15523","FBgn0027358","X",19616663,19618537,1874
"15524","FBgn0266577","2R",7783334,7785585,2251
"15525","FBgn0032629","2L",17187637,17260734,73097
"15526","FBgn0036491","3L",15298958,15300942,1984
"15527","FBgn0001941","2L",5986348,5988854,2506
"15528","FBgn0015008","3R",16975885,16977795,1910
"15529","FBgn0054044","3R",13712469,13714204,1735
"15530","FBgn0038525","3R",17609359,17610533,1174
"15531","FBgn0032897","2L",20858695,20861014,2319
"15532","FBgn0263041","3R",15637168,15638181,1013
"15533","FBgn0036951","3L",20210292,20212122,1830
"15534","FBgn0035336","3L",2373728,2376488,2760
"15535","FBgn0263495","3L",3688786,3689409,623
"15536","FBgn0011207","2L",9700810,9708883,8073
"15537","FBgn0035513","3L",4215379,4216414,1035
"15538","FBgn0085397","2R",21872030,21946259,74229
"15539","FBgn0039623","3R",29027236,29030938,3702
"15540","FBgn0033705","2R",12253992,12255701,1709
"15541","FBgn0029864","X",6309212,6329828,20616
"15542","FBgn0050325","2R",17877543,17880012,2469
"15543","FBgn0085789","Y",3047606,3048886,1280
"15544","FBgn0053491","X",20178755,20179597,842
"15545","FBgn0031294","2L",1008378,1048053,39675
"15546","FBgn0040670","3R",7093935,7094727,792
"15547","FBgn0032330","2L",11013206,11066998,53792
"15548","FBgn0046696","3R",31217364,31217662,298
"15549","FBgn0266348","X",22657324,22797682,140358
"15550","FBgn0035703","3L",6488681,6491210,2529
"15551","FBgn0052072","3L",11101875,11103030,1155
"15552","FBgn0039979","2R",4730439,4731241,802
"15553","FBgn0038124","3R",13188519,13189568,1049
"15554","FBgn0053129","2L",10964905,10970275,5370
"15555","FBgn0265882","3L",18457201,18457550,349
"15556","FBgn0037614","3R",8716243,8721320,5077
"15557","FBgn0263617","3L",3249340,3254504,5164
"15558","FBgn0053443","2R",19732926,19733060,134
"15559","FBgn0036319","3L",12853646,12857428,3782
"15560","FBgn0034157","2R",16779905,16783171,3266
"15561","FBgn0262565","2R",15374846,15375702,856
"15562","FBgn0037327","3R",5458563,5464753,6190
"15563","FBgn0050443","2R",6653217,6655267,2050
"15564","FBgn0265802","2L",12079604,12080568,964
"15565","FBgn0262144","3R",21736933,21737364,431
"15566","FBgn0259960","2L",11752973,11753555,582
"15567","FBgn0052263","3L",3810312,3811114,802
"15568","FBgn0067317","3R",21868003,21868770,767
"15569","FBgn0032741","2L",19027710,19030780,3070
"15570","FBgn0004389","3R",31193362,31194389,1027
"15571","FBgn0267411","Y",3289209,3290215,1006
"15572","FBgn0039154","3R",24137895,24140936,3041
"15573","FBgn0040871","X",14151579,14152006,427
"15574","FBgn0030208","X",10478838,10481943,3105
"15575","FBgn0267424","Y",3358571,3359286,715
"15576","FBgn0036602","3L",16307846,16308480,634
"15577","FBgn0027506","2R",17432173,17444938,12765
"15578","FBgn0265086","2L",13089803,13090559,756
"15579","FBgn0036044","3L",9787933,9797687,9754
"15580","FBgn0039313","3R",25281548,25283237,1689
"15581","FBgn0284244","2L",13251509,13257426,5917
"15582","FBgn0031731","2L",5715349,5716680,1331
"15583","FBgn0026409","3L",14537651,14540441,2790
"15584","FBgn0002567","2R",9177864,9186342,8478
"15585","FBgn0034504","2R",20327270,20330721,3451
"15586","FBgn0265997","2L",2757940,2758176,236
"15587","FBgn0085430","X",18863950,18884075,20125
"15588","FBgn0052480","3L",769503,769600,97
"15589","FBgn0035878","3L",8344421,8346382,1961
"15590","FBgn0082947","3L",20454496,20454574,78
"15591","FBgn0034617","2R",21310368,21312354,1986
"15592","FBgn0053647","3L",19236360,19237057,697
"15593","FBgn0267723","3R",21638652,21639088,436
"15594","FBgn0037295","3R",5150908,5170121,19213
"15595","FBgn0014848","3L",15658936,15659441,505
"15596","FBgn0038672","3R",19022458,19024030,1572
"15597","FBgn0003916","2L",901491,901654,163
"15598","FBgn0004167","3L",3336860,3368133,31273
"15599","FBgn0266880","2L",8370343,8370670,327
"15600","FBgn0031126","X",20657122,20661425,4303
"15601","FBgn0028370","2L",15552723,15583978,31255
"15602","FBgn0033738","2R",12431447,12436577,5130
"15603","FBgn0039875","3R",31772219,31775163,2944
"15604","FBgn0027491","2L",10308131,10310956,2825
"15605","FBgn0034975","2R",24099210,24107032,7822
"15606","FBgn0050393","2R",21266364,21267579,1215
"15607","FBgn0265142","2R",19652295,19652826,531
"15608","FBgn0052006","4",150764,153538,2774
"15609","FBgn0032820","2L",19761587,19764136,2549
"15610","FBgn0011904","3R",6822963,6823035,72
"15611","FBgn0039325","3R",25318550,25320101,1551
"15612","FBgn0031197","X",22547097,22548056,959
"15613","FBgn0087040","3L",9681268,9683370,2102
"15614","FBgn0266250","3R",16783497,16784672,1175
"15615","FBgn0267131","3R",30612028,30615478,3450
"15616","FBgn0050463","2R",16673235,16732916,59681
"15617","FBgn0028895","2L",16299943,16301765,1822
"15618","FBgn0033669","2R",11967343,11970115,2772
"15619","FBgn0029950","X",7418594,7422142,3548
"15620","FBgn0020616","2L",6950421,6954586,4165
"15621","FBgn0024846","2L",13780689,13782611,1922
"15622","FBgn0265718","3L",7408493,7409707,1214
"15623","FBgn0032234","2L",10380103,10382864,2761
"15624","FBgn0038463","3R",16996446,16999449,3003
"15625","FBgn0040259","3R",11157098,11159744,2646
"15626","FBgn0267269","2L",2625456,2627986,2530
"15627","FBgn0053631","3R",10064007,10064645,638
"15628","FBgn0036932","3L",20027819,20029020,1201
"15629","FBgn0264843","3L",15876091,15876472,381
"15630","FBgn0029667","X",3491011,3504851,13840
"15631","FBgn0026598","3R",24163966,24168264,4298
"15632","FBgn0035806","3L",7651180,7651900,720
"15633","FBgn0053653","4",1230837,1271759,40922
"15634","FBgn0032294","2L",10736319,10737043,724
"15635","FBgn0036671","3L",16863164,16864989,1825
"15636","FBgn0033484","2R",10085169,10096416,11247
"15637","FBgn0250817","2L",20253816,20254449,633
"15638","FBgn0034009","2R",15317817,15322171,4354
"15639","FBgn0004852","3L",19939287,19977960,38673
"15640","FBgn0038051","3R",12437817,12439139,1322
"15641","FBgn0027558","2R",7057654,7061732,4078
"15642","FBgn0011868","2R",18639726,18639796,70
"15643","FBgn0050208","2R",21161526,21161597,71
"15644","FBgn0030840","X",17446350,17448774,2424
"15645","FBgn0011327","3L",9475493,9476965,1472
"15646","FBgn0037539","3R",8010907,8013201,2294
"15647","FBgn0032472","2L",13142445,13142903,458
"15648","FBgn0034623","2R",21346875,21347883,1008
"15649","FBgn0033309","2R",8596972,8599962,2990
"15650","FBgn0029727","X",4784075,4786059,1984
"15651","FBgn0036258","3L",12143446,12146097,2651
"15652","FBgn0016053","2R",22330200,22332813,2613
"15653","FBgn0030624","X",15271036,15272405,1369
"15654","FBgn0053558","2R",6924687,6971637,46950
"15655","FBgn0264395","X",18459138,18460418,1280
"15656","FBgn0267191","3R",16428304,16428976,672
"15657","FBgn0032024","2L",8342695,8344378,1683
"15658","FBgn0032836","2L",19964136,19965702,1566
"15659","FBgn0039421","3R",26344290,26345473,1183
"15660","FBgn0034131","2R",16484841,16485552,711
"15661","FBgn0053189","3R",8780113,8780789,676
"15662","FBgn0039224","3R",24788248,24790136,1888
"15663","FBgn0052988","2L",8864864,8865692,828
"15664","FBgn0283442","2L",15061656,15074311,12655
"15665","FBgn0031022","X",19493292,19494401,1109
"15666","FBgn0265081","3R",10052846,10054298,1452
"15667","FBgn0003087","2L",10362989,10364092,1103
"15668","FBgn0053891","2L",21479042,21479454,412
"15669","FBgn0052088","3L",11728348,11732016,3668
"15670","FBgn0052525","X",21304713,21304820,107
"15671","FBgn0050476","2R",14752521,14753269,748
"15672","FBgn0033538","2R",10617662,10641807,24145
"15673","FBgn0035359","3L",2645368,2647192,1824
"15674","FBgn0024288","3R",31065253,31083407,18154
"15675","FBgn0267124","3R",31687978,31688526,548
"15676","FBgn0033067","2R",6180926,6181626,700
"15677","FBgn0040352","X",2871884,2872853,969
"15678","FBgn0262392","2L",3767621,3767688,67
"15679","FBgn0260775","2R",24157668,24159312,1644
"15680","FBgn0035911","3L",8574407,8576078,1671
"15681","FBgn0029091","3L",21962401,21969964,7563
"15682","FBgn0034709","2R",22189817,22202671,12854
"15683","FBgn0013708","mitochondrion_genome",14058,14130,72
"15684","FBgn0263459","2R",13557905,13558055,150
"15685","FBgn0038469","3R",17033588,17036045,2457
"15686","FBgn0050199","2R",25076765,25076836,71
"15687","FBgn0266181","3R",21783540,21786208,2668
"15688","FBgn0033703","2R",12240399,12240813,414
"15689","FBgn0051233","3R",21749853,21753237,3384
"15690","FBgn0011277","X",4645127,4647414,2287
"15691","FBgn0050333","2R",17604535,17604607,72
"15692","FBgn0046793","3L",4665927,4667389,1462
"15693","FBgn0265144","2R",19653296,19653595,299
"15694","FBgn0264371","2L",3588485,3590301,1816
"15695","FBgn0263256","2L",8145758,8158786,13028
"15696","FBgn0264719","3L",18693352,18693952,600
"15697","FBgn0039288","3R",25195527,25196531,1004
"15698","FBgn0029936","X",7102555,7104491,1936
"15699","FBgn0033850","2R",13521769,13523375,1606
"15700","FBgn0001084","2L",8401476,8403280,1804
"15701","FBgn0042112","3L",8124584,8125132,548
"15702","FBgn0038961","3R",22408566,22410915,2349
"15703","FBgn0264495","3R",6406855,6449274,42419
"15704","FBgn0250837","2L",11011312,11012135,823
"15705","FBgn0264940","X",22764525,22766663,2138
"15706","FBgn0030289","X",11344506,11348001,3495
"15707","FBgn0034820","2R",23087177,23088165,988
"15708","FBgn0037531","3R",7916599,7920299,3700
"15709","FBgn0035046","2R",24664398,24665439,1041
"15710","FBgn0005670","X",2159145,2162180,3035
"15711","FBgn0266027","2L",3397323,3398444,1121
"15712","FBgn0053376","2R",19757624,19757758,134
"15713","FBgn0012000","3R",7472060,7472132,72
"15714","FBgn0265062","3R",19278775,19279728,953
"15715","FBgn0011272","2L",9967313,9968645,1332
"15716","FBgn0264378","2R",14994559,14995195,636
"15717","FBgn0032642","2L",17481231,17482037,806
"15718","FBgn0010246","3L",1318480,1329617,11137
"15719","FBgn0038380","3R",15889194,15896078,6884
"15720","FBgn0051573","3R",17631679,17631750,71
"15721","FBgn0037829","3R",10753331,10755634,2303
"15722","FBgn0031777","2L",6069790,6070686,896
"15723","FBgn0265705","X",19667018,19667746,728
"15724","FBgn0015794","X",5670827,5671812,985
"15725","FBgn0266634","2R",12881445,12883253,1808
"15726","FBgn0036367","3L",13456208,13457238,1030
"15727","FBgn0003930","2L",21215036,21215178,142
"15728","FBgn0039563","3R",27952051,27954112,2061
"15729","FBgn0023495","3R",13370240,13371904,1664
"15730","FBgn0053852","2L",21516773,21517795,1022
"15731","FBgn0039525","3R",27559379,27561319,1940
"15732","FBgn0264295","2L",4007690,4007984,294
"15733","FBgn0262005","3R",17404487,17405109,622
"15734","FBgn0266048","2R",24390777,24391977,1200
"15735","FBgn0011766","3R",21620304,21660871,40567
"15736","FBgn0051618","2L",21423737,21424229,492
"15737","FBgn0037576","3R",8321747,8323054,1307
"15738","FBgn0033736","2R",12426883,12427861,978
"15739","FBgn0266431","X",9871098,9871702,604
"15740","FBgn0000139","3R",24650125,24653376,3251
"15741","FBgn0262679","3L",53873,54751,878
"15742","FBgn0263474","2L",21177040,21177176,136
"15743","FBgn0266842","2L",7328944,7329519,575
"15744","FBgn0014851","3L",15661248,15661809,561
"15745","FBgn0033667","2R",11904323,11912779,8456
"15746","FBgn0051279","3R",16430681,16432897,2216
"15747","FBgn0030975","X",18894446,18896581,2135
"15748","FBgn0266992","3L",11593447,11593712,265
"15749","FBgn0034117","2R",16341251,16344182,2931
"15750","FBgn0038436","3R",16477110,16481070,3960
"15751","FBgn0063378","2R",17702411,17702477,66
"15752","FBgn0036717","3L",17383636,17388956,5320
"15753","FBgn0040079","2L",16288290,16291195,2905
"15754","FBgn0052506","X",20449331,20467065,17734
"15755","FBgn0031804","2L",6357005,6358318,1313
"15756","FBgn0030610","X",15084029,15084699,670
"15757","FBgn0037944","3R",11744229,11750029,5800
"15758","FBgn0263111","X",11931280,11985087,53807
"15759","FBgn0030984","X",19125003,19127316,2313
"15760","FBgn0285940","2R",12903794,12906236,2442
"15761","FBgn0039369","3R",25776276,25777198,922
"15762","FBgn0037688","3R",9402564,9404269,1705
"15763","FBgn0050371","2R",8267643,8269334,1691
"15764","FBgn0033280","2R",8262674,8263278,604
"15765","FBgn0265709","3L",5371247,5371636,389
"15766","FBgn0035762","3L",7323619,7326255,2636
"15767","FBgn0267314","3R",16800600,16801203,603
"15768","FBgn0052279","3L",3314349,3314681,332
"15769","FBgn0037751","3R",9775121,9777943,2822
"15770","FBgn0004359","3R",26881734,26910997,29263
"15771","FBgn0037902","3R",11435850,11437523,1673
"15772","FBgn0265825","2L",772514,773093,579
"15773","FBgn0264476","3L",5050838,5051438,600
"15774","FBgn0035243","3L",1617348,1618158,810
"15775","FBgn0032462","2L",12966590,12967810,1220
"15776","FBgn0031644","2L",4889995,4891277,1282
"15777","FBgn0051890","2L",8683451,8683522,71
"15778","FBgn0023516","X",1866832,1869061,2229
"15779","FBgn0035416","3L",3199090,3211348,12258
"15780","FBgn0053544","2R",16778365,16778994,629
"15781","FBgn0050115","2R",18554119,18611777,57658
"15782","FBgn0038494","3R",17232253,17265049,32796
"15783","FBgn0265886","3L",19052302,19052790,488
"15784","FBgn0260233","3L",14747929,14757962,10033
"15785","FBgn0263480","3R",11410848,11410997,149
"15786","FBgn0267933","3L",15319923,15320356,433
"15787","FBgn0033883","2R",13860349,13862002,1653
"15788","FBgn0267937","3R",12833127,12833725,598
"15789","FBgn0037810","3R",10333115,10338265,5150
"15790","FBgn0267964","2L",19606569,19731561,124992
"15791","FBgn0035906","3L",8521429,8523501,2072
"15792","FBgn0039055","3R",23114014,23117931,3917
"15793","FBgn0029660","X",3460592,3462500,1908
"15794","FBgn0034106","2R",16283435,16287450,4015
"15795","FBgn0266186","2R",9841080,9842502,1422
"15796","FBgn0265698","2R",19683495,19684195,700
"15797","FBgn0265538","2R",17187504,17187678,174
"15798","FBgn0037716","3R",9578042,9581225,3183
"15799","FBgn0264738","X",17022304,17023370,1066
"15800","FBgn0035084","2R",24943392,24945201,1809
"15801","FBgn0036552","3L",15978524,15980004,1480
"15802","FBgn0025612","X",4641269,4644868,3599
"15803","FBgn0264496","2R",16221636,16223187,1551
"15804","FBgn0013469","3L",10981171,11009188,28017
"15805","FBgn0037202","3L",22879089,22880963,1874
"15806","FBgn0035424","3L",3224838,3236604,11766
"15807","FBgn0039722","3R",29912991,29914346,1355
"15808","FBgn0050169","2R",24526172,24529581,3409
"15809","FBgn0035880","3L",8352355,8356296,3941
"15810","FBgn0263094","2L",18291253,18291462,209
"15811","FBgn0051518","3R",18108993,18109064,71
"15812","FBgn0038706","3R",19423779,19425199,1420
"15813","FBgn0263776","3L",11036358,11051371,15013
"15814","FBgn0024189","2R",8798489,8856091,57602
"15815","FBgn0033899","2R",14157762,14159434,1672
"15816","FBgn0030412","X",12631605,12653442,21837
"15817","FBgn0036416","3L",14233469,14234609,1140
"15818","FBgn0030202","X",10432465,10432812,347
"15819","FBgn0027585","2R",8735810,8759590,23780
"15820","FBgn0032495","2L",13246232,13250189,3957
"15821","FBgn0035896","3L",8443042,8449377,6335
"15822","FBgn0026787","2L",103962,106732,2770
"15823","FBgn0025864","X",8592031,8602036,10005
"15824","FBgn0083951","2R",20975488,20976934,1446
"15825","FBgn0085191","2L",11531820,11533756,1936
"15826","FBgn0031824","2L",6492974,6494532,1558
"15827","FBgn0265804","2L",12086621,12088025,1404
"15828","FBgn0285971","2L",8464488,8466694,2206
"15829","FBgn0264676","X",12067200,12070139,2939
"15830","FBgn0261973","2R",24185825,24185922,97
"15831","FBgn0003140","2R",17955396,17956570,1174
"15832","FBgn0038598","3R",18286620,18288777,2157
"15833","FBgn0034243","2R",17565779,17568456,2677
"15834","FBgn0030481","X",13387563,13389332,1769
"15835","FBgn0036998","3L",20473783,20474791,1008
"15836","FBgn0026394","2L",4164689,4166134,1445
"15837","FBgn0266275","X",15082616,15083753,1137
"15838","FBgn0053731","2L",21463194,21463229,35
"15839","FBgn0038772","3R",20057748,20059291,1543
"15840","FBgn0013749","4",1124167,1125325,1158
"15841","FBgn0032331","2L",11016995,11018778,1783
"15842","FBgn0031054","X",19664561,19666866,2305
"15843","FBgn0267165","X",18120546,18121467,921
"15844","FBgn0264005","3R",17558930,17569097,10167
"15845","FBgn0263112","4",1198852,1224467,25615
"15846","FBgn0032129","2L",9547720,9566750,19030
"15847","FBgn0003275","3R",5371795,5372397,602
"15848","FBgn0039495","3R",27161158,27162911,1753
"15849","FBgn0265937","2R",21297495,21298495,1000
"15850","FBgn0016038","X",621530,623051,1521
"15851","FBgn0051370","3R",25302464,25303986,1522
"15852","FBgn0260761","2R",23599526,23600787,1261
"15853","FBgn0267134","3R",8546910,8547385,475
"15854","FBgn0040393","X",3236130,3236686,556
"15855","FBgn0017581","3R",11750931,11764457,13526
"15856","FBgn0000120","2L",18078269,18081307,3038
"15857","FBgn0266975","3L",2319386,2319919,533
"15858","FBgn0266052","X",6637123,6637548,425
"15859","FBgn0051183","3R",15857871,15875939,18068
"15860","FBgn0031636","2L",4838347,4841465,3118
"15861","FBgn0085345","3R",15230585,15231686,1101
"15862","FBgn0267234","3L",21318223,21318650,427
"15863","FBgn0267083","X",15973555,15973917,362
"15864","FBgn0031423","2L",2384761,2385792,1031
"15865","FBgn0029709","X",4540908,4542506,1598
"15866","FBgn0263619","3R",5607799,5609810,2011
"15867","FBgn0040623","3R",29490544,29491150,606
"15868","FBgn0267311","3L",1235472,1235702,230
"15869","FBgn0283682","2L",11095150,11100888,5738
"15870","FBgn0052232","3L",4993950,4996877,2927
"15871","FBgn0037778","3R",10045574,10047260,1686
"15872","FBgn0262366","3L",11834721,11836721,2000
"15873","FBgn0030871","X",17843343,17844704,1361
"15874","FBgn0267899","Y",3060612,3061377,765
"15875","FBgn0034627","2R",21384552,21386221,1669
"15876","FBgn0030543","X",14189516,14190755,1239
"15877","FBgn0266904","2L",7871978,7872367,389
"15878","FBgn0030729","X",16265242,16266537,1295
"15879","FBgn0015522","2R",17846699,17848444,1745
"15880","FBgn0038113","3R",13038375,13040184,1809
"15881","FBgn0267073","X",5428483,5429256,773
"15882","FBgn0030524","X",13790338,13791111,773
"15883","FBgn0039193","3R",24365554,24366349,795
"15884","FBgn0014018","3R",9044183,9047977,3794
"15885","FBgn0015585","3L",3815839,3816354,515
"15886","FBgn0036627","3L",16394586,16396880,2294
"15887","FBgn0086686","3R",14642672,14655716,13044
"15888","FBgn0067052","X",10589089,10589985,896
"15889","FBgn0010825","3L",8449922,8472669,22747
"15890","FBgn0031907","2L",7401335,7404727,3392
"15891","FBgn0029940","X",7266904,7267883,979
"15892","FBgn0029812","X",5808954,5810158,1204
"15893","FBgn0004556","3L",16728496,16730818,2322
"15894","FBgn0284249","2R",6662265,6668085,5820
"15895","FBgn0004174","3R",7364254,7364673,419
"15896","FBgn0039098","3R",23677358,23678421,1063
"15897","FBgn0034514","2R",20538877,20539316,439
"15898","FBgn0265309","2R",24334785,24335976,1191
"15899","FBgn0267651","3R",21370918,21373575,2657
"15900","FBgn0011785","3R",24319000,24328619,9619
"15901","FBgn0263469","2L",12433025,12433180,155
"15902","FBgn0262569","2R",18867848,18868167,319
"15903","FBgn0267292","2L",15549869,15550276,407
"15904","FBgn0032143","2L",9767058,9768727,1669
"15905","FBgn0031434","2L",2575280,2576997,1717
"15906","FBgn0036232","3L",11974905,11975810,905
"15907","FBgn0024289","3R",7052335,7054541,2206
"15908","FBgn0023083","3R",18573091,18589459,16368
"15909","FBgn0015239","3L",21494019,21497494,3475
"15910","FBgn0031176","X",21402339,21402772,433
"15911","FBgn0267610","Y",2482594,2483518,924
"15912","FBgn0033731","2R",12413962,12415170,1208
"15913","FBgn0000723","3R",9367603,9394546,26943
"15914","FBgn0011642","4",1057365,1065001,7636
"15915","FBgn0025833","2R",16874724,16895652,20928
"15916","FBgn0050369","2R",8259286,8259784,498
"15917","FBgn0034479","2R",19979242,19984895,5653
"15918","FBgn0262365","3R",13086224,13086761,537
"15919","FBgn0028434","2R",14852941,14853948,1007
"15920","FBgn0025815","X",6674387,6677176,2789
"15921","FBgn0030890","X",18078491,18088532,10041
"15922","FBgn0040899","X",2184725,2185258,533
"15923","FBgn0033202","2R",7659104,7660588,1484
"15924","FBgn0035688","3L",6164916,6173880,8964
"15925","FBgn0032478","2L",13183450,13184875,1425
"15926","FBgn0003082","2R",7825289,7827319,2030
"15927","FBgn0039475","3R",27022071,27023217,1146
"15928","FBgn0038797","3R",20499992,20502015,2023
"15929","FBgn0039907","4",436957,443911,6954
"15930","FBgn0035385","3L",3001716,3011860,10144
"15931","FBgn0051693","2L",22015190,22017334,2144
"15932","FBgn0261357","2L",18007935,18008962,1027
"15933","FBgn0029082","2R",15011396,15042134,30738
"15934","FBgn0263024","3R",27694318,27694541,223
"15935","FBgn0051207","3R",21046032,21047027,995
"15936","FBgn0020496","3R",13011649,13026275,14626
"15937","FBgn0265741","3L",11435650,11436206,556
"15938","FBgn0004590","3L",15651479,15652254,775
"15939","FBgn0034321","2R",18288696,18294712,6016
"15940","FBgn0030616","X",15137870,15139367,1497
"15941","FBgn0038611","3R",18381580,18385072,3492
"15942","FBgn0030667","X",15684947,15688857,3910
"15943","FBgn0039233","3R",24850627,24851385,758
"15944","FBgn0266565","3R",18158345,18159924,1579
"15945","FBgn0261931","X",9608946,9623243,14297
"15946","FBgn0031490","2L",3018508,3021506,2998
"15947","FBgn0029669","X",3514316,3515757,1441
"15948","FBgn0267114","3R",31469103,31469978,875
"15949","FBgn0053857","2L",21524952,21525480,528
"15950","FBgn0265497","2R",13578036,13579626,1590
"15951","FBgn0035414","3L",3190622,3192491,1869
"15952","FBgn0039379","3R",25851632,25853989,2357
"15953","FBgn0011278","3R",21441577,21446537,4960
"15954","FBgn0035121","3L",259043,264380,5337
"15955","FBgn0037918","3R",11585354,11590146,4792
"15956","FBgn0034279","2R",17767808,17769989,2181
"15957","FBgn0033680","2R",12081276,12082057,781
"15958","FBgn0264724","3L",15334782,15336171,1389
"15959","FBgn0035077","2R",24898273,24899505,1232
"15960","FBgn0028542","2L",13968280,13969976,1696
"15961","FBgn0262018","2L",17786971,17875247,88276
"15962","FBgn0015919","3L",12609631,12621798,12167
"15963","FBgn0024248","2L",10242512,10247078,4566
"15964","FBgn0053862","2L",21533184,21533676,492
"15965","FBgn0039536","3R",27662439,27677099,14660
"15966","FBgn0036997","3L",20466944,20469592,2648
"15967","FBgn0014023","3R",9514822,9515908,1086
"15968","FBgn0261843","3R",21365609,21370249,4640
"15969","FBgn0263871","2L",396120,396571,451
"15970","FBgn0010774","3R",7077904,7080387,2483
"15971","FBgn0266268","3R",31810460,31812296,1836
"15972","FBgn0028952","2L",2045494,2048054,2560
"15973","FBgn0267544","3L",11672613,11672974,361
"15974","FBgn0027617","3R",24814903,24817007,2104
"15975","FBgn0031752","2L",5949450,5955235,5785
"15976","FBgn0035900","3L",8507469,8509763,2294
"15977","FBgn0026722","2R",7932429,7936840,4411
"15978","FBgn0260986","X",1477063,1481420,4357
"15979","FBgn0262462","3R",16856275,16856342,67
"15980","FBgn0263090","2L",18293733,18294056,323
"15981","FBgn0265627","2R",18678680,18684198,5518
"15982","FBgn0267102","X",9590093,9590619,526
"15983","FBgn0264462","3L",17245882,17264290,18408
"15984","FBgn0264353","2L",21102586,21104298,1712
"15985","FBgn0038607","3R",18361994,18364277,2283
"15986","FBgn0032938","2L",21262956,21282790,19834
"15987","FBgn0029502","X",6771225,6773039,1814
"15988","FBgn0011787","3L",8956791,8957584,793
"15989","FBgn0030480","X",13385210,13385893,683
"15990","FBgn0003292","3L",11584122,11587770,3648
"15991","FBgn0030947","X",18660472,18662153,1681
"15992","FBgn0039069","3R",23284002,23286041,2039
"15993","FBgn0037332","3R",5474899,5485393,10494
"15994","FBgn0011280","X",20419613,20420979,1366
"15995","FBgn0032873","2L",20656426,20659218,2792
"15996","FBgn0263397","2R",14276130,14300095,23965
"15997","FBgn0002431","3R",9714623,9725615,10992
"15998","FBgn0259818","2L",144231,153300,9069
"15999","FBgn0265872","X",15079956,15080425,469
"16000","FBgn0082999","X",17144107,17144240,133
"16001","FBgn0267709","3R",19941997,19942403,406
"16002","FBgn0038020","3R",12366163,12367564,1401
"16003","FBgn0061361","2R",20642466,20643785,1319
"16004","FBgn0031454","2L",2758427,2759677,1250
"16005","FBgn0040262","2L",16794211,16796009,1798
"16006","FBgn0051473","3R",7811814,7813009,1195
"16007","FBgn0028717","3R",25888542,25893270,4728
"16008","FBgn0016078","2R",9400531,9413463,12932
"16009","FBgn0262966","2R",19637559,19638041,482
"16010","FBgn0033728","2R",12402216,12405108,2892
"16011","FBgn0265893","3L",20634172,20634651,479
"16012","FBgn0011892","2R",6946808,6946880,72
"16013","FBgn0036415","3L",14218204,14218974,770
"16014","FBgn0050287","2R",21536894,21538015,1121
"16015","FBgn0033502","2R",10265057,10269205,4148
"16016","FBgn0036144","3L",11176954,11197536,20582
"16017","FBgn0267147","3R",12849090,12849585,495
"16018","FBgn0036493","3L",15304255,15311195,6940
"16019","FBgn0040491","2R",11679492,11688557,9065
"16020","FBgn0033581","2R",11147602,11150068,2466
"16021","FBgn0260006","X",15125753,15137311,11558
"16022","FBgn0052785","X",3819699,3819770,71
"16023","FBgn0025111","X",10778954,10786907,7953
"16024","FBgn0065110","2L",10450134,10452396,2262
"16025","FBgn0262528","3L",15661867,15662279,412
"16026","FBgn0032677","2L",18294840,18297347,2507
"16027","FBgn0039667","3R",29494782,29498923,4141
"16028","FBgn0053128","2L",1494070,1495456,1386
"16029","FBgn0262481","2R",18864621,18865218,597
"16030","FBgn0039490","3R",27118646,27121590,2944
"16031","FBgn0015271","2L",13829837,13831576,1739
"16032","FBgn0053393","2R",19751358,19751492,134
"16033","FBgn0035847","3L",8178675,8180514,1839
"16034","FBgn0260868","X",20446371,20446703,332
"16035","FBgn0267613","3L",21194617,21196136,1519
"16036","FBgn0038006","3R",12234980,12236904,1924
"16037","FBgn0038606","3R",18330932,18360728,29796
"16038","FBgn0052421","3L",5356662,5356734,72
"16039","FBgn0266860","2R",9445444,9445794,350
"16040","FBgn0260027","3L",18667361,18668135,774
"16041","FBgn0040239","3L",5565231,5566765,1534
"16042","FBgn0033989","2R",14987660,14992230,4570
"16043","FBgn0033994","2R",15147860,15149709,1849
"16044","FBgn0261276","2R",14230611,14235449,4838
"16045","FBgn0085540","211000022280347",7,354,347
"16046","FBgn0031801","2L",6349393,6351034,1641
"16047","FBgn0054006","3R",27216304,27218184,1880
"16048","FBgn0265343","2R",10052643,10052995,352
"16049","FBgn0010501","2R",23551313,23553547,2234
"16050","FBgn0037065","3L",21281752,21285962,4210
"16051","FBgn0029957","X",7728755,7731729,2974
"16052","FBgn0035679","3L",6093204,6094747,1543
"16053","FBgn0046704","2L",6723903,6732766,8863
"16054","FBgn0051803","2L",17411649,17412633,984
"16055","FBgn0052512","X",21062277,21067540,5263
"16056","FBgn0086041","2L",21143854,21143941,87
"16057","FBgn0050195","2R",22646616,22647245,629
"16058","FBgn0052581","X",15796908,15799162,2254
"16059","FBgn0017424","3L",12129103,12131488,2385
"16060","FBgn0050218","2R",19725905,19725976,71
"16061","FBgn0085471","2R",14366798,14367874,1076
"16062","FBgn0051755","2L",9996706,10002736,6030
"16063","FBgn0039970","2R",5608635,5611586,2951
"16064","FBgn0266155","2L",15435747,15436320,573
"16065","FBgn0052813","X",1380914,1392843,11929
"16066","FBgn0051118","3R",24826665,24828409,1744
"16067","FBgn0267759","3R",23333504,23333803,299
"16068","FBgn0038643","3R",18693293,18693711,418
"16069","FBgn0038847","3R",21044068,21044905,837
"16070","FBgn0031045","X",19625705,19626601,896
"16071","FBgn0037424","3R",6301804,6303653,1849
"16072","FBgn0262424","3R",6809506,6809582,76
"16073","FBgn0262167","3R",24530576,24536395,5819
"16074","FBgn0037760","3R",9803486,9809368,5882
"16075","FBgn0265986","X",11193158,11193491,333
"16076","FBgn0267315","3R",16801299,16801877,578
"16077","FBgn0262968","X",7494544,7495497,953
"16078","FBgn0264818","X",17182880,17183242,362
"16079","FBgn0267222","3R",24282911,24283368,457
"16080","FBgn0027564","X",5692945,5695205,2260
"16081","FBgn0026749","X",13385914,13387417,1503
"16082","FBgn0262588","3R",28262735,28263622,887
"16083","FBgn0038063","3R",12550625,12595725,45100
"16084","FBgn0026441","3R",15320756,15325279,4523
"16085","FBgn0010389","3R",18045216,18052984,7768
"16086","FBgn0004047","X",13759546,13761547,2001
"16087","FBgn0265348","2R",10859695,10860191,496
"16088","FBgn0053807","2L",21431963,21432985,1022
"16089","FBgn0261436","3R",4227387,4229238,1851
"16090","FBgn0262352","2L",13119294,13120767,1473
"16091","FBgn0265379","3R",26195250,26230268,35018
"16092","FBgn0035993","3L",9440056,9442267,2211
"16093","FBgn0038576","3R",18185498,18187875,2377
"16094","FBgn0038471","3R",17040682,17041895,1213
"16095","FBgn0034816","2R",23074823,23076857,2034
"16096","FBgn0032151","2L",9793317,9886250,92933
"16097","FBgn0011977","X",14103363,14103444,81
"16098","FBgn0267145","3R",5015624,5021474,5850
"16099","FBgn0031117","X",20467455,20469796,2341
"16100","FBgn0039732","3R",29996961,29997676,715
"16101","FBgn0266640","2R",18209520,18210805,1285
"16102","FBgn0028658","2L",13808360,13811474,3114
"16103","FBgn0266734","3R",15774754,15775336,582
"16104","FBgn0053929","3R",12893972,12894529,557
"16105","FBgn0051159","3R",22613686,22616622,2936
"16106","FBgn0082971","2R",21326882,21327022,140
"16107","FBgn0259199","3L",2652088,2655455,3367
"16108","FBgn0030928","X",18491185,18492006,821
"16109","FBgn0035623","3L",5604790,5607190,2400
"16110","FBgn0040989","2L",18006627,18007216,589
"16111","FBgn0040028","X",21605884,21608920,3036
"16112","FBgn0000406","2L",16788774,16790721,1947
"16113","FBgn0267028","2R",5663909,5664615,706
"16114","FBgn0030721","X",16006147,16008721,2574
"16115","FBgn0032219","2L",10322476,10324990,2514
"16116","FBgn0034032","2R",15562697,15565801,3104
"16117","FBgn0082940","2R",14622088,14622167,79
"16118","FBgn0266854","2R",18173049,18173554,505
"16119","FBgn0260407","2L",13834250,13835072,822
"16120","FBgn0037710","3R",9561583,9563673,2090
"16121","FBgn0283433","X",20205043,20209603,4560
"16122","FBgn0020912","3R",30912754,30930682,17928
"16123","FBgn0031038","X",19611526,19615617,4091
"16124","FBgn0031985","2L",8116965,8124010,7045
"16125","FBgn0011812","2R",8432886,8433384,498
"16126","FBgn0030429","X",12855688,12857722,2034
"16127","FBgn0265583","2L",17589471,17589700,229
"16128","FBgn0028552","2R",24047145,24048903,1758
"16129","FBgn0026080","X",4114800,4117487,2687
"16130","FBgn0033752","2R",12519166,12521624,2458
"16131","FBgn0001170","2L",6013059,6019402,6343
"16132","FBgn0262943","2L",8242055,8242435,380
"16133","FBgn0037354","3R",5633627,5634640,1013
"16134","FBgn0263338","2L",17792412,17793694,1282
"16135","FBgn0050281","2R",22114997,22116189,1192
"16136","FBgn0051956","2L",3472603,3475338,2735
"16137","FBgn0026777","4",308093,310822,2729
"16138","FBgn0050201","2R",23072019,23072100,81
"16139","FBgn0036772","3L",17909483,17912565,3082
"16140","FBgn0033570","2R",10897144,10897885,741
"16141","FBgn0001989","2L",15749319,15751078,1759
"16142","FBgn0033236","2R",7942043,7955882,13839
"16143","FBgn0052442","3L",21528218,21529333,1115
"16144","FBgn0267777","3R",29719713,29721191,1478
"16145","FBgn0085359","X",19068275,19068973,698
"16146","FBgn0034880","2R",23556672,23560263,3591
"16147","FBgn0035027","2R",24571627,24574503,2876
"16148","FBgn0020299","3R",14577217,14608079,30862
"16149","FBgn0036959","3L",20241267,20245312,4045
"16150","FBgn0266209","2L",18795824,18796180,356
"16151","FBgn0040207","X",16267007,16276180,9173
"16152","FBgn0031489","2L",3016441,3018308,1867
"16153","FBgn0033043","2R",5797195,5798512,1317
"16154","FBgn0033479","2R",10063385,10066514,3129
"16155","FBgn0039042","3R",23043990,23044661,671
"16156","FBgn0035567","3L",4687587,4688774,1187
"16157","FBgn0013706","mitochondrion_genome",11638,11703,65
"16158","FBgn0267167","X",18244892,18245180,288
"16159","FBgn0026565","3R",6642262,6644434,2172
"16160","FBgn0033500","2R",10249220,10255495,6275
"16161","FBgn0004432","X",16317673,16320370,2697
"16162","FBgn0261004","3R",5603236,5606543,3307
"16163","FBgn0034198","2R",17134129,17135345,1216
"16164","FBgn0061492","3L",6094987,6096517,1530
"16165","FBgn0037736","3R",9734012,9739979,5967
"16166","FBgn0034478","2R",19951345,19951950,605
"16167","FBgn0033953","2R",14664246,14665356,1110
"16168","FBgn0034576","2R",21025078,21026086,1008
"16169","FBgn0285896","3L",14075772,14083229,7457
"16170","FBgn0034792","2R",22882747,22886247,3500
"16171","FBgn0083003","2R",22607385,22607520,135
"16172","FBgn0051612","2L",21762314,21795447,33133
"16173","FBgn0051108","3R",25112867,25122920,10053
"16174","FBgn0004910","3L",3909973,3935617,25644
"16175","FBgn0039094","3R",23602507,23605495,2988
"16176","FBgn0035328","3L",2276550,2278038,1488
"16177","FBgn0052170","3L",16877309,16879372,2063
"16178","FBgn0013704","mitochondrion_genome",6062,6125,63
"16179","FBgn0259190","X",7876963,7878836,1873
"16180","FBgn0030666","X",15675476,15677737,2261
"16181","FBgn0053002","2L",4458595,4459638,1043
"16182","FBgn0082582","3R",30532607,30578905,46298
"16183","FBgn0035187","3L",1190384,1193173,2789
"16184","FBgn0038280","3R",15014770,15016034,1264
"16185","FBgn0086035","2L",11234835,11234912,77
"16186","FBgn0264880","2R",7343345,7343695,350
"16187","FBgn0261477","2R",18440965,18445526,4561
"16188","FBgn0262390","X",4366179,4366248,69
"16189","FBgn0262180","3R",9517524,9517599,75
"16190","FBgn0265148","2L",21957820,21958360,540
"16191","FBgn0023526","X",2278031,2293411,15380
"16192","FBgn0026778","2L",2573436,2575052,1616
"16193","FBgn0041232","3L",6666638,6667816,1178
"16194","FBgn0265792","2L",10801595,10802801,1206
"16195","FBgn0037654","3R",9008321,9010274,1953
"16196","FBgn0261360","3L",19719527,19793569,74042
"16197","FBgn0267233","3R",4634975,4635655,680
"16198","FBgn0051580","3R",17646683,17646755,72
"16199","FBgn0036282","3L",12399539,12401935,2396
"16200","FBgn0085248","2R",8917708,8918877,1169
"16201","FBgn0038926","3R",22029440,22031900,2460
"16202","FBgn0259697","3L",24324866,24401655,76789
"16203","FBgn0047338","3L",15023492,15024009,517
"16204","FBgn0263390","3R",22981459,22998528,17069
"16205","FBgn0037204","3L",22898744,22900262,1518
"16206","FBgn0031906","2L",7390984,7398750,7766
"16207","FBgn0035870","3L",8305336,8306980,1644
"16208","FBgn0052036","3L",9488050,9489233,1183
"16209","FBgn0264916","3R",19149122,19149557,435
"16210","FBgn0262513","2R",16947658,16948224,566
"16211","FBgn0262656","X",3373159,3391697,18538
"16212","FBgn0267767","3R",25137701,25138001,300
"16213","FBgn0037146","3L",21972002,21984606,12604
"16214","FBgn0286041","3R",13970739,13970942,203
"16215","FBgn0030373","X",12072008,12072818,810
"16216","FBgn0032817","2L",19742817,19756904,14087
"16217","FBgn0265367","2L",3537844,3538333,489
"16218","FBgn0036160","3L",11457076,11458470,1394
"16219","FBgn0000625","3L",12462537,12468021,5484
"16220","FBgn0284415","2L",4655478,4656209,731
"16221","FBgn0011559","2L",18356047,18359026,2979
"16222","FBgn0052104","3L",12393804,12399322,5518
"16223","FBgn0262871","3R",17379944,17390265,10321
"16224","FBgn0053927","3R",4689951,4690608,657
"16225","FBgn0030258","X",11052171,11053556,1385
"16226","FBgn0053453","2R",19252501,19253228,727
"16227","FBgn0039855","3R",31590581,31592316,1735
"16228","FBgn0030296","X",11409947,11411667,1720
"16229","FBgn0052188","3L",17833277,17833625,348
"16230","FBgn0266587","2L",17584725,17585095,370
"16231","FBgn0003270","2L",18596136,18596921,785
"16232","FBgn0034176","2R",17000244,17001941,1697
"16233","FBgn0263278","2L",6424336,6426371,2035
"16234","FBgn0052227","3L",20268859,20295133,26274
"16235","FBgn0014877","2R",13554077,13555606,1529
"16236","FBgn0033243","2R",7966029,7968024,1995
"16237","FBgn0039577","3R",28303631,28304605,974
"16238","FBgn0031214","2L",76348,77783,1435
"16239","FBgn0261674","3L",12790192,12796084,5892
"16240","FBgn0267588","2R",23905334,23906700,1366
"16241","FBgn0035011","2R",24492214,24492855,641
"16242","FBgn0050452","2R",19725620,19725691,71
"16243","FBgn0034138","2R",16570112,16571230,1118
"16244","FBgn0033862","2R",13661495,13663598,2103
"16245","FBgn0263842","2L",3765494,3765863,369
"16246","FBgn0085195","2L",14743193,14743879,686
"16247","FBgn0036948","3L",20202070,20203687,1617
"16248","FBgn0264368","2L",5062636,5063442,806
"16249","FBgn0038720","3R",19616024,19632718,16694
"16250","FBgn0038745","3R",19897372,19903689,6317
"16251","FBgn0278598","2L",22538230,22548452,10222
"16252","FBgn0035148","3L",651542,652881,1339
"16253","FBgn0037282","3R",4817980,4821432,3452
"16254","FBgn0262433","X",18128219,18128318,99
"16255","FBgn0041236","2R",23103941,23105169,1228
"16256","FBgn0267348","3L",9614914,9623980,9066
"16257","FBgn0050464","2R",15506582,15508366,1784
"16258","FBgn0035047","2R",24669397,24671577,2180
"16259","FBgn0029879","X",6597088,6599699,2611
"16260","FBgn0037838","3R",10815288,10817490,2202
"16261","FBgn0037007","3L",20514598,20519393,4795
"16262","FBgn0031188","X",22469981,22472021,2040
"16263","FBgn0031420","2L",2375841,2380506,4665
"16264","FBgn0031723","2L",5587115,5588414,1299
"16265","FBgn0030868","X",17819155,17819685,530
"16266","FBgn0262875","2L",15215222,15216160,938
"16267","FBgn0051313","3R",14566432,14567429,997
"16268","FBgn0039809","3R",30881792,30883503,1711
"16269","FBgn0261244","X",13783714,13811493,27779
"16270","FBgn0264604","3L",8230961,8231697,736
"16271","FBgn0085237","2R",22333126,22333505,379
"16272","FBgn0028956","2R",17448533,17452598,4065
"16273","FBgn0015379","X",21345358,21346858,1500
"16274","FBgn0039091","3R",23587120,23589819,2699
"16275","FBgn0036205","3L",11777073,11780485,3412
"16276","FBgn0266277","X",11790796,11791777,981
"16277","FBgn0035007","2R",24472712,24474226,1514
"16278","FBgn0259110","X",15946936,15973159,26223
"16279","FBgn0259837","211000022279681",401,1054,653
"16280","FBgn0038133","3R",13290629,13291846,1217
"16281","FBgn0052267","3L",3471555,3472113,558
"16282","FBgn0265191","2R",21200483,21210821,10338
"16283","FBgn0267464","3L",1617485,1618190,705
"16284","FBgn0286029","X",4074961,4075428,467
"16285","FBgn0051680","2L",20640121,20640718,597
"16286","FBgn0051122","3R",18406064,18412874,6810
"16287","FBgn0015372","2R",23519839,23523613,3774
"16288","FBgn0040718","2L",2006763,2007193,430
"16289","FBgn0036108","3L",10889990,10890700,710
"16290","FBgn0033312","2R",8611379,8614155,2776
"16291","FBgn0039602","3R",28820221,28824508,4287
"16292","FBgn0053404","2R",19747318,19747452,134
"16293","FBgn0267149","3R",13478265,13478780,515
"16294","FBgn0052594","X",15024436,15042060,17624
"16295","FBgn0024179","3L",4064152,4071717,7565
"16296","FBgn0032785","2L",19454256,19457723,3467
"16297","FBgn0053412","2R",19744361,19744495,134
"16298","FBgn0011703","2L",10325026,10327943,2917
"16299","FBgn0003969","X",15999951,16005812,5861
"16300","FBgn0031101","X",20327444,20328680,1236
"16301","FBgn0053971","3L",1529439,1531259,1820
"16302","FBgn0283724","3L",3178930,3185287,6357
"16303","FBgn0267400","3R",5914316,5915335,1019
"16304","FBgn0039923","4",778516,788978,10462
"16305","FBgn0027560","2L",4388327,4392778,4451
"16306","FBgn0038491","3R",17151861,17153771,1910
"16307","FBgn0032236","2L",10386662,10387652,990
"16308","FBgn0028896","2L",16291284,16291948,664
"16309","FBgn0032487","2L",13221397,13222429,1032
"16310","FBgn0036109","3L",10891714,10892516,802
"16311","FBgn0039093","3R",23596561,23599034,2473
"16312","FBgn0031393","2L",2155753,2156790,1037
"16313","FBgn0260646","3L",16034524,16034853,329
"16314","FBgn0004045","X",10053811,10055498,1687
"16315","FBgn0001174","2L",1517533,1518148,615
"16316","FBgn0285962","2R",9864510,9875072,10562
"16317","FBgn0032921","2L",21156288,21157685,1397
"16318","FBgn0039761","3R",30253182,30254097,915
"16319","FBgn0265700","X",8707213,8708006,793
"16320","FBgn0037584","3R",8362826,8363894,1068
"16321","FBgn0260392","2R",18167227,18168380,1153
"16322","FBgn0267655","2R",16153263,16153811,548
"16323","FBgn0050181","2R",23538631,23540773,2142
"16324","FBgn0030990","X",19176109,19179830,3721
"16325","FBgn0262516","3L",19714418,19718328,3910
"16326","FBgn0002023","2L",19079256,19108427,29171
"16327","FBgn0011335","3L",12116101,12118055,1954
"16328","FBgn0262686","X",11906452,11906868,416
"16329","FBgn0260758","2L",16889908,16891239,1331
"16330","FBgn0259243","3L",20816118,20836048,19930
"16331","FBgn0000326","2R",21617061,21619079,2018
"16332","FBgn0039234","3R",24851601,24854869,3268
"16333","FBgn0052773","X",4387676,4611385,223709
"16334","FBgn0053087","2R",8174165,8226438,52273
"16335","FBgn0033901","2R",14161430,14163054,1624
"16336","FBgn0025702","3L",22273985,22284335,10350
"16337","FBgn0033362","2R",9007234,9013526,6292
"16338","FBgn0266449","2L",6070990,6073961,2971
"16339","FBgn0035360","3L",2648048,2650205,2157
"16340","FBgn0040519","2L",22104891,22105512,621
"16341","FBgn0027494","3R",27652760,27653363,603
"16342","FBgn0032770","2L",19364375,19365470,1095
"16343","FBgn0266689","3L",16689268,16697897,8629
"16344","FBgn0037512","3R",7722417,7724715,2298
"16345","FBgn0031747","2L",5903178,5904689,1511
"16346","FBgn0263032","2R",17032487,17034012,1525
"16347","FBgn0086046","X",10443911,10443989,78
"16348","FBgn0262850","X",11591469,11593359,1890
"16349","FBgn0032401","2L",12046711,12048918,2207
"16350","FBgn0263247","3L",11579743,11579950,207
"16351","FBgn0031773","2L",6063562,6065953,2391
"16352","FBgn0085434","2R",24891614,24921677,30063
"16353","FBgn0267215","3R",25846778,25847078,300
"16354","FBgn0266848","X",22451445,22455422,3977
"16355","FBgn0035256","3L",1670407,1672727,2320
"16356","FBgn0000109","3L",1883795,1885019,1224
"16357","FBgn0032888","2L",20820089,20820867,778
"16358","FBgn0036589","3L",16271282,16271918,636
"16359","FBgn0035948","3L",8977395,8979880,2485
"16360","FBgn0030915","X",18380082,18381479,1397
"16361","FBgn0032299","2L",10770868,10771370,502
"16362","FBgn0261862","2R",10469473,10478567,9094
"16363","FBgn0264871","3R",22550032,22552687,2655
"16364","FBgn0259145","2R",22740999,22798289,57290
"16365","FBgn0053181","X",8489348,8517029,27681
"16366","FBgn0038974","3R",22466905,22468157,1252
"16367","FBgn0036622","3L",16378974,16381570,2596
"16368","FBgn0051235","3R",18316075,18328942,12867
"16369","FBgn0016119","3R",23355220,23356064,844
"16370","FBgn0036255","3L",12136967,12137559,592
"16371","FBgn0036188","3L",11648756,11650499,1743
"16372","FBgn0027088","3L",15095142,15097686,2544
"16373","FBgn0035407","3L",3163786,3166250,2464
"16374","FBgn0263659","2R",16829095,16839494,10399
"16375","FBgn0029663","X",3476463,3482322,5859
"16376","FBgn0082957","3R",28602556,28602695,139
"16377","FBgn0261834","X",15976868,15977660,792
"16378","FBgn0263493","3L",9386112,9386463,351
"16379","FBgn0266011","2R",23383483,23384177,694
"16380","FBgn0036266","3L",12204123,12206022,1899
"16381","FBgn0005596","3R",29118330,29122879,4549
"16382","FBgn0004797","2L",16816660,16826964,10304
"16383","FBgn0053985","3L",15525891,15526812,921
"16384","FBgn0030237","X",10842205,10842995,790
"16385","FBgn0004619","3L",6624032,6635059,11027
"16386","FBgn0041713","2L",15035394,15037841,2447
"16387","FBgn0050239","2R",16219638,16219709,71
"16388","FBgn0265665","2R",19504775,19505462,687
"16389","FBgn0030983","X",19123755,19124388,633
"16390","FBgn0033229","2R",7832171,7833841,1670
"16391","FBgn0052022","3L",8720280,8721272,992
"16392","FBgn0262529","3L",15648571,15649125,554
"16393","FBgn0013687","mitochondrion_genome",14917,19524,4607
"16394","FBgn0267531","3L",8891556,8893800,2244
"16395","FBgn0031000","X",19215515,19216660,1145
"16396","FBgn0021967","2L",3466157,3467334,1177
"16397","FBgn0043458","3L",1490951,1496643,5692
"16398","FBgn0022023","2L",5051193,5053094,1901
"16399","FBgn0266993","3L",12337352,12337699,347
"16400","FBgn0265634","4",194732,195900,1168
"16401","FBgn0050293","2R",21063178,21064986,1808
"16402","FBgn0261697","2L",6127872,6130651,2779
"16403","FBgn0259986","3L",4153618,4160932,7314
"16404","FBgn0031710","2L",5521281,5523898,2617
"16405","FBgn0051333","3R",20891658,20891729,71
"16406","FBgn0052374","3L",7540269,7541168,899
"16407","FBgn0266151","2L",14732561,14733008,447
"16408","FBgn0040475","3L",9710422,9713827,3405
"16409","FBgn0284234","3R",18680604,18685290,4686
"16410","FBgn0262898","3L",18081121,18085310,4189
"16411","FBgn0036994","3L",20450532,20452864,2332
"16412","FBgn0000541","3L",233926,246912,12986
"16413","FBgn0050254","2R",11652367,11652439,72
"16414","FBgn0041588","3R",29149896,29151794,1898
"16415","FBgn0033603","2R",11266915,11272575,5660
"16416","FBgn0033050","2R",6017739,6020695,2956
"16417","FBgn0035192","3L",1235726,1242025,6299
"16418","FBgn0085236","2R",22329195,22329720,525
"16419","FBgn0051840","2L",14023722,14024099,377
"16420","FBgn0262717","3R",10686943,10696270,9327
"16421","FBgn0033874","2R",13836419,13839363,2944
"16422","FBgn0028514","2L",15923395,15926287,2892
"16423","FBgn0034011","2R",15327143,15328271,1128
"16424","FBgn0265550","3R",20485136,20485528,392
"16425","FBgn0041626","X",20141819,20143188,1369
"16426","FBgn0267056","X",21400011,21400837,826
"16427","FBgn0265366","2L",20847844,20848143,299
"16428","FBgn0267938","3R",12873131,12874445,1314
"16429","FBgn0263326","3L",19052902,19053389,487
"16430","FBgn0037878","3R",11220268,11221639,1371
"16431","FBgn0033471","2R",9971143,9972780,1637
"16432","FBgn0036655","3L",16724861,16725375,514
"16433","FBgn0003979","2L",5959596,5960340,744
"16434","FBgn0260222","2R",21691295,21692764,1469
"16435","FBgn0040687","3R",4335098,4335506,408
"16436","FBgn0036893","3L",19612455,19613489,1034
"16437","FBgn0033685","2R",12143191,12144552,1361
"16438","FBgn0267623","3L",22756796,22757328,532
"16439","FBgn0035109","3L",206134,207527,1393
"16440","FBgn0085384","3R",23803859,23859167,55308
"16441","FBgn0053180","X",15927185,15933867,6682
"16442","FBgn0038595","3R",18278181,18279522,1341
"16443","FBgn0042701","2L",22226152,22226771,619
"16444","FBgn0030053","X",8588811,8590774,1963
"16445","FBgn0000359","X",8479319,8480523,1204
"16446","FBgn0051898","2L",8400421,8401592,1171
"16447","FBgn0267516","X",23278007,23283731,5724
"16448","FBgn0036128","3L",11100675,11101698,1023
"16449","FBgn0031681","2L",5072170,5093592,21422
"16450","FBgn0029980","X",7931745,7933351,1606
"16451","FBgn0010040","3R",12374100,12374824,724
"16452","FBgn0039058","3R",23158017,23159316,1299
"16453","FBgn0038815","3R",20617883,20621269,3386
"16454","FBgn0029915","X",6851909,6867194,15285
"16455","FBgn0000244","3R",9528238,9533011,4773
"16456","FBgn0053802","2L",21418835,21419167,332
"16457","FBgn0035186","3L",1189588,1190472,884
"16458","FBgn0027553","X",7725996,7728361,2365
"16459","FBgn0044048","3L",9823349,9823897,548
"16460","FBgn0265657","2R",16738038,16738345,307
"16461","FBgn0038157","3R",13522951,13523535,584
"16462","FBgn0267433","Y",22250,137486,115236
"16463","FBgn0266022","2L",2257635,2258000,365
"16464","FBgn0033968","2R",14808419,14809931,1512
"16465","FBgn0266360","2L",7821034,7821343,309
"16466","FBgn0000382","X",2094234,2115701,21467
"16467","FBgn0020497","2L",8403573,8408853,5280
"16468","FBgn0262191","2L",16678240,16678335,95
"16469","FBgn0037849","3R",10873038,10875582,2544
"16470","FBgn0261618","3R",28318162,28336440,18278
"16471","FBgn0030272","X",11144120,11144809,689
"16472","FBgn0031331","2L",1334128,1335514,1386
"16473","FBgn0033773","2R",12751483,12752936,1453
"16474","FBgn0037443","3R",6389162,6405895,16733
"16475","FBgn0029769","X",5493014,5496052,3038
"16476","FBgn0029656","X",3314744,3316402,1658
"16477","FBgn0001075","2L",4198404,4221796,23392
"16478","FBgn0041182","2L",7693727,7701601,7874
"16479","FBgn0263839","3L",1488739,1488831,92
"16480","FBgn0259864","211000022279392",1,1356,1355
"16481","FBgn0086907","2L",16715891,16719635,3744
"16482","FBgn0004463","2R",12039041,12042623,3582
"16483","FBgn0031822","2L",6490155,6490843,688
"16484","FBgn0284417","3R",5970760,5971291,531
"16485","FBgn0051550","3R",5485543,5489489,3946
"16486","FBgn0040509","2L",12916814,12921008,4194
"16487","FBgn0031412","2L",2307948,2308872,924
"16488","FBgn0000056","2L",14615552,14618902,3350
"16489","FBgn0267295","3L",19504986,19505295,309
"16490","FBgn0031799","2L",6332881,6338671,5790
"16491","FBgn0030586","X",14842617,14844757,2140
"16492","FBgn0034793","2R",22886398,22887578,1180
"16493","FBgn0040795","3L",16327258,16327893,635
"16494","FBgn0264564","2L",11840455,11840913,458
"16495","FBgn0027363","2L",10858536,10862006,3470
"16496","FBgn0029532","X",752011,753653,1642
"16497","FBgn0050392","2R",21290914,21292181,1267
"16498","FBgn0040078","3R",10262123,10263899,1776
"16499","FBgn0003936","2L",15751557,15751682,125
"16500","FBgn0033467","2R",9959119,9959732,613
"16501","FBgn0033739","2R",12437345,12452916,15571
"16502","FBgn0036369","3L",13465552,13474787,9235
"16503","FBgn0002441","3R",27266326,27273273,6947
"16504","FBgn0262951","3L",22665300,22669528,4228
"16505","FBgn0014075","3L",18872747,18878245,5498
"16506","FBgn0263746","2L",16728035,16729681,1646
"16507","FBgn0036091","3L",10639740,10640136,396
"16508","FBgn0034770","2R",22706934,22707772,838
"16509","FBgn0041164","3L",3461317,3466303,4986
"16510","FBgn0030570","X",14496135,14497240,1105
"16511","FBgn0267771","3R",25738027,25738689,662
"16512","FBgn0003057","X",17225157,17226867,1710
"16513","FBgn0260002","3R",5625178,5625254,76
"16514","FBgn0023521","X",1940307,1941536,1229
"16515","FBgn0002562","X",12490291,12492982,2691
"16516","FBgn0022786","X",7722119,7725917,3798
"16517","FBgn0265069","2L",10680151,10680480,329
"16518","FBgn0051497","3R",16424987,16425060,73
"16519","FBgn0053155","2R",13954195,13955664,1469
"16520","FBgn0033706","2R",12257282,12258652,1370
"16521","FBgn0034183","2R",17046839,17048794,1955
"16522","FBgn0033542","2R",10725270,10727272,2002
"16523","FBgn0030035","X",8404535,8407263,2728
"16524","FBgn0033701","2R",12214010,12214395,385
"16525","FBgn0053318","2L",20923955,20924534,579
"16526","FBgn0036756","3L",17809231,17814119,4888
"16527","FBgn0051720","2L",10234585,10238317,3732
"16528","FBgn0264372","2L",4963976,4965425,1449
"16529","FBgn0031753","2L",5955312,5956466,1154
"16530","FBgn0265003","2R",6811019,6818199,7180
"16531","FBgn0265612","X",15225513,15226256,743
"16532","FBgn0267285","2L",18310879,18311356,477
"16533","FBgn0037720","3R",9591309,9625073,33764
"16534","FBgn0038008","3R",12254187,12256592,2405
"16535","FBgn0267272","X",13344881,13345271,390
"16536","FBgn0052204","3L",18922419,18946038,23619
"16537","FBgn0038052","3R",12447653,12449046,1393
"16538","FBgn0003511","3R",30039719,30043071,3352
"16539","FBgn0052313","3L",1544828,1545743,915
"16540","FBgn0266991","3L",11592451,11592783,332
"16541","FBgn0087041","2L",16342430,16352628,10198
"16542","FBgn0029730","X",4875670,4877263,1593
"16543","FBgn0036594","3L",16284680,16285396,716
"16544","FBgn0035770","3L",7357275,7360263,2988
"16545","FBgn0001404","X",2588503,2599111,10608
"16546","FBgn0263443","2R",24881130,24881817,687
"16547","FBgn0265756","3L",17334006,17334499,493
"16548","FBgn0026090","X",1857889,1858971,1082
"16549","FBgn0050355","2R",8679146,8679953,807
"16550","FBgn0265145","2R",19656295,19657840,1545
"16551","FBgn0264915","3R",20911640,20912869,1229
"16552","FBgn0265526","2R",16964295,16964894,599
"16553","FBgn0034127","2R",16433852,16435954,2102
"16554","FBgn0039527","3R",27586474,27596130,9656
"16555","FBgn0035313","3L",2185930,2187676,1746
"16556","FBgn0263566","2R",7711417,7711476,59
"16557","FBgn0266939","3L",18597995,18598429,434
"16558","FBgn0266808","2R",17800685,17801707,1022
"16559","FBgn0262870","3L",4629604,4687317,57713
"16560","FBgn0263772","X",4075743,4092237,16494
"16561","FBgn0032005","2L",8218071,8220741,2670
"16562","FBgn0259167","3L",5803033,5805749,2716
"16563","FBgn0010388","2R",14745961,14746714,753
"16564","FBgn0034554","2R",20863781,20867076,3295
"16565","FBgn0022153","2L",4394196,4400487,6291
"16566","FBgn0030386","X",12408861,12409825,964
"16567","FBgn0039876","3R",31775049,31776652,1603
"16568","FBgn0039140","3R",24034362,24038847,4485
"16569","FBgn0029720","X",4658158,4666700,8542
"16570","FBgn0041235","2R",23102477,23103733,1256
"16571","FBgn0026262","4",459887,466828,6941
"16572","FBgn0033571","2R",10898031,10899060,1029
"16573","FBgn0032360","2L",11342301,11343318,1017
"16574","FBgn0015040","2R",24631063,24632923,1860
"16575","FBgn0033945","2R",14604549,14605297,748
"16576","FBgn0020369","X",21316052,21317663,1611
"16577","FBgn0266795","2L",8082859,8083107,248
"16578","FBgn0033402","2R",9302823,9308722,5899
"16579","FBgn0003450","3R",13040165,13042770,2605
"16580","FBgn0003656","X",7956820,7968236,11416
"16581","FBgn0032195","2L",10222657,10224447,1790
"16582","FBgn0005636","2R",24275734,24291084,15350
"16583","FBgn0052626","X",13830741,13845866,15125
"16584","FBgn0002735","3R",25999851,26000761,910
"16585","FBgn0262895","3L",17033119,17033676,557
"16586","FBgn0286042","3R",25246874,25247422,548
"16587","FBgn0001138","3R",8147368,8181444,34076
"16588","FBgn0264707","3L",277437,305292,27855
"16589","FBgn0034491","2R",20257650,20261726,4076
"16590","FBgn0042710","3R",26450671,26452327,1656
"16591","FBgn0029657","X",3387944,3448943,60999
"16592","FBgn0004390","3L",9839093,9855285,16192
"16593","FBgn0036782","3L",18201494,18203637,2143
"16594","FBgn0051730","2L",13259064,13259743,679
"16595","FBgn0266841","2L",14496997,14498116,1119
"16596","FBgn0034480","2R",20003620,20005003,1383
"16597","FBgn0040091","2R",22641786,22643917,2131
"16598","FBgn0032189","2L",10199401,10200974,1573
"16599","FBgn0263113","2R",17539322,17544353,5031
"16600","FBgn0031493","2L",3026252,3029168,2916
"16601","FBgn0054038","2R",25167659,25169855,2196
"16602","FBgn0037341","3R",5564865,5567435,2570
"16603","FBgn0040283","3R",24058287,24062815,4528
"16604","FBgn0038390","3R",15965446,15968138,2692
"16605","FBgn0260932","2R",11886067,11887603,1536
"16606","FBgn0034247","2R",17582007,17584012,2005
"16607","FBgn0002775","3L",7123213,7125533,2320
"16608","FBgn0035850","3L",8186857,8191118,4261
"16609","FBgn0265268","3L",18603425,18605415,1990
"16610","FBgn0029535","X",844823,845297,474
"16611","FBgn0033158","2R",7311395,7313495,2100
"16612","FBgn0037329","3R",5467778,5469566,1788
"16613","FBgn0030964","X",18832682,18842901,10219
"16614","FBgn0264006","3L",13867414,13903236,35822
"16615","FBgn0037770","3R",9982816,9986060,3244
"16616","FBgn0039135","3R",23985213,23986569,1356
"16617","FBgn0267743","2L",7724576,7724976,400
"16618","FBgn0053919","2R",6623832,6624577,745
"16619","FBgn0086053","3R",9354268,9354342,74
"16620","FBgn0050340","2R",9599909,9601252,1343
"16621","FBgn0035497","3L",4094343,4103256,8913
"16622","FBgn0028848","2L",13708215,13710583,2368
"16623","FBgn0034413","2R",19035492,19036387,895
"16624","FBgn0032126","2L",9544171,9544875,704
"16625","FBgn0034181","2R",17016226,17019522,3296
"16626","FBgn0033616","2R",11307879,11309829,1950
"16627","FBgn0267122","3R",26756978,26757912,934
"16628","FBgn0022709","3L",12200322,12204082,3760
"16629","FBgn0031836","2L",6611011,6617117,6106
"16630","FBgn0266899","2L",20489308,20490282,974
"16631","FBgn0037502","3R",7420765,7423057,2292
"16632","FBgn0250816","3L",23554593,23689640,135047
"16633","FBgn0000077","X",9245915,9247336,1421
"16634","FBgn0264002","3L",2282883,2300944,18061
"16635","FBgn0034152","2R",16747834,16748590,756
"16636","FBgn0032230","2L",10364471,10366410,1939
"16637","FBgn0052362","3L",8065994,8066076,82
"16638","FBgn0040508","2L",12912530,12916774,4244
"16639","FBgn0054001","3L",10631079,10634612,3533
"16640","FBgn0034861","2R",23421521,23433354,11833
"16641","FBgn0261842","3R",21365609,21368279,2670
"16642","FBgn0267161","X",10054235,10055109,874
"16643","FBgn0029885","X",6660552,6661462,910
"16644","FBgn0284421","3L",20432468,20435156,2688
"16645","FBgn0038979","3R",22492953,22493746,793
"16646","FBgn0032845","2L",20089636,20091348,1712
"16647","FBgn0052537","X",19273349,19276539,3190
"16648","FBgn0030177","X",10083154,10085050,1896
"16649","FBgn0030037","X",8433923,8437820,3897
"16650","FBgn0003980","2L",5957004,5957639,635
"16651","FBgn0267589","2R",15540887,15541300,413
"16652","FBgn0260655","3L",19613427,19618521,5094
"16653","FBgn0267953","3R",26637805,26639515,1710
"16654","FBgn0265453","X",15547407,15547740,333
"16655","FBgn0035981","3L",9367377,9370300,2923
"16656","FBgn0038921","3R",22014697,22016212,1515
"16657","FBgn0026575","X",16422831,16438454,15623
"16658","FBgn0004895","3L",4018878,4021279,2401
"16659","FBgn0037340","3R",5563977,5564815,838
"16660","FBgn0032595","2L",16730458,16731039,581
"16661","FBgn0263231","3R",8654975,8660761,5786
"16662","FBgn0051253","3R",27959346,27960573,1227
"16663","FBgn0037330","3R",5469463,5470636,1173
"16664","FBgn0263516","X",16080923,16081056,133
"16665","FBgn0052379","3L",7396355,7398208,1853
"16666","FBgn0033446","2R",9810974,9820053,9079
"16667","FBgn0036368","3L",13450770,13465539,14769
"16668","FBgn0044050","3L",9801298,9802120,822
"16669","FBgn0004649","X",14193214,14199958,6744
"16670","FBgn0085465","3R",28282580,28283548,968
"16671","FBgn0051360","3R",17685097,17685807,710
"16672","FBgn0263083","2R",19030009,19030250,241
"16673","FBgn0004889","3R",10126129,10139772,13643
"16674","FBgn0026196","2L",6916753,6918743,1990
"16675","FBgn0038861","3R",21132734,21133881,1147
"16676","FBgn0266807","2R",22666125,22666605,480
"16677","FBgn0029754","X",5315130,5317295,2165
"16678","FBgn0053439","2R",19734396,19734530,134
"16679","FBgn0029824","X",5917097,5941852,24755
"16680","FBgn0034835","2R",23232626,23233927,1301
"16681","FBgn0037191","3L",22788439,22789247,808
"16682","FBgn0039887","3R",32038330,32039753,1423
"16683","FBgn0024234","2R",23851562,23853247,1685
"16684","FBgn0265874","X",15289362,15289705,343
"16685","FBgn0266594","3L",11050408,11050908,500
"16686","FBgn0033756","2R",12625808,12628619,2811
"16687","FBgn0053861","2L",21531302,21532324,1022
"16688","FBgn0017566","X",8248651,8251687,3036
"16689","FBgn0284246","2R",6074471,6076367,1896
"16690","FBgn0039373","3R",25811096,25811775,679
"16691","FBgn0033413","2R",9424087,9426107,2020
"16692","FBgn0035761","3L",7321099,7323411,2312
"16693","FBgn0265527","2R",16969395,16971695,2300
"16694","FBgn0028910","2L",14599674,14599745,71
"16695","FBgn0003984","3L",5813338,5845664,32326
"16696","FBgn0031264","2L",560568,563819,3251
"16697","FBgn0085399","2R",21987068,22039559,52491
"16698","FBgn0021742","X",10964032,10967134,3102
"16699","FBgn0037551","3R",8126605,8129835,3230
"16700","FBgn0037203","3L",22881045,22893821,12776
"16701","FBgn0264352","2L",5904958,5906250,1292
"16702","FBgn0034457","2R",19509768,19511471,1703
"16703","FBgn0035471","3L",3903492,3905035,1543
"16704","FBgn0083943","3R",10224909,10225587,678
"16705","FBgn0265104","2R",13329352,13344808,15456
"16706","FBgn0051568","3R",17645307,17645379,72
"16707","FBgn0000212","3L",15970082,15982869,12787
"16708","FBgn0265344","2R",10053095,10053393,298
"16709","FBgn0039530","3R",27607879,27634932,27053
"16710","FBgn0259853","Y",869892,871230,1338
"16711","FBgn0028371","2R",22717321,22740459,23138
"16712","FBgn0031305","2L",1132332,1134098,1766
"16713","FBgn0038277","3R",14900432,14901563,1131
"16714","FBgn0265976","2R",22236295,22236795,500
"16715","FBgn0031050","X",19644531,19646176,1645
"16716","FBgn0037754","3R",9784653,9789323,4670
"16717","FBgn0267455","3L",130730,131571,841
"16718","FBgn0035766","3L",7335442,7339340,3898
"16719","FBgn0266871","2L",17901807,17902691,884
"16720","FBgn0263629","2R",17766393,17766460,67
"16721","FBgn0262815","2R",15375834,15376481,647
"16722","FBgn0262009","3R",23372924,23373600,676
"16723","FBgn0014163","3L",16402796,16411828,9032
"16724","FBgn0037627","3R",8771246,8772691,1445
"16725","FBgn0030883","X",17906031,17907261,1230
"16726","FBgn0040949","2L",5956489,5956819,330
"16727","FBgn0003204","X",10744502,10749097,4595
"16728","FBgn0024232","2R",16641243,16651125,9882
"16729","FBgn0266257","3R",28777212,28777850,638
"16730","FBgn0014931","3R",7913851,7916550,2699
"16731","FBgn0034488","2R",20242752,20245388,2636
"16732","FBgn0263571","X",19169131,19169248,117
"16733","FBgn0263235","2L",12111110,12112256,1146
"16734","FBgn0033453","2R",9842686,9845512,2826
"16735","FBgn0031623","2L",4700835,4701485,650
"16736","FBgn0038324","3R",15351225,15353926,2701
"16737","FBgn0261394","2R",20994900,20996118,1218
"16738","FBgn0033789","2R",13049146,13049656,510
"16739","FBgn0036450","3L",14786791,14789665,2874
"16740","FBgn0011986","3L",5342084,5342165,81
"16741","FBgn0036070","3L",10151827,10152984,1157
"16742","FBgn0030959","X",18786142,18788210,2068
"16743","FBgn0001085","3L",14274343,14368639,94296
"16744","FBgn0034664","2R",21835448,21836357,909
"16745","FBgn0051708","2L",9051631,9071164,19533
"16746","FBgn0086680","3L",6790158,6794941,4783
"16747","FBgn0053208","3R",10001554,10042895,41341
"16748","FBgn0020765","3L",6152050,6152745,695
"16749","FBgn0037486","3R",7217679,7219705,2026
"16750","FBgn0265919","X",18912352,18912752,400
"16751","FBgn0261925","2L",15864929,15865461,532
"16752","FBgn0043576","2R",8709733,8710320,587
"16753","FBgn0039811","3R",30936589,30937102,513
"16754","FBgn0264951","2L",8205367,8205648,281
"16755","FBgn0030921","X",18437490,18438233,743
"16756","FBgn0031479","2L",2877091,2878232,1141
"16757","FBgn0001269","2R",11474465,11509695,35230
"16758","FBgn0040950","2L",6151969,6153701,1732
"16759","FBgn0262608","X",4247313,4247785,472
"16760","FBgn0266217","2L",2427050,2427881,831
"16761","FBgn0039324","3R",25316461,25318111,1650
"16762","FBgn0030982","X",19082609,19083290,681
"16763","FBgn0030091","X",9142493,9147894,5401
"16764","FBgn0265654","2R",12906395,12907295,900
"16765","FBgn0260799","2R",4595288,4609492,14204
"16766","FBgn0010551","2R",18819467,18822250,2783
"16767","FBgn0016070","3L",8990317,8997989,7672
"16768","FBgn0001090","X",18794246,18797687,3441
"16769","FBgn0263483","2R",10537135,10537270,135
"16770","FBgn0046685","3R",24627066,24630075,3009
"16771","FBgn0053883","2L",21499324,21499736,412
"16772","FBgn0033483","2R",10078366,10084210,5844
"16773","FBgn0031040","X",19616196,19616825,629
"16774","FBgn0030963","X",18830591,18832123,1532
"16775","FBgn0267730","3R",26235325,26252932,17607
"16776","FBgn0263352","3L",8432322,8442381,10059
"16777","FBgn0034429","2R",19289109,19289852,743
"16778","FBgn0284256","2L",18449517,18454587,5070
"16779","FBgn0033277","2R",8254223,8256931,2708
"16780","FBgn0035548","3L",4460622,4461504,882
"16781","FBgn0034366","2R",18620466,18625044,4578
"16782","FBgn0031821","2L",6487342,6488756,1414
"16783","FBgn0036806","3L",18684259,18686319,2060
"16784","FBgn0033541","2R",10648888,10649830,942
"16785","FBgn0037003","3L",20499836,20501500,1664
"16786","FBgn0262386","2L",16698404,16698488,84
"16787","FBgn0025681","2L",2992870,2998726,5856
"16788","FBgn0052305","3L",2248635,2252729,4094
"16789","FBgn0011286","2R",8860364,8888097,27733
"16790","FBgn0267746","3R",28137647,28137965,318
"16791","FBgn0028494","2R",17703335,17719346,16011
"16792","FBgn0004435","2R",12612740,12623197,10457
"16793","FBgn0029659","X",3459016,3460240,1224
"16794","FBgn0004956","X",18305354,18309291,3937
"16795","FBgn0265454","X",15547733,15548203,470
"16796","FBgn0001967","2L",14019357,14020208,851
"16797","FBgn0022774","3L",19647280,19649851,2571
"16798","FBgn0261805","2L",11853430,11853925,495
"16799","FBgn0082962","3R",5596360,5596509,149
"16800","FBgn0003460","2R",7419350,7434872,15522
"16801","FBgn0032886","2L",20797715,20814331,16616
"16802","FBgn0265849","2R",20292545,20292995,450
"16803","FBgn0034475","2R",19815554,19816204,650
"16804","FBgn0085340","X",20383584,20384062,478
"16805","FBgn0019960","3R",22019505,22023335,3830
"16806","FBgn0037435","3R",6346111,6347519,1408
"16807","FBgn0025457","3R",29674007,29675421,1414
"16808","FBgn0262975","3R",23185580,23226711,41131
"16809","FBgn0015818","X",6255822,6257596,1774
"16810","FBgn0086022","2R",18899429,18899537,108
"16811","FBgn0050417","2R",23326739,23327581,842
"16812","FBgn0030669","X",15700172,15701259,1087
"16813","FBgn0052450","3L",22329778,22330657,879
"16814","FBgn0053890","2L",21482504,21483098,594
"16815","FBgn0033880","2R",13854578,13855778,1200
"16816","FBgn0266159","2L",15610171,15610746,575
"16817","FBgn0050005","2R",9607292,9608350,1058
"16818","FBgn0027505","2L",12058304,12063184,4880
"16819","FBgn0036348","3L",13349165,13354940,5775
"16820","FBgn0262971","3R",19920597,19921310,713
"16821","FBgn0038377","3R",15860196,15861478,1282
"16822","FBgn0038065","3R",12628031,12630495,2464
"16823","FBgn0085220","2R",16951837,16952581,744
"16824","FBgn0085257","2R",11651857,11652339,482
"16825","FBgn0028879","2L",15074776,15096915,22139
"16826","FBgn0029746","X",5085759,5254864,169105
"16827","FBgn0265732","3L",10246790,10247771,981
"16828","FBgn0031886","2L",7064431,7065837,1406
"16829","FBgn0034223","2R",17465879,17469177,3298
"16830","FBgn0003274","2R",16586129,16586732,603
"16831","FBgn0033382","2R",9132480,9135453,2973
"16832","FBgn0037397","3R",6027767,6028621,854
"16833","FBgn0034996","2R",24255327,24257414,2087
"16834","FBgn0032076","2L",8939725,8942105,2380
"16835","FBgn0262393","3L",19797961,19798059,98
"16836","FBgn0051407","3R",10022845,10025150,2305
"16837","FBgn0037019","3L",20776766,20778264,1498
"16838","FBgn0025582","3L",16785242,16786941,1699
"16839","FBgn0032882","2L",20752476,20754655,2179
"16840","FBgn0052820","X",21611797,21615239,3442
"16841","FBgn0039440","3R",26629918,26630825,907
"16842","FBgn0067629","3R",14886456,14889146,2690
"16843","FBgn0004404","X",7934898,7935792,894
"16844","FBgn0032431","2L",12429827,12430892,1065
"16845","FBgn0036751","3L",17748833,17750588,1755
"16846","FBgn0052971","2L",14274821,14278002,3181
"16847","FBgn0052675","X",10760048,10764413,4365
"16848","FBgn0039465","3R",26961064,26964817,3753
"16849","FBgn0050275","2R",22707794,22712724,4930
"16850","FBgn0265813","2L",15807181,15810319,3138
"16851","FBgn0040375","X",2583745,2585699,1954
"16852","FBgn0002531","2R",8430115,8431243,1128
"16853","FBgn0035842","3L",8131429,8137498,6069
"16854","FBgn0032218","2L",10317497,10323102,5605
"16855","FBgn0010591","2R",17088441,17091958,3517
"16856","FBgn0050072","2R",14371186,14373006,1820
"16857","FBgn0263220","X",10233347,10263485,30138
"16858","FBgn0262266","X",280172,280269,97
"16859","FBgn0003459","3L",14402930,14409939,7009
"16860","FBgn0030769","X",16668818,16676753,7935
"16861","FBgn0086067","3L",830437,830511,74
"16862","FBgn0264500","X",10210181,10210636,455
"16863","FBgn0039628","3R",29051056,29052267,1211
"16864","FBgn0052475","3L",22428,26308,3880
"16865","FBgn0013772","2R",14887171,14889010,1839
"16866","FBgn0035907","3L",8523742,8524866,1124
"16867","FBgn0011474","3R",14316038,14320494,4456
"16868","FBgn0263406","3R",20678183,20679079,896
"16869","FBgn0050377","2R",7890025,7915032,25007
"16870","FBgn0266264","X",6089878,6090648,770
"16871","FBgn0035282","3L",1850915,1855591,4676
"16872","FBgn0039449","3R",26715165,26717389,2224
"16873","FBgn0032231","2L",10366692,10367946,1254
"16874","FBgn0266810","2R",17121095,17124636,3541
"16875","FBgn0263780","2R",1866080,2262115,396035
"16876","FBgn0034972","2R",24078234,24080527,2293
"16877","FBgn0034461","2R",19642947,19643698,751
"16878","FBgn0038319","3R",15330738,15331588,850
"16879","FBgn0051832","2L",15030928,15031750,822
"16880","FBgn0265669","2L",18112830,18113179,349
"16881","FBgn0033327","2R",8713446,8715094,1648
"16882","FBgn0010423","2R",11273845,11275286,1441
"16883","FBgn0024980","X",2739089,2744076,4987
"16884","FBgn0039621","3R",29024971,29026159,1188
"16885","FBgn0062978","2L",16704286,16716195,11909
"16886","FBgn0030034","X",8398940,8404516,5576
"16887","FBgn0028648","3L",7243080,7243933,853
"16888","FBgn0263198","2L",19045355,19048817,3462
"16889","FBgn0038487","3R",17141208,17142404,1196
"16890","FBgn0036574","3L",16132028,16136691,4663
"16891","FBgn0035270","3L",1771809,1775147,3338
"16892","FBgn0263652","3R",26018027,26019309,1282
"16893","FBgn0020640","3L",6137583,6138118,535
"16894","FBgn0002552","2R",8914524,8918234,3710
"16895","FBgn0001215","3R",28599834,28605777,5943
"16896","FBgn0267228","X",5882480,5899989,17509
"16897","FBgn0052228","3L",20265814,20268800,2986
"16898","FBgn0037465","3R",7064186,7067136,2950
"16899","FBgn0003923","2L",19812646,19812836,190
"16900","FBgn0262894","3L",16304282,16304662,380
"16901","FBgn0031935","2L",7716974,7719487,2513
"16902","FBgn0267563","3R",6835380,6835690,310
"16903","FBgn0264886","2L",3817724,3818534,810
"16904","FBgn0029079","2R",17590964,17591881,917
"16905","FBgn0250871","X",11907409,11917260,9851
"16906","FBgn0031558","2L",3692123,3692587,464
"16907","FBgn0285948","2L",4457186,4458364,1178
"16908","FBgn0039137","3R",23988806,23992916,4110
"16909","FBgn0020377","2R",12208893,12212155,3262
"16910","FBgn0051678","2L",20659132,20675941,16809
"16911","FBgn0265811","2L",13398858,13399831,973
"16912","FBgn0032268","2L",10567255,10568012,757
"16913","FBgn0262141","2R",22665646,22666145,499
"16914","FBgn0027360","2R",21690215,21691139,924
"16915","FBgn0066084","2R",24903416,24903935,519
"16916","FBgn0010109","2R",8228971,8232330,3359
"16917","FBgn0262351","3L",18925090,18926108,1018
"16918","FBgn0261614","2R",23101232,23101777,545
"16919","FBgn0264706","3R",21216820,21217242,422
"16920","FBgn0030554","X",14237988,14240152,2164
"16921","FBgn0034322","2R",18294759,18295658,899
"16922","FBgn0259713","2L",9930580,9931131,551
"16923","FBgn0038080","3R",12705094,12705818,724
"16924","FBgn0033702","2R",12224461,12229310,4849
"16925","FBgn0052672","X",10764878,10768338,3460
"16926","FBgn0030704","X",15890589,15891547,958
"16927","FBgn0031449","2L",2725674,2739830,14156
"16928","FBgn0032981","2L",22175415,22183991,8576
"16929","FBgn0266961","3L",6939049,6939702,653
"16930","FBgn0031774","2L",6065997,6067635,1638
"16931","FBgn0037137","3L",21832774,21836685,3911
"16932","FBgn0036340","3L",13036821,13040976,4155
"16933","FBgn0039312","3R",25278427,25279846,1419
"16934","FBgn0031930","2L",7691109,7692683,1574
"16935","FBgn0053870","2L",21532461,21533055,594
"16936","FBgn0036605","3L",16318954,16319526,572
"16937","FBgn0264713","X",17857077,17858084,1007
"16938","FBgn0261846","3R",13528597,13529356,759
"16939","FBgn0265512","2R",10155916,10158931,3015
"16940","FBgn0029853","X",6261169,6262119,950
"16941","FBgn0040296","3L",14974848,14976040,1192
"16942","FBgn0002719","3R",12713103,12722442,9339
"16943","FBgn0027567","3L",9864639,9870674,6035
"16944","FBgn0034784","2R",22840739,22842977,2238
"16945","FBgn0267626","3L",22350701,22351500,799
"16946","FBgn0034394","2R",18808356,18815019,6663
"16947","FBgn0033958","2R",14739359,14745335,5976
"16948","FBgn0053846","2L",21506684,21507706,1022
"16949","FBgn0267541","3L",11666319,11667079,760
"16950","FBgn0263625","3R",25794848,25795186,338
"16951","FBgn0259185","2R",24515685,24517458,1773
"16952","FBgn0261802","2L",22131221,22166221,35000
"16953","FBgn0033289","2R",8396397,8411767,15370
"16954","FBgn0050049","2R",12355671,12359087,3416
"16955","FBgn0034120","2R",16347614,16348527,913
"16956","FBgn0031323","2L",1198465,1199266,801
"16957","FBgn0040291","3L",357981,358486,505
"16958","FBgn0033817","2R",13239729,13241013,1284
"16959","FBgn0044826","3R",16445007,16453821,8814
"16960","FBgn0035040","2R",24610801,24615158,4357
"16961","FBgn0039728","3R",29983426,29990785,7359
"16962","FBgn0015589","3R",28832301,28844748,12447
"16963","FBgn0027532","3L",22067270,22071848,4578
"16964","FBgn0027338","3R",9574484,9577733,3249
"16965","FBgn0063375","2R",17701447,17701523,76
"16966","FBgn0051861","2L",12161767,12162605,838
"16967","FBgn0031631","2L",4815613,4818245,2632
"16968","FBgn0036292","3L",12502467,12503894,1427
"16969","FBgn0261383","X",5738663,5747254,8591
"16970","FBgn0265993","2L",18732464,18733323,859
"16971","FBgn0030759","X",16587873,16588930,1057
"16972","FBgn0039131","3R",23943628,23948424,4796
"16973","FBgn0036704","3L",17252377,17253937,1560
"16974","FBgn0030170","X",10010481,10014279,3798
"16975","FBgn0005613","2R",14201390,14212413,11023
"16976","FBgn0086021","2R",8165950,8166048,98
"16977","FBgn0263490","3R",24585653,24623899,38246
"16978","FBgn0035245","3L",1623179,1629301,6122
"16979","FBgn0030151","X",9778742,9782094,3352
"16980","FBgn0262537","3R",22768121,22768733,612
"16981","FBgn0034031","2R",15555446,15562436,6990
"16982","FBgn0032053","2L",8516753,8517380,627
"16983","FBgn0028703","2L",6677835,6684364,6529
"16984","FBgn0046875","3R",6111671,6112302,631
"16985","FBgn0264518","3L",3884481,3884801,320
"16986","FBgn0037515","3R",7759786,7763947,4161
"16987","FBgn0034715","2R",22221180,22223499,2319
"16988","FBgn0020909","X",13757179,13758598,1419
"16989","FBgn0031802","2L",6352324,6354331,2007
"16990","FBgn0027497","3R",5742510,5747138,4628
"16991","FBgn0039622","3R",29026439,29027174,735
"16992","FBgn0033527","2R",10468616,10469643,1027
"16993","FBgn0267740","2L",8934796,8935720,924
"16994","FBgn0032480","2L",13192201,13197281,5080
"16995","FBgn0050430","2R",25129432,25129985,553
"16996","FBgn0035452","3L",3612192,3615244,3052
"16997","FBgn0039564","3R",27954917,27957326,2409
"16998","FBgn0038343","3R",15484730,15485396,666
"16999","FBgn0032304","2L",10820705,10821967,1262
"17000","FBgn0037018","3L",20770143,20771507,1364
"17001","FBgn0264549","2L",3476343,3477648,1305
"17002","FBgn0036150","3L",11232972,11236218,3246
"17003","FBgn0040985","2L",16887109,16887966,857
"17004","FBgn0267241","3L",12490294,12491196,902
"17005","FBgn0032590","2L",16607370,16610037,2667
"17006","FBgn0026479","2L",2581281,2585430,4149
"17007","FBgn0036165","3L",11487550,11499055,11505
"17008","FBgn0085582","2R",1070657,1071319,662
"17009","FBgn0011893","2R",6947738,6947810,72
"17010","FBgn0027079","2R",13198850,13202709,3859
"17011","FBgn0003401","2R",23841461,23843286,1825
"17012","FBgn0015621","2L",819964,821209,1245
"17013","FBgn0039452","3R",26728727,26729341,614
"17014","FBgn0033063","2R",6137303,6138411,1108
"17015","FBgn0259707","2R",24607673,24608788,1115
"17016","FBgn0050026","2R",11408576,11409449,873
"17017","FBgn0265548","2L",17948147,17951740,3593
"17018","FBgn0005590","2L",19699379,19700968,1589
"17019","FBgn0278597","3R",16951907,16953770,1863
"17020","FBgn0267972","2L",1973957,1975413,1456
"17021","FBgn0264882","2L",1839494,1839896,402
"17022","FBgn0264958","2R",5967397,5967746,349
"17023","FBgn0030589","X",14854328,14856361,2033
"17024","FBgn0266682","3L",13028551,13029028,477
"17025","FBgn0026403","2R",10313891,10322104,8213
"17026","FBgn0266926","2R",11704755,11706222,1467
"17027","FBgn0037816","3R",10414218,10416046,1828
"17028","FBgn0031110","X",20416733,20417812,1079
"17029","FBgn0262081","3R",11633278,11650706,17428
"17030","FBgn0266708","2R",15687388,15688985,1597
"17031","FBgn0033593","2R",11241745,11242194,449
"17032","FBgn0261506","3L",19953794,19954526,732
"17033","FBgn0053535","2R",19564873,19564944,71
"17034","FBgn0039796","3R",30693572,30695498,1926
"17035","FBgn0000422","2L",19116483,19120306,3823
"17036","FBgn0265434","2R",24990570,25011965,21395
"17037","FBgn0004861","X",2126210,2138371,12161
"17038","FBgn0037016","3L",20730591,20744508,13917
"17039","FBgn0263557","2R",10012093,10012199,106
"17040","FBgn0041717","2L",8389724,8389820,96
"17041","FBgn0030665","X",15667885,15671029,3144
"17042","FBgn0002561","X",409721,410817,1096
"17043","FBgn0037293","3R",5128087,5129939,1852
"17044","FBgn0011887","2R",6165984,6166056,72
"17045","FBgn0031749","2L",5908927,5910289,1362
"17046","FBgn0064912","3R",21873739,21874922,1183
"17047","FBgn0011205","3L",20384429,20391913,7484
"17048","FBgn0034481","2R",20146118,20146824,706
"17049","FBgn0032369","2L",11644619,11648839,4220
"17050","FBgn0041241","2R",11361900,11363405,1505
"17051","FBgn0053241","X",14054357,14055080,723
"17052","FBgn0265470","3L",11405535,11406094,559
"17053","FBgn0265364","2R",11917875,11919096,1221
"17054","FBgn0030174","X",10055629,10070868,15239
"17055","FBgn0031535","2L",3452466,3453755,1289
"17056","FBgn0010482","2R",6721101,6740672,19571
"17057","FBgn0037700","3R",9504656,9505865,1209
"17058","FBgn0033215","2R",7712578,7714182,1604
"17059","FBgn0030680","X",15741343,15746231,4888
"17060","FBgn0039024","3R",22763960,22766172,2212
"17061","FBgn0041627","2L",15768630,15771159,2529
"17062","FBgn0038798","3R",20504788,20506186,1398
"17063","FBgn0260985","3L",4134860,4136038,1178
"17064","FBgn0051041","3R",29590070,29590906,836
"17065","FBgn0261583","3R",31707870,31708340,470
"17066","FBgn0085284","3L",18870224,18870897,673
"17067","FBgn0027348","2L",14013004,14019328,6324
"17068","FBgn0034513","2R",20536578,20538264,1686
"17069","FBgn0052106","3L",12773951,12778716,4765
"17070","FBgn0266150","2L",14576473,14577097,624
"17071","FBgn0026396","2L",2054589,2057967,3378
"17072","FBgn0039471","3R",27005899,27007055,1156
"17073","FBgn0030049","X",8560322,8570159,9837
"17074","FBgn0250846","3R",6605997,6608914,2917
"17075","FBgn0051576","3R",17668187,17668259,72
"17076","FBgn0260945","3L",12784429,12805116,20687
"17077","FBgn0038200","3R",14097293,14098080,787
"17078","FBgn0265814","2L",1618637,1626021,7384
"17079","FBgn0036936","3L",20106094,20107557,1463
"17080","FBgn0267924","2L",7404747,7404973,226
"17081","FBgn0027521","X",16303870,16307377,3507
"17082","FBgn0041240","2R",20685605,20686910,1305
"17083","FBgn0034707","2R",22183138,22185892,2754
"17084","FBgn0261702","3R",7143487,7144295,808
"17085","FBgn0031373","2L",1882008,1883185,1177
"17086","FBgn0032613","2L",16835136,16837258,2122
"17087","FBgn0034877","2R",23548239,23548982,743
"17088","FBgn0052649","X",12898768,12901114,2346
"17089","FBgn0022069","2L",13363308,13366189,2881
"17090","FBgn0040338","X",1011101,1011643,542
"17091","FBgn0267721","3R",22337064,22337669,605
"17092","FBgn0267253","X",9502826,9550838,48012
"17093","FBgn0028862","2L",15248879,15254715,5836
"17094","FBgn0001311","3R",5378093,5392866,14773
"17095","FBgn0032597","2L",16732550,16733624,1074
"17096","FBgn0265877","2R",20780295,20780695,400
"17097","FBgn0035265","3L",1735853,1738106,2253
"17098","FBgn0026061","3L",16563448,16573334,9886
"17099","FBgn0025790","2R",23859067,23862593,3526
"17100","FBgn0266102","X",644226,644616,390
"17101","FBgn0052641","X",13184478,13184996,518
"17102","FBgn0014464","X",8470888,8473087,2199
"17103","FBgn0032520","2L",13396392,13398664,2272
"17104","FBgn0067864","3L",1798803,1802184,3381
"17105","FBgn0032428","2L",12424904,12426440,1536
"17106","FBgn0030612","X",15086125,15088629,2504
"17107","FBgn0037757","3R",9793295,9797754,4459
"17108","FBgn0030509","X",13676894,13677882,988
"17109","FBgn0267450","3R",20325529,20326260,731
"17110","FBgn0042127","2L",11993989,11995432,1443
"17111","FBgn0263040","3R",15635468,15636489,1021
"17112","FBgn0263006","2R",23925077,23935884,10807
"17113","FBgn0004657","X",8061645,8070237,8592
"17114","FBgn0052806","X",1789566,1790418,852
"17115","FBgn0051068","3R",27233698,27236360,2662
"17116","FBgn0053405","2R",19746943,19747076,133
"17117","FBgn0039031","3R",22977270,22978164,894
"17118","FBgn0033615","2R",11301916,11305607,3691
"17119","FBgn0054002","3L",17858474,17860482,2008
"17120","FBgn0052230","3L",23339326,23345936,6610
"17121","FBgn0036009","3L",9529067,9531386,2319
"17122","FBgn0265891","3L",20626601,20627624,1023
"17123","FBgn0263587","3L",12541710,12542953,1243
"17124","FBgn0052284","3L",3186664,3187245,581
"17125","FBgn0050209","2R",21182678,21182749,71
"17126","FBgn0267230","3L",4107143,4107470,327
"17127","FBgn0034520","2R",20556877,20559953,3076
"17128","FBgn0031267","2L",573033,574264,1231
"17129","FBgn0034744","2R",22608310,22609419,1109
"17130","FBgn0037199","3L",22867175,22868243,1068
"17131","FBgn0262787","3L",6275787,6277035,1248
"17132","FBgn0034720","2R",22333500,22373109,39609
"17133","FBgn0039810","3R",30935396,30936507,1111
"17134","FBgn0259937","2R",24174877,24186343,11466
"17135","FBgn0003089","3L",19298623,19337609,38986
"17136","FBgn0038545","3R",17795075,17796317,1242
"17137","FBgn0036286","3L",12471728,12474428,2700
"17138","FBgn0085351","X",11726390,11733895,7505
"17139","FBgn0033249","2R",8000490,8002120,1630
"17140","FBgn0000357","3L",8726791,8727613,822
"17141","FBgn0031613","2L",4577719,4578218,499
"17142","FBgn0020235","3R",29747704,29749163,1459
"17143","FBgn0033555","2R",10821676,10822399,723
"17144","FBgn0030847","X",17579861,17599314,19453
"17145","FBgn0261847","3R",17121577,17122087,510
"17146","FBgn0259227","3R",11656149,11673974,17825
"17147","FBgn0039436","3R",26622451,26623543,1092
"17148","FBgn0265153","2L",223519,224708,1189
"17149","FBgn0030058","X",8691820,8693620,1800
"17150","FBgn0000542","X",3811698,3857621,45923
"17151","FBgn0031946","2L",7781465,7782760,1295
"17152","FBgn0264848","3L",12504292,12505821,1529
"17153","FBgn0051441","3R",11236286,11237624,1338
"17154","FBgn0265160","3R",28294623,28295279,656
"17155","FBgn0053898","2L",21462332,21462926,594
"17156","FBgn0265908","2L",4347501,4347954,453
"17157","FBgn0266707","X",2675188,2676657,1469
"17158","FBgn0026702","X",5622648,5625493,2845
"17159","FBgn0031375","2L",1950239,1970362,20123
"17160","FBgn0002940","3R",19886255,19888206,1951
"17161","FBgn0036652","3L",16673964,16676264,2300
"17162","FBgn0037030","3L",20836182,20837153,971
"17163","FBgn0029880","X",6633959,6636169,2210
"17164","FBgn0262965","2R",15373240,15373750,510
"17165","FBgn0013275","3R",11954163,11956544,2381
"17166","FBgn0027785","3R",19027368,19028015,647
"17167","FBgn0034474","2R",19783484,19784043,559
"17168","FBgn0050373","2R",8164000,8164869,869
"17169","FBgn0261293","2R",16468209,16468934,725
"17170","FBgn0030655","X",15572076,15574535,2459
"17171","FBgn0038476","3R",17080244,17084781,4537
"17172","FBgn0016917","3R",20535323,20552311,16988
"17173","FBgn0026616","3R",15804248,15824118,19870
"17174","FBgn0030551","X",14224647,14225879,1232
"17175","FBgn0263870","2L",439539,440104,565
"17176","FBgn0041625","3L",6320611,6322098,1487
"17177","FBgn0038479","3R",17126088,17126938,850
"17178","FBgn0037656","3R",9015446,9016822,1376
"17179","FBgn0267525","3L",16612500,16612827,327
"17180","FBgn0259231","X",18707494,18726572,19078
"17181","FBgn0051681","2L",2285925,2286873,948
"17182","FBgn0265139","X",1452430,1454177,1747
"17183","FBgn0034368","2R",18629594,18632045,2451
"17184","FBgn0267646","3L",4749407,4749991,584
"17185","FBgn0035670","3L",6061372,6062910,1538
"17186","FBgn0030956","X",18781265,18783494,2229
"17187","FBgn0013263","3L",14747929,14761049,13120
"17188","FBgn0053159","3L",3203675,3204448,773
"17189","FBgn0028675","2L",10182557,10199117,16560
"17190","FBgn0052161","3L",16846227,16847000,773
"17191","FBgn0035370","3L",2766999,2768392,1393
"17192","FBgn0033614","2R",11302247,11302987,740
"17193","FBgn0037376","3R",5787337,5789384,2047
"17194","FBgn0034797","2R",22896174,22916719,20545
"17195","FBgn0030098","X",9191657,9192548,891
"17196","FBgn0027563","3R",14225098,14226762,1664
"17197","FBgn0023177","X",20421087,20424002,2915
"17198","FBgn0263331","2L",15989756,15989957,201
"17199","FBgn0264839","3R",20827095,20828212,1117
"17200","FBgn0017561","X",10878054,10891250,13196
"17201","FBgn0035332","3L",2360557,2362686,2129
"17202","FBgn0032168","2L",9952072,9954181,2109
"17203","FBgn0003114","2R",20262958,20263684,726
"17204","FBgn0000527","3R",21229839,21237177,7338
"17205","FBgn0053897","2L",21463913,21464325,412
"17206","FBgn0000233","X",9694186,9697558,3372
"17207","FBgn0065046","X",10348170,10348337,167
"17208","FBgn0058006","2L",22622417,22756349,133932
"17209","FBgn0037930","3R",11674221,11674923,702
"17210","FBgn0034405","2R",18855767,18858245,2478
"17211","FBgn0264739","X",17023499,17024042,543
"17212","FBgn0038535","3R",17673732,17682515,8783
"17213","FBgn0264439","2L",7423820,7425932,2112
"17214","FBgn0034288","2R",18018665,18020211,1546
"17215","FBgn0265876","2R",20766395,20767845,1450
"17216","FBgn0026315","3R",11170817,11172664,1847
"17217","FBgn0029711","X",4544617,4548794,4177
"17218","FBgn0014031","X",6528948,6530726,1778
"17219","FBgn0035043","2R",24640683,24642239,1556
"17220","FBgn0026316","2R",17788412,17789410,998
"17221","FBgn0037387","3R",5841170,5846568,5398
"17222","FBgn0031579","2L",4004984,4005670,686
"17223","FBgn0038878","3R",21274243,21276249,2006
"17224","FBgn0286027","2L",15009939,15011764,1825
"17225","FBgn0038845","3R",21005160,21006990,1830
"17226","FBgn0023169","X",1375536,1378896,3360
"17227","FBgn0035691","3L",6189745,6192049,2304
"17228","FBgn0030575","X",14679568,14681418,1850
"17229","FBgn0031563","2L",3698451,3699092,641
"17230","FBgn0037848","3R",10868708,10870555,1847
"17231","FBgn0052499","X",22583634,22632710,49076
"17232","FBgn0284254","2R",15682719,15687415,4696
"17233","FBgn0265861","2R",20525395,20525751,356
"17234","FBgn0083941","2R",23749318,23749891,573
"17235","FBgn0023536","X",487878,490725,2847
"17236","FBgn0265933","3L",11323521,11323843,322
"17237","FBgn0264437","2L",8590370,8594489,4119
"17238","FBgn0263047","3R",22381340,22382147,807
"17239","FBgn0267948","3R",8517043,8517384,341
"17240","FBgn0266788","3L",13297004,13297570,566
"17241","FBgn0250845","3R",7206652,7208431,1779
"17242","FBgn0262734","X",16448665,16454972,6307
"17243","FBgn0027610","3R",13364938,13369278,4340
"17244","FBgn0086080","3L",17566042,17566162,120
"17245","FBgn0015025","3L",15816979,15818621,1642
"17246","FBgn0039298","3R",25240180,25241668,1488
"17247","FBgn0260962","3R",13052245,13056725,4480
"17248","FBgn0029131","2R",6648654,6652842,4188
"17249","FBgn0038851","3R",21074007,21076798,2791
"17250","FBgn0037723","3R",9631641,9633673,2032
"17251","FBgn0036610","3L",16328841,16329534,693
"17252","FBgn0036488","3L",15161817,15162470,653
"17253","FBgn0034219","2R",17445185,17447483,2298
"17254","FBgn0041180","2L",19548507,19556451,7944
"17255","FBgn0042118","3L",6150058,6150857,799
"17256","FBgn0033516","2R",10406975,10407445,470
"17257","FBgn0085314","3R",19385917,19387559,1642
"17258","FBgn0265302","2R",8229296,8230796,1500
"17259","FBgn0265423","3R",7325597,7326459,862
"17260","FBgn0030717","X",15983772,15985405,1633
"17261","FBgn0030723","X",16063738,16070304,6566
"17262","FBgn0011859","2L",1938089,1938159,70
"17263","FBgn0053865","2L",21538228,21538720,492
"17264","FBgn0010014","X",5332499,5334449,1950
"17265","FBgn0011865","2L",14530546,14530616,70
"17266","FBgn0265818","2L",2507312,2507596,284
"17267","FBgn0033348","2R",8920270,8922755,2485
"17268","FBgn0266632","2R",3943429,3949757,6328
"17269","FBgn0026432","3L",11993274,11998138,4864
"17270","FBgn0039010","3R",22707786,22710762,2976
"17271","FBgn0040532","3R",8822008,8822838,830
"17272","FBgn0016641","2R",21619321,21624446,5125
"17273","FBgn0040812","3L",13842377,13843017,640
"17274","FBgn0266799","2L",904029,904347,318
"17275","FBgn0265819","2L",4228921,4229458,537
"17276","FBgn0267320","3L",17032055,17032608,553
"17277","FBgn0037275","3R",4777497,4780302,2805
"17278","FBgn0036713","3L",17344947,17349666,4719
"17279","FBgn0052195","3L",18112959,18119150,6191
"17280","FBgn0262479","2R",18862862,18863277,415
"17281","FBgn0052373","3L",7650548,7759123,108575
"17282","FBgn0266573","2R",11404699,11404770,71
"17283","FBgn0034308","2R",18160720,18164746,4026
"17284","FBgn0260469","3L",27849226,27850751,1525
"17285","FBgn0264345","2L",6074251,6074796,545
"17286","FBgn0263967","2R",7492364,7493497,1133
"17287","FBgn0267061","X",20293601,20294288,687
"17288","FBgn0267155","3R",11780641,11781108,467
"17289","FBgn0028484","3L",4108186,4114157,5971
"17290","FBgn0032109","2L",9327744,9330332,2588
"17291","FBgn0039300","3R",25245955,25247514,1559
"17292","FBgn0085417","3R",14418593,14421865,3272
"17293","FBgn0051021","3R",30602206,30604041,1835
"17294","FBgn0038345","3R",15494602,15495620,1018
"17295","FBgn0027885","2L",17474912,17477888,2976
"17296","FBgn0262825","3R",17382129,17382767,638
"17297","FBgn0284237","2R",10205454,10227957,22503
"17298","FBgn0265797","2L",11354001,11354329,328
"17299","FBgn0039633","3R",29063040,29108948,45908
"17300","FBgn0267198","3R",16209248,16209484,236
"17301","FBgn0034579","2R",21060789,21061587,798
"17302","FBgn0053289","3L",21534660,21536861,2201
"17303","FBgn0038603","3R",18303279,18314407,11128
"17304","FBgn0038546","3R",17796376,17798304,1928
"17305","FBgn0263475","X",9274714,9274862,148
"17306","FBgn0265896","3L",20652906,20654126,1220
"17307","FBgn0033353","2R",8933423,8934445,1022
"17308","FBgn0034989","2R",24197824,24202187,4363
"17309","FBgn0065100","2L",21680670,21680700,30
"17310","FBgn0037014","3L",20637199,20640910,3711
"17311","FBgn0011938","2R",6152603,6152676,73
"17312","FBgn0267705","3R",10122422,10124412,1990
"17313","FBgn0000079","2R",17118636,17120303,1667
"17314","FBgn0051125","3R",24653371,24654820,1449
"17315","FBgn0033888","2R",13971325,13972834,1509
"17316","FBgn0266521","2L",6100377,6124653,24276
"17317","FBgn0050334","2R",12440633,12441320,687
"17318","FBgn0036962","3L",20273389,20275335,1946
"17319","FBgn0030973","X",18884513,18888860,4347
"17320","FBgn0035743","3L",7128903,7129673,770
"17321","FBgn0286051","3L",6603684,6608739,5055
"17322","FBgn0025814","X",21042125,21044107,1982
"17323","FBgn0263773","2L",20079270,20085070,5800
"17324","FBgn0051030","3R",30164692,30166419,1727
"17325","FBgn0029608","X",2252332,2254197,1865
"17326","FBgn0083952","3L",19805241,19806036,795
"17327","FBgn0053419","2R",19741768,19741902,134
"17328","FBgn0267561","3R",6833363,6834247,884
"17329","FBgn0262535","3L",3714027,3714717,690
"17330","FBgn0266140","2L",13746952,13756402,9450
"17331","FBgn0034978","2R",24116792,24123263,6471
"17332","FBgn0033782","2R",12924567,12930644,6077
"17333","FBgn0046888","2L",17181938,17183654,1716
"17334","FBgn0267698","3R",6350896,6361614,10718
"17335","FBgn0038252","3R",14663450,14664822,1372
"17336","FBgn0266088","2R",24955777,24957359,1582
"17337","FBgn0083017","2R",21330583,21330715,132
"17338","FBgn0038972","3R",22464985,22465938,953
"17339","FBgn0040394","X",2078343,2080405,2062
"17340","FBgn0037634","3R",8806322,8807581,1259
"17341","FBgn0005278","2L",106903,114432,7529
"17342","FBgn0265060","2R",6980395,6981195,800
"17343","FBgn0264490","3R",21949114,22014539,65425
"17344","FBgn0037616","3R",8721371,8723051,1680
"17345","FBgn0264440","2L",16861497,16862431,934
"17346","FBgn0038432","3R",16456052,16458233,2181
"17347","FBgn0035827","3L",7936373,7937258,885
"17348","FBgn0265720","3L",8751234,8751669,435
"17349","FBgn0033177","2R",7459685,7463395,3710
"17350","FBgn0013686","mitochondrion_genome",12735,14058,1323
"17351","FBgn0267773","3R",28336889,28337629,740
"17352","FBgn0037456","3R",6596625,6598022,1397
"17353","FBgn0002732","3R",26010893,26011568,675
"17354","FBgn0035929","3L",8801540,8802164,624
"17355","FBgn0051710","2L",9702442,9705954,3512
"17356","FBgn0265587","2L",8867875,8868747,872
"17357","FBgn0038530","3R",17625268,17626086,818
"17358","FBgn0263513","3R",22774140,22774232,92
"17359","FBgn0265843","2R",20084960,20086695,1735
"17360","FBgn0029989","X",8019523,8021345,1822
"17361","FBgn0264310","3L",737052,737479,427
"17362","FBgn0267562","3R",6834343,6834967,624
"17363","FBgn0015400","2L",11581937,11626883,44946
"17364","FBgn0085256","2R",11248126,11248610,484
"17365","FBgn0266379","2R",15987446,15988086,640
"17366","FBgn0039380","3R",25856154,25872670,16516
"17367","FBgn0031660","2L",4973976,4975316,1340
"17368","FBgn0004431","3L",1194739,1195302,563
"17369","FBgn0037402","3R",6122592,6124405,1813
"17370","FBgn0036465","3L",15041631,15042570,939
"17371","FBgn0267982","3L",550297,551010,713
"17372","FBgn0051659","2L",1358925,1359790,865
"17373","FBgn0086023","2R",21325218,21325323,105
"17374","FBgn0051482","3R",6601242,6602201,959
"17375","FBgn0030801","X",16884581,16886612,2031
"17376","FBgn0040211","2L",11136393,11138565,2172
"17377","FBgn0051104","3R",25285473,25286974,1501
"17378","FBgn0083953","3R",9399570,9400053,483
"17379","FBgn0267682","3R",12634192,12634744,552
"17380","FBgn0052485","3L",3050323,3051765,1442
"17381","FBgn0035627","3L",5659700,5662247,2547
"17382","FBgn0262514","3R",14899606,14900277,671
"17383","FBgn0029834","X",6040005,6050381,10376
"17384","FBgn0039565","3R",27957356,27959245,1889
"17385","FBgn0029814","X",5818559,5840823,22264
"17386","FBgn0262101","X",17245353,17247016,1663
"17387","FBgn0263707","2R",23079380,23079715,335
"17388","FBgn0040569","3R",18372928,18373329,401
"17389","FBgn0028943","2L",13535291,13535778,487
"17390","FBgn0266778","3L",20950359,20950783,424
"17391","FBgn0034644","2R",21646177,21657935,11758
"17392","FBgn0039552","3R",27871501,27872390,889
"17393","FBgn0001139","3R",26041736,26049911,8175
"17394","FBgn0030663","X",15644222,15644991,769
"17395","FBgn0267558","3L",16882191,16882539,348
"17396","FBgn0029928","X",7012239,7013881,1642
"17397","FBgn0040319","X",8102181,8116147,13966
"17398","FBgn0037933","3R",11679743,11680976,1233
"17399","FBgn0029763","X",5421533,5427219,5686
"17400","FBgn0038261","3R",14798986,14801163,2177
"17401","FBgn0028569","2L",19010866,19011532,666
"17402","FBgn0033900","2R",14159096,14161262,2166
"17403","FBgn0039491","3R",27121618,27124688,3070
"17404","FBgn0031051","X",19646306,19652269,5963
"17405","FBgn0032311","2L",10870167,10870722,555
"17406","FBgn0028838","2L",14762765,14764065,1300
"17407","FBgn0020257","2R",22684955,22688987,4032
"17408","FBgn0052657","X",12087211,12087695,484
"17409","FBgn0035423","3L",3223341,3224650,1309
"17410","FBgn0284238","2R",10209724,10211347,1623
"17411","FBgn0027091","2R",16143147,16145906,2759
"17412","FBgn0039651","3R",29202660,29204133,1473
"17413","FBgn0058053","3L",24009931,24011363,1432
"17414","FBgn0025378","X",1708806,1710182,1376
"17415","FBgn0036568","3L",16097834,16100088,2254
"17416","FBgn0045063","2R",12487451,12507333,19882
"17417","FBgn0050429","2R",25246467,25247584,1117
"17418","FBgn0267116","3R",32012648,32013408,760
"17419","FBgn0260741","3R",11960883,11962805,1922
"17420","FBgn0030660","X",15583159,15585249,2090
"17421","FBgn0031526","2L",3357646,3358618,972
"17422","FBgn0034791","2R",22881322,22882690,1368
"17423","FBgn0024996","X",2704571,2706217,1646
"17424","FBgn0053966","3L",1234130,1235420,1290
"17425","FBgn0033481","2R",10069106,10071067,1961
"17426","FBgn0036926","3L",19991887,19996269,4382
"17427","FBgn0011845","3R",24555302,24555373,71
"17428","FBgn0050449","2R",19729282,19729353,71
"17429","FBgn0029881","X",6600062,6653015,52953
"17430","FBgn0036250","3L",12125487,12127394,1907
"17431","FBgn0266369","2L",20919094,20922876,3782
"17432","FBgn0051802","2L",18208415,18209237,822
"17433","FBgn0039664","3R",29489468,29491383,1915
"17434","FBgn0033605","2R",11278893,11279683,790
"17435","FBgn0003162","2R",21175315,21182608,7293
"17436","FBgn0039679","3R",29672456,29674223,1767
"17437","FBgn0265655","2R",14476391,14477895,1504
"17438","FBgn0050056","2R",12562060,12562655,595
"17439","FBgn0264294","2R",7533506,7535936,2430
"17440","FBgn0266801","3R",8364328,8477617,113289
"17441","FBgn0034361","2R",18614210,18615018,808
"17442","FBgn0261633","3L",16033778,16034170,392
"17443","FBgn0266366","2L",11836440,11836808,368
"17444","FBgn0035078","2R",24897902,24900734,2832
"17445","FBgn0263554","3R",22480813,22480938,125
"17446","FBgn0267009","2L",10870867,10871133,266
"17447","FBgn0267300","3L",23731614,23732177,563
"17448","FBgn0039668","3R",29499025,29503797,4772
"17449","FBgn0263117","3R",22308663,22324094,15431
"17450","FBgn0038042","3R",12421236,12422429,1193
"17451","FBgn0030385","X",12375596,12377755,2159
"17452","FBgn0037546","3R",8059284,8087049,27765
"17453","FBgn0267677","3R",12266104,12266610,506
"17454","FBgn0262335","X",11547422,11547497,75
"17455","FBgn0082989","3R",5598638,5598777,139
"17456","FBgn0010341","X",19697091,19699938,2847
"17457","FBgn0263843","2L",3769926,3770454,528
"17458","FBgn0032646","2L",17499268,17501106,1838
"17459","FBgn0264087","2L",7642005,7675078,33073
"17460","FBgn0051354","3R",12502510,12504856,2346
"17461","FBgn0053903","2L",21439589,21440001,412
"17462","FBgn0053179","2L",16973091,16993984,20893
"17463","FBgn0267944","3R",7318988,7319232,244
"17464","FBgn0030569","X",14472408,14480086,7678
"17465","FBgn0263706","X",17456169,17561180,105011
"17466","FBgn0051902","2L",7887693,7889129,1436
"17467","FBgn0038718","3R",19610225,19612437,2212
"17468","FBgn0038428","3R",16441843,16443007,1164
"17469","FBgn0053402","2R",19748043,19748177,134
"17470","FBgn0265579","2L",16981867,16982301,434
"17471","FBgn0034210","2R",17405304,17407427,2123
"17472","FBgn0267179","X",11849777,11850072,295
"17473","FBgn0266302","3R",13085478,13085976,498
"17474","FBgn0053468","2R",14606307,14606980,673
"17475","FBgn0262400","2L",17574610,17574702,92
"17476","FBgn0052496","X",17898643,17899498,855
"17477","FBgn0262106","2L",2245230,2247383,2153
"17478","FBgn0039378","3R",25832230,25842878,10648
"17479","FBgn0053737","2L",21493562,21493597,35
"17480","FBgn0266391","2R",13671649,13671964,315
"17481","FBgn0029856","X",6282037,6283575,1538
"17482","FBgn0086450","X",9196808,9201820,5012
"17483","FBgn0033115","2R",6885552,6888262,2710
"17484","FBgn0051787","2L",18284845,18285720,875
"17485","FBgn0003920","X",16254672,16254863,191
"17486","FBgn0026593","3L",2189160,2192221,3061
"17487","FBgn0265255","2L",21798043,21799112,1069
"17488","FBgn0045827","2L",16004325,16005461,1136
"17489","FBgn0037845","3R",10858202,10859813,1611
"17490","FBgn0263414","3R",13971733,13974675,2942
"17491","FBgn0052091","3L",11631392,11642902,11510
"17492","FBgn0034867","2R",23475698,23476418,720
"17493","FBgn0045500","2L",1792057,1793268,1211
"17494","FBgn0050398","2R",21717804,21718832,1028
"17495","FBgn0260003","3R",19461085,19597288,136203
"17496","FBgn0023416","2L",21632587,21647964,15377
"17497","FBgn0015391","2L",16733617,16738388,4771
"17498","FBgn0262020","3L",10814819,10816084,1265
"17499","FBgn0037156","3L",22265806,22266679,873
"17500","FBgn0263573","3L",23339228,23339337,109
"17501","FBgn0028402","3L",21031825,21033561,1736
"17502","FBgn0010357","2R",11346325,11347395,1070
"17503","FBgn0036277","3L",12336676,12337236,560
"17504","FBgn0039585","3R",28484557,28486062,1505
"17505","FBgn0051019","3R",30597004,30599296,2292
"17506","FBgn0266328","2L",21628462,21628976,514
"17507","FBgn0266913","2L",15398687,15399003,316
"17508","FBgn0037087","3L",21493083,21493907,824
"17509","FBgn0259222","3R",20740108,20756639,16531
"17510","FBgn0036587","3L",16265797,16268156,2359
"17511","FBgn0036414","3L",14186249,14189648,3399
"17512","FBgn0026268","X",11168030,11169058,1028
"17513","FBgn0027620","3R",31793981,31799799,5818
"17514","FBgn0035871","3L",8307145,8308941,1796
"17515","FBgn0053397","2R",19749878,19750012,134
"17516","FBgn0052793","X",2929796,2932626,2830
"17517","FBgn0033490","2R",10137656,10139267,1611
"17518","FBgn0038083","3R",12741958,12743680,1722
"17519","FBgn0033582","2R",11217416,11219771,2355
"17520","FBgn0031457","2L",2763416,2765665,2249
"17521","FBgn0034121","2R",16359730,16363524,3794
"17522","FBgn0014930","3R",7912017,7913290,1273
"17523","FBgn0030911","X",18292380,18293059,679
"17524","FBgn0038475","3R",17073942,17079945,6003
"17525","FBgn0063083","3L",7406323,7406617,294
"17526","FBgn0031627","2L",4734592,4794044,59452
"17527","FBgn0035238","3L",1600726,1602674,1948
"17528","FBgn0035545","3L",4446573,4448072,1499
"17529","FBgn0039386","3R",25895822,25897174,1352
"17530","FBgn0040816","3L",11847383,11847803,420
"17531","FBgn0262380","2R",19661706,19661774,68
"17532","FBgn0036439","3L",14696551,14697105,554
"17533","FBgn0031711","2L",5524139,5525809,1670
"17534","FBgn0260718","2L",21577205,21577676,471
"17535","FBgn0033787","2R",12953112,12955712,2600
"17536","FBgn0037755","3R",9787816,9791221,3405
"17537","FBgn0011971","3R",14044525,14044606,81
"17538","FBgn0031256","2L",453108,454654,1546
"17539","FBgn0266413","3R",9632035,9633076,1041
"17540","FBgn0024947","2L",2880704,2885850,5146
"17541","FBgn0032876","2L",20678921,20681846,2925
"17542","FBgn0039052","3R",23097728,23099191,1463
"17543","FBgn0030016","X",8164266,8165708,1442
"17544","FBgn0031149","X",21049885,21053937,4052
"17545","FBgn0261927","X",5697123,5697660,537
"17546","FBgn0036196","3L",11699496,11708553,9057
"17547","FBgn0263260","2R",10050862,10052167,1305
"17548","FBgn0036324","3L",12901247,12902737,1490
"17549","FBgn0032645","2L",17497994,17498821,827
"17550","FBgn0033369","2R",9060461,9061924,1463
"17551","FBgn0000448","2R",10203995,10237348,33353
"17552","FBgn0034911","2R",23820354,23839864,19510
"17553","FBgn0015218","3L",9399618,9402460,2842
"17554","FBgn0011921","2R",9661225,9661296,71
"17555","FBgn0085344","2R",13202728,13206547,3819
"17556","FBgn0267076","X",5663114,5665605,2491
"17557","FBgn0243514","3R",27095867,27099679,3812
"17558","FBgn0261840","3R",21365609,21369330,3721
"17559","FBgn0037541","3R",8016210,8030790,14580
"17560","FBgn0036881","3L",19532743,19538289,5546
"17561","FBgn0263665","X",22870267,22872158,1891
"17562","FBgn0029992","X",8070244,8075466,5222
"17563","FBgn0031061","X",19701927,19704259,2332
"17564","FBgn0032522","2L",13412519,13413716,1197
"17565","FBgn0051087","3R",25311027,25313833,2806
"17566","FBgn0036833","3L",18920430,18922108,1678
"17567","FBgn0266697","3R",4402429,4402928,499
"17568","FBgn0002948","X",11580772,11585750,4978
"17569","FBgn0266825","2L",5486905,5487191,286
"17570","FBgn0031196","X",22542386,22544322,1936
"17571","FBgn0038583","3R",18218147,18220699,2552
"17572","FBgn0038492","3R",17152995,17202130,49135
"17573","FBgn0039420","3R",26262662,26277050,14388
"17574","FBgn0283503","3L",14043694,14049892,6198
"17575","FBgn0004237","3R",13656846,13660531,3685
"17576","FBgn0039112","3R",23759483,23760600,1117
"17577","FBgn0262685","X",11459786,11476504,16718
"17578","FBgn0029134","2R",10819978,10821178,1200
"17579","FBgn0037924","3R",11628759,11633206,4447
"17580","FBgn0033475","2R",10033304,10034698,1394
"17581","FBgn0266243","3R",10385494,10387385,1891
"17582","FBgn0051268","3R",17031802,17033515,1713
"17583","FBgn0034005","2R",15258761,15262873,4112
"17584","FBgn0262541","3R",22771156,22771770,614
"17585","FBgn0259139","3R",11815206,11819339,4133
"17586","FBgn0042101","3R",7797078,7798771,1693
"17587","FBgn0262228","X",19558753,19558843,90
"17588","FBgn0053854","2L",21520109,21520637,528
"17589","FBgn0085298","3L",528337,528996,659
"17590","FBgn0050178","2R",23986615,23987308,693
"17591","FBgn0021906","2L",1612429,1614160,1731
"17592","FBgn0024432","3R",18299229,18300044,815
"17593","FBgn0034601","2R",21177754,21178636,882
"17594","FBgn0266072","2L",7795849,7796260,411
"17595","FBgn0266625","2R",9284845,9285594,749
"17596","FBgn0033434","2R",9594045,9605624,11579
"17597","FBgn0051195","3R",20757269,20762369,5100
"17598","FBgn0264380","X",6592533,6593069,536
"17599","FBgn0033372","2R",9084598,9087808,3210
"17600","FBgn0263541","3L",9733659,9733780,121
"17601","FBgn0053673","2L",1945815,1946728,913
"17602","FBgn0259150","X",5650567,5662861,12294
"17603","FBgn0032798","2L",19518824,19525453,6629
"17604","FBgn0265875","X",15290317,15290755,438
"17605","FBgn0038765","3R",20026487,20028040,1553
"17606","FBgn0264727","3L",22072369,22072620,251
"17607","FBgn0266047","2R",24350969,24351389,420
"17608","FBgn0261612","2R",16243145,16259805,16660
"17609","FBgn0042134","3L",18668153,18673324,5171
"17610","FBgn0011855","3L",1401781,1401852,71
"17611","FBgn0031888","2L",7069536,7084635,15099
"17612","FBgn0000221","X",4104342,4105791,1449
"17613","FBgn0050440","2R",5468319,5495861,27542
"17614","FBgn0028396","3R",20871036,20871700,664
"17615","FBgn0267216","3R",25847239,25847638,399
"17616","FBgn0015270","3R",13964885,13967075,2190
"17617","FBgn0037169","3L",22548437,22549342,905
"17618","FBgn0086670","3L",1488906,1489045,139
"17619","FBgn0040600","3R",24769351,24770933,1582
"17620","FBgn0036376","3L",13513254,13516276,3022
"17621","FBgn0024352","2L",295122,297449,2327
"17622","FBgn0034588","2R",21118394,21120705,2311
"17623","FBgn0067102","2R",22075988,22079381,3393
"17624","FBgn0035529","3L",4292482,4293432,950
"17625","FBgn0035791","3L",7497211,7498831,1620
"17626","FBgn0260007","2R",11778526,11779235,709
"17627","FBgn0029820","X",5879869,5883391,3522
"17628","FBgn0010215","3L",23318646,23338100,19454
"17629","FBgn0030360","X",12007176,12009904,2728
"17630","FBgn0053889","2L",21484085,21484497,412
"17631","FBgn0031759","2L",5989400,5999501,10101
"17632","FBgn0262363","3R",8049673,8050059,386
"17633","FBgn0030733","X",16286288,16286988,700
"17634","FBgn0005533","3L",9428795,9429821,1026
"17635","FBgn0010497","2L",12027438,12034122,6684
"17636","FBgn0266164","2L",16072835,16073569,734
"17637","FBgn0052095","3L",11824207,11825732,1525
"17638","FBgn0033507","2R",10310113,10311143,1030
"17639","FBgn0034756","2R",22652573,22654530,1957
"17640","FBgn0265107","2R",7533190,7533497,307
"17641","FBgn0265345","2R",10782895,10785597,2702
"17642","FBgn0264361","2L",12343643,12344266,623
"17643","FBgn0267687","3R",14535245,14536223,978
"17644","FBgn0011962","3R",8140223,8140295,72
"17645","FBgn0029951","X",7574290,7576767,2477
"17646","FBgn0262391","2R",13329402,13329501,99
"17647","FBgn0034876","2R",23544823,23548151,3328
"17648","FBgn0264607","4",1035288,1053703,18415
"17649","FBgn0034082","2R",16157267,16158794,1527
"17650","FBgn0026238","2R",5116990,5128321,11331
"17651","FBgn0023549","X",2189188,2205373,16185
"17652","FBgn0036853","3L",19253290,19255061,1771
"17653","FBgn0267644","3L",2628041,2629018,977
"17654","FBgn0261586","2L",21326660,21327114,454
"17655","FBgn0266891","2L",10638562,10639592,1030
"17656","FBgn0033564","2R",10879974,10883202,3228
"17657","FBgn0002778","3L",14985100,14991667,6567
"17658","FBgn0025725","3L",1641066,1645199,4133
"17659","FBgn0036778","3L",18128940,18132689,3749
"17660","FBgn0083014","3L",261803,261953,150
"17661","FBgn0003961","2L",7780085,7781415,1330
"17662","FBgn0034935","2R",23946959,23949076,2117
"17663","FBgn0039757","3R",30206447,30209020,2573
"17664","FBgn0027594","3L",1715595,1731107,15512
"17665","FBgn0053532","2L",19418317,19419029,712
"17666","FBgn0040355","X",2890768,2894232,3464
"17667","FBgn0053766","3L",22645627,22646236,609
"17668","FBgn0034441","2R",19385923,19389318,3395
"17669","FBgn0039049","3R",23091724,23095184,3460
"17670","FBgn0083057","3L",831870,832008,138
"17671","FBgn0085500","Y",3212119,3212805,686
"17672","FBgn0265873","X",15077498,15081255,3757
"17673","FBgn0036777","3L",18112959,18121003,8044
"17674","FBgn0267955","2R",17245061,17245501,440
"17675","FBgn0250904","X",5614554,5616370,1816
"17676","FBgn0051493","3R",7131560,7132695,1135
"17677","FBgn0030400","X",12569169,12583193,14024
"17678","FBgn0262389","3R",24488612,24488682,70
"17679","FBgn0037255","3R",4485008,4487677,2669
"17680","FBgn0040252","3R",11175529,11177910,2381
"17681","FBgn0053864","2L",21536346,21537368,1022
"17682","FBgn0031309","2L",1149445,1150677,1232
"17683","FBgn0260866","2R",22563152,22592964,29812
"17684","FBgn0028471","3R",24314660,24318419,3759
"17685","FBgn0036359","3L",13425891,13426673,782
"17686","FBgn0036715","3L",17367753,17379530,11777
"17687","FBgn0265611","X",15297312,15298217,905
"17688","FBgn0000057","2R",18151704,18154060,2356
"17689","FBgn0266005","X",1047242,1088866,41624
"17690","FBgn0266672","3R",5754932,5758997,4065
"17691","FBgn0265424","3R",7326481,7327181,700
"17692","FBgn0041342","3L",1546092,1553504,7412
"17693","FBgn0032973","2L",22108964,22110449,1485
"17694","FBgn0039697","3R",29801599,29802945,1346
"17695","FBgn0026392","2L",11934505,11935716,1211
"17696","FBgn0039591","3R",28636411,28638799,2388
"17697","FBgn0283469","X",17907692,17911097,3405
"17698","FBgn0028945","2L",15628678,15629552,874
"17699","FBgn0038692","3R",19229463,19230832,1369
"17700","FBgn0027903","3L",1775633,1777019,1386
"17701","FBgn0265716","3L",6724902,6725279,377
"17702","FBgn0262892","3L",15332246,15332877,631
"17703","FBgn0052677","X",10627737,10710947,83210
"17704","FBgn0267290","2L",14448409,14449009,600
"17705","FBgn0036390","3L",13973123,13973477,354
"17706","FBgn0260231","3R",12028070,12031757,3687
"17707","FBgn0036023","3L",9639271,9640140,869
"17708","FBgn0263767","3L",15062207,15062622,415
"17709","FBgn0262359","2L",8243323,8244003,680
"17710","FBgn0260870","X",20574282,20574693,411
"17711","FBgn0035400","3L",3128034,3143457,15423
"17712","FBgn0262902","2R",24793807,24795772,1965
"17713","FBgn0267778","3R",29745209,29746083,874
"17714","FBgn0033324","2R",8706388,8709486,3098
"17715","FBgn0261564","2R",22925107,22932044,6937
"17716","FBgn0033887","2R",13969910,13971263,1353
"17717","FBgn0283639","X",19551318,19551379,61
"17718","FBgn0003375","3R",17595362,17596112,750
"17719","FBgn0040759","2R",12163675,12164896,1221
"17720","FBgn0040344","X",922889,927582,4693
"17721","FBgn0038136","3R",13298768,13302334,3566
"17722","FBgn0031850","2L",6686791,6709086,22295
"17723","FBgn0262562","3R",17768272,17794490,26218
"17724","FBgn0265865","X",13604359,13605651,1292
"17725","FBgn0037749","3R",9770532,9771542,1010
"17726","FBgn0034703","2R",22172803,22174691,1888
"17727","FBgn0038756","3R",19948443,19948907,464
"17728","FBgn0266144","2L",14349070,14349799,729
"17729","FBgn0028847","2L",13722161,13723642,1481
"17730","FBgn0025456","3R",17393272,17394640,1368
"17731","FBgn0267927","2L",9663744,9668501,4757
"17732","FBgn0039632","3R",29059272,29062975,3703
"17733","FBgn0027339","3L",22789233,22835194,45961
"17734","FBgn0040371","X",307684,308935,1251
"17735","FBgn0030456","X",13155038,13157372,2334
"17736","FBgn0051248","3R",7129320,7130908,1588
"17737","FBgn0029123","2L",8825645,8829670,4025
"17738","FBgn0029172","3L",11023535,11024846,1311
"17739","FBgn0267877","Y",3093855,3094575,720
"17740","FBgn0005586","2R",10721335,10729203,7868
"17741","FBgn0051646","2L",5626291,5658560,32269
"17742","FBgn0011606","X",2599158,2604052,4894
"17743","FBgn0003545","2R",17745500,17748078,2578
"17744","FBgn0264392","2L",16216239,16217044,805
"17745","FBgn0263453","3R",27368842,27369865,1023
"17746","FBgn0264831","3R",12268784,12270223,1439
"17747","FBgn0011283","2L",7496791,7497365,574
"17748","FBgn0053136","2R",18664449,18665792,1343
"17749","FBgn0262385","2R",9621251,9621338,87
"17750","FBgn0039634","3R",29109053,29112822,3769
"17751","FBgn0034325","2R",18297795,18298903,1108
"17752","FBgn0036754","3L",17802490,17804715,2225
"17753","FBgn0053182","2R",13176553,13198337,21784
