"","ensembl_gene_id","chromosome_name","start_position","end_position","length"
"1","ENSGALG00000000003","1",20328226,20347898,19672
"2","ENSGALG00000000011","6",32362856,32366096,3240
"3","ENSGALG00000000038","11",1969779,1971563,1784
"4","ENSGALG00000000044","14",13962836,13964455,1619
"5","ENSGALG00000000048","25",482603,488101,5498
"6","ENSGALG00000000055","4",60121988,60126244,4256
"7","ENSGALG00000000059","11",18842577,18845331,2754
"8","ENSGALG00000000067","4",89868567,89871730,3163
"9","ENSGALG00000000071","1",190327368,190335382,8014
"10","ENSGALG00000000081","16",2367597,2478250,110653
"11","ENSGALG00000000086","26",1113674,1120743,7069
"12","ENSGALG00000000091","1",194331748,194363395,31647
"13","ENSGALG00000000094","26",1106026,1112697,6671
"14","ENSGALG00000000102","26",1099146,1102387,3241
"15","ENSGALG00000000104","26",1089542,1098705,9163
"16","ENSGALG00000000106","26",1079126,1090634,11508
"17","ENSGALG00000000107","16",2482327,2491638,9311
"18","ENSGALG00000000109","18",9856717,9860064,3347
"19","ENSGALG00000000112","4",1997678,2003292,5614
"20","ENSGALG00000000115","16",2492672,2494263,1591
"21","ENSGALG00000000120","22",421956,427810,5854
"22","ENSGALG00000000122","16",2525327,2529817,4490
"23","ENSGALG00000000129","11",18820548,18838454,17906
"24","ENSGALG00000000136","16",2558049,2560828,2779
"25","ENSGALG00000000137","26",1678657,1680974,2317
"26","ENSGALG00000000141","16",2565094,2566926,1832
"27","ENSGALG00000000142","26",1041982,1065980,23998
"28","ENSGALG00000000146","19",5921244,5941204,19960
"29","ENSGALG00000000150","4",69289315,69296300,6985
"30","ENSGALG00000000151","Z",45410076,45570562,160486
"31","ENSGALG00000000154","26",1029892,1037452,7560
"32","ENSGALG00000000156","16",2574359,2580734,6375
"33","ENSGALG00000000158","16",2584405,2586614,2209
"34","ENSGALG00000000161","Z",45666922,45706187,39265
"35","ENSGALG00000000162","16",2586004,2588894,2890
"36","ENSGALG00000000164","26",1011100,1020640,9540
"37","ENSGALG00000000168","26",991509,1008522,17013
"38","ENSGALG00000000172","26",978298,981812,3514
"39","ENSGALG00000000184","Z",45721101,45760913,39812
"40","ENSGALG00000000186","26",1670781,1679287,8506
"41","ENSGALG00000000189","Z",45786454,45824614,38160
"42","ENSGALG00000000195","22",501885,551476,49591
"43","ENSGALG00000000201","27",4004619,4020058,15439
"44","ENSGALG00000000208","Z",45855483,46033418,177935
"45","ENSGALG00000000209","22",577317,581857,4540
"46","ENSGALG00000000215","Z",46038892,46065354,26462
"47","ENSGALG00000000217","26",954079,976671,22592
"48","ENSGALG00000000218","Z",46094705,46101520,6815
"49","ENSGALG00000000220","Z",46112427,46200441,88014
"50","ENSGALG00000000223","26",923122,934781,11659
"51","ENSGALG00000000225","26",915271,920488,5217
"52","ENSGALG00000000226","26",910864,914096,3232
"53","ENSGALG00000000227","22",605206,646892,41686
"54","ENSGALG00000000233","27",6502621,6508099,5478
"55","ENSGALG00000000234","Z",46272436,46396602,124166
"56","ENSGALG00000000235","22",688378,726427,38049
"57","ENSGALG00000000241","Z",46594962,46603606,8644
"58","ENSGALG00000000242","22",736997,875384,138387
"59","ENSGALG00000000243","27",4030006,4034840,4834
"60","ENSGALG00000000244","Z",46616371,46782893,166522
"61","ENSGALG00000000247","Z",46811852,46841797,29945
"62","ENSGALG00000000249","27",4034905,4038410,3505
"63","ENSGALG00000000251","27",4040247,4045220,4973
"64","ENSGALG00000000253","Z",46908349,46922477,14128
"65","ENSGALG00000000255","Z",47239613,47357106,117493
"66","ENSGALG00000000259","20",9867069,9873205,6136
"67","ENSGALG00000000264","Z",47448939,47484723,35784
"68","ENSGALG00000000273","Z",47527109,47681655,154546
"69","ENSGALG00000000274","27",4079597,4087573,7976
"70","ENSGALG00000000275","22",962634,970983,8349
"71","ENSGALG00000000276","Z",47772333,48059677,287344
"72","ENSGALG00000000277","22",973156,976774,3618
"73","ENSGALG00000000280","Z",48131380,48335018,203638
"74","ENSGALG00000000284","27",6243545,6248818,5273
"75","ENSGALG00000000293","27",4101688,4112295,10607
"76","ENSGALG00000000295","26",870577,887343,16766
"77","ENSGALG00000000296","5",27422449,27504335,81886
"78","ENSGALG00000000299","26",827967,854048,26081
"79","ENSGALG00000000302","26",807502,813890,6388
"80","ENSGALG00000000309","26",797808,805378,7570
"81","ENSGALG00000000311","22",981447,1052989,71542
"82","ENSGALG00000000313","26",790416,794166,3750
"83","ENSGALG00000000314","22",1089882,1108097,18215
"84","ENSGALG00000000317","22",1098617,1103124,4507
"85","ENSGALG00000000318","26",776660,782042,5382
"86","ENSGALG00000000329","26",1296534,1317744,21210
"87","ENSGALG00000000336","26",686280,770677,84397
"88","ENSGALG00000000337","28",506848,508022,1174
"89","ENSGALG00000000341","25",3270145,3271199,1054
"90","ENSGALG00000000349","27",4119715,4123304,3589
"91","ENSGALG00000000352","28",582246,604742,22496
"92","ENSGALG00000000357","22",1187068,1205333,18265
"93","ENSGALG00000000364","22",1287781,1294830,7049
"94","ENSGALG00000000365","22",1307275,1309948,2673
"95","ENSGALG00000000367","27",4187017,4266979,79962
"96","ENSGALG00000000371","27",4646659,4670553,23894
"97","ENSGALG00000000374","26",617184,633046,15862
"98","ENSGALG00000000377","28",604711,629778,25067
"99","ENSGALG00000000378","22",1324249,1333078,8829
"100","ENSGALG00000000379","27",4721958,4738989,17031
"101","ENSGALG00000000390","22",1337732,1346169,8437
"102","ENSGALG00000000394","26",1352712,1360431,7719
"103","ENSGALG00000000396","27",4751454,4764142,12688
"104","ENSGALG00000000397","26",574234,594203,19969
"105","ENSGALG00000000399","9",2860218,2863677,3459
"106","ENSGALG00000000400","26",1366688,1389976,23288
"107","ENSGALG00000000401","26",1400047,1402914,2867
"108","ENSGALG00000000402","22",1351044,1386815,35771
"109","ENSGALG00000000404","10",10883287,10904519,21232
"110","ENSGALG00000000407","28",646860,659632,12772
"111","ENSGALG00000000409","22",1402211,1410592,8381
"112","ENSGALG00000000410","27",4774952,4815919,40967
"113","ENSGALG00000000417","26",1413628,1422663,9035
"114","ENSGALG00000000419","26",1424151,1426410,2259
"115","ENSGALG00000000424","11",11429328,11442605,13277
"116","ENSGALG00000000430","28",659800,694959,35159
"117","ENSGALG00000000433","7",22205155,22208893,3738
"118","ENSGALG00000000437","26",1433283,1436412,3129
"119","ENSGALG00000000438","Z",27771796,27786843,15047
"120","ENSGALG00000000441","26",1438259,1442793,4534
"121","ENSGALG00000000442","26",1469306,1471568,2262
"122","ENSGALG00000000451","1",8003807,8010070,6263
"123","ENSGALG00000000452","22",1415487,1422100,6613
"124","ENSGALG00000000458","28",710915,722418,11503
"125","ENSGALG00000000461","27",4832151,4845337,13186
"126","ENSGALG00000000466","23",5273969,5292034,18065
"127","ENSGALG00000000469","22",5083582,5098900,15318
"128","ENSGALG00000000470","28",729616,757180,27564
"129","ENSGALG00000000474","28",770201,772981,2780
"130","ENSGALG00000000476","22",4410028,4620737,210709
"131","ENSGALG00000000478","27",4897150,5049377,152227
"132","ENSGALG00000000497","26",1533127,1536766,3639
"133","ENSGALG00000000498","27",5066557,5082805,16248
"134","ENSGALG00000000504","26",1539943,1544102,4159
"135","ENSGALG00000000505","27",5090432,5118510,28078
"136","ENSGALG00000000507","11",18738378,18745111,6733
"137","ENSGALG00000000510","27",5119774,5135568,15794
"138","ENSGALG00000000511","26",1544510,1563320,18810
"139","ENSGALG00000000513","11",18771553,18778212,6659
"140","ENSGALG00000000516","11",18778749,18811706,32957
"141","ENSGALG00000000518","26",510087,522316,12229
"142","ENSGALG00000000521","11",18813764,18819623,5859
"143","ENSGALG00000000523","26",1565335,1575057,9722
"144","ENSGALG00000000525","27",5141419,5180131,38712
"145","ENSGALG00000000528","11",18849334,18852939,3605
"146","ENSGALG00000000529","27",5186052,5190752,4700
"147","ENSGALG00000000533","26",1584188,1590134,5946
"148","ENSGALG00000000535","21",255925,259437,3512
"149","ENSGALG00000000538","27",5196842,5203338,6496
"150","ENSGALG00000000540","11",18853533,18862046,8513
"151","ENSGALG00000000541","26",481428,495534,14106
"152","ENSGALG00000000542","23",352761,353960,1199
"153","ENSGALG00000000544","26",1603818,1616373,12555
"154","ENSGALG00000000545","26",1725734,1730462,4728
"155","ENSGALG00000000549","11",18861162,18862768,1606
"156","ENSGALG00000000550","27",5203843,5214957,11114
"157","ENSGALG00000000551","26",1618156,1637334,19178
"158","ENSGALG00000000557","26",1717215,1724197,6982
"159","ENSGALG00000000558","28",792585,812847,20262
"160","ENSGALG00000000560","26",1639626,1646179,6553
"161","ENSGALG00000000564","27",5215338,5225187,9849
"162","ENSGALG00000000568","26",429845,474775,44930
"163","ENSGALG00000000573","21",291189,310409,19220
"164","ENSGALG00000000576","25",2624337,2626380,2043
"165","ENSGALG00000000577","28",832528,873641,41113
"166","ENSGALG00000000579","21",310699,314464,3765
"167","ENSGALG00000000581","27",5225378,5241792,16414
"168","ENSGALG00000000583","26",1695658,1714634,18976
"169","ENSGALG00000000584","26",380663,408134,27471
"170","ENSGALG00000000585","27",5250693,5256162,5469
"171","ENSGALG00000000589","28",898934,903624,4690
"172","ENSGALG00000000593","4",60162363,60166294,3931
"173","ENSGALG00000000596","27",5259680,5286482,26802
"174","ENSGALG00000000599","28",911079,922400,11321
"175","ENSGALG00000000603","27",5290753,5359216,68463
"176","ENSGALG00000000604","23",650448,671379,20931
"177","ENSGALG00000000606","26",355155,365068,9913
"178","ENSGALG00000000607","26",349399,353524,4125
"179","ENSGALG00000000608","11",18870452,18879210,8758
"180","ENSGALG00000000611","26",1783984,1790373,6389
"181","ENSGALG00000000613","28",928389,941429,13040
"182","ENSGALG00000000615","23",678435,689421,10986
"183","ENSGALG00000000616","26",323882,327166,3284
"184","ENSGALG00000000618","23",688912,702716,13804
"185","ENSGALG00000000619","28",945364,954006,8642
"186","ENSGALG00000000621","28",971434,981257,9823
"187","ENSGALG00000000625","27",5360090,5397664,37574
"188","ENSGALG00000000627","21",539941,556279,16338
"189","ENSGALG00000000629","28",983593,984731,1138
"190","ENSGALG00000000630","11",18909088,18913330,4242
"191","ENSGALG00000000632","11",18913184,18914832,1648
"192","ENSGALG00000000636","26",1813731,1832064,18333
"193","ENSGALG00000000637","21",570199,581910,11711
"194","ENSGALG00000000638","11",18914355,18919580,5225
"195","ENSGALG00000000639","26",1842480,1844570,2090
"196","ENSGALG00000000643","14",13235341,13245080,9739
"197","ENSGALG00000000645","21",607572,614042,6470
"198","ENSGALG00000000650","11",18933246,18934623,1377
"199","ENSGALG00000000652","21",622081,629374,7293
"200","ENSGALG00000000653","26",1979695,2003254,23559
"201","ENSGALG00000000654","11",18934966,18937487,2521
"202","ENSGALG00000000657","11",18938562,18946393,7831
"203","ENSGALG00000000660","11",18950606,18962787,12181
"204","ENSGALG00000000667","23",1063330,1068649,5319
"205","ENSGALG00000000668","26",2014218,2023555,9337
"206","ENSGALG00000000669","25",2520992,2528858,7866
"207","ENSGALG00000000672","23",1344051,1374495,30444
"208","ENSGALG00000000674","27",3817962,3888947,70985
"209","ENSGALG00000000678","23",1506533,1508755,2222
"210","ENSGALG00000000681","1",194484628,194551701,67073
"211","ENSGALG00000000684","26",2090546,2094449,3903
"212","ENSGALG00000000685","27",3794520,3809775,15255
"213","ENSGALG00000000690","1",194560365,194594269,33904
"214","ENSGALG00000000692","26",2156870,2171973,15103
"215","ENSGALG00000000693","11",19039525,19042055,2530
"216","ENSGALG00000000695","26",2178133,2192431,14298
"217","ENSGALG00000000699","11",19042181,19073845,31664
"218","ENSGALG00000000703","26",2224414,2246628,22214
"219","ENSGALG00000000707","11",19074895,19080147,5252
"220","ENSGALG00000000708","26",2262710,2277921,15211
"221","ENSGALG00000000712","26",2278989,2285673,6684
"222","ENSGALG00000000713","11",19493186,19635682,142496
"223","ENSGALG00000000719","21",640004,645489,5485
"224","ENSGALG00000000720","23",1516302,1523141,6839
"225","ENSGALG00000000721","26",2287405,2305691,18286
"226","ENSGALG00000000722","28",1008962,1015394,6432
"227","ENSGALG00000000723","23",1524210,1536927,12717
"228","ENSGALG00000000724","26",2303301,2320772,17471
"229","ENSGALG00000000726","28",1027920,1050549,22629
"230","ENSGALG00000000729","23",1536772,1555237,18465
"231","ENSGALG00000000731","23",1564116,1568510,4394
"232","ENSGALG00000000734","23",1570009,1573848,3839
"233","ENSGALG00000000736","28",1056317,1061333,5016
"234","ENSGALG00000000737","23",1574041,1579810,5769
"235","ENSGALG00000000740","28",1081503,1087781,6278
"236","ENSGALG00000000745","26",2324250,2343007,18757
"237","ENSGALG00000000747","21",645544,673036,27492
"238","ENSGALG00000000748","28",1088220,1098575,10355
"239","ENSGALG00000000751","25",174129,194999,20870
"240","ENSGALG00000000755","1",194764118,194819371,55253
"241","ENSGALG00000000761","1",194859310,194874075,14765
"242","ENSGALG00000000764","25",161090,164525,3435
"243","ENSGALG00000000769","26",2349209,2352491,3282
"244","ENSGALG00000000775","25",165228,169865,4637
"245","ENSGALG00000000776","26",192701,216901,24200
"246","ENSGALG00000000777","23",1582589,1627539,44950
"247","ENSGALG00000000783","23",1627960,1636790,8830
"248","ENSGALG00000000784","28",1099554,1130916,31362
"249","ENSGALG00000000785","12",1838093,1840008,1915
"250","ENSGALG00000000786","26",2355723,2358912,3189
"251","ENSGALG00000000787","11",19707224,19717686,10462
"252","ENSGALG00000000788","26",2366601,2368583,1982
"253","ENSGALG00000000790","23",1641843,1655758,13915
"254","ENSGALG00000000791","26",2384160,2390966,6806
"255","ENSGALG00000000793","25",257785,260117,2332
"256","ENSGALG00000000795","28",1155041,1161700,6659
"257","ENSGALG00000000802","11",19719050,19722530,3480
"258","ENSGALG00000000803","28",2045697,2048418,2721
"259","ENSGALG00000000806","28",2069057,2070874,1817
"260","ENSGALG00000000808","1",194959884,194997527,37643
"261","ENSGALG00000000811","11",19722896,19730099,7203
"262","ENSGALG00000000812","28",2082439,2086009,3570
"263","ENSGALG00000000814","23",1662541,1687966,25425
"264","ENSGALG00000000816","26",2390184,2469702,79518
"265","ENSGALG00000000817","11",19730464,19742076,11612
"266","ENSGALG00000000818","1",195032674,195039220,6546
"267","ENSGALG00000000820","23",1741624,1757003,15379
"268","ENSGALG00000000824","27",3764703,3768368,3665
"269","ENSGALG00000000830","1",195145039,195161469,16430
"270","ENSGALG00000000835","28",2118169,2124677,6508
"271","ENSGALG00000000836","25",313422,315503,2081
"272","ENSGALG00000000838","1",195171182,195183627,12445
"273","ENSGALG00000000839","1",195315169,195341425,26256
"274","ENSGALG00000000843","28",2130010,2185378,55368
"275","ENSGALG00000000845","1",195484990,195565945,80955
"276","ENSGALG00000000847","17",10706132,10748976,42844
"277","ENSGALG00000000848","11",19764265,19793120,28855
"278","ENSGALG00000000853","17",10683005,10692783,9778
"279","ENSGALG00000000855","23",1832025,1846206,14181
"280","ENSGALG00000000856","26",2507117,2516979,9862
"281","ENSGALG00000000857","27",3728837,3739621,10784
"282","ENSGALG00000000862","23",1849996,1879738,29742
"283","ENSGALG00000000863","26",2516995,2523234,6239
"284","ENSGALG00000000864","17",10673254,10682819,9565
"285","ENSGALG00000000866","25",342332,352320,9988
"286","ENSGALG00000000868","1",195591204,195602075,10871
"287","ENSGALG00000000870","27",3718449,3728829,10380
"288","ENSGALG00000000871","1",195574183,195575079,896
"289","ENSGALG00000000875","11",19798257,19824250,25993
"290","ENSGALG00000000881","23",1915119,1919682,4563
"291","ENSGALG00000000883","26",2535306,2553032,17726
"292","ENSGALG00000000884","13",1686038,1715067,29029
"293","ENSGALG00000000887","23",1920776,1923230,2454
"294","ENSGALG00000000891","19",500330,504124,3794
"295","ENSGALG00000000892","26",2562702,2564995,2293
"296","ENSGALG00000000893","11",19836052,19846702,10650
"297","ENSGALG00000000895","23",1924584,1933500,8916
"298","ENSGALG00000000901","11",19856230,19857745,1515
"299","ENSGALG00000000902","23",1939316,1944798,5482
"300","ENSGALG00000000903","11",19863899,19867114,3215
"301","ENSGALG00000000905","25",383948,386254,2306
"302","ENSGALG00000000906","17",10574805,10660252,85447
"303","ENSGALG00000000907","11",19866566,19879472,12906
"304","ENSGALG00000000908","11",19878815,19899510,20695
"305","ENSGALG00000000909","27",3697600,3702163,4563
"306","ENSGALG00000000911","26",2575609,2578946,3337
"307","ENSGALG00000000913","11",19912187,19927726,15539
"308","ENSGALG00000000914","27",3695485,3696729,1244
"309","ENSGALG00000000918","27",3690449,3694265,3816
"310","ENSGALG00000000919","26",2580165,2590723,10558
"311","ENSGALG00000000920","25",390267,399593,9326
"312","ENSGALG00000000927","17",10600666,10618538,17872
"313","ENSGALG00000000934","17",10544180,10549641,5461
"314","ENSGALG00000000943","23",2005470,2021064,15594
"315","ENSGALG00000000944","19",707198,710407,3209
"316","ENSGALG00000000946","13",2140881,2170325,29444
"317","ENSGALG00000000949","13",2173845,2180352,6507
"318","ENSGALG00000000950","17",10262203,10310998,48795
"319","ENSGALG00000000955","23",2028432,2033279,4847
"320","ENSGALG00000000962","24",342462,353153,10691
"321","ENSGALG00000000966","21",693159,714164,21005
"322","ENSGALG00000000972","17",10026746,10123535,96789
"323","ENSGALG00000000975","21",916953,919088,2135
"324","ENSGALG00000000977","17",9939834,10024847,85013
"325","ENSGALG00000000978","21",923773,935424,11651
"326","ENSGALG00000000988","27",3673094,3690321,17227
"327","ENSGALG00000000990","20",97923,123852,25929
"328","ENSGALG00000000991","23",2413031,2419046,6015
"329","ENSGALG00000000993","17",9897730,9941204,43474
"330","ENSGALG00000000994","23",2419840,2421026,1186
"331","ENSGALG00000000996","28",2185439,2206151,20712
"332","ENSGALG00000000997","27",3660178,3663464,3286
"333","ENSGALG00000000998","23",2421689,2430878,9189
"334","ENSGALG00000000999","11",456154,457818,1664
"335","ENSGALG00000001000","17",9890855,9894996,4141
"336","ENSGALG00000001003","23",2432697,2435041,2344
"337","ENSGALG00000001006","21",946988,976104,29116
"338","ENSGALG00000001013","17",9883271,9888343,5072
"339","ENSGALG00000001014","17",9879987,9883662,3675
"340","ENSGALG00000001017","21",979698,992769,13071
"341","ENSGALG00000001019","28",2232091,2244110,12019
"342","ENSGALG00000001021","18",808100,1027820,219720
"343","ENSGALG00000001022","27",3623533,3631332,7799
"344","ENSGALG00000001024","21",992801,996073,3272
"345","ENSGALG00000001025","17",9863064,9876915,13851
"346","ENSGALG00000001028","19",713614,767109,53495
"347","ENSGALG00000001030","28",2272056,2279787,7731
"348","ENSGALG00000001031","19",769653,792925,23272
"349","ENSGALG00000001034","20",258118,263562,5444
"350","ENSGALG00000001035","28",2283963,2295801,11838
"351","ENSGALG00000001036","18",1037893,1052626,14733
"352","ENSGALG00000001037","17",9826144,9857169,31025
"353","ENSGALG00000001038","23",2453389,2495023,41634
"354","ENSGALG00000001042","19",801748,844553,42805
"355","ENSGALG00000001043","28",2328523,2359784,31261
"356","ENSGALG00000001046","20",338819,473635,134816
"357","ENSGALG00000001048","17",9815450,9818837,3387
"358","ENSGALG00000001049","19",844308,849704,5396
"359","ENSGALG00000001051","23",2503214,2516531,13317
"360","ENSGALG00000001054","20",494619,499213,4594
"361","ENSGALG00000001055","27",3546258,3602488,56230
"362","ENSGALG00000001056","19",851485,853634,2149
"363","ENSGALG00000001058","21",1032001,1037986,5985
"364","ENSGALG00000001062","20",500509,515885,15376
"365","ENSGALG00000001067","23",2520375,2536047,15672
"366","ENSGALG00000001073","17",9753750,9812420,58670
"367","ENSGALG00000001076","19",963194,972046,8852
"368","ENSGALG00000001078","21",1263668,1264801,1133
"369","ENSGALG00000001079","27",3523220,3544732,21512
"370","ENSGALG00000001080","17",9728090,9743930,15840
"371","ENSGALG00000001081","21",1367733,1379691,11958
"372","ENSGALG00000001084","28",2363866,2377068,13202
"373","ENSGALG00000001091","26",2605514,2611145,5631
"374","ENSGALG00000001093","28",2462717,2516908,54191
"375","ENSGALG00000001094","17",9704130,9726809,22679
"376","ENSGALG00000001096","28",2523110,2525051,1941
"377","ENSGALG00000001097","27",3494643,3509799,15156
"378","ENSGALG00000001099","13",2202774,2302936,100162
"379","ENSGALG00000001101","28",2527626,2543765,16139
"380","ENSGALG00000001103","17",9673564,9693756,20192
"381","ENSGALG00000001107","27",3463125,3475238,12113
"382","ENSGALG00000001108","28",2559679,2576547,16868
"383","ENSGALG00000001109","27",3444203,3455470,11267
"384","ENSGALG00000001110","19",1000030,1079724,79694
"385","ENSGALG00000001111","18",1100120,1140795,40675
"386","ENSGALG00000001115","21",1390844,1412012,21168
"387","ENSGALG00000001117","26",2618673,2632975,14302
"388","ENSGALG00000001118","17",9627008,9673191,46183
"389","ENSGALG00000001121","28",2578636,2605473,26837
"390","ENSGALG00000001122","19",1102760,1225316,122556
"391","ENSGALG00000001124","17",9524055,9542497,18442
"392","ENSGALG00000001126","28",2605859,2620370,14511
"393","ENSGALG00000001130","19",1259310,1444843,185533
"394","ENSGALG00000001132","13",2309549,2312956,3407
"395","ENSGALG00000001136","21",1417763,1419447,1684
"396","ENSGALG00000001141","21",1435552,1437201,1649
"397","ENSGALG00000001143","24",907941,974253,66312
"398","ENSGALG00000001144","13",10991599,10999944,8345
"399","ENSGALG00000001146","28",2621315,2626103,4788
"400","ENSGALG00000001149","11",543433,548011,4578
"401","ENSGALG00000001153","19",1512994,2173032,660038
"402","ENSGALG00000001156","18",1691965,1692597,632
"403","ENSGALG00000001157","17",9321360,9497657,176297
"404","ENSGALG00000001158","13",11003203,11033062,29859
"405","ENSGALG00000001161","24",1016857,1089783,72926
"406","ENSGALG00000001163","18",1701769,1724694,22925
"407","ENSGALG00000001165","21",1438217,1460034,21817
"408","ENSGALG00000001167","24",1098789,1101947,3158
"409","ENSGALG00000001168","11",561309,569012,7703
"410","ENSGALG00000001169","17",9279299,9313749,34450
"411","ENSGALG00000001171","28",2648568,2668955,20387
"412","ENSGALG00000001172","21",1446518,1468998,22480
"413","ENSGALG00000001174","19",2786402,2799813,13411
"414","ENSGALG00000001175","26",2687134,2698396,11262
"415","ENSGALG00000001177","26",2726911,2737426,10515
"416","ENSGALG00000001181","24",1097586,1142577,44991
"417","ENSGALG00000001182","20",521820,567192,45372
"418","ENSGALG00000001183","18",1725828,1819262,93434
"419","ENSGALG00000001184","11",569115,575366,6251
"420","ENSGALG00000001189","19",2800480,2807394,6914
"421","ENSGALG00000001191","27",5939150,5944728,5578
"422","ENSGALG00000001201","11",594651,600184,5533
"423","ENSGALG00000001203","24",1450781,1454320,3539
"424","ENSGALG00000001204","11",601661,608743,7082
"425","ENSGALG00000001206","13",9084205,9089820,5615
"426","ENSGALG00000001207","21",1473954,1548181,74227
"427","ENSGALG00000001209","20",571792,576537,4745
"428","ENSGALG00000001214","11",610410,614453,4043
"429","ENSGALG00000001219","20",601476,622937,21461
"430","ENSGALG00000001220","11",615984,623539,7555
"431","ENSGALG00000001223","21",1554923,1563411,8488
"432","ENSGALG00000001225","17",9117855,9177510,59655
"433","ENSGALG00000001229","21",1681755,1772379,90624
"434","ENSGALG00000001231","20",630016,655765,25749
"435","ENSGALG00000001234","11",623460,629266,5806
"436","ENSGALG00000001235","28",2692405,2698634,6229
"437","ENSGALG00000001238","18",2096001,2172093,76092
"438","ENSGALG00000001239","13",9062003,9071099,9096
"439","ENSGALG00000001244","18",2174402,2200678,26276
"440","ENSGALG00000001245","28",2700507,2712155,11648
"441","ENSGALG00000001250","24",1470296,1511525,41229
"442","ENSGALG00000001252","28",2707242,2712155,4913
"443","ENSGALG00000001253","17",9082742,9098283,15541
"444","ENSGALG00000001256","11",631380,666403,35023
"445","ENSGALG00000001258","1",195605956,195618448,12492
"446","ENSGALG00000001262","23",2655282,2672704,17422
"447","ENSGALG00000001263","19",2867022,2901742,34720
"448","ENSGALG00000001264","26",2758582,2845137,86555
"449","ENSGALG00000001267","28",2712374,2720662,8288
"450","ENSGALG00000001270","21",1802100,1841490,39390
"451","ENSGALG00000001273","28",2730221,2731462,1241
"452","ENSGALG00000001275","17",9073411,9077516,4105
"453","ENSGALG00000001276","27",6190823,6194818,3995
"454","ENSGALG00000001279","27",6001003,6022400,21397
"455","ENSGALG00000001282","21",1852238,1862627,10389
"456","ENSGALG00000001283","23",2679438,2696177,16739
"457","ENSGALG00000001288","21",1895685,1907122,11437
"458","ENSGALG00000001289","28",2734803,2740719,5916
"459","ENSGALG00000001299","27",6090482,6098133,7651
"460","ENSGALG00000001304","21",1909587,1916282,6695
"461","ENSGALG00000001306","24",1568478,1585984,17506
"462","ENSGALG00000001309","27",6094182,6101707,7525
"463","ENSGALG00000001310","23",2708287,2723179,14892
"464","ENSGALG00000001311","18",2212800,2231061,18261
"465","ENSGALG00000001313","19",3022962,3033581,10619
"466","ENSGALG00000001314","17",9061884,9070028,8144
"467","ENSGALG00000001315","27",6104309,6113729,9420
"468","ENSGALG00000001316","11",668262,707441,39179
"469","ENSGALG00000001317","28",2745050,2756833,11783
"470","ENSGALG00000001319","26",3099869,3114498,14629
"471","ENSGALG00000001320","10",2894101,2896916,2815
"472","ENSGALG00000001325","10",2898903,2902533,3630
"473","ENSGALG00000001328","28",2772421,2783648,11227
"474","ENSGALG00000001329","23",2743037,2816538,73501
"475","ENSGALG00000001330","27",6115324,6117913,2589
"476","ENSGALG00000001331","24",1595777,1613311,17534
"477","ENSGALG00000001332","20",660867,683752,22885
"478","ENSGALG00000001333","17",9045273,9056754,11481
"479","ENSGALG00000001334","21",1932296,1966109,33813
"480","ENSGALG00000001335","18",2248818,2255712,6894
"481","ENSGALG00000001341","24",1652013,1665766,13753
"482","ENSGALG00000001342","28",2785948,2797635,11687
"483","ENSGALG00000001343","26",3114989,3135255,20266
"484","ENSGALG00000001347","17",9022808,9033001,10193
"485","ENSGALG00000001348","18",2262969,2307564,44595
"486","ENSGALG00000001350","11",719306,751138,31832
"487","ENSGALG00000001362","10",2929279,2937676,8397
"488","ENSGALG00000001363","19",3033038,3084837,51799
"489","ENSGALG00000001364","13",9169288,9201025,31737
"490","ENSGALG00000001366","21",4924613,4930908,6295
"491","ENSGALG00000001369","26",3151328,3154238,2910
"492","ENSGALG00000001370","24",1687768,1698988,11220
"493","ENSGALG00000001371","18",2798139,2821873,23734
"494","ENSGALG00000001373","26",3154638,3288987,134349
"495","ENSGALG00000001374","21",2008845,2016560,7715
"496","ENSGALG00000001375","18",2594690,2691529,96839
"497","ENSGALG00000001376","10",2941257,2966568,25311
"498","ENSGALG00000001377","28",2799499,2814078,14579
"499","ENSGALG00000001382","21",2019114,2031584,12470
"500","ENSGALG00000001383","13",8938645,9038296,99651
"501","ENSGALG00000001387","19",3107347,3214173,106826
"502","ENSGALG00000001389","17",8924021,8959039,35018
"503","ENSGALG00000001391","11",763228,765693,2465
"504","ENSGALG00000001392","21",2032641,2041878,9237
"505","ENSGALG00000001394","10",2969171,2977199,8028
"506","ENSGALG00000001405","26",3166589,3174135,7546
"507","ENSGALG00000001407","24",1706345,1715873,9528
"508","ENSGALG00000001409","13",8854546,8878613,24067
"509","ENSGALG00000001410","19",3256399,3279042,22643
"510","ENSGALG00000001412","10",2987868,3010326,22458
"511","ENSGALG00000001416","13",8713341,8730589,17248
"512","ENSGALG00000001418","26",3177160,3183039,5879
"513","ENSGALG00000001419","17",8755610,8909731,154121
"514","ENSGALG00000001420","20",767867,830245,62378
"515","ENSGALG00000001425","24",1807038,1825266,18228
"516","ENSGALG00000001428","9",1130123,1145518,15395
"517","ENSGALG00000001429","13",8666972,8700998,34026
"518","ENSGALG00000001431","26",3184817,3189219,4402
"519","ENSGALG00000001433","18",3121259,3232611,111352
"520","ENSGALG00000001434","17",8723126,8733376,10250
"521","ENSGALG00000001437","24",1887297,2185646,298349
"522","ENSGALG00000001439","11",793917,847606,53689
"523","ENSGALG00000001441","19",3291933,3316212,24279
"524","ENSGALG00000001442","24",2144948,2396494,251546
"525","ENSGALG00000001445","13",8593917,8632025,38108
"526","ENSGALG00000001446","17",8696510,8723691,27181
"527","ENSGALG00000001449","10",3042694,3053063,10369
"528","ENSGALG00000001450","24",2458724,2497695,38971
"529","ENSGALG00000001452","26",3215547,3220046,4499
"530","ENSGALG00000001459","12",970285,981315,11030
"531","ENSGALG00000001462","26",3223957,3226298,2341
"532","ENSGALG00000001463","23",3357695,3366101,8406
"533","ENSGALG00000001465","18",9097963,9100480,2517
"534","ENSGALG00000001467","19",3325996,3346544,20548
"535","ENSGALG00000001470","10",3071342,3074466,3124
"536","ENSGALG00000001472","24",2520519,2547726,27207
"537","ENSGALG00000001473","21",2049102,2082157,33055
"538","ENSGALG00000001474","17",8676966,8692183,15217
"539","ENSGALG00000001475","23",3387729,3398400,10671
"540","ENSGALG00000001476","26",3235315,3257217,21902
"541","ENSGALG00000001479","19",3352330,3356233,3903
"542","ENSGALG00000001480","26",3267357,3277876,10519
"543","ENSGALG00000001483","21",2089567,2112355,22788
"544","ENSGALG00000001486","28",1911962,1933263,21301
"545","ENSGALG00000001489","21",2122345,2144382,22037
"546","ENSGALG00000001490","9",1183162,1185021,1859
"547","ENSGALG00000001491","24",2549260,2574831,25571
"548","ENSGALG00000001492","20",840182,897629,57447
"549","ENSGALG00000001501","15",801554,828953,27399
"550","ENSGALG00000001502","23",3634339,3639204,4865
"551","ENSGALG00000001503","18",3231950,3341251,109301
"552","ENSGALG00000001504","26",3285259,3291572,6313
"553","ENSGALG00000001506","13",8539665,8542809,3144
"554","ENSGALG00000001512","26",3298602,3392361,93759
"555","ENSGALG00000001513","17",8643905,8676088,32183
"556","ENSGALG00000001518","18",3310711,3313521,2810
"557","ENSGALG00000001521","24",2575317,2583331,8014
"558","ENSGALG00000001522","20",905966,962906,56940
"559","ENSGALG00000001525","27",6118078,6127639,9561
"560","ENSGALG00000001527","21",2180506,2190706,10200
"561","ENSGALG00000001529","24",2585506,2590683,5177
"562","ENSGALG00000001531","18",3342109,3349216,7107
"563","ENSGALG00000001533","11",847627,860563,12936
"564","ENSGALG00000001534","21",2206190,2209802,3612
"565","ENSGALG00000001536","20",979607,1019444,39837
"566","ENSGALG00000001538","26",3512831,3533199,20368
"567","ENSGALG00000001540","23",3668446,3675366,6920
"568","ENSGALG00000001542","21",2214476,2217199,2723
"569","ENSGALG00000001545","18",3365331,3388901,23570
"570","ENSGALG00000001546","19",3356517,3407652,51135
"571","ENSGALG00000001547","26",3533312,3543352,10040
"572","ENSGALG00000001550","20",1031067,1059871,28804
"573","ENSGALG00000001551","21",2215995,2226072,10077
"574","ENSGALG00000001555","21",2238517,2242030,3513
"575","ENSGALG00000001557","24",2590528,2597651,7123
"576","ENSGALG00000001558","26",3545026,3550985,5959
"577","ENSGALG00000001559","10",3088213,3090606,2393
"578","ENSGALG00000001561","21",2245514,2268919,23405
"579","ENSGALG00000001563","18",3389456,3404559,15103
"580","ENSGALG00000001564","19",3422032,3455961,33929
"581","ENSGALG00000001565","17",8606511,8642257,35746
"582","ENSGALG00000001568","20",1063070,1074979,11909
"583","ENSGALG00000001569","26",3550867,3556444,5577
"584","ENSGALG00000001571","28",1844413,1858231,13818
"585","ENSGALG00000001572","10",3091477,3093201,1724
"586","ENSGALG00000001573","19",3462945,3470294,7349
"587","ENSGALG00000001577","18",3410347,3449930,39583
"588","ENSGALG00000001583","17",8597003,8608024,11021
"589","ENSGALG00000001586","10",3093547,3097724,4177
"590","ENSGALG00000001592","28",1807297,1815894,8597
"591","ENSGALG00000001593","15",961140,967346,6206
"592","ENSGALG00000001595","17",8588061,8591957,3896
"593","ENSGALG00000001596","28",1766431,1793744,27313
"594","ENSGALG00000001597","27",6822517,6825848,3331
"595","ENSGALG00000001600","21",2277331,2335088,57757
"596","ENSGALG00000001602","11",889768,912266,22498
"597","ENSGALG00000001603","18",3478570,3492518,13948
"598","ENSGALG00000001604","24",2597820,2619876,22056
"599","ENSGALG00000001605","26",3558395,3564832,6437
"600","ENSGALG00000001606","23",3681549,3698102,16553
"601","ENSGALG00000001607","18",3496809,3506892,10083
"602","ENSGALG00000001608","22",2087959,2217683,129724
"603","ENSGALG00000001610","27",6829291,6842574,13283
"604","ENSGALG00000001611","24",2619471,2649394,29923
"605","ENSGALG00000001613","12",1165743,1174018,8275
"606","ENSGALG00000001615","10",3097900,3110653,12753
"607","ENSGALG00000001616","15",967724,980147,12423
"608","ENSGALG00000001617","19",3475171,3556769,81598
"609","ENSGALG00000001618","18",3513612,3547810,34198
"610","ENSGALG00000001619","9",1346740,1365532,18792
"611","ENSGALG00000001620","17",8579238,8586394,7156
"612","ENSGALG00000001621","15",996735,998492,1757
"613","ENSGALG00000001624","27",6842842,6847854,5012
"614","ENSGALG00000001626","18",3657523,3661970,4447
"615","ENSGALG00000001633","22",1926335,1931020,4685
"616","ENSGALG00000001634","27",6855155,6857164,2009
"617","ENSGALG00000001637","17",8568490,8578266,9776
"618","ENSGALG00000001639","23",3697675,3711118,13443
"619","ENSGALG00000001640","22",1919874,1925323,5449
"620","ENSGALG00000001642","12",1175090,1180455,5365
"621","ENSGALG00000001644","10",3113239,3133530,20291
"622","ENSGALG00000001645","17",8511817,8555334,43517
"623","ENSGALG00000001647","11",949815,971949,22134
"624","ENSGALG00000001651","22",1915804,1919840,4036
"625","ENSGALG00000001652","15",1006141,1036096,29955
"626","ENSGALG00000001653","23",3720827,3723387,2560
"627","ENSGALG00000001654","19",3578323,3580860,2537
"628","ENSGALG00000001655","12",1180932,1183221,2289
"629","ENSGALG00000001658","27",6926456,6929003,2547
"630","ENSGALG00000001661","3",16081562,16095818,14256
"631","ENSGALG00000001662","13",8418800,8471899,53099
"632","ENSGALG00000001663","22",1912618,1915994,3376
"633","ENSGALG00000001664","10",3138069,3142964,4895
"634","ENSGALG00000001666","19",3581614,3584062,2448
"635","ENSGALG00000001668","Z",7304134,7356093,51959
"636","ENSGALG00000001678","8",4668674,4676370,7696
"637","ENSGALG00000001682","27",6930419,6950589,20170
"638","ENSGALG00000001684","18",4078960,4116794,37834
"639","ENSGALG00000001688","15",1038490,1075779,37289
"640","ENSGALG00000001689","10",2858214,2867161,8947
"641","ENSGALG00000001690","13",8067187,8204642,137455
"642","ENSGALG00000001691","21",2344913,2352264,7351
"643","ENSGALG00000001692","17",8478459,8506069,27610
"644","ENSGALG00000001693","22",1905877,1911632,5755
"645","ENSGALG00000001695","13",8003001,8025268,22267
"646","ENSGALG00000001696","9",1368924,1387022,18098
"647","ENSGALG00000001697","12",1203188,1217526,14338
"648","ENSGALG00000001698","13",7912871,7955961,43090
"649","ENSGALG00000001701","21",2351877,2357793,5916
"650","ENSGALG00000001702","11",979152,987407,8255
"651","ENSGALG00000001708","27",6951028,6964451,13423
"652","ENSGALG00000001709","12",1237478,1240970,3492
"653","ENSGALG00000001711","10",2810721,2835077,24356
"654","ENSGALG00000001714","21",2358776,2382647,23871
"655","ENSGALG00000001716","10",2728829,2736012,7183
"656","ENSGALG00000001717","26",3611404,3626345,14941
"657","ENSGALG00000001718","13",7457251,7462872,5621
"658","ENSGALG00000001720","12",1245955,1273175,27220
"659","ENSGALG00000001721","10",2717416,2720401,2985
"660","ENSGALG00000001722","11",988177,1000115,11938
"661","ENSGALG00000001723","8",4677124,4679231,2107
"662","ENSGALG00000001725","18",4009885,4059271,49386
"663","ENSGALG00000001726","13",7452382,7456921,4539
"664","ENSGALG00000001727","22",1887126,1890661,3535
"665","ENSGALG00000001728","17",8388350,8438866,50516
"666","ENSGALG00000001729","10",2705343,2713673,8330
"667","ENSGALG00000001730","9",1387811,1441223,53412
"668","ENSGALG00000001731","27",6965457,6987194,21737
"669","ENSGALG00000001733","26",3637430,3652647,15217
"670","ENSGALG00000001737","19",3596372,3618621,22249
"671","ENSGALG00000001740","18",4171183,4209840,38657
"672","ENSGALG00000001741","10",2643086,2690706,47620
"673","ENSGALG00000001749","28",1746737,1763012,16275
"674","ENSGALG00000001750","13",7426321,7436881,10560
"675","ENSGALG00000001753","12",1279013,1338568,59555
"676","ENSGALG00000001758","17",8319880,8338842,18962
"677","ENSGALG00000001764","10",2482852,2579139,96287
"678","ENSGALG00000001765","Z",68690379,68707323,16944
"679","ENSGALG00000001768","13",5570216,6186858,616642
"680","ENSGALG00000001773","28",1679119,1722626,43507
"681","ENSGALG00000001774","10",2272014,2467955,195941
"682","ENSGALG00000001777","18",4223660,4240761,17101
"683","ENSGALG00000001779","11",1017151,1034057,16906
"684","ENSGALG00000001780","9",1447045,1456329,9284
"685","ENSGALG00000001782","Z",68709133,68726436,17303
"686","ENSGALG00000001788","10",2179000,2190828,11828
"687","ENSGALG00000001790","18",4245590,4247698,2108
"688","ENSGALG00000001791","11",1073448,1076886,3438
"689","ENSGALG00000001792","14",14734417,14736601,2184
"690","ENSGALG00000001793","19",3899838,3920950,21112
"691","ENSGALG00000001797","17",8222353,8272562,50209
"692","ENSGALG00000001798","10",2142296,2176785,34489
"693","ENSGALG00000001800","28",1663794,1670975,7181
"694","ENSGALG00000001801","Z",68726465,68758615,32150
"695","ENSGALG00000001802","18",4247802,4258928,11126
"696","ENSGALG00000001803","9",1466236,1483201,16965
"697","ENSGALG00000001805","18",4261188,4282078,20890
"698","ENSGALG00000001806","28",1615042,1616784,1742
"699","ENSGALG00000001812","28",1582029,1594481,12452
"700","ENSGALG00000001816","26",3668023,3719251,51228
"701","ENSGALG00000001817","11",1107575,1138059,30484
"702","ENSGALG00000001823","1",191772902,191781820,8918
"703","ENSGALG00000001824","11",1164536,1167744,3208
"704","ENSGALG00000001826","13",5502592,5567229,64637
"705","ENSGALG00000001828","19",4263409,4272191,8782
"706","ENSGALG00000001833","19",4277219,4284123,6904
"707","ENSGALG00000001835","21",2453661,2465445,11784
"708","ENSGALG00000001837","19",4287038,4296319,9281
"709","ENSGALG00000001838","22",1658735,1691768,33033
"710","ENSGALG00000001840","Z",68766291,68802701,36410
"711","ENSGALG00000001841","14",14764139,14776196,12057
"712","ENSGALG00000001844","19",4300257,4302289,2032
"713","ENSGALG00000001845","26",3719029,3730042,11013
"714","ENSGALG00000001848","21",2470192,2476038,5846
"715","ENSGALG00000001849","12",2917890,2962756,44866
"716","ENSGALG00000001850","13",5487041,5503846,16805
"717","ENSGALG00000001852","19",4305068,4315416,10348
"718","ENSGALG00000001856","Z",68835617,68871648,36031
"719","ENSGALG00000001857","21",2480437,2496606,16169
"720","ENSGALG00000001859","21",2534192,2535226,1034
"721","ENSGALG00000001860","26",3732468,3746581,14113
"722","ENSGALG00000001862","18",4293769,4305245,11476
"723","ENSGALG00000001863","8",16869042,16889747,20705
"724","ENSGALG00000001864","Z",68919383,68933625,14242
"725","ENSGALG00000001866","14",14794442,14798053,3611
"726","ENSGALG00000001869","Z",69047285,69263974,216689
"727","ENSGALG00000001872","21",2535880,2548699,12819
"728","ENSGALG00000001876","19",4316715,4323669,6954
"729","ENSGALG00000001882","21",2563494,2569802,6308
"730","ENSGALG00000001883","18",4308786,4315058,6272
"731","ENSGALG00000001885","19",4324550,4326231,1681
"732","ENSGALG00000001889","17",8208061,8215543,7482
"733","ENSGALG00000001892","18",4342538,4349605,7067
"734","ENSGALG00000001894","21",2571445,2579572,8127
"735","ENSGALG00000001895","13",5431390,5441421,10031
"736","ENSGALG00000001900","Z",8501025,8509540,8515
"737","ENSGALG00000001901","10",2092692,2140958,48266
"738","ENSGALG00000001905","19",4330097,4357118,27021
"739","ENSGALG00000001907","6",2968233,3091445,123212
"740","ENSGALG00000001912","23",3747602,3776817,29215
"741","ENSGALG00000001916","13",4953827,5426056,472229
"742","ENSGALG00000001917","19",4366910,4375573,8663
"743","ENSGALG00000001918","Z",8525124,8538233,13109
"744","ENSGALG00000001921","17",8190155,8191419,1264
"745","ENSGALG00000001925","15",1232691,1273276,40585
"746","ENSGALG00000001926","19",4403291,4405344,2053
"747","ENSGALG00000001932","19",4415997,4430634,14637
"748","ENSGALG00000001933","Z",70684899,70731502,46603
"749","ENSGALG00000001934","6",3059913,3082527,22614
"750","ENSGALG00000001935","21",2584009,2599090,15081
"751","ENSGALG00000001936","9",1494408,1519920,25512
"752","ENSGALG00000001938","8",1583595,1606906,23311
"753","ENSGALG00000001939","26",3777501,3797196,19695
"754","ENSGALG00000001942","13",4874945,4897890,22945
"755","ENSGALG00000001943","18",4361778,4372525,10747
"756","ENSGALG00000001944","Z",70734902,70754882,19980
"757","ENSGALG00000001945","12",1593635,1640711,47076
"758","ENSGALG00000001946","23",3864606,3877239,12633
"759","ENSGALG00000001947","Z",70755485,70786855,31370
"760","ENSGALG00000001948","28",1454529,1467709,13180
"761","ENSGALG00000001949","19",4434155,4442703,8548
"762","ENSGALG00000001950","17",8184325,8188905,4580
"763","ENSGALG00000001951","8",1608099,1629918,21819
"764","ENSGALG00000001954","Z",70789066,70798064,8998
"765","ENSGALG00000001955","18",4373834,4377659,3825
"766","ENSGALG00000001956","26",3801282,3803089,1807
"767","ENSGALG00000001959","8",1634022,1639776,5754
"768","ENSGALG00000001962","28",2892258,2920771,28513
"769","ENSGALG00000001963","19",4442808,4452005,9197
"770","ENSGALG00000001964","17",8173607,8182744,9137
"771","ENSGALG00000001965","11",1173212,1185606,12394
"772","ENSGALG00000001968","26",3808445,3837071,28626
"773","ENSGALG00000001971","18",4379079,4426613,47534
"774","ENSGALG00000001972","8",1643277,1651368,8091
"775","ENSGALG00000001973","23",3883489,3895651,12162
"776","ENSGALG00000001975","19",4452679,4460489,7810
"777","ENSGALG00000001976","26",3846650,3869273,22623
"778","ENSGALG00000001977","6",3104861,3175701,70840
"779","ENSGALG00000001978","28",2931429,2940550,9121
"780","ENSGALG00000001981","10",2054851,2065812,10961
"781","ENSGALG00000001983","8",1650127,1662816,12689
"782","ENSGALG00000001985","14",13900515,13930696,30181
"783","ENSGALG00000001986","Z",8540925,8562119,21194
"784","ENSGALG00000001988","15",1292445,1327211,34766
"785","ENSGALG00000001992","10",2035713,2053005,17292
"786","ENSGALG00000001994","14",13886338,13889967,3629
"787","ENSGALG00000001995","9",1544087,1557705,13618
"788","ENSGALG00000001996","23",3895254,3898459,3205
"789","ENSGALG00000001998","28",2942189,2947196,5007
"790","ENSGALG00000002000","10",2028436,2035919,7483
"791","ENSGALG00000002001","8",1664383,1690060,25677
"792","ENSGALG00000002002","26",3869575,3872586,3011
"793","ENSGALG00000002003","6",3229366,3305485,76119
"794","ENSGALG00000002008","18",4477544,4493919,16375
"795","ENSGALG00000002010","23",3899030,3901447,2417
"796","ENSGALG00000002012","6",3313775,3317807,4032
"797","ENSGALG00000002013","23",3903590,3909605,6015
"798","ENSGALG00000002014","Z",70810178,70821962,11784
"799","ENSGALG00000002015","6",3338993,3346509,7516
"800","ENSGALG00000002016","12",1720584,1784240,63656
"801","ENSGALG00000002018","14",13807325,13851939,44614
"802","ENSGALG00000002021","23",3918293,3926741,8448
"803","ENSGALG00000002022","Z",70837600,70855202,17602
"804","ENSGALG00000002023","Z",8577948,8591196,13248
"805","ENSGALG00000002024","15",1326281,1366341,40060
"806","ENSGALG00000002028","14",15029907,15042718,12811
"807","ENSGALG00000002029","28",2989377,3000647,11270
"808","ENSGALG00000002033","14",13797492,13799633,2141
"809","ENSGALG00000002038","26",3872602,3887081,14479
"810","ENSGALG00000002042","14",15091186,15101366,10180
"811","ENSGALG00000002043","9",1570319,1577792,7473
"812","ENSGALG00000002044","14",13793041,13797471,4430
"813","ENSGALG00000002046","6",3438309,3449439,11130
"814","ENSGALG00000002048","6",3471874,3474857,2983
"815","ENSGALG00000002050","18",4509081,4529515,20434
"816","ENSGALG00000002053","19",4460358,4486127,25769
"817","ENSGALG00000002055","21",2806116,2808648,2532
"818","ENSGALG00000002056","15",1558449,1575120,16671
"819","ENSGALG00000002057","9",1632534,1635992,3458
"820","ENSGALG00000002060","19",4495336,4513485,18149
"821","ENSGALG00000002062","18",4538742,4552221,13479
"822","ENSGALG00000002064","Z",8592089,8597473,5384
"823","ENSGALG00000002066","6",3479797,3488573,8776
"824","ENSGALG00000002067","14",13782899,13791076,8177
"825","ENSGALG00000002069","Z",8598884,8606934,8050
"826","ENSGALG00000002070","9",1655080,1674567,19487
"827","ENSGALG00000002080","13",4712213,4872139,159926
"828","ENSGALG00000002081","19",4519805,4527564,7759
"829","ENSGALG00000002082","26",3892490,3902220,9730
"830","ENSGALG00000002083","20",1875006,2078239,203233
"831","ENSGALG00000002085","28",1169318,1181306,11988
"832","ENSGALG00000002086","19",4534259,4537686,3427
"833","ENSGALG00000002087","Z",70943793,70975777,31984
"834","ENSGALG00000002088","18",4534834,4536871,2037
"835","ENSGALG00000002089","6",3490435,3508014,17579
"836","ENSGALG00000002090","8",1703384,1727662,24278
"837","ENSGALG00000002091","11",1204008,1206052,2044
"838","ENSGALG00000002093","10",1852294,1855973,3679
"839","ENSGALG00000002094","15",1597453,1604407,6954
"840","ENSGALG00000002095","20",2120742,2142317,21575
"841","ENSGALG00000002097","10",1847504,1849186,1682
"842","ENSGALG00000002098","23",4000662,4069929,69267
"843","ENSGALG00000002099","12",1786656,1827828,41172
"844","ENSGALG00000002102","10",1841767,1843695,1928
"845","ENSGALG00000002103","11",1222442,1224448,2006
"846","ENSGALG00000002105","13",4697667,4701051,3384
"847","ENSGALG00000002106","8",1724671,1738919,14248
"848","ENSGALG00000002107","15",1601083,1613660,12577
"849","ENSGALG00000002108","18",4557242,4573010,15768
"850","ENSGALG00000002110","Z",70975841,70990235,14394
"851","ENSGALG00000002111","14",13715895,13723537,7642
"852","ENSGALG00000002112","23",4160678,4166175,5497
"853","ENSGALG00000002113","13",4598169,4629140,30971
"854","ENSGALG00000002116","18",4582296,4586252,3956
"855","ENSGALG00000002117","6",3507801,3566313,58512
"856","ENSGALG00000002118","13",4533095,4541847,8752
"857","ENSGALG00000002119","14",15104268,15162089,57821
"858","ENSGALG00000002121","21",2857631,2868762,11131
"859","ENSGALG00000002123","23",4171808,4182985,11177
"860","ENSGALG00000002124","15",1614684,1697331,82647
"861","ENSGALG00000002125","Z",70995461,71015584,20123
"862","ENSGALG00000002127","23",4182923,4183988,1065
"863","ENSGALG00000002129","8",1739634,1761181,21547
"864","ENSGALG00000002131","12",1863048,1867162,4114
"865","ENSGALG00000002132","13",4271443,4451078,179635
"866","ENSGALG00000002137","15",1710641,1716042,5401
"867","ENSGALG00000002138","12",1840425,1843438,3013
"868","ENSGALG00000002139","26",3912642,3929915,17273
"869","ENSGALG00000002141","9",1672334,1716213,43879
"870","ENSGALG00000002142","Z",71070879,71152160,81281
"871","ENSGALG00000002143","15",1720652,1738292,17640
"872","ENSGALG00000002144","23",4205132,4226583,21451
"873","ENSGALG00000002145","8",1766235,1826011,59776
"874","ENSGALG00000002147","26",3930482,3935108,4626
"875","ENSGALG00000002150","10",1793936,1820488,26552
"876","ENSGALG00000002151","19",4604718,4607629,2911
"877","ENSGALG00000002152","13",4235928,4257273,21345
"878","ENSGALG00000002155","9",1733842,1899914,166072
"879","ENSGALG00000002157","10",1790978,1793271,2293
"880","ENSGALG00000002158","15",1739403,1761553,22150
"881","ENSGALG00000002159","18",4586308,4604300,17992
"882","ENSGALG00000002160","10",1784065,1786985,2920
"883","ENSGALG00000002162","Z",71167702,71204524,36822
"884","ENSGALG00000002164","8",1826039,1850680,24641
"885","ENSGALG00000002165","Z",8647537,8854699,207162
"886","ENSGALG00000002167","10",1778245,1784620,6375
"887","ENSGALG00000002169","9",2399821,2413850,14029
"888","ENSGALG00000002170","26",3944966,3951972,7006
"889","ENSGALG00000002172","9",2430180,2448079,17899
"890","ENSGALG00000002175","8",1849527,1897406,47879
"891","ENSGALG00000002179","18",4606588,4619745,13157
"892","ENSGALG00000002180","15",1803483,1824720,21237
"893","ENSGALG00000002182","8",1987324,2069077,81753
"894","ENSGALG00000002183","Z",71400261,71505016,104755
"895","ENSGALG00000002186","19",4611887,4620704,8817
"896","ENSGALG00000002187","Z",71751384,71806908,55524
"897","ENSGALG00000002189","10",1765883,1776678,10795
"898","ENSGALG00000002191","13",4053522,4055527,2005
"899","ENSGALG00000002192","8",2418766,2492350,73584
"900","ENSGALG00000002193","9",2459432,2493573,34141
"901","ENSGALG00000002194","18",4620156,4625016,4860
"902","ENSGALG00000002197","13",4020555,4032068,11513
"903","ENSGALG00000002198","11",1344641,1359497,14856
"904","ENSGALG00000002199","21",2873105,2880012,6907
"905","ENSGALG00000002200","14",15208575,15219030,10455
"906","ENSGALG00000002201","14",13658840,13679023,20183
"907","ENSGALG00000002203","13",3919090,4012490,93400
"908","ENSGALG00000002204","15",10363855,10366678,2823
"909","ENSGALG00000002205","15",1850942,1898896,47954
"910","ENSGALG00000002207","8",2500571,2512425,11854
"911","ENSGALG00000002210","10",1762469,1763840,1371
"912","ENSGALG00000002216","8",2565913,2621188,55275
"913","ENSGALG00000002219","18",4640659,4647839,7180
"914","ENSGALG00000002222","21",2886877,2919910,33033
"915","ENSGALG00000002223","8",2669865,2680557,10692
"916","ENSGALG00000002225","19",4627665,4651317,23652
"917","ENSGALG00000002227","Z",71872238,71944766,72528
"918","ENSGALG00000002229","13",3572457,3637749,65292
"919","ENSGALG00000002232","21",3041502,3157181,115679
"920","ENSGALG00000002234","18",4655895,4661873,5978
"921","ENSGALG00000002237","11",1372530,1396927,24397
"922","ENSGALG00000002239","14",15224075,15238698,14623
"923","ENSGALG00000002240","12",2164236,2173206,8970
"924","ENSGALG00000002242","15",2645754,2764117,118363
"925","ENSGALG00000002244","11",1397797,1400275,2478
"926","ENSGALG00000002246","8",2721709,2868051,146342
"927","ENSGALG00000002247","11",1407170,1411255,4085
"928","ENSGALG00000002249","23",4331597,4354226,22629
"929","ENSGALG00000002250","Z",71964912,72039733,74821
"930","ENSGALG00000002253","12",2173269,2204208,30939
"931","ENSGALG00000002260","12",2264031,2268470,4439
"932","ENSGALG00000002262","13",3538939,3563502,24563
"933","ENSGALG00000002263","9",2728404,2746826,18422
"934","ENSGALG00000002266","6",3585026,3633966,48940
"935","ENSGALG00000002267","14",15245851,15263173,17322
"936","ENSGALG00000002272","15",2860822,2871281,10459
"937","ENSGALG00000002273","14",15263057,15273745,10688
"938","ENSGALG00000002276","14",13620156,13627615,7459
"939","ENSGALG00000002277","9",2716647,2771699,55052
"940","ENSGALG00000002278","18",4667774,4704044,36270
"941","ENSGALG00000002282","3",57842516,57843985,1469
"942","ENSGALG00000002283","12",2273248,2315377,42129
"943","ENSGALG00000002284","23",4245909,4251135,5226
"944","ENSGALG00000002285","14",13610665,13618018,7353
"945","ENSGALG00000002286","18",4707277,4709117,1840
"946","ENSGALG00000002287","8",2876608,2906095,29487
"947","ENSGALG00000002288","19",4651809,4667060,15251
"948","ENSGALG00000002289","6",3650070,3681305,31235
"949","ENSGALG00000002294","Z",72764590,72877720,113130
"950","ENSGALG00000002298","23",4279194,4285138,5944
"951","ENSGALG00000002299","6",3712791,3726535,13744
"952","ENSGALG00000002301","11",1413189,1466512,53323
"953","ENSGALG00000002303","6",3740718,3751326,10608
"954","ENSGALG00000002304","23",4288423,4294399,5976
"955","ENSGALG00000002305","8",2975514,2990446,14932
"956","ENSGALG00000002307","6",3758271,3762459,4188
"957","ENSGALG00000002308","Z",72935523,73029710,94187
"958","ENSGALG00000002311","18",4716747,4719610,2863
"959","ENSGALG00000002312","19",4900519,4918418,17899
"960","ENSGALG00000002313","11",1468224,1475359,7135
"961","ENSGALG00000002314","6",3766876,3800358,33482
"962","ENSGALG00000002315","9",2829201,2840634,11433
"963","ENSGALG00000002316","14",13605907,13610327,4420
"964","ENSGALG00000002318","Z",73044444,73078736,34292
"965","ENSGALG00000002319","23",4293444,4298380,4936
"966","ENSGALG00000002321","11",1474237,1485084,10847
"967","ENSGALG00000002325","14",13600259,13604377,4118
"968","ENSGALG00000002326","Z",8885670,8943726,58056
"969","ENSGALG00000002329","19",4939772,4941235,1463
"970","ENSGALG00000002335","12",2360795,2623950,263155
"971","ENSGALG00000002336","15",2872376,2917993,45617
"972","ENSGALG00000002341","Z",73107483,73136810,29327
"973","ENSGALG00000002345","Z",73136596,73140245,3649
"974","ENSGALG00000002346","23",4371910,4385436,13526
"975","ENSGALG00000002347","9",11068310,11088924,20614
"976","ENSGALG00000002350","14",15304269,15344033,39764
"977","ENSGALG00000002354","15",2918623,2923298,4675
"978","ENSGALG00000002356","11",1510105,1514127,4022
"979","ENSGALG00000002358","Z",73146956,73156876,9920
"980","ENSGALG00000002362","12",2631004,2634847,3843
"981","ENSGALG00000002363","13",3514654,3536257,21603
"982","ENSGALG00000002364","17",8149868,8171824,21956
"983","ENSGALG00000002369","8",3032092,3039022,6930
"984","ENSGALG00000002370","6",4939678,4992201,52523
"985","ENSGALG00000002371","Z",8966773,9000212,33439
"986","ENSGALG00000002374","9",10871026,11044696,173670
"987","ENSGALG00000002375","17",8107664,8143170,35506
"988","ENSGALG00000002377","21",3220612,3233063,12451
"989","ENSGALG00000002379","19",4998829,5001580,2751
"990","ENSGALG00000002383","Z",9066022,9069155,3133
"991","ENSGALG00000002386","Z",9080563,9084664,4101
"992","ENSGALG00000002388","19",5001205,5016500,15295
"993","ENSGALG00000002389","18",4720956,4740037,19081
"994","ENSGALG00000002390","21",3234528,3244322,9794
"995","ENSGALG00000002394","Z",9116265,9126065,9800
"996","ENSGALG00000002395","6",5024944,5056345,31401
"997","ENSGALG00000002397","19",5020304,5035592,15288
"998","ENSGALG00000002399","Z",73221628,73232634,11006
"999","ENSGALG00000002403","15",2927966,2996889,68923
"1000","ENSGALG00000002407","11",1545435,1649122,103687
"1001","ENSGALG00000002408","23",4453389,4458518,5129
"1002","ENSGALG00000002412","Z",9126064,9135875,9811
"1003","ENSGALG00000002413","Z",6770918,6823825,52907
"1004","ENSGALG00000002414","6",5059767,5100064,40297
"1005","ENSGALG00000002415","18",4747662,4777163,29501
"1006","ENSGALG00000002417","7",22134066,22137553,3487
"1007","ENSGALG00000002419","Z",6945983,7102689,156706
"1008","ENSGALG00000002421","6",5107187,5115923,8736
"1009","ENSGALG00000002424","18",4777175,4814056,36881
"1010","ENSGALG00000002426","6",5127362,5131035,3673
"1011","ENSGALG00000002427","18",4786057,4801335,15278
"1012","ENSGALG00000002428","14",15355914,15363700,7786
"1013","ENSGALG00000002430","Z",73237469,73242977,5508
"1014","ENSGALG00000002431","8",3040540,3073154,32614
"1015","ENSGALG00000002432","6",5131184,5134863,3679
"1016","ENSGALG00000002437","17",8025526,8031500,5974
"1017","ENSGALG00000002439","Z",73250107,73302354,52247
"1018","ENSGALG00000002442","14",15365556,15370961,5405
"1019","ENSGALG00000002443","14",13556819,13569661,12842
"1020","ENSGALG00000002445","23",4459155,4486555,27400
"1021","ENSGALG00000002447","13",3341061,3448619,107558
"1022","ENSGALG00000002448","19",5035151,5041406,6255
"1023","ENSGALG00000002450","14",13549937,13555202,5265
"1024","ENSGALG00000002452","Z",7195127,7209340,14213
"1025","ENSGALG00000002455","13",3390516,3392394,1878
"1026","ENSGALG00000002457","13",3246934,3338390,91456
"1027","ENSGALG00000002458","11",1649800,1700756,50956
"1028","ENSGALG00000002461","15",3014915,3017600,2685
"1029","ENSGALG00000002463","19",5042463,5047132,4669
"1030","ENSGALG00000002466","21",3244323,3253164,8841
"1031","ENSGALG00000002467","11",1702335,1713816,11481
"1032","ENSGALG00000002469","8",3784395,3878789,94394
"1033","ENSGALG00000002470","7",22414232,22421162,6930
"1034","ENSGALG00000002473","21",3257956,3270047,12091
"1035","ENSGALG00000002478","13",3205699,3231032,25333
"1036","ENSGALG00000002479","6",5149739,5166480,16741
"1037","ENSGALG00000002484","14",15374063,15382016,7953
"1038","ENSGALG00000002485","19",5046563,5053011,6448
"1039","ENSGALG00000002486","12",2761134,2805732,44598
"1040","ENSGALG00000002487","15",3081466,3120971,39505
"1041","ENSGALG00000002488","13",3194141,3201706,7565
"1042","ENSGALG00000002489","17",8009102,8013127,4025
"1043","ENSGALG00000002490","14",15382194,15393648,11454
"1044","ENSGALG00000002492","21",3301148,3309683,8535
"1045","ENSGALG00000002495","19",5051702,5054408,2706
"1046","ENSGALG00000002496","6",5188235,5191519,3284
"1047","ENSGALG00000002497","14",13523068,13537027,13959
"1048","ENSGALG00000002499","23",4494059,4529122,35063
"1049","ENSGALG00000002500","12",2804081,2807450,3369
"1050","ENSGALG00000002501","19",5055814,5067156,11342
"1051","ENSGALG00000002503","6",5196550,5203105,6555
"1052","ENSGALG00000002504","8",3888298,3896277,7979
"1053","ENSGALG00000002506","21",3327693,3354672,26979
"1054","ENSGALG00000002507","6",5216200,5224380,8180
"1055","ENSGALG00000002510","12",2808088,2841720,33632
"1056","ENSGALG00000002511","26",3966988,3974554,7566
"1057","ENSGALG00000002514","23",4538494,4546750,8256
"1058","ENSGALG00000002515","17",7899618,7927026,27408
"1059","ENSGALG00000002517","23",4556794,4557658,864
"1060","ENSGALG00000002519","21",3403876,3423372,19496
"1061","ENSGALG00000002523","Z",9167587,9172144,4557
"1062","ENSGALG00000002524","8",3899466,3912236,12770
"1063","ENSGALG00000002525","6",5430790,5475162,44372
"1064","ENSGALG00000002527","21",3422392,3475582,53190
"1065","ENSGALG00000002528","13",3168035,3179689,11654
"1066","ENSGALG00000002529","Z",73305265,73341429,36164
"1067","ENSGALG00000002531","11",1722517,1750003,27486
"1068","ENSGALG00000002532","23",4593526,4596408,2882
"1069","ENSGALG00000002536","15",3215557,3505480,289923
"1070","ENSGALG00000002539","Z",73473843,73543841,69998
"1071","ENSGALG00000002542","19",5069730,5082830,13100
"1072","ENSGALG00000002543","6",5483503,5512585,29082
"1073","ENSGALG00000002544","13",3130846,3140064,9218
"1074","ENSGALG00000002546","17",7734269,7862385,128116
"1075","ENSGALG00000002548","Z",9172857,9204072,31215
"1076","ENSGALG00000002549","8",3999641,4003821,4180
"1077","ENSGALG00000002550","26",3979543,3982439,2896
"1078","ENSGALG00000002551","14",13473277,13496508,23231
"1079","ENSGALG00000002553","13",2788001,2834253,46252
"1080","ENSGALG00000002554","26",3987326,4005185,17859
"1081","ENSGALG00000002555","6",5520195,5598425,78230
"1082","ENSGALG00000002556","26",4027554,4047830,20276
"1083","ENSGALG00000002557","15",3354437,3473621,119184
"1084","ENSGALG00000002558","19",5095412,5104199,8787
"1085","ENSGALG00000002561","26",4080001,4083104,3103
"1086","ENSGALG00000002562","13",2689768,2705890,16122
"1087","ENSGALG00000002563","28",4532733,4540968,8235
"1088","ENSGALG00000002564","8",4066661,4072187,5526
"1089","ENSGALG00000002569","15",3483355,3487600,4245
"1090","ENSGALG00000002570","13",2687360,2689815,2455
"1091","ENSGALG00000002576","19",5082064,5091544,9480
"1092","ENSGALG00000002577","13",2709040,2714533,5493
"1093","ENSGALG00000002578","Z",9221379,9225735,4356
"1094","ENSGALG00000002579","15",3506970,3627749,120779
"1095","ENSGALG00000002581","8",4083518,4086151,2633
"1096","ENSGALG00000002583","21",3475568,3498330,22762
"1097","ENSGALG00000002587","19",5108134,5143381,35247
"1098","ENSGALG00000002588","26",4087851,4102719,14868
"1099","ENSGALG00000002591","28",3032188,3034572,2384
"1100","ENSGALG00000002594","7",999492,1117976,118484
"1101","ENSGALG00000002595","28",3034833,3036390,1557
"1102","ENSGALG00000002597","14",13469982,13472376,2394
"1103","ENSGALG00000002598","19",5111091,5168955,57864
"1104","ENSGALG00000002599","Z",9282572,9296247,13675
"1105","ENSGALG00000002603","11",1751185,1765843,14658
"1106","ENSGALG00000002605","Z",9297716,9298745,1029
"1107","ENSGALG00000002606","21",3498472,3533136,34664
"1108","ENSGALG00000002610","14",13466193,13472225,6032
"1109","ENSGALG00000002612","9",10778211,10814015,35804
"1110","ENSGALG00000002615","26",4108401,4119816,11415
"1111","ENSGALG00000002616","21",3576339,3587213,10874
"1112","ENSGALG00000002618","19",5171753,5178604,6851
"1113","ENSGALG00000002621","28",3737181,3755054,17873
"1114","ENSGALG00000002622","13",2681277,2686153,4876
"1115","ENSGALG00000002623","9",10713989,10733607,19618
"1116","ENSGALG00000002624","6",5785245,5805815,20570
"1117","ENSGALG00000002630","26",4121528,4129739,8211
"1118","ENSGALG00000002631","19",5234532,5284091,49559
"1119","ENSGALG00000002632","7",1118003,1183599,65596
"1120","ENSGALG00000002634","13",2655521,2670468,14947
"1121","ENSGALG00000002637","21",3596396,3598338,1942
"1122","ENSGALG00000002638","6",5829189,5856130,26941
"1123","ENSGALG00000002639","9",10687964,10708703,20739
"1124","ENSGALG00000002643","8",4090730,4097363,6633
"1125","ENSGALG00000002644","26",4130378,4134782,4404
"1126","ENSGALG00000002645","15",3630416,3647097,16681
"1127","ENSGALG00000002646","7",1316651,1326910,10259
"1128","ENSGALG00000002647","9",10648483,10686787,38304
"1129","ENSGALG00000002648","11",1766723,1770224,3501
"1130","ENSGALG00000002649","21",3600704,3636748,36044
"1131","ENSGALG00000002651","11",1776442,1780422,3980
"1132","ENSGALG00000002653","19",5293364,5308527,15163
"1133","ENSGALG00000002655","7",1348987,1399109,50122
"1134","ENSGALG00000002656","19",5312374,5325437,13063
"1135","ENSGALG00000002659","17",7495903,7507682,11779
"1136","ENSGALG00000002661","19",5330957,5350899,19942
"1137","ENSGALG00000002663","9",10612524,10648117,35593
"1138","ENSGALG00000002666","14",13409979,13450780,40801
"1139","ENSGALG00000002667","8",4172583,4181579,8996
"1140","ENSGALG00000002671","15",3797791,3988984,191193
"1141","ENSGALG00000002675","26",4137342,4159954,22612
"1142","ENSGALG00000002678","10",3160778,3172796,12018
"1143","ENSGALG00000002679","15",4008082,4050199,42117
"1144","ENSGALG00000002682","17",7458700,7488415,29715
"1145","ENSGALG00000002683","14",13403863,13409668,5805
"1146","ENSGALG00000002686","6",5904366,5912683,8317
"1147","ENSGALG00000002689","7",2249420,2257089,7669
"1148","ENSGALG00000002690","11",1783777,1801364,17587
"1149","ENSGALG00000002692","26",4178714,4184847,6133
"1150","ENSGALG00000002693","6",5912791,5925081,12290
"1151","ENSGALG00000002695","15",4053657,4075057,21400
"1152","ENSGALG00000002699","17",7348639,7446893,98254
"1153","ENSGALG00000002701","6",5926431,5929549,3118
"1154","ENSGALG00000002703","6",5929986,5935003,5017
"1155","ENSGALG00000002705","6",5951613,5961190,9577
"1156","ENSGALG00000002706","9",10579299,10611437,32138
"1157","ENSGALG00000002707","25",2949573,2954364,4791
"1158","ENSGALG00000002708","10",3212741,3290778,78037
"1159","ENSGALG00000002709","19",5352851,5403539,50688
"1160","ENSGALG00000002710","6",5966532,5997073,30541
"1161","ENSGALG00000002714","15",4100056,4278736,178680
"1162","ENSGALG00000002719","18",4841362,4862572,21210
"1163","ENSGALG00000002722","12",2901547,2905708,4161
"1164","ENSGALG00000002723","26",4191024,4271626,80602
"1165","ENSGALG00000002725","8",4203923,4207433,3510
"1166","ENSGALG00000002726","21",3645371,3721077,75706
"1167","ENSGALG00000002728","18",4866126,4876014,9888
"1168","ENSGALG00000002729","9",10550183,10571324,21141
"1169","ENSGALG00000002734","8",4207866,4220980,13114
"1170","ENSGALG00000002735","26",4272223,4275688,3465
"1171","ENSGALG00000002739","19",5408476,5424636,16160
"1172","ENSGALG00000002742","15",4562927,4746811,183884
"1173","ENSGALG00000002744","6",7005075,7303413,298338
"1174","ENSGALG00000002750","7",2277081,2327746,50665
"1175","ENSGALG00000002759","10",3510449,3538948,28499
"1176","ENSGALG00000002761","6",7315727,7337324,21597
"1177","ENSGALG00000002762","26",4279568,4303482,23914
"1178","ENSGALG00000002763","7",2337402,2352802,15400
"1179","ENSGALG00000002764","9",10461236,10501942,40706
"1180","ENSGALG00000002765","27",7990870,8009225,18355
"1181","ENSGALG00000002766","11",1886612,1890948,4336
"1182","ENSGALG00000002769","6",7337219,7349970,12751
"1183","ENSGALG00000002771","8",4371681,4375045,3364
"1184","ENSGALG00000002773","26",4305415,4310043,4628
"1185","ENSGALG00000002774","10",3562039,3587603,25564
"1186","ENSGALG00000002775","11",1892371,1901853,9482
"1187","ENSGALG00000002781","27",7970099,7990457,20358
"1188","ENSGALG00000002783","19",5454360,5480180,25820
"1189","ENSGALG00000002784","12",2910044,2914156,4112
"1190","ENSGALG00000002786","10",3594815,3641597,46782
"1191","ENSGALG00000002789","7",2471804,2577364,105560
"1192","ENSGALG00000002790","13",9263565,9297986,34421
"1193","ENSGALG00000002792","26",4351853,4357451,5598
"1194","ENSGALG00000002797","21",3724856,3734646,9790
"1195","ENSGALG00000002798","11",1901047,1949555,48508
"1196","ENSGALG00000002800","9",10425071,10442463,17392
"1197","ENSGALG00000002802","26",4359456,4369874,10418
"1198","ENSGALG00000002803","8",4396089,4462422,66333
"1199","ENSGALG00000002804","27",7945964,7960601,14637
"1200","ENSGALG00000002813","26",4376564,4382087,5523
"1201","ENSGALG00000002816","13",9525284,9568153,42869
"1202","ENSGALG00000002818","27",7935605,7944619,9014
"1203","ENSGALG00000002820","21",3741291,3744957,3666
"1204","ENSGALG00000002827","18",4966111,4976221,10110
"1205","ENSGALG00000002830","26",4383940,4403978,20038
"1206","ENSGALG00000002831","13",9572001,9637277,65276
"1207","ENSGALG00000002832","27",7921645,7924699,3054
"1208","ENSGALG00000002836","21",3745002,3826918,81916
"1209","ENSGALG00000002837","27",7918185,7920899,2714
"1210","ENSGALG00000002840","26",4440323,4474302,33979
"1211","ENSGALG00000002841","18",4976515,4983928,7413
"1212","ENSGALG00000002843","19",5487858,5491925,4067
"1213","ENSGALG00000002845","6",7369397,7806023,436626
"1214","ENSGALG00000002846","13",9642877,9751876,108999
"1215","ENSGALG00000002848","26",4556844,4562416,5572
"1216","ENSGALG00000002849","18",4985113,4988234,3121
"1217","ENSGALG00000002850","9",10367568,10409827,42259
"1218","ENSGALG00000002853","11",1980933,2031846,50913
"1219","ENSGALG00000002854","Z",9455347,9647483,192136
"1220","ENSGALG00000002855","17",7335774,7343652,7878
"1221","ENSGALG00000002856","27",7914430,7918149,3719
"1222","ENSGALG00000002860","26",4573412,4579852,6440
"1223","ENSGALG00000002861","11",2032092,2036216,4124
"1224","ENSGALG00000002863","13",9797415,9852537,55122
"1225","ENSGALG00000002864","6",7492006,7573415,81409
"1226","ENSGALG00000002866","7",2714508,2770441,55933
"1227","ENSGALG00000002868","13",9856065,9860391,4326
"1228","ENSGALG00000002870","26",4584396,4595231,10835
"1229","ENSGALG00000002877","18",4994148,5003643,9495
"1230","ENSGALG00000002878","13",9873168,9892226,19058
"1231","ENSGALG00000002880","27",7907883,7912277,4394
"1232","ENSGALG00000002881","26",4615270,4620658,5388
"1233","ENSGALG00000002882","13",9897119,9902358,5239
"1234","ENSGALG00000002883","10",3662745,3799455,136710
"1235","ENSGALG00000002886","13",9921886,9924100,2214
"1236","ENSGALG00000002888","21",3830441,3953755,123314
"1237","ENSGALG00000002891","7",2771932,2785778,13846
"1238","ENSGALG00000002892","6",8441148,8461055,19907
"1239","ENSGALG00000002893","13",9947853,9957394,9541
"1240","ENSGALG00000002897","9",10296206,10307893,11687
"1241","ENSGALG00000002899","15",4746626,4784057,37431
"1242","ENSGALG00000002900","18",5048916,5054527,5611
"1243","ENSGALG00000002904","6",8461693,8499207,37514
"1244","ENSGALG00000002906","21",4071151,4076774,5623
"1245","ENSGALG00000002907","7",2795396,2813128,17732
"1246","ENSGALG00000002908","12",2972533,2990373,17840
"1247","ENSGALG00000002911","3",56993933,57046070,52137
"1248","ENSGALG00000002913","15",4786518,4789593,3075
"1249","ENSGALG00000002919","12",3011044,3015929,4885
"1250","ENSGALG00000002921","7",2826403,2842090,15687
"1251","ENSGALG00000002922","8",4546230,4625309,79079
"1252","ENSGALG00000002925","10",3810178,3840160,29982
"1253","ENSGALG00000002929","9",10169029,10271674,102645
"1254","ENSGALG00000002931","8",4626888,4628302,1414
"1255","ENSGALG00000002932","18",5064083,5066287,2204
"1256","ENSGALG00000002937","27",7879741,7886805,7064
"1257","ENSGALG00000002942","6",8516356,8663452,147096
"1258","ENSGALG00000002943","19",5492009,5509846,17837
"1259","ENSGALG00000002944","7",2842238,2943240,101002
"1260","ENSGALG00000002945","10",3840816,3896080,55264
"1261","ENSGALG00000002952","10",3918768,3940587,21819
"1262","ENSGALG00000002954","18",5066741,5096291,29550
"1263","ENSGALG00000002955","17",7269757,7290205,20448
"1264","ENSGALG00000002957","11",2036749,2043464,6715
"1265","ENSGALG00000002958","9",10092468,10198054,105586
"1266","ENSGALG00000002959","6",8670653,8685139,14486
"1267","ENSGALG00000002960","8",4627165,4632645,5480
"1268","ENSGALG00000002963","9",9999445,10077916,78471
"1269","ENSGALG00000002964","15",4787567,4803782,16215
"1270","ENSGALG00000002967","6",8889016,8904914,15898
"1271","ENSGALG00000002968","20",2146538,2166147,19609
"1272","ENSGALG00000002969","28",3605676,3618416,12740
"1273","ENSGALG00000002971","13",10924239,10966316,42077
"1274","ENSGALG00000002973","27",7874990,7879971,4981
"1275","ENSGALG00000002974","9",9726068,9792058,65990
"1276","ENSGALG00000002980","6",8832056,8953024,120968
"1277","ENSGALG00000002981","14",1071961,1082730,10769
"1278","ENSGALG00000002982","17",7235916,7240174,4258
"1279","ENSGALG00000002984","13",10916142,10918396,2254
"1280","ENSGALG00000002985","18",5095894,5104494,8600
"1281","ENSGALG00000002987","19",5543842,5551420,7578
"1282","ENSGALG00000002988","8",4633303,4636689,3386
"1283","ENSGALG00000002990","13",10914280,10916096,1816
"1284","ENSGALG00000002992","9",9704805,9721804,16999
"1285","ENSGALG00000002993","18",5153057,5313472,160415
"1286","ENSGALG00000003003","9",9693543,9695640,2097
"1287","ENSGALG00000003005","10",4055376,4067927,12551
"1288","ENSGALG00000003010","11",2046725,2117520,70795
"1289","ENSGALG00000003011","18",5812118,5833003,20885
"1290","ENSGALG00000003013","6",9115242,9166926,51684
"1291","ENSGALG00000003014","10",4073313,4080153,6840
"1292","ENSGALG00000003015","19",5554574,5561459,6885
"1293","ENSGALG00000003016","21",4078712,4105097,26385
"1294","ENSGALG00000003021","10",4080158,4092860,12702
"1295","ENSGALG00000003022","8",4675696,4682832,7136
"1296","ENSGALG00000003024","28",3755802,3761970,6168
"1297","ENSGALG00000003025","9",9667482,9672242,4760
"1298","ENSGALG00000003026","14",1142254,1156542,14288
"1299","ENSGALG00000003029","8",4683627,4686254,2627
"1300","ENSGALG00000003031","19",5561964,5568555,6591
"1301","ENSGALG00000003033","18",5836752,5890639,53887
"1302","ENSGALG00000003034","21",4105253,4109012,3759
"1303","ENSGALG00000003035","8",4686653,4690632,3979
"1304","ENSGALG00000003039","21",4116739,4124448,7709
"1305","ENSGALG00000003042","20",2166028,2172601,6573
"1306","ENSGALG00000003045","20",2177137,2180913,3776
"1307","ENSGALG00000003046","10",4097848,4102983,5135
"1308","ENSGALG00000003047","28",3761765,3772296,10531
"1309","ENSGALG00000003052","9",9629184,9664692,35508
"1310","ENSGALG00000003053","8",4695523,4702534,7011
"1311","ENSGALG00000003058","28",3777894,3786314,8420
"1312","ENSGALG00000003059","18",5906620,5937242,30622
"1313","ENSGALG00000003063","10",4103099,4108004,4905
"1314","ENSGALG00000003065","20",2183024,2207161,24137
"1315","ENSGALG00000003067","9",9611815,9614811,2996
"1316","ENSGALG00000003068","27",7833491,7847657,14166
"1317","ENSGALG00000003071","11",2147564,2155667,8103
"1318","ENSGALG00000003072","19",5568657,5590184,21527
"1319","ENSGALG00000003073","6",9336702,9386648,49946
"1320","ENSGALG00000003074","28",3790233,3811820,21587
"1321","ENSGALG00000003075","13",10834101,10837807,3706
"1322","ENSGALG00000003076","8",4846877,4850856,3979
"1323","ENSGALG00000003078","18",5945780,5973025,27245
"1324","ENSGALG00000003079","9",9588160,9610296,22136
"1325","ENSGALG00000003081","8",4860575,4897990,37415
"1326","ENSGALG00000003082","19",5643569,5658310,14741
"1327","ENSGALG00000003084","11",2155240,2162490,7250
"1328","ENSGALG00000003085","6",9409873,9417895,8022
"1329","ENSGALG00000003086","21",4123703,4138661,14958
"1330","ENSGALG00000003091","14",1197084,1231716,34632
"1331","ENSGALG00000003092","22",2492103,2501587,9484
"1332","ENSGALG00000003096","20",2208406,2258331,49925
"1333","ENSGALG00000003099","18",6021507,6028831,7324
"1334","ENSGALG00000003101","22",2504687,2508843,4156
"1335","ENSGALG00000003103","12",3002525,3009824,7299
"1336","ENSGALG00000003105","18",6106146,6162953,56807
"1337","ENSGALG00000003106","20",2300399,2414076,113677
"1338","ENSGALG00000003107","11",2162212,2182455,20243
"1339","ENSGALG00000003108","19",5675613,5773312,97699
"1340","ENSGALG00000003111","14",1232513,1241144,8631
"1341","ENSGALG00000003113","13",10825770,10832208,6438
"1342","ENSGALG00000003114","18",6187592,6189553,1961
"1343","ENSGALG00000003118","22",2510164,2527342,17178
"1344","ENSGALG00000003120","15",4858160,5021986,163826
"1345","ENSGALG00000003122","14",2776904,2780273,3369
"1346","ENSGALG00000003123","27",7823872,7832297,8425
"1347","ENSGALG00000003124","22",2527806,2530973,3167
"1348","ENSGALG00000003126","7",3087685,3490215,402530
"1349","ENSGALG00000003128","20",2544324,2553966,9642
"1350","ENSGALG00000003129","22",2532722,2543452,10730
"1351","ENSGALG00000003130","28",3818740,3824430,5690
"1352","ENSGALG00000003131","18",6259783,6271406,11623
"1353","ENSGALG00000003134","13",10823042,10824827,1785
"1354","ENSGALG00000003135","6",9421563,9766762,345199
"1355","ENSGALG00000003136","7",3660255,3763201,102946
"1356","ENSGALG00000003137","15",5036041,5046876,10835
"1357","ENSGALG00000003138","12",19681376,19684780,3404
"1358","ENSGALG00000003142","22",2545037,2547478,2441
"1359","ENSGALG00000003143","14",1270001,1291042,21041
"1360","ENSGALG00000003144","18",6279757,6287152,7395
"1361","ENSGALG00000003146","15",5140595,5154005,13410
"1362","ENSGALG00000003147","20",2557331,2590035,32704
"1363","ENSGALG00000003148","7",3803059,4151276,348217
"1364","ENSGALG00000003149","26",4621920,4659150,37230
"1365","ENSGALG00000003153","28",3824581,3829413,4832
"1366","ENSGALG00000003154","14",1292131,1312468,20337
"1367","ENSGALG00000003155","19",5765094,5766811,1717
"1368","ENSGALG00000003160","28",3831598,3842053,10455
"1369","ENSGALG00000003161","28",3843368,3845601,2233
"1370","ENSGALG00000003162","27",7795407,7801973,6566
"1371","ENSGALG00000003163","11",2204172,2321739,117567
"1372","ENSGALG00000003164","8",5049545,5081020,31475
"1373","ENSGALG00000003165","6",9774397,9819482,45085
"1374","ENSGALG00000003168","Z",9711679,9742308,30629
"1375","ENSGALG00000003169","11",2344366,2385704,41338
"1376","ENSGALG00000003172","6",9839922,9859361,19439
"1377","ENSGALG00000003174","23",5047674,5051256,3582
"1378","ENSGALG00000003175","17",7193290,7201244,7954
"1379","ENSGALG00000003176","6",9874825,9877832,3007
"1380","ENSGALG00000003179","21",4174743,4179124,4381
"1381","ENSGALG00000003181","17",7172768,7175847,3079
"1382","ENSGALG00000003183","11",2391861,2425403,33542
"1383","ENSGALG00000003185","18",6293718,6304458,10740
"1384","ENSGALG00000003189","23",5059841,5087792,27951
"1385","ENSGALG00000003193","10",4148571,4161467,12896
"1386","ENSGALG00000003194","15",5211809,5226925,15116
"1387","ENSGALG00000003195","11",2445774,2456359,10585
"1388","ENSGALG00000003196","6",9949854,9959635,9781
"1389","ENSGALG00000003197","17",7165127,7168878,3751
"1390","ENSGALG00000003199","27",7786835,7790716,3881
"1391","ENSGALG00000003201","11",2455977,2460100,4123
"1392","ENSGALG00000003203","12",3079182,3080283,1101
"1393","ENSGALG00000003204","17",7158851,7165164,6313
"1394","ENSGALG00000003205","22",2560417,2565086,4669
"1395","ENSGALG00000003206","8",5082577,5087008,4431
"1396","ENSGALG00000003208","11",19898209,19912789,14580
"1397","ENSGALG00000003211","19",5773507,5782898,9391
"1398","ENSGALG00000003212","26",4698648,4703751,5103
"1399","ENSGALG00000003213","1",51206946,51218711,11765
"1400","ENSGALG00000003217","14",1329782,1337607,7825
"1401","ENSGALG00000003219","11",19912202,19917951,5749
"1402","ENSGALG00000003220","28",3849564,3866418,16854
"1403","ENSGALG00000003221","10",4160976,4188318,27342
"1404","ENSGALG00000003224","11",2460701,2475384,14683
"1405","ENSGALG00000003226","26",4710399,4718290,7891
"1406","ENSGALG00000003227","18",6309446,6396232,86786
"1407","ENSGALG00000003228","26",4719126,4722373,3247
"1408","ENSGALG00000003233","22",2571212,2578623,7411
"1409","ENSGALG00000003235","Z",9754369,9793178,38809
"1410","ENSGALG00000003238","28",1354469,1369557,15088
"1411","ENSGALG00000003241","23",5312890,5314715,1825
"1412","ENSGALG00000003242","22",2578576,2581509,2933
"1413","ENSGALG00000003243","12",3083014,3119482,36468
"1414","ENSGALG00000003245","22",2583326,2584747,1421
"1415","ENSGALG00000003247","26",4722844,4737094,14250
"1416","ENSGALG00000003248","Z",9801245,9816238,14993
"1417","ENSGALG00000003249","6",9967532,10003120,35588
"1418","ENSGALG00000003250","8",5087422,5091070,3648
"1419","ENSGALG00000003254","22",2584892,2587870,2978
"1420","ENSGALG00000003256","27",7749490,7777682,28192
"1421","ENSGALG00000003258","11",2479810,2493248,13438
"1422","ENSGALG00000003259","15",5240730,5244581,3851
"1423","ENSGALG00000003260","18",6568827,6578597,9770
"1424","ENSGALG00000003261","27",7732348,7746653,14305
"1425","ENSGALG00000003265","23",5210834,5228269,17435
"1426","ENSGALG00000003267","27",7716059,7727343,11284
"1427","ENSGALG00000003272","23",5230360,5245209,14849
"1428","ENSGALG00000003273","11",2493276,2499485,6209
"1429","ENSGALG00000003281","20",2624555,2632499,7944
"1430","ENSGALG00000003282","27",7694496,7699792,5296
"1431","ENSGALG00000003283","28",3881306,3901182,19876
"1432","ENSGALG00000003284","18",6608206,6621462,13256
"1433","ENSGALG00000003285","13",11074501,11082223,7722
"1434","ENSGALG00000003286","10",4198612,4227772,29160
"1435","ENSGALG00000003287","23",5251644,5259470,7826
"1436","ENSGALG00000003288","Z",10102092,10116802,14710
"1437","ENSGALG00000003293","11",2501626,2526862,25236
"1438","ENSGALG00000003294","18",6621921,6637172,15251
"1439","ENSGALG00000003295","Z",10140727,10313424,172697
"1440","ENSGALG00000003297","23",5272426,5285757,13331
"1441","ENSGALG00000003298","15",5244199,5251014,6815
"1442","ENSGALG00000003299","22",2604802,2634066,29264
"1443","ENSGALG00000003301","23",5293606,5294513,907
"1444","ENSGALG00000003302","11",2527643,2531674,4031
"1445","ENSGALG00000003304","28",3909947,3943089,33142
"1446","ENSGALG00000003307","15",5251373,5257346,5973
"1447","ENSGALG00000003308","6",10003715,10019905,16190
"1448","ENSGALG00000003310","Z",10331208,10346031,14823
"1449","ENSGALG00000003313","23",5295424,5299538,4114
"1450","ENSGALG00000003314","15",5258917,5277195,18278
"1451","ENSGALG00000003318","15",5262284,5281948,19664
"1452","ENSGALG00000003319","18",6639244,6650095,10851
"1453","ENSGALG00000003321","15",5282073,5285226,3153
"1454","ENSGALG00000003322","10",4293509,4313367,19858
"1455","ENSGALG00000003323","11",2532308,2633462,101154
"1456","ENSGALG00000003324","8",5216524,5248858,32334
"1457","ENSGALG00000003325","15",5287583,5295697,8114
"1458","ENSGALG00000003326","Z",10347410,10368350,20940
"1459","ENSGALG00000003329","8",5269307,5278242,8935
"1460","ENSGALG00000003331","13",11098999,11113445,14446
"1461","ENSGALG00000003333","27",7690790,7694475,3685
"1462","ENSGALG00000003336","10",4326596,4365657,39061
"1463","ENSGALG00000003337","23",5299800,5304088,4288
"1464","ENSGALG00000003339","21",4138682,4198915,60233
"1465","ENSGALG00000003340","17",7130052,7137248,7196
"1466","ENSGALG00000003344","13",11113461,11120397,6936
"1467","ENSGALG00000003345","27",7678129,7689239,11110
"1468","ENSGALG00000003348","13",11121563,11122199,636
"1469","ENSGALG00000003349","22",2719080,2729173,10093
"1470","ENSGALG00000003353","Z",10460141,10544706,84565
"1471","ENSGALG00000003354","27",7667566,7676495,8929
"1472","ENSGALG00000003355","13",11122341,11124691,2350
"1473","ENSGALG00000003356","22",2731653,2733379,1726
"1474","ENSGALG00000003357","28",3991121,3997724,6603
"1475","ENSGALG00000003358","21",4200628,4206138,5510
"1476","ENSGALG00000003359","27",7656881,7668808,11927
"1477","ENSGALG00000003360","13",11124638,11127201,2563
"1478","ENSGALG00000003361","26",4741023,4747509,6486
"1479","ENSGALG00000003362","20",2633593,2665223,31630
"1480","ENSGALG00000003365","Z",10557632,10563411,5779
"1481","ENSGALG00000003369","27",7646435,7652243,5808
"1482","ENSGALG00000003370","13",11127919,11135666,7747
"1483","ENSGALG00000003373","Z",10563505,10567859,4354
"1484","ENSGALG00000003374","11",3254661,3298212,43551
"1485","ENSGALG00000003377","13",11137633,11143985,6352
"1486","ENSGALG00000003378","14",1349084,1352298,3214
"1487","ENSGALG00000003381","10",4402619,4479564,76945
"1488","ENSGALG00000003383","23",5323393,5339496,16103
"1489","ENSGALG00000003385","28",4068722,4075053,6331
"1490","ENSGALG00000003387","Z",10575852,10577897,2045
"1491","ENSGALG00000003391","14",1363474,1379693,16219
"1492","ENSGALG00000003392","15",5299498,5328661,29163
"1493","ENSGALG00000003396","11",3320835,3378444,57609
"1494","ENSGALG00000003397","18",6650286,6673539,23253
"1495","ENSGALG00000003398","22",2737380,2757692,20312
"1496","ENSGALG00000003400","14",1379901,1382292,2391
"1497","ENSGALG00000003403","27",7580080,7589611,9531
"1498","ENSGALG00000003405","23",5342394,5348814,6420
"1499","ENSGALG00000003408","23",5263950,5353331,89381
"1500","ENSGALG00000003409","20",2669019,2694181,25162
"1501","ENSGALG00000003412","17",7090031,7108362,18331
"1502","ENSGALG00000003416","1",197379735,197386740,7005
"1503","ENSGALG00000003419","15",5364336,5380950,16614
"1504","ENSGALG00000003420","23",5358716,5363244,4528
"1505","ENSGALG00000003424","8",5540636,5563972,23336
"1506","ENSGALG00000003425","11",3427529,3442713,15184
"1507","ENSGALG00000003426","18",6678071,6721351,43280
"1508","ENSGALG00000003427","10",4490788,4524948,34160
"1509","ENSGALG00000003428","28",4104469,4114609,10140
"1510","ENSGALG00000003429","8",5588882,5693333,104451
"1511","ENSGALG00000003430","14",1382543,1394283,11740
"1512","ENSGALG00000003432","Z",10583389,10597099,13710
"1513","ENSGALG00000003433","11",3459157,3474477,15320
"1514","ENSGALG00000003434","18",6726265,6731088,4823
"1515","ENSGALG00000003435","26",4946576,4950586,4010
"1516","ENSGALG00000003438","8",5837470,5849103,11633
"1517","ENSGALG00000003439","21",4207169,4227450,20281
"1518","ENSGALG00000003441","17",7080384,7087304,6920
"1519","ENSGALG00000003443","8",5849184,5851743,2559
"1520","ENSGALG00000003445","8",5849191,5858523,9332
"1521","ENSGALG00000003446","Z",10610212,10705011,94799
"1522","ENSGALG00000003447","26",4956769,4965400,8631
"1523","ENSGALG00000003454","18",6731429,6743995,12566
"1524","ENSGALG00000003456","10",4543071,4556711,13640
"1525","ENSGALG00000003457","27",7553413,7558599,5186
"1526","ENSGALG00000003458","14",1408659,1422508,13849
"1527","ENSGALG00000003461","26",4986067,5018796,32729
"1528","ENSGALG00000003462","14",1425959,1429348,3389
"1529","ENSGALG00000003464","27",7544945,7553226,8281
"1530","ENSGALG00000003466","1",62141900,62159550,17650
"1531","ENSGALG00000003467","26",5026434,5029084,2650
"1532","ENSGALG00000003470","22",2825849,2861391,35542
"1533","ENSGALG00000003472","7",4153280,4189147,35867
"1534","ENSGALG00000003473","22",2877954,2888842,10888
"1535","ENSGALG00000003474","26",5021528,5026376,4848
"1536","ENSGALG00000003475","27",7521200,7545007,23807
"1537","ENSGALG00000003476","18",6755211,6787645,32434
"1538","ENSGALG00000003478","17",7053329,7062205,8876
"1539","ENSGALG00000003483","22",2899324,2903254,3930
"1540","ENSGALG00000003484","7",4211052,4254224,43172
"1541","ENSGALG00000003485","26",5030630,5043220,12590
"1542","ENSGALG00000003487","10",4563114,4590828,27714
"1543","ENSGALG00000003492","22",2903466,2911854,8388
"1544","ENSGALG00000003495","8",5858744,5866421,7677
"1545","ENSGALG00000003496","18",6791861,6805476,13615
"1546","ENSGALG00000003498","26",5068732,5076378,7646
"1547","ENSGALG00000003499","28",4120115,4138482,18367
"1548","ENSGALG00000003500","17",7036633,7041507,4874
"1549","ENSGALG00000003503","20",3612403,3627085,14682
"1550","ENSGALG00000003505","10",4602240,4609086,6846
"1551","ENSGALG00000003507","14",1515927,1534922,18995
"1552","ENSGALG00000003509","17",7014967,7020150,5183
"1553","ENSGALG00000003510","8",5888634,5903888,15254
"1554","ENSGALG00000003512","13",11280457,11286010,5553
"1555","ENSGALG00000003517","23",5371267,5376872,5605
"1556","ENSGALG00000003518","22",2911977,2921567,9590
"1557","ENSGALG00000003519","26",5083108,5085044,1936
"1558","ENSGALG00000003520","18",6878337,6885109,6772
"1559","ENSGALG00000003521","10",4617488,4636539,19051
"1560","ENSGALG00000003522","23",5376041,5383122,7081
"1561","ENSGALG00000003523","20",3630048,3642568,12520
"1562","ENSGALG00000003526","6",10033025,10057694,24669
"1563","ENSGALG00000003527","28",4148246,4156109,7863
"1564","ENSGALG00000003529","23",5383539,5388690,5151
"1565","ENSGALG00000003532","18",6885268,6892792,7524
"1566","ENSGALG00000003533","6",10057707,10062489,4782
"1567","ENSGALG00000003536","27",7517127,7520296,3169
"1568","ENSGALG00000003537","20",3642072,3654543,12471
"1569","ENSGALG00000003539","23",5393111,5412913,19802
"1570","ENSGALG00000003540","18",6895937,6909697,13760
"1571","ENSGALG00000003545","17",6827636,6880154,52518
"1572","ENSGALG00000003547","Z",10978967,10990022,11055
"1573","ENSGALG00000003548","14",1552022,1586667,34645
"1574","ENSGALG00000003549","6",10069198,10071589,2391
"1575","ENSGALG00000003550","20",3697349,3734407,37058
"1576","ENSGALG00000003553","7",4266278,4345086,78808
"1577","ENSGALG00000003554","26",5176373,5179960,3587
"1578","ENSGALG00000003557","6",10074805,10081046,6241
"1579","ENSGALG00000003558","Z",10992888,11023261,30373
"1580","ENSGALG00000003559","20",3738686,3748958,10272
"1581","ENSGALG00000003560","11",3571368,3634461,63093
"1582","ENSGALG00000003562","14",1586869,1639631,52762
"1583","ENSGALG00000003563","23",5412996,5417808,4812
"1584","ENSGALG00000003566","18",6912721,6941858,29137
"1585","ENSGALG00000003567","23",5427586,5438486,10900
"1586","ENSGALG00000003568","20",3767099,3812479,45380
"1587","ENSGALG00000003569","14",1712152,1721236,9084
"1588","ENSGALG00000003570","7",4368941,4386891,17950
"1589","ENSGALG00000003572","28",4172075,4211793,39718
"1590","ENSGALG00000003573","23",5443485,5446113,2628
"1591","ENSGALG00000003574","11",3655780,3683801,28021
"1592","ENSGALG00000003575","20",10505844,10507903,2059
"1593","ENSGALG00000003578","7",4388774,4439109,50335
"1594","ENSGALG00000003580","11",3706912,3741657,34745
"1595","ENSGALG00000003582","Z",11170515,11234911,64396
"1596","ENSGALG00000003584","18",6978815,6984489,5674
"1597","ENSGALG00000003588","11",4181069,4183523,2454
"1598","ENSGALG00000003589","19",5790911,5795785,4874
"1599","ENSGALG00000003590","18",6987331,6993610,6279
"1600","ENSGALG00000003594","22",2927488,2974857,47369
"1601","ENSGALG00000003595","19",5795706,5798772,3066
"1602","ENSGALG00000003596","14",1723283,1795839,72556
"1603","ENSGALG00000003597","23",5470579,5477371,6792
"1604","ENSGALG00000003601","26",5221530,5245884,24354
"1605","ENSGALG00000003602","11",4878175,4936909,58734
"1606","ENSGALG00000003604","19",5804285,5807797,3512
"1607","ENSGALG00000003605","Z",11358146,11454064,95918
"1608","ENSGALG00000003614","23",5476662,5483514,6852
"1609","ENSGALG00000003624","27",7510372,7514135,3763
"1610","ENSGALG00000003625","23",5484215,5485837,1622
"1611","ENSGALG00000003628","10",4710761,4798157,87396
"1612","ENSGALG00000003631","Z",11468109,11532281,64172
"1613","ENSGALG00000003634","6",10235979,10280889,44910
"1614","ENSGALG00000003636","21",4234399,4237316,2917
"1615","ENSGALG00000003641","22",2982759,3009704,26945
"1616","ENSGALG00000003642","14",2394173,2416757,22584
"1617","ENSGALG00000003644","10",4876557,4878284,1727
"1618","ENSGALG00000003645","15",5419880,5476679,56799
"1619","ENSGALG00000003647","19",5809556,5823321,13765
"1620","ENSGALG00000003648","5",3281271,3284689,3418
"1621","ENSGALG00000003650","18",7046647,7057756,11109
"1622","ENSGALG00000003651","27",7505169,7510246,5077
"1623","ENSGALG00000003652","6",10285644,10300082,14438
"1624","ENSGALG00000003655","5",3197905,3276726,78821
"1625","ENSGALG00000003657","19",5870573,5874427,3854
"1626","ENSGALG00000003658","20",3828357,3854961,26604
"1627","ENSGALG00000003660","5",3167825,3169000,1175
"1628","ENSGALG00000003661","17",6788839,6816609,27770
"1629","ENSGALG00000003663","11",4991886,5011381,19495
"1630","ENSGALG00000003665","19",5880064,5884125,4061
"1631","ENSGALG00000003670","20",4690689,4693338,2649
"1632","ENSGALG00000003672","13",11317888,11330697,12809
"1633","ENSGALG00000003674","1",6811050,6827488,16438
"1634","ENSGALG00000003675","14",2436022,2524536,88514
"1635","ENSGALG00000003677","17",6746034,6781803,35769
"1636","ENSGALG00000003681","20",4862868,4896419,33551
"1637","ENSGALG00000003682","15",5492846,5498570,5724
"1638","ENSGALG00000003683","17",6634913,6715908,80995
"1639","ENSGALG00000003684","14",2536745,2544323,7578
"1640","ENSGALG00000003687","15",5498812,5504141,5329
"1641","ENSGALG00000003688","Z",11533783,11564661,30878
"1642","ENSGALG00000003689","6",10302749,10312180,9431
"1643","ENSGALG00000003690","27",7438735,7442565,3830
"1644","ENSGALG00000003691","13",11336604,11375924,39320
"1645","ENSGALG00000003693","23",5492614,5603434,110820
"1646","ENSGALG00000003695","6",10338413,10355225,16812
"1647","ENSGALG00000003696","15",5504462,5509411,4949
"1648","ENSGALG00000003699","13",11388767,11649631,260864
"1649","ENSGALG00000003701","6",10373860,10450843,76983
"1650","ENSGALG00000003702","13",11940304,11988525,48221
"1651","ENSGALG00000003703","28",4258017,4262921,4904
"1652","ENSGALG00000003705","10",4903456,4984184,80728
"1653","ENSGALG00000003708","Z",11566273,11702158,135885
"1654","ENSGALG00000003709","22",3021586,3034748,13162
"1655","ENSGALG00000003712","17",6539667,6617270,77603
"1656","ENSGALG00000003713","21",4318060,4322084,4024
"1657","ENSGALG00000003716","Z",11726876,11742913,16037
"1658","ENSGALG00000003717","28",4263083,4303548,40465
"1659","ENSGALG00000003720","12",3154917,3201908,46991
"1660","ENSGALG00000003722","13",12010392,12015815,5423
"1661","ENSGALG00000003726","Z",11920848,11993157,72309
"1662","ENSGALG00000003727","28",4303372,4312690,9318
"1663","ENSGALG00000003731","21",4339299,4377676,38377
"1664","ENSGALG00000003732","17",6532711,6537248,4537
"1665","ENSGALG00000003733","Z",12007437,12057034,49597
"1666","ENSGALG00000003734","21",4377697,4391855,14158
"1667","ENSGALG00000003736","15",5511096,5523595,12499
"1668","ENSGALG00000003738","12",3201509,3205400,3891
"1669","ENSGALG00000003741","19",6077659,6104244,26585
"1670","ENSGALG00000003742","28",4313215,4353604,40389
"1671","ENSGALG00000003743","15",5528999,5539743,10744
"1672","ENSGALG00000003744","13",12027893,12054652,26759
"1673","ENSGALG00000003745","21",4391515,4398036,6521
"1674","ENSGALG00000003747","Z",12167208,12182395,15187
"1675","ENSGALG00000003748","5",2963916,3014137,50221
"1676","ENSGALG00000003750","20",4900259,4930546,30287
"1677","ENSGALG00000003751","6",10457505,10473583,16078
"1678","ENSGALG00000003753","11",6153713,6171640,17927
"1679","ENSGALG00000003757","17",6519929,6533687,13758
"1680","ENSGALG00000003758","7",4556218,4564139,7921
"1681","ENSGALG00000003759","10",5138735,5486292,347557
"1682","ENSGALG00000003765","6",10482683,10502453,19770
"1683","ENSGALG00000003766","19",5896970,5913837,16867
"1684","ENSGALG00000003767","11",6241053,6411630,170577
"1685","ENSGALG00000003770","10",5524170,5556443,32273
"1686","ENSGALG00000003771","28",4364672,4376473,11801
"1687","ENSGALG00000003774","21",4421128,4431113,9985
"1688","ENSGALG00000003775","Z",12187279,12262599,75320
"1689","ENSGALG00000003777","5",2461637,2746195,284558
"1690","ENSGALG00000003778","28",4384819,4391056,6237
"1691","ENSGALG00000003781","14",2550586,2578126,27540
"1692","ENSGALG00000003786","11",6508615,6522917,14302
"1693","ENSGALG00000003788","10",5823812,5839785,15973
"1694","ENSGALG00000003789","17",6438262,6443322,5060
"1695","ENSGALG00000003792","Z",12272880,12313334,40454
"1696","ENSGALG00000003793","10",5843239,5848304,5065
"1697","ENSGALG00000003794","28",4412468,4417567,5099
"1698","ENSGALG00000003795","15",5566666,5572747,6081
"1699","ENSGALG00000003798","14",2579659,2589053,9394
"1700","ENSGALG00000003799","12",3209127,3238321,29194
"1701","ENSGALG00000003800","23",5616117,5628117,12000
"1702","ENSGALG00000003802","10",5926089,5995672,69583
"1703","ENSGALG00000003803","Z",12347586,12371157,23571
"1704","ENSGALG00000003805","6",10769461,10913135,143674
"1705","ENSGALG00000003806","12",3243952,3262378,18426
"1706","ENSGALG00000003807","15",5572249,5577062,4813
"1707","ENSGALG00000003812","7",4582880,4684385,101505
"1708","ENSGALG00000003814","6",10918336,10919304,968
"1709","ENSGALG00000003815","20",5019515,5049331,29816
"1710","ENSGALG00000003816","23",5644988,5652023,7035
"1711","ENSGALG00000003818","13",12072751,12112751,40000
"1712","ENSGALG00000003819","14",2591498,2598184,6686
"1713","ENSGALG00000003820","15",5578016,5582595,4579
"1714","ENSGALG00000003821","7",4685059,4695434,10375
"1715","ENSGALG00000003824","28",4420685,4433351,12666
"1716","ENSGALG00000003826","15",5583594,5591583,7989
"1717","ENSGALG00000003829","23",5653211,5655702,2491
"1718","ENSGALG00000003832","12",3286872,3310838,23966
"1719","ENSGALG00000003833","8",6089202,6161870,72668
"1720","ENSGALG00000003836","7",4695620,4701337,5717
"1721","ENSGALG00000003837","11",6526571,6580958,54387
"1722","ENSGALG00000003838","23",5656815,5662254,5439
"1723","ENSGALG00000003839","12",3314049,3319671,5622
"1724","ENSGALG00000003841","4",1834265,1850149,15884
"1725","ENSGALG00000003842","20",5042743,5050245,7502
"1726","ENSGALG00000003845","28",2220234,2226350,6116
"1727","ENSGALG00000003849","10",6125779,6175117,49338
"1728","ENSGALG00000003851","23",5664869,5678872,14003
"1729","ENSGALG00000003854","15",5671460,5710128,38668
"1730","ENSGALG00000003855","20",5066108,5083688,17580
"1731","ENSGALG00000003857","13",12132157,12149954,17797
"1732","ENSGALG00000003859","27",7320674,7326276,5602
"1733","ENSGALG00000003860","4",1724355,1762986,38631
"1734","ENSGALG00000003861","6",11141114,11168922,27808
"1735","ENSGALG00000003862","7",4706293,4793733,87440
"1736","ENSGALG00000003863","15",5714657,5727150,12493
"1737","ENSGALG00000003866","17",6343648,6354483,10835
"1738","ENSGALG00000003870","13",12159620,12161948,2328
"1739","ENSGALG00000003875","17",6313958,6334825,20867
"1740","ENSGALG00000003876","13",12172827,12188986,16159
"1741","ENSGALG00000003878","4",1675565,1676294,729
"1742","ENSGALG00000003879","23",5688384,5696791,8407
"1743","ENSGALG00000003880","8",6189807,6203800,13993
"1744","ENSGALG00000003881","4",1669055,1673130,4075
"1745","ENSGALG00000003882","27",7303677,7318189,14512
"1746","ENSGALG00000003883","10",6184394,6221492,37098
"1747","ENSGALG00000003885","8",6204758,6208758,4000
"1748","ENSGALG00000003886","13",12229467,12420212,190745
"1749","ENSGALG00000003891","11",6697537,6892810,195273
"1750","ENSGALG00000003893","8",6212265,6287512,75247
"1751","ENSGALG00000003895","17",6255537,6261662,6125
"1752","ENSGALG00000003899","7",4804962,4812496,7534
"1753","ENSGALG00000003901","15",5727682,5734094,6412
"1754","ENSGALG00000003904","7",4815805,4833602,17797
"1755","ENSGALG00000003906","10",6237778,6318535,80757
"1756","ENSGALG00000003907","11",7288050,7304749,16699
"1757","ENSGALG00000003908","5",2427182,2452845,25663
"1758","ENSGALG00000003909","20",5094149,5101033,6884
"1759","ENSGALG00000003911","18",7295811,7307917,12106
"1760","ENSGALG00000003913","10",6245695,6255517,9822
"1761","ENSGALG00000003914","28",4437755,4441529,3774
"1762","ENSGALG00000003916","11",7356723,7375225,18502
"1763","ENSGALG00000003919","13",12712730,12720801,8071
"1764","ENSGALG00000003920","4",1648817,1669836,21019
"1765","ENSGALG00000003921","20",5102003,5104991,2988
"1766","ENSGALG00000003922","27",7235585,7253739,18154
"1767","ENSGALG00000003923","7",4846504,4899768,53264
"1768","ENSGALG00000003924","8",6289074,6355763,66689
"1769","ENSGALG00000003925","6",11198643,11240977,42334
"1770","ENSGALG00000003929","20",5120205,5122460,2255
"1771","ENSGALG00000003930","10",6257701,6346419,88718
"1772","ENSGALG00000003932","20",5127284,5143926,16642
"1773","ENSGALG00000003933","8",6368170,6376220,8050
"1774","ENSGALG00000003935","6",11267674,11282106,14432
"1775","ENSGALG00000003936","23",5709280,5713960,4680
"1776","ENSGALG00000003937","13",12720692,12738061,17369
"1777","ENSGALG00000003939","28",4484819,4487194,2375
"1778","ENSGALG00000003941","17",6210644,6246892,36248
"1779","ENSGALG00000003942","11",7378128,7417829,39701
"1780","ENSGALG00000003944","10",6348118,6409092,60974
"1781","ENSGALG00000003947","6",11282256,11288754,6498
"1782","ENSGALG00000003948","12",3345428,3352328,6900
"1783","ENSGALG00000003950","13",12738476,12745824,7348
"1784","ENSGALG00000003952","20",5148004,5151439,3435
"1785","ENSGALG00000003955","8",6384431,6436044,51613
"1786","ENSGALG00000003958","5",2270331,2405844,135513
"1787","ENSGALG00000003959","28",4510264,4518819,8555
"1788","ENSGALG00000003965","5",2267447,2271334,3887
"1789","ENSGALG00000003966","19",5949676,5952152,2476
"1790","ENSGALG00000003969","21",4663917,4673877,9960
"1791","ENSGALG00000003972","13",12745890,12760743,14853
"1792","ENSGALG00000003973","19",5955265,5957173,1908
"1793","ENSGALG00000003976","4",1591207,1611198,19991
"1794","ENSGALG00000003977","12",3353843,3372272,18429
"1795","ENSGALG00000003978","28",4519896,4523865,3969
"1796","ENSGALG00000003979","19",5957276,5967069,9793
"1797","ENSGALG00000003980","7",5114780,5192958,78178
"1798","ENSGALG00000003985","10",6664537,6680129,15592
"1799","ENSGALG00000003986","23",5732085,5733729,1644
"1800","ENSGALG00000003987","19",5971111,5975016,3905
"1801","ENSGALG00000003990","6",11290532,11295363,4831
"1802","ENSGALG00000003991","21",4673991,4676457,2466
"1803","ENSGALG00000003995","19",6005974,6009998,4024
"1804","ENSGALG00000003999","5",1958644,2261543,302899
"1805","ENSGALG00000004002","23",5733966,5739642,5676
"1806","ENSGALG00000004003","4",1576520,1588476,11956
"1807","ENSGALG00000004004","11",7505176,7578698,73522
"1808","ENSGALG00000004005","21",4676382,4680371,3989
"1809","ENSGALG00000004009","19",6026937,6029799,2862
"1810","ENSGALG00000004017","8",6457160,6463744,6584
"1811","ENSGALG00000004019","4",1573612,1576698,3086
"1812","ENSGALG00000004028","20",5162754,5167745,4991
"1813","ENSGALG00000004033","13",12866217,12903053,36836
"1814","ENSGALG00000004034","21",4686160,4739361,53201
"1815","ENSGALG00000004035","19",6109485,6113457,3972
"1816","ENSGALG00000004037","6",11315563,11330111,14548
"1817","ENSGALG00000004038","10",6684696,6695463,10767
"1818","ENSGALG00000004039","21",4747775,4763367,15592
"1819","ENSGALG00000004040","13",12969660,12979696,10036
"1820","ENSGALG00000004042","19",6121566,6130232,8666
"1821","ENSGALG00000004044","5",1920626,1930635,10009
"1822","ENSGALG00000004045","7",5234473,5522177,287704
"1823","ENSGALG00000004046","10",6698487,6705074,6587
"1824","ENSGALG00000004047","23",5736095,5744336,8241
"1825","ENSGALG00000004048","28",4727381,4835713,108332
"1826","ENSGALG00000004049","11",7578362,7651000,72638
"1827","ENSGALG00000004052","17",6122589,6153492,30903
"1828","ENSGALG00000004055","14",2679816,2775732,95916
"1829","ENSGALG00000004057","23",5743506,5747633,4127
"1830","ENSGALG00000004058","14",2703952,2736640,32688
"1831","ENSGALG00000004059","10",6707025,6745503,38478
"1832","ENSGALG00000004063","4",1557649,1566476,8827
"1833","ENSGALG00000004064","14",2757417,2761606,4189
"1834","ENSGALG00000004065","6",11333870,11348888,15018
"1835","ENSGALG00000004066","21",4783628,4787518,3890
"1836","ENSGALG00000004068","13",12979764,12989584,9820
"1837","ENSGALG00000004069","4",1555576,1556617,1041
"1838","ENSGALG00000004070","14",2927831,2938908,11077
"1839","ENSGALG00000004071","11",7656093,7683363,27270
"1840","ENSGALG00000004074","20",5178294,5182050,3756
"1841","ENSGALG00000004078","13",13001201,13010129,8928
"1842","ENSGALG00000004079","4",1530286,1553576,23290
"1843","ENSGALG00000004081","21",4788385,4825706,37321
"1844","ENSGALG00000004082","19",6146978,6202471,55493
"1845","ENSGALG00000004083","13",13030976,13139199,108223
"1846","ENSGALG00000004085","5",1906529,1919803,13274
"1847","ENSGALG00000004087","10",6784258,7036593,252335
"1848","ENSGALG00000004088","17",6032920,6121111,88191
"1849","ENSGALG00000004093","4",1505219,1510377,5158
"1850","ENSGALG00000004096","10",7109509,7149541,40032
"1851","ENSGALG00000004097","21",5220770,5234371,13601
"1852","ENSGALG00000004098","20",5185964,5224532,38568
"1853","ENSGALG00000004101","13",13391268,13399852,8584
"1854","ENSGALG00000004102","21",5255306,5258665,3359
"1855","ENSGALG00000004103","10",7166206,7175738,9532
"1856","ENSGALG00000004104","14",2960776,2987551,26775
"1857","ENSGALG00000004106","5",1895074,1901741,6667
"1858","ENSGALG00000004107","4",1468938,1477971,9033
"1859","ENSGALG00000004108","6",11438888,11454347,15459
"1860","ENSGALG00000004110","20",5224028,5228641,4613
"1861","ENSGALG00000004111","4",1453967,1459823,5856
"1862","ENSGALG00000004112","23",5747558,5752219,4661
"1863","ENSGALG00000004113","4",1445083,1449667,4584
"1864","ENSGALG00000004115","11",7714250,7725141,10891
"1865","ENSGALG00000004116","7",5604055,5633935,29880
"1866","ENSGALG00000004120","23",5753275,5754330,1055
"1867","ENSGALG00000004121","4",1395651,1409355,13704
"1868","ENSGALG00000004122","23",5759074,5763181,4107
"1869","ENSGALG00000004123","20",5231078,5240973,9895
"1870","ENSGALG00000004127","4",1364735,1369925,5190
"1871","ENSGALG00000004128","4",1346530,1359078,12548
"1872","ENSGALG00000004129","7",5641273,5649047,7774
"1873","ENSGALG00000004133","23",5765828,5774220,8392
"1874","ENSGALG00000004134","13",13550385,13574271,23886
"1875","ENSGALG00000004140","7",5812663,5825176,12513
"1876","ENSGALG00000004141","23",5776686,5779203,2517
"1877","ENSGALG00000004143","20",5242537,5256414,13877
"1878","ENSGALG00000004144","6",11485483,11498075,12592
"1879","ENSGALG00000004146","20",5277690,5321475,43785
"1880","ENSGALG00000004150","10",7185220,7263560,78340
"1881","ENSGALG00000004152","17",6003739,6008708,4969
"1882","ENSGALG00000004153","5",1877162,1894802,17640
"1883","ENSGALG00000004155","23",5781663,5804872,23209
"1884","ENSGALG00000004156","6",11508509,11517289,8780
"1885","ENSGALG00000004160","13",13587591,13608653,21062
"1886","ENSGALG00000004161","10",7264609,7272826,8217
"1887","ENSGALG00000004162","18",7798240,7804327,6087
"1888","ENSGALG00000004163","8",6516322,6522709,6387
"1889","ENSGALG00000004165","17",5999621,6003436,3815
"1890","ENSGALG00000004166","5",1870154,1876969,6815
"1891","ENSGALG00000004167","6",11522560,11524423,1863
"1892","ENSGALG00000004168","28",4970129,4972661,2532
"1893","ENSGALG00000004169","4",1297142,1332719,35577
"1894","ENSGALG00000004170","20",5355077,5367709,12632
"1895","ENSGALG00000004171","10",7273119,7315284,42165
"1896","ENSGALG00000004172","5",1864700,1869053,4353
"1897","ENSGALG00000004173","8",6534561,6542774,8213
"1898","ENSGALG00000004174","6",11524668,11536453,11785
"1899","ENSGALG00000004176","13",13610528,13614853,4325
"1900","ENSGALG00000004179","15",5748946,5760604,11658
"1901","ENSGALG00000004180","17",5992369,5998468,6099
"1902","ENSGALG00000004184","13",13624036,13632278,8242
"1903","ENSGALG00000004186","19",6333122,6344467,11345
"1904","ENSGALG00000004189","14",2999628,3008787,9159
"1905","ENSGALG00000004190","15",5762337,5771346,9009
"1906","ENSGALG00000004191","5",1853554,1864605,11051
"1907","ENSGALG00000004192","10",7339296,7345988,6692
"1908","ENSGALG00000004193","18",7786981,7826236,39255
"1909","ENSGALG00000004195","4",1269816,1286882,17066
"1910","ENSGALG00000004196","7",5831611,5843614,12003
"1911","ENSGALG00000004197","6",11536758,11550268,13510
"1912","ENSGALG00000004198","4",1266339,1269650,3311
"1913","ENSGALG00000004199","14",3015631,3023103,7472
"1914","ENSGALG00000004200","28",5011472,5029347,17875
"1915","ENSGALG00000004203","14",3023831,3027172,3341
"1916","ENSGALG00000004204","10",7352945,7383551,30606
"1917","ENSGALG00000004205","8",6550216,6573472,23256
"1918","ENSGALG00000004209","14",3139896,3142286,2390
"1919","ENSGALG00000004212","10",7384780,7427378,42598
"1920","ENSGALG00000004215","18",7826149,7844274,18125
"1921","ENSGALG00000004216","8",6624875,6629330,4455
"1922","ENSGALG00000004220","20",5395581,5403232,7651
"1923","ENSGALG00000004221","23",5809698,5818061,8363
"1924","ENSGALG00000004222","6",11585402,11612168,26766
"1925","ENSGALG00000004224","14",3156908,3476461,319553
"1926","ENSGALG00000004225","15",5772976,5789002,16026
"1927","ENSGALG00000004227","8",6632962,6649915,16953
"1928","ENSGALG00000004228","7",5903680,5932487,28807
"1929","ENSGALG00000004230","10",7430735,7445902,15167
"1930","ENSGALG00000004231","23",5819774,5826643,6869
"1931","ENSGALG00000004234","5",1824446,1833694,9248
"1932","ENSGALG00000004236","7",5942946,5979718,36772
"1933","ENSGALG00000004237","18",7852932,7869256,16324
"1934","ENSGALG00000004238","14",3477599,3479865,2266
"1935","ENSGALG00000004239","5",1821594,1823163,1569
"1936","ENSGALG00000004240","15",5872047,5889264,17217
"1937","ENSGALG00000004243","5",1817672,1819250,1578
"1938","ENSGALG00000004244","20",5403489,5411063,7574
"1939","ENSGALG00000004245","14",3479887,3483891,4004
"1940","ENSGALG00000004246","19",6349841,6361974,12133
"1941","ENSGALG00000004247","15",5889130,5896824,7694
"1942","ENSGALG00000004248","6",11613486,11621951,8465
"1943","ENSGALG00000004249","23",5839056,5875552,36496
"1944","ENSGALG00000004250","5",1794613,1812254,17641
"1945","ENSGALG00000004251","4",1241080,1246271,5191
"1946","ENSGALG00000004252","28",5030693,5034171,3478
"1947","ENSGALG00000004254","15",5900288,5913095,12807
"1948","ENSGALG00000004255","14",3487345,3508179,20834
"1949","ENSGALG00000004257","6",11622065,11633629,11564
"1950","ENSGALG00000004259","19",6371390,6387309,15919
"1951","ENSGALG00000004260","5",1783009,1789928,6919
"1952","ENSGALG00000004261","10",7520347,7547386,27039
"1953","ENSGALG00000004262","19",6387881,6391810,3929
"1954","ENSGALG00000004263","28",5034853,5039077,4224
"1955","ENSGALG00000004266","28",5040872,5047576,6704
"1956","ENSGALG00000004267","5",1777020,1781819,4799
"1957","ENSGALG00000004268","23",5890689,5899912,9223
"1958","ENSGALG00000004270","10",7557497,7611673,54176
"1959","ENSGALG00000004272","7",6003930,6013310,9380
"1960","ENSGALG00000004273","8",6682209,6791752,109543
"1961","ENSGALG00000004274","7",6157285,6187756,30471
"1962","ENSGALG00000004276","14",3534997,3541893,6896
"1963","ENSGALG00000004280","5",1763496,1773626,10130
"1964","ENSGALG00000004282","23",5903355,5910667,7312
"1965","ENSGALG00000004285","20",5418333,5446344,28011
"1966","ENSGALG00000004286","6",11712568,11751772,39204
"1967","ENSGALG00000004288","7",6215668,6433721,218053
"1968","ENSGALG00000004290","8",6716174,6733176,17002
"1969","ENSGALG00000004293","3",45498435,45518857,20422
"1970","ENSGALG00000004294","10",7768069,7808270,40201
"1971","ENSGALG00000004295","19",6396508,6416637,20129
"1972","ENSGALG00000004297","12",3442270,3511826,69556
"1973","ENSGALG00000004300","5",1720111,1756043,35932
"1974","ENSGALG00000004302","7",6553073,6593641,40568
"1975","ENSGALG00000004304","10",7853621,8005950,152329
"1976","ENSGALG00000004306","5",1709027,1716094,7067
"1977","ENSGALG00000004309","20",5477701,5488850,11149
"1978","ENSGALG00000004310","14",3646453,3710836,64383
"1979","ENSGALG00000004311","Z",23312434,23332349,19915
"1980","ENSGALG00000004319","6",11899306,11907384,8078
"1981","ENSGALG00000004320","13",13664153,13701069,36916
"1982","ENSGALG00000004321","20",5492048,5500197,8149
"1983","ENSGALG00000004322","7",6622423,6635326,12903
"1984","ENSGALG00000004323","8",6831975,6972643,140668
"1985","ENSGALG00000004324","15",5938524,5979400,40876
"1986","ENSGALG00000004325","6",11904936,11935569,30633
"1987","ENSGALG00000004326","19",6419064,6441777,22713
"1988","ENSGALG00000004328","5",1673838,1708602,34764
"1989","ENSGALG00000004329","14",3718328,3739905,21577
"1990","ENSGALG00000004332","6",11938528,11947762,9234
"1991","ENSGALG00000004333","18",7950536,7974012,23476
"1992","ENSGALG00000004334","11",7782060,7936449,154389
"1993","ENSGALG00000004336","4",1229311,1237808,8497
"1994","ENSGALG00000004339","Z",23210259,23289222,78963
"1995","ENSGALG00000004341","8",6986150,6991402,5252
"1996","ENSGALG00000004342","11",7821077,7826803,5726
"1997","ENSGALG00000004343","15",5984677,5999533,14856
"1998","ENSGALG00000004345","6",11950266,11973318,23052
"1999","ENSGALG00000004346","4",1223375,1228842,5467
"2000","ENSGALG00000004347","10",8216238,8265053,48815
"2001","ENSGALG00000004348","14",3740254,3748302,8048
"2002","ENSGALG00000004350","Z",23183991,23205580,21589
"2003","ENSGALG00000004352","15",5989099,5991828,2729
"2004","ENSGALG00000004353","Z",23086355,23119037,32682
"2005","ENSGALG00000004355","6",11982195,12061362,79167
"2006","ENSGALG00000004357","13",13735681,13748138,12457
"2007","ENSGALG00000004358","14",3763942,3770749,6807
"2008","ENSGALG00000004360","13",13729635,13735808,6173
"2009","ENSGALG00000004362","5",1655877,1673814,17937
"2010","ENSGALG00000004363","7",6852312,6859362,7050
"2011","ENSGALG00000004364","19",6464720,6487543,22823
"2012","ENSGALG00000004365","15",5996365,6006391,10026
"2013","ENSGALG00000004366","12",3513037,3525813,12776
"2014","ENSGALG00000004367","4",1219019,1224786,5767
"2015","ENSGALG00000004369","10",8378046,8386023,7977
"2016","ENSGALG00000004370","18",7978389,8014156,35767
"2017","ENSGALG00000004372","6",12061891,12152583,90692
"2018","ENSGALG00000004373","18",8145867,8171206,25339
"2019","ENSGALG00000004375","11",7826732,7852579,25847
"2020","ENSGALG00000004376","18",8184812,8191556,6744
"2021","ENSGALG00000004378","17",5945702,5950760,5058
"2022","ENSGALG00000004379","15",6008253,6016332,8079
"2023","ENSGALG00000004383","19",6490173,6494064,3891
"2024","ENSGALG00000004386","18",8785940,8789042,3102
"2025","ENSGALG00000004387","10",8404804,8423928,19124
"2026","ENSGALG00000004390","Z",22789928,22948747,158819
"2027","ENSGALG00000004393","5",1623560,1636140,12580
"2028","ENSGALG00000004394","7",6712367,6730379,18012
"2029","ENSGALG00000004397","15",6029841,6070325,40484
"2030","ENSGALG00000004398","14",3830739,3870033,39294
"2031","ENSGALG00000004400","19",6503224,6550631,47407
"2032","ENSGALG00000004401","4",1202967,1205851,2884
"2033","ENSGALG00000004410","6",12173752,12181430,7678
"2034","ENSGALG00000004412","15",6094826,6099589,4763
"2035","ENSGALG00000004413","18",8903444,8963934,60490
"2036","ENSGALG00000004416","19",6605813,6610481,4668
"2037","ENSGALG00000004418","18",8969030,8971311,2281
"2038","ENSGALG00000004420","14",3925849,4284907,359058
"2039","ENSGALG00000004424","8",6998139,7009527,11388
"2040","ENSGALG00000004425","Z",22721122,22759474,38352
"2041","ENSGALG00000004428","11",7850364,7853719,3355
"2042","ENSGALG00000004431","6",12215807,12219963,4156
"2043","ENSGALG00000004435","10",8432340,8464678,32338
"2044","ENSGALG00000004436","14",4288119,4299512,11393
"2045","ENSGALG00000004437","Z",22593889,22715686,121797
"2046","ENSGALG00000004438","Z",22502339,22568346,66007
"2047","ENSGALG00000004440","15",6104547,6111541,6994
"2048","ENSGALG00000004441","18",8995773,8999287,3514
"2049","ENSGALG00000004442","6",12220165,12228467,8302
"2050","ENSGALG00000004444","11",7865514,7879259,13745
"2051","ENSGALG00000004446","6",12229136,12232669,3533
"2052","ENSGALG00000004448","8",7100994,7106165,5171
"2053","ENSGALG00000004449","14",4323045,4332386,9341
"2054","ENSGALG00000004455","3",2219254,2362677,143423
"2055","ENSGALG00000004460","14",4353687,4396536,42849
"2056","ENSGALG00000004465","6",12239480,12253050,13570
"2057","ENSGALG00000004467","15",6112451,6164114,51663
"2058","ENSGALG00000004469","20",5579113,5580702,1589
"2059","ENSGALG00000004472","8",7112556,7151143,38587
"2060","ENSGALG00000004474","11",8369833,8376012,6179
"2061","ENSGALG00000004475","4",1195803,1199520,3717
"2062","ENSGALG00000004476","12",3527264,3534653,7389
"2063","ENSGALG00000004477","19",6614289,6620781,6492
"2064","ENSGALG00000004480","11",8393870,8446227,52357
"2065","ENSGALG00000004483","3",2211235,2219474,8239
"2066","ENSGALG00000004486","15",6179851,6191881,12030
"2067","ENSGALG00000004489","11",8419633,8446981,27348
"2068","ENSGALG00000004491","Z",22452215,22497335,45120
"2069","ENSGALG00000004492","19",6669701,6722801,53100
"2070","ENSGALG00000004493","15",6192499,6204993,12494
"2071","ENSGALG00000004494","11",8447460,8459801,12341
"2072","ENSGALG00000004495","18",9109548,9115392,5844
"2073","ENSGALG00000004496","13",13753105,13762545,9440
"2074","ENSGALG00000004498","20",5583217,5590855,7638
"2075","ENSGALG00000004500","8",7250615,7378011,127396
"2076","ENSGALG00000004503","19",6723506,6726879,3373
"2077","ENSGALG00000004504","14",4415776,4428191,12415
"2078","ENSGALG00000004505","18",9137482,9139173,1691
"2079","ENSGALG00000004506","11",8502946,8542347,39401
"2080","ENSGALG00000004508","20",5667155,5760114,92959
"2081","ENSGALG00000004509","19",6732619,6734639,2020
"2082","ENSGALG00000004514","18",9141163,9143240,2077
"2083","ENSGALG00000004515","15",6226114,6237789,11675
"2084","ENSGALG00000004517","12",3551260,3554379,3119
"2085","ENSGALG00000004518","Z",22436116,22452194,16078
"2086","ENSGALG00000004519","19",6739040,6751542,12502
"2087","ENSGALG00000004521","13",13762915,13764542,1627
"2088","ENSGALG00000004523","21",5504961,5517404,12443
"2089","ENSGALG00000004525","18",9143458,9145603,2145
"2090","ENSGALG00000004526","8",7387437,7436311,48874
"2091","ENSGALG00000004528","11",9225471,9286162,60691
"2092","ENSGALG00000004529","15",6236515,6242716,6201
"2093","ENSGALG00000004530","14",4435969,4445512,9543
"2094","ENSGALG00000004531","21",5515436,5532562,17126
"2095","ENSGALG00000004532","11",9750706,9766299,15593
"2096","ENSGALG00000004533","21",5535457,5537932,2475
"2097","ENSGALG00000004534","13",13770696,13781162,10466
"2098","ENSGALG00000004538","8",7454048,7474177,20129
"2099","ENSGALG00000004542","20",5765509,5816496,50987
"2100","ENSGALG00000004545","10",8767591,8861883,94292
"2101","ENSGALG00000004550","15",6252342,6269152,16810
"2102","ENSGALG00000004553","6",12299751,12327380,27629
"2103","ENSGALG00000004554","8",7478362,7485785,7423
"2104","ENSGALG00000004555","13",13782576,13790479,7903
"2105","ENSGALG00000004557","14",4448200,4469037,20837
"2106","ENSGALG00000004559","11",9773485,9799515,26030
"2107","ENSGALG00000004562","15",6282908,6293393,10485
"2108","ENSGALG00000004568","21",5543786,5548558,4772
"2109","ENSGALG00000004569","6",12473957,12503037,29080
"2110","ENSGALG00000004570","20",5859344,5913084,53740
"2111","ENSGALG00000004571","15",6295803,6311046,15243
"2112","ENSGALG00000004572","21",5568351,5570129,1778
"2113","ENSGALG00000004573","17",5668179,5684619,16440
"2114","ENSGALG00000004574","21",5578172,5580814,2642
"2115","ENSGALG00000004578","8",7505125,7691141,186016
"2116","ENSGALG00000004581","13",13819393,13828228,8835
"2117","ENSGALG00000004582","15",6330278,6334348,4070
"2118","ENSGALG00000004583","18",9145624,9173263,27639
"2119","ENSGALG00000004587","8",7719525,7758539,39014
"2120","ENSGALG00000004588","13",13844163,13849165,5002
"2121","ENSGALG00000004590","21",5586241,5605153,18912
"2122","ENSGALG00000004591","8",7765201,7771303,6102
"2123","ENSGALG00000004593","20",5918672,5975454,56782
"2124","ENSGALG00000004594","13",13851648,13855558,3910
"2125","ENSGALG00000004597","8",7781188,7791510,10322
"2126","ENSGALG00000004598","15",6370783,6391511,20728
"2127","ENSGALG00000004604","17",5656357,5665722,9365
"2128","ENSGALG00000004610","15",6404746,6415472,10726
"2129","ENSGALG00000004611","14",4550654,4569107,18453
"2130","ENSGALG00000004612","21",5605266,5615188,9922
"2131","ENSGALG00000004613","19",6774396,6787281,12885
"2132","ENSGALG00000004614","8",7811903,7821247,9344
"2133","ENSGALG00000004618","19",6788637,6792217,3580
"2134","ENSGALG00000004620","8",7848917,7898075,49158
"2135","ENSGALG00000004621","20",6185927,6338401,152474
"2136","ENSGALG00000004622","17",5651404,5657476,6072
"2137","ENSGALG00000004623","21",5633885,5641548,7663
"2138","ENSGALG00000004625","15",6419311,6462154,42843
"2139","ENSGALG00000004627","8",7907067,7918210,11143
"2140","ENSGALG00000004628","19",6792389,6800086,7697
"2141","ENSGALG00000004629","14",4599649,4651582,51933
"2142","ENSGALG00000004630","11",9820273,9825733,5460
"2143","ENSGALG00000004631","21",5646905,5658909,12004
"2144","ENSGALG00000004637","19",6800175,6808318,8143
"2145","ENSGALG00000004640","21",5659278,5664990,5712
"2146","ENSGALG00000004642","8",7921538,7942103,20565
"2147","ENSGALG00000004645","17",5637157,5645118,7961
"2148","ENSGALG00000004646","21",5661333,5667749,6416
"2149","ENSGALG00000004648","11",9853569,9857087,3518
"2150","ENSGALG00000004649","19",6811017,6821588,10571
"2151","ENSGALG00000004650","15",6478762,6514166,35404
"2152","ENSGALG00000004653","6",12639927,12644952,5025
"2153","ENSGALG00000004655","14",4669726,4684664,14938
"2154","ENSGALG00000004657","21",5668759,5672508,3749
"2155","ENSGALG00000004659","17",5621133,5633169,12036
"2156","ENSGALG00000004660","19",6833810,6842817,9007
"2157","ENSGALG00000004661","12",3654065,3659153,5088
"2158","ENSGALG00000004662","21",5722669,5738134,15465
"2159","ENSGALG00000004663","20",6366483,6398193,31710
"2160","ENSGALG00000004665","14",4711364,4717460,6096
"2161","ENSGALG00000004667","8",7948738,7992112,43374
"2162","ENSGALG00000004669","19",6849327,6858068,8741
"2163","ENSGALG00000004670","12",3688502,3701516,13014
"2164","ENSGALG00000004671","11",9860328,9900923,40595
"2165","ENSGALG00000004675","11",9900952,9905204,4252
"2166","ENSGALG00000004676","12",3703348,3704648,1300
"2167","ENSGALG00000004679","19",6927193,6937680,10487
"2168","ENSGALG00000004683","20",9535972,9552110,16138
"2169","ENSGALG00000004684","12",3718788,3743338,24550
"2170","ENSGALG00000004687","12",3743099,3861939,118840
"2171","ENSGALG00000004689","17",5590367,5608468,18101
"2172","ENSGALG00000004691","19",6940495,6948527,8032
"2173","ENSGALG00000004693","14",4748751,4763835,15084
"2174","ENSGALG00000004695","12",3762272,3778378,16106
"2175","ENSGALG00000004696","10",9444258,9458327,14069
"2176","ENSGALG00000004700","8",7994109,8002276,8167
"2177","ENSGALG00000004701","17",5579042,5588504,9462
"2178","ENSGALG00000004702","17",5557660,5565731,8071
"2179","ENSGALG00000004704","11",9912504,9940866,28362
"2180","ENSGALG00000004705","14",4781451,4783571,2120
"2181","ENSGALG00000004707","20",6401875,6423438,21563
"2182","ENSGALG00000004710","10",9461198,9485282,24084
"2183","ENSGALG00000004711","14",4784016,4788773,4757
"2184","ENSGALG00000004714","14",4788949,4795805,6856
"2185","ENSGALG00000004719","17",5511446,5557670,46224
"2186","ENSGALG00000004721","14",4843740,4845029,1289
"2187","ENSGALG00000004722","12",3792114,3806886,14772
"2188","ENSGALG00000004725","15",6505287,6514051,8764
"2189","ENSGALG00000004727","19",6954591,6988531,33940
"2190","ENSGALG00000004728","8",8032895,8108276,75381
"2191","ENSGALG00000004729","11",10088016,10120434,32418
"2192","ENSGALG00000004734","4",1828742,1832873,4131
"2193","ENSGALG00000004736","20",6434901,6458344,23443
"2194","ENSGALG00000004738","17",5500646,5509174,8528
"2195","ENSGALG00000004740","10",9489523,9520477,30954
"2196","ENSGALG00000004741","21",5956010,6053651,97641
"2197","ENSGALG00000004742","4",1860090,1862633,2543
"2198","ENSGALG00000004743","15",6514818,6534275,19457
"2199","ENSGALG00000004745","14",4915961,4922198,6237
"2200","ENSGALG00000004747","6",12645144,12647593,2449
"2201","ENSGALG00000004749","14",4924362,4932502,8140
"2202","ENSGALG00000004750","12",3862147,3876655,14508
"2203","ENSGALG00000004756","11",9962507,9982421,19914
"2204","ENSGALG00000004758","20",6525285,6624185,98900
"2205","ENSGALG00000004759","14",4935123,4946169,11046
"2206","ENSGALG00000004760","15",6543749,6557011,13262
"2207","ENSGALG00000004763","19",6994213,7000330,6117
"2208","ENSGALG00000004767","17",5481438,5500391,18953
"2209","ENSGALG00000004769","6",12654355,12673270,18915
"2210","ENSGALG00000004771","21",6073556,6075682,2126
"2211","ENSGALG00000004777","6",12694308,12699133,4825
"2212","ENSGALG00000004778","19",7001491,7007065,5574
"2213","ENSGALG00000004781","21",6175387,6201927,26540
"2214","ENSGALG00000004782","8",8144138,8153180,9042
"2215","ENSGALG00000004783","17",5472223,5475502,3279
"2216","ENSGALG00000004793","19",7065537,7069275,3738
"2217","ENSGALG00000004794","6",12699300,12748414,49114
"2218","ENSGALG00000004796","21",6337084,6369848,32764
"2219","ENSGALG00000004798","14",5062970,5119951,56981
"2220","ENSGALG00000004799","19",7068712,7073816,5104
"2221","ENSGALG00000004800","21",6372895,6377167,4272
"2222","ENSGALG00000004801","4",1863469,1879108,15639
"2223","ENSGALG00000004804","20",6579828,6656826,76998
"2224","ENSGALG00000004806","8",8305678,8331735,26057
"2225","ENSGALG00000004809","6",13095237,13103157,7920
"2226","ENSGALG00000004812","8",8332878,8393131,60253
"2227","ENSGALG00000004813","12",3912103,4026538,114435
"2228","ENSGALG00000004814","11",9986426,10012360,25934
"2229","ENSGALG00000004816","14",5128047,5138885,10838
"2230","ENSGALG00000004817","19",7073888,7081023,7135
"2231","ENSGALG00000004818","15",6679247,6682601,3354
"2232","ENSGALG00000004820","19",7085977,7086290,313
"2233","ENSGALG00000004821","15",6682823,6704251,21428
"2234","ENSGALG00000004825","4",1879807,1888342,8535
"2235","ENSGALG00000004831","4",1889130,1893556,4426
"2236","ENSGALG00000004832","4",1893812,1898775,4963
"2237","ENSGALG00000004833","21",6377332,6383361,6029
"2238","ENSGALG00000004834","14",5142277,5153495,11218
"2239","ENSGALG00000004837","20",6707861,6715070,7209
"2240","ENSGALG00000004839","11",10018024,10138369,120345
"2241","ENSGALG00000004840","15",6743586,6745464,1878
"2242","ENSGALG00000004841","5",17305316,17306496,1180
"2243","ENSGALG00000004842","14",5153919,5159452,5533
"2244","ENSGALG00000004845","5",17262339,17262897,558
"2245","ENSGALG00000004848","21",6397421,6405423,8002
"2246","ENSGALG00000004849","15",6768114,6774393,6279
"2247","ENSGALG00000004850","6",13114186,13389295,275109
"2248","ENSGALG00000004852","17",5387537,5447145,59608
"2249","ENSGALG00000004853","11",10057900,10080398,22498
"2250","ENSGALG00000004856","4",1896299,1904953,8654
"2251","ENSGALG00000004858","15",6798406,6802479,4073
"2252","ENSGALG00000004859","20",6715285,6727531,12246
"2253","ENSGALG00000004860","14",5183631,5185545,1914
"2254","ENSGALG00000004869","15",6812747,6820365,7618
"2255","ENSGALG00000004870","4",1905214,1913688,8474
"2256","ENSGALG00000004871","6",13986141,14015668,29527
"2257","ENSGALG00000004874","21",6409998,6416533,6535
"2258","ENSGALG00000004875","14",5190747,5228149,37402
"2259","ENSGALG00000004878","21",6417028,6426299,9271
"2260","ENSGALG00000004879","12",4459523,4542964,83441
"2261","ENSGALG00000004881","17",5366372,5385378,19006
"2262","ENSGALG00000004882","21",6444377,6447573,3196
"2263","ENSGALG00000004885","10",10495517,10503481,7964
"2264","ENSGALG00000004889","21",6460791,6475374,14583
"2265","ENSGALG00000004893","15",6820427,6823274,2847
"2266","ENSGALG00000004897","1",15836984,15848465,11481
"2267","ENSGALG00000004899","11",10315327,10439917,124590
"2268","ENSGALG00000004900","19",7138271,7140397,2126
"2269","ENSGALG00000004901","15",6818553,6868398,49845
"2270","ENSGALG00000004902","14",5319981,5371193,51212
"2271","ENSGALG00000004903","11",10491009,10661037,170028
"2272","ENSGALG00000004907","11",10693177,10733016,39839
"2273","ENSGALG00000004908","4",1971968,1982270,10302
"2274","ENSGALG00000004916","14",5371507,5386809,15302
"2275","ENSGALG00000004917","19",7178655,7196511,17856
"2276","ENSGALG00000004918","4",1990182,1993850,3668
"2277","ENSGALG00000004920","17",5358563,5362524,3961
"2278","ENSGALG00000004921","12",4639388,4696883,57495
"2279","ENSGALG00000004924","19",7197445,7200240,2795
"2280","ENSGALG00000004926","14",5387747,5392015,4268
"2281","ENSGALG00000004927","17",5355051,5360831,5780
"2282","ENSGALG00000004928","15",6873123,6888003,14880
"2283","ENSGALG00000004929","14",5391949,5398965,7016
"2284","ENSGALG00000004930","12",4781954,4783378,1424
"2285","ENSGALG00000004932","12",4788083,4877625,89542
"2286","ENSGALG00000004935","11",10872994,10891271,18277
"2287","ENSGALG00000004936","4",2009676,2016606,6930
"2288","ENSGALG00000004937","12",4897543,4976871,79328
"2289","ENSGALG00000004940","12",4989551,5012049,22498
"2290","ENSGALG00000004943","11",10891878,10903620,11742
"2291","ENSGALG00000004945","10",10537715,10583316,45601
"2292","ENSGALG00000004946","9",9462681,9492856,30175
"2293","ENSGALG00000004947","6",14006542,14037322,30780
"2294","ENSGALG00000004948","4",2019981,2025100,5119
"2295","ENSGALG00000004949","11",10895866,10936760,40894
"2296","ENSGALG00000004952","4",2025936,2028063,2127
"2297","ENSGALG00000004953","14",5401997,5410520,8523
"2298","ENSGALG00000004955","12",5166040,5208541,42501
"2299","ENSGALG00000004956","11",10964811,10986960,22149
"2300","ENSGALG00000004957","9",9424788,9454131,29343
"2301","ENSGALG00000004958","4",2028580,2039548,10968
"2302","ENSGALG00000004959","9",9398655,9402191,3536
"2303","ENSGALG00000004960","10",10623539,10768837,145298
"2304","ENSGALG00000004963","4",2039702,2042007,2305
"2305","ENSGALG00000004965","17",5345787,5353651,7864
"2306","ENSGALG00000004966","9",8894774,9020869,126095
"2307","ENSGALG00000004969","12",5131077,5237794,106717
"2308","ENSGALG00000004971","17",5320444,5338453,18009
"2309","ENSGALG00000004974","12",5238244,5289513,51269
"2310","ENSGALG00000004975","4",2041814,2045101,3287
"2311","ENSGALG00000004980","6",14211114,14648816,437702
"2312","ENSGALG00000004981","12",5326624,5336795,10171
"2313","ENSGALG00000004986","17",5306106,5311904,5798
"2314","ENSGALG00000004991","12",5340144,5355247,15103
"2315","ENSGALG00000004997","14",5467856,5475958,8102
"2316","ENSGALG00000004998","12",5353662,5392350,38688
"2317","ENSGALG00000004999","4",2044717,2051320,6603
"2318","ENSGALG00000005000","6",15671950,15678555,6605
"2319","ENSGALG00000005001","12",5392472,5461851,69379
"2320","ENSGALG00000005002","6",15691878,15706094,14216
"2321","ENSGALG00000005004","6",15720706,15732613,11907
"2322","ENSGALG00000005005","14",5476096,5480584,4488
"2323","ENSGALG00000005006","11",11119446,11136709,17263
"2324","ENSGALG00000005007","6",15747223,15762578,15355
"2325","ENSGALG00000005011","10",10820876,10835698,14822
"2326","ENSGALG00000005012","12",5462895,5472995,10100
"2327","ENSGALG00000005014","4",2050685,2055056,4371
"2328","ENSGALG00000005016","Z",79844243,79926708,82465
"2329","ENSGALG00000005017","6",15764580,15786536,21956
"2330","ENSGALG00000005019","6",15803534,15823046,19512
"2331","ENSGALG00000005020","12",5473051,5484229,11178
"2332","ENSGALG00000005021","12",5493932,5506764,12832
"2333","ENSGALG00000005022","12",5515883,5519044,3161
"2334","ENSGALG00000005024","12",5546824,5591184,44360
"2335","ENSGALG00000005028","14",5481753,5493655,11902
"2336","ENSGALG00000005030","9",8661263,8781136,119873
"2337","ENSGALG00000005031","4",2056879,2068479,11600
"2338","ENSGALG00000005034","12",5621659,5646173,24514
"2339","ENSGALG00000005035","6",15829762,15916612,86850
"2340","ENSGALG00000005036","17",5276316,5295621,19305
"2341","ENSGALG00000005037","19",7214048,7221657,7609
"2342","ENSGALG00000005038","4",2078970,2095918,16948
"2343","ENSGALG00000005042","12",5657062,5792880,135818
"2344","ENSGALG00000005043","15",6963505,6970903,7398
"2345","ENSGALG00000005046","14",5503923,5511652,7729
"2346","ENSGALG00000005052","4",2111228,2112286,1058
"2347","ENSGALG00000005054","4",2116619,2125783,9164
"2348","ENSGALG00000005057","6",15948142,16221228,273086
"2349","ENSGALG00000005061","19",7304190,7308630,4440
"2350","ENSGALG00000005062","15",6973568,6988195,14627
"2351","ENSGALG00000005063","17",5241787,5243598,1811
"2352","ENSGALG00000005064","14",5519249,5533877,14628
"2353","ENSGALG00000005065","8",10608778,10684950,76172
"2354","ENSGALG00000005066","17",5233790,5239994,6204
"2355","ENSGALG00000005070","6",16221445,16238150,16705
"2356","ENSGALG00000005071","4",2126107,2141053,14946
"2357","ENSGALG00000005074","17",5201839,5237283,35444
"2358","ENSGALG00000005076","9",8632127,8646221,14094
"2359","ENSGALG00000005077","4",2144014,2164240,20226
"2360","ENSGALG00000005078","12",6021285,6080368,59083
"2361","ENSGALG00000005079","6",16242475,16296001,53526
"2362","ENSGALG00000005080","8",10813212,10837430,24218
"2363","ENSGALG00000005083","14",5535594,5564397,28803
"2364","ENSGALG00000005084","19",7313633,7334393,20760
"2365","ENSGALG00000005086","6",16341344,16349555,8211
"2366","ENSGALG00000005087","14",5544787,5556709,11922
"2367","ENSGALG00000005088","6",16404371,16525081,120710
"2368","ENSGALG00000005090","19",7334937,7342479,7542
"2369","ENSGALG00000005092","12",6100521,6125075,24554
"2370","ENSGALG00000005093","19",7348128,7352660,4532
"2371","ENSGALG00000005094","14",5564574,5568596,4022
"2372","ENSGALG00000005095","17",5166891,5181671,14780
"2373","ENSGALG00000005096","14",5629436,5631869,2433
"2374","ENSGALG00000005099","17",5160792,5162562,1770
"2375","ENSGALG00000005102","20",7236310,7648851,412541
"2376","ENSGALG00000005103","19",7353284,7364909,11625
"2377","ENSGALG00000005105","8",10837334,10878877,41543
"2378","ENSGALG00000005107","6",16558510,16661215,102705
"2379","ENSGALG00000005108","9",8558501,8609719,51218
"2380","ENSGALG00000005118","9",8549021,8551673,2652
"2381","ENSGALG00000005120","12",6210165,6279431,69266
"2382","ENSGALG00000005121","20",7673996,7708555,34559
"2383","ENSGALG00000005122","15",7006773,7029577,22804
"2384","ENSGALG00000005123","12",6435529,6467522,31993
"2385","ENSGALG00000005125","20",7721897,7732856,10959
"2386","ENSGALG00000005126","19",7410886,7423059,12173
"2387","ENSGALG00000005128","12",6506037,6514868,8831
"2388","ENSGALG00000005132","11",11193985,11196368,2383
"2389","ENSGALG00000005134","6",16669233,16730354,61121
"2390","ENSGALG00000005135","9",8473943,8497084,23141
"2391","ENSGALG00000005138","15",7032217,7041287,9070
"2392","ENSGALG00000005139","19",7424483,7453824,29341
"2393","ENSGALG00000005140","11",11211167,11216791,5624
"2394","ENSGALG00000005145","20",7741772,7756939,15167
"2395","ENSGALG00000005146","11",11300569,11305631,5062
"2396","ENSGALG00000005147","8",11450029,11467906,17877
"2397","ENSGALG00000005150","19",7455383,7456543,1160
"2398","ENSGALG00000005156","6",16746638,16758682,12044
"2399","ENSGALG00000005158","9",8445710,8469090,23380
"2400","ENSGALG00000005160","19",7456617,7512591,55974
"2401","ENSGALG00000005162","8",11468855,11483449,14594
"2402","ENSGALG00000005164","20",7757151,7762240,5089
"2403","ENSGALG00000005169","6",16774824,16781124,6300
"2404","ENSGALG00000005170","20",7770874,7779087,8213
"2405","ENSGALG00000005171","9",8423201,8439506,16305
"2406","ENSGALG00000005173","19",7521816,7528589,6773
"2407","ENSGALG00000005180","8",11693571,11741165,47594
"2408","ENSGALG00000005181","6",16782708,16809817,27109
"2409","ENSGALG00000005188","2",1070522,1138100,67578
"2410","ENSGALG00000005194","Z",9056639,9060366,3727
"2411","ENSGALG00000005195","20",7793104,7823035,29931
"2412","ENSGALG00000005198","19",7528763,7541085,12322
"2413","ENSGALG00000005200","20",7823884,7830932,7048
"2414","ENSGALG00000005203","8",11872299,11926941,54642
"2415","ENSGALG00000005204","15",8386812,8392109,5297
"2416","ENSGALG00000005205","19",7544599,7550856,6257
"2417","ENSGALG00000005206","9",8222654,8263172,40518
"2418","ENSGALG00000005207","6",16818878,16849933,31055
"2419","ENSGALG00000005208","8",12067120,12071019,3899
"2420","ENSGALG00000005209","2",1186169,1206259,20090
"2421","ENSGALG00000005212","2",1238715,1257265,18550
"2422","ENSGALG00000005214","11",11336170,11351377,15207
"2423","ENSGALG00000005215","14",5667870,5837019,169149
"2424","ENSGALG00000005217","9",8181677,8204484,22807
"2425","ENSGALG00000005223","2",1432870,1562154,129284
"2426","ENSGALG00000005226","6",16860338,16872753,12415
"2427","ENSGALG00000005229","8",12119346,12137301,17955
"2428","ENSGALG00000005230","19",7564936,7611409,46473
"2429","ENSGALG00000005232","6",16926091,16976146,50055
"2430","ENSGALG00000005236","9",8147337,8181705,34368
"2431","ENSGALG00000005237","12",7107979,7211462,103483
"2432","ENSGALG00000005241","11",11352669,11379958,27289
"2433","ENSGALG00000005242","2",1572974,1597843,24869
"2434","ENSGALG00000005243","6",16985735,17029305,43570
"2435","ENSGALG00000005247","14",5947292,5959521,12229
"2436","ENSGALG00000005248","8",12174912,12231784,56872
"2437","ENSGALG00000005249","12",7222115,7298893,76778
"2438","ENSGALG00000005251","11",11391261,11418784,27523
"2439","ENSGALG00000005252","8",12236462,12241257,4795
"2440","ENSGALG00000005253","14",5989615,5992223,2608
"2441","ENSGALG00000005254","11",11440156,11442802,2646
"2442","ENSGALG00000005256","9",7784937,7875161,90224
"2443","ENSGALG00000005257","8",12271795,12279181,7386
"2444","ENSGALG00000005258","14",6016630,6025175,8545
"2445","ENSGALG00000005259","2",1815087,1919770,104683
"2446","ENSGALG00000005263","14",6145956,6149345,3389
"2447","ENSGALG00000005265","5",7436058,7495397,59339
"2448","ENSGALG00000005266","11",11463948,11501923,37975
"2449","ENSGALG00000005268","2",1982684,1996512,13828
"2450","ENSGALG00000005269","19",7615239,7630260,15021
"2451","ENSGALG00000005277","8",12295535,12303972,8437
"2452","ENSGALG00000005279","19",7631791,7678745,46954
"2453","ENSGALG00000005280","8",12304101,12317552,13451
"2454","ENSGALG00000005283","9",6918243,6948708,30465
"2455","ENSGALG00000005284","8",12320048,12330981,10933
"2456","ENSGALG00000005285","19",7735478,7759275,23797
"2457","ENSGALG00000005287","2",2080866,2086418,5552
"2458","ENSGALG00000005290","8",12328300,12336161,7861
"2459","ENSGALG00000005291","14",6358204,6372021,13817
"2460","ENSGALG00000005292","2",2093895,2104170,10275
"2461","ENSGALG00000005293","14",6375556,6377491,1935
"2462","ENSGALG00000005294","5",7591669,7664920,73251
"2463","ENSGALG00000005295","19",7797174,8098869,301695
"2464","ENSGALG00000005297","2",2107464,2119611,12147
"2465","ENSGALG00000005298","17",5241069,5246953,5884
"2466","ENSGALG00000005299","6",17032797,17047411,14614
"2467","ENSGALG00000005302","8",12336171,12348597,12426
"2468","ENSGALG00000005303","2",2124989,2136868,11879
"2469","ENSGALG00000005305","2",2162908,2166703,3795
"2470","ENSGALG00000005309","12",7348689,7371332,22643
"2471","ENSGALG00000005314","19",8127011,8144977,17966
"2472","ENSGALG00000005315","14",6389096,6392406,3310
"2473","ENSGALG00000005316","Z",81135284,81191167,55883
"2474","ENSGALG00000005318","5",7676131,7692468,16337
"2475","ENSGALG00000005319","11",12824211,12973016,148805
"2476","ENSGALG00000005321","20",7832322,7910579,78257
"2477","ENSGALG00000005323","Z",44008388,44008987,599
"2478","ENSGALG00000005326","6",17053947,17058803,4856
"2479","ENSGALG00000005327","9",6067154,6078035,10881
"2480","ENSGALG00000005328","2",2387986,2392484,4498
"2481","ENSGALG00000005329","8",12349410,12364573,15163
"2482","ENSGALG00000005330","Z",81295733,81371880,76147
"2483","ENSGALG00000005331","2",2396097,2402774,6677
"2484","ENSGALG00000005332","12",7450925,7616503,165578
"2485","ENSGALG00000005336","2",2426967,2440924,13957
"2486","ENSGALG00000005337","Z",81461079,81494229,33150
"2487","ENSGALG00000005338","20",7932950,7938510,5560
"2488","ENSGALG00000005340","8",12370159,12388535,18376
"2489","ENSGALG00000005345","20",7941683,7956242,14559
"2490","ENSGALG00000005346","Z",81573781,81579815,6034
"2491","ENSGALG00000005347","11",13794910,13862852,67942
"2492","ENSGALG00000005349","14",6400336,6409625,9289
"2493","ENSGALG00000005350","19",8169952,8266166,96214
"2494","ENSGALG00000005351","Z",81605055,81673923,68868
"2495","ENSGALG00000005352","20",8019682,8030097,10415
"2496","ENSGALG00000005353","5",7710329,7748090,37761
"2497","ENSGALG00000005354","Z",81855523,81857544,2021
"2498","ENSGALG00000005357","9",6039052,6053320,14268
"2499","ENSGALG00000005359","6",17257036,17260757,3721
"2500","ENSGALG00000005360","19",8243835,8262292,18457
"2501","ENSGALG00000005361","11",13953742,13961321,7579
"2502","ENSGALG00000005363","12",7618908,7631523,12615
"2503","ENSGALG00000005365","14",6422730,6435778,13048
"2504","ENSGALG00000005367","9",6033561,6038799,5238
"2505","ENSGALG00000005368","Z",81708876,81746900,38024
"2506","ENSGALG00000005369","5",7794166,7820509,26343
"2507","ENSGALG00000005374","19",8273900,8290252,16352
"2508","ENSGALG00000005377","11",14060228,14531588,471360
"2509","ENSGALG00000005378","5",7820343,7864789,44446
"2510","ENSGALG00000005379","15",7203165,7224637,21472
"2511","ENSGALG00000005383","4",2185735,2190011,4276
"2512","ENSGALG00000005385","12",7633818,7641257,7439
"2513","ENSGALG00000005390","Z",81806718,81819704,12986
"2514","ENSGALG00000005391","12",7642056,7646168,4112
"2515","ENSGALG00000005393","2",2449662,2461758,12096
"2516","ENSGALG00000005395","Z",81832191,81847651,15460
"2517","ENSGALG00000005397","19",8296187,8312883,16696
"2518","ENSGALG00000005398","14",6439886,6448948,9062
"2519","ENSGALG00000005400","12",7720781,8130930,410149
"2520","ENSGALG00000005401","2",2665702,2717022,51320
"2521","ENSGALG00000005402","11",15120384,15130994,10610
"2522","ENSGALG00000005403","19",8314207,8335528,21321
"2523","ENSGALG00000005407","8",12469818,12503713,33895
"2524","ENSGALG00000005408","11",15458803,15472631,13828
"2525","ENSGALG00000005409","19",8536207,8539366,3159
"2526","ENSGALG00000005411","14",6451971,6456783,4812
"2527","ENSGALG00000005412","2",3278997,3314408,35411
"2528","ENSGALG00000005414","14",6507434,6520157,12723
"2529","ENSGALG00000005415","5",8004041,8091334,87293
"2530","ENSGALG00000005416","Z",31833333,31861093,27760
"2531","ENSGALG00000005417","2",3303811,3312840,9029
"2532","ENSGALG00000005418","8",12509733,12529822,20089
"2533","ENSGALG00000005419","12",8386407,8740271,353864
"2534","ENSGALG00000005420","19",8547245,8588658,41413
"2535","ENSGALG00000005421","14",6525004,6528361,3357
"2536","ENSGALG00000005422","6",17280775,17317773,36998
"2537","ENSGALG00000005423","Z",81867579,81872830,5251
"2538","ENSGALG00000005425","4",2200032,2217805,17773
"2539","ENSGALG00000005426","Z",31717415,31775790,58375
"2540","ENSGALG00000005430","2",3313209,3355141,41932
"2541","ENSGALG00000005434","Z",31707230,31708325,1095
"2542","ENSGALG00000005435","11",15418536,15454950,36414
"2543","ENSGALG00000005438","5",8179591,8207462,27871
"2544","ENSGALG00000005439","19",8593460,8693146,99686
"2545","ENSGALG00000005441","Z",31376186,31541016,164830
"2546","ENSGALG00000005442","8",12531463,12557002,25539
"2547","ENSGALG00000005448","2",3512686,3549349,36663
"2548","ENSGALG00000005450","12",8777157,8793042,15885
"2549","ENSGALG00000005451","6",17320779,17341233,20454
"2550","ENSGALG00000005452","19",8701796,8723880,22084
"2551","ENSGALG00000005456","11",15732855,15735747,2892
"2552","ENSGALG00000005458","14",6528969,6536325,7356
"2553","ENSGALG00000005460","20",8179858,8205178,25320
"2554","ENSGALG00000005462","6",17391366,17396259,4893
"2555","ENSGALG00000005464","4",2217826,2246491,28665
"2556","ENSGALG00000005465","14",6537182,6539428,2246
"2557","ENSGALG00000005467","11",15747635,15757141,9506
"2558","ENSGALG00000005468","19",8744826,8779072,34246
"2559","ENSGALG00000005470","8",12561720,12758336,196616
"2560","ENSGALG00000005472","11",15783046,15792110,9064
"2561","ENSGALG00000005473","11",15783046,15786682,3636
"2562","ENSGALG00000005474","11",15793378,15797891,4513
"2563","ENSGALG00000005475","4",2247938,2257549,9611
"2564","ENSGALG00000005476","2",3652705,3758795,106090
"2565","ENSGALG00000005478","8",12790282,12813460,23178
"2566","ENSGALG00000005481","12",8830149,8941812,111663
"2567","ENSGALG00000005483","11",15966487,16395265,428778
"2568","ENSGALG00000005487","2",3896895,3930891,33996
"2569","ENSGALG00000005489","19",8778606,8785894,7288
"2570","ENSGALG00000005490","14",6539294,6541961,2667
"2571","ENSGALG00000005493","4",2258265,2264371,6106
"2572","ENSGALG00000005494","11",16541642,16561927,20285
"2573","ENSGALG00000005499","12",8950452,8989422,38970
"2574","ENSGALG00000005502","11",16658649,16675822,17173
"2575","ENSGALG00000005503","11",16725796,16738294,12498
"2576","ENSGALG00000005504","19",8792517,8809163,16646
"2577","ENSGALG00000005505","9",5767466,5850702,83236
"2578","ENSGALG00000005506","12",8998425,9007651,9226
"2579","ENSGALG00000005507","4",2269274,2283429,14155
"2580","ENSGALG00000005509","8",12966245,13290132,323887
"2581","ENSGALG00000005512","15",7244600,7280058,35458
"2582","ENSGALG00000005515","15",7280820,7282692,1872
"2583","ENSGALG00000005516","19",8816345,8831771,15426
"2584","ENSGALG00000005517","2",4025276,4046080,20804
"2585","ENSGALG00000005519","6",17425485,17478708,53223
"2586","ENSGALG00000005521","9",5655084,5680030,24946
"2587","ENSGALG00000005522","19",8838677,8845322,6645
"2588","ENSGALG00000005524","20",8227321,8272370,45049
"2589","ENSGALG00000005525","19",8854438,8858046,3608
"2590","ENSGALG00000005527","12",9007497,9031248,23751
"2591","ENSGALG00000005530","19",8866264,8877882,11618
"2592","ENSGALG00000005531","20",8323108,8328203,5095
"2593","ENSGALG00000005533","4",2290629,2312885,22256
"2594","ENSGALG00000005534","6",17511469,17552060,40591
"2595","ENSGALG00000005535","13",13855851,13873523,17672
"2596","ENSGALG00000005537","12",9038049,9047098,9049
"2597","ENSGALG00000005540","5",8242174,8358807,116633
"2598","ENSGALG00000005541","4",2316360,2318850,2490
"2599","ENSGALG00000005543","9",5529446,5532957,3511
"2600","ENSGALG00000005544","9",5509855,5510772,917
"2601","ENSGALG00000005547","6",17555230,17600114,44884
"2602","ENSGALG00000005549","19",8884139,8898622,14483
"2603","ENSGALG00000005550","9",5412062,5444046,31984
"2604","ENSGALG00000005551","5",8397385,8419626,22241
"2605","ENSGALG00000005552","8",13336528,13398389,61861
"2606","ENSGALG00000005553","4",2322335,2351352,29017
"2607","ENSGALG00000005554","9",5398453,5403001,4548
"2608","ENSGALG00000005558","14",6543051,6553285,10234
"2609","ENSGALG00000005559","19",8900796,8902874,2078
"2610","ENSGALG00000005567","19",8923405,9107370,183965
"2611","ENSGALG00000005569","5",8422219,8474922,52703
"2612","ENSGALG00000005571","8",13729738,13737105,7367
"2613","ENSGALG00000005572","14",6553214,6557431,4217
"2614","ENSGALG00000005575","19",9121994,9144694,22700
"2615","ENSGALG00000005579","14",6565542,6570116,4574
"2616","ENSGALG00000005580","8",13738852,13781167,42315
"2617","ENSGALG00000005582","2",4048418,4071760,23342
"2618","ENSGALG00000005583","8",13781317,13802579,21262
"2619","ENSGALG00000005584","5",8537044,8777333,240289
"2620","ENSGALG00000005587","5",9011427,9022665,11238
"2621","ENSGALG00000005589","14",6572269,6596578,24309
"2622","ENSGALG00000005594","19",9182682,9186458,3776
"2623","ENSGALG00000005595","15",7434521,7445818,11297
"2624","ENSGALG00000005597","8",13815244,13837179,21935
"2625","ENSGALG00000005598","14",6599142,6613765,14623
"2626","ENSGALG00000005599","6",17613138,17622310,9172
"2627","ENSGALG00000005601","12",9048747,9114490,65743
"2628","ENSGALG00000005608","14",6632320,6660242,27922
"2629","ENSGALG00000005609","20",8328212,8337556,9344
"2630","ENSGALG00000005610","8",13840231,13932290,92059
"2631","ENSGALG00000005612","2",4102174,4126164,23990
"2632","ENSGALG00000005613","6",17640007,17642288,2281
"2633","ENSGALG00000005614","15",7445260,7446863,1603
"2634","ENSGALG00000005616","13",13888545,13891555,3010
"2635","ENSGALG00000005617","14",6660806,6665789,4983
"2636","ENSGALG00000005618","5",9037142,9055364,18222
"2637","ENSGALG00000005619","8",13932222,13939362,7140
"2638","ENSGALG00000005621","13",13896868,13917085,20217
"2639","ENSGALG00000005622","12",9119458,9129851,10393
"2640","ENSGALG00000005623","15",7446507,7456494,9987
"2641","ENSGALG00000005626","15",7454492,7464825,10333
"2642","ENSGALG00000005628","20",8340728,8372146,31418
"2643","ENSGALG00000005630","15",7465177,7483070,17893
"2644","ENSGALG00000005631","9",5367515,5380854,13339
"2645","ENSGALG00000005632","5",9121570,9145502,23932
"2646","ENSGALG00000005634","15",7458871,7470893,12022
"2647","ENSGALG00000005637","6",17661496,17759694,98198
"2648","ENSGALG00000005638","4",2390550,2394261,3711
"2649","ENSGALG00000005643","5",9149552,9160157,10605
"2650","ENSGALG00000005644","2",4129233,4138053,8820
"2651","ENSGALG00000005646","14",6666643,6696121,29478
"2652","ENSGALG00000005647","8",13947647,13974017,26370
"2653","ENSGALG00000005648","4",2395597,2401986,6389
"2654","ENSGALG00000005649","6",17762866,17767843,4977
"2655","ENSGALG00000005651","11",16837056,16851013,13957
"2656","ENSGALG00000005652","20",8379979,8427313,47334
"2657","ENSGALG00000005653","6",17767580,17775671,8091
"2658","ENSGALG00000005654","15",7819084,7836307,17223
"2659","ENSGALG00000005655","9",5360592,5365725,5133
"2660","ENSGALG00000005656","12",9131936,9151391,19455
"2661","ENSGALG00000005657","2",4245112,4382203,137091
"2662","ENSGALG00000005659","4",2418535,2426800,8265
"2663","ENSGALG00000005660","19",9152551,9232106,79555
"2664","ENSGALG00000005661","2",4416749,4418563,1814
"2665","ENSGALG00000005662","5",9179063,9204672,25609
"2666","ENSGALG00000005667","9",5336966,5354172,17206
"2667","ENSGALG00000005668","19",9244014,9251499,7485
"2668","ENSGALG00000005670","12",9157916,9234162,76246
"2669","ENSGALG00000005672","13",13923362,13933620,10258
"2670","ENSGALG00000005673","10",11034282,11039009,4727
"2671","ENSGALG00000005674","11",16858652,16903198,44546
"2672","ENSGALG00000005675","9",5328489,5334339,5850
"2673","ENSGALG00000005676","15",7841495,7967456,125961
"2674","ENSGALG00000005678","12",9260248,9328729,68481
"2675","ENSGALG00000005679","13",13936846,13947085,10239
"2676","ENSGALG00000005682","10",11112583,11114349,1766
"2677","ENSGALG00000005683","8",13997576,14048208,50632
"2678","ENSGALG00000005684","6",17811592,17814305,2713
"2679","ENSGALG00000005685","19",9302652,9331188,28536
"2680","ENSGALG00000005687","6",17815013,17826035,11022
"2681","ENSGALG00000005688","12",9331542,9335224,3682
"2682","ENSGALG00000005689","6",17930807,18009556,78749
"2683","ENSGALG00000005694","2",4427833,4450500,22667
"2684","ENSGALG00000005695","15",7966112,7979171,13059
"2685","ENSGALG00000005696","12",9340653,9350933,10280
"2686","ENSGALG00000005698","6",18236535,18246423,9888
"2687","ENSGALG00000005699","19",9404696,9445516,40820
"2688","ENSGALG00000005700","20",8431479,8437948,6469
"2689","ENSGALG00000005701","12",9362450,9382321,19871
"2690","ENSGALG00000005702","19",9445802,9449883,4081
"2691","ENSGALG00000005703","10",11129292,11143870,14578
"2692","ENSGALG00000005704","6",18246637,18249367,2730
"2693","ENSGALG00000005706","15",7979264,7982270,3006
"2694","ENSGALG00000005707","19",9449074,9451267,2193
"2695","ENSGALG00000005708","11",16993544,17014236,20692
"2696","ENSGALG00000005710","2",4568785,4637109,68324
"2697","ENSGALG00000005713","12",9387203,9422420,35217
"2698","ENSGALG00000005714","14",6699971,6782586,82615
"2699","ENSGALG00000005716","5",9248870,9478933,230063
"2700","ENSGALG00000005718","20",8485910,8489984,4074
"2701","ENSGALG00000005721","9",5304098,5318084,13986
"2702","ENSGALG00000005722","6",18250654,18282430,31776
"2703","ENSGALG00000005725","13",13980059,13997910,17851
"2704","ENSGALG00000005733","6",18287218,18291826,4608
"2705","ENSGALG00000005737","19",9451330,9509867,58537
"2706","ENSGALG00000005739","6",18321285,18340590,19305
"2707","ENSGALG00000005744","11",17614798,17622303,7505
"2708","ENSGALG00000005745","20",8701743,8714334,12591
"2709","ENSGALG00000005747","4",2437020,2438111,1091
"2710","ENSGALG00000005749","11",17610547,17614743,4196
"2711","ENSGALG00000005750","5",9534149,9568096,33947
"2712","ENSGALG00000005752","8",14062866,14135100,72234
"2713","ENSGALG00000005753","4",2439653,2443073,3420
"2714","ENSGALG00000005754","11",17599345,17606961,7616
"2715","ENSGALG00000005757","11",17590414,17597150,6736
"2716","ENSGALG00000005759","Z",7372029,7372640,611
"2717","ENSGALG00000005762","20",8719016,8728781,9765
"2718","ENSGALG00000005763","2",4666085,4685727,19642
"2719","ENSGALG00000005766","6",18351666,18365667,14001
"2720","ENSGALG00000005767","14",6815258,6843873,28615
"2721","ENSGALG00000005768","9",5289877,5299258,9381
"2722","ENSGALG00000005769","5",9572428,9580919,8491
"2723","ENSGALG00000005770","13",14000097,14017080,16983
"2724","ENSGALG00000005772","9",5256404,5276844,20440
"2725","ENSGALG00000005774","20",8729917,8777657,47740
"2726","ENSGALG00000005775","4",2447051,2466722,19671
"2727","ENSGALG00000005776","8",14137372,14149521,12149
"2728","ENSGALG00000005778","15",7983414,7992601,9187
"2729","ENSGALG00000005779","11",17771651,17789514,17863
"2730","ENSGALG00000005781","20",8784838,8801814,16976
"2731","ENSGALG00000005782","8",14159785,14264973,105188
"2732","ENSGALG00000005784","15",7993411,7998234,4823
"2733","ENSGALG00000005787","5",9588123,9619996,31873
"2734","ENSGALG00000005788","9",5174155,5238789,64634
"2735","ENSGALG00000005789","12",9456460,9465454,8994
"2736","ENSGALG00000005790","20",8807030,8821031,14001
"2737","ENSGALG00000005794","6",18393039,18397700,4661
"2738","ENSGALG00000005795","6",18406321,18414396,8075
"2739","ENSGALG00000005796","15",8001344,8004755,3411
"2740","ENSGALG00000005797","20",8822383,8865514,43131
"2741","ENSGALG00000005800","Z",7510336,7540872,30536
"2742","ENSGALG00000005801","20",8870865,8890329,19464
"2743","ENSGALG00000005802","13",14053033,14099309,46276
"2744","ENSGALG00000005803","15",8012874,8084346,71472
"2745","ENSGALG00000005805","2",4687442,4736540,49098
"2746","ENSGALG00000005806","Z",7583295,7612042,28747
"2747","ENSGALG00000005807","5",9624027,9655347,31320
"2748","ENSGALG00000005808","15",8093227,8111255,18028
"2749","ENSGALG00000005809","9",5151187,5166192,15005
"2750","ENSGALG00000005814","Z",7654557,7656593,2036
"2751","ENSGALG00000005815","5",9669263,9676928,7665
"2752","ENSGALG00000005820","13",14101869,14133615,31746
"2753","ENSGALG00000005821","Z",7677351,7715763,38412
"2754","ENSGALG00000005822","20",8932804,8991081,58277
"2755","ENSGALG00000005823","9",5116399,5150308,33909
"2756","ENSGALG00000005824","15",8114798,8130894,16096
"2757","ENSGALG00000005826","2",4751686,4787893,36207
"2758","ENSGALG00000005830","19",9522848,9547621,24773
"2759","ENSGALG00000005831","Z",7780562,7905039,124477
"2760","ENSGALG00000005834","19",9586056,9615085,29029
"2761","ENSGALG00000005839","Z",7926291,7938483,12192
"2762","ENSGALG00000005840","5",9681277,9737308,56031
"2763","ENSGALG00000005842","4",2531208,2539175,7967
"2764","ENSGALG00000005843","20",9001254,9014412,13158
"2765","ENSGALG00000005845","11",17954812,17987235,32423
"2766","ENSGALG00000005846","Z",30957164,31049251,92087
"2767","ENSGALG00000005848","Z",8328565,8349086,20521
"2768","ENSGALG00000005849","20",9020800,9023108,2308
"2769","ENSGALG00000005850","8",14265560,14318955,53395
"2770","ENSGALG00000005852","20",9027158,9033512,6354
"2771","ENSGALG00000005853","4",2708137,2824865,116728
"2772","ENSGALG00000005854","19",9617661,9642214,24553
"2773","ENSGALG00000005855","11",17992311,18000421,8110
"2774","ENSGALG00000005856","13",14144151,14161503,17352
"2775","ENSGALG00000005857","6",18466839,18488267,21428
"2776","ENSGALG00000005858","8",14328120,14340589,12469
"2777","ENSGALG00000005860","2",4788891,4796965,8074
"2778","ENSGALG00000005861","14",6876093,6882097,6004
"2779","ENSGALG00000005862","15",8132945,8134668,1723
"2780","ENSGALG00000005867","6",18496927,18582316,85389
"2781","ENSGALG00000005869","12",9501312,9520387,19075
"2782","ENSGALG00000005872","11",18012363,18142822,130459
"2783","ENSGALG00000005878","14",6881536,6886510,4974
"2784","ENSGALG00000005882","4",2861231,2899005,37774
"2785","ENSGALG00000005884","2",4797808,4866093,68285
"2786","ENSGALG00000005885","15",8150942,8161390,10448
"2787","ENSGALG00000005886","19",9783481,9807365,23884
"2788","ENSGALG00000005888","14",6892250,6895546,3296
"2789","ENSGALG00000005889","8",14351493,14378262,26769
"2790","ENSGALG00000005891","15",8162642,8197559,34917
"2791","ENSGALG00000005893","6",18594248,18614513,20265
"2792","ENSGALG00000005894","10",11279577,11302025,22448
"2793","ENSGALG00000005896","15",8203883,8207643,3760
"2794","ENSGALG00000005897","12",9520459,9523459,3000
"2795","ENSGALG00000005900","14",6895718,6902692,6974
"2796","ENSGALG00000005901","20",9080298,9091978,11680
"2797","ENSGALG00000005902","12",9533929,9552794,18865
"2798","ENSGALG00000005903","5",9791730,9802780,11050
"2799","ENSGALG00000005904","8",14378876,14386605,7729
"2800","ENSGALG00000005905","14",6905008,6910974,5966
"2801","ENSGALG00000005907","12",9559413,9566986,7573
"2802","ENSGALG00000005908","5",9814177,9822449,8272
"2803","ENSGALG00000005909","12",9596109,9612130,16021
"2804","ENSGALG00000005914","6",18616583,18647534,30951
"2805","ENSGALG00000005918","8",14431709,14445937,14228
"2806","ENSGALG00000005922","8",14447758,14455256,7498
"2807","ENSGALG00000005923","6",18684046,18690552,6506
"2808","ENSGALG00000005924","13",14200870,14211125,10255
"2809","ENSGALG00000005928","19",9910100,9922595,12495
"2810","ENSGALG00000005929","13",14222792,14240938,18146
"2811","ENSGALG00000005930","4",2950481,2994938,44457
"2812","ENSGALG00000005931","12",9907189,9925537,18348
"2813","ENSGALG00000005932","20",9103180,9131619,28439
"2814","ENSGALG00000005933","14",6944708,6956149,11441
"2815","ENSGALG00000005934","2",5019153,5024005,4852
"2816","ENSGALG00000005936","4",2997857,3013197,15340
"2817","ENSGALG00000005938","14",6956912,6960203,3291
"2818","ENSGALG00000005944","9",17687917,17692375,4458
"2819","ENSGALG00000005947","2",4892458,4905115,12657
"2820","ENSGALG00000005948","5",9990843,9993911,3068
"2821","ENSGALG00000005951","15",8240436,8242752,2316
"2822","ENSGALG00000005953","8",14565754,14600186,34432
"2823","ENSGALG00000005956","6",18712501,18725961,13460
"2824","ENSGALG00000005957","4",3042069,3056203,14134
"2825","ENSGALG00000005958","5",10005768,10037297,31529
"2826","ENSGALG00000005959","8",14599942,14643173,43231
"2827","ENSGALG00000005961","13",14282890,14288271,5381
"2828","ENSGALG00000005964","4",3068330,3073413,5083
"2829","ENSGALG00000005966","12",9936983,9947735,10752
"2830","ENSGALG00000005968","15",8274524,8282968,8444
"2831","ENSGALG00000005969","6",18741815,18788695,46880
"2832","ENSGALG00000005971","5",10431294,10445037,13743
"2833","ENSGALG00000005972","12",9962393,9989249,26856
"2834","ENSGALG00000005973","14",7014706,7034373,19667
"2835","ENSGALG00000005974","7",6741231,6760769,19538
"2836","ENSGALG00000005975","6",18791954,18809656,17702
"2837","ENSGALG00000005976","20",9351561,9367830,16269
"2838","ENSGALG00000005977","8",14636254,14671765,35511
"2839","ENSGALG00000005978","6",18815478,18829935,14457
"2840","ENSGALG00000005979","2",4915988,5006109,90121
"2841","ENSGALG00000005981","6",18841742,18845428,3686
"2842","ENSGALG00000005982","4",3197457,3265724,68267
"2843","ENSGALG00000005983","15",8282835,8293532,10697
"2844","ENSGALG00000005985","6",18850965,18862872,11907
"2845","ENSGALG00000005986","5",10457958,10515004,57046
"2846","ENSGALG00000005992","10",11397441,11504013,106572
"2847","ENSGALG00000005994","15",8295036,8299924,4888
"2848","ENSGALG00000005995","19",9919986,9937317,17331
"2849","ENSGALG00000005996","10",11514677,11532698,18021
"2850","ENSGALG00000005997","4",3290944,3311600,20656
"2851","ENSGALG00000005998","5",10584558,10619955,35397
"2852","ENSGALG00000005999","12",10069635,10096797,27162
"2853","ENSGALG00000006001","20",9411755,9435643,23888
"2854","ENSGALG00000006002","10",11535844,11547540,11696
"2855","ENSGALG00000006007","20",9442480,9452082,9602
"2856","ENSGALG00000006008","10",11559419,11588865,29446
"2857","ENSGALG00000006009","12",10097118,10129130,32012
"2858","ENSGALG00000006010","10",11621075,11624022,2947
"2859","ENSGALG00000006011","19",9953043,9974603,21560
"2860","ENSGALG00000006013","20",9462229,9488060,25831
"2861","ENSGALG00000006015","5",10651664,10668952,17288
"2862","ENSGALG00000006016","9",5080014,5097549,17535
"2863","ENSGALG00000006017","4",3316455,3386100,69645
"2864","ENSGALG00000006018","2",5008677,5015039,6362
"2865","ENSGALG00000006019","8",14672386,14688883,16497
"2866","ENSGALG00000006020","10",11643180,11656460,13280
"2867","ENSGALG00000006022","5",10668250,10675823,7573
"2868","ENSGALG00000006025","2",5035589,5057115,21526
"2869","ENSGALG00000006027","10",11664716,11683763,19047
"2870","ENSGALG00000006031","8",14698872,14714760,15888
"2871","ENSGALG00000006033","2",5347137,5353920,6783
"2872","ENSGALG00000006034","19",9974434,10024381,49947
"2873","ENSGALG00000006035","5",10693066,10768567,75501
"2874","ENSGALG00000006037","12",10137401,10148820,11419
"2875","ENSGALG00000006038","8",14742786,14850067,107281
"2876","ENSGALG00000006040","20",9491130,9503800,12670
"2877","ENSGALG00000006041","10",11747963,11814277,66314
"2878","ENSGALG00000006043","14",7172489,7203850,31361
"2879","ENSGALG00000006044","9",5048219,5051725,3506
"2880","ENSGALG00000006045","10",11857452,11901262,43810
"2881","ENSGALG00000006047","12",10150244,10166115,15871
"2882","ENSGALG00000006048","19",10024453,10039126,14673
"2883","ENSGALG00000006049","4",3425936,3453335,27399
"2884","ENSGALG00000006050","5",10781249,10791201,9952
"2885","ENSGALG00000006051","8",14895304,14912309,17005
"2886","ENSGALG00000006052","2",5355491,5379083,23592
"2887","ENSGALG00000006053","15",8308323,8317487,9164
"2888","ENSGALG00000006054","5",10769515,10802866,33351
"2889","ENSGALG00000006056","12",10166704,10269571,102867
"2890","ENSGALG00000006057","13",14827875,14836883,9008
"2891","ENSGALG00000006061","4",3473459,3480395,6936
"2892","ENSGALG00000006062","20",9569513,9605598,36085
"2893","ENSGALG00000006064","19",10042756,10052236,9480
"2894","ENSGALG00000006068","14",7241377,7268892,27515
"2895","ENSGALG00000006069","19",10057630,10079751,22121
"2896","ENSGALG00000006072","2",5451025,5481478,30453
"2897","ENSGALG00000006073","14",7277376,7279266,1890
"2898","ENSGALG00000006074","5",11366630,11601652,235022
"2899","ENSGALG00000006076","13",14754116,14817923,63807
"2900","ENSGALG00000006077","5",11765074,11770877,5803
"2901","ENSGALG00000006078","14",7279377,7288943,9566
"2902","ENSGALG00000006080","4",3771853,3833252,61399
"2903","ENSGALG00000006083","10",11903990,11918958,14968
"2904","ENSGALG00000006087","4",3845726,3958957,113231
"2905","ENSGALG00000006088","14",7288979,7295766,6787
"2906","ENSGALG00000006091","8",14942815,14955149,12334
"2907","ENSGALG00000006092","20",9621257,9628621,7364
"2908","ENSGALG00000006094","4",3991827,4012722,20895
"2909","ENSGALG00000006096","5",11951870,11956268,4398
"2910","ENSGALG00000006097","12",10299237,10383397,84160
"2911","ENSGALG00000006098","4",4025689,4042949,17260
"2912","ENSGALG00000006101","20",9629100,9642654,13554
"2913","ENSGALG00000006104","10",12079844,12100380,20536
"2914","ENSGALG00000006106","20",9650082,9655443,5361
"2915","ENSGALG00000006108","4",4070477,4079067,8590
"2916","ENSGALG00000006109","6",19006936,19110449,103513
"2917","ENSGALG00000006110","14",7296562,7302521,5959
"2918","ENSGALG00000006112","2",5538868,5700257,161389
"2919","ENSGALG00000006113","8",15351257,15372541,21284
"2920","ENSGALG00000006117","14",7316394,7321981,5587
"2921","ENSGALG00000006118","11",18379252,18412636,33384
"2922","ENSGALG00000006119","10",12109325,12115762,6437
"2923","ENSGALG00000006120","13",15109179,15119211,10032
"2924","ENSGALG00000006121","5",11958466,12018064,59598
"2925","ENSGALG00000006122","14",7322166,7328970,6804
"2926","ENSGALG00000006123","20",9658906,9695548,36642
"2927","ENSGALG00000006127","4",4080433,4093980,13547
"2928","ENSGALG00000006130","20",9700709,9711179,10470
"2929","ENSGALG00000006131","7",6813342,6820174,6832
"2930","ENSGALG00000006132","4",4097508,4111721,14213
"2931","ENSGALG00000006133","7",6834552,6835948,1396
"2932","ENSGALG00000006134","6",23275784,23279169,3385
"2933","ENSGALG00000006137","6",19118047,19156066,38019
"2934","ENSGALG00000006138","20",9732482,9752786,20304
"2935","ENSGALG00000006140","14",7329807,7338318,8511
"2936","ENSGALG00000006141","7",6883186,6897532,14346
"2937","ENSGALG00000006143","6",23266557,23272729,6172
"2938","ENSGALG00000006144","11",18760175,18764817,4642
"2939","ENSGALG00000006147","5",12022253,12051047,28794
"2940","ENSGALG00000006149","6",23273199,23275691,2492
"2941","ENSGALG00000006152","20",9786517,9794241,7724
"2942","ENSGALG00000006153","2",5782448,5801847,19399
"2943","ENSGALG00000006156","14",7336991,7358644,21653
"2944","ENSGALG00000006157","4",4132552,4164537,31985
"2945","ENSGALG00000006158","2",5811828,5901800,89972
"2946","ENSGALG00000006160","13",15180801,15181724,923
"2947","ENSGALG00000006161","11",18755498,18759263,3765
"2948","ENSGALG00000006165","6",19271811,19318331,46520
"2949","ENSGALG00000006167","8",15496216,15521468,25252
"2950","ENSGALG00000006170","8",15464547,15478321,13774
"2951","ENSGALG00000006172","5",12070315,12134884,64569
"2952","ENSGALG00000006173","2",6172986,6255970,82984
"2953","ENSGALG00000006174","6",19392946,19425288,32342
"2954","ENSGALG00000006175","11",18749428,18753144,3716
"2955","ENSGALG00000006179","11",18734052,18738360,4308
"2956","ENSGALG00000006180","4",4178763,4197070,18307
"2957","ENSGALG00000006181","2",6273813,6290633,16820
"2958","ENSGALG00000006182","20",9807223,9814892,7669
"2959","ENSGALG00000006186","20",9847813,9861801,13988
"2960","ENSGALG00000006188","8",15524413,15545438,21025
"2961","ENSGALG00000006189","2",6325398,6329886,4488
"2962","ENSGALG00000006190","4",4200870,4231430,30560
"2963","ENSGALG00000006192","5",12148432,12193954,45522
"2964","ENSGALG00000006194","20",9910901,9915465,4564
"2965","ENSGALG00000006197","20",9935277,9957940,22663
"2966","ENSGALG00000006198","7",6913221,6923292,10071
"2967","ENSGALG00000006201","20",9958550,9965786,7236
"2968","ENSGALG00000006202","14",7361816,7370915,9099
"2969","ENSGALG00000006203","20",9976045,9983068,7023
"2970","ENSGALG00000006205","8",15547182,15564927,17745
"2971","ENSGALG00000006207","20",9989963,10003069,13106
"2972","ENSGALG00000006211","20",10015064,10033228,18164
"2973","ENSGALG00000006216","5",12395624,12398842,3218
"2974","ENSGALG00000006217","7",6928671,6931688,3017
"2975","ENSGALG00000006219","2",6368885,6550794,181909
"2976","ENSGALG00000006220","5",12414763,12510791,96028
"2977","ENSGALG00000006221","9",5010321,5043013,32692
"2978","ENSGALG00000006225","10",12115837,12171882,56045
"2979","ENSGALG00000006229","25",2452489,2458591,6102
"2980","ENSGALG00000006231","5",12523791,12654177,130386
"2981","ENSGALG00000006233","2",6578374,6618231,39857
"2982","ENSGALG00000006236","5",12656760,12667360,10600
"2983","ENSGALG00000006237","8",15570672,15620490,49818
"2984","ENSGALG00000006239","6",19551920,19556673,4753
"2985","ENSGALG00000006241","9",24085087,24091634,6547
"2986","ENSGALG00000006242","11",18519181,18520626,1445
"2987","ENSGALG00000006246","9",16034406,16038155,3749
"2988","ENSGALG00000006250","11",18514747,18518136,3389
"2989","ENSGALG00000006252","8",16116468,16130653,14185
"2990","ENSGALG00000006253","9",5001443,5010056,8613
"2991","ENSGALG00000006254","6",19565955,19609491,43536
"2992","ENSGALG00000006258","13",15289707,15400987,111280
"2993","ENSGALG00000006260","9",4998020,5005575,7555
"2994","ENSGALG00000006261","8",16296960,16315002,18042
"2995","ENSGALG00000006267","20",10034302,10047698,13396
"2996","ENSGALG00000006270","14",7379189,7388599,9410
"2997","ENSGALG00000006272","9",16037792,16044575,6783
"2998","ENSGALG00000006273","20",10051629,10058646,7017
"2999","ENSGALG00000006283","9",4978365,4992700,14335
"3000","ENSGALG00000006284","8",16326269,16343226,16957
"3001","ENSGALG00000006286","14",7388848,7411353,22505
"3002","ENSGALG00000006290","14",7497239,7540825,43586
"3003","ENSGALG00000006292","2",6879822,6904349,24527
"3004","ENSGALG00000006294","9",16044675,16050994,6319
"3005","ENSGALG00000006297","13",15696791,15759768,62977
"3006","ENSGALG00000006298","9",4958640,4978293,19653
"3007","ENSGALG00000006300","5",12754029,12780561,26532
"3008","ENSGALG00000006301","14",7676431,7681914,5483
"3009","ENSGALG00000006302","6",20032197,20039312,7115
"3010","ENSGALG00000006305","9",4951779,4957263,5484
"3011","ENSGALG00000006306","12",11080285,11103940,23655
"3012","ENSGALG00000006307","14",7681768,7689009,7241
"3013","ENSGALG00000006309","13",15805507,15833180,27673
"3014","ENSGALG00000006312","5",12760478,12774385,13907
"3015","ENSGALG00000006317","9",4943378,4951651,8273
"3016","ENSGALG00000006318","14",7710463,7723251,12788
"3017","ENSGALG00000006320","15",8345049,8354558,9509
"3018","ENSGALG00000006322","8",16349218,16362800,13582
"3019","ENSGALG00000006323","13",15913091,15918063,4972
"3020","ENSGALG00000006325","12",11116418,11157789,41371
"3021","ENSGALG00000006326","15",8375207,8377034,1827
"3022","ENSGALG00000006327","13",15919410,15932584,13174
"3023","ENSGALG00000006328","12",11166241,11175396,9155
"3024","ENSGALG00000006329","13",15943328,15957612,14284
"3025","ENSGALG00000006331","6",20042684,20062218,19534
"3026","ENSGALG00000006332","1",4112110,4125975,13865
"3027","ENSGALG00000006334","4",75971194,75983004,11810
"3028","ENSGALG00000006341","13",15959333,15976071,16738
"3029","ENSGALG00000006342","5",12774686,12786050,11364
"3030","ENSGALG00000006343","6",20062668,20118932,56264
"3031","ENSGALG00000006344","15",8395951,8406821,10870
"3032","ENSGALG00000006345","12",11175609,11186645,11036
"3033","ENSGALG00000006346","13",16035275,16042796,7521
"3034","ENSGALG00000006350","15",8408011,8410445,2434
"3035","ENSGALG00000006351","6",20087175,20099497,12322
"3036","ENSGALG00000006352","6",20161234,20165780,4546
"3037","ENSGALG00000006354","9",4924759,4930056,5297
"3038","ENSGALG00000006355","5",12791511,12803475,11964
"3039","ENSGALG00000006356","1",3736971,3836067,99096
"3040","ENSGALG00000006357","12",11188945,11196767,7822
"3041","ENSGALG00000006361","9",4921468,4924316,2848
"3042","ENSGALG00000006362","2",7796809,7798633,1824
"3043","ENSGALG00000006363","15",8412346,8504251,91905
"3044","ENSGALG00000006367","13",16352132,16368162,16030
"3045","ENSGALG00000006368","5",12883349,12965653,82304
"3046","ENSGALG00000006371","13",16377691,16380816,3125
"3047","ENSGALG00000006372","2",8053974,8140763,86789
"3048","ENSGALG00000006374","15",8525645,8536564,10919
"3049","ENSGALG00000006375","9",4917495,4926717,9222
"3050","ENSGALG00000006376","10",12525266,12542521,17255
"3051","ENSGALG00000006378","6",20166929,20179294,12365
"3052","ENSGALG00000006379","2",8166209,8175880,9671
"3053","ENSGALG00000006382","5",13013917,13081114,67197
"3054","ENSGALG00000006385","9",4891411,4917621,26210
"3055","ENSGALG00000006387","2",8502129,8513581,11452
"3056","ENSGALG00000006388","10",12549593,12590413,40820
"3057","ENSGALG00000006390","15",8549986,8561869,11883
"3058","ENSGALG00000006392","9",4879911,4889610,9699
"3059","ENSGALG00000006393","4",4303444,4313877,10433
"3060","ENSGALG00000006394","14",7726359,7738340,11981
"3061","ENSGALG00000006395","9",4871958,4876064,4106
"3062","ENSGALG00000006399","10",12666066,12667133,1067
"3063","ENSGALG00000006401","5",13094418,13254458,160040
"3064","ENSGALG00000006402","9",4855404,4859977,4573
"3065","ENSGALG00000006403","10",12677503,12683390,5887
"3066","ENSGALG00000006404","13",16391606,16409679,18073
"3067","ENSGALG00000006405","9",4851073,4855829,4756
"3068","ENSGALG00000006406","4",4321737,4327851,6114
"3069","ENSGALG00000006407","5",13256269,13266308,10039
"3070","ENSGALG00000006408","9",4846157,4851312,5155
"3071","ENSGALG00000006409","1",3688056,3728758,40702
"3072","ENSGALG00000006410","4",4332282,4345435,13153
"3073","ENSGALG00000006411","13",16412239,16415262,3023
"3074","ENSGALG00000006412","4",4348840,4354659,5819
"3075","ENSGALG00000006413","10",12689664,12736649,46985
"3076","ENSGALG00000006415","4",4365859,4369906,4047
"3077","ENSGALG00000006417","13",16416762,16440002,23240
"3078","ENSGALG00000006418","14",7742569,7773050,30481
"3079","ENSGALG00000006420","10",12796230,12826671,30441
"3080","ENSGALG00000006421","6",20194880,20203208,8328
"3081","ENSGALG00000006422","15",8567577,8582523,14946
"3082","ENSGALG00000006423","14",7782280,7789956,7676
"3083","ENSGALG00000006424","13",16465774,16518603,52829
"3084","ENSGALG00000006425","12",11318269,11407020,88751
"3085","ENSGALG00000006426","9",4807197,4827091,19894
"3086","ENSGALG00000006427","5",13266596,13301342,34746
"3087","ENSGALG00000006428","14",7811646,7819827,8181
"3088","ENSGALG00000006430","15",8592927,8608665,15738
"3089","ENSGALG00000006431","6",20227632,20253500,25868
"3090","ENSGALG00000006434","14",7820952,7824137,3185
"3091","ENSGALG00000006436","9",4800305,4802155,1850
"3092","ENSGALG00000006437","2",8600621,8614906,14285
"3093","ENSGALG00000006439","4",4374897,4404306,29409
"3094","ENSGALG00000006441","14",7823897,7832947,9050
"3095","ENSGALG00000006443","1",195587654,195590524,2870
"3096","ENSGALG00000006445","10",12854642,12928455,73813
"3097","ENSGALG00000006446","5",13305879,13331820,25941
"3098","ENSGALG00000006453","9",4765436,4777129,11693
"3099","ENSGALG00000006454","5",13347574,13396672,49098
"3100","ENSGALG00000006455","15",8611686,8627636,15950
"3101","ENSGALG00000006456","14",7881342,7922149,40807
"3102","ENSGALG00000006457","4",4410295,4425195,14900
"3103","ENSGALG00000006459","12",11645027,11656746,11719
"3104","ENSGALG00000006460","20",10075293,10086559,11266
"3105","ENSGALG00000006461","2",8668167,8731922,63755
"3106","ENSGALG00000006462","13",16586221,16602196,15975
"3107","ENSGALG00000006465","12",11664478,11669688,5210
"3108","ENSGALG00000006467","20",10088809,10098528,9719
"3109","ENSGALG00000006469","24",2877577,2895175,17598
"3110","ENSGALG00000006471","9",4734672,4758168,23496
"3111","ENSGALG00000006473","1",2887148,3334587,447439
"3112","ENSGALG00000006474","13",16610573,16623562,12989
"3113","ENSGALG00000006477","2",8738366,8788229,49863
"3114","ENSGALG00000006479","20",10101688,10104791,3103
"3115","ENSGALG00000006480","13",16620708,16679055,58347
"3116","ENSGALG00000006482","10",13008297,13019135,10838
"3117","ENSGALG00000006486","6",20424248,20473425,49177
"3118","ENSGALG00000006487","4",4425299,4452400,27101
"3119","ENSGALG00000006488","9",4665763,4707010,41247
"3120","ENSGALG00000006489","1",2596212,2783089,186877
"3121","ENSGALG00000006490","24",2897357,2925022,27665
"3122","ENSGALG00000006491","6",20474784,20483465,8681
"3123","ENSGALG00000006494","24",2929796,3036108,106312
"3124","ENSGALG00000006502","6",20551751,20576052,24301
"3125","ENSGALG00000006503","13",16693676,16748810,55134
"3126","ENSGALG00000006505","10",13022106,13071558,49452
"3127","ENSGALG00000006506","13",16749773,16755766,5993
"3128","ENSGALG00000006507","24",3059934,3100446,40512
"3129","ENSGALG00000006508","4",4750152,4964186,214034
"3130","ENSGALG00000006511","10",13078381,13081323,2942
"3131","ENSGALG00000006512","24",3102875,3110564,7689
"3132","ENSGALG00000006513","4",5010204,5022805,12601
"3133","ENSGALG00000006515","24",3127754,3129687,1933
"3134","ENSGALG00000006516","10",13083181,13104916,21735
"3135","ENSGALG00000006519","10",13192538,13200860,8322
"3136","ENSGALG00000006520","14",7970779,8020491,49712
"3137","ENSGALG00000006521","5",13772652,13806760,34108
"3138","ENSGALG00000006522","20",10105874,10112326,6452
"3139","ENSGALG00000006525","2",9508795,9542249,33454
"3140","ENSGALG00000006526","12",11683446,11738536,55090
"3141","ENSGALG00000006527","24",3151297,3163767,12470
"3142","ENSGALG00000006530","5",13810153,13814540,4387
"3143","ENSGALG00000006531","9",4565923,4584327,18404
"3144","ENSGALG00000006532","14",8032206,8037255,5049
"3145","ENSGALG00000006534","10",13256887,13259232,2345
"3146","ENSGALG00000006539","9",4551856,4565071,13215
"3147","ENSGALG00000006540","6",21009127,21010503,1376
"3148","ENSGALG00000006542","2",9553966,9621260,67294
"3149","ENSGALG00000006543","9",4551587,4557627,6040
"3150","ENSGALG00000006544","12",11752319,11755128,2809
"3151","ENSGALG00000006546","5",13821201,13843461,22260
"3152","ENSGALG00000006547","9",4549402,4551224,1822
"3153","ENSGALG00000006552","5",13942581,13947245,4664
"3154","ENSGALG00000006558","2",9627521,9652688,25167
"3155","ENSGALG00000006560","1",9343631,9514699,171068
"3156","ENSGALG00000006561","5",14195145,14206180,11035
"3157","ENSGALG00000006562","4",5025240,5073391,48151
"3158","ENSGALG00000006563","1",8841295,8982974,141679
"3159","ENSGALG00000006564","9",4531072,4544764,13692
"3160","ENSGALG00000006565","15",8663295,8688492,25197
"3161","ENSGALG00000006566","9",4522384,4530759,8375
"3162","ENSGALG00000006567","24",3169790,3221633,51843
"3163","ENSGALG00000006568","20",10113124,10127346,14222
"3164","ENSGALG00000006571","12",11778259,11816939,38680
"3165","ENSGALG00000006572","5",14207186,14237040,29854
"3166","ENSGALG00000006574","9",4516570,4520368,3798
"3167","ENSGALG00000006575","2",9698844,9749846,51002
"3168","ENSGALG00000006576","1",8188214,8295700,107486
"3169","ENSGALG00000006583","5",14250735,14289860,39125
"3170","ENSGALG00000006584","24",3388666,3396866,8200
"3171","ENSGALG00000006586","20",10136327,10140317,3990
"3172","ENSGALG00000006588","15",8693398,8706692,13294
"3173","ENSGALG00000006591","5",14291354,14294088,2734
"3174","ENSGALG00000006593","9",4296019,4304376,8357
"3175","ENSGALG00000006594","20",10142922,10147715,4793
"3176","ENSGALG00000006596","15",8715869,8719468,3599
"3177","ENSGALG00000006597","9",4285878,4290793,4915
"3178","ENSGALG00000006598","24",3518080,3556074,37994
"3179","ENSGALG00000006599","2",9915431,9980505,65074
"3180","ENSGALG00000006600","9",4278717,4281923,3206
"3181","ENSGALG00000006601","12",11824873,11855648,30775
"3182","ENSGALG00000006602","5",14304943,14309008,4065
"3183","ENSGALG00000006604","20",10147922,10157222,9300
"3184","ENSGALG00000006607","15",8719648,8725737,6089
"3185","ENSGALG00000006608","5",14310133,14525237,215104
"3186","ENSGALG00000006609","9",3883599,3930088,46489
"3187","ENSGALG00000006611","10",13268773,13277622,8849
"3188","ENSGALG00000006612","20",10158453,10173320,14867
"3189","ENSGALG00000006613","5",14320728,14334260,13532
"3190","ENSGALG00000006617","6",33485512,33491742,6230
"3191","ENSGALG00000006622","6",21291752,21314439,22687
"3192","ENSGALG00000006623","4",5080054,5129056,49002
"3193","ENSGALG00000006626","6",21315128,21343739,28611
"3194","ENSGALG00000006627","15",8729297,8742998,13701
"3195","ENSGALG00000006629","6",21325448,21360467,35019
"3196","ENSGALG00000006630","20",10240466,10245423,4957
"3197","ENSGALG00000006631","10",13279032,13295578,16546
"3198","ENSGALG00000006632","9",3837537,3855471,17934
"3199","ENSGALG00000006633","1",8021261,8028175,6914
"3200","ENSGALG00000006635","10",13300546,13308471,7925
"3201","ENSGALG00000006637","4",5141467,5145258,3791
"3202","ENSGALG00000006638","24",3617948,3740700,122752
"3203","ENSGALG00000006639","6",21375204,21388540,13336
"3204","ENSGALG00000006642","15",8766745,8783957,17212
"3205","ENSGALG00000006644","13",17366433,17385594,19161
"3206","ENSGALG00000006646","14",8040974,8088595,47621
"3207","ENSGALG00000006647","5",14360355,14381768,21413
"3208","ENSGALG00000006648","15",8803892,8857762,53870
"3209","ENSGALG00000006649","9",3818688,3823456,4768
"3210","ENSGALG00000006651","12",11872813,11874795,1982
"3211","ENSGALG00000006652","2",9990437,10275976,285539
"3212","ENSGALG00000006653","13",17414871,17416684,1813
"3213","ENSGALG00000006655","9",3763611,3895836,132225
"3214","ENSGALG00000006657","20",10263977,10271702,7725
"3215","ENSGALG00000006658","10",13393849,13416699,22850
"3216","ENSGALG00000006662","20",10288014,10296054,8040
"3217","ENSGALG00000006663","24",3746751,3810567,63816
"3218","ENSGALG00000006666","20",10297297,10301910,4613
"3219","ENSGALG00000006670","6",20695689,20699934,4245
"3220","ENSGALG00000006672","2",10335050,10367215,32165
"3221","ENSGALG00000006673","24",3823482,3859717,36235
"3222","ENSGALG00000006676","10",13417443,13421763,4320
"3223","ENSGALG00000006677","13",17442199,17465935,23736
"3224","ENSGALG00000006681","5",14526605,14822859,296254
"3225","ENSGALG00000006682","1",7324436,7372660,48224
"3226","ENSGALG00000006688","12",11878342,11881077,2735
"3227","ENSGALG00000006689","10",13427782,13462876,35094
"3228","ENSGALG00000006690","1",6699316,6704061,4745
"3229","ENSGALG00000006691","12",11881167,11884058,2891
"3230","ENSGALG00000006693","20",10325022,10329836,4814
"3231","ENSGALG00000006695","15",8865927,8958301,92374
"3232","ENSGALG00000006697","5",14859903,14884969,25066
"3233","ENSGALG00000006702","10",13474537,13481834,7297
"3234","ENSGALG00000006703","2",10442049,10453087,11038
"3235","ENSGALG00000006704","9",3630354,3699812,69458
"3236","ENSGALG00000006705","6",21390657,21454748,64091
"3237","ENSGALG00000006707","4",5146544,5150926,4382
"3238","ENSGALG00000006708","13",14943967,14982567,38600
"3239","ENSGALG00000006710","15",8965803,8976084,10281
"3240","ENSGALG00000006712","15",8978153,9048094,69941
"3241","ENSGALG00000006714","9",3610193,3613933,3740
"3242","ENSGALG00000006715","24",3862361,3873263,10902
"3243","ENSGALG00000006717","5",15071724,15112067,40343
"3244","ENSGALG00000006719","15",8986343,9013471,27128
"3245","ENSGALG00000006723","2",10454430,10459537,5107
"3246","ENSGALG00000006724","9",3145813,3521172,375359
"3247","ENSGALG00000006725","10",13489102,13532280,43178
"3248","ENSGALG00000006728","15",9054070,9080058,25988
"3249","ENSGALG00000006731","1",4825152,4937625,112473
"3250","ENSGALG00000006738","20",10334013,10342498,8485
"3251","ENSGALG00000006743","15",9108063,9116390,8327
"3252","ENSGALG00000006749","2",10463982,10502941,38959
"3253","ENSGALG00000006750","10",13591422,13601475,10053
"3254","ENSGALG00000006751","24",4202427,4206868,4441
"3255","ENSGALG00000006753","1",4815823,4822759,6936
"3256","ENSGALG00000006755","24",4209130,4218970,9840
"3257","ENSGALG00000006756","20",10341499,10348637,7138
"3258","ENSGALG00000006757","14",8412741,8686419,273678
"3259","ENSGALG00000006758","24",4223242,4227441,4199
"3260","ENSGALG00000006760","4",5151806,5158364,6558
"3261","ENSGALG00000006763","6",21538202,21623893,85691
"3262","ENSGALG00000006766","15",9134809,9176596,41787
"3263","ENSGALG00000006773","4",5158785,5161824,3039
"3264","ENSGALG00000006775","20",10367592,10377566,9974
"3265","ENSGALG00000006776","12",11927983,11930527,2544
"3266","ENSGALG00000006777","10",13612327,13615857,3530
"3267","ENSGALG00000006779","24",4292299,4296313,4014
"3268","ENSGALG00000006780","14",8720837,8727644,6807
"3269","ENSGALG00000006782","10",13615877,13618457,2580
"3270","ENSGALG00000006783","9",11648159,11698175,50016
"3271","ENSGALG00000006785","13",17591206,17597339,6133
"3272","ENSGALG00000006786","4",5163565,5169836,6271
"3273","ENSGALG00000006787","12",11938359,11939817,1458
"3274","ENSGALG00000006788","20",10381362,10402171,20809
"3275","ENSGALG00000006791","20",10401918,10413974,12056
"3276","ENSGALG00000006792","20",10415519,10422917,7398
"3277","ENSGALG00000006794","13",17625973,17643175,17202
"3278","ENSGALG00000006795","24",4304182,4310313,6131
"3279","ENSGALG00000006796","4",5171035,5178153,7118
"3280","ENSGALG00000006797","2",10527604,10822309,294705
"3281","ENSGALG00000006799","5",15307816,15350714,42898
"3282","ENSGALG00000006801","13",17651727,17653397,1670
"3283","ENSGALG00000006802","12",11948006,11968917,20911
"3284","ENSGALG00000006803","Z",44885553,44886518,965
"3285","ENSGALG00000006804","8",16385301,16404071,18770
"3286","ENSGALG00000006805","9",11715875,11727846,11971
"3287","ENSGALG00000006806","24",4315650,4320043,4393
"3288","ENSGALG00000006807","9",11740248,11751391,11143
"3289","ENSGALG00000006808","4",5176802,5182610,5808
"3290","ENSGALG00000006809","24",4343410,4355489,12079
"3291","ENSGALG00000006810","9",12056956,12064322,7366
"3292","ENSGALG00000006812","24",4372115,4373115,1000
"3293","ENSGALG00000006817","20",10427975,10468083,40108
"3294","ENSGALG00000006818","24",4373557,4420428,46871
"3295","ENSGALG00000006819","10",14062978,14334624,271646
"3296","ENSGALG00000006821","4",5184912,5192800,7888
"3297","ENSGALG00000006822","4",5208408,5259929,51521
"3298","ENSGALG00000006824","12",11969309,11989472,20163
"3299","ENSGALG00000006826","10",14396229,14405244,9015
"3300","ENSGALG00000006829","14",8731539,8790169,58630
"3301","ENSGALG00000006830","5",15355511,15461654,106143
"3302","ENSGALG00000006833","1",4774156,4799281,25125
"3303","ENSGALG00000006834","9",12583262,12599587,16325
"3304","ENSGALG00000006835","20",10510927,10512737,1810
"3305","ENSGALG00000006836","20",10514689,10516148,1459
"3306","ENSGALG00000006837","5",15478170,15870938,392768
"3307","ENSGALG00000006838","15",9197732,9214453,16721
"3308","ENSGALG00000006840","10",14421016,14484749,63733
"3309","ENSGALG00000006841","5",15871249,15872644,1395
"3310","ENSGALG00000006842","20",10516581,10518982,2401
"3311","ENSGALG00000006843","9",12577515,12614155,36640
"3312","ENSGALG00000006848","20",10518704,10522009,3305
"3313","ENSGALG00000006851","4",6565250,6989919,424669
"3314","ENSGALG00000006854","20",10525549,10528418,2869
"3315","ENSGALG00000006855","9",12619518,12636112,16594
"3316","ENSGALG00000006856","5",15884246,15915623,31377
"3317","ENSGALG00000006857","18",10304635,10313512,8877
"3318","ENSGALG00000006860","13",17663660,17679532,15872
"3319","ENSGALG00000006861","14",8873314,8882226,8912
"3320","ENSGALG00000006864","8",16434266,16549728,115462
"3321","ENSGALG00000006867","12",12002724,12024786,22062
"3322","ENSGALG00000006868","5",15928417,15957238,28821
"3323","ENSGALG00000006871","10",14786967,14897705,110738
"3324","ENSGALG00000006872","15",9214524,9238681,24157
"3325","ENSGALG00000006873","5",16064998,16084574,19576
"3326","ENSGALG00000006876","20",10528674,10532766,4092
"3327","ENSGALG00000006877","4",8078253,8111548,33295
"3328","ENSGALG00000006880","18",9223491,9252720,29229
"3329","ENSGALG00000006882","10",14943831,14967990,24159
"3330","ENSGALG00000006886","4",8277517,8541470,263953
"3331","ENSGALG00000006887","10",14995725,15004493,8768
"3332","ENSGALG00000006889","14",8882558,8896929,14371
"3333","ENSGALG00000006891","1",4720811,4767090,46279
"3334","ENSGALG00000006895","18",9260044,9272559,12515
"3335","ENSGALG00000006898","15",9266258,9285315,19057
"3336","ENSGALG00000006899","24",4423180,4426923,3743
"3337","ENSGALG00000006900","18",9274039,9277147,3108
"3338","ENSGALG00000006901","18",9275749,9296161,20412
"3339","ENSGALG00000006904","5",16327023,16335748,8725
"3340","ENSGALG00000006906","4",8558092,8651858,93766
"3341","ENSGALG00000006908","9",12637636,12769122,131486
"3342","ENSGALG00000006910","12",12030092,12041674,11582
"3343","ENSGALG00000006911","14",8913539,8925051,11512
"3344","ENSGALG00000006912","6",21812767,21889131,76364
"3345","ENSGALG00000006916","14",8927258,8931721,4463
"3346","ENSGALG00000006919","4",8657030,8670417,13387
"3347","ENSGALG00000006921","15",9288091,9292779,4688
"3348","ENSGALG00000006922","24",4442181,4447599,5418
"3349","ENSGALG00000006925","14",8932617,8947472,14855
"3350","ENSGALG00000006926","24",4446438,4449757,3319
"3351","ENSGALG00000006929","4",8678574,8699226,20652
"3352","ENSGALG00000006933","14",8953140,8976064,22924
"3353","ENSGALG00000006934","15",9301202,9318435,17233
"3354","ENSGALG00000006936","12",12050715,12054358,3643
"3355","ENSGALG00000006937","12",12055550,12069339,13789
"3356","ENSGALG00000006939","2",11439678,11481488,41810
"3357","ENSGALG00000006942","15",9331196,9336290,5094
"3358","ENSGALG00000006944","12",12063727,12067083,3356
"3359","ENSGALG00000006947","9",12794254,12807370,13116
"3360","ENSGALG00000006949","10",15061660,15113883,52223
"3361","ENSGALG00000006950","15",9338543,9369255,30712
"3362","ENSGALG00000006955","6",22000494,22007023,6529
"3363","ENSGALG00000006956","12",12072401,12100919,28518
"3364","ENSGALG00000006958","17",5031761,5159465,127704
"3365","ENSGALG00000006960","15",9369614,9383187,13573
"3366","ENSGALG00000006963","18",9480639,9489310,8671
"3367","ENSGALG00000006964","14",9033722,9043723,10001
"3368","ENSGALG00000006965","15",9385682,9389695,4013
"3369","ENSGALG00000006966","6",22042154,22046776,4622
"3370","ENSGALG00000006968","15",9390984,9405373,14389
"3371","ENSGALG00000006969","24",4453214,4474869,21655
"3372","ENSGALG00000006973","6",22051933,22144236,92303
"3373","ENSGALG00000006974","20",10753853,10760204,6351
"3374","ENSGALG00000006976","9",12801542,12825362,23820
"3375","ENSGALG00000006978","4",8717385,8732413,15028
"3376","ENSGALG00000006979","15",9411863,9458544,46681
"3377","ENSGALG00000006982","14",9045104,9069244,24140
"3378","ENSGALG00000006983","6",22168276,22256565,88289
"3379","ENSGALG00000006989","6",22372081,22447792,75711
"3380","ENSGALG00000006992","20",10572557,10576665,4108
"3381","ENSGALG00000006995","9",12832591,12836179,3588
"3382","ENSGALG00000006997","17",4358151,4436723,78572
"3383","ENSGALG00000007000","10",16265424,16276853,11429
"3384","ENSGALG00000007001","17",3938812,3944462,5650
"3385","ENSGALG00000007003","17",3921693,3933795,12102
"3386","ENSGALG00000007004","24",4489763,4491131,1368
"3387","ENSGALG00000007007","6",22492113,22548666,56553
"3388","ENSGALG00000007008","14",9078715,9099106,20391
"3389","ENSGALG00000007009","20",10604610,10618315,13705
"3390","ENSGALG00000007012","10",16900546,16908325,7779
"3391","ENSGALG00000007014","6",23205808,23212431,6623
"3392","ENSGALG00000007015","20",10622623,10626251,3628
"3393","ENSGALG00000007016","10",17067179,17103197,36018
"3394","ENSGALG00000007017","24",4592248,4595673,3425
"3395","ENSGALG00000007018","18",9537931,9542135,4204
"3396","ENSGALG00000007021","7",7050186,7147718,97532
"3397","ENSGALG00000007022","10",17114479,17120457,5978
"3398","ENSGALG00000007023","12",12133753,12182582,48829
"3399","ENSGALG00000007025","1",15633800,15729892,96092
"3400","ENSGALG00000007027","18",9542784,9545703,2919
"3401","ENSGALG00000007028","4",8732666,8906442,173776
"3402","ENSGALG00000007030","14",9114379,9129367,14988
"3403","ENSGALG00000007036","2",11482055,11507235,25180
"3404","ENSGALG00000007037","5",16683896,16735572,51676
"3405","ENSGALG00000007038","17",3593160,3854597,261437
"3406","ENSGALG00000007040","9",12850505,12907216,56711
"3407","ENSGALG00000007041","4",8926898,8964157,37259
"3408","ENSGALG00000007042","18",9551560,9562020,10460
"3409","ENSGALG00000007044","14",9132050,9150359,18309
"3410","ENSGALG00000007045","6",22597002,22847758,250756
"3411","ENSGALG00000007047","5",16762407,16770584,8177
"3412","ENSGALG00000007048","10",17303559,17324081,20522
"3413","ENSGALG00000007052","12",12191823,12223412,31589
"3414","ENSGALG00000007054","18",9565437,9586683,21246
"3415","ENSGALG00000007057","10",17343951,17393080,49129
"3416","ENSGALG00000007058","9",12975136,12987465,12329
"3417","ENSGALG00000007059","14",9142666,9148845,6179
"3418","ENSGALG00000007065","2",12861377,12865383,4006
"3419","ENSGALG00000007070","14",9166630,9185734,19104
"3420","ENSGALG00000007072","15",9463306,9470871,7565
"3421","ENSGALG00000007075","9",13001669,13050849,49180
"3422","ENSGALG00000007076","2",12879629,12992702,113073
"3423","ENSGALG00000007077","5",16814154,16844218,30064
"3424","ENSGALG00000007078","6",22955041,22993260,38219
"3425","ENSGALG00000007079","17",3365148,3582266,217118
"3426","ENSGALG00000007080","13",17740791,17758380,17589
"3427","ENSGALG00000007082","2",13012790,13044927,32137
"3428","ENSGALG00000007084","1",79964642,79968560,3918
"3429","ENSGALG00000007090","6",22997062,23003524,6462
"3430","ENSGALG00000007092","10",17521159,17533004,11845
"3431","ENSGALG00000007093","18",9776820,9792219,15399
"3432","ENSGALG00000007095","2",13054990,13100900,45910
"3433","ENSGALG00000007097","4",8986672,9021732,35060
"3434","ENSGALG00000007098","1",15477557,15560977,83420
"3435","ENSGALG00000007101","24",5128898,5133510,4612
"3436","ENSGALG00000007102","15",9477751,9488714,10963
"3437","ENSGALG00000007109","24",5136775,5138258,1483
"3438","ENSGALG00000007110","4",9283691,9296473,12782
"3439","ENSGALG00000007111","12",12229086,12237116,8030
"3440","ENSGALG00000007112","10",17767527,17779753,12226
"3441","ENSGALG00000007114","24",5140181,5141930,1749
"3442","ENSGALG00000007115","10",17780255,17808686,28431
"3443","ENSGALG00000007116","15",9490219,9517591,27372
"3444","ENSGALG00000007118","4",9308659,9332151,23492
"3445","ENSGALG00000007119","14",9204871,9217764,12893
"3446","ENSGALG00000007123","4",9336822,9341547,4725
"3447","ENSGALG00000007124","15",9541162,9542476,1314
"3448","ENSGALG00000007125","2",13147629,13581750,434121
"3449","ENSGALG00000007127","5",16924715,16934417,9702
"3450","ENSGALG00000007128","4",9342726,9373476,30750
"3451","ENSGALG00000007130","14",9219673,9232032,12359
"3452","ENSGALG00000007131","4",9383205,9391216,8011
"3453","ENSGALG00000007132","12",12238654,12252445,13791
"3454","ENSGALG00000007133","14",9239445,9241210,1765
"3455","ENSGALG00000007139","12",12255792,12269886,14094
"3456","ENSGALG00000007140","2",13897935,14004606,106671
"3457","ENSGALG00000007141","10",17915117,17979890,64773
"3458","ENSGALG00000007144","24",5145236,5215773,70537
"3459","ENSGALG00000007145","2",14057886,14099286,41400
"3460","ENSGALG00000007147","15",9560589,9561338,749
"3461","ENSGALG00000007149","14",9258448,9306090,47642
"3462","ENSGALG00000007150","9",13186707,13234803,48096
"3463","ENSGALG00000007151","4",9426824,9460455,33631
"3464","ENSGALG00000007152","12",12271572,12275706,4134
"3465","ENSGALG00000007153","15",9563293,9565829,2536
"3466","ENSGALG00000007155","14",9317253,9318876,1623
"3467","ENSGALG00000007157","4",9484216,9496535,12319
"3468","ENSGALG00000007158","14",9342202,9344743,2541
"3469","ENSGALG00000007160","4",9504323,9521047,16724
"3470","ENSGALG00000007161","1",15135366,15199297,63931
"3471","ENSGALG00000007162","10",18051822,18060084,8262
"3472","ENSGALG00000007167","14",9399868,9453186,53318
"3473","ENSGALG00000007168","12",12285419,12348377,62958
"3474","ENSGALG00000007169","2",14123932,14181104,57172
"3475","ENSGALG00000007170","10",18059065,18064217,5152
"3476","ENSGALG00000007171","14",9474126,9492269,18143
"3477","ENSGALG00000007172","12",12565610,12938688,373078
"3478","ENSGALG00000007174","17",2929454,2943258,13804
"3479","ENSGALG00000007177","12",13123560,13498453,374893
"3480","ENSGALG00000007178","5",16940926,16958072,17146
"3481","ENSGALG00000007181","18",9820165,9837087,16922
"3482","ENSGALG00000007183","1",15105451,15128477,23026
"3483","ENSGALG00000007184","12",13539675,13541861,2186
"3484","ENSGALG00000007185","15",9565975,9572193,6218
"3485","ENSGALG00000007186","17",2882867,2987652,104785
"3486","ENSGALG00000007190","17",2874201,2877495,3294
"3487","ENSGALG00000007191","18",9860348,9863127,2779
"3488","ENSGALG00000007193","9",13303068,13305862,2794
"3489","ENSGALG00000007195","15",9576607,9578666,2059
"3490","ENSGALG00000007199","15",9578709,9581330,2621
"3491","ENSGALG00000007203","5",16964921,16979956,15035
"3492","ENSGALG00000007205","15",9582003,9583360,1357
"3493","ENSGALG00000007211","20",10649497,10684260,34763
"3494","ENSGALG00000007215","2",14216533,14248028,31495
"3495","ENSGALG00000007216","14",9506852,9516852,10000
"3496","ENSGALG00000007217","5",16987346,16994543,7197
"3497","ENSGALG00000007218","9",13421516,13470538,49022
"3498","ENSGALG00000007220","5",16995951,17000513,4562
"3499","ENSGALG00000007222","9",13858565,13865482,6917
"3500","ENSGALG00000007224","18",9879271,9888438,9167
"3501","ENSGALG00000007226","9",13868182,13917246,49064
"3502","ENSGALG00000007227","15",9624166,9651621,27455
"3503","ENSGALG00000007234","4",9540599,9582501,41902
"3504","ENSGALG00000007236","15",9666806,9668229,1423
"3505","ENSGALG00000007237","18",9938407,9943202,4795
"3506","ENSGALG00000007240","4",9589706,9595509,5803
"3507","ENSGALG00000007241","14",9517553,9522273,4720
"3508","ENSGALG00000007242","4",9901515,9904127,2612
"3509","ENSGALG00000007244","15",9670176,9678598,8422
"3510","ENSGALG00000007246","20",10731594,10750358,18764
"3511","ENSGALG00000007247","15",9679685,9721617,41932
"3512","ENSGALG00000007248","10",18048568,18125749,77181
"3513","ENSGALG00000007251","18",9946446,9957679,11233
"3514","ENSGALG00000007252","10",18143011,18161153,18142
"3515","ENSGALG00000007253","9",14006895,14047894,40999
"3516","ENSGALG00000007254","2",14277537,14339863,62326
"3517","ENSGALG00000007257","14",9523644,9544639,20995
"3518","ENSGALG00000007260","2",14388433,14494158,105725
"3519","ENSGALG00000007262","10",18157007,18166727,9720
"3520","ENSGALG00000007266","2",14591854,14633849,41995
"3521","ENSGALG00000007267","11",18421736,18424810,3074
"3522","ENSGALG00000007268","12",13553845,13726591,172746
"3523","ENSGALG00000007269","4",10750330,10800416,50086
"3524","ENSGALG00000007272","11",18426124,18433726,7602
"3525","ENSGALG00000007276","15",9724720,9765409,40689
"3526","ENSGALG00000007278","14",9652802,9801024,148222
"3527","ENSGALG00000007282","4",10908948,10917481,8533
"3528","ENSGALG00000007284","12",13810284,13889941,79657
"3529","ENSGALG00000007286","18",9947357,9961503,14146
"3530","ENSGALG00000007287","5",17173545,17187894,14349
"3531","ENSGALG00000007288","12",13893361,13896406,3045
"3532","ENSGALG00000007289","10",18168002,18187752,19750
"3533","ENSGALG00000007291","14",10259730,10273380,13650
"3534","ENSGALG00000007298","24",5265642,5274470,8828
"3535","ENSGALG00000007299","12",13920134,13951645,31511
"3536","ENSGALG00000007300","18",9970057,9973913,3856
"3537","ENSGALG00000007302","12",13943984,14003991,60007
"3538","ENSGALG00000007304","6",23021332,23035696,14364
"3539","ENSGALG00000007305","18",9976818,9980677,3859
"3540","ENSGALG00000007307","14",10319365,10384016,64651
"3541","ENSGALG00000007308","15",9769631,9784984,15353
"3542","ENSGALG00000007310","24",5276096,5310519,34423
"3543","ENSGALG00000007311","4",10939321,10941844,2523
"3544","ENSGALG00000007314","24",5319919,5399942,80023
"3545","ENSGALG00000007315","12",14010163,14017166,7003
"3546","ENSGALG00000007319","15",9789578,9831110,41532
"3547","ENSGALG00000007320","24",5405480,5406721,1241
"3548","ENSGALG00000007324","9",14201848,14296035,94187
"3549","ENSGALG00000007326","14",10454197,10461151,6954
"3550","ENSGALG00000007330","5",17194978,17220348,25370
"3551","ENSGALG00000007331","2",14681633,14783967,102334
"3552","ENSGALG00000007332","12",14033841,14122269,88428
"3553","ENSGALG00000007333","10",18195430,18202059,6629
"3554","ENSGALG00000007334","14",10466461,10508368,41907
"3555","ENSGALG00000007335","10",18205411,18211496,6085
"3556","ENSGALG00000007337","9",14499435,14783213,283778
"3557","ENSGALG00000007341","5",17229964,17231629,1665
"3558","ENSGALG00000007346","2",14902023,14928738,26715
"3559","ENSGALG00000007349","10",18207823,18212715,4892
"3560","ENSGALG00000007350","5",17227428,17229764,2336
"3561","ENSGALG00000007351","2",14995874,15011632,15758
"3562","ENSGALG00000007353","10",18223420,18228560,5140
"3563","ENSGALG00000007354","15",9851336,9920684,69348
"3564","ENSGALG00000007356","2",15014348,15032488,18140
"3565","ENSGALG00000007357","9",14938213,14954449,16236
"3566","ENSGALG00000007358","10",18233025,18241830,8805
"3567","ENSGALG00000007361","9",14959957,14961612,1655
"3568","ENSGALG00000007362","5",17232738,17242055,9317
"3569","ENSGALG00000007364","18",10077443,10079309,1866
"3570","ENSGALG00000007365","10",18257186,18261676,4490
"3571","ENSGALG00000007367","18",10096028,10100634,4606
"3572","ENSGALG00000007370","5",17248507,17251852,3345
"3573","ENSGALG00000007371","10",18280750,18356598,75848
"3574","ENSGALG00000007373","15",9925493,9931131,5638
"3575","ENSGALG00000007374","5",17252452,17253522,1070
"3576","ENSGALG00000007378","1",77463747,77472850,9103
"3577","ENSGALG00000007381","5",17253818,17261848,8030
"3578","ENSGALG00000007382","21",4895882,4903581,7699
"3579","ENSGALG00000007383","15",10006078,10008129,2051
"3580","ENSGALG00000007386","18",10116735,10130095,13360
"3581","ENSGALG00000007387","14",12345932,12383948,38016
"3582","ENSGALG00000007389","18",10130826,10137476,6650
"3583","ENSGALG00000007393","15",10068238,10102850,34612
"3584","ENSGALG00000007395","6",23037359,23051416,14057
"3585","ENSGALG00000007396","15",10106054,10174292,68238
"3586","ENSGALG00000007403","15",10177078,10179073,1995
"3587","ENSGALG00000007404","13",18256584,18263765,7181
"3588","ENSGALG00000007406","24",5443038,5445653,2615
"3589","ENSGALG00000007408","2",15436178,15577480,141302
"3590","ENSGALG00000007409","24",5447291,5451642,4351
"3591","ENSGALG00000007410","10",18372197,18447980,75783
"3592","ENSGALG00000007412","24",5471930,5477522,5592
"3593","ENSGALG00000007416","24",5480338,5485277,4939
"3594","ENSGALG00000007417","2",15599282,15670561,71279
"3595","ENSGALG00000007418","24",5487325,5489870,2545
"3596","ENSGALG00000007419","9",15017996,15035605,17609
"3597","ENSGALG00000007426","2",15687491,15728548,41057
"3598","ENSGALG00000007430","24",5505160,5513204,8044
"3599","ENSGALG00000007431","12",14398620,14690794,292174
"3600","ENSGALG00000007434","14",12387740,12420305,32565
"3601","ENSGALG00000007435","2",15786146,15799233,13087
"3602","ENSGALG00000007437","10",18463290,18484380,21090
"3603","ENSGALG00000007438","24",5513391,5518013,4622
"3604","ENSGALG00000007439","20",10872054,10877912,5858
"3605","ENSGALG00000007441","1",196900378,196929712,29334
"3606","ENSGALG00000007443","4",10998969,11014124,15155
"3607","ENSGALG00000007447","20",10887341,10892358,5017
"3608","ENSGALG00000007448","4",11028600,11029490,890
"3609","ENSGALG00000007456","14",12457406,12499797,42391
"3610","ENSGALG00000007462","20",10895414,11013490,118076
"3611","ENSGALG00000007465","6",23057823,23061814,3991
"3612","ENSGALG00000007466","4",11158706,11169798,11092
"3613","ENSGALG00000007467","12",14762054,14852340,90286
"3614","ENSGALG00000007470","4",11170881,11177013,6132
"3615","ENSGALG00000007473","14",12534726,12537892,3166
"3616","ENSGALG00000007474","9",15053018,15075192,22174
"3617","ENSGALG00000007476","4",11177127,11194883,17756
"3618","ENSGALG00000007477","20",10901215,10910634,9419
"3619","ENSGALG00000007478","9",15076581,15078779,2198
"3620","ENSGALG00000007479","6",23068562,23072037,3475
"3621","ENSGALG00000007481","10",18484949,18494592,9643
"3622","ENSGALG00000007483","12",14847918,14926384,78466
"3623","ENSGALG00000007484","6",23099863,23103500,3637
"3624","ENSGALG00000007485","9",15091718,15104420,12702
"3625","ENSGALG00000007489","6",23106192,23119460,13268
"3626","ENSGALG00000007490","15",10189921,10195504,5583
"3627","ENSGALG00000007491","10",18494123,18505513,11390
"3628","ENSGALG00000007492","2",15924135,15944225,20090
"3629","ENSGALG00000007493","4",11273078,11283634,10556
"3630","ENSGALG00000007494","13",18498942,18524347,25405
"3631","ENSGALG00000007495","10",18508304,18523269,14965
"3632","ENSGALG00000007503","7",7165130,7176245,11115
"3633","ENSGALG00000007507","2",15947101,15964487,17386
"3634","ENSGALG00000007508","6",23116734,23202994,86260
"3635","ENSGALG00000007510","4",11283945,11289018,5073
"3636","ENSGALG00000007511","7",7177686,7189495,11809
"3637","ENSGALG00000007512","15",10208636,10245440,36804
"3638","ENSGALG00000007513","7",7193153,7246330,53177
"3639","ENSGALG00000007515","6",23251548,23253727,2179
"3640","ENSGALG00000007516","13",18524937,18544949,20012
"3641","ENSGALG00000007519","2",15965524,15992654,27130
"3642","ENSGALG00000007520","5",17282810,17290670,7860
"3643","ENSGALG00000007522","18",10138422,10181595,43173
"3644","ENSGALG00000007525","5",17320112,17337040,16928
"3645","ENSGALG00000007526","4",11295349,11299195,3846
"3646","ENSGALG00000007527","7",7259184,7325166,65982
"3647","ENSGALG00000007528","13",18567870,18598661,30791
"3648","ENSGALG00000007530","4",11302073,11305919,3846
"3649","ENSGALG00000007531","6",23255380,23260563,5183
"3650","ENSGALG00000007533","20",11061622,11073420,11798
"3651","ENSGALG00000007536","9",15157571,15163391,5820
"3652","ENSGALG00000007537","5",17337682,17356167,18485
"3653","ENSGALG00000007538","4",11333698,11336766,3068
"3654","ENSGALG00000007539","6",23279065,23281033,1968
"3655","ENSGALG00000007541","20",11076024,11084403,8379
"3656","ENSGALG00000007543","20",11158900,11172710,13810
"3657","ENSGALG00000007546","4",11345577,11367340,21763
"3658","ENSGALG00000007547","2",16014648,16093019,78371
"3659","ENSGALG00000007549","20",11181276,11208265,26989
"3660","ENSGALG00000007550","5",17369384,17392697,23313
"3661","ENSGALG00000007554","20",11214851,11230580,15729
"3662","ENSGALG00000007555","5",17778656,17793544,14888
"3663","ENSGALG00000007556","5",17790358,17811445,21087
"3664","ENSGALG00000007557","9",15165984,15184391,18407
"3665","ENSGALG00000007559","2",16094674,16116800,22126
"3666","ENSGALG00000007562","5",17843044,17845980,2936
"3667","ENSGALG00000007564","2",16116859,16140069,23210
"3668","ENSGALG00000007565","13",18602029,18670143,68114
"3669","ENSGALG00000007569","12",15014839,15023143,8304
"3670","ENSGALG00000007570","4",11440335,11449639,9304
"3671","ENSGALG00000007572","6",23286309,23300252,13943
"3672","ENSGALG00000007575","20",11230797,11253154,22357
"3673","ENSGALG00000007579","2",16143077,16201613,58536
"3674","ENSGALG00000007581","9",15191538,15204958,13420
"3675","ENSGALG00000007582","13",18700534,18731040,30506
"3676","ENSGALG00000007585","25",477457,480199,2742
"3677","ENSGALG00000007590","4",11625916,11649932,24016
"3678","ENSGALG00000007592","6",23300528,23304345,3817
"3679","ENSGALG00000007593","13",18752656,18788177,35521
"3680","ENSGALG00000007594","4",11654023,11659535,5512
"3681","ENSGALG00000007595","9",15206056,15256069,50013
"3682","ENSGALG00000007596","12",15030285,15057873,27588
"3683","ENSGALG00000007599","4",11668128,11671967,3839
"3684","ENSGALG00000007606","6",23308083,23310469,2386
"3685","ENSGALG00000007607","9",15259949,15276211,16262
"3686","ENSGALG00000007608","4",11685188,11872215,187027
"3687","ENSGALG00000007609","6",23326295,23340590,14295
"3688","ENSGALG00000007610","13",18789653,18800044,10391
"3689","ENSGALG00000007611","9",15278279,15281121,2842
"3690","ENSGALG00000007615","10",18589348,18605528,16180
"3691","ENSGALG00000007618","24",5563452,5565530,2078
"3692","ENSGALG00000007619","14",12796696,12802141,5445
"3693","ENSGALG00000007620","13",18825211,18833164,7953
"3694","ENSGALG00000007623","18",10190070,10295277,105207
"3695","ENSGALG00000007624","20",11253117,11273945,20828
"3696","ENSGALG00000007625","5",18066746,18084292,17546
"3697","ENSGALG00000007631","10",18610088,18797433,187345
"3698","ENSGALG00000007636","20",11554555,11562277,7722
"3699","ENSGALG00000007638","14",12818819,12827110,8291
"3700","ENSGALG00000007641","6",23470328,23489022,18694
"3701","ENSGALG00000007642","13",18845582,18856700,11118
"3702","ENSGALG00000007643","10",18882001,18897191,15190
"3703","ENSGALG00000007645","6",23492176,23498630,6454
"3704","ENSGALG00000007646","4",11924118,12042777,118659
"3705","ENSGALG00000007647","2",16302527,16395715,93188
"3706","ENSGALG00000007649","10",18896840,18905616,8776
"3707","ENSGALG00000007650","18",10437507,10444800,7293
"3708","ENSGALG00000007651","7",7912708,7932691,19983
"3709","ENSGALG00000007652","12",15139287,15242142,102855
"3710","ENSGALG00000007653","20",11635626,11647397,11771
"3711","ENSGALG00000007657","4",12107176,12115777,8601
"3712","ENSGALG00000007658","6",23504471,23608495,104024
"3713","ENSGALG00000007659","24",5675830,5691720,15890
"3714","ENSGALG00000007661","18",10324832,10337709,12877
"3715","ENSGALG00000007663","13",18859815,18904338,44523
"3716","ENSGALG00000007664","9",15291664,15353104,61440
"3717","ENSGALG00000007665","15",10292857,10312463,19606
"3718","ENSGALG00000007666","6",23613017,23634385,21368
"3719","ENSGALG00000007667","2",16494334,16675173,180839
"3720","ENSGALG00000007668","20",11682314,11723878,41564
"3721","ENSGALG00000007669","13",18949948,18952753,2805
"3722","ENSGALG00000007673","18",10377416,10381845,4429
"3723","ENSGALG00000007675","24",5596881,5602957,6076
"3724","ENSGALG00000007676","18",10383573,10388399,4826
"3725","ENSGALG00000007677","2",16724410,16731025,6615
"3726","ENSGALG00000007680","2",16731266,16740274,9008
"3727","ENSGALG00000007681","9",15312935,15322126,9191
"3728","ENSGALG00000007683","4",12148991,12167804,18813
"3729","ENSGALG00000007685","24",5607649,5619306,11657
"3730","ENSGALG00000007687","10",18908081,18939690,31609
"3731","ENSGALG00000007689","24",5659830,5663155,3325
"3732","ENSGALG00000007690","20",11939844,11947261,7417
"3733","ENSGALG00000007691","9",15359987,15403232,43245
"3734","ENSGALG00000007694","2",16749655,16794344,44689
"3735","ENSGALG00000007695","10",18940350,18942751,2401
"3736","ENSGALG00000007697","6",23634965,23658886,23921
"3737","ENSGALG00000007698","15",10313011,10321910,8899
"3738","ENSGALG00000007699","24",5664030,5665784,1754
"3739","ENSGALG00000007700","5",18140181,18164052,23871
"3740","ENSGALG00000007701","9",15424639,15428284,3645
"3741","ENSGALG00000007702","18",10396712,10410104,13392
"3742","ENSGALG00000007703","4",12171879,12187890,16011
"3743","ENSGALG00000007706","6",23669486,23675847,6361
"3744","ENSGALG00000007707","24",5665122,5667610,2488
"3745","ENSGALG00000007709","20",11969172,11990669,21497
"3746","ENSGALG00000007710","4",12232158,12242910,10752
"3747","ENSGALG00000007711","10",18942659,18948763,6104
"3748","ENSGALG00000007712","7",8016186,8098275,82089
"3749","ENSGALG00000007713","18",10410168,10414906,4738
"3750","ENSGALG00000007714","9",15443328,15446163,2835
"3751","ENSGALG00000007716","24",5667700,5675589,7889
"3752","ENSGALG00000007717","20",11976791,11984112,7321
"3753","ENSGALG00000007720","15",10329429,10349666,20237
"3754","ENSGALG00000007721","2",16795056,16932049,136993
"3755","ENSGALG00000007723","18",10447902,10451391,3489
"3756","ENSGALG00000007728","15",10396499,10406063,9564
"3757","ENSGALG00000007731","6",23757619,23765090,7471
"3758","ENSGALG00000007732","15",10623518,10688187,64669
"3759","ENSGALG00000007736","10",18949910,18967554,17644
"3760","ENSGALG00000007740","4",12295203,12299978,4775
"3761","ENSGALG00000007741","12",16053940,16058208,4268
"3762","ENSGALG00000007744","20",11992062,12008045,15983
"3763","ENSGALG00000007747","18",10451542,10493098,41556
"3764","ENSGALG00000007748","4",12310289,12331702,21413
"3765","ENSGALG00000007750","4",12342843,12356401,13558
"3766","ENSGALG00000007752","9",15525421,15538000,12579
"3767","ENSGALG00000007753","6",23706735,23775916,69181
"3768","ENSGALG00000007755","4",12376599,12497277,120678
"3769","ENSGALG00000007757","20",12011414,12019585,8171
"3770","ENSGALG00000007758","15",10986121,11046721,60600
"3771","ENSGALG00000007759","7",8220110,8328185,108075
"3772","ENSGALG00000007762","14",12891875,12969501,77626
"3773","ENSGALG00000007766","2",16935030,17269638,334608
"3774","ENSGALG00000007767","9",15555615,15719509,163894
"3775","ENSGALG00000007768","20",12020474,12027221,6747
"3776","ENSGALG00000007769","12",16307942,16503337,195395
"3777","ENSGALG00000007771","20",12027572,12032765,5193
"3778","ENSGALG00000007777","7",9633968,9664680,30712
"3779","ENSGALG00000007778","15",11069471,11075105,5634
"3780","ENSGALG00000007779","14",12988577,13047466,58889
"3781","ENSGALG00000007780","12",16666749,16682429,15680
"3782","ENSGALG00000007781","15",11080655,11083506,2851
"3783","ENSGALG00000007785","12",16703105,16707773,4668
"3784","ENSGALG00000007786","20",12254307,12288709,34402
"3785","ENSGALG00000007788","4",12513106,12540210,27104
"3786","ENSGALG00000007791","18",10548514,10554252,5738
"3787","ENSGALG00000007792","20",12334560,12337089,2529
"3788","ENSGALG00000007793","4",12557477,12569502,12025
"3789","ENSGALG00000007794","24",5740654,5762035,21381
"3790","ENSGALG00000007796","20",12384156,12418680,34524
"3791","ENSGALG00000007798","12",16858536,16897156,38620
"3792","ENSGALG00000007800","4",12579038,12598950,19912
"3793","ENSGALG00000007803","6",23783093,23787154,4061
"3794","ENSGALG00000007804","12",16898430,16917447,19017
"3795","ENSGALG00000007806","4",12790680,12801083,10403
"3796","ENSGALG00000007808","18",10569907,10591840,21933
"3797","ENSGALG00000007809","20",12555394,12760723,205329
"3798","ENSGALG00000007810","12",16918018,16950486,32468
"3799","ENSGALG00000007814","9",15724063,15726925,2862
"3800","ENSGALG00000007815","24",5775726,5783659,7933
"3801","ENSGALG00000007817","5",18995653,19029466,33813
"3802","ENSGALG00000007819","12",17007247,17127236,119989
"3803","ENSGALG00000007820","6",23793963,23908311,114348
"3804","ENSGALG00000007821","14",13131467,13143364,11897
"3805","ENSGALG00000007822","18",10611928,10614290,2362
"3806","ENSGALG00000007825","3",2132842,2156058,23216
"3807","ENSGALG00000007831","6",23992226,23998712,6486
"3808","ENSGALG00000007832","3",2124834,2132004,7170
"3809","ENSGALG00000007833","24",5795133,5808918,13785
"3810","ENSGALG00000007835","3",2090439,2124498,34059
"3811","ENSGALG00000007837","6",24015945,24019958,4013
"3812","ENSGALG00000007839","24",5811385,5892244,80859
"3813","ENSGALG00000007840","15",11095425,11099116,3691
"3814","ENSGALG00000007841","7",9675351,9718284,42933
"3815","ENSGALG00000007843","4",12808926,12883679,74753
"3816","ENSGALG00000007845","3",2054433,2088375,33942
"3817","ENSGALG00000007848","24",6135796,6138663,2867
"3818","ENSGALG00000007853","3",2015400,2032464,17064
"3819","ENSGALG00000007861","4",12887297,12901122,13825
"3820","ENSGALG00000007862","12",17291942,17382288,90346
"3821","ENSGALG00000007863","4",12902246,12904721,2475
"3822","ENSGALG00000007864","2",17448659,17498050,49391
"3823","ENSGALG00000007867","11",1334504,1345280,10776
"3824","ENSGALG00000007868","24",6140068,6160788,20720
"3825","ENSGALG00000007874","24",6169486,6173722,4236
"3826","ENSGALG00000007877","2",17544486,17645198,100712
"3827","ENSGALG00000007878","24",6175246,6178293,3047
"3828","ENSGALG00000007882","24",6178908,6183667,4759
"3829","ENSGALG00000007886","5",19338964,19346387,7423
"3830","ENSGALG00000007887","10",19195522,19311098,115576
"3831","ENSGALG00000007892","2",17695373,17728029,32656
"3832","ENSGALG00000007899","9",15755236,15759481,4245
"3833","ENSGALG00000007900","2",17743273,17746768,3495
"3834","ENSGALG00000007902","4",12911845,12929913,18068
"3835","ENSGALG00000007904","24",6188496,6194932,6436
"3836","ENSGALG00000007905","1",15009296,15165846,156550
"3837","ENSGALG00000007906","9",15759299,15764449,5150
"3838","ENSGALG00000007907","15",11105096,11111632,6536
"3839","ENSGALG00000007909","10",19311292,19369884,58592
"3840","ENSGALG00000007912","20",13107712,13155856,48144
"3841","ENSGALG00000007914","2",17823830,17951910,128080
"3842","ENSGALG00000007917","1",15053471,15105407,51936
"3843","ENSGALG00000007919","9",15767947,15786451,18504
"3844","ENSGALG00000007920","5",19671101,19710796,39695
"3845","ENSGALG00000007924","7",9781864,9800618,18754
"3846","ENSGALG00000007926","18",10623538,10627074,3536
"3847","ENSGALG00000007927","12",17945860,18046961,101101
"3848","ENSGALG00000007928","2",17920466,18034491,114025
"3849","ENSGALG00000007929","24",6196567,6228780,32213
"3850","ENSGALG00000007930","10",19374080,19496976,122896
"3851","ENSGALG00000007931","1",14993975,15007776,13801
"3852","ENSGALG00000007932","5",19717642,19735423,17781
"3853","ENSGALG00000007934","18",10626968,10634275,7307
"3854","ENSGALG00000007936","4",12938400,12949670,11270
"3855","ENSGALG00000007937","15",11112091,11125582,13491
"3856","ENSGALG00000007938","5",19742333,19745458,3125
"3857","ENSGALG00000007941","5",19755982,19795325,39343
"3858","ENSGALG00000007944","7",9813840,9920479,106639
"3859","ENSGALG00000007945","24",6239995,6246232,6237
"3860","ENSGALG00000007948","5",20745722,21182056,436334
"3861","ENSGALG00000007950","24",6247051,6248737,1686
"3862","ENSGALG00000007952","4",12977246,13012349,35103
"3863","ENSGALG00000007954","15",11128038,11134308,6270
"3864","ENSGALG00000007955","18",10639258,10647713,8455
"3865","ENSGALG00000007956","2",18525903,18759573,233670
"3866","ENSGALG00000007958","7",9992200,10012237,20037
"3867","ENSGALG00000007959","1",14959701,14973287,13586
"3868","ENSGALG00000007961","18",10653105,10655190,2085
"3869","ENSGALG00000007963","20",13171132,13253864,82732
"3870","ENSGALG00000007964","15",11136040,11139800,3760
"3871","ENSGALG00000007965","18",10646850,10667777,20927
"3872","ENSGALG00000007967","24",6250001,6254540,4539
"3873","ENSGALG00000007970","10",19522398,19573066,50668
"3874","ENSGALG00000007971","18",10674173,10680838,6665
"3875","ENSGALG00000007972","4",13079135,13140422,61287
"3876","ENSGALG00000007974","18",10686425,10698638,12213
"3877","ENSGALG00000007976","4",13151658,13165563,13905
"3878","ENSGALG00000007979","10",19575321,19577993,2672
"3879","ENSGALG00000007980","20",13362490,13370389,7899
"3880","ENSGALG00000007981","10",19578869,19585207,6338
"3881","ENSGALG00000007986","20",13383258,13384664,1406
"3882","ENSGALG00000007989","20",13406400,13427696,21296
"3883","ENSGALG00000007992","18",10698969,10717873,18904
"3884","ENSGALG00000007993","4",13231208,13304309,73101
"3885","ENSGALG00000007994","20",13464452,13478200,13748
"3886","ENSGALG00000007996","7",10057110,10167732,110622
"3887","ENSGALG00000007998","1",14925155,14945434,20279
"3888","ENSGALG00000007999","18",10717882,10723317,5435
"3889","ENSGALG00000008003","1",1535010,1544020,9010
"3890","ENSGALG00000008005","20",13486258,13534186,47928
"3891","ENSGALG00000008006","4",13332487,13379286,46799
"3892","ENSGALG00000008007","10",19594940,19629103,34163
"3893","ENSGALG00000008009","1",14895745,14919193,23448
"3894","ENSGALG00000008010","20",13537599,13576469,38870
"3895","ENSGALG00000008011","18",10732596,10738621,6025
"3896","ENSGALG00000008013","1",1544377,1557306,12929
"3897","ENSGALG00000008014","20",13708222,13709555,1333
"3898","ENSGALG00000008015","20",13738004,13752252,14248
"3899","ENSGALG00000008016","18",10741594,10779489,37895
"3900","ENSGALG00000008018","20",13790217,13793622,3405
"3901","ENSGALG00000008021","20",13795918,13801015,5097
"3902","ENSGALG00000008022","16",2567828,2571359,3531
"3903","ENSGALG00000008023","18",10792478,10831006,38528
"3904","ENSGALG00000008025","6",24063674,24088541,24867
"3905","ENSGALG00000008026","20",13801179,13807904,6725
"3906","ENSGALG00000008032","1",14842550,14848604,6054
"3907","ENSGALG00000008034","18",10835668,10861578,25910
"3908","ENSGALG00000008036","1",1569016,1580853,11837
"3909","ENSGALG00000008037","15",11167231,11190833,23602
"3910","ENSGALG00000008038","7",10184959,10205119,20160
"3911","ENSGALG00000008039","6",24108244,24121172,12928
"3912","ENSGALG00000008040","15",11192649,11209492,16843
"3913","ENSGALG00000008043","10",19645369,19672951,27582
"3914","ENSGALG00000008045","20",13824729,13895027,70298
"3915","ENSGALG00000008047","5",22433934,22456850,22916
"3916","ENSGALG00000008048","1",1584921,1594275,9354
"3917","ENSGALG00000008049","6",24257821,24283161,25340
"3918","ENSGALG00000008050","1",14682620,14697934,15314
"3919","ENSGALG00000008051","15",11209733,11284143,74410
"3920","ENSGALG00000008053","5",22505245,22544625,39380
"3921","ENSGALG00000008054","10",19677140,19696345,19205
"3922","ENSGALG00000008055","5",22558108,22570827,12719
"3923","ENSGALG00000008056","20",13861021,13896307,35286
"3924","ENSGALG00000008057","18",10892959,10923792,30833
"3925","ENSGALG00000008058","4",13392419,13452859,60440
"3926","ENSGALG00000008059","15",11292842,11317278,24436
"3927","ENSGALG00000008060","1",14593473,14674699,81226
"3928","ENSGALG00000008063","10",19716810,19722665,5855
"3929","ENSGALG00000008066","15",11319653,11321105,1452
"3930","ENSGALG00000008070","15",11321487,11334082,12595
"3931","ENSGALG00000008072","4",13511411,13553410,41999
"3932","ENSGALG00000008073","15",11346663,11387068,40405
"3933","ENSGALG00000008074","4",13620556,13686385,65829
"3934","ENSGALG00000008076","4",13698638,13736813,38175
"3935","ENSGALG00000008077","10",19767468,19773275,5807
"3936","ENSGALG00000008080","5",22998387,23015965,17578
"3937","ENSGALG00000008081","1",14541326,14569607,28281
"3938","ENSGALG00000008084","5",23026487,23031266,4779
"3939","ENSGALG00000008085","15",11407143,11411892,4749
"3940","ENSGALG00000008086","6",24122168,24136313,14145
"3941","ENSGALG00000008087","1",1600797,1604593,3796
"3942","ENSGALG00000008088","4",13761450,13795773,34323
"3943","ENSGALG00000008089","5",23024418,23038386,13968
"3944","ENSGALG00000008091","5",23038606,23041095,2489
"3945","ENSGALG00000008092","4",13806407,13813922,7515
"3946","ENSGALG00000008094","7",10221487,10231186,9699
"3947","ENSGALG00000008095","10",19774820,19792621,17801
"3948","ENSGALG00000008096","6",24136936,24218063,81127
"3949","ENSGALG00000008097","5",23040708,23093179,52471
"3950","ENSGALG00000008098","1",14365885,14392312,26427
"3951","ENSGALG00000008100","5",23098904,23108100,9196
"3952","ENSGALG00000008103","1",1605215,1614380,9165
"3953","ENSGALG00000008107","4",13876602,13898001,21399
"3954","ENSGALG00000008108","5",23108352,23119486,11134
"3955","ENSGALG00000008111","1",1614551,1619688,5137
"3956","ENSGALG00000008113","7",10323371,10366305,42934
"3957","ENSGALG00000008114","6",24283253,24287389,4136
"3958","ENSGALG00000008115","1",14159516,14267311,107795
"3959","ENSGALG00000008120","10",19916361,19936011,19650
"3960","ENSGALG00000008121","6",24341471,24343997,2526
"3961","ENSGALG00000008122","5",23134558,23166262,31704
"3962","ENSGALG00000008123","1",14138452,14150312,11860
"3963","ENSGALG00000008124","6",24344499,24347587,3088
"3964","ENSGALG00000008127","5",23185094,23206765,21671
"3965","ENSGALG00000008128","7",10239859,10249549,9690
"3966","ENSGALG00000008132","1",14118066,14138060,19994
"3967","ENSGALG00000008133","6",24348004,24352786,4782
"3968","ENSGALG00000008135","7",10794292,10924557,130265
"3969","ENSGALG00000008136","7",11009022,11014057,5035
"3970","ENSGALG00000008139","3",2560870,2680684,119814
"3971","ENSGALG00000008141","4",13903972,13924666,20694
"3972","ENSGALG00000008144","1",1619330,1638626,19296
"3973","ENSGALG00000008145","7",11020628,11026849,6221
"3974","ENSGALG00000008146","10",20089839,20112252,22413
"3975","ENSGALG00000008148","5",23218040,23273821,55781
"3976","ENSGALG00000008149","15",11435907,11457089,21182
"3977","ENSGALG00000008150","15",11476814,11485534,8720
"3978","ENSGALG00000008151","15",11487157,11490889,3732
"3979","ENSGALG00000008152","7",11092899,11169151,76252
"3980","ENSGALG00000008153","1",1649616,1654200,4584
"3981","ENSGALG00000008154","1",13958935,14006452,47517
"3982","ENSGALG00000008155","7",11175038,11181067,6029
"3983","ENSGALG00000008160","6",24353656,24452939,99283
"3984","ENSGALG00000008162","1",1655960,1680468,24508
"3985","ENSGALG00000008163","3",2948220,3011913,63693
"3986","ENSGALG00000008164","10",20114123,20157777,43654
"3987","ENSGALG00000008165","3",3016904,3018514,1610
"3988","ENSGALG00000008166","3",3021579,3025935,4356
"3989","ENSGALG00000008167","1",13903212,13955809,52597
"3990","ENSGALG00000008168","1",1679825,1696352,16527
"3991","ENSGALG00000008169","1",1696185,1712220,16035
"3992","ENSGALG00000008172","3",3030269,3041396,11127
"3993","ENSGALG00000008174","Z",78808957,78841432,32475
"3994","ENSGALG00000008175","1",13486054,13555003,68949
"3995","ENSGALG00000008176","3",3041079,3073674,32595
"3996","ENSGALG00000008177","15",11574676,11603131,28455
"3997","ENSGALG00000008178","9",15837337,15842611,5274
"3998","ENSGALG00000008179","6",24460271,24516319,56048
"3999","ENSGALG00000008180","10",20171900,20204388,32488
"4000","ENSGALG00000008181","5",23284346,23340192,55846
"4001","ENSGALG00000008182","3",3044379,3055276,10897
"4002","ENSGALG00000008185","7",11196756,11233011,36255
"4003","ENSGALG00000008187","10",20198916,20207682,8766
"4004","ENSGALG00000008188","Z",78975255,78994586,19331
"4005","ENSGALG00000008193","1",13185663,13457234,271571
"4006","ENSGALG00000008195","3",3072614,3092030,19416
"4007","ENSGALG00000008197","Z",79004881,79039363,34482
"4008","ENSGALG00000008198","3",3091851,3106753,14902
"4009","ENSGALG00000008199","10",20212122,20248395,36273
"4010","ENSGALG00000008201","15",11611346,11627560,16214
"4011","ENSGALG00000008204","Z",79117516,79130913,13397
"4012","ENSGALG00000008206","15",11628671,11631426,2755
"4013","ENSGALG00000008207","15",11634130,11680387,46257
"4014","ENSGALG00000008208","10",20257007,20277757,20750
"4015","ENSGALG00000008211","5",23379940,23388853,8913
"4016","ENSGALG00000008217","15",11696113,11719714,23601
"4017","ENSGALG00000008218","5",23388785,23403305,14520
"4018","ENSGALG00000008220","7",11284739,11295272,10533
"4019","ENSGALG00000008222","1",13143618,13176986,33368
"4020","ENSGALG00000008226","7",11313253,11318562,5309
"4021","ENSGALG00000008228","7",11306186,11313888,7702
"4022","ENSGALG00000008229","Z",79146009,79164153,18144
"4023","ENSGALG00000008230","6",24526945,24549491,22546
"4024","ENSGALG00000008231","5",23406293,23426262,19969
"4025","ENSGALG00000008233","3",3107742,3127503,19761
"4026","ENSGALG00000008234","7",11322145,11338539,16394
"4027","ENSGALG00000008236","1",13132814,13140156,7342
"4028","ENSGALG00000008237","Z",79172117,79205381,33264
"4029","ENSGALG00000008238","15",11842672,12020606,177934
"4030","ENSGALG00000008239","7",11394046,11397731,3685
"4031","ENSGALG00000008240","7",11400646,11419712,19066
"4032","ENSGALG00000008241","6",24550190,24561232,11042
"4033","ENSGALG00000008247","5",23437881,23447259,9378
"4034","ENSGALG00000008249","1",13115336,13132568,17232
"4035","ENSGALG00000008253","15",12598201,12638563,40362
"4036","ENSGALG00000008254","3",3158895,3193023,34128
"4037","ENSGALG00000008255","5",23440889,23529747,88858
"4038","ENSGALG00000008256","10",20347261,20364102,16841
"4039","ENSGALG00000008257","3",3201470,3222450,20980
"4040","ENSGALG00000008262","10",20370328,20388562,18234
"4041","ENSGALG00000008263","12",18230670,18486808,256138
"4042","ENSGALG00000008265","6",24565603,24582928,17325
"4043","ENSGALG00000008267","12",18489501,18503711,14210
"4044","ENSGALG00000008269","3",3236158,3265532,29374
"4045","ENSGALG00000008270","6",24590725,24595374,4649
"4046","ENSGALG00000008272","10",20422863,20424795,1932
"4047","ENSGALG00000008273","6",24604152,24606364,2212
"4048","ENSGALG00000008274","12",18513762,18525154,11392
"4049","ENSGALG00000008275","10",20433602,20434880,1278
"4050","ENSGALG00000008280","1",13106457,13115404,8947
"4051","ENSGALG00000008281","6",24677212,24753757,76545
"4052","ENSGALG00000008282","4",14102211,14114315,12104
"4053","ENSGALG00000008283","9",15845591,15850670,5079
"4054","ENSGALG00000008285","1",13065354,13085319,19965
"4055","ENSGALG00000008286","12",18771301,18798301,27000
"4056","ENSGALG00000008287","4",14114460,14117321,2861
"4057","ENSGALG00000008288","1",13055479,13063032,7553
"4058","ENSGALG00000008289","15",12740583,12788535,47952
"4059","ENSGALG00000008290","4",14121934,14142349,20415
"4060","ENSGALG00000008291","10",20444440,20448187,3747
"4061","ENSGALG00000008293","6",24766109,24990507,224398
"4062","ENSGALG00000008294","12",18802449,18953172,150723
"4063","ENSGALG00000008297","10",20469938,20483264,13326
"4064","ENSGALG00000008298","1",13007015,13024134,17119
"4065","ENSGALG00000008301","1",12932861,12973755,40894
"4066","ENSGALG00000008302","10",20483878,20486357,2479
"4067","ENSGALG00000008303","15",12856850,12862055,5205
"4068","ENSGALG00000008304","6",25000476,25039301,38825
"4069","ENSGALG00000008306","1",12915252,12921296,6044
"4070","ENSGALG00000008308","12",18986975,18991321,4346
"4071","ENSGALG00000008309","1",12885040,12935312,50272
"4072","ENSGALG00000008312","1",12815093,12861596,46503
"4073","ENSGALG00000008313","3",3276268,3283076,6808
"4074","ENSGALG00000008314","12",19004930,19018578,13648
"4075","ENSGALG00000008317","15",12864255,12866637,2382
"4076","ENSGALG00000008318","6",25039313,25083389,44076
"4077","ENSGALG00000008319","15",12867704,12870568,2864
"4078","ENSGALG00000008320","12",19022312,19033650,11338
"4079","ENSGALG00000008321","9",15868999,15880630,11631
"4080","ENSGALG00000008325","5",23632981,23671034,38053
"4081","ENSGALG00000008326","4",14162384,14186992,24608
"4082","ENSGALG00000008328","1",12650569,12700021,49452
"4083","ENSGALG00000008330","1",12642781,12647019,4238
"4084","ENSGALG00000008332","5",23673116,23683121,10005
"4085","ENSGALG00000008335","1",12579897,12642685,62788
"4086","ENSGALG00000008337","15",12872924,12875336,2412
"4087","ENSGALG00000008340","10",20534450,20539528,5078
"4088","ENSGALG00000008341","10",20543114,20554250,11136
"4089","ENSGALG00000008346","7",11436085,11444574,8489
"4090","ENSGALG00000008347","5",23721124,23734856,13732
"4091","ENSGALG00000008348","10",20574311,20583361,9050
"4092","ENSGALG00000008349","12",19629856,19651438,21582
"4093","ENSGALG00000008351","12",19676683,19680120,3437
"4094","ENSGALG00000008352","10",20585795,20594264,8469
"4095","ENSGALG00000008354","5",23739312,23743460,4148
"4096","ENSGALG00000008355","7",11449832,11455934,6102
"4097","ENSGALG00000008357","15",12879143,12931736,52593
"4098","ENSGALG00000008358","5",23743965,23868998,125033
"4099","ENSGALG00000008359","3",3329006,3331372,2366
"4100","ENSGALG00000008362","3",3340865,3343007,2142
"4101","ENSGALG00000008365","5",23877418,23884160,6742
"4102","ENSGALG00000008367","5",23884634,23886637,2003
"4103","ENSGALG00000008368","12",19697218,19731666,34448
"4104","ENSGALG00000008369","9",15881970,15921221,39251
"4105","ENSGALG00000008370","7",11462356,11480366,18010
"4106","ENSGALG00000008372","3",3546571,3591719,45148
"4107","ENSGALG00000008373","7",11490898,11499873,8975
"4108","ENSGALG00000008376","9",15926748,15945666,18918
"4109","ENSGALG00000008378","12",19736835,19803309,66474
"4110","ENSGALG00000008380","5",23887606,23926161,38555
"4111","ENSGALG00000008381","7",11505507,11516967,11460
"4112","ENSGALG00000008382","1",11521697,11555109,33412
"4113","ENSGALG00000008385","10",20594970,20635489,40519
"4114","ENSGALG00000008386","3",3599016,3639744,40728
"4115","ENSGALG00000008389","4",14203581,14211407,7826
"4116","ENSGALG00000008393","5",23934630,23975322,40692
"4117","ENSGALG00000008398","7",11518596,11537572,18976
"4118","ENSGALG00000008401","1",1752992,1763231,10239
"4119","ENSGALG00000008403","5",24007735,24135509,127774
"4120","ENSGALG00000008404","4",14216213,14240493,24280
"4121","ENSGALG00000008405","2",98528472,98559608,31136
"4122","ENSGALG00000008407","12",19833087,19846617,13530
"4123","ENSGALG00000008408","4",14256173,14306628,50455
"4124","ENSGALG00000008409","6",25196883,25205695,8812
"4125","ENSGALG00000008411","12",19849378,19852107,2729
"4126","ENSGALG00000008414","9",15945340,15972493,27153
"4127","ENSGALG00000008415","7",11545922,11578947,33025
"4128","ENSGALG00000008416","3",3841238,3871039,29801
"4129","ENSGALG00000008417","6",25241877,25296308,54431
"4130","ENSGALG00000008418","5",24137468,24151840,14372
"4131","ENSGALG00000008419","12",19853528,19868566,15038
"4132","ENSGALG00000008420","12",19859843,19874418,14575
"4133","ENSGALG00000008421","5",24156326,24162006,5680
"4134","ENSGALG00000008424","1",1768773,1769795,1022
"4135","ENSGALG00000008425","10",20638234,20655060,16826
"4136","ENSGALG00000008427","1",11413084,11443325,30241
"4137","ENSGALG00000008428","7",11591958,11617897,25939
"4138","ENSGALG00000008429","3",3921732,3934633,12901
"4139","ENSGALG00000008431","4",14314490,14340811,26321
"4140","ENSGALG00000008432","9",15974028,15997218,23190
"4141","ENSGALG00000008434","6",25384378,25647775,263397
"4142","ENSGALG00000008435","7",11763927,11776913,12986
"4143","ENSGALG00000008436","5",24183069,24201831,18762
"4144","ENSGALG00000008437","1",1772740,1784158,11418
"4145","ENSGALG00000008438","5",24201697,24206058,4361
"4146","ENSGALG00000008439","1",11333589,11371413,37824
"4147","ENSGALG00000008440","5",24229253,24231231,1978
"4148","ENSGALG00000008442","4",15290397,15521568,231171
"4149","ENSGALG00000008443","18",9929414,9938281,8867
"4150","ENSGALG00000008444","1",1833150,1840448,7298
"4151","ENSGALG00000008445","3",4055975,4107356,51381
"4152","ENSGALG00000008447","4",15530219,15544105,13886
"4153","ENSGALG00000008452","12",19881680,19914129,32449
"4154","ENSGALG00000008454","7",11777039,11801661,24622
"4155","ENSGALG00000008456","17",2470501,2727279,256778
"4156","ENSGALG00000008457","3",4154797,4182140,27343
"4157","ENSGALG00000008459","7",11821550,11916693,95143
"4158","ENSGALG00000008460","5",24451176,24460107,8931
"4159","ENSGALG00000008462","18",4576203,4580639,4436
"4160","ENSGALG00000008465","6",26083271,26356014,272743
"4161","ENSGALG00000008466","7",11936941,11952247,15306
"4162","ENSGALG00000008469","5",24476138,24491757,15619
"4163","ENSGALG00000008470","7",11973780,11981643,7863
"4164","ENSGALG00000008473","12",19926150,19990738,64588
"4165","ENSGALG00000008474","7",11985951,12007348,21397
"4166","ENSGALG00000008475","17",2324755,2351466,26711
"4167","ENSGALG00000008477","1",2056289,2511935,455646
"4168","ENSGALG00000008479","7",12028376,12146878,118502
"4169","ENSGALG00000008480","9",15997173,16005085,7912
"4170","ENSGALG00000008482","4",15574392,15623964,49572
"4171","ENSGALG00000008485","7",12138734,12173094,34360
"4172","ENSGALG00000008486","1",10375977,10734880,358903
"4173","ENSGALG00000008487","12",20012823,20081825,69002
"4174","ENSGALG00000008490","12",20107152,20111710,4558
"4175","ENSGALG00000008491","4",15652758,15672807,20049
"4176","ENSGALG00000008493","7",12179296,12182133,2837
"4177","ENSGALG00000008494","7",12187150,12222849,35699
"4178","ENSGALG00000008496","5",24519457,24530127,10670
"4179","ENSGALG00000008497","1",31106674,31121733,15059
"4180","ENSGALG00000008498","2",18779714,18995157,215443
"4181","ENSGALG00000008500","12",20120838,20134079,13241
"4182","ENSGALG00000008501","7",12266170,12321029,54859
"4183","ENSGALG00000008503","9",16021901,16024265,2364
"4184","ENSGALG00000008504","3",16580199,16608452,28253
"4185","ENSGALG00000008506","12",20135662,20138729,3067
"4186","ENSGALG00000008507","4",15682570,15730263,47693
"4187","ENSGALG00000008508","3",4194440,4208671,14231
"4188","ENSGALG00000008513","4",16382396,16384100,1704
"4189","ENSGALG00000008514","5",24634300,24643252,8952
"4190","ENSGALG00000008516","7",12354370,12361679,7309
"4191","ENSGALG00000008517","4",16384954,16392362,7408
"4192","ENSGALG00000008518","17",2287820,2308533,20713
"4193","ENSGALG00000008519","12",20137521,20174947,37426
"4194","ENSGALG00000008520","9",16051651,16069156,17505
"4195","ENSGALG00000008523","6",26634513,26664552,30039
"4196","ENSGALG00000008525","3",4209087,4236900,27813
"4197","ENSGALG00000008529","7",12380240,12390798,10558
"4198","ENSGALG00000008530","3",16516836,16523403,6567
"4199","ENSGALG00000008532","17",2266795,2277934,11139
"4200","ENSGALG00000008534","9",16102960,16105780,2820
"4201","ENSGALG00000008536","3",4274637,4294091,19454
"4202","ENSGALG00000008537","9",16119700,16130843,11143
"4203","ENSGALG00000008538","3",16497527,16500460,2933
"4204","ENSGALG00000008539","1",19029131,19044906,15775
"4205","ENSGALG00000008542","6",26669740,26768280,98540
"4206","ENSGALG00000008544","3",16420525,16490003,69478
"4207","ENSGALG00000008545","9",16218168,16232354,14186
"4208","ENSGALG00000008546","12",20187838,20274748,86910
"4209","ENSGALG00000008548","7",12390869,12399996,9127
"4210","ENSGALG00000008549","10",20728015,20740065,12050
"4211","ENSGALG00000008550","3",16201791,16246746,44955
"4212","ENSGALG00000008551","1",19045087,19056483,11396
"4213","ENSGALG00000008552","3",16194666,16199101,4435
"4214","ENSGALG00000008553","5",24663248,24738505,75257
"4215","ENSGALG00000008554","1",20198062,20240989,42927
"4216","ENSGALG00000008555","6",26774727,26826626,51899
"4217","ENSGALG00000008557","2",19078328,19094413,16085
"4218","ENSGALG00000008559","4",16393709,16414065,20356
"4219","ENSGALG00000008561","6",26833510,26842592,9082
"4220","ENSGALG00000008562","7",12404841,12423563,18722
"4221","ENSGALG00000008563","3",16177804,16189143,11339
"4222","ENSGALG00000008564","2",19094513,19114342,19829
"4223","ENSGALG00000008567","3",4309807,4352759,42952
"4224","ENSGALG00000008569","5",24756733,24773702,16969
"4225","ENSGALG00000008572","4",16422849,16439800,16951
"4226","ENSGALG00000008574","1",194436252,194446714,10462
"4227","ENSGALG00000008579","5",24793049,24795962,2913
"4228","ENSGALG00000008582","7",12447136,12519795,72659
"4229","ENSGALG00000008584","5",24796212,24810473,14261
"4230","ENSGALG00000008585","6",26948857,26997494,48637
"4231","ENSGALG00000008586","17",2241348,2243444,2096
"4232","ENSGALG00000008587","5",24811174,24817551,6377
"4233","ENSGALG00000008589","7",12555296,12570730,15434
"4234","ENSGALG00000008590","7",12570845,12576467,5622
"4235","ENSGALG00000008591","2",19119896,19343839,223943
"4236","ENSGALG00000008593","4",16441331,16448493,7162
"4237","ENSGALG00000008595","5",24817277,24842932,25655
"4238","ENSGALG00000008597","3",4363776,4365845,2069
"4239","ENSGALG00000008599","5",24874554,24881577,7023
"4240","ENSGALG00000008601","9",16291385,16337111,45726
"4241","ENSGALG00000008602","2",19370281,19404271,33990
"4242","ENSGALG00000008603","5",24896103,24930838,34735
"4243","ENSGALG00000008604","4",16450062,16472364,22302
"4244","ENSGALG00000008606","7",12576609,12590450,13841
"4245","ENSGALG00000008608","9",16303131,16310398,7267
"4246","ENSGALG00000008609","3",4406323,4417810,11487
"4247","ENSGALG00000008611","4",16476509,16483164,6655
"4248","ENSGALG00000008613","4",16492920,16494113,1193
"4249","ENSGALG00000008614","3",16096879,16112242,15363
"4250","ENSGALG00000008615","5",24938602,24952531,13929
"4251","ENSGALG00000008616","17",2195780,2233577,37797
"4252","ENSGALG00000008618","4",16494368,16501047,6679
"4253","ENSGALG00000008620","4",16501944,16504398,2454
"4254","ENSGALG00000008621","7",12666450,12744588,78138
"4255","ENSGALG00000008623","17",2166268,2170923,4655
"4256","ENSGALG00000008624","5",25078510,25115395,36885
"4257","ENSGALG00000008625","17",2152582,2163344,10762
"4258","ENSGALG00000008627","3",15979242,16071844,92602
"4259","ENSGALG00000008628","5",25144346,25145743,1397
"4260","ENSGALG00000008629","2",19573334,19621981,48647
"4261","ENSGALG00000008631","5",25149919,25189178,39259
"4262","ENSGALG00000008632","3",15944552,15976454,31902
"4263","ENSGALG00000008633","4",16507527,16532945,25418
"4264","ENSGALG00000008635","1",20505033,20508744,3711
"4265","ENSGALG00000008638","2",19497094,19526728,29634
"4266","ENSGALG00000008645","4",16533304,16542633,9329
"4267","ENSGALG00000008646","9",16312852,16324176,11324
"4268","ENSGALG00000008648","4",16544363,16552461,8098
"4269","ENSGALG00000008651","3",15927353,15940433,13080
"4270","ENSGALG00000008652","4",16552918,16556801,3883
"4271","ENSGALG00000008653","5",25195649,25255228,59579
"4272","ENSGALG00000008656","7",13376431,13388513,12082
"4273","ENSGALG00000008658","8",16551740,16579545,27805
"4274","ENSGALG00000008659","2",19682112,19693882,11770
"4275","ENSGALG00000008660","3",15917270,15922608,5338
"4276","ENSGALG00000008661","8",16587842,16590293,2451
"4277","ENSGALG00000008663","8",16625897,16672394,46497
"4278","ENSGALG00000008666","7",13408731,13412887,4156
"4279","ENSGALG00000008667","3",15647437,15658771,11334
"4280","ENSGALG00000008669","7",13436135,13454946,18811
"4281","ENSGALG00000008670","8",16687314,16694446,7132
"4282","ENSGALG00000008671","2",19733122,19771927,38805
"4283","ENSGALG00000008675","4",16561047,16563108,2061
"4284","ENSGALG00000008676","3",15616824,15644373,27549
"4285","ENSGALG00000008677","2",19700327,19802856,102529
"4286","ENSGALG00000008681","17",2092280,2126139,33859
"4287","ENSGALG00000008682","4",16564093,16581626,17533
"4288","ENSGALG00000008684","9",16355099,16361974,6875
"4289","ENSGALG00000008686","2",19816795,19845645,28850
"4290","ENSGALG00000008689","4",16596602,16603925,7323
"4291","ENSGALG00000008691","3",15568556,15585361,16805
"4292","ENSGALG00000008696","8",16742105,16764127,22022
"4293","ENSGALG00000008698","3",15560649,15568643,7994
"4294","ENSGALG00000008700","6",27094512,27111651,17139
"4295","ENSGALG00000008701","3",4475544,4516350,40806
"4296","ENSGALG00000008702","3",15552060,15557418,5358
"4297","ENSGALG00000008703","9",16362069,16373062,10993
"4298","ENSGALG00000008704","2",19855448,19994614,139166
"4299","ENSGALG00000008707","3",15522085,15540596,18511
"4300","ENSGALG00000008709","8",16765732,16781321,15589
"4301","ENSGALG00000008713","3",15519544,15520683,1139
"4302","ENSGALG00000008714","7",13598813,13653730,54917
"4303","ENSGALG00000008716","3",4684844,4686787,1943
"4304","ENSGALG00000008722","8",16782846,16802543,19697
"4305","ENSGALG00000008725","3",5496073,5630444,134371
"4306","ENSGALG00000008727","5",25395587,25420105,24518
"4307","ENSGALG00000008728","2",20127432,20147266,19834
"4308","ENSGALG00000008730","7",13668815,13681937,13122
"4309","ENSGALG00000008731","3",15499040,15539871,40831
"4310","ENSGALG00000008732","3",5661982,5666978,4996
"4311","ENSGALG00000008733","8",16810670,16822126,11456
"4312","ENSGALG00000008734","3",12111551,12286838,175287
"4313","ENSGALG00000008735","3",12088678,12107322,18644
"4314","ENSGALG00000008736","17",1953840,2069709,115869
"4315","ENSGALG00000008738","7",13680574,13686738,6164
"4316","ENSGALG00000008739","2",20283219,20330243,47024
"4317","ENSGALG00000008740","1",21884126,21946881,62755
"4318","ENSGALG00000008741","3",11998079,12006782,8703
"4319","ENSGALG00000008744","9",16375392,16527556,152164
"4320","ENSGALG00000008745","3",11969797,11992290,22493
"4321","ENSGALG00000008747","2",20336331,20435530,99199
"4322","ENSGALG00000008749","3",15490931,15498846,7915
"4323","ENSGALG00000008750","17",1942496,1950943,8447
"4324","ENSGALG00000008752","5",25367151,25377869,10718
"4325","ENSGALG00000008753","3",11966173,11969604,3431
"4326","ENSGALG00000008756","3",11941428,11957951,16523
"4327","ENSGALG00000008757","3",11929031,11934921,5890
"4328","ENSGALG00000008759","9",16528504,16544195,15691
"4329","ENSGALG00000008760","3",11857525,11863372,5847
"4330","ENSGALG00000008761","1",22238881,22251669,12788
"4331","ENSGALG00000008763","8",16844808,16864555,19747
"4332","ENSGALG00000008764","2",20492485,20575251,82766
"4333","ENSGALG00000008765","3",11828964,11846476,17512
"4334","ENSGALG00000008771","6",27122877,27178543,55666
"4335","ENSGALG00000008776","1",22287864,22327497,39633
"4336","ENSGALG00000008778","3",10658095,10707270,49175
"4337","ENSGALG00000008779","3",10612572,10632536,19964
"4338","ENSGALG00000008780","8",16940149,16946646,6497
"4339","ENSGALG00000008784","8",16953648,16965095,11447
"4340","ENSGALG00000008785","9",16547508,16563542,16034
"4341","ENSGALG00000008786","7",13692234,13766299,74065
"4342","ENSGALG00000008787","3",10567493,10575980,8487
"4343","ENSGALG00000008791","2",20585985,20613422,27437
"4344","ENSGALG00000008793","3",15471739,15488351,16612
"4345","ENSGALG00000008794","2",20616815,20619955,3140
"4346","ENSGALG00000008795","6",27574464,27600048,25584
"4347","ENSGALG00000008796","8",16969699,16975356,5657
"4348","ENSGALG00000008797","1",22351089,22401091,50002
"4349","ENSGALG00000008798","17",1931676,1938932,7256
"4350","ENSGALG00000008802","6",27631488,27639564,8076
"4351","ENSGALG00000008803","7",13788835,13797934,9099
"4352","ENSGALG00000008805","1",22419625,22425777,6152
"4353","ENSGALG00000008806","17",1924726,1946331,21605
"4354","ENSGALG00000008807","9",16569414,16586727,17313
"4355","ENSGALG00000008808","3",15457010,15469802,12792
"4356","ENSGALG00000008810","3",15443415,15451711,8296
"4357","ENSGALG00000008811","3",10532551,10556800,24249
"4358","ENSGALG00000008812","3",15437950,15444620,6670
"4359","ENSGALG00000008813","2",20644330,20664067,19737
"4360","ENSGALG00000008814","1",22434929,22445383,10454
"4361","ENSGALG00000008815","3",15421291,15430454,9163
"4362","ENSGALG00000008818","7",13798294,13811022,12728
"4363","ENSGALG00000008819","17",1900196,1925313,25117
"4364","ENSGALG00000008821","1",22449623,22454662,5039
"4365","ENSGALG00000008823","1",22456440,22477009,20569
"4366","ENSGALG00000008827","3",15397548,15416818,19270
"4367","ENSGALG00000008828","3",10378580,10423866,45286
"4368","ENSGALG00000008834","8",17005989,17013371,7382
"4369","ENSGALG00000008835","8",17017291,17029086,11795
"4370","ENSGALG00000008836","1",22485251,22539257,54006
"4371","ENSGALG00000008837","3",10247163,10289340,42177
"4372","ENSGALG00000008838","17",1870533,1896590,26057
"4373","ENSGALG00000008839","9",16588019,16645147,57128
"4374","ENSGALG00000008840","6",27661391,27681605,20214
"4375","ENSGALG00000008842","7",13813674,13871850,58176
"4376","ENSGALG00000008844","17",1846199,1870295,24096
"4377","ENSGALG00000008845","3",14754615,14781742,27127
"4378","ENSGALG00000008847","3",10188732,10229406,40674
"4379","ENSGALG00000008850","8",17124650,17182287,57637
"4380","ENSGALG00000008852","9",17241691,17245183,3492
"4381","ENSGALG00000008855","3",10164257,10188294,24037
"4382","ENSGALG00000008857","17",1836504,1844590,8086
"4383","ENSGALG00000008858","3",10131713,10143027,11314
"4384","ENSGALG00000008859","17",1828839,1835807,6968
"4385","ENSGALG00000008860","4",16693260,16706646,13386
"4386","ENSGALG00000008861","17",1821891,1828716,6825
"4387","ENSGALG00000008862","7",13877069,13896783,19714
"4388","ENSGALG00000008864","9",17247026,17278252,31226
"4389","ENSGALG00000008865","17",1811462,1820311,8849
"4390","ENSGALG00000008866","3",9992627,10131875,139248
"4391","ENSGALG00000008867","4",16711121,16731302,20181
"4392","ENSGALG00000008870","6",27683963,27693870,9907
"4393","ENSGALG00000008872","4",16731361,16739622,8261
"4394","ENSGALG00000008873","17",1807509,1811764,4255
"4395","ENSGALG00000008874","1",22565977,22590094,24117
"4396","ENSGALG00000008875","3",14299839,14672677,372838
"4397","ENSGALG00000008880","6",27694195,27943774,249579
"4398","ENSGALG00000008881","17",1734410,1747726,13316
"4399","ENSGALG00000008883","6",28006744,28178462,171718
"4400","ENSGALG00000008885","7",13988323,14095263,106940
"4401","ENSGALG00000008886","17",1423467,1554275,130808
"4402","ENSGALG00000008888","4",16845799,17180206,334407
"4403","ENSGALG00000008889","9",17345389,17354004,8615
"4404","ENSGALG00000008890","8",18695737,18954195,258458
"4405","ENSGALG00000008896","7",14106274,14154526,48252
"4406","ENSGALG00000008898","17",1366340,1396917,30577
"4407","ENSGALG00000008901","8",19088734,19108187,19453
"4408","ENSGALG00000008902","8",19189801,19211722,21921
"4409","ENSGALG00000008903","7",14156691,14197263,40572
"4410","ENSGALG00000008905","6",28388027,28407872,19845
"4411","ENSGALG00000008907","3",14058563,14184797,126234
"4412","ENSGALG00000008908","7",14257747,14259601,1854
"4413","ENSGALG00000008909","9",17541652,17583458,41806
"4414","ENSGALG00000008910","7",14306197,14316264,10067
"4415","ENSGALG00000008911","17",1338035,1340745,2710
"4416","ENSGALG00000008912","2",20665075,20706383,41308
"4417","ENSGALG00000008914","6",28407511,28452857,45346
"4418","ENSGALG00000008916","8",19220317,19242727,22410
"4419","ENSGALG00000008918","3",14045653,14055302,9649
"4420","ENSGALG00000008920","17",1312877,1330720,17843
"4421","ENSGALG00000008925","17",1312991,1313401,410
"4422","ENSGALG00000008926","1",22670291,22971425,301134
"4423","ENSGALG00000008930","3",9676896,9693979,17083
"4424","ENSGALG00000008931","3",9592856,9662389,69533
"4425","ENSGALG00000008932","17",1280371,1289568,9197
"4426","ENSGALG00000008933","6",28458646,28478945,20299
"4427","ENSGALG00000008934","9",17701501,17719909,18408
"4428","ENSGALG00000008936","17",1290696,1294902,4206
"4429","ENSGALG00000008937","3",9563168,9592601,29433
"4430","ENSGALG00000008938","6",28504700,28518725,14025
"4431","ENSGALG00000008939","8",19243036,19264136,21100
"4432","ENSGALG00000008940","5",25427166,25520280,93114
"4433","ENSGALG00000008941","1",22977640,22983971,6331
"4434","ENSGALG00000008942","3",9524890,9552231,27341
"4435","ENSGALG00000008944","3",9395346,9458482,63136
"4436","ENSGALG00000008945","8",19269326,19285928,16602
"4437","ENSGALG00000008946","6",28519491,28550586,31095
"4438","ENSGALG00000008947","3",13939800,14041253,101453
"4439","ENSGALG00000008949","6",28606240,28608617,2377
"4440","ENSGALG00000008950","5",25532127,25551896,19769
"4441","ENSGALG00000008951","8",19297753,19332508,34755
"4442","ENSGALG00000008952","17",1265985,1279220,13235
"4443","ENSGALG00000008953","1",23009937,23038493,28556
"4444","ENSGALG00000008954","2",20768642,20810312,41670
"4445","ENSGALG00000008956","6",28633992,28651058,17066
"4446","ENSGALG00000008957","3",9383316,9394077,10761
"4447","ENSGALG00000008960","3",9310529,9323708,13179
"4448","ENSGALG00000008962","3",9267920,9295874,27954
"4449","ENSGALG00000008963","2",20828415,20844335,15920
"4450","ENSGALG00000008969","3",9260060,9446795,186735
"4451","ENSGALG00000008970","4",17200089,17295351,95262
"4452","ENSGALG00000008974","8",19332100,19366477,34377
"4453","ENSGALG00000008975","1",23349811,23381342,31531
"4454","ENSGALG00000008976","2",20850062,20974465,124403
"4455","ENSGALG00000008979","3",9237777,9243926,6149
"4456","ENSGALG00000008980","6",28685715,28701120,15405
"4457","ENSGALG00000008983","9",17624174,17660602,36428
"4458","ENSGALG00000008985","2",20983100,20992378,9278
"4459","ENSGALG00000008988","8",19375099,19428986,53887
"4460","ENSGALG00000008990","4",17301974,17322995,21021
"4461","ENSGALG00000008991","5",25804196,25827301,23105
"4462","ENSGALG00000008996","3",13866589,13879079,12490
"4463","ENSGALG00000008997","2",21007327,21026905,19578
"4464","ENSGALG00000008998","3",9164062,9211550,47488
"4465","ENSGALG00000008999","6",28705869,28759542,53673
"4466","ENSGALG00000009001","7",14780212,14809720,29508
"4467","ENSGALG00000009002","1",23415784,23554158,138374
"4468","ENSGALG00000009003","3",13751856,13817913,66057
"4469","ENSGALG00000009004","2",21172333,21382361,210028
"4470","ENSGALG00000009006","2",21641463,21650943,9480
"4471","ENSGALG00000009007","3",9144569,9148345,3776
"4472","ENSGALG00000009012","7",14842857,14976181,133324
"4473","ENSGALG00000009013","3",13717148,13724622,7474
"4474","ENSGALG00000009015","8",19534794,19598636,63842
"4475","ENSGALG00000009016","3",13641962,13716976,75014
"4476","ENSGALG00000009017","2",21667322,21673630,6308
"4477","ENSGALG00000009018","5",25831277,25852094,20817
"4478","ENSGALG00000009020","3",13599642,13633726,34084
"4479","ENSGALG00000009021","8",19606487,19673054,66567
"4480","ENSGALG00000009023","1",23568700,23587086,18386
"4481","ENSGALG00000009024","3",9097406,9136655,39249
"4482","ENSGALG00000009026","2",21682611,21706828,24217
"4483","ENSGALG00000009027","8",19735941,19930919,194978
"4484","ENSGALG00000009028","3",13189289,13199549,10260
"4485","ENSGALG00000009029","1",23609312,23654509,45197
"4486","ENSGALG00000009031","7",15017686,15069511,51825
"4487","ENSGALG00000009032","8",19953424,19965159,11735
"4488","ENSGALG00000009033","8",19965263,19967145,1882
"4489","ENSGALG00000009034","3",9091386,9110192,18806
"4490","ENSGALG00000009035","2",21718731,21731532,12801
"4491","ENSGALG00000009036","5",25852299,25871820,19521
"4492","ENSGALG00000009037","3",12892857,12984138,91281
"4493","ENSGALG00000009040","4",17368832,17400336,31504
"4494","ENSGALG00000009041","3",8772209,8777996,5787
"4495","ENSGALG00000009042","3",12825298,12864186,38888
"4496","ENSGALG00000009044","2",21749428,21771950,22522
"4497","ENSGALG00000009045","8",19966544,19972442,5898
"4498","ENSGALG00000009047","3",8735999,8745985,9986
"4499","ENSGALG00000009048","6",28775575,28948158,172583
"4500","ENSGALG00000009050","5",25874264,25898344,24080
"4501","ENSGALG00000009052","3",8705197,8715863,10666
"4502","ENSGALG00000009056","3",8530368,8636888,106520
"4503","ENSGALG00000009057","3",12725381,12798093,72712
"4504","ENSGALG00000009061","9",17592937,17602342,9405
"4505","ENSGALG00000009062","2",21788601,22097425,308824
"4506","ENSGALG00000009063","4",17406321,17430410,24089
"4507","ENSGALG00000009064","2",22134540,22136747,2207
"4508","ENSGALG00000009065","4",17503248,17509318,6070
"4509","ENSGALG00000009066","1",23662850,23926311,263461
"4510","ENSGALG00000009067","4",17605471,17631574,26103
"4511","ENSGALG00000009068","3",12635777,12683252,47475
"4512","ENSGALG00000009069","3",8356314,8379148,22834
"4513","ENSGALG00000009070","7",10231654,10236618,4964
"4514","ENSGALG00000009071","4",17644907,17651422,6515
"4515","ENSGALG00000009073","3",12595835,12614895,19060
"4516","ENSGALG00000009075","4",17685301,17700030,14729
"4517","ENSGALG00000009076","9",17584908,17588440,3532
"4518","ENSGALG00000009078","3",8390484,8454832,64348
"4519","ENSGALG00000009081","5",25904242,25917935,13693
"4520","ENSGALG00000009082","3",12555719,12587558,31839
"4521","ENSGALG00000009085","4",17705878,17738729,32851
"4522","ENSGALG00000009086","3",8325117,8350293,25176
"4523","ENSGALG00000009091","6",29011128,29039507,28379
"4524","ENSGALG00000009092","3",8270256,8292236,21980
"4525","ENSGALG00000009093","3",11863403,11866943,3540
"4526","ENSGALG00000009095","3",8231020,8250534,19514
"4527","ENSGALG00000009096","4",17740413,17781487,41074
"4528","ENSGALG00000009097","5",25937093,25954313,17220
"4529","ENSGALG00000009098","4",17794159,17870027,75868
"4530","ENSGALG00000009100","3",8032161,8144176,112015
"4531","ENSGALG00000009104","1",24435899,24484038,48139
"4532","ENSGALG00000009107","3",7172818,7823576,650758
"4533","ENSGALG00000009110","1",24490276,24495990,5714
"4534","ENSGALG00000009111","5",25961531,25966218,4687
"4535","ENSGALG00000009112","5",25956755,25961481,4726
"4536","ENSGALG00000009119","3",16850310,16858699,8389
"4537","ENSGALG00000009128","4",18042924,18045047,2123
"4538","ENSGALG00000009129","2",24451494,24453892,2398
"4539","ENSGALG00000009130","3",16861604,16894451,32847
"4540","ENSGALG00000009134","1",24616305,24691437,75132
"4541","ENSGALG00000009135","7",15386468,15401754,15286
"4542","ENSGALG00000009139","4",18046383,18056099,9716
"4543","ENSGALG00000009147","25",2407633,2418982,11349
"4544","ENSGALG00000009149","7",15401946,15406358,4412
"4545","ENSGALG00000009152","6",29096845,29512936,416091
"4546","ENSGALG00000009153","25",2291057,2407537,116480
"4547","ENSGALG00000009154","4",18056170,18086637,30467
"4548","ENSGALG00000009156","5",26069622,26096589,26967
"4549","ENSGALG00000009157","9",19381072,19406302,25230
"4550","ENSGALG00000009158","3",12391368,12550464,159096
"4551","ENSGALG00000009168","4",18189034,18535906,346872
"4552","ENSGALG00000009169","3",17001496,17013624,12128
"4553","ENSGALG00000009170","9",19410811,19426299,15488
"4554","ENSGALG00000009172","7",15434552,15516341,81789
"4555","ENSGALG00000009173","6",29568136,29703924,135788
"4556","ENSGALG00000009176","5",26132388,26166104,33716
"4557","ENSGALG00000009177","4",18668176,18696911,28735
"4558","ENSGALG00000009179","9",19447018,19455676,8658
"4559","ENSGALG00000009182","6",29729434,29748201,18767
"4560","ENSGALG00000009185","5",26196568,26206964,10396
"4561","ENSGALG00000009192","4",19319215,19321788,2573
"4562","ENSGALG00000009195","3",17013679,17028855,15176
"4563","ENSGALG00000009202","7",15530430,15541507,11077
"4564","ENSGALG00000009205","14",14438034,14559559,121525
"4565","ENSGALG00000009207","4",19768464,19870165,101701
"4566","ENSGALG00000009212","4",19876653,19916272,39619
"4567","ENSGALG00000009214","3",17029870,17035028,5158
"4568","ENSGALG00000009217","14",14270201,14295203,25002
"4569","ENSGALG00000009219","3",17045413,17078471,33058
"4570","ENSGALG00000009222","9",19471769,19619406,147637
"4571","ENSGALG00000009224","7",15680124,15682118,1994
"4572","ENSGALG00000009228","3",17119785,17149024,29239
"4573","ENSGALG00000009229","14",14249705,14260962,11257
"4574","ENSGALG00000009230","4",19928294,19998920,70626
"4575","ENSGALG00000009233","3",17153512,17191074,37562
"4576","ENSGALG00000009234","14",14236203,14243294,7091
"4577","ENSGALG00000009236","7",15718776,15770328,51552
"4578","ENSGALG00000009240","7",15795206,15819376,24170
"4579","ENSGALG00000009241","4",20063168,20067413,4245
"4580","ENSGALG00000009246","3",17212579,17230427,17848
"4581","ENSGALG00000009248","6",29829102,29879088,49986
"4582","ENSGALG00000009249","5",26214323,26270727,56404
"4583","ENSGALG00000009250","7",15825248,15840498,15250
"4584","ENSGALG00000009252","9",19674293,19709791,35498
"4585","ENSGALG00000009253","3",17263074,17267827,4753
"4586","ENSGALG00000009254","6",29917122,29935121,17999
"4587","ENSGALG00000009256","3",17273856,17277099,3243
"4588","ENSGALG00000009257","4",20249413,20305236,55823
"4589","ENSGALG00000009260","5",26271724,26291686,19962
"4590","ENSGALG00000009261","6",30033928,30037380,3452
"4591","ENSGALG00000009262","4",20308597,20315123,6526
"4592","ENSGALG00000009264","7",16208242,16240983,32741
"4593","ENSGALG00000009265","6",30065669,30068847,3178
"4594","ENSGALG00000009266","4",20321300,20328290,6990
"4595","ENSGALG00000009268","4",20332665,20338478,5813
"4596","ENSGALG00000009269","5",26296854,26311104,14250
"4597","ENSGALG00000009270","7",16302455,16304988,2533
"4598","ENSGALG00000009272","4",20343216,20391061,47845
"4599","ENSGALG00000009274","7",16319229,16321094,1865
"4600","ENSGALG00000009275","3",17289368,17318123,28755
"4601","ENSGALG00000009276","4",20396156,20397656,1500
"4602","ENSGALG00000009278","4",20419208,20423020,3812
"4603","ENSGALG00000009279","1",4524285,4616058,91773
"4604","ENSGALG00000009280","4",20538373,20543866,5493
"4605","ENSGALG00000009282","5",26349055,26370948,21893
"4606","ENSGALG00000009286","7",16638236,16652554,14318
"4607","ENSGALG00000009287","7",16657945,16702160,44215
"4608","ENSGALG00000009288","14",14178481,14188580,10099
"4609","ENSGALG00000009289","6",30092809,30110773,17964
"4610","ENSGALG00000009291","3",17327535,17347820,20285
"4611","ENSGALG00000009292","5",26400138,26404503,4365
"4612","ENSGALG00000009293","7",16717993,16797948,79955
"4613","ENSGALG00000009297","14",14162894,14178376,15482
"4614","ENSGALG00000009298","9",19829026,19858603,29577
"4615","ENSGALG00000009300","5",26429499,26522602,93103
"4616","ENSGALG00000009301","7",16798486,16810189,11703
"4617","ENSGALG00000009302","6",30231251,30236803,5552
"4618","ENSGALG00000009303","3",17438558,17480222,41664
"4619","ENSGALG00000009304","6",30435396,30463341,27945
"4620","ENSGALG00000009305","3",17507071,17520890,13819
"4621","ENSGALG00000009306","9",19861346,19868706,7360
"4622","ENSGALG00000009307","6",30590365,30606795,16430
"4623","ENSGALG00000009308","3",17558062,17599394,41332
"4624","ENSGALG00000009309","9",19871778,19876084,4306
"4625","ENSGALG00000009312","9",19878895,19880940,2045
"4626","ENSGALG00000009314","6",30764722,30804284,39562
"4627","ENSGALG00000009315","5",26533055,26554073,21018
"4628","ENSGALG00000009318","14",14083901,14161575,77674
"4629","ENSGALG00000009320","5",26593233,26614911,21678
"4630","ENSGALG00000009322","3",17672118,17701641,29523
"4631","ENSGALG00000009325","7",16957125,17050196,93071
"4632","ENSGALG00000009328","6",30925510,30953116,27606
"4633","ENSGALG00000009330","3",17705163,17711133,5970
"4634","ENSGALG00000009331","3",17716351,17728981,12630
"4635","ENSGALG00000009332","5",26616754,26624529,7775
"4636","ENSGALG00000009336","6",30953846,30963313,9467
"4637","ENSGALG00000009338","5",26653986,26676965,22979
"4638","ENSGALG00000009341","14",14040887,14078874,37987
"4639","ENSGALG00000009345","5",26683296,26695692,12396
"4640","ENSGALG00000009346","14",14025385,14035041,9656
"4641","ENSGALG00000009349","9",19920957,19930995,10038
"4642","ENSGALG00000009350","6",30962012,30975792,13780
"4643","ENSGALG00000009352","5",26716366,26875132,158766
"4644","ENSGALG00000009355","9",19935349,19943732,8383
"4645","ENSGALG00000009356","9",19949891,19961418,11527
"4646","ENSGALG00000009360","3",17779866,17799623,19757
"4647","ENSGALG00000009361","4",20813724,20854195,40471
"4648","ENSGALG00000009364","9",19964981,19987896,22915
"4649","ENSGALG00000009365","2",22493952,22507735,13783
"4650","ENSGALG00000009366","4",20873531,20887179,13648
"4651","ENSGALG00000009368","5",26908701,27134788,226087
"4652","ENSGALG00000009369","6",30976326,30981760,5434
"4653","ENSGALG00000009372","9",19994295,20013955,19660
"4654","ENSGALG00000009373","4",20906538,20914132,7594
"4655","ENSGALG00000009378","4",21202944,21318742,115798
"4656","ENSGALG00000009379","9",20031453,20047148,15695
"4657","ENSGALG00000009381","5",27178967,27244842,65875
"4658","ENSGALG00000009382","3",17803816,17833090,29274
"4659","ENSGALG00000009387","5",27699720,27751679,51959
"4660","ENSGALG00000009388","3",17861903,17932443,70540
"4661","ENSGALG00000009392","3",17958137,17960722,2585
"4662","ENSGALG00000009395","4",21362248,21407298,45050
"4663","ENSGALG00000009399","2",22622554,22625627,3073
"4664","ENSGALG00000009400","5",27839047,27917728,78681
"4665","ENSGALG00000009402","9",20090319,20105368,15049
"4666","ENSGALG00000009403","6",30989133,31145085,155952
"4667","ENSGALG00000009405","4",21423255,21510819,87564
"4668","ENSGALG00000009409","9",20107407,20114295,6888
"4669","ENSGALG00000009410","2",22648851,22674871,26020
"4670","ENSGALG00000009413","3",18081222,18103577,22355
"4671","ENSGALG00000009415","5",27925918,28047170,121252
"4672","ENSGALG00000009421","5",28087093,28091730,4637
"4673","ENSGALG00000009422","6",31170655,31187619,16964
"4674","ENSGALG00000009424","1",26049718,26110344,60626
"4675","ENSGALG00000009426","3",18103016,18128618,25602
"4676","ENSGALG00000009427","6",31196449,31215975,19526
"4677","ENSGALG00000009428","5",28098839,28167889,69050
"4678","ENSGALG00000009429","4",21878289,21927832,49543
"4679","ENSGALG00000009431","5",28194527,28212226,17699
"4680","ENSGALG00000009433","6",31229092,31246998,17906
"4681","ENSGALG00000009435","1",26502865,26529724,26859
"4682","ENSGALG00000009438","5",28215545,28232960,17415
"4683","ENSGALG00000009439","1",26817562,26821855,4293
"4684","ENSGALG00000009440","1",26909371,26943265,33894
"4685","ENSGALG00000009441","3",18158312,18168470,10158
"4686","ENSGALG00000009442","4",21928800,21947001,18201
"4687","ENSGALG00000009443","1",26946875,26968412,21537
"4688","ENSGALG00000009445","6",31268250,31304876,36626
"4689","ENSGALG00000009446","1",27049177,27056263,7086
"4690","ENSGALG00000009448","1",27057994,27068635,10641
"4691","ENSGALG00000009450","3",18423363,18445768,22405
"4692","ENSGALG00000009451","4",21945224,21955824,10600
"4693","ENSGALG00000009452","5",28252274,28309388,57114
"4694","ENSGALG00000009453","3",18723065,18732704,9639
"4695","ENSGALG00000009454","1",27109323,27142306,32983
"4696","ENSGALG00000009455","6",31307241,31321417,14176
"4697","ENSGALG00000009456","5",28322687,28332169,9482
"4698","ENSGALG00000009457","3",18734608,18735012,404
"4699","ENSGALG00000009458","9",20477304,20626551,149247
"4700","ENSGALG00000009463","5",28339648,28406328,66680
"4701","ENSGALG00000009466","6",31321086,31337575,16489
"4702","ENSGALG00000009467","2",22674892,22680498,5606
"4703","ENSGALG00000009468","9",20664119,20716340,52221
"4704","ENSGALG00000009470","9",20725151,20764204,39053
"4705","ENSGALG00000009473","2",22678104,22683834,5730
"4706","ENSGALG00000009475","2",22684301,22700755,16454
"4707","ENSGALG00000009476","2",22703461,22836675,133214
"4708","ENSGALG00000009477","9",20764374,20776134,11760
"4709","ENSGALG00000009479","2",22911382,22916121,4739
"4710","ENSGALG00000009480","1",27163396,27407139,243743
"4711","ENSGALG00000009482","2",22928450,22947948,19498
"4712","ENSGALG00000009483","3",18746271,18800385,54114
"4713","ENSGALG00000009485","1",27428136,27876726,448590
"4714","ENSGALG00000009488","1",27616564,27618690,2126
"4715","ENSGALG00000009491","5",28602721,28945763,343042
"4716","ENSGALG00000009492","1",28562689,28571188,8499
"4717","ENSGALG00000009493","5",28959000,28968965,9965
"4718","ENSGALG00000009494","1",28571393,28579128,7735
"4719","ENSGALG00000009495","6",31834704,31906976,72272
"4720","ENSGALG00000009496","4",23323549,23339843,16294
"4721","ENSGALG00000009497","1",28630010,28633253,3243
"4722","ENSGALG00000009498","4",23376363,23380348,3985
"4723","ENSGALG00000009499","4",23356377,23396539,40162
"4724","ENSGALG00000009500","2",22944848,23062879,118031
"4725","ENSGALG00000009501","4",23415290,23432605,17315
"4726","ENSGALG00000009502","6",31972921,32042255,69334
"4727","ENSGALG00000009503","3",18846742,18887139,40397
"4728","ENSGALG00000009504","6",32042789,32050896,8107
"4729","ENSGALG00000009505","1",28651041,28685420,34379
"4730","ENSGALG00000009507","5",29011050,29062894,51844
"4731","ENSGALG00000009509","2",23060807,23197789,136982
"4732","ENSGALG00000009510","5",29068716,29074495,5779
"4733","ENSGALG00000009511","9",21316359,21355592,39233
"4734","ENSGALG00000009512","2",23301645,23311143,9498
"4735","ENSGALG00000009514","1",28704251,28843445,139194
"4736","ENSGALG00000009519","5",29074720,29091937,17217
"4737","ENSGALG00000009520","4",23437223,23636944,199721
"4738","ENSGALG00000009523","1",28882582,29120860,238278
"4739","ENSGALG00000009525","7",17895178,17914041,18863
"4740","ENSGALG00000009526","5",29091857,29099825,7968
"4741","ENSGALG00000009528","4",23756329,23808676,52347
"4742","ENSGALG00000009530","1",29166774,29412777,246003
"4743","ENSGALG00000009532","1",29589324,29620342,31018
"4744","ENSGALG00000009533","9",22123904,22133458,9554
"4745","ENSGALG00000009538","5",29100045,29107183,7138
"4746","ENSGALG00000009540","1",29633538,29660476,26938
"4747","ENSGALG00000009544","1",29690804,29702640,11836
"4748","ENSGALG00000009545","7",17886474,17959918,73444
"4749","ENSGALG00000009547","1",29702686,29770993,68307
"4750","ENSGALG00000009549","9",22276441,22299523,23082
"4751","ENSGALG00000009551","7",17962890,17987030,24140
"4752","ENSGALG00000009552","5",29151954,29157524,5570
"4753","ENSGALG00000009553","9",22313604,22345248,31644
"4754","ENSGALG00000009554","4",23814566,23878305,63739
"4755","ENSGALG00000009556","1",29774813,29833578,58765
"4756","ENSGALG00000009559","9",22347523,22391052,43529
"4757","ENSGALG00000009560","4",23878783,23885142,6359
"4758","ENSGALG00000009562","5",29157311,29169648,12337
"4759","ENSGALG00000009564","7",18041029,18067715,26686
"4760","ENSGALG00000009565","5",29170078,29180567,10489
"4761","ENSGALG00000009566","3",18886888,18911956,25068
"4762","ENSGALG00000009567","4",24072461,24205658,133197
"4763","ENSGALG00000009568","4",24520359,24685116,164757
"4764","ENSGALG00000009569","7",18072747,18156068,83321
"4765","ENSGALG00000009570","5",29180275,29311574,131299
"4766","ENSGALG00000009572","1",30046660,30129302,82642
"4767","ENSGALG00000009573","4",24927202,24945212,18010
"4768","ENSGALG00000009574","9",22414329,22416411,2082
"4769","ENSGALG00000009576","3",18892413,18922845,30432
"4770","ENSGALG00000009577","1",30181037,30190843,9806
"4771","ENSGALG00000009581","5",29189427,29237604,48177
"4772","ENSGALG00000009583","7",18170242,18183928,13686
"4773","ENSGALG00000009586","1",30191199,30202651,11452
"4774","ENSGALG00000009587","5",29263703,29530569,266866
"4775","ENSGALG00000009592","5",29682651,29686884,4233
"4776","ENSGALG00000009593","9",22562051,22572591,10540
"4777","ENSGALG00000009594","9",22591912,22599539,7627
"4778","ENSGALG00000009595","1",30203889,30222692,18803
"4779","ENSGALG00000009596","1",30234476,30430729,196253
"4780","ENSGALG00000009598","3",18926218,18963234,37016
"4781","ENSGALG00000009601","1",30463434,30606675,143241
"4782","ENSGALG00000009602","7",18273898,18440953,167055
"4783","ENSGALG00000009603","1",30651171,30655041,3870
"4784","ENSGALG00000009604","1",30661406,30681723,20317
"4785","ENSGALG00000009606","6",32367978,32382286,14308
"4786","ENSGALG00000009608","7",18479329,18537738,58409
"4787","ENSGALG00000009610","6",32384001,32386306,2305
"4788","ENSGALG00000009611","5",29687623,29720743,33120
"4789","ENSGALG00000009612","3",19449227,19512091,62864
"4790","ENSGALG00000009615","3",19522587,19548144,25557
"4791","ENSGALG00000009616","3",19747666,19838517,90851
"4792","ENSGALG00000009619","5",29722191,29753143,30952
"4793","ENSGALG00000009621","14",4573328,4577556,4228
"4794","ENSGALG00000009622","4",24946440,24954701,8261
"4795","ENSGALG00000009624","5",29759897,29830286,70389
"4796","ENSGALG00000009626","5",29833567,29849200,15633
"4797","ENSGALG00000009627","3",19838367,19941802,103435
"4798","ENSGALG00000009628","4",11383388,11412143,28755
"4799","ENSGALG00000009633","5",30227202,30242739,15537
"4800","ENSGALG00000009634","9",22602046,22620465,18419
"4801","ENSGALG00000009637","5",30254659,30261563,6904
"4802","ENSGALG00000009638","1",30720903,30787549,66646
"4803","ENSGALG00000009639","4",24959132,24997825,38693
"4804","ENSGALG00000009640","5",30281791,30329607,47816
"4805","ENSGALG00000009641","2",23572966,23610978,38012
"4806","ENSGALG00000009642","5",30287850,30373018,85168
"4807","ENSGALG00000009645","3",20068343,20429542,361199
"4808","ENSGALG00000009650","4",25017886,25199203,181317
"4809","ENSGALG00000009651","9",22606347,22610846,4499
"4810","ENSGALG00000009652","3",20458579,20827409,368830
"4811","ENSGALG00000009653","2",23622221,23646230,24009
"4812","ENSGALG00000009654","9",22621538,22635771,14233
"4813","ENSGALG00000009655","4",25220326,25235195,14869
"4814","ENSGALG00000009667","4",25273122,25277372,4250
"4815","ENSGALG00000009668","4",25322460,25332339,9879
"4816","ENSGALG00000009669","9",22645366,22758490,113124
"4817","ENSGALG00000009670","2",23650907,23677464,26557
"4818","ENSGALG00000009674","4",25336747,25380396,43649
"4819","ENSGALG00000009676","7",18572975,18577032,4057
"4820","ENSGALG00000009677","7",18575885,18584649,8764
"4821","ENSGALG00000009678","3",20828976,20854141,25165
"4822","ENSGALG00000009680","23",3399324,3403325,4001
"4823","ENSGALG00000009681","6",32458807,32470396,11589
"4824","ENSGALG00000009682","9",22884604,22895776,11172
"4825","ENSGALG00000009683","4",25395535,25437030,41495
"4826","ENSGALG00000009684","6",32678749,32691860,13111
"4827","ENSGALG00000009686","2",23715866,23846194,130328
"4828","ENSGALG00000009687","3",20934919,21040114,105195
"4829","ENSGALG00000009689","2",23853489,23867206,13717
"4830","ENSGALG00000009690","3",21085200,21149788,64588
"4831","ENSGALG00000009691","2",23882027,23890633,8606
"4832","ENSGALG00000009692","4",25454977,25526708,71731
"4833","ENSGALG00000009693","6",32715646,32724206,8560
"4834","ENSGALG00000009698","1",31057372,31082708,25336
"4835","ENSGALG00000009699","9",22923588,22935534,11946
"4836","ENSGALG00000009700","2",23905072,23914501,9429
"4837","ENSGALG00000009703","28",3266860,3270287,3427
"4838","ENSGALG00000009704","6",32816686,32859776,43090
"4839","ENSGALG00000009705","5",30373917,30541375,167458
"4840","ENSGALG00000009709","28",3258993,3265937,6944
"4841","ENSGALG00000009714","4",25542372,25549419,7047
"4842","ENSGALG00000009718","6",33084591,33085682,1091
"4843","ENSGALG00000009719","4",26882271,26914396,32125
"4844","ENSGALG00000009722","2",23942102,24123388,181286
"4845","ENSGALG00000009723","5",30598320,30751690,153370
"4846","ENSGALG00000009724","5",30776671,30777369,698
"4847","ENSGALG00000009725","5",30796985,30824895,27910
"4848","ENSGALG00000009728","2",24127768,24221691,93923
"4849","ENSGALG00000009730","1",31222996,31253936,30940
"4850","ENSGALG00000009731","5",30826454,30855767,29313
"4851","ENSGALG00000009732","4",28645569,28654982,9413
"4852","ENSGALG00000009733","2",24321442,24327977,6535
"4853","ENSGALG00000009737","2",24644607,24650874,6267
"4854","ENSGALG00000009738","6",33195329,33207599,12270
"4855","ENSGALG00000009739","1",31370366,31379889,9523
"4856","ENSGALG00000009740","5",30872492,30911992,39500
"4857","ENSGALG00000009743","1",31548265,31563241,14976
"4858","ENSGALG00000009744","5",30915854,30924514,8660
"4859","ENSGALG00000009747","1",31563284,31570534,7250
"4860","ENSGALG00000009748","2",24662430,24676154,13724
"4861","ENSGALG00000009752","2",24691867,24702573,10706
"4862","ENSGALG00000009755","1",31842742,31886512,43770
"4863","ENSGALG00000009758","4",28905344,28960060,54716
"4864","ENSGALG00000009759","1",32162492,32242011,79519
"4865","ENSGALG00000009774","4",29204108,29232394,28286
"4866","ENSGALG00000009782","4",29261966,29294001,32035
"4867","ENSGALG00000009784","3",21159219,21262585,103366
"4868","ENSGALG00000009787","6",34219436,34227592,8156
"4869","ENSGALG00000009788","3",21270194,21297310,27116
"4870","ENSGALG00000009790","4",29304171,29311186,7015
"4871","ENSGALG00000009791","3",21385127,21421817,36690
"4872","ENSGALG00000009792","4",29323991,29326742,2751
"4873","ENSGALG00000009795","1",33104538,33194925,90387
"4874","ENSGALG00000009796","3",21738841,21823981,85140
"4875","ENSGALG00000009800","4",29331534,29343728,12194
"4876","ENSGALG00000009801","5",31651198,31766696,115498
"4877","ENSGALG00000009802","3",21827667,21839929,12262
"4878","ENSGALG00000009803","4",29358225,29368088,9863
"4879","ENSGALG00000009805","1",33210895,33338738,127843
"4880","ENSGALG00000009807","3",21873328,21881217,7889
"4881","ENSGALG00000009809","4",29379320,29572109,192789
"4882","ENSGALG00000009811","3",21884702,21899753,15051
"4883","ENSGALG00000009813","4",29619101,29627656,8555
"4884","ENSGALG00000009814","3",21899749,21911625,11876
"4885","ENSGALG00000009815","1",33515304,33527383,12079
"4886","ENSGALG00000009817","5",32399175,32406806,7631
"4887","ENSGALG00000009821","3",22025576,22030009,4433
"4888","ENSGALG00000009822","3",21967276,22050431,83155
"4889","ENSGALG00000009823","6",34283421,34314120,30699
"4890","ENSGALG00000009825","1",33560543,33701007,140464
"4891","ENSGALG00000009826","4",29630213,29646811,16598
"4892","ENSGALG00000009828","3",22051036,22090451,39415
"4893","ENSGALG00000009830","4",29651474,29681776,30302
"4894","ENSGALG00000009835","1",33726767,33752020,25253
"4895","ENSGALG00000009836","4",29687612,29694605,6993
"4896","ENSGALG00000009837","3",22123438,22145700,22262
"4897","ENSGALG00000009838","5",32415013,32461731,46718
"4898","ENSGALG00000009839","7",18617871,18634233,16362
"4899","ENSGALG00000009840","1",33758984,33785156,26172
"4900","ENSGALG00000009841","7",18643643,18660105,16462
"4901","ENSGALG00000009842","1",33813098,33886822,73724
"4902","ENSGALG00000009843","3",22145670,22166335,20665
"4903","ENSGALG00000009844","5",32480478,32485436,4958
"4904","ENSGALG00000009845","5",32502596,32505180,2584
"4905","ENSGALG00000009846","7",18672192,18682785,10593
"4906","ENSGALG00000009847","5",32627667,32704945,77278
"4907","ENSGALG00000009848","3",22185167,22240475,55308
"4908","ENSGALG00000009850","5",33031679,33185933,154254
"4909","ENSGALG00000009854","3",22263928,22270603,6675
"4910","ENSGALG00000009855","4",29702447,29745516,43069
"4911","ENSGALG00000009856","1",33892987,33913536,20549
"4912","ENSGALG00000009858","3",22290234,22295308,5074
"4913","ENSGALG00000009859","1",33914416,33962286,47870
"4914","ENSGALG00000009861","3",22313882,22350044,36162
"4915","ENSGALG00000009864","3",22364629,22387324,22695
"4916","ENSGALG00000009865","4",29771882,29886214,114332
"4917","ENSGALG00000009868","4",29911254,29922369,11115
"4918","ENSGALG00000009870","4",29989429,30022148,32719
"4919","ENSGALG00000009871","3",22389980,22414051,24071
"4920","ENSGALG00000009873","1",34057985,34105026,47041
"4921","ENSGALG00000009875","1",34324330,34428910,104580
"4922","ENSGALG00000009877","3",22428235,22599162,170927
"4923","ENSGALG00000009879","1",34489776,34497789,8013
"4924","ENSGALG00000009880","4",30075344,30313807,238463
"4925","ENSGALG00000009881","3",22668052,22760407,92355
"4926","ENSGALG00000009884","3",22825936,22906255,80319
"4927","ENSGALG00000009885","1",34535707,34549257,13550
"4928","ENSGALG00000009886","4",30413937,30430300,16363
"4929","ENSGALG00000009887","3",22932307,22952244,19937
"4930","ENSGALG00000009890","3",22956893,22963144,6251
"4931","ENSGALG00000009895","1",34551571,34761125,209554
"4932","ENSGALG00000009896","3",22966378,23038588,72210
"4933","ENSGALG00000009898","4",30455566,30578444,122878
"4934","ENSGALG00000009900","5",34035437,34149368,113931
"4935","ENSGALG00000009901","1",35019110,35029782,10672
"4936","ENSGALG00000009902","8",19971912,19993915,22003
"4937","ENSGALG00000009903","1",35173604,35177772,4168
"4938","ENSGALG00000009904","1",35221629,35224087,2458
"4939","ENSGALG00000009905","1",35233248,35257392,24144
"4940","ENSGALG00000009906","3",23082392,23132592,50200
"4941","ENSGALG00000009907","5",34347159,34367234,20075
"4942","ENSGALG00000009909","3",23141809,23151326,9517
"4943","ENSGALG00000009911","3",23186938,23204981,18043
"4944","ENSGALG00000009913","4",30587498,30610590,23092
"4945","ENSGALG00000009915","3",23698626,23850581,151955
"4946","ENSGALG00000009916","5",34370977,34415640,44663
"4947","ENSGALG00000009919","3",24028612,24038420,9808
"4948","ENSGALG00000009920","5",34450679,34467653,16974
"4949","ENSGALG00000009925","3",24054773,24166383,111610
"4950","ENSGALG00000009926","3",24223735,24254972,31237
"4951","ENSGALG00000009927","1",35332501,35366120,33619
"4952","ENSGALG00000009929","27",5912684,5917218,4534
"4953","ENSGALG00000009932","3",25096501,25247758,151257
"4954","ENSGALG00000009934","1",35367839,35393184,25345
"4955","ENSGALG00000009935","27",5865127,5871629,6502
"4956","ENSGALG00000009936","5",34531603,34543262,11659
"4957","ENSGALG00000009939","27",5759636,5784661,25025
"4958","ENSGALG00000009940","1",35393882,35399422,5540
"4959","ENSGALG00000009942","1",35415393,35427159,11766
"4960","ENSGALG00000009943","27",5717774,5744311,26537
"4961","ENSGALG00000009944","27",5705152,5717075,11923
"4962","ENSGALG00000009945","1",35432767,35464430,31663
"4963","ENSGALG00000009946","5",34548447,34599123,50676
"4964","ENSGALG00000009947","3",25256109,25303550,47441
"4965","ENSGALG00000009948","4",30847852,30924570,76718
"4966","ENSGALG00000009954","3",25309379,25331245,21866
"4967","ENSGALG00000009955","3",25331747,25347053,15306
"4968","ENSGALG00000009957","8",20012281,20023311,11030
"4969","ENSGALG00000009958","3",25344295,25359387,15092
"4970","ENSGALG00000009959","1",35681991,35711338,29347
"4971","ENSGALG00000009961","4",31010883,31024926,14043
"4972","ENSGALG00000009963","1",35542896,35546583,3687
"4973","ENSGALG00000009965","8",20024802,20028925,4123
"4974","ENSGALG00000009966","1",35566490,35612114,45624
"4975","ENSGALG00000009967","3",25371305,25456660,85355
"4976","ENSGALG00000009968","4",31026953,31052941,25988
"4977","ENSGALG00000009971","8",20029182,20034557,5375
"4978","ENSGALG00000009973","3",25588912,25603301,14389
"4979","ENSGALG00000009974","4",31180282,31187602,7320
"4980","ENSGALG00000009975","1",35620953,35632931,11978
"4981","ENSGALG00000009977","4",31116058,31162776,46718
"4982","ENSGALG00000009978","5",34687317,34694681,7364
"4983","ENSGALG00000009981","3",25603481,25620190,16709
"4984","ENSGALG00000009982","4",31214218,31320627,106409
"4985","ENSGALG00000009983","5",34706211,34788651,82440
"4986","ENSGALG00000009985","4",31368147,31373643,5496
"4987","ENSGALG00000009988","8",20037114,20049506,12392
"4988","ENSGALG00000009990","3",26195862,26317142,121280
"4989","ENSGALG00000009992","5",34812372,34925880,113508
"4990","ENSGALG00000009993","8",20059234,20069284,10050
"4991","ENSGALG00000009995","5",34982476,35237118,254642
"4992","ENSGALG00000010000","3",26338154,26619224,281070
"4993","ENSGALG00000010001","5",35917400,35941789,24389
"4994","ENSGALG00000010005","3",26671415,26746226,74811
"4995","ENSGALG00000010006","4",31378289,31551743,173454
"4996","ENSGALG00000010007","5",36120283,36125843,5560
"4997","ENSGALG00000010009","4",31586087,31704957,118870
"4998","ENSGALG00000010010","3",26838815,26855054,16239
"4999","ENSGALG00000010013","4",31904342,31933857,29515
"5000","ENSGALG00000010014","3",26873800,26880135,6335
"5001","ENSGALG00000010016","3",26898348,26956262,57914
"5002","ENSGALG00000010017","3",27035389,27055369,19980
"5003","ENSGALG00000010018","1",35639105,35646809,7704
"5004","ENSGALG00000010019","4",31955443,31966000,10557
"5005","ENSGALG00000010020","3",27055515,27213152,157637
"5006","ENSGALG00000010022","4",31942105,31984326,42221
"5007","ENSGALG00000010023","3",27250948,27261822,10874
"5008","ENSGALG00000010025","5",36126018,36150075,24057
"5009","ENSGALG00000010026","3",27329669,27359503,29834
"5010","ENSGALG00000010027","5",36173425,36176185,2760
"5011","ENSGALG00000010029","1",35651357,35667845,16488
"5012","ENSGALG00000010030","5",36184806,36199758,14952
"5013","ENSGALG00000010031","4",31986664,32114649,127985
"5014","ENSGALG00000010032","3",27415048,27479318,64270
"5015","ENSGALG00000010034","5",36267163,36286597,19434
"5016","ENSGALG00000010035","4",32119492,32321153,201661
"5017","ENSGALG00000010036","3",27500695,27510879,10184
"5018","ENSGALG00000010039","3",27531575,27695285,163710
"5019","ENSGALG00000010042","1",35841859,35931514,89655
"5020","ENSGALG00000010043","3",27695074,27760628,65554
"5021","ENSGALG00000010044","1",35937978,35948946,10968
"5022","ENSGALG00000010046","5",36303273,36317971,14698
"5023","ENSGALG00000010047","3",27903237,27919436,16199
"5024","ENSGALG00000010048","3",27919747,27934487,14740
"5025","ENSGALG00000010049","1",35964985,36023189,58204
"5026","ENSGALG00000010050","3",28348991,28495437,146446
"5027","ENSGALG00000010051","3",28809406,28837732,28326
"5028","ENSGALG00000010052","5",36318746,36329700,10954
"5029","ENSGALG00000010053","8",20271073,20504572,233499
"5030","ENSGALG00000010055","3",28856440,29039975,183535
"5031","ENSGALG00000010057","3",29057896,29196236,138340
"5032","ENSGALG00000010060","5",36370614,36381285,10671
"5033","ENSGALG00000010061","4",32846926,33218988,372062
"5034","ENSGALG00000010068","3",29216511,29242017,25506
"5035","ENSGALG00000010073","21",6773167,6778804,5637
"5036","ENSGALG00000010074","8",20507881,20527431,19550
"5037","ENSGALG00000010077","4",33235392,33239654,4262
"5038","ENSGALG00000010078","3",29410438,29492850,82412
"5039","ENSGALG00000010079","21",6729868,6749872,20004
"5040","ENSGALG00000010081","4",33241407,33318356,76949
"5041","ENSGALG00000010083","8",20538514,20684008,145494
"5042","ENSGALG00000010084","21",6638309,6718151,79842
"5043","ENSGALG00000010087","8",20690981,20714758,23777
"5044","ENSGALG00000010088","5",36443890,36556577,112687
"5045","ENSGALG00000010089","8",20715240,20717622,2382
"5046","ENSGALG00000010090","4",33390140,33428724,38584
"5047","ENSGALG00000010091","8",20717728,20722672,4944
"5048","ENSGALG00000010093","5",36563104,36582077,18973
"5049","ENSGALG00000010094","8",20724855,20732722,7867
"5050","ENSGALG00000010096","5",36729897,36743180,13283
"5051","ENSGALG00000010097","4",33435516,33477552,42036
"5052","ENSGALG00000010098","8",20733964,20748606,14642
"5053","ENSGALG00000010103","4",33680239,33710874,30635
"5054","ENSGALG00000010104","8",20771222,20800963,29741
"5055","ENSGALG00000010106","8",20805578,20902813,97235
"5056","ENSGALG00000010108","4",34021280,34025895,4615
"5057","ENSGALG00000010109","8",21031854,21081679,49825
"5058","ENSGALG00000010110","8",21085109,21088405,3296
"5059","ENSGALG00000010114","5",36928525,36946793,18268
"5060","ENSGALG00000010116","3",29501011,29619293,118282
"5061","ENSGALG00000010117","5",36951399,37178495,227096
"5062","ENSGALG00000010118","5",37181549,37355992,174443
"5063","ENSGALG00000010119","4",34029543,34062799,33256
"5064","ENSGALG00000010120","8",21098307,21114361,16054
"5065","ENSGALG00000010122","4",34067371,34079449,12078
"5066","ENSGALG00000010124","8",21119710,21124237,4527
"5067","ENSGALG00000010125","4",34082296,34104242,21946
"5068","ENSGALG00000010127","3",29621182,29628094,6912
"5069","ENSGALG00000010129","8",21135671,21145202,9531
"5070","ENSGALG00000010130","4",34128059,34146657,18598
"5071","ENSGALG00000010131","3",29630380,29745172,114792
"5072","ENSGALG00000010133","8",21151297,21166349,15052
"5073","ENSGALG00000010136","4",34148243,34157856,9613
"5074","ENSGALG00000010137","5",37425147,37444767,19620
"5075","ENSGALG00000010139","5",37561121,37562401,1280
"5076","ENSGALG00000010140","8",21175780,21270007,94227
"5077","ENSGALG00000010145","3",30006735,30187312,180577
"5078","ENSGALG00000010147","Z",25695976,25715039,19063
"5079","ENSGALG00000010149","3",30280731,30303453,22722
"5080","ENSGALG00000010150","5",37773303,37799068,25765
"5081","ENSGALG00000010151","3",30269956,30278500,8544
"5082","ENSGALG00000010152","1",36249788,36266933,17145
"5083","ENSGALG00000010154","5",37800072,37808809,8737
"5084","ENSGALG00000010156","Z",25744347,25805121,60774
"5085","ENSGALG00000010157","5",37808853,37812677,3824
"5086","ENSGALG00000010158","Z",25835638,25933937,98299
"5087","ENSGALG00000010160","Z",25949442,26005324,55882
"5088","ENSGALG00000010161","Z",26009162,26016185,7023
"5089","ENSGALG00000010163","1",36352208,36436218,84010
"5090","ENSGALG00000010164","Z",26326425,26436050,109625
"5091","ENSGALG00000010165","3",30345790,30353990,8200
"5092","ENSGALG00000010166","Z",26557518,26572225,14707
"5093","ENSGALG00000010167","5",37813407,37823078,9671
"5094","ENSGALG00000010169","3",30360306,30367367,7061
"5095","ENSGALG00000010170","4",34286985,34293799,6814
"5096","ENSGALG00000010173","Z",26601232,26611454,10222
"5097","ENSGALG00000010174","3",30380945,30392920,11975
"5098","ENSGALG00000010175","3",30393097,30399049,5952
"5099","ENSGALG00000010177","1",36454512,36492133,37621
"5100","ENSGALG00000010178","Z",26628902,26654019,25117
"5101","ENSGALG00000010179","Z",26672598,26796711,124113
"5102","ENSGALG00000010180","Z",26853966,26967115,113149
"5103","ENSGALG00000010182","3",30399448,30404762,5314
"5104","ENSGALG00000010183","1",36551880,36564012,12132
"5105","ENSGALG00000010185","4",34300843,34323344,22501
"5106","ENSGALG00000010186","3",30442438,30454580,12142
"5107","ENSGALG00000010187","Z",27065681,27123343,57662
"5108","ENSGALG00000010189","5",37829239,37858026,28787
"5109","ENSGALG00000010190","1",36575097,36602208,27111
"5110","ENSGALG00000010192","5",37864102,37880025,15923
"5111","ENSGALG00000010193","5",37880445,37899754,19309
"5112","ENSGALG00000010195","4",34346569,34356307,9738
"5113","ENSGALG00000010196","5",37899536,37906784,7248
"5114","ENSGALG00000010197","5",37907101,37914653,7552
"5115","ENSGALG00000010198","1",36613330,36667621,54291
"5116","ENSGALG00000010199","4",34359295,34368819,9524
"5117","ENSGALG00000010200","1",36736396,36951463,215067
"5118","ENSGALG00000010201","4",34368754,34391463,22709
"5119","ENSGALG00000010202","5",37909770,37930631,20861
"5120","ENSGALG00000010203","8",21270375,21276714,6339
"5121","ENSGALG00000010204","1",37712525,37808043,95518
"5122","ENSGALG00000010207","4",34394077,34427189,33112
"5123","ENSGALG00000010208","1",37820647,37853581,32934
"5124","ENSGALG00000010209","4",34434678,34445343,10665
"5125","ENSGALG00000010211","5",37945091,37954593,9502
"5126","ENSGALG00000010214","4",34551821,34593192,41371
"5127","ENSGALG00000010217","8",21279840,21291575,11735
"5128","ENSGALG00000010218","9",22947045,22955401,8356
"5129","ENSGALG00000010219","8",21290142,21295998,5856
"5130","ENSGALG00000010221","8",21296800,21377920,81120
"5131","ENSGALG00000010222","1",37853568,37870874,17306
"5132","ENSGALG00000010223","1",37868999,37878734,9735
"5133","ENSGALG00000010224","1",37882246,37890696,8450
"5134","ENSGALG00000010225","5",38054597,38064479,9882
"5135","ENSGALG00000010226","8",21385883,21389966,4083
"5136","ENSGALG00000010227","1",37893908,37899384,5476
"5137","ENSGALG00000010228","8",21390437,21395389,4952
"5138","ENSGALG00000010229","5",38063993,38077282,13289
"5139","ENSGALG00000010230","8",21400454,21458320,57866
"5140","ENSGALG00000010232","5",38084164,38090330,6166
"5141","ENSGALG00000010233","5",38094760,38106584,11824
"5142","ENSGALG00000010234","8",21490165,21495843,5678
"5143","ENSGALG00000010237","5",38136479,38138708,2229
"5144","ENSGALG00000010238","1",38027576,38055929,28353
"5145","ENSGALG00000010243","8",21501345,21528251,26906
"5146","ENSGALG00000010244","8",21508992,21528082,19090
"5147","ENSGALG00000010246","1",38120515,38171779,51264
"5148","ENSGALG00000010253","1",38250500,38316500,66000
"5149","ENSGALG00000010255","8",21528403,21538668,10265
"5150","ENSGALG00000010256","9",23001767,23033870,32103
"5151","ENSGALG00000010258","5",38139299,38205852,66553
"5152","ENSGALG00000010259","2",24710268,24768511,58243
"5153","ENSGALG00000010268","4",34607222,34615681,8459
"5154","ENSGALG00000010269","9",23040155,23068606,28451
"5155","ENSGALG00000010270","5",38218529,38234041,15512
"5156","ENSGALG00000010273","4",34628096,34640529,12433
"5157","ENSGALG00000010275","5",38237596,38243180,5584
"5158","ENSGALG00000010276","8",21542371,21574425,32054
"5159","ENSGALG00000010279","8",21574984,21578092,3108
"5160","ENSGALG00000010282","3",30454982,30494217,39235
"5161","ENSGALG00000010283","4",34710681,34735934,25253
"5162","ENSGALG00000010284","9",23083565,23104817,21252
"5163","ENSGALG00000010285","3",30500634,30503469,2835
"5164","ENSGALG00000010286","5",38300357,38316875,16518
"5165","ENSGALG00000010287","8",21578677,21586117,7440
"5166","ENSGALG00000010288","3",30523259,30549878,26619
"5167","ENSGALG00000010290","3",30775054,30796571,21517
"5168","ENSGALG00000010291","4",34741804,34746119,4315
"5169","ENSGALG00000010293","8",21595383,21606407,11024
"5170","ENSGALG00000010294","5",38316979,38321286,4307
"5171","ENSGALG00000010296","3",30902464,30921774,19310
"5172","ENSGALG00000010298","4",34746467,34748287,1820
"5173","ENSGALG00000010299","3",30923219,30942843,19624
"5174","ENSGALG00000010301","5",38330614,38342339,11725
"5175","ENSGALG00000010302","9",23104838,23115100,10262
"5176","ENSGALG00000010303","3",30966869,30977586,10717
"5177","ENSGALG00000010304","5",38342950,38360994,18044
"5178","ENSGALG00000010307","5",38361141,38362156,1015
"5179","ENSGALG00000010309","5",38363416,38365723,2307
"5180","ENSGALG00000010311","1",38750910,39004044,253134
"5181","ENSGALG00000010312","9",23132124,23185052,52928
"5182","ENSGALG00000010313","8",21688967,21772686,83719
"5183","ENSGALG00000010314","5",38369408,38393355,23947
"5184","ENSGALG00000010315","3",30981415,30989558,8143
"5185","ENSGALG00000010316","4",34756078,34919149,163071
"5186","ENSGALG00000010317","3",30993386,31001851,8465
"5187","ENSGALG00000010318","5",38398130,38412344,14214
"5188","ENSGALG00000010320","1",39563363,39631576,68213
"5189","ENSGALG00000010322","5",38459491,38481098,21607
"5190","ENSGALG00000010323","5",38487611,38497586,9975
"5191","ENSGALG00000010324","4",34930600,34949275,18675
"5192","ENSGALG00000010325","1",39644313,39767984,123671
"5193","ENSGALG00000010326","5",38505542,38536670,31128
"5194","ENSGALG00000010331","9",23214990,23250380,35390
"5195","ENSGALG00000010333","4",34947965,34976929,28964
"5196","ENSGALG00000010334","3",109851221,109852186,965
"5197","ENSGALG00000010335","8",21786013,21811771,25758
"5198","ENSGALG00000010337","9",23314217,23335415,21198
"5199","ENSGALG00000010338","4",34985338,34986964,1626
"5200","ENSGALG00000010340","5",38539035,38658576,119541
"5201","ENSGALG00000010341","3",31002023,31029729,27706
"5202","ENSGALG00000010342","1",39845476,39934790,89314
"5203","ENSGALG00000010343","8",21841065,21844951,3886
"5204","ENSGALG00000010346","5",38669193,38684139,14946
"5205","ENSGALG00000010347","4",35013347,35018533,5186
"5206","ENSGALG00000010349","3",31030686,31034043,3357
"5207","ENSGALG00000010350","5",38769385,38799934,30549
"5208","ENSGALG00000010351","8",21849466,21864259,14793
"5209","ENSGALG00000010352","9",23361907,23405126,43219
"5210","ENSGALG00000010356","8",21923578,21941787,18209
"5211","ENSGALG00000010357","9",23519306,23520980,1674
"5212","ENSGALG00000010359","8",21942496,21951011,8515
"5213","ENSGALG00000010360","8",21953799,21957278,3479
"5214","ENSGALG00000010363","4",35047642,35091500,43858
"5215","ENSGALG00000010364","9",23596912,23603064,6152
"5216","ENSGALG00000010370","9",23652600,23746699,94099
"5217","ENSGALG00000010371","4",35094094,35205619,111525
"5218","ENSGALG00000010372","5",39066319,39104510,38191
"5219","ENSGALG00000010375","23",3371952,3373864,1912
"5220","ENSGALG00000010377","9",23696323,23697949,1626
"5221","ENSGALG00000010379","4",35370112,35436997,66885
"5222","ENSGALG00000010384","9",23749597,23753278,3681
"5223","ENSGALG00000010385","3",31054430,31068536,14106
"5224","ENSGALG00000010386","3",31101931,31106033,4102
"5225","ENSGALG00000010390","5",39278568,39286069,7501
"5226","ENSGALG00000010391","4",35458424,35500410,41986
"5227","ENSGALG00000010392","4",35628834,36177811,548977
"5228","ENSGALG00000010395","9",23766368,23771115,4747
"5229","ENSGALG00000010397","4",36748697,37032793,284096
"5230","ENSGALG00000010399","9",23785352,23791069,5717
"5231","ENSGALG00000010401","9",23791276,23804409,13133
"5232","ENSGALG00000010402","4",37170329,37196424,26095
"5233","ENSGALG00000010406","5",39336110,39347493,11383
"5234","ENSGALG00000010411","9",23911969,23940203,28234
"5235","ENSGALG00000010412","9",23950498,23990584,40086
"5236","ENSGALG00000010413","5",39347899,39351943,4044
"5237","ENSGALG00000010417","8",21968378,21979987,11609
"5238","ENSGALG00000010427","9",23998508,24002932,4424
"5239","ENSGALG00000010428","3",31161253,31177139,15886
"5240","ENSGALG00000010432","5",39387369,39397465,10096
"5241","ENSGALG00000010433","8",21981390,21991112,9722
"5242","ENSGALG00000010435","3",31182830,31220795,37965
"5243","ENSGALG00000010440","8",22150522,22174621,24099
"5244","ENSGALG00000010444","8",22198145,22206503,8358
"5245","ENSGALG00000010446","8",22209428,22221917,12489
"5246","ENSGALG00000010448","3",31248689,31430389,181700
"5247","ENSGALG00000010457","5",39416973,39422482,5509
"5248","ENSGALG00000010459","5",39428868,39440884,12016
"5249","ENSGALG00000010461","6",35112704,35230061,117357
"5250","ENSGALG00000010463","5",39441320,39446996,5676
"5251","ENSGALG00000010464","6",35270668,35292182,21514
"5252","ENSGALG00000010468","5",39455412,39460341,4929
"5253","ENSGALG00000010469","8",22236673,22243748,7075
"5254","ENSGALG00000010470","6",35538901,35604326,65425
"5255","ENSGALG00000010471","6",35730058,35756142,26084
"5256","ENSGALG00000010473","8",22247458,22251459,4001
"5257","ENSGALG00000010476","6",35758042,35762509,4467
"5258","ENSGALG00000010478","8",22273447,22290927,17480
"5259","ENSGALG00000010481","8",22291565,22304065,12500
"5260","ENSGALG00000010485","5",39551703,39564681,12978
"5261","ENSGALG00000010486","6",35793460,35816831,23371
"5262","ENSGALG00000010490","6",35825229,35837369,12140
"5263","ENSGALG00000010491","6",35920340,35936635,16295
"5264","ENSGALG00000010493","6",36003362,36214463,211101
"5265","ENSGALG00000010494","8",22961544,22982526,20982
"5266","ENSGALG00000010497","14",4479913,4485230,5317
"5267","ENSGALG00000010500","6",36216483,36218976,2493
"5268","ENSGALG00000010501","5",39567130,39584221,17091
"5269","ENSGALG00000010502","8",22977670,23027628,49958
"5270","ENSGALG00000010504","5",39583740,39664776,81036
"5271","ENSGALG00000010507","25",3769137,3773541,4404
"5272","ENSGALG00000010513","6",36241945,36247511,5566
"5273","ENSGALG00000010517","6",36263377,36276087,12710
"5274","ENSGALG00000010526","4",37701947,37707117,5170
"5275","ENSGALG00000010533","8",23901404,23976471,75067
"5276","ENSGALG00000010535","4",37977072,38007439,30367
"5277","ENSGALG00000010536","8",24156063,24295113,139050
"5278","ENSGALG00000010537","8",24299173,24303146,3973
"5279","ENSGALG00000010538","3",31481892,31584930,103038
"5280","ENSGALG00000010539","8",24334153,24360758,26605
"5281","ENSGALG00000010540","8",24366673,24408000,41327
"5282","ENSGALG00000010541","3",31609464,31785558,176094
"5283","ENSGALG00000010542","4",38039481,38075449,35968
"5284","ENSGALG00000010543","8",24411559,24454049,42490
"5285","ENSGALG00000010547","3",31786701,31801008,14307
"5286","ENSGALG00000010551","3",31890337,31916467,26130
"5287","ENSGALG00000010553","4",38396623,38427589,30966
"5288","ENSGALG00000010554","3",31979443,32020628,41185
"5289","ENSGALG00000010555","8",24471404,24524761,53357
"5290","ENSGALG00000010560","3",32108928,32127395,18467
"5291","ENSGALG00000010561","3",32119832,32134369,14537
"5292","ENSGALG00000010562","5",40872945,40962655,89710
"5293","ENSGALG00000010564","4",38427792,38520485,92693
"5294","ENSGALG00000010565","8",24525439,24548688,23249
"5295","ENSGALG00000010567","8",24549328,24596574,47246
"5296","ENSGALG00000010569","8",24602645,24611889,9244
"5297","ENSGALG00000010570","8",24612084,24622313,10229
"5298","ENSGALG00000010571","3",32136492,32187614,51122
"5299","ENSGALG00000010572","5",40973189,41020852,47663
"5300","ENSGALG00000010573","4",38607077,38673379,66302
"5301","ENSGALG00000010575","4",38673417,38690114,16697
"5302","ENSGALG00000010576","5",41030173,41056607,26434
"5303","ENSGALG00000010577","4",38695973,38730384,34411
"5304","ENSGALG00000010579","5",41075417,41130702,55285
"5305","ENSGALG00000010580","3",32190707,32247840,57133
"5306","ENSGALG00000010581","5",41149257,41176115,26858
"5307","ENSGALG00000010582","4",38738539,38774220,35681
"5308","ENSGALG00000010583","3",32259901,32302354,42453
"5309","ENSGALG00000010588","4",89727925,89729882,1957
"5310","ENSGALG00000010589","5",42391306,42393294,1988
"5311","ENSGALG00000010592","4",38804855,38872224,67369
"5312","ENSGALG00000010593","5",43061946,43109368,47422
"5313","ENSGALG00000010594","3",32364422,32389936,25514
"5314","ENSGALG00000010595","5",43100745,43106712,5967
"5315","ENSGALG00000010596","4",39167827,39202586,34759
"5316","ENSGALG00000010598","5",43170624,43224081,53457
"5317","ENSGALG00000010601","4",39244685,39256258,11573
"5318","ENSGALG00000010607","5",43240627,43275219,34592
"5319","ENSGALG00000010609","3",33634880,33642058,7178
"5320","ENSGALG00000010610","4",39265386,39318627,53241
"5321","ENSGALG00000010611","4",39326496,39354844,28348
"5322","ENSGALG00000010612","3",33641807,33686796,44989
"5323","ENSGALG00000010613","8",24654352,24694793,40441
"5324","ENSGALG00000010614","4",39355762,39358582,2820
"5325","ENSGALG00000010616","5",43288734,43321236,32502
"5326","ENSGALG00000010618","3",33708793,33721721,12928
"5327","ENSGALG00000010619","8",24697100,24727774,30674
"5328","ENSGALG00000010620","3",33727602,33759099,31497
"5329","ENSGALG00000010621","3",33762266,33766835,4569
"5330","ENSGALG00000010622","5",43328326,43349121,20795
"5331","ENSGALG00000010623","8",24728882,24744108,15226
"5332","ENSGALG00000010624","3",33771735,33798156,26421
"5333","ENSGALG00000010625","3",33837372,33858132,20760
"5334","ENSGALG00000010627","8",24744263,24748574,4311
"5335","ENSGALG00000010628","4",39432686,39469690,37004
"5336","ENSGALG00000010629","8",24751096,24784695,33599
"5337","ENSGALG00000010630","3",33876529,33929454,52925
"5338","ENSGALG00000010633","8",24796809,24805423,8614
"5339","ENSGALG00000010635","3",33929665,33952049,22384
"5340","ENSGALG00000010636","4",39481425,39497440,16015
"5341","ENSGALG00000010638","4",39494858,39510633,15775
"5342","ENSGALG00000010639","5",43357812,43451566,93754
"5343","ENSGALG00000010641","3",33951857,33961883,10026
"5344","ENSGALG00000010642","4",39520122,39561578,41456
"5345","ENSGALG00000010643","8",24858272,24878220,19948
"5346","ENSGALG00000010645","4",39577144,39603215,26071
"5347","ENSGALG00000010646","4",39615025,39740111,125086
"5348","ENSGALG00000010647","8",24881132,24886539,5407
"5349","ENSGALG00000010649","3",33983981,34007220,23239
"5350","ENSGALG00000010651","3",34033598,34041878,8280
"5351","ENSGALG00000010652","8",24886660,24898811,12151
"5352","ENSGALG00000010653","3",34048590,34412338,363748
"5353","ENSGALG00000010654","4",39750588,39775485,24897
"5354","ENSGALG00000010657","7",18684599,18690739,6140
"5355","ENSGALG00000010658","4",39775032,39783823,8791
"5356","ENSGALG00000010659","4",39817848,39827168,9320
"5357","ENSGALG00000010661","4",39828633,39831534,2901
"5358","ENSGALG00000010662","4",39875740,39878901,3161
"5359","ENSGALG00000010663","5",43464120,43500737,36617
"5360","ENSGALG00000010664","3",34279395,34717416,438021
"5361","ENSGALG00000010665","5",43597000,43779806,182806
"5362","ENSGALG00000010668","4",39881333,39966929,85596
"5363","ENSGALG00000010669","5",43876759,43912350,35591
"5364","ENSGALG00000010671","3",34777526,34790199,12673
"5365","ENSGALG00000010672","5",43917283,43969356,52073
"5366","ENSGALG00000010673","8",24940840,24983416,42576
"5367","ENSGALG00000010674","4",40002738,40022726,19988
"5368","ENSGALG00000010675","5",44001308,44009253,7945
"5369","ENSGALG00000010677","5",44011775,44036319,24544
"5370","ENSGALG00000010678","3",34820640,34835301,14661
"5371","ENSGALG00000010680","5",44183260,44303460,120200
"5372","ENSGALG00000010681","8",24984865,24991884,7019
"5373","ENSGALG00000010688","Z",43463336,43564075,100739
"5374","ENSGALG00000010689","8",25001724,25003801,2077
"5375","ENSGALG00000010691","3",34837317,34858844,21527
"5376","ENSGALG00000010692","8",25016404,25163464,147060
"5377","ENSGALG00000010694","Z",43565405,43596339,30934
"5378","ENSGALG00000010697","Z",43598380,43681200,82820
"5379","ENSGALG00000010699","2",24774072,24786862,12790
"5380","ENSGALG00000010700","2",24790712,24793994,3282
"5381","ENSGALG00000010702","3",34865405,34930518,65113
"5382","ENSGALG00000010703","5",44381604,44421927,40323
"5383","ENSGALG00000010705","3",34997069,35002178,5109
"5384","ENSGALG00000010707","5",44424073,44441557,17484
"5385","ENSGALG00000010708","2",24954107,25024569,70462
"5386","ENSGALG00000010711","2",25087512,25222398,134886
"5387","ENSGALG00000010713","3",35221764,35325431,103667
"5388","ENSGALG00000010716","4",42211864,42223799,11935
"5389","ENSGALG00000010718","2",26286162,26491943,205781
"5390","ENSGALG00000010719","4",42233732,42250523,16791
"5391","ENSGALG00000010721","8",25257022,25429515,172493
"5392","ENSGALG00000010722","2",26619867,26630325,10458
"5393","ENSGALG00000010733","3",35325057,35413252,88195
"5394","ENSGALG00000010734","5",44543394,44579829,36435
"5395","ENSGALG00000010736","8",25457804,25462021,4217
"5396","ENSGALG00000010737","3",35569976,35737294,167318
"5397","ENSGALG00000010738","5",44630721,44653557,22836
"5398","ENSGALG00000010740","8",25452541,25457119,4578
"5399","ENSGALG00000010741","3",35797770,35799577,1807
"5400","ENSGALG00000010743","8",25466486,25471907,5421
"5401","ENSGALG00000010744","4",43216401,43284221,67820
"5402","ENSGALG00000010745","4",43290527,43292715,2188
"5403","ENSGALG00000010746","8",25479823,25489409,9586
"5404","ENSGALG00000010747","5",44669751,44711483,41732
"5405","ENSGALG00000010748","3",35824198,35839291,15093
"5406","ENSGALG00000010749","8",25489529,25493551,4022
"5407","ENSGALG00000010752","8",25496702,25500343,3641
"5408","ENSGALG00000010758","8",25505665,25514791,9126
"5409","ENSGALG00000010760","3",35868590,35890278,21688
"5410","ENSGALG00000010761","8",25514723,25519546,4823
"5411","ENSGALG00000010762","3",35912417,35927799,15382
"5412","ENSGALG00000010763","5",44728801,44756472,27671
"5413","ENSGALG00000010764","4",43680194,43697009,16815
"5414","ENSGALG00000010766","5",44761932,44773968,12036
"5415","ENSGALG00000010768","3",35970274,35972202,1928
"5416","ENSGALG00000010769","4",43759687,43785536,25849
"5417","ENSGALG00000010770","2",26738333,26787906,49573
"5418","ENSGALG00000010774","8",25524304,25575125,50821
"5419","ENSGALG00000010778","3",36486653,36741396,254743
"5420","ENSGALG00000010781","4",43851693,43924374,72681
"5421","ENSGALG00000010783","5",44776755,44790265,13510
"5422","ENSGALG00000010785","8",25581818,25591828,10010
"5423","ENSGALG00000010789","8",25599268,25601076,1808
"5424","ENSGALG00000010792","2",27838091,28021352,183261
"5425","ENSGALG00000010793","5",44896394,44930765,34371
"5426","ENSGALG00000010794","2",28039372,28092164,52792
"5427","ENSGALG00000010795","2",28279818,28389303,109485
"5428","ENSGALG00000010798","8",25608221,25616427,8206
"5429","ENSGALG00000010801","8",25624594,25626958,2364
"5430","ENSGALG00000010803","2",28390438,28452815,62377
"5431","ENSGALG00000010804","2",28455013,28475977,20964
"5432","ENSGALG00000010805","8",25639131,25696695,57564
"5433","ENSGALG00000010806","5",44940027,44995746,55719
"5434","ENSGALG00000010809","2",28476110,28534287,58177
"5435","ENSGALG00000010811","5",45000454,45025305,24851
"5436","ENSGALG00000010812","3",37258840,37528009,269169
"5437","ENSGALG00000010813","5",45034325,45050422,16097
"5438","ENSGALG00000010818","8",26048187,26090895,42708
"5439","ENSGALG00000010820","5",45084388,45094601,10213
"5440","ENSGALG00000010822","4",44348398,44355142,6744
"5441","ENSGALG00000010825","2",28562930,28566950,4020
"5442","ENSGALG00000010826","8",26110379,26128996,18617
"5443","ENSGALG00000010835","5",17163204,17170118,6914
"5444","ENSGALG00000010836","2",28740786,28814243,73457
"5445","ENSGALG00000010837","4",44357317,44391275,33958
"5446","ENSGALG00000010839","4",44391491,44398887,7396
"5447","ENSGALG00000010840","2",28965435,29025740,60305
"5448","ENSGALG00000010842","5",45250582,45261925,11343
"5449","ENSGALG00000010843","3",37893859,37919523,25664
"5450","ENSGALG00000010847","4",44468359,44536888,68529
"5451","ENSGALG00000010850","8",26158855,26174657,15802
"5452","ENSGALG00000010853","8",26178921,26194902,15981
"5453","ENSGALG00000010854","2",29076224,29386193,309969
"5454","ENSGALG00000010855","4",44672480,44698800,26320
"5455","ENSGALG00000010857","8",26201306,26289893,88587
"5456","ENSGALG00000010858","7",18736749,18812213,75464
"5457","ENSGALG00000010859","4",44700356,44709072,8716
"5458","ENSGALG00000010861","8",26650130,26666710,16580
"5459","ENSGALG00000010863","2",29750694,29754175,3481
"5460","ENSGALG00000010864","4",44723699,44731614,7915
"5461","ENSGALG00000010865","2",29771902,29788849,16947
"5462","ENSGALG00000010866","4",44741719,44748186,6467
"5463","ENSGALG00000010867","8",26673217,26674144,927
"5464","ENSGALG00000010868","2",29901282,29932513,31231
"5465","ENSGALG00000010869","8",26680432,26692538,12106
"5466","ENSGALG00000010870","8",26714120,26715827,1707
"5467","ENSGALG00000010873","7",18858521,18883878,25357
"5468","ENSGALG00000010874","5",45340638,45435097,94459
"5469","ENSGALG00000010875","2",29980460,30030227,49767
"5470","ENSGALG00000010878","4",44783153,44809209,26056
"5471","ENSGALG00000010879","8",26692555,26971644,279089
"5472","ENSGALG00000010881","5",45556294,45580842,24548
"5473","ENSGALG00000010882","4",44809823,44833268,23445
"5474","ENSGALG00000010884","5",45612325,45626744,14419
"5475","ENSGALG00000010885","4",44872836,44933275,60439
"5476","ENSGALG00000010886","4",44937045,44941626,4581
"5477","ENSGALG00000010889","8",26991410,27014272,22862
"5478","ENSGALG00000010891","7",18864633,18912832,48199
"5479","ENSGALG00000010896","Z",60803931,60830335,26404
"5480","ENSGALG00000010899","7",18917107,18922496,5389
"5481","ENSGALG00000010900","7",18928191,18932697,4506
"5482","ENSGALG00000010901","2",30069508,30103222,33714
"5483","ENSGALG00000010902","7",18943431,19054038,110607
"5484","ENSGALG00000010903","4",45493922,45604213,110291
"5485","ENSGALG00000010909","4",45615049,45636930,21881
"5486","ENSGALG00000010915","2",30863310,30866004,2694
"5487","ENSGALG00000010921","4",45641817,45656379,14562
"5488","ENSGALG00000010924","8",27396999,27629040,232041
"5489","ENSGALG00000010925","2",30895603,30933262,37659
"5490","ENSGALG00000010926","4",45655850,45659023,3173
"5491","ENSGALG00000010927","4",45667318,45670752,3434
"5492","ENSGALG00000010928","4",45671455,45672224,769
"5493","ENSGALG00000010929","4",45682236,45695284,13048
"5494","ENSGALG00000010930","7",19085871,19169487,83616
"5495","ENSGALG00000010931","7",19190231,19191211,980
"5496","ENSGALG00000010932","4",45696109,45702330,6221
"5497","ENSGALG00000010934","8",27673703,27808047,134344
"5498","ENSGALG00000010935","1",39965497,40063282,97785
"5499","ENSGALG00000010936","1",40080215,40081940,1725
"5500","ENSGALG00000010938","2",30953027,30977707,24680
"5501","ENSGALG00000010939","1",40108427,40156885,48458
"5502","ENSGALG00000010940","1",40199693,40276809,77116
"5503","ENSGALG00000010942","2",30977907,30984334,6427
"5504","ENSGALG00000010943","7",19595814,19652432,56618
"5505","ENSGALG00000010949","2",31127614,31144995,17381
"5506","ENSGALG00000010950","5",45636526,45697900,61374
"5507","ENSGALG00000010953","8",27815241,27824970,9729
"5508","ENSGALG00000010954","2",31145533,31152182,6649
"5509","ENSGALG00000010956","7",19656327,19687107,30780
"5510","ENSGALG00000010957","8",27839632,27850114,10482
"5511","ENSGALG00000010958","1",40280597,40569224,288627
"5512","ENSGALG00000010960","7",19687128,19712618,25490
"5513","ENSGALG00000010961","2",31154360,31262400,108040
"5514","ENSGALG00000010963","4",45702438,45709564,7126
"5515","ENSGALG00000010967","8",27852461,27939873,87412
"5516","ENSGALG00000010969","5",45726288,45736369,10081
"5517","ENSGALG00000010971","7",19728602,19787165,58563
"5518","ENSGALG00000010973","2",31280845,31304603,23758
"5519","ENSGALG00000010974","5",45910321,45911817,1496
"5520","ENSGALG00000010975","1",40888158,41131936,243778
"5521","ENSGALG00000010976","2",31310308,31322677,12369
"5522","ENSGALG00000010977","2",31327774,31334403,6629
"5523","ENSGALG00000010978","8",27897264,27905006,7742
"5524","ENSGALG00000010979","4",45715041,45720203,5162
"5525","ENSGALG00000010980","2",31337816,31434231,96415
"5526","ENSGALG00000010983","2",31464055,31472130,8075
"5527","ENSGALG00000010985","8",27947422,27969461,22039
"5528","ENSGALG00000010986","3",38100145,38113286,13141
"5529","ENSGALG00000010988","2",31577867,31599648,21781
"5530","ENSGALG00000010991","8",28139885,28160353,20468
"5531","ENSGALG00000010992","1",41676490,41708448,31958
"5532","ENSGALG00000010995","8",28162365,28187331,24966
"5533","ENSGALG00000010997","2",31606777,31631552,24775
"5534","ENSGALG00000010998","8",28187203,28212014,24811
"5535","ENSGALG00000010999","5",46021692,46065300,43608
"5536","ENSGALG00000011000","3",38524569,38557190,32621
"5537","ENSGALG00000011003","3",38567265,38616829,49564
"5538","ENSGALG00000011005","3",38762090,38790863,28773
"5539","ENSGALG00000011007","2",31647411,31714056,66645
"5540","ENSGALG00000011008","3",38887936,38927053,39117
"5541","ENSGALG00000011009","7",19817502,19873003,55501
"5542","ENSGALG00000011013","3",38929612,39078262,148650
"5543","ENSGALG00000011016","8",28213176,28232260,19084
"5544","ENSGALG00000011017","4",45728695,45740095,11400
"5545","ENSGALG00000011019","8",28332890,28375114,42224
"5546","ENSGALG00000011020","2",31761476,31764714,3238
"5547","ENSGALG00000011021","2",31767642,31772416,4774
"5548","ENSGALG00000011022","2",31800647,31804213,3566
"5549","ENSGALG00000011024","8",28426867,28509563,82696
"5550","ENSGALG00000011031","8",28552333,28603383,51050
"5551","ENSGALG00000011035","8",28615900,28626590,10690
"5552","ENSGALG00000011036","2",32181657,32194928,13271
"5553","ENSGALG00000011038","2",32194366,32208181,13815
"5554","ENSGALG00000011040","7",19912518,19967580,55062
"5555","ENSGALG00000011041","8",28628003,28668296,40293
"5556","ENSGALG00000011046","2",32217070,32251177,34107
"5557","ENSGALG00000011047","8",28669447,28675292,5845
"5558","ENSGALG00000011052","7",20004119,20025892,21773
"5559","ENSGALG00000011058","8",28687054,28717255,30201
"5560","ENSGALG00000011065","3",39844405,39848234,3829
"5561","ENSGALG00000011068","7",20045523,20118965,73442
"5562","ENSGALG00000011069","7",20488320,20581516,93196
"5563","ENSGALG00000011076","5",46187929,46228922,40993
"5564","ENSGALG00000011078","4",45807324,45891224,83900
"5565","ENSGALG00000011079","5",46259416,46265888,6472
"5566","ENSGALG00000011080","5",46550123,46571687,21564
"5567","ENSGALG00000011084","3",40068687,40076967,8280
"5568","ENSGALG00000011086","3",40087452,40090517,3065
"5569","ENSGALG00000011088","5",46646127,46650779,4652
"5570","ENSGALG00000011091","3",40097108,40125127,28019
"5571","ENSGALG00000011093","5",46651390,46670540,19150
"5572","ENSGALG00000011094","8",28854640,28875786,21146
"5573","ENSGALG00000011096","3",40129566,40145393,15827
"5574","ENSGALG00000011098","3",40162308,40180002,17694
"5575","ENSGALG00000011099","7",21075293,21113292,37999
"5576","ENSGALG00000011101","3",40180105,40214133,34028
"5577","ENSGALG00000011104","7",21120995,21132163,11168
"5578","ENSGALG00000011106","3",40287180,40380983,93803
"5579","ENSGALG00000011109","4",45932534,46032124,99590
"5580","ENSGALG00000011111","3",40401196,40465340,64144
"5581","ENSGALG00000011113","8",28885345,28911667,26322
"5582","ENSGALG00000011114","3",40511303,40540413,29110
"5583","ENSGALG00000011116","5",46806027,46838896,32869
"5584","ENSGALG00000011117","3",40543177,40555076,11899
"5585","ENSGALG00000011118","8",28936620,28965800,29180
"5586","ENSGALG00000011121","8",28969156,28975854,6698
"5587","ENSGALG00000011124","4",46061676,46215503,153827
"5588","ENSGALG00000011128","7",21375858,21422146,46288
"5589","ENSGALG00000011130","4",46271533,46280009,8476
"5590","ENSGALG00000011131","7",21452859,21480464,27605
"5591","ENSGALG00000011132","7",21626535,21764185,137650
"5592","ENSGALG00000011133","4",46279854,46315572,35718
"5593","ENSGALG00000011136","3",40564709,40593020,28311
"5594","ENSGALG00000011138","5",48197831,48210529,12698
"5595","ENSGALG00000011139","5",48214228,48312719,98491
"5596","ENSGALG00000011141","7",21793549,21822090,28541
"5597","ENSGALG00000011145","2",33525854,33528127,2273
"5598","ENSGALG00000011149","7",21828489,21864267,35778
"5599","ENSGALG00000011153","7",21882268,21921613,39345
"5600","ENSGALG00000011155","3",40666273,40675811,9538
"5601","ENSGALG00000011162","5",48358544,48373872,15328
"5602","ENSGALG00000011164","2",33620223,33781928,161705
"5603","ENSGALG00000011166","5",48376335,48382152,5817
"5604","ENSGALG00000011168","1",42829927,42836694,6767
"5605","ENSGALG00000011169","3",40770761,40792143,21382
"5606","ENSGALG00000011170","2",33838517,33863336,24819
"5607","ENSGALG00000011171","3",40793364,40804578,11214
"5608","ENSGALG00000011172","7",21930914,21996451,65537
"5609","ENSGALG00000011174","3",40804438,40810410,5972
"5610","ENSGALG00000011175","4",46379729,46397571,17842
"5611","ENSGALG00000011176","2",33867648,33902516,34868
"5612","ENSGALG00000011177","1",42869836,42885028,15192
"5613","ENSGALG00000011178","4",46397282,46402835,5553
"5614","ENSGALG00000011180","3",40837462,40916045,78583
"5615","ENSGALG00000011181","2",33912328,33919576,7248
"5616","ENSGALG00000011182","3",40917808,40929676,11868
"5617","ENSGALG00000011184","4",46406249,46416007,9758
"5618","ENSGALG00000011185","2",33920266,33940447,20181
"5619","ENSGALG00000011186","3",41197504,41213936,16432
"5620","ENSGALG00000011189","3",41213958,41220324,6366
"5621","ENSGALG00000011190","4",46423727,46424857,1130
"5622","ENSGALG00000011192","3",41221513,41238416,16903
"5623","ENSGALG00000011193","3",41238384,41241039,2655
"5624","ENSGALG00000011200","3",41431874,41463697,31823
"5625","ENSGALG00000011202","2",33952599,33970922,18323
"5626","ENSGALG00000011203","4",46439548,46444745,5197
"5627","ENSGALG00000011205","3",41691462,41825582,134120
"5628","ENSGALG00000011206","1",43015486,43066975,51489
"5629","ENSGALG00000011207","1",43322569,43326909,4340
"5630","ENSGALG00000011208","4",46447365,46463696,16331
"5631","ENSGALG00000011209","5",48603440,48669491,66051
"5632","ENSGALG00000011210","4",46465724,46472824,7100
"5633","ENSGALG00000011211","2",33996462,34016729,20267
"5634","ENSGALG00000011213","5",48671881,48687922,16041
"5635","ENSGALG00000011214","1",196648341,196655118,6777
"5636","ENSGALG00000011216","2",34016956,34027642,10686
"5637","ENSGALG00000011219","18",9898955,9907499,8544
"5638","ENSGALG00000011220","5",48730241,48739091,8850
"5639","ENSGALG00000011221","4",46506402,46524029,17627
"5640","ENSGALG00000011222","8",28999313,29014127,14814
"5641","ENSGALG00000011224","7",22000489,22026477,25988
"5642","ENSGALG00000011225","5",48749877,48755650,5773
"5643","ENSGALG00000011226","2",34034015,34140082,106067
"5644","ENSGALG00000011227","4",46806174,46831897,25723
"5645","ENSGALG00000011228","5",48761498,48777907,16409
"5646","ENSGALG00000011229","8",29018004,29036076,18072
"5647","ENSGALG00000011235","2",34255021,34277260,22239
"5648","ENSGALG00000011236","5",48857109,49002559,145450
"5649","ENSGALG00000011237","2",34293909,34296747,2838
"5650","ENSGALG00000011238","8",29072809,29096474,23665
"5651","ENSGALG00000011239","2",34296808,34317152,20344
"5652","ENSGALG00000011241","2",34320041,34414155,94114
"5653","ENSGALG00000011242","7",22058182,22070812,12630
"5654","ENSGALG00000011243","2",34429595,34442888,13293
"5655","ENSGALG00000011244","5",49134545,49144769,10224
"5656","ENSGALG00000011248","2",34519722,34632243,112521
"5657","ENSGALG00000011250","7",22086695,22105857,19162
"5658","ENSGALG00000011251","2",34651269,34954644,303375
"5659","ENSGALG00000011252","7",22129021,22132591,3570
"5660","ENSGALG00000011254","2",35150112,35241163,91051
"5661","ENSGALG00000011255","8",29113515,29124276,10761
"5662","ENSGALG00000011259","8",29124295,29130623,6328
"5663","ENSGALG00000011262","2",35491690,35656661,164971
"5664","ENSGALG00000011266","4",46994913,47009784,14871
"5665","ENSGALG00000011267","2",35741014,35747472,6458
"5666","ENSGALG00000011269","1",43956041,43978617,22576
"5667","ENSGALG00000011270","1",44000044,44009051,9007
"5668","ENSGALG00000011271","1",44018283,44031180,12897
"5669","ENSGALG00000011272","2",35764554,35781496,16942
"5670","ENSGALG00000011274","1",44050178,44202174,151996
"5671","ENSGALG00000011275","8",29133310,29143643,10333
"5672","ENSGALG00000011276","1",44429339,44433309,3970
"5673","ENSGALG00000011277","1",44616111,44646792,30681
"5674","ENSGALG00000011278","2",35794568,35834790,40222
"5675","ENSGALG00000011280","1",44655033,44720507,65474
"5676","ENSGALG00000011281","2",35837240,35842547,5307
"5677","ENSGALG00000011283","2",36200600,36598490,397890
"5678","ENSGALG00000011284","8",29260098,29332676,72578
"5679","ENSGALG00000011285","1",44855280,44869564,14284
"5680","ENSGALG00000011286","2",37076403,37120914,44511
"5681","ENSGALG00000011287","3",41935664,41943728,8064
"5682","ENSGALG00000011288","3",41973928,41987008,13080
"5683","ENSGALG00000011289","2",37124668,37133561,8893
"5684","ENSGALG00000011290","2",37133710,37139279,5569
"5685","ENSGALG00000011291","2",37152397,37175363,22966
"5686","ENSGALG00000011293","1",44901269,44908500,7231
"5687","ENSGALG00000011294","2",37209656,37257267,47611
"5688","ENSGALG00000011296","3",42134063,42159856,25793
"5689","ENSGALG00000011297","1",44934717,45010543,75826
"5690","ENSGALG00000011298","2",37462364,37785654,323290
"5691","ENSGALG00000011299","3",42171065,42196994,25929
"5692","ENSGALG00000011300","2",37785630,37853554,67924
"5693","ENSGALG00000011301","8",29340044,29355899,15855
"5694","ENSGALG00000011304","2",37862138,37881702,19564
"5695","ENSGALG00000011305","8",29357735,29375787,18052
"5696","ENSGALG00000011306","7",22170600,22175002,4402
"5697","ENSGALG00000011309","1",45094960,45161493,66533
"5698","ENSGALG00000011312","2",37881673,37888175,6502
"5699","ENSGALG00000011314","2",38121822,38167107,45285
"5700","ENSGALG00000011318","7",22139888,22185035,45147
"5701","ENSGALG00000011319","4",47983446,48374220,390774
"5702","ENSGALG00000011320","1",45195312,45317916,122604
"5703","ENSGALG00000011322","2",38299506,38378275,78769
"5704","ENSGALG00000011323","1",45273005,45274433,1428
"5705","ENSGALG00000011324","7",22201254,22204320,3066
"5706","ENSGALG00000011325","1",45339203,45346941,7738
"5707","ENSGALG00000011326","7",22209846,22211975,2129
"5708","ENSGALG00000011327","1",45354985,45399450,44465
"5709","ENSGALG00000011328","7",22212056,22216253,4197
"5710","ENSGALG00000011329","3",42208745,42320506,111761
"5711","ENSGALG00000011330","5",49625615,49667887,42272
"5712","ENSGALG00000011331","8",29405130,29420571,15441
"5713","ENSGALG00000011332","7",22216454,22223656,7202
"5714","ENSGALG00000011335","7",22266262,22298170,31908
"5715","ENSGALG00000011340","8",29461007,29472794,11787
"5716","ENSGALG00000011341","3",42501436,42522334,20898
"5717","ENSGALG00000011342","1",45405227,45469802,64575
"5718","ENSGALG00000011343","7",22253721,22259709,5988
"5719","ENSGALG00000011347","7",22301636,22309634,7998
"5720","ENSGALG00000011349","7",22316359,22322097,5738
"5721","ENSGALG00000011350","8",29514747,29680796,166049
"5722","ENSGALG00000011353","8",29915375,29960430,45055
"5723","ENSGALG00000011354","7",22350254,22352592,2338
"5724","ENSGALG00000011355","7",22386125,22397621,11496
"5725","ENSGALG00000011356","8",29930523,29974805,44282
"5726","ENSGALG00000011357","1",45469720,45543803,74083
"5727","ENSGALG00000011358","7",22402840,22410862,8022
"5728","ENSGALG00000011360","7",22421786,22425915,4129
"5729","ENSGALG00000011361","8",29982323,29988079,5756
"5730","ENSGALG00000011365","5",49704532,49748151,43619
"5731","ENSGALG00000011366","5",49751116,49768128,17012
"5732","ENSGALG00000011368","5",49770765,49782167,11402
"5733","ENSGALG00000011369","8",30056346,30067892,11546
"5734","ENSGALG00000011372","5",49784823,49790219,5396
"5735","ENSGALG00000011373","5",49792778,49827946,35168
"5736","ENSGALG00000011375","7",22462035,22465723,3688
"5737","ENSGALG00000011376","5",49842461,49843339,878
"5738","ENSGALG00000011377","1",45566403,45581182,14779
"5739","ENSGALG00000011379","8",30055243,30137386,82143
"5740","ENSGALG00000011384","5",49878989,49956406,77417
"5741","ENSGALG00000011386","7",22467737,22473283,5546
"5742","ENSGALG00000011387","4",49178276,49197803,19527
"5743","ENSGALG00000011388","8",30140039,30151687,11648
"5744","ENSGALG00000011389","5",50027923,50071113,43190
"5745","ENSGALG00000011391","5",50083577,50100328,16751
"5746","ENSGALG00000011392","8",30152808,30177132,24324
"5747","ENSGALG00000011393","7",22473686,22482607,8921
"5748","ENSGALG00000011394","8",27041734,27057723,15989
"5749","ENSGALG00000011395","4",49230286,49237907,7621
"5750","ENSGALG00000011400","1",45585772,45597222,11450
"5751","ENSGALG00000011402","7",22491551,22503173,11622
"5752","ENSGALG00000011403","4",49243125,49258059,14934
"5753","ENSGALG00000011404","4",49268699,49271994,3295
"5754","ENSGALG00000011405","2",38388128,38516426,128298
"5755","ENSGALG00000011406","1",45630400,45665253,34853
"5756","ENSGALG00000011409","1",45696332,45697655,1323
"5757","ENSGALG00000011413","8",27059863,27073615,13752
"5758","ENSGALG00000011414","1",45700558,45708415,7857
"5759","ENSGALG00000011418","3",42572589,42580049,7460
"5760","ENSGALG00000011419","4",49367971,49372172,4201
"5761","ENSGALG00000011421","1",45710248,45722994,12746
"5762","ENSGALG00000011423","3",42596925,42617901,20976
"5763","ENSGALG00000011426","3",42624043,42646410,22367
"5764","ENSGALG00000011427","7",22503353,22530692,27339
"5765","ENSGALG00000011428","2",38775654,38800952,25298
"5766","ENSGALG00000011432","5",50105817,50190209,84392
"5767","ENSGALG00000011434","7",22547805,22552363,4558
"5768","ENSGALG00000011436","7",22559065,22564339,5274
"5769","ENSGALG00000011439","2",38854063,39545916,691853
"5770","ENSGALG00000011442","2",39748110,39810215,62105
"5771","ENSGALG00000011443","5",50298314,50318822,20508
"5772","ENSGALG00000011444","4",49486462,49505483,19021
"5773","ENSGALG00000011445","7",22565740,22573403,7663
"5774","ENSGALG00000011446","5",50330268,50347510,17242
"5775","ENSGALG00000011447","2",39825774,39907578,81804
"5776","ENSGALG00000011448","4",49511007,49520346,9339
"5777","ENSGALG00000011450","13",14271909,14274538,2629
"5778","ENSGALG00000011452","7",22569989,22587368,17379
"5779","ENSGALG00000011454","4",49616379,49618256,1877
"5780","ENSGALG00000011455","4",49624941,49625982,1041
"5781","ENSGALG00000011456","1",45821229,45909169,87940
"5782","ENSGALG00000011457","4",49640272,49655415,15143
"5783","ENSGALG00000011459","1",45938688,45955192,16504
"5784","ENSGALG00000011464","5",50410078,50417416,7338
"5785","ENSGALG00000011465","2",40078293,40127386,49093
"5786","ENSGALG00000011468","7",23232312,23248990,16678
"5787","ENSGALG00000011469","7",23255548,23307791,52243
"5788","ENSGALG00000011473","3",42691591,42928349,236758
"5789","ENSGALG00000011475","7",23330690,23372262,41572
"5790","ENSGALG00000011476","4",49658327,49708196,49869
"5791","ENSGALG00000011481","2",40263892,40286452,22560
"5792","ENSGALG00000011483","3",42945334,42953613,8279
"5793","ENSGALG00000011484","2",40304543,40340905,36362
"5794","ENSGALG00000011485","27",7676881,7677960,1079
"5795","ENSGALG00000011488","2",40345059,40372785,27726
"5796","ENSGALG00000011489","3",43047577,43055477,7900
"5797","ENSGALG00000011490","2",40384646,40393391,8745
"5798","ENSGALG00000011491","2",40398740,40421230,22490
"5799","ENSGALG00000011492","7",23496750,23539803,43053
"5800","ENSGALG00000011493","7",23551701,23559373,7672
"5801","ENSGALG00000011494","2",40442858,40472053,29195
"5802","ENSGALG00000011497","7",23565554,23577911,12357
"5803","ENSGALG00000011498","2",40558064,40579978,21914
"5804","ENSGALG00000011499","4",49916846,49938073,21227
"5805","ENSGALG00000011502","7",23616324,23620493,4169
"5806","ENSGALG00000011504","1",46668979,46691156,22177
"5807","ENSGALG00000011505","5",50439883,50500972,61089
"5808","ENSGALG00000011506","4",49938453,49950091,11638
"5809","ENSGALG00000011511","5",50513973,50524885,10912
"5810","ENSGALG00000011514","1",46695138,46703045,7907
"5811","ENSGALG00000011515","7",23626750,23643336,16586
"5812","ENSGALG00000011518","2",41055004,41087064,32060
"5813","ENSGALG00000011522","5",50525667,50547048,21381
"5814","ENSGALG00000011524","4",49948752,49966346,17594
"5815","ENSGALG00000011528","5",50621149,50662604,41455
"5816","ENSGALG00000011529","4",49974752,49982898,8146
"5817","ENSGALG00000011531","1",46718130,46743511,25381
"5818","ENSGALG00000011533","5",50665051,50674947,9896
"5819","ENSGALG00000011534","5",50675344,50685676,10332
"5820","ENSGALG00000011537","3",43276034,43439484,163450
"5821","ENSGALG00000011541","7",23682689,23766446,83757
"5822","ENSGALG00000011543","4",49984208,49998626,14418
"5823","ENSGALG00000011544","1",71628882,71641293,12411
"5824","ENSGALG00000011548","5",50687646,50750275,62629
"5825","ENSGALG00000011549","1",46756977,47167938,410961
"5826","ENSGALG00000011551","4",50012279,50018146,5867
"5827","ENSGALG00000011555","3",44210556,44347552,136996
"5828","ENSGALG00000011557","1",47185502,47238128,52626
"5829","ENSGALG00000011560","3",44391258,44584053,192795
"5830","ENSGALG00000011562","3",44583493,45261117,677624
"5831","ENSGALG00000011564","4",50027838,50078064,50226
"5832","ENSGALG00000011565","5",50786850,50808516,21666
"5833","ENSGALG00000011566","7",24024963,24051622,26659
"5834","ENSGALG00000011569","1",47252693,47283648,30955
"5835","ENSGALG00000011570","25",3345282,3351236,5954
"5836","ENSGALG00000011571","3",45283852,45353246,69394
"5837","ENSGALG00000011572","5",50822509,50872096,49587
"5838","ENSGALG00000011573","4",50089708,50124266,34558
"5839","ENSGALG00000011577","7",24417886,24674006,256120
"5840","ENSGALG00000011579","3",45580430,45588242,7812
"5841","ENSGALG00000011581","5",50931834,50997535,65701
"5842","ENSGALG00000011590","5",51598336,51605594,7258
"5843","ENSGALG00000011592","7",25228579,25265411,36832
"5844","ENSGALG00000011593","7",25292679,25297091,4412
"5845","ENSGALG00000011594","1",47342861,47375651,32790
"5846","ENSGALG00000011596","7",25353898,25421281,67383
"5847","ENSGALG00000011605","7",25427554,25471015,43461
"5848","ENSGALG00000011608","5",51691469,51709667,18198
"5849","ENSGALG00000011609","5",18899233,18904487,5254
"5850","ENSGALG00000011612","4",50399945,50405933,5988
"5851","ENSGALG00000011614","1",47510012,47607135,97123
"5852","ENSGALG00000011615","3",45562424,45573464,11040
"5853","ENSGALG00000011616","4",50415796,50429903,14107
"5854","ENSGALG00000011618","5",51739659,51762064,22405
"5855","ENSGALG00000011619","5",51773814,51775775,1961
"5856","ENSGALG00000011620","5",51789219,51852080,62861
"5857","ENSGALG00000011621","3",45589705,45644012,54307
"5858","ENSGALG00000011622","3",45656630,45657619,989
"5859","ENSGALG00000011623","4",50473922,50604585,130663
"5860","ENSGALG00000011624","3",45677747,45688264,10517
"5861","ENSGALG00000011625","3",45688651,45691597,2946
"5862","ENSGALG00000011626","4",50722658,50728122,5464
"5863","ENSGALG00000011630","7",25779538,25958144,178606
"5864","ENSGALG00000011633","1",47613048,47636250,23202
"5865","ENSGALG00000011635","7",26038309,26066954,28645
"5866","ENSGALG00000011637","3",45691777,45699620,7843
"5867","ENSGALG00000011639","5",51944497,51977507,33010
"5868","ENSGALG00000011642","4",50730426,50809631,79205
"5869","ENSGALG00000011643","1",47648410,47707994,59584
"5870","ENSGALG00000011645","7",26082412,26225483,143071
"5871","ENSGALG00000011646","5",51984130,51996689,12559
"5872","ENSGALG00000011649","7",22223830,22232143,8313
"5873","ENSGALG00000011650","7",26242390,26246801,4411
"5874","ENSGALG00000011651","1",47708080,47713676,5596
"5875","ENSGALG00000011652","7",26247147,26252585,5438
"5876","ENSGALG00000011655","7",26299421,26318288,18867
"5877","ENSGALG00000011657","7",26318406,26331755,13349
"5878","ENSGALG00000011659","3",45699532,45707626,8094
"5879","ENSGALG00000011660","3",45713103,45736034,22931
"5880","ENSGALG00000011661","3",45740686,45749159,8473
"5881","ENSGALG00000011662","1",47715092,47760419,45327
"5882","ENSGALG00000011663","3",45891575,45929214,37639
"5883","ENSGALG00000011664","4",50876758,50893943,17185
"5884","ENSGALG00000011668","4",50925077,50928369,3292
"5885","ENSGALG00000011671","7",26391057,26427532,36475
"5886","ENSGALG00000011677","7",26448702,26481703,33001
"5887","ENSGALG00000011680","4",51053219,51252071,198852
"5888","ENSGALG00000011681","5",7315554,7323897,8343
"5889","ENSGALG00000011682","1",47775838,47846899,71061
"5890","ENSGALG00000011683","4",51571156,51602821,31665
"5891","ENSGALG00000011684","4",51603053,51612923,9870
"5892","ENSGALG00000011685","5",7254514,7298111,43597
"5893","ENSGALG00000011686","7",26550205,26731077,180872
"5894","ENSGALG00000011687","5",52000607,52016763,16156
"5895","ENSGALG00000011688","5",7298109,7313840,15731
"5896","ENSGALG00000011689","7",26824064,26916163,92099
"5897","ENSGALG00000011690","5",52105547,52113558,8011
"5898","ENSGALG00000011692","5",52134885,52142967,8082
"5899","ENSGALG00000011695","5",7164776,7254371,89595
"5900","ENSGALG00000011696","5",52301377,52360978,59601
"5901","ENSGALG00000011697","7",26927568,26942616,15048
"5902","ENSGALG00000011704","7",27151313,27170993,19680
"5903","ENSGALG00000011705","5",52854754,53013815,159061
"5904","ENSGALG00000011708","7",27172896,27356465,183569
"5905","ENSGALG00000011715","5",53057972,53060373,2401
"5906","ENSGALG00000011717","1",47862544,47884993,22449
"5907","ENSGALG00000011718","5",53066586,53089159,22573
"5908","ENSGALG00000011721","5",53102807,53104597,1790
"5909","ENSGALG00000011722","1",47892850,47900521,7671
"5910","ENSGALG00000011724","1",47904971,47919971,15000
"5911","ENSGALG00000011727","1",47943095,47949063,5968
"5912","ENSGALG00000011734","2",42654209,42655342,1133
"5913","ENSGALG00000011735","2",42681277,42683185,1908
"5914","ENSGALG00000011738","1",47987082,47995411,8329
"5915","ENSGALG00000011740","1",48028649,48034022,5373
"5916","ENSGALG00000011742","1",48045860,48050453,4593
"5917","ENSGALG00000011743","1",48050698,48054209,3511
"5918","ENSGALG00000011744","7",27415443,27857542,442099
"5919","ENSGALG00000011745","1",48057324,48065843,8519
"5920","ENSGALG00000011747","1",48069616,48087052,17436
"5921","ENSGALG00000011762","4",51615757,51647742,31985
"5922","ENSGALG00000011770","7",27861069,27866904,5835
"5923","ENSGALG00000011783","1",48176543,48177285,742
"5924","ENSGALG00000011792","4",51707040,51717971,10931
"5925","ENSGALG00000011794","1",48200510,48209397,8887
"5926","ENSGALG00000011796","1",48226520,48227584,1064
"5927","ENSGALG00000011797","5",53109028,53146645,37617
"5928","ENSGALG00000011798","1",48243645,48250223,6578
"5929","ENSGALG00000011799","1",48252389,48259629,7240
"5930","ENSGALG00000011800","1",48265083,48286901,21818
"5931","ENSGALG00000011801","5",53184725,53226447,41722
"5932","ENSGALG00000011802","1",48286846,48299555,12709
"5933","ENSGALG00000011803","1",48327303,48341580,14277
"5934","ENSGALG00000011805","4",51771902,51779687,7785
"5935","ENSGALG00000011806","7",27920485,27939639,19154
"5936","ENSGALG00000011808","2",42730095,42731243,1148
"5937","ENSGALG00000011809","1",48468643,48670570,201927
"5938","ENSGALG00000011811","5",53231805,53388473,156668
"5939","ENSGALG00000011812","4",51795704,51797389,1685
"5940","ENSGALG00000011813","7",27951577,27971764,20187
"5941","ENSGALG00000011814","1",48844718,48898342,53624
"5942","ENSGALG00000011816","18",9745042,9754319,9277
"5943","ENSGALG00000011822","18",9750313,9758928,8615
"5944","ENSGALG00000011823","4",52507987,52651583,143596
"5945","ENSGALG00000011827","5",53460628,53469499,8871
"5946","ENSGALG00000011831","4",52779411,52910398,130987
"5947","ENSGALG00000011833","4",53381734,53566168,184434
"5948","ENSGALG00000011834","4",53561954,53577563,15609
"5949","ENSGALG00000011835","4",53577145,53603062,25917
"5950","ENSGALG00000011838","1",48945372,48990389,45017
"5951","ENSGALG00000011840","5",53496627,53562481,65854
"5952","ENSGALG00000011844","4",53679705,53684460,4755
"5953","ENSGALG00000011847","1",49002485,49047790,45305
"5954","ENSGALG00000011854","1",49060104,49108222,48118
"5955","ENSGALG00000011855","5",53596072,53640888,44816
"5956","ENSGALG00000011856","1",49117492,49118395,903
"5957","ENSGALG00000011858","5",53682353,53829994,147641
"5958","ENSGALG00000011859","1",49156263,49172880,16617
"5959","ENSGALG00000011861","5",54047342,54104268,56926
"5960","ENSGALG00000011863","1",49183470,49197405,13935
"5961","ENSGALG00000011865","15",10257189,10276666,19477
"5962","ENSGALG00000011866","1",49200767,49204422,3655
"5963","ENSGALG00000011867","1",49205227,49213282,8055
"5964","ENSGALG00000011868","5",54150986,54159510,8524
"5965","ENSGALG00000011870","5",54161509,54192262,30753
"5966","ENSGALG00000011872","1",49252184,49267900,15716
"5967","ENSGALG00000011875","4",53878897,53918091,39194
"5968","ENSGALG00000011878","1",49285282,49390517,105235
"5969","ENSGALG00000011880","4",53918279,53933298,15019
"5970","ENSGALG00000011881","4",53933630,53938773,5143
"5971","ENSGALG00000011884","4",53941065,53946536,5471
"5972","ENSGALG00000011885","4",53964699,53995130,30431
"5973","ENSGALG00000011889","5",54228533,54333650,105117
"5974","ENSGALG00000011893","5",54413895,54446537,32642
"5975","ENSGALG00000011894","1",49408394,49417609,9215
"5976","ENSGALG00000011897","1",49420739,49422753,2014
"5977","ENSGALG00000011898","1",49425024,49426989,1965
"5978","ENSGALG00000011900","1",49428093,49432399,4306
"5979","ENSGALG00000011902","24",5236175,5239380,3205
"5980","ENSGALG00000011904","5",54446630,54452056,5426
"5981","ENSGALG00000011908","1",49432937,49440746,7809
"5982","ENSGALG00000011910","5",54454364,54569488,115124
"5983","ENSGALG00000011913","1",49443024,49454058,11034
"5984","ENSGALG00000011914","1",49462031,49468047,6016
"5985","ENSGALG00000011917","5",54706446,54719162,12716
"5986","ENSGALG00000011918","1",49511857,49516278,4421
"5987","ENSGALG00000011921","5",54753623,54771346,17723
"5988","ENSGALG00000011922","5",54775094,54784642,9548
"5989","ENSGALG00000011930","1",76409969,76447113,37144
"5990","ENSGALG00000011931","1",49553680,49557259,3579
"5991","ENSGALG00000011932","1",49558421,49571511,13090
"5992","ENSGALG00000011937","27",6479452,6490273,10821
"5993","ENSGALG00000011947","1",49601065,49607425,6360
"5994","ENSGALG00000011950","1",49608449,49628904,20455
"5995","ENSGALG00000011953","1",49629138,49635168,6030
"5996","ENSGALG00000011957","1",49639915,49646711,6796
"5997","ENSGALG00000011958","1",49664266,49678899,14633
"5998","ENSGALG00000011961","4",54109012,54173032,64020
"5999","ENSGALG00000011962","4",54187801,54205828,18027
"6000","ENSGALG00000011963","4",54227745,54309687,81942
"6001","ENSGALG00000011965","1",49688865,49725642,36777
"6002","ENSGALG00000011966","1",49734327,49753467,19140
"6003","ENSGALG00000011967","4",54534509,54537977,3468
"6004","ENSGALG00000011970","1",49754389,49758184,3795
"6005","ENSGALG00000011974","4",54538589,54542357,3768
"6006","ENSGALG00000011976","1",49758949,49773616,14667
"6007","ENSGALG00000011982","4",54643508,54703347,59839
"6008","ENSGALG00000011986","4",54716739,54719703,2964
"6009","ENSGALG00000011990","4",54729233,54752851,23618
"6010","ENSGALG00000011991","4",54775901,54793119,17218
"6011","ENSGALG00000011992","1",49780325,49836356,56031
"6012","ENSGALG00000011993","1",49860867,49871899,11032
"6013","ENSGALG00000011994","4",54815201,54903904,88703
"6014","ENSGALG00000011998","4",54919270,54969961,50691
"6015","ENSGALG00000012000","4",54976336,54999992,23656
"6016","ENSGALG00000012003","1",49891065,49906124,15059
"6017","ENSGALG00000012004","4",55019083,55052946,33863
"6018","ENSGALG00000012005","5",54816596,54847803,31207
"6019","ENSGALG00000012006","5",54870149,54966041,95892
"6020","ENSGALG00000012007","1",49906355,49926196,19841
"6021","ENSGALG00000012009","5",54996558,55000810,4252
"6022","ENSGALG00000012010","4",55063378,55126784,63406
"6023","ENSGALG00000012011","5",55000990,55004165,3175
"6024","ENSGALG00000012013","1",49931494,49945608,14114
"6025","ENSGALG00000012015","4",56092083,56195330,103247
"6026","ENSGALG00000012017","5",55009316,55090253,80937
"6027","ENSGALG00000012018","4",56248208,56292940,44732
"6028","ENSGALG00000012020","5",7054297,7162808,108511
"6029","ENSGALG00000012021","5",55140639,55150916,10277
"6030","ENSGALG00000012023","5",55292899,55301585,8686
"6031","ENSGALG00000012024","1",49972914,50059631,86717
"6032","ENSGALG00000012025","5",55334072,55398498,64426
"6033","ENSGALG00000012030","5",5858774,5892293,33519
"6034","ENSGALG00000012032","5",5842994,5851053,8059
"6035","ENSGALG00000012033","1",50063873,50081111,17238
"6036","ENSGALG00000012034","1",50091088,50106774,15686
"6037","ENSGALG00000012037","5",55411958,55455908,43950
"6038","ENSGALG00000012039","5",55465942,55474524,8582
"6039","ENSGALG00000012041","5",55475250,55494935,19685
"6040","ENSGALG00000012044","4",56725180,57009349,284169
"6041","ENSGALG00000012045","7",27987357,28007534,20177
"6042","ENSGALG00000012048","4",57070604,57098235,27631
"6043","ENSGALG00000012049","7",28037739,28054010,16271
"6044","ENSGALG00000012050","1",50120269,50164133,43864
"6045","ENSGALG00000012052","7",28087994,28116724,28730
"6046","ENSGALG00000012055","7",28122092,28146591,24499
"6047","ENSGALG00000012056","1",50298523,50339266,40743
"6048","ENSGALG00000012059","7",28150921,28172550,21629
"6049","ENSGALG00000012061","7",28185901,28203831,17930
"6050","ENSGALG00000012067","7",28207851,28216993,9142
"6051","ENSGALG00000012068","4",57119098,57126545,7447
"6052","ENSGALG00000012072","7",28237978,28253588,15610
"6053","ENSGALG00000012074","4",57133859,57167350,33491
"6054","ENSGALG00000012075","7",28256073,28261454,5381
"6055","ENSGALG00000012076","4",57171233,57177054,5821
"6056","ENSGALG00000012080","2",46175212,46178881,3669
"6057","ENSGALG00000012082","7",28267680,28275742,8062
"6058","ENSGALG00000012085","5",55486193,55490014,3821
"6059","ENSGALG00000012087","7",28275428,28285479,10051
"6060","ENSGALG00000012089","5",55503452,55514773,11321
"6061","ENSGALG00000012092","7",28286840,28313799,26959
"6062","ENSGALG00000012094","5",55581694,55687960,106266
"6063","ENSGALG00000012095","5",55690420,55695393,4973
"6064","ENSGALG00000012098","5",55710414,55728263,17849
"6065","ENSGALG00000012100","7",28330072,28344049,13977
"6066","ENSGALG00000012101","5",55759095,55769932,10837
"6067","ENSGALG00000012103","5",5779258,5836920,57662
"6068","ENSGALG00000012105","5",55769003,55795784,26781
"6069","ENSGALG00000012106","7",28353282,28366950,13668
"6070","ENSGALG00000012109","5",5765071,5800938,35867
"6071","ENSGALG00000012111","7",28370913,28374010,3097
"6072","ENSGALG00000012112","7",28381630,28385331,3701
"6073","ENSGALG00000012113","7",28385668,28397361,11693
"6074","ENSGALG00000012115","5",5683522,5714265,30743
"6075","ENSGALG00000012117","7",28404445,28422283,17838
"6076","ENSGALG00000012118","5",56071886,56100318,28432
"6077","ENSGALG00000012119","7",28482051,28491954,9903
"6078","ENSGALG00000012121","5",5568465,5575654,7189
"6079","ENSGALG00000012123","5",5444151,5461448,17297
"6080","ENSGALG00000012124","5",56146220,56210990,64770
"6081","ENSGALG00000012126","4",58121540,58134365,12825
"6082","ENSGALG00000012127","5",5303921,5477496,173575
"6083","ENSGALG00000012128","5",5244787,5304228,59441
"6084","ENSGALG00000012129","7",28878074,28910403,32329
"6085","ENSGALG00000012130","5",5240137,5272446,32309
"6086","ENSGALG00000012135","1",50599346,50602300,2954
"6087","ENSGALG00000012136","5",4822409,4942957,120548
"6088","ENSGALG00000012137","5",56284033,56354355,70322
"6089","ENSGALG00000012139","5",4803099,4810319,7220
"6090","ENSGALG00000012142","5",4730016,4734458,4442
"6091","ENSGALG00000012144","1",50613511,50619573,6062
"6092","ENSGALG00000012145","5",56361766,56369688,7922
"6093","ENSGALG00000012147","7",28923545,28931240,7695
"6094","ENSGALG00000012148","5",56371803,56387589,15786
"6095","ENSGALG00000012150","1",50660193,50668685,8492
"6096","ENSGALG00000012153","5",4143648,4250171,106523
"6097","ENSGALG00000012155","4",58021967,58080491,58524
"6098","ENSGALG00000012156","7",29190336,29372124,181788
"6099","ENSGALG00000012159","7",29611431,29637868,26437
"6100","ENSGALG00000012160","5",4100525,4143339,42814
"6101","ENSGALG00000012163","5",3979544,4011508,31964
"6102","ENSGALG00000012165","5",56433608,56454798,21190
"6103","ENSGALG00000012166","7",29649127,29673686,24559
"6104","ENSGALG00000012170","5",3937292,3949809,12517
"6105","ENSGALG00000012171","7",29705706,29769983,64277
"6106","ENSGALG00000012172","1",50691560,50697388,5828
"6107","ENSGALG00000012173","5",56457111,56460218,3107
"6108","ENSGALG00000012177","7",29785117,30106820,321703
"6109","ENSGALG00000012178","1",50720146,50737226,17080
"6110","ENSGALG00000012179","5",56487610,56496095,8485
"6111","ENSGALG00000012181","4",58101330,58112441,11111
"6112","ENSGALG00000012185","4",58136113,58139510,3397
"6113","ENSGALG00000012186","4",58145236,58153306,8070
"6114","ENSGALG00000012187","7",30239783,30329855,90072
"6115","ENSGALG00000012190","7",30340176,30422024,81848
"6116","ENSGALG00000012194","5",3848102,3868453,20351
"6117","ENSGALG00000012196","4",58154371,58188683,34312
"6118","ENSGALG00000012197","7",30420994,30458182,37188
"6119","ENSGALG00000012199","5",56496547,56526788,30241
"6120","ENSGALG00000012200","5",56530534,56547633,17099
"6121","ENSGALG00000012206","5",56630914,56641644,10730
"6122","ENSGALG00000012207","7",30476368,30482109,5741
"6123","ENSGALG00000012208","5",56643329,56649751,6422
"6124","ENSGALG00000012211","4",58197414,58313786,116372
"6125","ENSGALG00000012214","7",30501294,30520598,19304
"6126","ENSGALG00000012216","4",58350823,58586570,235747
"6127","ENSGALG00000012218","1",50847151,50849565,2414
"6128","ENSGALG00000012219","4",58597982,58837212,239230
"6129","ENSGALG00000012220","5",56665337,56672072,6735
"6130","ENSGALG00000012222","4",59688409,59777549,89140
"6131","ENSGALG00000012223","7",30533313,30553147,19834
"6132","ENSGALG00000012227","4",59785679,59862479,76800
"6133","ENSGALG00000012228","5",56940987,57248827,307840
"6134","ENSGALG00000012229","5",57737586,57738431,845
"6135","ENSGALG00000012230","5",57738424,57745588,7164
"6136","ENSGALG00000012232","5",57748683,57761672,12989
"6137","ENSGALG00000012236","1",50865020,50876251,11231
"6138","ENSGALG00000012237","5",57760627,57779793,19166
"6139","ENSGALG00000012239","4",59919382,59943366,23984
"6140","ENSGALG00000012241","5",57783095,57811038,27943
"6141","ENSGALG00000012244","5",57810249,57822314,12065
"6142","ENSGALG00000012245","4",59946344,59954096,7752
"6143","ENSGALG00000012246","7",30584704,30627356,42652
"6144","ENSGALG00000012254","1",50905908,50917205,11297
"6145","ENSGALG00000012256","3",46032734,46380904,348170
"6146","ENSGALG00000012259","7",30632908,30646566,13658
"6147","ENSGALG00000012260","7",30647554,30663466,15912
"6148","ENSGALG00000012263","5",57822583,57844116,21533
"6149","ENSGALG00000012264","4",60015008,60024687,9679
"6150","ENSGALG00000012265","1",51075320,51093611,18291
"6151","ENSGALG00000012269","5",57863106,57866374,3268
"6152","ENSGALG00000012272","1",50950320,50975712,25392
"6153","ENSGALG00000012273","5",57869306,57917081,47775
"6154","ENSGALG00000012275","3",46588323,46628360,40037
"6155","ENSGALG00000012277","1",50976162,50979138,2976
"6156","ENSGALG00000012281","1",50979471,50998677,19206
"6157","ENSGALG00000012282","5",57917717,57934479,16762
"6158","ENSGALG00000012285","1",50999516,51007562,8046
"6159","ENSGALG00000012287","5",57934496,57941300,6804
"6160","ENSGALG00000012289","3",46689545,46735983,46438
"6161","ENSGALG00000012290","1",51055215,51064410,9195
"6162","ENSGALG00000012291","1",51067332,51070945,3613
"6163","ENSGALG00000012292","4",60568176,60699388,131212
"6164","ENSGALG00000012293","1",51071012,51075308,4296
"6165","ENSGALG00000012295","5",57938576,57947538,8962
"6166","ENSGALG00000012296","1",51097092,51106741,9649
"6167","ENSGALG00000012297","3",46755894,46932292,176398
"6168","ENSGALG00000012298","4",60731764,60752199,20435
"6169","ENSGALG00000012299","1",51089196,51112478,23282
"6170","ENSGALG00000012300","3",46971121,46990282,19161
"6171","ENSGALG00000012304","4",60786295,60843850,57555
"6172","ENSGALG00000012307","1",51117014,51118848,1834
"6173","ENSGALG00000012308","4",60851437,60898854,47417
"6174","ENSGALG00000012311","4",60910770,60932855,22085
"6175","ENSGALG00000012312","1",51123081,51128130,5049
"6176","ENSGALG00000012317","3",47042192,47073545,31353
"6177","ENSGALG00000012319","4",60955253,60970704,15451
"6178","ENSGALG00000012321","5",57950810,58008557,57747
"6179","ENSGALG00000012322","13",18270817,18306102,35285
"6180","ENSGALG00000012336","3",47205516,47305776,100260
"6181","ENSGALG00000012338","4",60973338,60987632,14294
"6182","ENSGALG00000012339","5",58016047,58042735,26688
"6183","ENSGALG00000012341","5",58041981,58053138,11157
"6184","ENSGALG00000012342","3",47726722,47866699,139977
"6185","ENSGALG00000012345","3",47909859,48062234,152375
"6186","ENSGALG00000012348","7",30665923,30679252,13329
"6187","ENSGALG00000012350","Z",71017085,71057636,40551
"6188","ENSGALG00000012355","7",30683175,30721164,37989
"6189","ENSGALG00000012356","3",48169255,48188056,18801
"6190","ENSGALG00000012357","7",30761616,30764299,2683
"6191","ENSGALG00000012361","5",58056876,58107170,50294
"6192","ENSGALG00000012362","7",30959190,31199600,240410
"6193","ENSGALG00000012364","3",48219988,48239861,19873
"6194","ENSGALG00000012365","5",58114673,58123645,8972
"6195","ENSGALG00000012367","5",58124994,58156481,31487
"6196","ENSGALG00000012370","3",48242278,48258995,16717
"6197","ENSGALG00000012374","5",58189492,58216673,27181
"6198","ENSGALG00000012377","7",31246874,31261994,15120
"6199","ENSGALG00000012378","3",48262834,48281305,18471
"6200","ENSGALG00000012379","5",58235042,58247858,12816
"6201","ENSGALG00000012380","7",31376946,31407737,30791
"6202","ENSGALG00000012382","7",31584693,31720416,135723
"6203","ENSGALG00000012386","3",48286539,48303618,17079
"6204","ENSGALG00000012387","3",48305929,48314982,9053
"6205","ENSGALG00000012388","3",48319824,48353937,34113
"6206","ENSGALG00000012392","3",48530510,48546549,16039
"6207","ENSGALG00000012394","5",58251114,58259992,8878
"6208","ENSGALG00000012395","3",48624389,48741485,117096
"6209","ENSGALG00000012396","5",58273131,58276100,2969
"6210","ENSGALG00000012401","5",58333186,58347293,14107
"6211","ENSGALG00000012404","5",58350545,58368109,17564
"6212","ENSGALG00000012407","7",31850143,32428239,578096
"6213","ENSGALG00000012408","5",58368967,58380737,11770
"6214","ENSGALG00000012410","1",51151276,51155431,4155
"6215","ENSGALG00000012412","3",48743410,48879114,135704
"6216","ENSGALG00000012414","5",58397792,58403918,6126
"6217","ENSGALG00000012416","1",51155529,51162122,6593
"6218","ENSGALG00000012418","7",32639735,32697227,57492
"6219","ENSGALG00000012419","1",51162834,51165452,2618
"6220","ENSGALG00000012420","1",51166508,51169768,3260
"6221","ENSGALG00000012421","7",32698930,33027332,328402
"6222","ENSGALG00000012422","1",51186462,51193519,7057
"6223","ENSGALG00000012424","7",33114173,33278345,164172
"6224","ENSGALG00000012425","5",58413781,58449844,36063
"6225","ENSGALG00000012426","5",58463837,58525746,61909
"6226","ENSGALG00000012429","5",58714564,58717395,2831
"6227","ENSGALG00000012442","1",51255614,51276612,20998
"6228","ENSGALG00000012444","7",34497511,34552031,54520
"6229","ENSGALG00000012446","1",51333318,51335744,2426
"6230","ENSGALG00000012448","7",34556631,34570319,13688
"6231","ENSGALG00000012449","7",34657822,34697019,39197
"6232","ENSGALG00000012452","5",58865655,58882817,17162
"6233","ENSGALG00000012453","7",34721338,34761957,40619
"6234","ENSGALG00000012454","1",51385635,51405059,19424
"6235","ENSGALG00000012456","1",51413962,51423737,9775
"6236","ENSGALG00000012457","1",51425940,51431518,5578
"6237","ENSGALG00000012462","7",34771501,34839047,67546
"6238","ENSGALG00000012464","5",58929202,58939830,10628
"6239","ENSGALG00000012466","5",58942972,58948799,5827
"6240","ENSGALG00000012468","5",58950139,58968358,18219
"6241","ENSGALG00000012470","7",34907319,34912403,5084
"6242","ENSGALG00000012472","1",51457537,51470895,13358
"6243","ENSGALG00000012473","7",34920849,34933480,12631
"6244","ENSGALG00000012480","7",35101444,35110812,9368
"6245","ENSGALG00000012481","7",35127799,35141587,13788
"6246","ENSGALG00000012483","1",51474615,51491816,17201
"6247","ENSGALG00000012484","7",35143826,35170393,26567
"6248","ENSGALG00000012488","1",51511486,51518776,7290
"6249","ENSGALG00000012489","5",59000367,59011185,10818
"6250","ENSGALG00000012490","1",51519368,51524961,5593
"6251","ENSGALG00000012505","5",59650477,59690594,40117
"6252","ENSGALG00000012513","7",35401143,35426412,25269
"6253","ENSGALG00000012522","1",51608164,51618692,10528
"6254","ENSGALG00000012525","7",35441647,35546372,104725
"6255","ENSGALG00000012526","7",35550399,35568418,18019
"6256","ENSGALG00000012529","1",51709011,51716385,7374
"6257","ENSGALG00000012530","1",51716683,51725962,9279
"6258","ENSGALG00000012532","1",51727168,51734903,7735
"6259","ENSGALG00000012536","7",35658764,35725602,66838
"6260","ENSGALG00000012537","7",35735910,35765494,29584
"6261","ENSGALG00000012538","7",36032926,36038300,5374
"6262","ENSGALG00000012540","1",51917777,51989848,72071
"6263","ENSGALG00000012541","1",52004040,52007757,3717
"6264","ENSGALG00000012542","1",52034440,52042836,8396
"6265","ENSGALG00000012543","7",36056082,36108269,52187
"6266","ENSGALG00000012544","7",36204915,36208072,3157
"6267","ENSGALG00000012545","7",36217989,36226734,8745
"6268","ENSGALG00000012546","1",52093781,52114911,21130
"6269","ENSGALG00000012550","1",52103308,52109433,6125
"6270","ENSGALG00000012552","1",52116279,52137392,21113
"6271","ENSGALG00000012555","7",36314871,36353560,38689
"6272","ENSGALG00000012559","1",52678868,52954337,275469
"6273","ENSGALG00000012561","7",36368611,36435156,66545
"6274","ENSGALG00000012569","1",53227761,53241371,13610
"6275","ENSGALG00000012570","7",36480800,36530667,49867
"6276","ENSGALG00000012574","7",36526008,36550929,24921
"6277","ENSGALG00000012575","Z",39183808,39265774,81966
"6278","ENSGALG00000012576","Z",39728943,39767984,39041
"6279","ENSGALG00000012577","Z",39821677,39963817,142140
"6280","ENSGALG00000012579","7",36554034,36661657,107623
"6281","ENSGALG00000012583","Z",39979314,39991612,12298
"6282","ENSGALG00000012584","7",36683241,36708553,25312
"6283","ENSGALG00000012585","Z",39993578,40023005,29427
"6284","ENSGALG00000012586","Z",40025493,40048181,22688
"6285","ENSGALG00000012587","7",36710535,36713993,3458
"6286","ENSGALG00000012588","Z",40053080,40077364,24284
"6287","ENSGALG00000012589","Z",40079073,40087531,8458
"6288","ENSGALG00000012591","Z",40089100,40104919,15819
"6289","ENSGALG00000012592","Z",40107242,40111098,3856
"6290","ENSGALG00000012593","Z",40176150,40219592,43442
"6291","ENSGALG00000012594","Z",40301107,40506493,205386
"6292","ENSGALG00000012595","Z",40677336,40738461,61125
"6293","ENSGALG00000012598","Z",40746428,40773068,26640
"6294","ENSGALG00000012601","Z",40778614,40804385,25771
"6295","ENSGALG00000012606","Z",40832093,40839365,7272
"6296","ENSGALG00000012607","Z",40841869,40874793,32924
"6297","ENSGALG00000012608","Z",41291902,41388905,97003
"6298","ENSGALG00000012610","Z",41419265,41425489,6224
"6299","ENSGALG00000012611","1",53286579,53299252,12673
"6300","ENSGALG00000012612","Z",41434019,41454584,20565
"6301","ENSGALG00000012613","Z",41459118,41469158,10040
"6302","ENSGALG00000012618","Z",41672485,41742224,69739
"6303","ENSGALG00000012619","1",53325209,53342024,16815
"6304","ENSGALG00000012620","Z",41783741,41851352,67611
"6305","ENSGALG00000012621","Z",41978720,42045926,67206
"6306","ENSGALG00000012623","Z",42432329,42437371,5042
"6307","ENSGALG00000012624","Z",42275026,42278699,3673
"6308","ENSGALG00000012627","Z",42226916,42272737,45821
"6309","ENSGALG00000012628","Z",42191365,42213067,21702
"6310","ENSGALG00000012629","Z",42177767,42182052,4285
"6311","ENSGALG00000012631","1",53343403,53357843,14440
"6312","ENSGALG00000012638","1",53591410,53626354,34944
"6313","ENSGALG00000012639","1",53628604,53634012,5408
"6314","ENSGALG00000012640","1",53635743,53648531,12788
"6315","ENSGALG00000012644","Z",24754667,24755989,1322
"6316","ENSGALG00000012647","1",53713025,53802913,89888
"6317","ENSGALG00000012655","1",53811388,53878902,67514
"6318","ENSGALG00000012658","1",53881515,53897895,16380
"6319","ENSGALG00000012659","1",53903598,53908679,5081
"6320","ENSGALG00000012662","1",53933066,53978011,44945
"6321","ENSGALG00000012671","2",58571228,58577382,6154
"6322","ENSGALG00000012677","2",59039263,59415499,376236
"6323","ENSGALG00000012680","2",59420911,59461745,40834
"6324","ENSGALG00000012681","2",59566193,59625203,59010
"6325","ENSGALG00000012683","2",60241734,60287806,46072
"6326","ENSGALG00000012684","2",60324519,60341971,17452
"6327","ENSGALG00000012685","2",60347681,60373473,25792
"6328","ENSGALG00000012687","2",60373607,60382598,8991
"6329","ENSGALG00000012688","2",60384133,60385455,1322
"6330","ENSGALG00000012689","2",60397627,60509298,111671
"6331","ENSGALG00000012691","1",54291424,54319655,28231
"6332","ENSGALG00000012692","2",60512496,60519960,7464
"6333","ENSGALG00000012694","1",54320742,54323938,3196
"6334","ENSGALG00000012695","2",60520038,60523463,3425
"6335","ENSGALG00000012696","2",60523859,60531947,8088
"6336","ENSGALG00000012697","1",54333887,54374347,40460
"6337","ENSGALG00000012699","2",60595560,60610916,15356
"6338","ENSGALG00000012700","2",60644514,60667750,23236
"6339","ENSGALG00000012702","2",61065775,61271210,205435
"6340","ENSGALG00000012703","2",61271949,61340803,68854
"6341","ENSGALG00000012704","2",61479711,61493929,14218
"6342","ENSGALG00000012705","2",61526463,61561966,35503
"6343","ENSGALG00000012709","2",61572031,61650422,78391
"6344","ENSGALG00000012710","17",6162996,6173508,10512
"6345","ENSGALG00000012712","2",61921863,61932480,10617
"6346","ENSGALG00000012715","2",61960517,62027180,66663
"6347","ENSGALG00000012720","2",62040196,62086207,46011
"6348","ENSGALG00000012721","2",62091157,62100297,9140
"6349","ENSGALG00000012724","2",62100860,62110796,9936
"6350","ENSGALG00000012730","2",62136946,62200155,63209
"6351","ENSGALG00000012731","2",62216173,62227686,11513
"6352","ENSGALG00000012732","2",62237702,62532964,295262
"6353","ENSGALG00000012735","2",62675250,62679088,3838
"6354","ENSGALG00000012739","2",62710582,62820321,109739
"6355","ENSGALG00000012747","2",63027555,63115283,87728
"6356","ENSGALG00000012748","2",63142207,63181112,38905
"6357","ENSGALG00000012754","1",55078825,55114899,36074
"6358","ENSGALG00000012755","1",55281097,55330373,49276
"6359","ENSGALG00000012756","1",55369893,55417954,48061
"6360","ENSGALG00000012757","1",55372179,55373646,1467
"6361","ENSGALG00000012759","1",55418026,55444014,25988
"6362","ENSGALG00000012760","1",55450039,55465325,15286
"6363","ENSGALG00000012761","1",55492486,55507806,15320
"6364","ENSGALG00000012763","1",55519674,55560047,40373
"6365","ENSGALG00000012766","1",55560638,55572432,11794
"6366","ENSGALG00000012768","2",63211417,63216465,5048
"6367","ENSGALG00000012769","1",55571461,55590991,19530
"6368","ENSGALG00000012770","2",63228311,63243379,15068
"6369","ENSGALG00000012775","2",63286294,63299774,13480
"6370","ENSGALG00000012778","2",64129120,64156530,27410
"6371","ENSGALG00000012782","2",64294321,64330903,36582
"6372","ENSGALG00000012783","1",55597280,55669104,71824
"6373","ENSGALG00000012784","2",64356493,64377224,20731
"6374","ENSGALG00000012787","2",64378425,64463337,84912
"6375","ENSGALG00000012790","2",64524991,64561164,36173
"6376","ENSGALG00000012791","1",55750244,55990181,239937
"6377","ENSGALG00000012792","1",56021548,56144368,122820
"6378","ENSGALG00000012795","2",64598110,64612733,14623
"6379","ENSGALG00000012796","1",56172463,56308924,136461
"6380","ENSGALG00000012798","2",64623377,64634226,10849
"6381","ENSGALG00000012799","2",64646985,64767538,120553
"6382","ENSGALG00000012801","2",64889269,64914270,25001
"6383","ENSGALG00000012802","2",65009436,65078561,69125
"6384","ENSGALG00000012808","2",65582899,65686117,103218
"6385","ENSGALG00000012809","2",65891427,65921040,29613
"6386","ENSGALG00000012812","1",56355825,56376192,20367
"6387","ENSGALG00000012813","2",65939197,65962215,23018
"6388","ENSGALG00000012814","2",66063479,66086421,22942
"6389","ENSGALG00000012816","2",66164028,66258705,94677
"6390","ENSGALG00000012821","2",66278012,66281874,3862
"6391","ENSGALG00000012823","1",56379268,56436811,57543
"6392","ENSGALG00000012827","2",66321163,66341383,20220
"6393","ENSGALG00000012830","2",66457756,66470687,12931
"6394","ENSGALG00000012833","10",20500465,20507873,7408
"6395","ENSGALG00000012834","1",56550352,56584722,34370
"6396","ENSGALG00000012836","10",20510560,20515030,4470
"6397","ENSGALG00000012837","2",66497426,66625421,127995
"6398","ENSGALG00000012845","2",67521992,67599260,77268
"6399","ENSGALG00000012847","1",56636822,56652446,15624
"6400","ENSGALG00000012849","1",56750744,56771091,20347
"6401","ENSGALG00000012850","1",56771259,56776787,5528
"6402","ENSGALG00000012852","1",56779849,56801776,21927
"6403","ENSGALG00000012856","2",67588349,67613675,25326
"6404","ENSGALG00000012857","1",56832861,56870164,37303
"6405","ENSGALG00000012860","28",1430606,1436103,5497
"6406","ENSGALG00000012863","1",56891283,56901579,10296
"6407","ENSGALG00000012865","1",56921170,57002305,81135
"6408","ENSGALG00000012866","2",67630790,67640410,9620
"6409","ENSGALG00000012869","2",67682465,67690037,7572
"6410","ENSGALG00000012870","1",57259624,57307928,48304
"6411","ENSGALG00000012872","2",67733489,67745143,11654
"6412","ENSGALG00000012873","2",67749398,67762854,13456
"6413","ENSGALG00000012874","1",57312780,57323475,10695
"6414","ENSGALG00000012875","1",57325922,57338604,12682
"6415","ENSGALG00000012876","1",57338774,57344343,5569
"6416","ENSGALG00000012877","1",57351612,57424085,72473
"6417","ENSGALG00000012879","2",67779277,67798879,19602
"6418","ENSGALG00000012882","2",67810334,67828096,17762
"6419","ENSGALG00000012885","2",67837316,67924872,87556
"6420","ENSGALG00000012886","2",67949988,67966351,16363
"6421","ENSGALG00000012888","2",67975897,68105942,130045
"6422","ENSGALG00000012889","2",68136178,68176758,40580
"6423","ENSGALG00000012890","1",57435331,57641794,206463
"6424","ENSGALG00000012894","1",57808038,57809438,1400
"6425","ENSGALG00000012898","2",68242226,68316439,74213
"6426","ENSGALG00000012903","2",68316299,68448968,132669
"6427","ENSGALG00000012906","2",68583087,68696145,113058
"6428","ENSGALG00000012907","2",69056000,69056995,995
"6429","ENSGALG00000012908","1",58369935,58390981,21046
"6430","ENSGALG00000012909","2",69157598,69168662,11064
"6431","ENSGALG00000012911","1",58641232,58673128,31896
"6432","ENSGALG00000012913","1",58821965,58864004,42039
"6433","ENSGALG00000012915","2",108001950,108013186,11236
"6434","ENSGALG00000012916","2",69168719,69237681,68962
"6435","ENSGALG00000012917","2",69267185,69363889,96704
"6436","ENSGALG00000012919","1",58904234,58910125,5891
"6437","ENSGALG00000012921","1",71449364,71582019,132655
"6438","ENSGALG00000012923","2",71193073,71261863,68790
"6439","ENSGALG00000012929","1",58915471,58950391,34920
"6440","ENSGALG00000012932","1",58965081,59072088,107007
"6441","ENSGALG00000012934","1",59088124,59268526,180402
"6442","ENSGALG00000012938","1",59380846,59403925,23079
"6443","ENSGALG00000012941","2",73025298,73384586,359288
"6444","ENSGALG00000012944","1",59422545,59528716,106171
"6445","ENSGALG00000012946","1",59546382,59561664,15282
"6446","ENSGALG00000012947","1",59579364,59610650,31286
"6447","ENSGALG00000012952","2",75358894,75406459,47565
"6448","ENSGALG00000012953","1",59614918,59656100,41182
"6449","ENSGALG00000012956","1",59699833,59845195,145362
"6450","ENSGALG00000012964","2",76157176,76405248,248072
"6451","ENSGALG00000012965","2",76282124,76306131,24007
"6452","ENSGALG00000012966","3",48961177,48969226,8049
"6453","ENSGALG00000012968","3",48976571,48994506,17935
"6454","ENSGALG00000012971","3",49020942,49053025,32083
"6455","ENSGALG00000012973","3",49053965,49241576,187611
"6456","ENSGALG00000012974","1",59938893,59978098,39205
"6457","ENSGALG00000012975","1",59998045,60099039,100994
"6458","ENSGALG00000012978","11",15268801,15320700,51899
"6459","ENSGALG00000012984","28",1291895,1303396,11501
"6460","ENSGALG00000012985","1",60190170,60217228,27058
"6461","ENSGALG00000012986","1",60229002,60274689,45687
"6462","ENSGALG00000012987","1",60277783,60290283,12500
"6463","ENSGALG00000012988","1",60296873,60354263,57390
"6464","ENSGALG00000012989","1",60359915,60404116,44201
"6465","ENSGALG00000012992","1",60432078,60530003,97925
"6466","ENSGALG00000012994","1",60556357,60832599,276242
"6467","ENSGALG00000012997","2",76621805,76732534,110729
"6468","ENSGALG00000012998","1",60852680,60917603,64923
"6469","ENSGALG00000013001","2",77878228,78042678,164450
"6470","ENSGALG00000013002","2",78125211,78169242,44031
"6471","ENSGALG00000013005","2",78256607,78261431,4824
"6472","ENSGALG00000013006","2",78263682,78272601,8919
"6473","ENSGALG00000013007","1",61045233,61073779,28546
"6474","ENSGALG00000013008","1",60978921,60980846,1925
"6475","ENSGALG00000013018","1",15825374,15829351,3977
"6476","ENSGALG00000013022","1",61134027,61599794,465767
"6477","ENSGALG00000013026","1",61644952,61654448,9496
"6478","ENSGALG00000013031","1",61651327,61672321,20994
"6479","ENSGALG00000013033","2",78356447,78363091,6644
"6480","ENSGALG00000013034","1",61682861,61775123,92262
"6481","ENSGALG00000013035","2",78379457,78388741,9284
"6482","ENSGALG00000013036","1",61788323,61799223,10900
"6483","ENSGALG00000013037","1",61798694,61836141,37447
"6484","ENSGALG00000013039","1",61839049,61860517,21468
"6485","ENSGALG00000013041","2",78405510,78413636,8126
"6486","ENSGALG00000013042","1",61867663,61967208,99545
"6487","ENSGALG00000013043","2",78413620,78423635,10015
"6488","ENSGALG00000013045","1",62049179,62053565,4386
"6489","ENSGALG00000013056","1",62058137,62065268,7131
"6490","ENSGALG00000013057","1",62069663,62083647,13984
"6491","ENSGALG00000013060","2",79237722,79440729,203007
"6492","ENSGALG00000013061","2",79701901,79758138,56237
"6493","ENSGALG00000013063","2",79772665,79786504,13839
"6494","ENSGALG00000013064","2",79786750,79803207,16457
"6495","ENSGALG00000013069","1",62167702,62186545,18843
"6496","ENSGALG00000013072","1",62458428,62466587,8159
"6497","ENSGALG00000013073","2",79940291,79950017,9726
"6498","ENSGALG00000013079","2",80073338,80135176,61838
"6499","ENSGALG00000013081","2",80493427,80551989,58562
"6500","ENSGALG00000013083","2",80557169,80583440,26271
"6501","ENSGALG00000013084","2",80583586,80611449,27863
"6502","ENSGALG00000013085","1",62781911,62930757,148846
"6503","ENSGALG00000013086","2",80659236,80730292,71056
"6504","ENSGALG00000013090","6",23213501,23218830,5329
"6505","ENSGALG00000013091","1",62935249,63064741,129492
"6506","ENSGALG00000013092","1",63098506,63107795,9289
"6507","ENSGALG00000013094","2",80755118,80807342,52224
"6508","ENSGALG00000013095","1",63109353,63163425,54072
"6509","ENSGALG00000013097","1",63214463,63245438,30975
"6510","ENSGALG00000013098","1",63277443,63284355,6912
"6511","ENSGALG00000013100","2",80852532,80991947,139415
"6512","ENSGALG00000013101","16",2276258,2395893,119635
"6513","ENSGALG00000013102","2",81067153,81215837,148684
"6514","ENSGALG00000013112","1",63890908,63899629,8721
"6515","ENSGALG00000013117","1",63981655,64179076,197421
"6516","ENSGALG00000013123","1",64181929,64224901,42972
"6517","ENSGALG00000013124","2",83079749,83445594,365845
"6518","ENSGALG00000013125","1",64224976,64225943,967
"6519","ENSGALG00000013129","2",83513138,83560047,46909
"6520","ENSGALG00000013131","2",83562242,83571431,9189
"6521","ENSGALG00000013134","1",64349798,64514784,164986
"6522","ENSGALG00000013135","2",83799056,83873117,74061
"6523","ENSGALG00000013138","2",84202852,84276644,73792
"6524","ENSGALG00000013143","1",64882883,65118721,235838
"6525","ENSGALG00000013149","2",84795137,85006306,211169
"6526","ENSGALG00000013154","1",65137008,65158246,21238
"6527","ENSGALG00000013155","2",85442153,85618905,176752
"6528","ENSGALG00000013156","2",85614487,85626391,11904
"6529","ENSGALG00000013157","2",85628166,85637391,9225
"6530","ENSGALG00000013160","2",85637791,85646774,8983
"6531","ENSGALG00000013165","2",85647805,85662193,14388
"6532","ENSGALG00000013167","2",85662894,85678854,15960
"6533","ENSGALG00000013168","1",65265009,65268984,3975
"6534","ENSGALG00000013169","14",12197791,12209594,11803
"6535","ENSGALG00000013173","1",65298236,65313377,15141
"6536","ENSGALG00000013174","1",65317661,65337020,19359
"6537","ENSGALG00000013177","1",65359495,65418925,59430
"6538","ENSGALG00000013180","2",85713768,85738300,24532
"6539","ENSGALG00000013183","2",85742908,85772374,29466
"6540","ENSGALG00000013187","2",85785734,85815041,29307
"6541","ENSGALG00000013189","2",85817469,85879564,62095
"6542","ENSGALG00000013191","2",85983022,85987033,4011
"6543","ENSGALG00000013193","2",86608324,86612432,4108
"6544","ENSGALG00000013196","2",87809146,87849912,40766
"6545","ENSGALG00000013197","2",87858631,87903391,44760
"6546","ENSGALG00000013200","2",87910969,88368255,457286
"6547","ENSGALG00000013205","1",66453732,66480164,26432
"6548","ENSGALG00000013207","2",88491627,88549212,57585
"6549","ENSGALG00000013208","4",60990743,61026616,35873
"6550","ENSGALG00000013209","2",88557203,88570501,13298
"6551","ENSGALG00000013210","1",66503373,66570677,67304
"6552","ENSGALG00000013211","1",66588236,66704165,115929
"6553","ENSGALG00000013212","2",88684786,88736696,51910
"6554","ENSGALG00000013218","1",66793430,66796768,3338
"6555","ENSGALG00000013221","3",16685418,16704573,19155
"6556","ENSGALG00000013223","11",14040581,14047502,6921
"6557","ENSGALG00000013225","11",13982142,14025331,43189
"6558","ENSGALG00000013226","1",66827505,66833778,6273
"6559","ENSGALG00000013229","1",66843524,66853791,10267
"6560","ENSGALG00000013232","25",2675996,2680461,4465
"6561","ENSGALG00000013234","25",2672117,2674826,2709
"6562","ENSGALG00000013235","7",17699379,17709260,9881
"6563","ENSGALG00000013239","25",2647908,2649620,1712
"6564","ENSGALG00000013244","1",66874049,66946411,72362
"6565","ENSGALG00000013247","1",191609238,191627294,18056
"6566","ENSGALG00000013253","25",2589277,2598489,9212
"6567","ENSGALG00000013265","1",67048510,67088148,39638
"6568","ENSGALG00000013268","2",88754376,88902355,147979
"6569","ENSGALG00000013272","1",74873840,74925413,51573
"6570","ENSGALG00000013273","1",67114029,67117233,3204
"6571","ENSGALG00000013281","4",61027909,61034587,6678
"6572","ENSGALG00000013287","4",61036771,61045027,8256
"6573","ENSGALG00000013293","10",9700229,9712392,12163
"6574","ENSGALG00000013294","10",9662329,9683958,21629
"6575","ENSGALG00000013297","5",3749262,3782806,33544
"6576","ENSGALG00000013304","5",3630870,3646132,15262
"6577","ENSGALG00000013310","4",84494785,84540451,45666
"6578","ENSGALG00000013311","5",3449594,3622521,172927
"6579","ENSGALG00000013342","7",5218437,5220507,2070
"6580","ENSGALG00000013348","25",1797652,1830167,32515
"6581","ENSGALG00000013352","25",1842753,1847937,5184
"6582","ENSGALG00000013356","26",2475894,2486807,10913
"6583","ENSGALG00000013365","28",1439512,1454067,14555
"6584","ENSGALG00000013369","28",1383268,1393884,10616
"6585","ENSGALG00000013371","28",1380917,1382110,1193
"6586","ENSGALG00000013372","Z",10886978,10900701,13723
"6587","ENSGALG00000013376","Z",10904777,10916949,12172
"6588","ENSGALG00000013377","Z",10937257,10979460,42203
"6589","ENSGALG00000013383","23",5611502,5615013,3511
"6590","ENSGALG00000013397","2",88903234,88921286,18052
"6591","ENSGALG00000013400","2",88921515,88928014,6499
"6592","ENSGALG00000013402","2",88971793,89054391,82598
"6593","ENSGALG00000013403","2",89082566,89090432,7866
"6594","ENSGALG00000013406","12",15663150,15690673,27523
"6595","ENSGALG00000013408","12",15693136,15706614,13478
"6596","ENSGALG00000013409","23",2220746,2229123,8377
"6597","ENSGALG00000013410","12",15707287,15721052,13765
"6598","ENSGALG00000013414","4",61062031,61084516,22485
"6599","ENSGALG00000013420","1",75332032,75341754,9722
"6600","ENSGALG00000013422","1",75327637,75331844,4207
"6601","ENSGALG00000013424","1",75291781,75327340,35559
"6602","ENSGALG00000013427","4",61098758,61239973,141215
"6603","ENSGALG00000013430","2",89090806,89115686,24880
"6604","ENSGALG00000013431","28",1069498,1073390,3892
"6605","ENSGALG00000013437","11",15474797,15498142,23345
"6606","ENSGALG00000013438","2",89118938,89169010,50072
"6607","ENSGALG00000013441","2",89168602,89253599,84997
"6608","ENSGALG00000013452","2",89253790,89301445,47655
"6609","ENSGALG00000013454","27",6287837,6290582,2745
"6610","ENSGALG00000013462","2",89303231,89335819,32588
"6611","ENSGALG00000013468","4",61315317,61322880,7563
"6612","ENSGALG00000013481","27",7069465,7091251,21786
"6613","ENSGALG00000013484","27",7093741,7098525,4784
"6614","ENSGALG00000013489","1",186228663,186241876,13213
"6615","ENSGALG00000013493","Z",44662396,44696180,33784
"6616","ENSGALG00000013494","11",15370178,15377758,7580
"6617","ENSGALG00000013495","27",7118248,7123056,4808
"6618","ENSGALG00000013503","4",61340939,61353442,12503
"6619","ENSGALG00000013505","3",49258198,49530795,272597
"6620","ENSGALG00000013506","27",7131800,7149445,17645
"6621","ENSGALG00000013510","Z",24707997,24717639,9642
"6622","ENSGALG00000013511","Z",24717663,24724746,7083
"6623","ENSGALG00000013512","Z",24736603,24743170,6567
"6624","ENSGALG00000013528","22",3902960,3937658,34698
"6625","ENSGALG00000013532","5",18710570,18743777,33207
"6626","ENSGALG00000013535","4",61357027,61369973,12946
"6627","ENSGALG00000013537","25",2866149,2882180,16031
"6628","ENSGALG00000013546","Z",16648999,16663409,14410
"6629","ENSGALG00000013548","Z",16643589,16666277,22688
"6630","ENSGALG00000013565","1",77661403,77673356,11953
"6631","ENSGALG00000013568","2",89365079,89385555,20476
"6632","ENSGALG00000013569","2",89693065,89697358,4293
"6633","ENSGALG00000013571","4",61378572,61392809,14237
"6634","ENSGALG00000013573","2",89697618,89699292,1674
"6635","ENSGALG00000013575","2",89717661,89722211,4550
"6636","ENSGALG00000013576","4",61619295,61668372,49077
"6637","ENSGALG00000013579","4",61698013,61798424,100411
"6638","ENSGALG00000013583","4",69474903,69506031,31128
"6639","ENSGALG00000013590","4",62763514,62772379,8865
"6640","ENSGALG00000013591","2",89775663,89781385,5722
"6641","ENSGALG00000013594","2",89782356,89840622,58266
"6642","ENSGALG00000013598","2",89883629,89906746,23117
"6643","ENSGALG00000013600","4",62797493,62804740,7247
"6644","ENSGALG00000013602","4",62808175,62846044,37869
"6645","ENSGALG00000013603","3",49550704,49569883,19179
"6646","ENSGALG00000013604","3",49586424,49602336,15912
"6647","ENSGALG00000013605","2",89911310,90085595,174285
"6648","ENSGALG00000013606","4",62853578,62872237,18659
"6649","ENSGALG00000013607","3",49696705,49702902,6197
"6650","ENSGALG00000013609","3",49705239,49719357,14118
"6651","ENSGALG00000013615","4",62907589,62999208,91619
"6652","ENSGALG00000013616","3",50129976,50151868,21892
"6653","ENSGALG00000013617","4",63002339,63021875,19536
"6654","ENSGALG00000013621","2",110240177,110289554,49377
"6655","ENSGALG00000013624","2",90145304,90201328,56024
"6656","ENSGALG00000013625","3",50167911,50232264,64353
"6657","ENSGALG00000013626","2",90209334,90214798,5464
"6658","ENSGALG00000013627","4",63027358,63067114,39756
"6659","ENSGALG00000013628","2",90222982,90228705,5723
"6660","ENSGALG00000013632","2",90236164,90240896,4732
"6661","ENSGALG00000013634","Z",42489132,42547323,58191
"6662","ENSGALG00000013635","3",50414485,50445901,31416
"6663","ENSGALG00000013637","2",90240952,90248204,7252
"6664","ENSGALG00000013639","23",2556373,2558963,2590
"6665","ENSGALG00000013640","2",90467903,90576864,108961
"6666","ENSGALG00000013642","21",4968293,5020062,51769
"6667","ENSGALG00000013646","4",63129241,63148736,19495
"6668","ENSGALG00000013647","3",50678048,50704801,26753
"6669","ENSGALG00000013649","4",63148951,63169279,20328
"6670","ENSGALG00000013651","3",60217079,60270213,53134
"6671","ENSGALG00000013655","4",63178948,63206134,27186
"6672","ENSGALG00000013657","2",90579225,90647828,68603
"6673","ENSGALG00000013659","3",50725203,50762452,37249
"6674","ENSGALG00000013660","2",90772185,90872589,100404
"6675","ENSGALG00000013661","4",63215055,63261190,46135
"6676","ENSGALG00000013663","4",63267129,63271376,4247
"6677","ENSGALG00000013672","2",91334478,91387810,53332
"6678","ENSGALG00000013674","4",63620950,63732824,111874
"6679","ENSGALG00000013683","3",51465143,51563959,98816
"6680","ENSGALG00000013684","4",63861918,64214244,352326
"6681","ENSGALG00000013685","6",33448529,33469510,20981
"6682","ENSGALG00000013688","6",33473293,33482070,8777
"6683","ENSGALG00000013689","3",51620425,51638185,17760
"6684","ENSGALG00000013695","3",51660522,51760022,99500
"6685","ENSGALG00000013697","2",91814326,91830339,16013
"6686","ENSGALG00000013703","2",91875930,91886754,10824
"6687","ENSGALG00000013708","2",91931500,91942888,11388
"6688","ENSGALG00000013709","2",91981478,91986776,5298
"6689","ENSGALG00000013710","3",51808003,51861928,53925
"6690","ENSGALG00000013715","4",64370643,64586585,215942
"6691","ENSGALG00000013720","2",91986880,92010837,23957
"6692","ENSGALG00000013722","12",3631598,3635036,3438
"6693","ENSGALG00000013723","12",3635427,3637460,2033
"6694","ENSGALG00000013725","4",64714109,64728848,14739
"6695","ENSGALG00000013726","4",64733840,64768851,35011
"6696","ENSGALG00000013727","3",51874584,51938032,63448
"6697","ENSGALG00000013728","4",64741468,64783894,42426
"6698","ENSGALG00000013731","2",93532912,93543953,11041
"6699","ENSGALG00000013732","3",51949090,51963080,13990
"6700","ENSGALG00000013733","3",51964607,51969192,4585
"6701","ENSGALG00000013737","3",52142821,52165059,22238
"6702","ENSGALG00000013738","1",7225803,7245380,19577
"6703","ENSGALG00000013740","22",5151443,5159448,8005
"6704","ENSGALG00000013741","3",52171021,52200623,29602
"6705","ENSGALG00000013742","3",52201415,52238151,36736
"6706","ENSGALG00000013743","18",9638646,9641916,3270
"6707","ENSGALG00000013745","2",93592202,93672860,80658
"6708","ENSGALG00000013747","3",52304980,52312768,7788
"6709","ENSGALG00000013748","2",93679817,93715007,35190
"6710","ENSGALG00000013753","2",93727152,93971533,244381
"6711","ENSGALG00000013754","3",52353589,52378280,24691
"6712","ENSGALG00000013756","3",52378552,52388126,9574
"6713","ENSGALG00000013757","2",94226785,94252977,26192
"6714","ENSGALG00000013759","9",17588519,17592370,3851
"6715","ENSGALG00000013762","2",94275197,94289016,13819
"6716","ENSGALG00000013764","4",64787542,64807047,19505
"6717","ENSGALG00000013765","3",52392519,52401620,9101
"6718","ENSGALG00000013768","3",52409174,52528843,119669
"6719","ENSGALG00000013771","4",64810015,64867065,57050
"6720","ENSGALG00000013773","3",52529964,52540546,10582
"6721","ENSGALG00000013775","2",95113245,95216691,103446
"6722","ENSGALG00000013776","4",64924871,64954289,29418
"6723","ENSGALG00000013777","3",52540656,52558882,18226
"6724","ENSGALG00000013778","4",64955204,64981147,25943
"6725","ENSGALG00000013780","3",52596322,52717340,121018
"6726","ENSGALG00000013782","2",95468521,95545982,77461
"6727","ENSGALG00000013784","11",18457285,18461372,4087
"6728","ENSGALG00000013785","2",97338196,97453065,114869
"6729","ENSGALG00000013793","4",65084415,65108758,24343
"6730","ENSGALG00000013794","2",97308619,97335244,26625
"6731","ENSGALG00000013795","3",52794638,52866174,71536
"6732","ENSGALG00000013803","3",52959497,53067360,107863
"6733","ENSGALG00000013804","4",65129662,65135891,6229
"6734","ENSGALG00000013809","Z",7358700,7496820,138120
"6735","ENSGALG00000013810","3",53100608,53131288,30680
"6736","ENSGALG00000013813","3",53139542,53155861,16319
"6737","ENSGALG00000013814","2",97290429,97308480,18051
"6738","ENSGALG00000013817","2",97073307,97195740,122433
"6739","ENSGALG00000013818","3",54059667,54061125,1458
"6740","ENSGALG00000013821","3",16636721,16639607,2886
"6741","ENSGALG00000013822","3",54077243,54114208,36965
"6742","ENSGALG00000013824","3",54130235,54163918,33683
"6743","ENSGALG00000013826","3",54176664,54179502,2838
"6744","ENSGALG00000013828","3",16619745,16634264,14519
"6745","ENSGALG00000013829","3",54198322,54264069,65747
"6746","ENSGALG00000013830","2",97199690,97210085,10395
"6747","ENSGALG00000013834","3",54273073,54278672,5599
"6748","ENSGALG00000013838","5",27660750,27663048,2298
"6749","ENSGALG00000013846","3",54492908,54572776,79868
"6750","ENSGALG00000013848","15",7068522,7079367,10845
"6751","ENSGALG00000013851","15",7042382,7058329,15947
"6752","ENSGALG00000013853","2",97210279,97233233,22954
"6753","ENSGALG00000013858","2",97057241,97071814,14573
"6754","ENSGALG00000013861","3",54664503,54683327,18824
"6755","ENSGALG00000013863","2",97037931,97057122,19191
"6756","ENSGALG00000013865","3",54895190,54914161,18971
"6757","ENSGALG00000013867","2",97013090,97047494,34404
"6758","ENSGALG00000013869","3",54956242,54977305,21063
"6759","ENSGALG00000013872","2",96985906,96998514,12608
"6760","ENSGALG00000013874","3",55012657,55048318,35661
"6761","ENSGALG00000013878","22",4138675,4143999,5324
"6762","ENSGALG00000013879","22",4127112,4138607,11495
"6763","ENSGALG00000013881","22",4117999,4124786,6787
"6764","ENSGALG00000013882","22",4110333,4118011,7678
"6765","ENSGALG00000013883","22",4106739,4108635,1896
"6766","ENSGALG00000013886","2",96632938,96858886,225948
"6767","ENSGALG00000013887","2",96599127,96616410,17283
"6768","ENSGALG00000013889","2",96584306,96598993,14687
"6769","ENSGALG00000013892","3",55054006,55149738,95732
"6770","ENSGALG00000013893","10",8108447,8114659,6212
"6771","ENSGALG00000013899","25",83453,110586,27133
"6772","ENSGALG00000013900","3",55160010,55257947,97937
"6773","ENSGALG00000013907","4",65185439,65213106,27667
"6774","ENSGALG00000013911","1",71375201,71400743,25542
"6775","ENSGALG00000013912","3",55260164,55283655,23491
"6776","ENSGALG00000013916","10",20562187,20563224,1037
"6777","ENSGALG00000013920","1",7983063,7992822,9759
"6778","ENSGALG00000013926","1",7993092,8003663,10571
"6779","ENSGALG00000013929","4",65398425,65431696,33271
"6780","ENSGALG00000013931","4",65475198,65496134,20936
"6781","ENSGALG00000013932","2",98051108,98065183,14075
"6782","ENSGALG00000013935","3",55290293,55506996,216703
"6783","ENSGALG00000013940","4",65644634,65720676,76042
"6784","ENSGALG00000013941","3",55353526,55514981,161455
"6785","ENSGALG00000013943","4",65720701,65758061,37360
"6786","ENSGALG00000013948","4",65944536,65948246,3710
"6787","ENSGALG00000013950","3",38148652,38169225,20573
"6788","ENSGALG00000013951","3",55667104,55751669,84565
"6789","ENSGALG00000013952","3",38124927,38149873,24946
"6790","ENSGALG00000013956","3",55778483,55804513,26030
"6791","ENSGALG00000013962","3",55846631,55911966,65335
"6792","ENSGALG00000013964","4",66145698,66161979,16281
"6793","ENSGALG00000013967","1",6851074,6858323,7249
"6794","ENSGALG00000013968","4",66162397,66168332,5935
"6795","ENSGALG00000013969","3",55914705,55924998,10293
"6796","ENSGALG00000013971","3",56205535,56302921,97386
"6797","ENSGALG00000013980","3",56302892,56331660,28768
"6798","ENSGALG00000013981","3",56337729,56344309,6580
"6799","ENSGALG00000013990","3",56858322,56862421,4099
"6800","ENSGALG00000013993","3",56889501,56916337,26836
"6801","ENSGALG00000013994","3",56916402,56917399,997
"6802","ENSGALG00000013999","1",77526063,77541005,14942
"6803","ENSGALG00000014011","1",67126380,67162894,36514
"6804","ENSGALG00000014012","23",2071078,2084408,13330
"6805","ENSGALG00000014016","25",723875,738551,14676
"6806","ENSGALG00000014023","4",60154127,60156849,2722
"6807","ENSGALG00000014026","4",60128048,60153671,25623
"6808","ENSGALG00000014030","1",67162847,67181904,19057
"6809","ENSGALG00000014031","1",67181939,67199983,18044
"6810","ENSGALG00000014038","1",6862559,6896744,34185
"6811","ENSGALG00000014042","1",67612113,67631404,19291
"6812","ENSGALG00000014054","13",10842168,10855094,12926
"6813","ENSGALG00000014060","1",191746049,191761996,15947
"6814","ENSGALG00000014064","4",69378550,69390246,11696
"6815","ENSGALG00000014066","1",191533931,191542179,8248
"6816","ENSGALG00000014067","28",3346915,3355534,8619
"6817","ENSGALG00000014069","5",22418650,22435035,16385
"6818","ENSGALG00000014071","1",67659344,67921693,262349
"6819","ENSGALG00000014078","4",66184701,66219754,35053
"6820","ENSGALG00000014081","4",66269429,66282880,13451
"6821","ENSGALG00000014083","1",67963378,67982231,18853
"6822","ENSGALG00000014084","1",67983476,67994798,11322
"6823","ENSGALG00000014085","1",67998522,68015987,17465
"6824","ENSGALG00000014094","1",68074888,68118677,43789
"6825","ENSGALG00000014096","1",68130384,68166501,36117
"6826","ENSGALG00000014103","4",66298316,66439427,141111
"6827","ENSGALG00000014106","1",68191397,68291071,99674
"6828","ENSGALG00000014115","4",66459339,66485331,25992
"6829","ENSGALG00000014117","4",88653691,88655304,1613
"6830","ENSGALG00000014118","4",88644122,88649461,5339
"6831","ENSGALG00000014121","10",2848816,2852184,3368
"6832","ENSGALG00000014122","1",68297311,68348236,50925
"6833","ENSGALG00000014124","4",66502757,66544534,41777
"6834","ENSGALG00000014126","1",68314084,68324267,10183
"6835","ENSGALG00000014127","4",66556118,66563523,7405
"6836","ENSGALG00000014128","1",68335336,68348032,12696
"6837","ENSGALG00000014138","4",66591368,66632326,40958
"6838","ENSGALG00000014140","1",68365225,68398932,33707
"6839","ENSGALG00000014144","4",66638161,66758374,120213
"6840","ENSGALG00000014152","5",16401134,16419820,18686
"6841","ENSGALG00000014155","22",5177339,5208257,30918
"6842","ENSGALG00000014159","1",68405048,68468405,63357
"6843","ENSGALG00000014163","1",68477408,68498513,21105
"6844","ENSGALG00000014164","1",68501326,68513915,12589
"6845","ENSGALG00000014166","1",68519442,68531303,11861
"6846","ENSGALG00000014167","1",68531713,68552590,20877
"6847","ENSGALG00000014170","1",196939707,196956041,16334
"6848","ENSGALG00000014176","21",4842054,4843618,1564
"6849","ENSGALG00000014178","1",68564109,68765156,201047
"6850","ENSGALG00000014179","14",13338770,13350329,11559
"6851","ENSGALG00000014182","19",6587381,6595618,8237
"6852","ENSGALG00000014186","1",68817721,68879496,61775
"6853","ENSGALG00000014188","1",68893975,68896951,2976
"6854","ENSGALG00000014189","1",69011403,69044852,33449
"6855","ENSGALG00000014192","4",66765329,66794720,29391
"6856","ENSGALG00000014194","1",69091135,69109302,18167
"6857","ENSGALG00000014200","4",66823740,66915422,91682
"6858","ENSGALG00000014201","1",69116160,69172538,56378
"6859","ENSGALG00000014202","4",66931457,66966985,35528
"6860","ENSGALG00000014203","1",69176886,69198132,21246
"6861","ENSGALG00000014206","4",67066083,67117921,51838
"6862","ENSGALG00000014209","7",16882459,16902727,20268
"6863","ENSGALG00000014210","4",67593017,67600493,7476
"6864","ENSGALG00000014213","1",69701235,69786844,85609
"6865","ENSGALG00000014217","4",67601523,67617711,16188
"6866","ENSGALG00000014218","1",69921526,69983708,62182
"6867","ENSGALG00000014221","4",67606393,67650496,44103
"6868","ENSGALG00000014222","1",70202950,70218992,16042
"6869","ENSGALG00000014225","4",67689273,67774415,85142
"6870","ENSGALG00000014226","1",70227079,70290413,63334
"6871","ENSGALG00000014227","1",70331029,70338080,7051
"6872","ENSGALG00000014228","1",70362862,70398886,36024
"6873","ENSGALG00000014232","1",70399298,70413365,14067
"6874","ENSGALG00000014233","1",70452867,70534884,82017
"6875","ENSGALG00000014234","1",70567704,70663626,95922
"6876","ENSGALG00000014236","4",68148034,68237929,89895
"6877","ENSGALG00000014242","4",68290811,68317278,26467
"6878","ENSGALG00000014248","4",68365143,68375086,9943
"6879","ENSGALG00000014250","4",68438642,68440511,1869
"6880","ENSGALG00000014252","1",75845885,75853747,7862
"6881","ENSGALG00000014258","4",68509592,68515621,6029
"6882","ENSGALG00000014261","4",68642734,68647699,4965
"6883","ENSGALG00000014262","4",68674139,68728558,54419
"6884","ENSGALG00000014263","1",75865514,75884654,19140
"6885","ENSGALG00000014264","4",68814202,68825528,11326
"6886","ENSGALG00000014267","4",68865637,68933834,68197
"6887","ENSGALG00000014268","4",68963214,68975555,12341
"6888","ENSGALG00000014276","7",16914151,16935072,20921
"6889","ENSGALG00000014280","1",75632084,75637754,5670
"6890","ENSGALG00000014286","4",69081052,69152713,71661
"6891","ENSGALG00000014290","4",69165418,69201037,35619
"6892","ENSGALG00000014297","5",16053125,16056590,3465
"6893","ENSGALG00000014298","4",69316744,69353001,36257
"6894","ENSGALG00000014321","4",69214818,69251117,36299
"6895","ENSGALG00000014324","1",75548453,75558943,10490
"6896","ENSGALG00000014329","1",75476115,75504709,28594
"6897","ENSGALG00000014331","1",75399377,75413553,14176
"6898","ENSGALG00000014335","1",75380258,75394716,14458
"6899","ENSGALG00000014336","4",69834800,69855846,21046
"6900","ENSGALG00000014337","4",69914094,69961970,47876
"6901","ENSGALG00000014342","1",75219390,75286457,67067
"6902","ENSGALG00000014346","1",75057946,75199031,141085
"6903","ENSGALG00000014347","1",75027120,75040418,13298
"6904","ENSGALG00000014355","4",73068961,73127122,58161
"6905","ENSGALG00000014362","1",77307980,77318936,10956
"6906","ENSGALG00000014365","4",73224322,73315382,91060
"6907","ENSGALG00000014371","3",37820739,37836628,15889
"6908","ENSGALG00000014372","4",73421043,73440963,19920
"6909","ENSGALG00000014378","4",73479748,73495834,16086
"6910","ENSGALG00000014381","13",14988688,15014765,26077
"6911","ENSGALG00000014386","4",73527042,73550829,23787
"6912","ENSGALG00000014387","27",6528661,6530620,1959
"6913","ENSGALG00000014391","4",73611512,73661940,50428
"6914","ENSGALG00000014395","4",73692460,73744226,51766
"6915","ENSGALG00000014406","4",74946865,74962574,15709
"6916","ENSGALG00000014408","14",5455111,5467327,12216
"6917","ENSGALG00000014410","1",77433979,77438548,4569
"6918","ENSGALG00000014412","1",77439994,77445026,5032
"6919","ENSGALG00000014413","1",77454326,77464115,9789
"6920","ENSGALG00000014421","4",75821282,75869811,48529
"6921","ENSGALG00000014425","4",75726455,75920712,194257
"6922","ENSGALG00000014426","1",77477877,77514773,36896
"6923","ENSGALG00000014428","1",77546387,77554991,8604
"6924","ENSGALG00000014432","2",111204409,111207110,2701
"6925","ENSGALG00000014435","1",77585845,77587396,1551
"6926","ENSGALG00000014442","1",77619214,77623350,4136
"6927","ENSGALG00000014443","1",77633594,77642717,9123
"6928","ENSGALG00000014447","Z",27452882,27469311,16429
"6929","ENSGALG00000014448","Z",27444539,27453951,9412
"6930","ENSGALG00000014453","1",79952697,79957248,4551
"6931","ENSGALG00000014455","1",77694435,77702350,7915
"6932","ENSGALG00000014457","1",77734990,77749769,14779
"6933","ENSGALG00000014463","3",37710303,37774495,64192
"6934","ENSGALG00000014464","3",37651044,37698782,47738
"6935","ENSGALG00000014466","1",77803621,77808412,4791
"6936","ENSGALG00000014467","1",77817350,77820482,3132
"6937","ENSGALG00000014468","1",77831588,77841435,9847
"6938","ENSGALG00000014477","1",77873930,77885897,11967
"6939","ENSGALG00000014485","4",76025150,76382215,357065
"6940","ENSGALG00000014486","4",76442333,76481335,39002
"6941","ENSGALG00000014490","1",77900316,77910271,9955
"6942","ENSGALG00000014496","4",76507126,76565949,58823
"6943","ENSGALG00000014501","4",76567092,76569320,2228
"6944","ENSGALG00000014508","4",76602399,76622926,20527
"6945","ENSGALG00000014509","4",76637942,76652266,14324
"6946","ENSGALG00000014510","4",76655650,76689147,33497
"6947","ENSGALG00000014513","1",77922769,77924912,2143
"6948","ENSGALG00000014514","4",76691324,76735809,44485
"6949","ENSGALG00000014515","4",76744821,76779005,34184
"6950","ENSGALG00000014516","4",76833051,76880121,47070
"6951","ENSGALG00000014525","1",77924975,77939984,15009
"6952","ENSGALG00000014526","1",77940005,77943711,3706
"6953","ENSGALG00000014528","1",77952924,77962832,9908
"6954","ENSGALG00000014537","5",29608119,29626791,18672
"6955","ENSGALG00000014540","22",3763729,3785186,21457
"6956","ENSGALG00000014551","1",71309071,71524675,215604
"6957","ENSGALG00000014554","1",77983830,77990589,6759
"6958","ENSGALG00000014555","1",77991895,77993033,1138
"6959","ENSGALG00000014561","1",77994636,78014698,20062
"6960","ENSGALG00000014567","1",78015335,78020461,5126
"6961","ENSGALG00000014568","1",78020566,78022842,2276
"6962","ENSGALG00000014569","5",15965565,15987045,21480
"6963","ENSGALG00000014570","1",78023023,78038708,15685
"6964","ENSGALG00000014573","5",18749501,18771124,21623
"6965","ENSGALG00000014575","1",7287501,7311282,23781
"6966","ENSGALG00000014581","28",3672331,3680267,7936
"6967","ENSGALG00000014582","24",4700047,4856723,156676
"6968","ENSGALG00000014585","19",4941785,4942879,1094
"6969","ENSGALG00000014589","28",2309232,2317220,7988
"6970","ENSGALG00000014603","1",78045961,78055022,9061
"6971","ENSGALG00000014607","27",7018144,7036054,17910
"6972","ENSGALG00000014614","6",20720818,20745934,25116
"6973","ENSGALG00000014615","2",99519352,99618009,98657
"6974","ENSGALG00000014616","11",2122187,2123328,1141
"6975","ENSGALG00000014624","10",17723587,17767097,43510
"6976","ENSGALG00000014638","25",3564403,3597752,33349
"6977","ENSGALG00000014640","25",3675357,3682115,6758
"6978","ENSGALG00000014642","Z",51359549,51407969,48420
"6979","ENSGALG00000014643","25",3617842,3624498,6656
"6980","ENSGALG00000014645","Z",60517700,60640680,122980
"6981","ENSGALG00000014646","25",3635048,3645497,10449
"6982","ENSGALG00000014647","25",3649248,3654647,5399
"6983","ENSGALG00000014648","Z",59940610,59957212,16602
"6984","ENSGALG00000014649","Z",59920983,59929566,8583
"6985","ENSGALG00000014650","Z",59912198,59914465,2267
"6986","ENSGALG00000014651","Z",59892416,59896505,4089
"6987","ENSGALG00000014652","25",3654868,3663616,8748
"6988","ENSGALG00000014656","25",3709975,3725559,15584
"6989","ENSGALG00000014659","1",78058485,78065761,7276
"6990","ENSGALG00000014661","Z",58296404,58559444,263040
"6991","ENSGALG00000014662","1",78070071,78071702,1631
"6992","ENSGALG00000014664","Z",58062811,58282346,219535
"6993","ENSGALG00000014668","Z",57735038,57998974,263936
"6994","ENSGALG00000014670","Z",57629183,57671044,41861
"6995","ENSGALG00000014672","Z",57617708,57629190,11482
"6996","ENSGALG00000014673","Z",57610727,57613816,3089
"6997","ENSGALG00000014674","1",78071723,78086627,14904
"6998","ENSGALG00000014675","Z",57563915,57592147,28232
"6999","ENSGALG00000014678","Z",57470318,57523525,53207
"7000","ENSGALG00000014680","1",78087297,78096282,8985
"7001","ENSGALG00000014681","Z",57335212,57363032,27820
"7002","ENSGALG00000014682","Z",57223733,57284131,60398
"7003","ENSGALG00000014683","1",78099886,78110916,11030
"7004","ENSGALG00000014684","Z",57207629,57222063,14434
"7005","ENSGALG00000014685","1",78151657,78154679,3022
"7006","ENSGALG00000014686","Z",56968843,57129354,160511
"7007","ENSGALG00000014687","1",78162527,78195976,33449
"7008","ENSGALG00000014688","1",78201045,78212460,11415
"7009","ENSGALG00000014689","1",78257533,78259472,1939
"7010","ENSGALG00000014690","Z",56896189,56948360,52171
"7011","ENSGALG00000014691","Z",56385484,56394437,8953
"7012","ENSGALG00000014692","Z",56417094,56440973,23879
"7013","ENSGALG00000014695","1",78276084,78333916,57832
"7014","ENSGALG00000014698","1",78336971,78362958,25987
"7015","ENSGALG00000014699","Z",56552981,56651665,98684
"7016","ENSGALG00000014700","Z",16737509,16761257,23748
"7017","ENSGALG00000014701","1",78380088,78418997,38909
"7018","ENSGALG00000014703","Z",56660659,56687575,26916
"7019","ENSGALG00000014708","1",78425057,78436557,11500
"7020","ENSGALG00000014709","Z",16760913,16805888,44975
"7021","ENSGALG00000014711","Z",16804844,16861020,56176
"7022","ENSGALG00000014712","Z",16883916,16926017,42101
"7023","ENSGALG00000014713","Z",16929403,16961191,31788
"7024","ENSGALG00000014716","Z",17026875,17060827,33952
"7025","ENSGALG00000014717","Z",17092305,17142593,50288
"7026","ENSGALG00000014718","Z",17405389,17461088,55699
"7027","ENSGALG00000014719","Z",17465683,17470926,5243
"7028","ENSGALG00000014721","Z",17476263,17499010,22747
"7029","ENSGALG00000014722","1",79179715,79187290,7575
"7030","ENSGALG00000014723","1",79147794,79157641,9847
"7031","ENSGALG00000014724","Z",17517388,17555314,37926
"7032","ENSGALG00000014725","Z",18019411,18025319,5908
"7033","ENSGALG00000014726","Z",18063446,18207759,144313
"7034","ENSGALG00000014727","Z",18250991,18507712,256721
"7035","ENSGALG00000014729","Z",18855387,18874705,19318
"7036","ENSGALG00000014730","Z",18876427,18908652,32225
"7037","ENSGALG00000014732","Z",18931084,18970451,39367
"7038","ENSGALG00000014734","Z",19094374,19205727,111353
"7039","ENSGALG00000014736","1",78552909,78576195,23286
"7040","ENSGALG00000014737","Z",19421087,19478292,57205
"7041","ENSGALG00000014740","Z",19489299,19563233,73934
"7042","ENSGALG00000014742","Z",19994081,19995570,1489
"7043","ENSGALG00000014743","Z",20052493,20125241,72748
"7044","ENSGALG00000014746","1",78604630,78633785,29155
"7045","ENSGALG00000014747","Z",20211836,20325470,113634
"7046","ENSGALG00000014749","1",78678054,78732359,54305
"7047","ENSGALG00000014750","1",78771732,78773515,1783
"7048","ENSGALG00000014751","Z",20369274,20519860,150586
"7049","ENSGALG00000014753","Z",20549041,20570488,21447
"7050","ENSGALG00000014754","1",78777330,78971694,194364
"7051","ENSGALG00000014756","Z",20570577,20585195,14618
"7052","ENSGALG00000014758","2",99623422,99648395,24973
"7053","ENSGALG00000014759","1",79114221,79129925,15704
"7054","ENSGALG00000014762","2",100000085,100018727,18642
"7055","ENSGALG00000014765","Z",20586231,20606756,20525
"7056","ENSGALG00000014766","1",79328749,79338994,10245
"7057","ENSGALG00000014767","Z",20606619,20631370,24751
"7058","ENSGALG00000014768","Z",20633050,20653718,20668
"7059","ENSGALG00000014769","Z",20653928,20692517,38589
"7060","ENSGALG00000014772","1",79431556,79472851,41295
"7061","ENSGALG00000014773","Z",20753783,20841038,87255
"7062","ENSGALG00000014776","1",79496664,79585348,88684
"7063","ENSGALG00000014784","Z",21008217,21296403,288186
"7064","ENSGALG00000014786","Z",21600456,21657260,56804
"7065","ENSGALG00000014787","Z",21885739,21906410,20671
"7066","ENSGALG00000014788","Z",21910292,21917147,6855
"7067","ENSGALG00000014789","Z",21916343,21924487,8144
"7068","ENSGALG00000014790","Z",21927561,21950303,22742
"7069","ENSGALG00000014791","1",79884289,79906621,22332
"7070","ENSGALG00000014793","2",100491423,100845080,353657
"7071","ENSGALG00000014794","1",79906673,79928553,21880
"7072","ENSGALG00000014795","2",100818249,100826684,8435
"7073","ENSGALG00000014798","Z",21970233,22007388,37155
"7074","ENSGALG00000014799","2",101191146,101207940,16794
"7075","ENSGALG00000014800","1",79969020,79998068,29048
"7076","ENSGALG00000014801","2",101172292,101191007,18715
"7077","ENSGALG00000014804","Z",22015511,22053757,38246
"7078","ENSGALG00000014807","Z",22058070,22068952,10882
"7079","ENSGALG00000014810","Z",22175870,22214446,38576
"7080","ENSGALG00000014811","2",101090869,101163136,72267
"7081","ENSGALG00000014812","1",80053840,80093005,39165
"7082","ENSGALG00000014813","Z",22241850,22331531,89681
"7083","ENSGALG00000014818","1",80132983,80149686,16703
"7084","ENSGALG00000014819","Z",22345907,22404480,58573
"7085","ENSGALG00000014820","1",80157630,80163043,5413
"7086","ENSGALG00000014821","3",59052743,59130068,77325
"7087","ENSGALG00000014824","Z",12839346,12850017,10671
"7088","ENSGALG00000014826","Z",12854252,12891679,37427
"7089","ENSGALG00000014828","3",59266598,59303456,36858
"7090","ENSGALG00000014831","3",59770898,59817269,46371
"7091","ENSGALG00000014832","Z",12893076,12913153,20077
"7092","ENSGALG00000014833","Z",12917710,12920908,3198
"7093","ENSGALG00000014834","3",59835089,59902821,67732
"7094","ENSGALG00000014835","Z",12908352,12956390,48038
"7095","ENSGALG00000014836","2",100992993,101029049,36056
"7096","ENSGALG00000014840","Z",12966092,12991491,25399
"7097","ENSGALG00000014841","3",60103490,60136557,33067
"7098","ENSGALG00000014843","3",60138294,60190411,52117
"7099","ENSGALG00000014845","Z",13020833,13110955,90122
"7100","ENSGALG00000014846","Z",13176241,13262529,86288
"7101","ENSGALG00000014847","2",100908841,100986444,77603
"7102","ENSGALG00000014848","3",60899753,60939705,39952
"7103","ENSGALG00000014851","Z",13276864,13286540,9676
"7104","ENSGALG00000014853","3",61157421,61206950,49529
"7105","ENSGALG00000014854","2",100880899,100889848,8949
"7106","ENSGALG00000014855","Z",13428369,13558411,130042
"7107","ENSGALG00000014857","Z",13587893,13596605,8712
"7108","ENSGALG00000014858","2",101835010,101839411,4401
"7109","ENSGALG00000014859","Z",13611180,13627548,16368
"7110","ENSGALG00000014860","2",101881311,101930571,49260
"7111","ENSGALG00000014862","Z",13647830,13665258,17428
"7112","ENSGALG00000014863","Z",13697683,13710190,12507
"7113","ENSGALG00000014865","Z",13710211,13721555,11344
"7114","ENSGALG00000014867","Z",13710579,13744178,33599
"7115","ENSGALG00000014868","3",61372227,61386774,14547
"7116","ENSGALG00000014869","Z",13746657,13788556,41899
"7117","ENSGALG00000014872","Z",13972677,14032776,60099
"7118","ENSGALG00000014873","3",61829237,61838470,9233
"7119","ENSGALG00000014875","Z",14409335,14603955,194620
"7120","ENSGALG00000014876","3",61886381,61968901,82520
"7121","ENSGALG00000014877","Z",14736634,14761209,24575
"7122","ENSGALG00000014878","3",62548908,62691253,142345
"7123","ENSGALG00000014880","Z",14799199,14906049,106850
"7124","ENSGALG00000014881","3",62755347,62817307,61960
"7125","ENSGALG00000014883","3",62823583,62869644,46061
"7126","ENSGALG00000014884","Z",15144193,15155463,11270
"7127","ENSGALG00000014887","3",62844061,62855425,11364
"7128","ENSGALG00000014891","Z",15771673,15844372,72699
"7129","ENSGALG00000014892","3",62906921,63044317,137396
"7130","ENSGALG00000014897","2",101942208,101949734,7526
"7131","ENSGALG00000014899","3",63296036,63310724,14688
"7132","ENSGALG00000014900","3",63284010,63293892,9882
"7133","ENSGALG00000014901","1",80198363,80208691,10328
"7134","ENSGALG00000014902","3",63246984,63274664,27680
"7135","ENSGALG00000014903","Z",15862431,15924311,61880
"7136","ENSGALG00000014904","2",101952738,101965088,12350
"7137","ENSGALG00000014906","Z",15932055,15940610,8555
"7138","ENSGALG00000014907","3",63189791,63235852,46061
"7139","ENSGALG00000014908","Z",16072541,16079179,6638
"7140","ENSGALG00000014910","2",102015734,102109014,93280
"7141","ENSGALG00000014911","Z",16201009,16414354,213345
"7142","ENSGALG00000014913","3",63103068,63175476,72408
"7143","ENSGALG00000014914","Z",16452909,16470302,17393
"7144","ENSGALG00000014915","2",102126864,102147220,20356
"7145","ENSGALG00000014916","Z",43184133,43259306,75173
"7146","ENSGALG00000014917","3",63086092,63091470,5378
"7147","ENSGALG00000014918","3",63709871,63742912,33041
"7148","ENSGALG00000014920","2",102148239,102165595,17356
"7149","ENSGALG00000014922","2",102170492,102246911,76419
"7150","ENSGALG00000014923","Z",24570156,24702274,132118
"7151","ENSGALG00000014924","1",80209348,80265753,56405
"7152","ENSGALG00000014925","3",63761182,63771757,10575
"7153","ENSGALG00000014930","Z",24273701,24275470,1769
"7154","ENSGALG00000014931","4",77442948,77504384,61436
"7155","ENSGALG00000014933","Z",24225243,24240761,15518
"7156","ENSGALG00000014934","4",78033714,78044776,11062
"7157","ENSGALG00000014935","2",102336920,102408052,71132
"7158","ENSGALG00000014936","2",102411150,102436061,24911
"7159","ENSGALG00000014937","3",63782064,63799496,17432
"7160","ENSGALG00000014938","2",102443796,102465867,22071
"7161","ENSGALG00000014939","Z",24207082,24224343,17261
"7162","ENSGALG00000014940","3",63799081,63805160,6079
"7163","ENSGALG00000014942","Z",24202516,24206407,3891
"7164","ENSGALG00000014943","Z",24164781,24196348,31567
"7165","ENSGALG00000014944","Z",24089346,24107538,18192
"7166","ENSGALG00000014948","Z",24007165,24025406,18241
"7167","ENSGALG00000014949","1",80556280,80569250,12970
"7168","ENSGALG00000014950","3",63813421,63820420,6999
"7169","ENSGALG00000014952","Z",23905299,23977323,72024
"7170","ENSGALG00000014953","3",63823638,63834723,11085
"7171","ENSGALG00000014954","4",78250796,78254035,3239
"7172","ENSGALG00000014956","Z",23872229,23901554,29325
"7173","ENSGALG00000014957","4",78304219,78340393,36174
"7174","ENSGALG00000014958","Z",23843817,23867162,23345
"7175","ENSGALG00000014960","Z",23821153,23844219,23066
"7176","ENSGALG00000014962","3",63868068,63871243,3175
"7177","ENSGALG00000014963","3",63884722,63905439,20717
"7178","ENSGALG00000014964","3",63927963,64048903,120940
"7179","ENSGALG00000014965","3",64024537,64031213,6676
"7180","ENSGALG00000014966","1",80581691,80599590,17899
"7181","ENSGALG00000014967","Z",23595088,23689449,94361
"7182","ENSGALG00000014970","1",80650200,80694243,44043
"7183","ENSGALG00000014971","4",78383025,78453860,70835
"7184","ENSGALG00000014973","1",80723913,80731661,7748
"7185","ENSGALG00000014974","2",102477248,102545888,68640
"7186","ENSGALG00000014975","4",78488493,78491401,2908
"7187","ENSGALG00000014976","2",102638198,102654114,15916
"7188","ENSGALG00000014977","1",80750811,80886512,135701
"7189","ENSGALG00000014978","Z",23461532,23577608,116076
"7190","ENSGALG00000014979","3",64064317,64109976,45659
"7191","ENSGALG00000014980","1",80915820,80927454,11634
"7192","ENSGALG00000014981","1",80938546,80940510,1964
"7193","ENSGALG00000014982","2",102827327,102859258,31931
"7194","ENSGALG00000014983","Z",23447817,23454784,6967
"7195","ENSGALG00000014984","Z",23413354,23422556,9202
"7196","ENSGALG00000014988","1",80944283,80954049,9766
"7197","ENSGALG00000014989","Z",23387539,23392421,4882
"7198","ENSGALG00000014991","3",64830915,64853226,22311
"7199","ENSGALG00000014992","4",78514011,78519656,5645
"7200","ENSGALG00000014994","Z",23367125,23375581,8456
"7201","ENSGALG00000014995","Z",25517804,25583080,65276
"7202","ENSGALG00000014997","1",80955255,80972874,17619
"7203","ENSGALG00000014998","2",102922659,102951590,28931
"7204","ENSGALG00000014999","Z",25324362,25392656,68294
"7205","ENSGALG00000015000","4",78530750,78538243,7493
"7206","ENSGALG00000015001","3",65714396,65810805,96409
"7207","ENSGALG00000015002","Z",25266792,25313284,46492
"7208","ENSGALG00000015004","2",103020626,103032224,11598
"7209","ENSGALG00000015006","1",81097708,81108336,10628
"7210","ENSGALG00000015008","Z",25197569,25213519,15950
"7211","ENSGALG00000015009","4",78538304,78555906,17602
"7212","ENSGALG00000015010","4",78573670,78595712,22042
"7213","ENSGALG00000015012","4",78594505,78650996,56491
"7214","ENSGALG00000015013","4",78805627,78808134,2507
"7215","ENSGALG00000015014","Z",25036411,25112335,75924
"7216","ENSGALG00000015015","4",78878821,78881513,2692
"7217","ENSGALG00000015016","1",81130221,81161028,30807
"7218","ENSGALG00000015017","3",65815544,65827995,12451
"7219","ENSGALG00000015018","1",81232635,81309584,76949
"7220","ENSGALG00000015019","Z",24956185,25022351,66166
"7221","ENSGALG00000015020","Z",24901868,24918432,16564
"7222","ENSGALG00000015021","Z",24897185,24901681,4496
"7223","ENSGALG00000015022","3",65946996,66021357,74361
"7224","ENSGALG00000015024","Z",27481209,27515273,34064
"7225","ENSGALG00000015025","1",81276492,81306906,30414
"7226","ENSGALG00000015026","3",66029757,66056035,26278
"7227","ENSGALG00000015027","Z",27532087,27615380,83293
"7228","ENSGALG00000015028","Z",27624861,27627531,2670
"7229","ENSGALG00000015029","4",79084298,79147207,62909
"7230","ENSGALG00000015030","2",103049116,103074569,25453
"7231","ENSGALG00000015032","Z",27663890,27681451,17561
"7232","ENSGALG00000015033","3",66086797,66200963,114166
"7233","ENSGALG00000015034","2",103083312,103114057,30745
"7234","ENSGALG00000015036","Z",27712512,27762665,50153
"7235","ENSGALG00000015037","4",79147283,79199619,52336
"7236","ENSGALG00000015038","1",81317906,81339566,21660
"7237","ENSGALG00000015040","3",66217809,66280609,62800
"7238","ENSGALG00000015044","3",66312756,66318181,5425
"7239","ENSGALG00000015045","Z",27800576,27810305,9729
"7240","ENSGALG00000015050","Z",27824458,27886360,61902
"7241","ENSGALG00000015051","3",66377571,66490935,113364
"7242","ENSGALG00000015052","Z",27945244,28026717,81473
"7243","ENSGALG00000015053","Z",28030060,28068079,38019
"7244","ENSGALG00000015055","3",66523052,66554168,31116
"7245","ENSGALG00000015056","2",103119354,103231680,112326
"7246","ENSGALG00000015057","3",66560138,66566914,6776
"7247","ENSGALG00000015058","Z",28784783,29141409,356626
"7248","ENSGALG00000015059","1",81342003,81357144,15141
"7249","ENSGALG00000015061","3",66629521,66666402,36881
"7250","ENSGALG00000015064","2",103247556,103279094,31538
"7251","ENSGALG00000015066","3",66714941,66745219,30278
"7252","ENSGALG00000015068","3",66764729,66766028,1299
"7253","ENSGALG00000015069","1",81391656,81407632,15976
"7254","ENSGALG00000015070","3",66793642,66860116,66474
"7255","ENSGALG00000015071","Z",34160694,34260169,99475
"7256","ENSGALG00000015073","1",81358311,81383483,25172
"7257","ENSGALG00000015075","1",81425204,81452490,27286
"7258","ENSGALG00000015077","1",81531508,81551013,19505
"7259","ENSGALG00000015078","Z",34030516,34141730,111214
"7260","ENSGALG00000015079","1",81562063,81573670,11607
"7261","ENSGALG00000015080","Z",33788816,33891677,102861
"7262","ENSGALG00000015081","Z",33744116,33762006,17890
"7263","ENSGALG00000015082","Z",33736390,33740880,4490
"7264","ENSGALG00000015083","Z",33679379,33729221,49842
"7265","ENSGALG00000015084","1",81625126,81711797,86671
"7266","ENSGALG00000015086","2",103288644,103359526,70882
"7267","ENSGALG00000015089","1",83026159,83080167,54008
"7268","ENSGALG00000015090","Z",33602917,33617017,14100
"7269","ENSGALG00000015091","Z",33585614,33602478,16864
"7270","ENSGALG00000015093","2",103371899,103389986,18087
"7271","ENSGALG00000015094","1",83692165,83698118,5953
"7272","ENSGALG00000015096","Z",32971787,33062636,90849
"7273","ENSGALG00000015101","Z",32350839,32692210,341371
"7274","ENSGALG00000015103","Z",31978142,32207290,229148
"7275","ENSGALG00000015105","Z",31937116,31971222,34106
"7276","ENSGALG00000015107","Z",34485673,34580466,94793
"7277","ENSGALG00000015108","Z",34582882,34592944,10062
"7278","ENSGALG00000015109","Z",34597386,34662316,64930
"7279","ENSGALG00000015110","Z",34698424,34709646,11222
"7280","ENSGALG00000015111","Z",34714860,34792783,77923
"7281","ENSGALG00000015112","2",103577193,103841408,264215
"7282","ENSGALG00000015113","Z",34812638,34839726,27088
"7283","ENSGALG00000015115","Z",34893638,34957995,64357
"7284","ENSGALG00000015117","1",83745457,83755386,9929
"7285","ENSGALG00000015118","Z",34965606,35020664,55058
"7286","ENSGALG00000015119","2",104083432,104126238,42806
"7287","ENSGALG00000015122","2",104150943,104221821,70878
"7288","ENSGALG00000015123","1",83805906,83813150,7244
"7289","ENSGALG00000015124","2",104251195,104316535,65340
"7290","ENSGALG00000015126","Z",35092121,35350353,258232
"7291","ENSGALG00000015128","2",104436841,104447519,10678
"7292","ENSGALG00000015132","2",104786041,104900468,114427
"7293","ENSGALG00000015133","1",84316703,84317788,1085
"7294","ENSGALG00000015134","1",84330787,84333931,3144
"7295","ENSGALG00000015136","1",84338733,84353225,14492
"7296","ENSGALG00000015138","Z",35550979,35630494,79515
"7297","ENSGALG00000015140","2",105940768,105962020,21252
"7298","ENSGALG00000015141","Z",35688721,35713819,25098
"7299","ENSGALG00000015142","2",106086315,106107525,21210
"7300","ENSGALG00000015143","2",106129430,106138301,8871
"7301","ENSGALG00000015144","Z",35747523,35762090,14567
"7302","ENSGALG00000015145","Z",35819526,35878296,58770
"7303","ENSGALG00000015147","Z",35905444,35958334,52890
"7304","ENSGALG00000015148","Z",36034182,36052126,17944
"7305","ENSGALG00000015150","Z",36554623,36687861,133238
"7306","ENSGALG00000015151","2",106147108,106171103,23995
"7307","ENSGALG00000015152","1",84399987,84443291,43304
"7308","ENSGALG00000015153","2",106222683,106258773,36090
"7309","ENSGALG00000015154","Z",36720674,36812329,91655
"7310","ENSGALG00000015155","Z",36823857,36845893,22036
"7311","ENSGALG00000015156","Z",36846475,36855645,9170
"7312","ENSGALG00000015157","2",106275249,106324274,49025
"7313","ENSGALG00000015163","2",106346463,106353655,7192
"7314","ENSGALG00000015166","Z",37363154,37376174,13020
"7315","ENSGALG00000015167","Z",37409069,37540076,131007
"7316","ENSGALG00000015170","Z",37613636,37716285,102649
"7317","ENSGALG00000015172","1",84500925,84518713,17788
"7318","ENSGALG00000015176","Z",37721342,37726001,4659
"7319","ENSGALG00000015177","Z",37796494,37913443,116949
"7320","ENSGALG00000015179","Z",37947914,37969665,21751
"7321","ENSGALG00000015180","Z",37974730,37990032,15302
"7322","ENSGALG00000015181","2",106409990,106508279,98289
"7323","ENSGALG00000015182","1",84518158,84523562,5404
"7324","ENSGALG00000015183","2",106515195,106545790,30595
"7325","ENSGALG00000015184","Z",38482984,38580242,97258
"7326","ENSGALG00000015185","1",84523342,84526837,3495
"7327","ENSGALG00000015190","1",84528015,84532502,4487
"7328","ENSGALG00000015191","1",84536001,84540607,4606
"7329","ENSGALG00000015193","1",84661651,84685255,23604
"7330","ENSGALG00000015195","28",3300429,3302247,1818
"7331","ENSGALG00000015196","2",106885853,107013873,128020
"7332","ENSGALG00000015197","1",84688230,84701091,12861
"7333","ENSGALG00000015198","2",107062555,107248585,186030
"7334","ENSGALG00000015200","28",3273460,3298759,25299
"7335","ENSGALG00000015203","28",3254654,3257628,2974
"7336","ENSGALG00000015204","1",84701318,84724935,23617
"7337","ENSGALG00000015208","Z",44480987,44631748,150761
"7338","ENSGALG00000015209","Z",44356123,44369961,13838
"7339","ENSGALG00000015211","2",107360212,107534708,174496
"7340","ENSGALG00000015213","Z",44133295,44137277,3982
"7341","ENSGALG00000015215","2",107572271,107654002,81731
"7342","ENSGALG00000015216","Z",44075509,44125480,49971
"7343","ENSGALG00000015218","1",84778681,84788885,10204
"7344","ENSGALG00000015219","2",107656418,107705493,49075
"7345","ENSGALG00000015221","1",84792952,84802664,9712
"7346","ENSGALG00000015224","3",66860920,66900003,39083
"7347","ENSGALG00000015225","1",84803475,84810188,6713
"7348","ENSGALG00000015226","2",107710840,107910331,199491
"7349","ENSGALG00000015230","1",84810190,84899752,89562
"7350","ENSGALG00000015231","3",66916714,66925265,8551
"7351","ENSGALG00000015233","1",84899572,84913575,14003
"7352","ENSGALG00000015234","2",108097150,108147488,50338
"7353","ENSGALG00000015235","1",85121273,85126277,5004
"7354","ENSGALG00000015237","3",66931886,66940954,9068
"7355","ENSGALG00000015240","1",85287225,85295598,8373
"7356","ENSGALG00000015244","1",85209232,85223485,14253
"7357","ENSGALG00000015246","1",85240431,85248944,8513
"7358","ENSGALG00000015247","1",85247196,85258715,11519
"7359","ENSGALG00000015248","2",108764816,109090785,325969
"7360","ENSGALG00000015249","1",85262293,85275930,13637
"7361","ENSGALG00000015252","1",85336671,85378990,42319
"7362","ENSGALG00000015253","1",85383662,85470351,86689
"7363","ENSGALG00000015254","2",109572158,109745154,172996
"7364","ENSGALG00000015256","Z",50129168,50258002,128834
"7365","ENSGALG00000015257","Z",50108930,50122328,13398
"7366","ENSGALG00000015258","1",85657472,85699919,42447
"7367","ENSGALG00000015259","2",109935359,110008388,73029
"7368","ENSGALG00000015261","2",110084486,110087007,2521
"7369","ENSGALG00000015263","1",85710579,85718966,8387
"7370","ENSGALG00000015264","Z",50057859,50100505,42646
"7371","ENSGALG00000015267","1",85718934,85945887,226953
"7372","ENSGALG00000015268","Z",49944419,49957118,12699
"7373","ENSGALG00000015269","2",110144374,110165360,20986
"7374","ENSGALG00000015271","1",85910572,85928953,18381
"7375","ENSGALG00000015273","1",85946022,85977162,31140
"7376","ENSGALG00000015274","2",110336672,110362086,25414
"7377","ENSGALG00000015275","1",85978411,85985291,6880
"7378","ENSGALG00000015283","3",67051451,67074362,22911
"7379","ENSGALG00000015284","Z",51422920,51434686,11766
"7380","ENSGALG00000015285","1",85989575,86010298,20723
"7381","ENSGALG00000015286","3",67074926,67146996,72070
"7382","ENSGALG00000015287","1",86009787,86023732,13945
"7383","ENSGALG00000015288","Z",51623297,51635725,12428
"7384","ENSGALG00000015289","3",67151293,67212997,61704
"7385","ENSGALG00000015290","Z",51637861,51667970,30109
"7386","ENSGALG00000015293","1",86036845,86054389,17544
"7387","ENSGALG00000015294","1",86063936,86086125,22189
"7388","ENSGALG00000015297","3",67292563,67374494,81931
"7389","ENSGALG00000015299","1",86088878,86107419,18541
"7390","ENSGALG00000015301","Z",51686031,51736428,50397
"7391","ENSGALG00000015303","3",67391076,67462006,70930
"7392","ENSGALG00000015304","3",67467464,67489909,22445
"7393","ENSGALG00000015305","3",67490385,67505356,14971
"7394","ENSGALG00000015306","3",67542264,67553225,10961
"7395","ENSGALG00000015307","1",86150625,86219278,68653
"7396","ENSGALG00000015308","3",67569468,67623854,54386
"7397","ENSGALG00000015311","Z",52053817,52075093,21276
"7398","ENSGALG00000015313","3",67850522,67962399,111877
"7399","ENSGALG00000015314","3",67984758,67993302,8544
"7400","ENSGALG00000015315","Z",52089154,52096585,7431
"7401","ENSGALG00000015316","3",67999790,68003969,4179
"7402","ENSGALG00000015320","Z",52098369,52107270,8901
"7403","ENSGALG00000015322","1",86333855,86382748,48893
"7404","ENSGALG00000015324","1",86425648,86430040,4392
"7405","ENSGALG00000015326","Z",52125584,52140386,14802
"7406","ENSGALG00000015327","1",86429694,86436587,6893
"7407","ENSGALG00000015328","1",86432580,86435687,3107
"7408","ENSGALG00000015330","1",86436740,86446300,9560
"7409","ENSGALG00000015331","Z",52144197,52181378,37181
"7410","ENSGALG00000015332","Z",52349944,52449580,99636
"7411","ENSGALG00000015333","Z",52701915,52751686,49771
"7412","ENSGALG00000015334","1",86451332,86456704,5372
"7413","ENSGALG00000015336","Z",52823800,52882099,58299
"7414","ENSGALG00000015338","3",68101830,68113781,11951
"7415","ENSGALG00000015339","1",86469530,86473519,3989
"7416","ENSGALG00000015340","2",111084380,111107118,22738
"7417","ENSGALG00000015342","1",86479995,86486708,6713
"7418","ENSGALG00000015343","3",68113880,68149493,35613
"7419","ENSGALG00000015344","1",86495572,86513442,17870
"7420","ENSGALG00000015345","3",68161619,68200435,38816
"7421","ENSGALG00000015346","1",86521572,86537922,16350
"7422","ENSGALG00000015347","1",86683391,86712815,29424
"7423","ENSGALG00000015348","1",87615066,87731006,115940
"7424","ENSGALG00000015349","Z",53306523,53415783,109260
"7425","ENSGALG00000015351","1",87757880,87881272,123392
"7426","ENSGALG00000015352","Z",53457178,53473680,16502
"7427","ENSGALG00000015353","1",88325470,88449177,123707
"7428","ENSGALG00000015355","1",88694160,88714875,20715
"7429","ENSGALG00000015356","1",88731807,88749184,17377
"7430","ENSGALG00000015358","1",88760863,88804642,43779
"7431","ENSGALG00000015360","1",88827762,88854919,27157
"7432","ENSGALG00000015362","1",88912485,88924526,12041
"7433","ENSGALG00000015363","1",88927960,88942320,14360
"7434","ENSGALG00000015364","1",88956754,88981453,24699
"7435","ENSGALG00000015366","Z",53526319,53554762,28443
"7436","ENSGALG00000015367","1",89486875,89545180,58305
"7437","ENSGALG00000015368","Z",53554422,53568090,13668
"7438","ENSGALG00000015372","Z",53568962,53570888,1926
"7439","ENSGALG00000015373","Z",53575086,53596769,21683
"7440","ENSGALG00000015374","Z",53612274,53617623,5349
"7441","ENSGALG00000015375","1",89665094,89684871,19777
"7442","ENSGALG00000015376","Z",53619590,53666667,47077
"7443","ENSGALG00000015377","1",89725242,89805852,80610
"7444","ENSGALG00000015378","1",89812172,89817466,5294
"7445","ENSGALG00000015379","1",89826120,89837361,11241
"7446","ENSGALG00000015382","Z",53688052,53697089,9037
"7447","ENSGALG00000015384","Z",53701403,53711316,9913
"7448","ENSGALG00000015385","Z",53725276,53729213,3937
"7449","ENSGALG00000015386","Z",53756951,53770500,13549
"7450","ENSGALG00000015387","3",68246858,68320347,73489
"7451","ENSGALG00000015388","3",68350477,68445504,95027
"7452","ENSGALG00000015389","1",89861241,89885047,23806
"7453","ENSGALG00000015390","Z",53790696,53848912,58216
"7454","ENSGALG00000015391","Z",53860971,53914442,53471
"7455","ENSGALG00000015395","1",89959483,89966753,7270
"7456","ENSGALG00000015396","1",89972837,89985759,12922
"7457","ENSGALG00000015397","Z",53927813,53937732,9919
"7458","ENSGALG00000015399","Z",53942652,53953359,10707
"7459","ENSGALG00000015400","1",90031206,90034767,3561
"7460","ENSGALG00000015402","1",90073522,90080670,7148
"7461","ENSGALG00000015403","1",90418011,90635463,217452
"7462","ENSGALG00000015404","2",111182778,111199494,16716
"7463","ENSGALG00000015405","3",68717965,68811461,93496
"7464","ENSGALG00000015407","2",111237295,111284428,47133
"7465","ENSGALG00000015409","1",91099246,91130574,31328
"7466","ENSGALG00000015410","3",68858596,68885270,26674
"7467","ENSGALG00000015412","1",91130619,91178356,47737
"7468","ENSGALG00000015413","1",91145013,91160961,15948
"7469","ENSGALG00000015414","1",91182435,91202043,19608
"7470","ENSGALG00000015415","3",69023777,69068018,44241
"7471","ENSGALG00000015416","2",111306864,111320818,13954
"7472","ENSGALG00000015418","1",92512977,92617903,104926
"7473","ENSGALG00000015419","2",111379997,111384344,4347
"7474","ENSGALG00000015422","Z",54043441,54141518,98077
"7475","ENSGALG00000015425","Z",54612204,54628981,16777
"7476","ENSGALG00000015428","Z",54674450,54716862,42412
"7477","ENSGALG00000015433","Z",54811100,54902450,91350
"7478","ENSGALG00000015434","3",70157498,70521359,363861
"7479","ENSGALG00000015435","1",92869586,92913017,43431
"7480","ENSGALG00000015436","2",112049920,112062668,12748
"7481","ENSGALG00000015437","1",92913598,92920427,6829
"7482","ENSGALG00000015438","1",92933089,92944816,11727
"7483","ENSGALG00000015439","Z",55002761,55066931,64170
"7484","ENSGALG00000015441","1",93019252,93065622,46370
"7485","ENSGALG00000015442","Z",55093602,55122344,28742
"7486","ENSGALG00000015443","Z",55127487,55146261,18774
"7487","ENSGALG00000015446","1",93077757,93187518,109761
"7488","ENSGALG00000015450","2",112818627,112860948,42321
"7489","ENSGALG00000015451","Z",55574822,55632691,57869
"7490","ENSGALG00000015453","1",93210808,93219627,8819
"7491","ENSGALG00000015458","1",93259644,93288991,29347
"7492","ENSGALG00000015459","1",93298035,93302853,4818
"7493","ENSGALG00000015461","1",93327859,93348148,20289
"7494","ENSGALG00000015464","1",93435286,93470481,35195
"7495","ENSGALG00000015465","3",70672876,70939143,266267
"7496","ENSGALG00000015466","3",70959454,70999506,40052
"7497","ENSGALG00000015468","3",71425492,71428784,3292
"7498","ENSGALG00000015471","3",71405148,71422998,17850
"7499","ENSGALG00000015473","1",93651767,93662293,10526
"7500","ENSGALG00000015474","1",93674849,93698837,23988
"7501","ENSGALG00000015478","3",71429787,71482168,52381
"7502","ENSGALG00000015480","1",93705780,93721328,15548
"7503","ENSGALG00000015483","3",71486522,71511444,24922
"7504","ENSGALG00000015485","1",93810698,93817896,7198
"7505","ENSGALG00000015486","3",71514528,71520267,5739
"7506","ENSGALG00000015488","1",93889971,93891173,1202
"7507","ENSGALG00000015489","3",71527144,71544385,17241
"7508","ENSGALG00000015490","3",71678603,71732006,53403
"7509","ENSGALG00000015491","1",93900144,93923220,23076
"7510","ENSGALG00000015492","1",93917559,93930207,12648
"7511","ENSGALG00000015494","1",93982791,93983891,1100
"7512","ENSGALG00000015495","1",94257934,94273544,15610
"7513","ENSGALG00000015496","1",94275062,94287484,12422
"7514","ENSGALG00000015497","1",94356495,94376726,20231
"7515","ENSGALG00000015511","1",97569877,97995865,425988
"7516","ENSGALG00000015513","3",72435233,72521377,86144
"7517","ENSGALG00000015517","3",72530453,72641635,111182
"7518","ENSGALG00000015519","1",98288159,98697579,409420
"7519","ENSGALG00000015528","4",79331087,79416639,85552
"7520","ENSGALG00000015529","4",79483567,79516954,33387
"7521","ENSGALG00000015531","4",79530610,79704158,173548
"7522","ENSGALG00000015537","4",79706434,79733872,27438
"7523","ENSGALG00000015538","4",79788886,79853583,64697
"7524","ENSGALG00000015540","Z",55711213,55747828,36615
"7525","ENSGALG00000015542","Z",65341946,65469193,127247
"7526","ENSGALG00000015543","Z",65339780,65340558,778
"7527","ENSGALG00000015544","Z",65311685,65338122,26437
"7528","ENSGALG00000015546","4",79859920,79922039,62119
"7529","ENSGALG00000015547","4",79928316,79930707,2391
"7530","ENSGALG00000015548","Z",65283629,65332020,48391
"7531","ENSGALG00000015549","4",79935260,79941880,6620
"7532","ENSGALG00000015551","Z",65210349,65277593,67244
"7533","ENSGALG00000015554","4",79986601,80511445,524844
"7534","ENSGALG00000015556","4",80530710,80589183,58473
"7535","ENSGALG00000015568","4",80793977,80825261,31284
"7536","ENSGALG00000015570","3",72720696,72721955,1259
"7537","ENSGALG00000015571","Z",64369091,64385471,16380
"7538","ENSGALG00000015572","Z",64356341,64364473,8132
"7539","ENSGALG00000015573","3",72780194,72808323,28129
"7540","ENSGALG00000015576","Z",64322900,64352145,29245
"7541","ENSGALG00000015577","Z",64297349,64305700,8351
"7542","ENSGALG00000015580","3",72810901,72832528,21627
"7543","ENSGALG00000015589","Z",64140404,64257195,116791
"7544","ENSGALG00000015590","3",73174355,73186779,12424
"7545","ENSGALG00000015591","4",80933353,80968494,35141
"7546","ENSGALG00000015593","3",73911004,74054520,143516
"7547","ENSGALG00000015594","4",80968536,80981295,12759
"7548","ENSGALG00000015595","4",81142872,81147963,5091
"7549","ENSGALG00000015596","3",75083923,75132422,48499
"7550","ENSGALG00000015598","Z",63986799,64109277,122478
"7551","ENSGALG00000015599","4",81401297,81403526,2229
"7552","ENSGALG00000015602","Z",63955273,63976950,21677
"7553","ENSGALG00000015603","Z",63940607,63946893,6286
"7554","ENSGALG00000015605","3",75307454,75404609,97155
"7555","ENSGALG00000015608","4",81576968,81578308,1340
"7556","ENSGALG00000015609","4",81613402,81613926,524
"7557","ENSGALG00000015611","3",75427685,75445754,18069
"7558","ENSGALG00000015612","4",81846608,81856078,9470
"7559","ENSGALG00000015615","4",81911075,81926188,15113
"7560","ENSGALG00000015616","Z",63906538,63937293,30755
"7561","ENSGALG00000015617","Z",63563409,63565254,1845
"7562","ENSGALG00000015618","Z",63542055,63557854,15799
"7563","ENSGALG00000015620","Z",62992672,63173370,180698
"7564","ENSGALG00000015623","4",81930559,81966939,36380
"7565","ENSGALG00000015624","Z",62855240,62961099,105859
"7566","ENSGALG00000015626","4",81997699,82036497,38798
"7567","ENSGALG00000015627","Z",62725137,62818255,93118
"7568","ENSGALG00000015628","4",82077210,82093294,16084
"7569","ENSGALG00000015630","Z",62363362,62692551,329189
"7570","ENSGALG00000015635","4",82134637,82208291,73654
"7571","ENSGALG00000015641","Z",61202799,61212577,9778
"7572","ENSGALG00000015645","4",82215228,82245582,30354
"7573","ENSGALG00000015649","4",82245802,82267166,21364
"7574","ENSGALG00000015652","4",82270627,82295317,24690
"7575","ENSGALG00000015656","Z",65797112,66041637,244525
"7576","ENSGALG00000015660","Z",66066126,66115305,49179
"7577","ENSGALG00000015662","1",99391578,99407800,16222
"7578","ENSGALG00000015663","Z",66228725,66241158,12433
"7579","ENSGALG00000015664","4",82295739,82352947,57208
"7580","ENSGALG00000015665","4",82359242,82394778,35536
"7581","ENSGALG00000015666","4",82441244,82449180,7936
"7582","ENSGALG00000015667","4",82499070,82523353,24283
"7583","ENSGALG00000015669","Z",66269978,66319837,49859
"7584","ENSGALG00000015675","1",99421122,99454742,33620
"7585","ENSGALG00000015677","Z",66362196,66399087,36891
"7586","ENSGALG00000015681","1",99699127,99764877,65750
"7587","ENSGALG00000015682","Z",66458648,66484239,25591
"7588","ENSGALG00000015683","Z",66590950,66596998,6048
"7589","ENSGALG00000015684","Z",66601376,66607870,6494
"7590","ENSGALG00000015685","4",82596511,82644224,47713
"7591","ENSGALG00000015687","4",82748159,82785178,37019
"7592","ENSGALG00000015688","4",82843121,82879154,36033
"7593","ENSGALG00000015689","Z",66608737,66666770,58033
"7594","ENSGALG00000015691","Z",66668700,66692579,23879
"7595","ENSGALG00000015692","4",82914479,82979265,64786
"7596","ENSGALG00000015693","1",99983468,100073181,89713
"7597","ENSGALG00000015699","4",83173167,83196460,23293
"7598","ENSGALG00000015701","1",100685485,100716977,31492
"7599","ENSGALG00000015702","Z",66692894,66712751,19857
"7600","ENSGALG00000015704","Z",66723956,66729464,5508
"7601","ENSGALG00000015705","4",83217917,83228766,10849
"7602","ENSGALG00000015706","4",83316611,83339735,23124
"7603","ENSGALG00000015708","4",83408777,83460342,51565
"7604","ENSGALG00000015709","4",83883600,83903849,20249
"7605","ENSGALG00000015710","4",83906907,83914273,7366
"7606","ENSGALG00000015712","4",83930355,83937106,6751
"7607","ENSGALG00000015713","4",83971307,84040349,69042
"7608","ENSGALG00000015720","1",100912368,100941544,29176
"7609","ENSGALG00000015721","Z",66748440,66871680,123240
"7610","ENSGALG00000015722","4",84902870,84908132,5262
"7611","ENSGALG00000015728","Z",66921865,66966158,44293
"7612","ENSGALG00000015729","Z",67015030,67081222,66192
"7613","ENSGALG00000015733","3",75447370,75541229,93859
"7614","ENSGALG00000015737","1",102077385,102329583,252198
"7615","ENSGALG00000015742","1",103804015,103813504,9489
"7616","ENSGALG00000015746","1",103822633,103856294,33661
"7617","ENSGALG00000015751","1",103855858,103860617,4759
"7618","ENSGALG00000015753","Z",67243630,67276948,33318
"7619","ENSGALG00000015754","Z",67290504,67291211,707
"7620","ENSGALG00000015762","3",75541476,75544276,2800
"7621","ENSGALG00000015763","1",103860753,103890491,29738
"7622","ENSGALG00000015768","3",75547294,75651254,103960
"7623","ENSGALG00000015770","1",103922338,104122132,199794
"7624","ENSGALG00000015773","4",85464568,85479658,15090
"7625","ENSGALG00000015775","3",75684051,75708805,24754
"7626","ENSGALG00000015776","3",75708979,75735202,26223
"7627","ENSGALG00000015778","3",75770652,75790286,19634
"7628","ENSGALG00000015779","3",75796307,75810677,14370
"7629","ENSGALG00000015780","3",75829783,75832053,2270
"7630","ENSGALG00000015783","4",85480276,85493124,12848
"7631","ENSGALG00000015787","3",75847300,76033360,186060
"7632","ENSGALG00000015791","3",76359719,76377160,17441
"7633","ENSGALG00000015795","1",104379620,104419315,39695
"7634","ENSGALG00000015799","Z",67625314,67708073,82759
"7635","ENSGALG00000015800","3",76380620,76418162,37542
"7636","ENSGALG00000015802","1",105292679,105296811,4132
"7637","ENSGALG00000015803","4",85573746,85600909,27163
"7638","ENSGALG00000015804","1",105298701,105326293,27592
"7639","ENSGALG00000015805","4",85603433,85607432,3999
"7640","ENSGALG00000015806","3",76418282,76450684,32402
"7641","ENSGALG00000015807","1",105326595,105330045,3450
"7642","ENSGALG00000015808","3",76451007,76467565,16558
"7643","ENSGALG00000015809","4",85608943,85626485,17542
"7644","ENSGALG00000015810","3",76468737,76481009,12272
"7645","ENSGALG00000015812","3",76505605,76508146,2541
"7646","ENSGALG00000015813","1",105332806,105350716,17910
"7647","ENSGALG00000015815","4",85631638,85652848,21210
"7648","ENSGALG00000015821","1",105351905,105363111,11206
"7649","ENSGALG00000015822","1",105378074,105407520,29446
"7650","ENSGALG00000015824","3",76586294,76603827,17533
"7651","ENSGALG00000015826","3",76631645,76632760,1115
"7652","ENSGALG00000015828","1",105444523,105470343,25820
"7653","ENSGALG00000015830","3",76882802,76907147,24345
"7654","ENSGALG00000015831","3",76920815,76968453,47638
"7655","ENSGALG00000015833","3",76970519,76992372,21853
"7656","ENSGALG00000015835","1",105503331,105582844,79513
"7657","ENSGALG00000015836","3",77469083,77515525,46442
"7658","ENSGALG00000015838","3",77520011,77538966,18955
"7659","ENSGALG00000015841","1",105751778,105752452,674
"7660","ENSGALG00000015842","1",105805720,105885857,80137
"7661","ENSGALG00000015844","1",105995337,106000048,4711
"7662","ENSGALG00000015845","3",77592090,77594215,2125
"7663","ENSGALG00000015846","3",77640791,77711585,70794
"7664","ENSGALG00000015849","3",77764330,77922710,158380
"7665","ENSGALG00000015851","3",77922673,77925855,3182
"7666","ENSGALG00000015854","3",77925881,77936295,10414
"7667","ENSGALG00000015858","3",77936596,77992089,55493
"7668","ENSGALG00000015860","3",77999441,78075125,75684
"7669","ENSGALG00000015864","3",78261639,78308481,46842
"7670","ENSGALG00000015874","3",79204850,79232930,28080
"7671","ENSGALG00000015876","3",79270155,79302116,31961
"7672","ENSGALG00000015877","3",79346708,79364073,17365
"7673","ENSGALG00000015878","3",79409441,79421209,11768
"7674","ENSGALG00000015879","1",106074483,106129164,54681
"7675","ENSGALG00000015880","3",79469956,79494820,24864
"7676","ENSGALG00000015884","1",106220400,106223709,3309
"7677","ENSGALG00000015887","1",106243613,106287385,43772
"7678","ENSGALG00000015889","3",79509049,79608704,99655
"7679","ENSGALG00000015892","3",79633587,79644162,10575
"7680","ENSGALG00000015895","3",80084761,80087769,3008
"7681","ENSGALG00000015897","3",80395515,80449179,53664
"7682","ENSGALG00000015898","3",80452926,80523317,70391
"7683","ENSGALG00000015900","4",85741367,85743715,2348
"7684","ENSGALG00000015901","3",80562641,80628792,66151
"7685","ENSGALG00000015902","4",85919110,85924985,5875
"7686","ENSGALG00000015904","3",80772707,80786201,13494
"7687","ENSGALG00000015906","3",80790621,80793955,3334
"7688","ENSGALG00000015908","3",80804845,80905035,100190
"7689","ENSGALG00000015910","3",81366477,81446191,79714
"7690","ENSGALG00000015916","3",81459037,81484756,25719
"7691","ENSGALG00000015917","3",81503064,81509231,6167
"7692","ENSGALG00000015923","3",81519740,81527377,7637
"7693","ENSGALG00000015925","3",81528332,81532592,4260
"7694","ENSGALG00000015928","3",81535223,81549339,14116
"7695","ENSGALG00000015935","4",85957982,85980747,22765
"7696","ENSGALG00000015937","4",85982308,85986038,3730
"7697","ENSGALG00000015939","4",85994262,86001997,7735
"7698","ENSGALG00000015944","3",82053379,82087597,34218
"7699","ENSGALG00000015949","3",82298027,82321213,23186
"7700","ENSGALG00000015951","3",82399479,82408639,9160
"7701","ENSGALG00000015953","4",86120205,86127415,7210
"7702","ENSGALG00000015958","4",86128674,86168138,39464
"7703","ENSGALG00000015959","3",82553530,82647722,94192
"7704","ENSGALG00000015960","4",86172874,86187864,14990
"7705","ENSGALG00000015961","4",86200311,86215802,15491
"7706","ENSGALG00000015967","4",87571874,87575381,3507
"7707","ENSGALG00000015969","3",82677497,82757736,80239
"7708","ENSGALG00000015970","3",82821169,82887349,66180
"7709","ENSGALG00000015977","4",88402221,88446642,44421
"7710","ENSGALG00000015978","4",88524793,88533950,9157
"7711","ENSGALG00000015995","4",88545151,88643132,97981
"7712","ENSGALG00000016001","4",88682845,88689142,6297
"7713","ENSGALG00000016003","4",88742558,88767126,24568
"7714","ENSGALG00000016011","1",107200537,107201298,761
"7715","ENSGALG00000016014","1",107251544,107292156,40612
"7716","ENSGALG00000016017","4",88865896,88993479,127583
"7717","ENSGALG00000016020","1",107322493,107332064,9571
"7718","ENSGALG00000016022","1",107358560,107506805,148245
"7719","ENSGALG00000016024","1",107902287,107912598,10311
"7720","ENSGALG00000016027","1",107912724,107920067,7343
"7721","ENSGALG00000016034","4",89176735,89316390,139655
"7722","ENSGALG00000016036","1",107923828,107968058,44230
"7723","ENSGALG00000016042","1",108001836,108019446,17610
"7724","ENSGALG00000016043","1",108042558,108043265,707
"7725","ENSGALG00000016044","1",108142878,108198091,55213
"7726","ENSGALG00000016047","1",108202036,108342302,140266
"7727","ENSGALG00000016050","1",108342783,108401530,58747
"7728","ENSGALG00000016052","1",108403926,108421241,17315
"7729","ENSGALG00000016053","1",108470896,108524230,53334
"7730","ENSGALG00000016054","1",108556236,108714780,158544
"7731","ENSGALG00000016055","1",108846535,108871402,24867
"7732","ENSGALG00000016058","1",108908312,109023131,114819
"7733","ENSGALG00000016059","1",109131453,109144592,13139
"7734","ENSGALG00000016062","1",109260958,109269904,8946
"7735","ENSGALG00000016065","1",109272435,109323160,50725
"7736","ENSGALG00000016067","1",109326296,109332889,6593
"7737","ENSGALG00000016070","1",109333197,109339750,6553
"7738","ENSGALG00000016086","4",89672386,89673546,1160
"7739","ENSGALG00000016088","4",89693309,89703407,10098
"7740","ENSGALG00000016089","4",89703490,89706161,2671
"7741","ENSGALG00000016094","4",89768123,89843165,75042
"7742","ENSGALG00000016098","4",89880065,90118830,238765
"7743","ENSGALG00000016102","4",90145114,90161305,16191
"7744","ENSGALG00000016105","4",90633304,90698669,65365
"7745","ENSGALG00000016124","4",37938465,37955430,16965
"7746","ENSGALG00000016125","1",109341186,109354590,13404
"7747","ENSGALG00000016127","1",109359681,109366841,7160
"7748","ENSGALG00000016128","1",109397569,109410287,12718
"7749","ENSGALG00000016132","1",109426312,109457601,31289
"7750","ENSGALG00000016138","1",109565520,110029599,464079
"7751","ENSGALG00000016140","1",110226286,110236394,10108
"7752","ENSGALG00000016142","1",110239567,110260524,20957
"7753","ENSGALG00000016144","1",110262821,110276844,14023
"7754","ENSGALG00000016147","1",110474372,110480252,5880
"7755","ENSGALG00000016148","1",110425541,110458812,33271
"7756","ENSGALG00000016154","2",147999992,148001344,1352
"7757","ENSGALG00000016157","1",110541743,110555529,13786
"7758","ENSGALG00000016164","1",110622794,110676191,53397
"7759","ENSGALG00000016165","1",110686572,110690949,4377
"7760","ENSGALG00000016169","1",110712815,110725955,13140
"7761","ENSGALG00000016173","1",110728999,110753448,24449
"7762","ENSGALG00000016174","3",83099425,83166464,67039
"7763","ENSGALG00000016176","3",83255916,83705954,450038
"7764","ENSGALG00000016183","3",85128401,85177092,48691
"7765","ENSGALG00000016185","1",110776509,110811358,34849
"7766","ENSGALG00000016186","1",110824235,110867346,43111
"7767","ENSGALG00000016187","1",110880693,110902129,21436
"7768","ENSGALG00000016191","1",110926351,110964131,37780
"7769","ENSGALG00000016196","1",111011328,111035262,23934
"7770","ENSGALG00000016198","1",111041981,111057817,15836
"7771","ENSGALG00000016199","1",111071770,111078627,6857
"7772","ENSGALG00000016202","1",111301459,111335748,34289
"7773","ENSGALG00000016205","1",111372132,111410212,38080
"7774","ENSGALG00000016215","1",112117781,112133306,15525
"7775","ENSGALG00000016217","1",112149411,112296680,147269
"7776","ENSGALG00000016221","1",112372336,112431837,59501
"7777","ENSGALG00000016222","1",112500338,112520391,20053
"7778","ENSGALG00000016224","1",112604059,112660963,56904
"7779","ENSGALG00000016227","1",113198416,113202575,4159
"7780","ENSGALG00000016228","1",113301915,113303342,1427
"7781","ENSGALG00000016231","1",113327072,113346140,19068
"7782","ENSGALG00000016232","1",113370872,113375131,4259
"7783","ENSGALG00000016236","1",113385291,113456709,71418
"7784","ENSGALG00000016238","1",113500610,113567673,67063
"7785","ENSGALG00000016241","1",113578487,113587894,9407
"7786","ENSGALG00000016245","1",113671430,113729288,57858
"7787","ENSGALG00000016251","1",114074141,114163628,89487
"7788","ENSGALG00000016254","1",114206429,114232333,25904
"7789","ENSGALG00000016258","1",114353222,114397787,44565
"7790","ENSGALG00000016259","1",114440914,114448263,7349
"7791","ENSGALG00000016261","1",114457437,114478974,21537
"7792","ENSGALG00000016262","1",114494391,114509421,15030
"7793","ENSGALG00000016265","1",114517355,114546887,29532
"7794","ENSGALG00000016266","1",114579211,114609539,30328
"7795","ENSGALG00000016267","3",85591557,85628914,37357
"7796","ENSGALG00000016268","1",114751100,115013873,262773
"7797","ENSGALG00000016271","3",85646064,85661211,15147
"7798","ENSGALG00000016273","3",85729874,85746676,16802
"7799","ENSGALG00000016276","3",86081964,86389548,307584
"7800","ENSGALG00000016278","3",86640619,86724466,83847
"7801","ENSGALG00000016279","3",86745056,86757353,12297
"7802","ENSGALG00000016281","1",116192489,117253225,1060736
"7803","ENSGALG00000016282","3",86776072,86815886,39814
"7804","ENSGALG00000016283","3",86821519,86843295,21776
"7805","ENSGALG00000016284","1",116011137,116024459,13322
"7806","ENSGALG00000016285","1",116059996,116093676,33680
"7807","ENSGALG00000016286","1",116112612,116121679,9067
"7808","ENSGALG00000016287","1",115748151,115750190,2039
"7809","ENSGALG00000016288","1",117527572,118143733,616161
"7810","ENSGALG00000016289","3",86843658,87137461,293803
"7811","ENSGALG00000016292","3",87199659,87241935,42276
"7812","ENSGALG00000016293","3",87360676,87415579,54903
"7813","ENSGALG00000016294","3",87481259,87553795,72536
"7814","ENSGALG00000016296","3",87561662,87574788,13126
"7815","ENSGALG00000016297","3",87590272,87623808,33536
"7816","ENSGALG00000016299","3",87700116,87743877,43761
"7817","ENSGALG00000016300","3",87866280,87910198,43918
"7818","ENSGALG00000016301","3",87917091,88015595,98504
"7819","ENSGALG00000016304","3",88017842,88103589,85747
"7820","ENSGALG00000016309","3",88147849,88151591,3742
"7821","ENSGALG00000016312","1",119273945,119465002,191057
"7822","ENSGALG00000016313","3",88184018,88215580,31562
"7823","ENSGALG00000016314","3",88246591,88283573,36982
"7824","ENSGALG00000016316","3",88302328,88310936,8608
"7825","ENSGALG00000016318","1",119466920,119508528,41608
"7826","ENSGALG00000016320","3",88320831,88338333,17502
"7827","ENSGALG00000016321","3",88342284,88357572,15288
"7828","ENSGALG00000016322","3",88359782,88366861,7079
"7829","ENSGALG00000016323","1",119517283,119567431,50148
"7830","ENSGALG00000016324","3",88374105,88384918,10813
"7831","ENSGALG00000016325","3",88388999,88395707,6708
"7832","ENSGALG00000016326","1",119590936,119599200,8264
"7833","ENSGALG00000016327","1",119617268,119631662,14394
"7834","ENSGALG00000016328","3",88396106,88429051,32945
"7835","ENSGALG00000016329","3",88471489,88528088,56599
"7836","ENSGALG00000016332","3",88558041,88679655,121614
"7837","ENSGALG00000016340","1",119652008,119666014,14006
"7838","ENSGALG00000016342","3",90705369,90802601,97232
"7839","ENSGALG00000016345","1",119704493,119736164,31671
"7840","ENSGALG00000016348","1",119746943,119749754,2811
"7841","ENSGALG00000016350","3",90864295,90984736,120441
"7842","ENSGALG00000016351","1",119754033,119774891,20858
"7843","ENSGALG00000016356","3",91617877,91645194,27317
"7844","ENSGALG00000016357","1",119778665,119787144,8479
"7845","ENSGALG00000016358","1",119862721,119892355,29634
"7846","ENSGALG00000016359","3",91615210,91682313,67103
"7847","ENSGALG00000016361","3",91782224,91783324,1100
"7848","ENSGALG00000016362","3",91875015,91915377,40362
"7849","ENSGALG00000016363","3",91915385,91937137,21752
"7850","ENSGALG00000016364","3",91939182,91952584,13402
"7851","ENSGALG00000016367","3",92598069,92724636,126567
"7852","ENSGALG00000016370","3",92750489,92789780,39291
"7853","ENSGALG00000016375","1",120317314,120408886,91572
"7854","ENSGALG00000016377","3",92904139,92977622,73483
"7855","ENSGALG00000016379","1",120425336,120468539,43203
"7856","ENSGALG00000016382","1",120491889,120522883,30994
"7857","ENSGALG00000016384","3",92994427,93120877,126450
"7858","ENSGALG00000016385","3",93570218,93634842,64624
"7859","ENSGALG00000016387","3",93634555,93681884,47329
"7860","ENSGALG00000016388","1",120595114,120596901,1787
"7861","ENSGALG00000016389","3",93697530,93703548,6018
"7862","ENSGALG00000016391","1",120600351,120804008,203657
"7863","ENSGALG00000016392","3",93709143,93717206,8063
"7864","ENSGALG00000016397","3",94540125,94542103,1978
"7865","ENSGALG00000016400","3",94991681,95016338,24657
"7866","ENSGALG00000016406","1",121157720,121225454,67734
"7867","ENSGALG00000016409","3",95874104,95933821,59717
"7868","ENSGALG00000016410","1",121229301,121238473,9172
"7869","ENSGALG00000016412","3",95942849,96033545,90696
"7870","ENSGALG00000016415","1",121300649,121335637,34988
"7871","ENSGALG00000016418","1",121356060,121377378,21318
"7872","ENSGALG00000016419","3",96096130,96181444,85314
"7873","ENSGALG00000016420","1",121385060,121606919,221859
"7874","ENSGALG00000016421","3",96183941,96191112,7171
"7875","ENSGALG00000016424","3",96191000,96209632,18632
"7876","ENSGALG00000016425","3",96209831,96213156,3325
"7877","ENSGALG00000016426","1",121619269,121702537,83268
"7878","ENSGALG00000016427","3",96213351,96245797,32446
"7879","ENSGALG00000016430","1",121691899,121704059,12160
"7880","ENSGALG00000016431","Z",82009343,82120633,111290
"7881","ENSGALG00000016433","3",96266562,96292983,26421
"7882","ENSGALG00000016438","Z",82200619,82223072,22453
"7883","ENSGALG00000016440","3",96486785,96494476,7691
"7884","ENSGALG00000016441","3",96498135,96502627,4492
"7885","ENSGALG00000016442","3",96516162,96521232,5070
"7886","ENSGALG00000016443","3",96721221,96773216,51995
"7887","ENSGALG00000016444","3",96780811,96788676,7865
"7888","ENSGALG00000016445","3",96860494,96904691,44197
"7889","ENSGALG00000016446","3",96909880,96926659,16779
"7890","ENSGALG00000016447","3",96926585,96943756,17171
"7891","ENSGALG00000016448","3",97009136,97011650,2514
"7892","ENSGALG00000016449","3",97160703,97165526,4823
"7893","ENSGALG00000016451","3",97177532,97270178,92646
"7894","ENSGALG00000016454","3",97283667,97294099,10432
"7895","ENSGALG00000016455","3",97305446,97393711,88265
"7896","ENSGALG00000016456","3",97402679,97470693,68014
"7897","ENSGALG00000016457","3",97859114,97880210,21096
"7898","ENSGALG00000016459","3",98547690,98550805,3115
"7899","ENSGALG00000016461","3",98936284,98957643,21359
"7900","ENSGALG00000016462","3",99207484,99211831,4347
"7901","ENSGALG00000016463","3",99567584,99621073,53489
"7902","ENSGALG00000016464","3",100056251,100133415,77164
"7903","ENSGALG00000016465","3",100212447,100223336,10889
"7904","ENSGALG00000016467","3",100135676,100170579,34903
"7905","ENSGALG00000016468","3",100169561,100187161,17600
"7906","ENSGALG00000016469","3",100204489,100205795,1306
"7907","ENSGALG00000016470","3",100258029,100259513,1484
"7908","ENSGALG00000016471","3",100541466,100547451,5985
"7909","ENSGALG00000016473","3",101012220,101014419,2199
"7910","ENSGALG00000016475","3",101331559,101347513,15954
"7911","ENSGALG00000016476","3",101353096,101354281,1185
"7912","ENSGALG00000016477","3",101354461,101391431,36970
"7913","ENSGALG00000016478","3",101394465,101409742,15277
"7914","ENSGALG00000016479","3",101413017,101426470,13453
"7915","ENSGALG00000016480","3",101546272,101566050,19778
"7916","ENSGALG00000016481","3",101578290,101621518,43228
"7917","ENSGALG00000016483","3",101650872,101662307,11435
"7918","ENSGALG00000016485","3",101681364,101683698,2334
"7919","ENSGALG00000016486","3",101863127,101906927,43800
"7920","ENSGALG00000016487","3",101927863,102036252,108389
"7921","ENSGALG00000016491","3",102199405,102233660,34255
"7922","ENSGALG00000016492","3",102274603,102281938,7335
"7923","ENSGALG00000016494","3",103237108,103274205,37097
"7924","ENSGALG00000016495","3",103811477,103953916,142439
"7925","ENSGALG00000016497","3",104043560,104060781,17221
"7926","ENSGALG00000016498","3",104064465,104093730,29265
"7927","ENSGALG00000016499","3",104117200,104131180,13980
"7928","ENSGALG00000016500","3",104141133,104187699,46566
"7929","ENSGALG00000016501","3",104190916,104194372,3456
"7930","ENSGALG00000016502","3",104195023,104200149,5126
"7931","ENSGALG00000016504","3",104214249,104270106,55857
"7932","ENSGALG00000016505","3",104286884,104301775,14891
"7933","ENSGALG00000016506","3",104302069,104318193,16124
"7934","ENSGALG00000016507","3",104325698,104331561,5863
"7935","ENSGALG00000016508","3",104332544,104340810,8266
"7936","ENSGALG00000016509","3",104340995,104374512,33517
"7937","ENSGALG00000016510","3",104370906,104377540,6634
"7938","ENSGALG00000016511","1",121777765,121819130,41365
"7939","ENSGALG00000016512","3",104377325,104402322,24997
"7940","ENSGALG00000016513","3",104403225,104420237,17012
"7941","ENSGALG00000016514","3",104421057,104426261,5204
"7942","ENSGALG00000016516","3",104426656,104430293,3637
"7943","ENSGALG00000016518","1",121822368,121859658,37290
"7944","ENSGALG00000016522","1",121861691,121891693,30002
"7945","ENSGALG00000016523","1",121900872,121912941,12069
"7946","ENSGALG00000016524","3",104490018,104502053,12035
"7947","ENSGALG00000016529","1",121923761,122022946,99185
"7948","ENSGALG00000016531","3",104750809,104834649,83840
"7949","ENSGALG00000016535","3",104865999,104903427,37428
"7950","ENSGALG00000016536","3",104913067,104937303,24236
"7951","ENSGALG00000016537","1",122078244,122134183,55939
"7952","ENSGALG00000016538","1",122146582,122148228,1646
"7953","ENSGALG00000016541","1",122293276,122340369,47093
"7954","ENSGALG00000016543","1",122350876,122496961,146085
"7955","ENSGALG00000016545","1",122667268,122766511,99243
"7956","ENSGALG00000016546","1",122788545,122796822,8277
"7957","ENSGALG00000016547","1",122800841,122819731,18890
"7958","ENSGALG00000016548","1",122824941,122843890,18949
"7959","ENSGALG00000016549","1",122843957,122900758,56801
"7960","ENSGALG00000016551","1",123220541,123254525,33984
"7961","ENSGALG00000016552","1",123259095,123270120,11025
"7962","ENSGALG00000016554","1",123308765,123331190,22425
"7963","ENSGALG00000016555","3",104935442,104949071,13629
"7964","ENSGALG00000016556","3",104955256,104962557,7301
"7965","ENSGALG00000016557","1",123334097,123360200,26103
"7966","ENSGALG00000016558","1",123415471,123448479,33008
"7967","ENSGALG00000016559","1",123457973,123467284,9311
"7968","ENSGALG00000016560","3",104975750,104996776,21026
"7969","ENSGALG00000016562","1",123471156,123482949,11793
"7970","ENSGALG00000016563","1",123496180,123509692,13512
"7971","ENSGALG00000016564","3",105015066,105027598,12532
"7972","ENSGALG00000016565","3",105030006,105034588,4582
"7973","ENSGALG00000016567","3",105043160,105052107,8947
"7974","ENSGALG00000016568","1",123679401,123713845,34444
"7975","ENSGALG00000016569","1",123713870,123728313,14443
"7976","ENSGALG00000016570","3",105054461,105067233,12772
"7977","ENSGALG00000016571","1",123760153,123886114,125961
"7978","ENSGALG00000016574","1",124157206,124192838,35632
"7979","ENSGALG00000016575","1",124201020,124307978,106958
"7980","ENSGALG00000016576","1",124308474,124337655,29181
"7981","ENSGALG00000016577","3",105305216,105335944,30728
"7982","ENSGALG00000016578","1",124337730,124348310,10580
"7983","ENSGALG00000016579","1",124344548,124352711,8163
"7984","ENSGALG00000016580","3",105090968,105109766,18798
"7985","ENSGALG00000016581","1",124357476,124367398,9922
"7986","ENSGALG00000016582","3",105111720,105120097,8377
"7987","ENSGALG00000016583","3",105120537,105133840,13303
"7988","ENSGALG00000016584","1",124845633,124876994,31361
"7989","ENSGALG00000016586","3",105134511,105145425,10914
"7990","ENSGALG00000016590","1",124490191,124497611,7420
"7991","ENSGALG00000016591","3",105338705,105350819,12114
"7992","ENSGALG00000016592","1",124459466,124485720,26254
"7993","ENSGALG00000016595","3",105351728,105356515,4787
"7994","ENSGALG00000016600","3",105372181,105388173,15992
"7995","ENSGALG00000016602","1",125571190,125724317,153127
"7996","ENSGALG00000016605","3",105391119,105427984,36865
"7997","ENSGALG00000016607","1",126199878,126236135,36257
"7998","ENSGALG00000016608","3",105444375,105456601,12226
"7999","ENSGALG00000016609","3",105457089,105463791,6702
"8000","ENSGALG00000016610","3",105463857,105471230,7373
"8001","ENSGALG00000016615","1",126518232,126531997,13765
"8002","ENSGALG00000016617","3",105475190,105630321,155131
"8003","ENSGALG00000016618","1",127493302,127513076,19774
"8004","ENSGALG00000016620","3",105680855,105684242,3387
"8005","ENSGALG00000016622","1",127723784,127825809,102025
"8006","ENSGALG00000016624","3",105709011,105792887,83876
"8007","ENSGALG00000016628","1",128198874,128363671,164797
"8008","ENSGALG00000016630","3",105945167,106022732,77565
"8009","ENSGALG00000016631","3",106028202,106095978,67776
"8010","ENSGALG00000016633","3",106142315,106205324,63009
"8011","ENSGALG00000016635","1",129627979,129644722,16743
"8012","ENSGALG00000016636","1",129751647,129764188,12541
"8013","ENSGALG00000016639","3",106228343,106346314,117971
"8014","ENSGALG00000016642","3",106689077,106707066,17989
"8015","ENSGALG00000016646","3",106942888,106966214,23326
"8016","ENSGALG00000016648","1",129773839,129788312,14473
"8017","ENSGALG00000016649","3",107134940,107158285,23345
"8018","ENSGALG00000016651","3",107177930,107186837,8907
"8019","ENSGALG00000016653","3",107212392,107212649,257
"8020","ENSGALG00000016654","1",129791262,129808979,17717
"8021","ENSGALG00000016655","1",129816981,129833250,16269
"8022","ENSGALG00000016661","3",107236167,107271386,35219
"8023","ENSGALG00000016662","3",107328235,107354072,25837
"8024","ENSGALG00000016664","3",107354453,107358580,4127
"8025","ENSGALG00000016665","3",107359160,107370240,11080
"8026","ENSGALG00000016667","3",107427145,107429861,2716
"8027","ENSGALG00000016668","3",107446916,107449084,2168
"8028","ENSGALG00000016669","3",107453344,107455847,2503
"8029","ENSGALG00000016670","3",107461886,107464431,2545
"8030","ENSGALG00000016673","3",107485825,107498655,12830
"8031","ENSGALG00000016674","3",107503552,107521378,17826
"8032","ENSGALG00000016675","3",107527254,107530181,2927
"8033","ENSGALG00000016676","3",107541369,107553023,11654
"8034","ENSGALG00000016677","3",107554531,107561284,6753
"8035","ENSGALG00000016678","3",107567499,107569597,2098
"8036","ENSGALG00000016680","3",108221189,108246601,25412
"8037","ENSGALG00000016681","1",129980985,130145449,164464
"8038","ENSGALG00000016684","3",108759943,108772090,12147
"8039","ENSGALG00000016685","1",130327377,130338282,10905
"8040","ENSGALG00000016686","1",130342617,130350924,8307
"8041","ENSGALG00000016687","1",130386938,130414561,27623
"8042","ENSGALG00000016689","1",130423704,130450205,26501
"8043","ENSGALG00000016690","3",108774929,108782996,8067
"8044","ENSGALG00000016691","1",130453389,130458629,5240
"8045","ENSGALG00000016692","3",108792603,108799691,7088
"8046","ENSGALG00000016693","1",130482654,130498132,15478
"8047","ENSGALG00000016697","3",108799743,108819150,19407
"8048","ENSGALG00000016698","1",131032587,131040414,7827
"8049","ENSGALG00000016699","3",108821405,108825651,4246
"8050","ENSGALG00000016702","1",131249780,131299962,50182
"8051","ENSGALG00000016704","3",108846159,108884707,38548
"8052","ENSGALG00000016705","3",109064071,109337621,273550
"8053","ENSGALG00000016707","3",109626433,109689182,62749
"8054","ENSGALG00000016708","3",109694867,109702468,7601
"8055","ENSGALG00000016709","3",109712120,109777458,65338
"8056","ENSGALG00000016710","3",109796312,109817660,21348
"8057","ENSGALG00000016713","3",109831301,109844348,13047
"8058","ENSGALG00000016716","1",131301183,131358996,57813
"8059","ENSGALG00000016717","1",131359738,131370442,10704
"8060","ENSGALG00000016719","3",109933981,109966590,32609
"8061","ENSGALG00000016720","3",109994342,110060826,66484
"8062","ENSGALG00000016721","1",131370527,131395496,24969
"8063","ENSGALG00000016722","1",131405635,131412658,7023
"8064","ENSGALG00000016723","3",110067035,110073729,6694
"8065","ENSGALG00000016724","1",131416725,131429820,13095
"8066","ENSGALG00000016725","3",110092843,110116096,23253
"8067","ENSGALG00000016726","3",110161744,110245933,84189
"8068","ENSGALG00000016727","1",131438266,131455659,17393
"8069","ENSGALG00000016728","1",131504408,131522595,18187
"8070","ENSGALG00000016731","3",110772760,110779590,6830
"8071","ENSGALG00000016732","3",110783853,110802840,18987
"8072","ENSGALG00000016734","1",131537500,131605265,67765
"8073","ENSGALG00000016735","1",131653636,131675363,21727
"8074","ENSGALG00000016736","1",131681532,131744672,63140
"8075","ENSGALG00000016737","1",131746791,131757830,11039
"8076","ENSGALG00000016739","1",131806734,131911385,104651
"8077","ENSGALG00000016740","1",131975543,132105662,130119
"8078","ENSGALG00000016744","1",132566482,132611904,45422
"8079","ENSGALG00000016755","1",133708781,133728300,19519
"8080","ENSGALG00000016757","1",133775253,133793015,17762
"8081","ENSGALG00000016758","1",133803189,133805089,1900
"8082","ENSGALG00000016759","1",133809550,133813733,4183
"8083","ENSGALG00000016760","1",133803259,133830101,26842
"8084","ENSGALG00000016761","1",133828101,133831585,3484
"8085","ENSGALG00000016764","1",133860171,133890836,30665
"8086","ENSGALG00000016766","1",133893037,133946308,53271
"8087","ENSGALG00000016767","1",133973567,134294259,320692
"8088","ENSGALG00000016768","1",134355045,134386116,31071
"8089","ENSGALG00000016769","1",134408808,134422786,13978
"8090","ENSGALG00000016770","1",134455770,134457943,2173
"8091","ENSGALG00000016771","1",134460007,134462166,2159
"8092","ENSGALG00000016772","1",134464050,134469956,5906
"8093","ENSGALG00000016774","1",134540472,134668511,128039
"8094","ENSGALG00000016775","1",134671350,134676353,5003
"8095","ENSGALG00000016776","1",134671345,134727061,55716
"8096","ENSGALG00000016779","1",134765809,134783865,18056
"8097","ENSGALG00000016781","1",134881704,135030233,148529
"8098","ENSGALG00000016785","1",135176642,135199850,23208
"8099","ENSGALG00000016788","1",135229034,135244807,15773
"8100","ENSGALG00000016791","1",135300958,135332438,31480
"8101","ENSGALG00000016792","1",135338180,135347201,9021
"8102","ENSGALG00000016794","1",136338851,136370991,32140
"8103","ENSGALG00000016795","1",136395103,136422429,27326
"8104","ENSGALG00000016796","1",136427099,136441778,14679
"8105","ENSGALG00000016797","1",136441653,136481145,39492
"8106","ENSGALG00000016799","1",136578371,136660944,82573
"8107","ENSGALG00000016801","1",136727257,136782858,55601
"8108","ENSGALG00000016802","1",136882220,136958484,76264
"8109","ENSGALG00000016803","1",136952979,137035946,82967
"8110","ENSGALG00000016804","1",137344058,137365066,21008
"8111","ENSGALG00000016805","1",137466314,137472566,6252
"8112","ENSGALG00000016806","1",137479099,137506333,27234
"8113","ENSGALG00000016808","1",137784416,137797037,12621
"8114","ENSGALG00000016809","1",137823933,137849975,26042
"8115","ENSGALG00000016810","1",138070166,138156158,85992
"8116","ENSGALG00000016811","1",138171329,138198192,26863
"8117","ENSGALG00000016813","1",138242421,138251129,8708
"8118","ENSGALG00000016815","1",138268907,138282713,13806
"8119","ENSGALG00000016816","1",138283945,138303644,19699
"8120","ENSGALG00000016817","1",138347996,138478854,130858
"8121","ENSGALG00000016820","1",138512589,138549860,37271
"8122","ENSGALG00000016822","1",138638383,138644102,5719
"8123","ENSGALG00000016823","1",138648967,138690320,41353
"8124","ENSGALG00000016824","1",138696217,138727777,31560
"8125","ENSGALG00000016826","1",138755714,138775306,19592
"8126","ENSGALG00000016828","1",138803178,138831232,28054
"8127","ENSGALG00000016830","1",138856050,138890288,34238
"8128","ENSGALG00000016831","1",138890968,138904751,13783
"8129","ENSGALG00000016832","1",138904758,138912133,7375
"8130","ENSGALG00000016833","1",138939079,138948241,9162
"8131","ENSGALG00000016834","1",138951176,139094938,143762
"8132","ENSGALG00000016836","1",139263988,139314276,50288
"8133","ENSGALG00000016837","1",139459694,139735145,275451
"8134","ENSGALG00000016843","1",140248816,140390143,141327
"8135","ENSGALG00000016844","1",140394688,140425482,30794
"8136","ENSGALG00000016845","1",140453799,140504526,50727
"8137","ENSGALG00000016847","1",140506977,140546009,39032
"8138","ENSGALG00000016849","1",140545200,140551013,5813
"8139","ENSGALG00000016852","1",141624410,141643190,18780
"8140","ENSGALG00000016853","1",141647287,141655299,8012
"8141","ENSGALG00000016854","1",141655789,141659420,3631
"8142","ENSGALG00000016855","1",142495383,142506971,11588
"8143","ENSGALG00000016858","1",144099552,144110941,11389
"8144","ENSGALG00000016859","1",144171934,144190015,18081
"8145","ENSGALG00000016860","1",144193574,144208754,15180
"8146","ENSGALG00000016861","1",144209956,144226593,16637
"8147","ENSGALG00000016862","1",144230791,144241401,10610
"8148","ENSGALG00000016863","1",144242943,144249042,6099
"8149","ENSGALG00000016864","1",144281168,144285163,3995
"8150","ENSGALG00000016865","1",144285988,144332880,46892
"8151","ENSGALG00000016866","1",144408607,144791819,383212
"8152","ENSGALG00000016867","1",144799552,144931151,131599
"8153","ENSGALG00000016868","1",144950412,145152965,202553
"8154","ENSGALG00000016870","1",145329072,145382220,53148
"8155","ENSGALG00000016872","1",145418480,145689429,270949
"8156","ENSGALG00000016875","1",145752924,145888554,135630
"8157","ENSGALG00000016878","1",145919668,145946316,26648
"8158","ENSGALG00000016880","1",145983298,146096273,112975
"8159","ENSGALG00000016881","1",146022451,146033636,11185
"8160","ENSGALG00000016883","1",146109887,146227739,117852
"8161","ENSGALG00000016884","1",146243004,146267048,24044
"8162","ENSGALG00000016885","1",146279044,146334067,55023
"8163","ENSGALG00000016886","1",146337724,146535921,198197
"8164","ENSGALG00000016889","1",146713664,146744321,30657
"8165","ENSGALG00000016890","1",146761697,146853286,91589
"8166","ENSGALG00000016891","1",146937817,146938848,1031
"8167","ENSGALG00000016893","1",147288623,147367495,78872
"8168","ENSGALG00000016894","1",147366070,147401831,35761
"8169","ENSGALG00000016895","1",147415213,147447857,32644
"8170","ENSGALG00000016896","1",147543882,147692199,148317
"8171","ENSGALG00000016897","1",147857299,147878330,21031
"8172","ENSGALG00000016898","1",147878338,147891031,12693
"8173","ENSGALG00000016899","1",147901713,147921618,19905
"8174","ENSGALG00000016900","1",147943317,148011418,68101
"8175","ENSGALG00000016902","1",149017824,149419556,401732
"8176","ENSGALG00000016904","1",151668738,151671260,2522
"8177","ENSGALG00000016905","1",152610983,152613061,2078
"8178","ENSGALG00000016906","1",154055398,154060716,5318
"8179","ENSGALG00000016907","1",159079030,159292352,213322
"8180","ENSGALG00000016908","1",160443682,160632766,189084
"8181","ENSGALG00000016910","1",154485125,154533031,47906
"8182","ENSGALG00000016911","1",154872629,154900156,27527
"8183","ENSGALG00000016912","1",155290926,155305744,14818
"8184","ENSGALG00000016913","1",155364813,155418952,54139
"8185","ENSGALG00000016915","1",155590325,155793849,203524
"8186","ENSGALG00000016917","1",155832773,155841295,8522
"8187","ENSGALG00000016918","1",155847003,155855177,8174
"8188","ENSGALG00000016919","1",155850483,155873611,23128
"8189","ENSGALG00000016920","1",156241817,156370149,128332
"8190","ENSGALG00000016921","1",156377101,156417286,40185
"8191","ENSGALG00000016922","1",156436746,156448252,11506
"8192","ENSGALG00000016925","1",156469523,156560260,90737
"8193","ENSGALG00000016926","1",156971305,157226206,254901
"8194","ENSGALG00000016927","1",157439308,157456502,17194
"8195","ENSGALG00000016929","1",157476165,157591528,115363
"8196","ENSGALG00000016930","1",157591877,157612652,20775
"8197","ENSGALG00000016931","1",157621742,157641267,19525
"8198","ENSGALG00000016932","1",157641512,157647997,6485
"8199","ENSGALG00000016934","1",163198688,163201888,3200
"8200","ENSGALG00000016936","1",163529033,163630680,101647
"8201","ENSGALG00000016937","1",163718389,163898101,179712
"8202","ENSGALG00000016941","1",164781979,164862248,80269
"8203","ENSGALG00000016943","1",166896762,166920965,24203
"8204","ENSGALG00000016945","1",167041408,167053133,11725
"8205","ENSGALG00000016946","1",167057759,167080491,22732
"8206","ENSGALG00000016947","1",167082233,167169083,86850
"8207","ENSGALG00000016949","1",167168760,167191131,22371
"8208","ENSGALG00000016951","1",167195784,167214212,18428
"8209","ENSGALG00000016954","1",167287899,167297490,9591
"8210","ENSGALG00000016955","1",167303114,167502950,199836
"8211","ENSGALG00000016959","1",167542039,167697926,155887
"8212","ENSGALG00000016964","1",167989491,168020290,30799
"8213","ENSGALG00000016965","1",168054028,168080218,26190
"8214","ENSGALG00000016967","1",168111366,168408299,296933
"8215","ENSGALG00000016968","1",168499547,168510405,10858
"8216","ENSGALG00000016969","1",168498203,168576759,78556
"8217","ENSGALG00000016971","1",168785733,168818502,32769
"8218","ENSGALG00000016972","1",168926223,168950766,24543
"8219","ENSGALG00000016974","1",168988938,169079728,90790
"8220","ENSGALG00000016975","1",169017605,169018944,1339
"8221","ENSGALG00000016979","1",169101305,169110752,9447
"8222","ENSGALG00000016980","1",169110180,169141055,30875
"8223","ENSGALG00000016981","1",169183530,169188007,4477
"8224","ENSGALG00000016984","1",169277758,169317221,39463
"8225","ENSGALG00000016985","1",169324754,169340549,15795
"8226","ENSGALG00000016986","1",169350498,169399736,49238
"8227","ENSGALG00000016988","1",169433594,169458314,24720
"8228","ENSGALG00000016990","1",169520649,169643009,122360
"8229","ENSGALG00000016991","1",169645535,169655095,9560
"8230","ENSGALG00000016992","1",169670496,169697156,26660
"8231","ENSGALG00000016993","1",169965109,169985664,20555
"8232","ENSGALG00000016994","1",169993419,170000774,7355
"8233","ENSGALG00000016995","1",170000869,170009932,9063
"8234","ENSGALG00000016996","1",170036105,170062168,26063
"8235","ENSGALG00000016997","1",170065610,170150030,84420
"8236","ENSGALG00000016998","1",170117172,170118599,1427
"8237","ENSGALG00000017000","1",170154736,170180679,25943
"8238","ENSGALG00000017002","1",170318524,170431070,112546
"8239","ENSGALG00000017003","1",170432827,170436669,3842
"8240","ENSGALG00000017004","1",170447986,170461822,13836
"8241","ENSGALG00000017005","1",170465095,170526727,61632
"8242","ENSGALG00000017006","1",170527078,170545135,18057
"8243","ENSGALG00000017008","1",170565642,170586338,20696
"8244","ENSGALG00000017009","1",170597186,170650244,53058
"8245","ENSGALG00000017010","1",170670674,170685701,15027
"8246","ENSGALG00000017011","1",170690519,170696381,5862
"8247","ENSGALG00000017012","1",170697168,170700171,3003
"8248","ENSGALG00000017015","1",171220977,171264767,43790
"8249","ENSGALG00000017016","1",171336927,171374560,37633
"8250","ENSGALG00000017017","1",171398869,171415010,16141
"8251","ENSGALG00000017018","1",171417529,171459449,41920
"8252","ENSGALG00000017019","1",171476437,171542217,65780
"8253","ENSGALG00000017021","1",171640608,171674156,33548
"8254","ENSGALG00000017022","1",171682351,171686451,4100
"8255","ENSGALG00000017023","1",171687564,171713462,25898
"8256","ENSGALG00000017024","1",171712442,171724935,12493
"8257","ENSGALG00000017025","1",171725372,171734808,9436
"8258","ENSGALG00000017026","1",171734632,171754792,20160
"8259","ENSGALG00000017029","1",171794980,171799117,4137
"8260","ENSGALG00000017031","1",171811132,171827960,16828
"8261","ENSGALG00000017032","1",171829720,171845524,15804
"8262","ENSGALG00000017033","1",171849045,171872727,23682
"8263","ENSGALG00000017034","1",171900251,171963536,63285
"8264","ENSGALG00000017035","1",172218067,172269368,51301
"8265","ENSGALG00000017036","1",172289679,172427314,137635
"8266","ENSGALG00000017038","1",172566357,172586597,20240
"8267","ENSGALG00000017039","1",172589578,172598847,9269
"8268","ENSGALG00000017040","1",172599921,172643010,43089
"8269","ENSGALG00000017042","1",172894944,172906531,11587
"8270","ENSGALG00000017044","1",173127323,173264665,137342
"8271","ENSGALG00000017046","1",173372443,173406135,33692
"8272","ENSGALG00000017047","1",173658067,173691648,33581
"8273","ENSGALG00000017048","1",173691483,173700689,9206
"8274","ENSGALG00000017049","1",173700751,173720152,19401
"8275","ENSGALG00000017050","1",173759258,173780357,21099
"8276","ENSGALG00000017052","1",173950858,173956539,5681
"8277","ENSGALG00000017053","1",173995752,174011944,16192
"8278","ENSGALG00000017062","1",174375172,174843962,468790
"8279","ENSGALG00000017064","1",175226091,175239903,13812
"8280","ENSGALG00000017065","1",175547844,175573201,25357
"8281","ENSGALG00000017068","1",175586953,175631538,44585
"8282","ENSGALG00000017070","1",175733995,175832231,98236
"8283","ENSGALG00000017071","1",175842544,175866761,24217
"8284","ENSGALG00000017072","1",175888052,175900559,12507
"8285","ENSGALG00000017073","1",175900477,175937209,36732
"8286","ENSGALG00000017075","1",175943342,176107764,164422
"8287","ENSGALG00000017076","1",176284287,176314671,30384
"8288","ENSGALG00000017077","1",176342901,176364943,22042
"8289","ENSGALG00000017079","1",176429802,176446180,16378
"8290","ENSGALG00000017083","1",176581678,176605870,24192
"8291","ENSGALG00000017084","1",176669159,176726085,56926
"8292","ENSGALG00000017085","1",176789375,176807957,18582
"8293","ENSGALG00000017089","1",177111041,177124879,13838
"8294","ENSGALG00000017090","1",177125675,177134363,8688
"8295","ENSGALG00000017091","1",177165538,177266964,101426
"8296","ENSGALG00000017092","1",177274173,177336260,62087
"8297","ENSGALG00000017096","1",177523273,177558046,34773
"8298","ENSGALG00000017097","1",177589197,177594994,5797
"8299","ENSGALG00000017098","1",177594916,177599340,4424
"8300","ENSGALG00000017099","1",177647062,177649238,2176
"8301","ENSGALG00000017102","1",177816875,177817873,998
"8302","ENSGALG00000017103","1",177851600,177895540,43940
"8303","ENSGALG00000017104","1",177955965,178026108,70143
"8304","ENSGALG00000017105","1",178030540,178040304,9764
"8305","ENSGALG00000017106","1",178053268,178362187,308919
"8306","ENSGALG00000017111","1",178382951,178420156,37205
"8307","ENSGALG00000017112","1",178421332,178445740,24408
"8308","ENSGALG00000017117","1",178731781,178738215,6434
"8309","ENSGALG00000017118","1",178737986,178812572,74586
"8310","ENSGALG00000017119","1",178822909,178879534,56625
"8311","ENSGALG00000017120","1",178932916,178982063,49147
"8312","ENSGALG00000017122","1",178989722,179102539,112817
"8313","ENSGALG00000017125","1",179741155,179876036,134881
"8314","ENSGALG00000017126","1",179883997,179922552,38555
"8315","ENSGALG00000017128","1",179931545,179940988,9443
"8316","ENSGALG00000017129","1",179947226,179950091,2865
"8317","ENSGALG00000017132","1",180044064,180112332,68268
"8318","ENSGALG00000017133","1",180122191,180131960,9769
"8319","ENSGALG00000017134","1",180148363,180181761,33398
"8320","ENSGALG00000017135","1",180188436,180238997,50561
"8321","ENSGALG00000017136","1",180268523,180278083,9560
"8322","ENSGALG00000017137","1",180313130,180314665,1535
"8323","ENSGALG00000017139","1",180355361,180392875,37514
"8324","ENSGALG00000017142","1",180486091,180524977,38886
"8325","ENSGALG00000017145","1",180550812,180568847,18035
"8326","ENSGALG00000017148","1",180615148,180632384,17236
"8327","ENSGALG00000017153","1",180936321,180969903,33582
"8328","ENSGALG00000017154","1",180987196,181008738,21542
"8329","ENSGALG00000017155","1",181226287,181226754,467
"8330","ENSGALG00000017156","1",181322903,181487159,164256
"8331","ENSGALG00000017158","1",181559336,181567603,8267
"8332","ENSGALG00000017159","1",181590958,181650668,59710
"8333","ENSGALG00000017162","1",181650846,181670657,19811
"8334","ENSGALG00000017163","1",181673539,181685617,12078
"8335","ENSGALG00000017165","1",181692016,181714409,22393
"8336","ENSGALG00000017166","1",181732680,181742258,9578
"8337","ENSGALG00000017167","1",181760889,181778160,17271
"8338","ENSGALG00000017168","1",181822186,181824109,1923
"8339","ENSGALG00000017169","1",181839724,181881942,42218
"8340","ENSGALG00000017170","1",181880177,181939483,59306
"8341","ENSGALG00000017171","1",181966817,182022834,56017
"8342","ENSGALG00000017172","1",182061433,182065423,3990
"8343","ENSGALG00000017173","1",182130487,182257860,127373
"8344","ENSGALG00000017177","1",182457193,182471609,14416
"8345","ENSGALG00000017179","1",183232405,183372535,140130
"8346","ENSGALG00000017181","1",183673256,183686237,12981
"8347","ENSGALG00000017183","1",183730975,183738566,7591
"8348","ENSGALG00000017184","1",183873073,183877709,4636
"8349","ENSGALG00000017185","1",183903226,183920317,17091
"8350","ENSGALG00000017186","1",183926160,183936332,10172
"8351","ENSGALG00000017189","1",184057697,184077150,19453
"8352","ENSGALG00000017190","1",184104312,184140429,36117
"8353","ENSGALG00000017191","1",184143212,184157279,14067
"8354","ENSGALG00000017195","1",184494415,184532824,38409
"8355","ENSGALG00000017196","1",184547720,184703043,155323
"8356","ENSGALG00000017197","1",184782914,185386260,603346
"8357","ENSGALG00000017199","1",186248196,186456865,208669
"8358","ENSGALG00000017200","1",186489972,186536071,46099
"8359","ENSGALG00000017201","1",186545459,186558375,12916
"8360","ENSGALG00000017202","1",186558472,186567752,9280
"8361","ENSGALG00000017204","1",186709569,186747771,38202
"8362","ENSGALG00000017205","1",186760966,186767598,6632
"8363","ENSGALG00000017207","1",186781159,186797999,16840
"8364","ENSGALG00000017208","1",186814876,186872104,57228
"8365","ENSGALG00000017210","1",186932532,186935320,2788
"8366","ENSGALG00000017211","1",186935469,186955206,19737
"8367","ENSGALG00000017212","1",186958524,186961472,2948
"8368","ENSGALG00000017216","1",187061747,187071961,10214
"8369","ENSGALG00000017217","1",187083455,187092642,9187
"8370","ENSGALG00000017218","1",187090984,187108246,17262
"8371","ENSGALG00000017219","1",187105314,187114711,9397
"8372","ENSGALG00000017220","1",187114813,187125635,10822
"8373","ENSGALG00000017227","1",187334925,187443112,108187
"8374","ENSGALG00000017228","1",187523990,187544411,20421
"8375","ENSGALG00000017229","1",187671552,188016984,345432
"8376","ENSGALG00000017234","1",188927712,188953081,25369
"8377","ENSGALG00000017235","1",189025780,189161699,135919
"8378","ENSGALG00000017237","1",189153122,189202896,49774
"8379","ENSGALG00000017238","1",189236711,189484068,247357
"8380","ENSGALG00000017239","1",189543239,189559491,16252
"8381","ENSGALG00000017242","1",190012922,190017357,4435
"8382","ENSGALG00000017244","1",190099704,190104302,4598
"8383","ENSGALG00000017246","1",190149703,190268109,118406
"8384","ENSGALG00000017248","1",190343744,190384017,40273
"8385","ENSGALG00000017249","1",190407769,190427144,19375
"8386","ENSGALG00000017250","1",190431423,190445874,14451
"8387","ENSGALG00000017262","1",193877713,193930403,52690
"8388","ENSGALG00000017268","1",194285089,194285891,802
"8389","ENSGALG00000017271","1",74343324,74478720,135396
"8390","ENSGALG00000017272","1",74541146,74683073,141927
"8391","ENSGALG00000017274","1",74715928,74740777,24849
"8392","ENSGALG00000017276","1",74769488,74786815,17327
"8393","ENSGALG00000017282","1",73689598,73711387,21789
"8394","ENSGALG00000017283","1",73471157,73515295,44138
"8395","ENSGALG00000017287","1",73398600,73411082,12482
"8396","ENSGALG00000017289","1",73358186,73385073,26887
"8397","ENSGALG00000017290","1",73323857,73358098,34241
"8398","ENSGALG00000017291","1",73191857,73320608,128751
"8399","ENSGALG00000017295","1",72752038,72764874,12836
"8400","ENSGALG00000017296","1",72671873,72682871,10998
"8401","ENSGALG00000017299","1",197370910,197373989,3079
"8402","ENSGALG00000017302","1",195701721,195741913,40192
"8403","ENSGALG00000017304","1",195816616,195850848,34232
"8404","ENSGALG00000017307","1",195879120,195909268,30148
"8405","ENSGALG00000017308","1",195927366,195949522,22156
"8406","ENSGALG00000017309","1",195964053,195983561,19508
"8407","ENSGALG00000017312","1",196023421,196053237,29816
"8408","ENSGALG00000017314","1",196069721,196079965,10244
"8409","ENSGALG00000017316","1",196116614,196119547,2933
"8410","ENSGALG00000017317","1",196119543,196123843,4300
"8411","ENSGALG00000017318","1",196124023,196138995,14972
"8412","ENSGALG00000017319","1",196140371,196150403,10032
"8413","ENSGALG00000017320","1",196160546,196219266,58720
"8414","ENSGALG00000017321","1",196223183,196230734,7551
"8415","ENSGALG00000017323","1",196231994,196379825,147831
"8416","ENSGALG00000017326","1",196400110,196613874,213764
"8417","ENSGALG00000017327","1",196442816,196449067,6251
"8418","ENSGALG00000017329","1",196502552,196621676,119124
"8419","ENSGALG00000017330","1",196638370,196645721,7351
"8420","ENSGALG00000017332","1",196850267,196856462,6195
"8421","ENSGALG00000017333","1",197563823,197583891,20068
"8422","ENSGALG00000017334","1",197487500,197530937,43437
"8423","ENSGALG00000017336","1",197452240,197464277,12037
"8424","ENSGALG00000017341","1",197348787,197353947,5160
"8425","ENSGALG00000017342","1",197338569,197339615,1046
"8426","ENSGALG00000017343","1",197315886,197319358,3472
"8427","ENSGALG00000017347","1",197288212,197289402,1190
"8428","ENSGALG00000017350","1",197157405,197175419,18014
"8429","ENSGALG00000017357","18",4241336,4245766,4430
"8430","ENSGALG00000017358","19",4382201,4400820,18619
"8431","ENSGALG00000017362","13",12143095,12173099,30004
"8432","ENSGALG00000017363","11",7734011,7783037,49026
"8433","ENSGALG00000017365","13",18910013,18920300,10287
"8434","ENSGALG00000017366","20",13384759,13395113,10354
"8435","ENSGALG00000017368","12",18506274,18509911,3637
"8436","ENSGALG00000017370","10",9178837,9190055,11218
"8437","ENSGALG00000017376","8",1909179,1914835,5656
"8438","ENSGALG00000017378","6",23234581,23244586,10005
"8439","ENSGALG00000017380","8",21951261,21952830,1569
"8440","ENSGALG00000017384","5",28232933,28240034,7101
"8441","ENSGALG00000017388","5",48699995,48722973,22978
"8442","ENSGALG00000017389","5",54570181,54576242,6061
"8443","ENSGALG00000017392","3",9243265,9249046,5781
"8444","ENSGALG00000017394","2",7910368,7918977,8609
"8445","ENSGALG00000017395","2",18048559,18051063,2504
"8446","ENSGALG00000017398","2",106059525,106075529,16004
"8447","ENSGALG00000017405","Z",10035819,10086725,50906
"8448","ENSGALG00000017411","Z",10315034,10316374,1340
"8449","ENSGALG00000017414","27",7477796,7493324,15528
"8450","ENSGALG00000017418","18",9471731,9474194,2463
"8451","ENSGALG00000017419","6",23202999,23207986,4987
"8452","ENSGALG00000017447","Z",36854753,36876806,22053
"8453","ENSGALG00000017462","13",17291960,17350348,58388
"8454","ENSGALG00000017485","4",69518863,69524197,5334
"8455","ENSGALG00000017493","1",195602594,195605798,3204
"8456","ENSGALG00000017524","28",1185679,1189321,3642
"8457","ENSGALG00000017553","27",6462486,6468426,5940
"8458","ENSGALG00000017558","Z",81801034,81807114,6080
"8459","ENSGALG00000017611","17",5940937,5945767,4830
"8460","ENSGALG00000017627","6",24038158,24041819,3661
"8461","ENSGALG00000017644","11",16818088,16836168,18080
"8462","ENSGALG00000017652","5",27601429,27628557,27128
"8463","ENSGALG00000017658","Z",41073186,41073665,479
"8464","ENSGALG00000017681","14",12384106,12384860,754
"8465","ENSGALG00000017706","Z",61215512,61276354,60842
"8466","ENSGALG00000017715","23",5106695,5112284,5589
"8467","ENSGALG00000017790","2",44413238,44413356,118
"8468","ENSGALG00000017804","2",54388860,54388971,111
"8469","ENSGALG00000017808","1",50695231,50695323,92
"8470","ENSGALG00000017810","1",169085608,169085737,129
"8471","ENSGALG00000017811","1",177655148,177655280,132
"8472","ENSGALG00000017812","1",187121086,187121217,131
"8473","ENSGALG00000017813","1",187121926,187121998,72
"8474","ENSGALG00000017814","1",187122869,187123000,131
"8475","ENSGALG00000017815","1",187123728,187123866,138
"8476","ENSGALG00000017817","1",196642502,196642646,144
"8477","ENSGALG00000017818","1",196643890,196644037,147
"8478","ENSGALG00000017819","10",1792193,1792324,131
"8479","ENSGALG00000017822","10",18946420,18946519,99
"8480","ENSGALG00000017823","10",18946945,18947016,71
"8481","ENSGALG00000017824","10",18947810,18947911,101
"8482","ENSGALG00000017825","11",1432691,1432826,135
"8483","ENSGALG00000017828","12",19877144,19877282,138
"8484","ENSGALG00000017829","16",2526877,2526947,70
"8485","ENSGALG00000017831","17",7167499,7167571,72
"8486","ENSGALG00000017832","17",7166158,7166232,74
"8487","ENSGALG00000017833","17",1926076,1926204,128
"8488","ENSGALG00000017836","2",4087705,4087842,137
"8489","ENSGALG00000017838","2",44296907,44297062,155
"8490","ENSGALG00000017839","2",44298109,44298267,158
"8491","ENSGALG00000017840","20",6469025,6469119,94
"8492","ENSGALG00000017841","23",576114,576199,85
"8493","ENSGALG00000017843","23",2703490,2703624,134
"8494","ENSGALG00000017845","23",2704413,2704555,142
"8495","ENSGALG00000017846","23",5617148,5617280,132
"8496","ENSGALG00000017847","23",5618437,5618565,128
"8497","ENSGALG00000017848","23",5619087,5619217,130
"8498","ENSGALG00000017849","24",3105620,3105710,90
"8499","ENSGALG00000017850","27",6856003,6856134,131
"8500","ENSGALG00000017853","3",45692505,45692641,136
"8501","ENSGALG00000017855","4",2120107,2120240,133
"8502","ENSGALG00000017857","4",16503469,16503600,131
"8503","ENSGALG00000017858","4",55057419,55057549,130
"8504","ENSGALG00000017860","4",85470899,85471041,142
"8505","ENSGALG00000017862","5",9634111,9634292,181
"8506","ENSGALG00000017863","5",9991965,9992096,131
"8507","ENSGALG00000017864","5",9993003,9993134,131
"8508","ENSGALG00000017866","5",50414275,50414398,123
"8509","ENSGALG00000017867","6",3501729,3501928,199
"8510","ENSGALG00000017868","6",30942097,30942229,132
"8511","ENSGALG00000017870","8",7793183,7793266,83
"8512","ENSGALG00000017871","8",7793618,7793700,82
"8513","ENSGALG00000017872","8",7793869,7793952,83
"8514","ENSGALG00000017874","8",21122549,21122620,71
"8515","ENSGALG00000017875","8",30140894,30140976,82
"8516","ENSGALG00000017876","8",30142420,30142504,84
"8517","ENSGALG00000017894","1",49183032,49183180,148
"8518","ENSGALG00000017900","1",185077860,185077966,106
"8519","ENSGALG00000017902","Z",45788049,45788223,174
"8520","ENSGALG00000017903","11",5176684,5176790,106
"8521","ENSGALG00000017906","15",9678812,9678952,140
"8522","ENSGALG00000017907","15",9679418,9679558,140
"8523","ENSGALG00000017909","17",7508696,7508823,127
"8524","ENSGALG00000017910","18",3473888,3473994,106
"8525","ENSGALG00000017912","2",37063330,37063504,174
"8526","ENSGALG00000017921","3",4965671,4965860,189
"8527","ENSGALG00000017923","3",38983550,38983712,162
"8528","ENSGALG00000017926","3",88359209,88359537,328
"8529","ENSGALG00000017930","4",23858532,23858819,287
"8530","ENSGALG00000017953","Z",11258541,11258703,162
"8531","ENSGALG00000018235","1",4030403,4030491,88
"8532","ENSGALG00000018237","1",33181711,33181810,99
"8533","ENSGALG00000018238","1",46333894,46334002,108
"8534","ENSGALG00000018239","1",49496336,49496404,68
"8535","ENSGALG00000018242","1",100395008,100395088,80
"8536","ENSGALG00000018243","1",100395750,100395857,107
"8537","ENSGALG00000018244","1",100428097,100428186,89
"8538","ENSGALG00000018247","1",111967038,111967136,98
"8539","ENSGALG00000018248","1",149439848,149439925,77
"8540","ENSGALG00000018249","1",149439957,149440050,93
"8541","ENSGALG00000018251","1",149440270,149440350,80
"8542","ENSGALG00000018252","1",149440404,149440496,92
"8543","ENSGALG00000018253","1",149440556,149440646,90
"8544","ENSGALG00000018254","1",170717614,170717697,83
"8545","ENSGALG00000018258","10",13575940,13576038,98
"8546","ENSGALG00000018261","11",19068658,19068752,94
"8547","ENSGALG00000018262","12",3389984,3390089,105
"8548","ENSGALG00000018264","12",6488746,6488848,102
"8549","ENSGALG00000018265","12",6489790,6489881,91
"8550","ENSGALG00000018266","12",6490205,6490294,89
"8551","ENSGALG00000018267","13",8517276,8517374,98
"8552","ENSGALG00000018269","13",5314120,5314214,94
"8553","ENSGALG00000018274","17",9797660,9797744,84
"8554","ENSGALG00000018275","17",9796020,9796110,90
"8555","ENSGALG00000018276","17",8047160,8047243,83
"8556","ENSGALG00000018277","17",5405912,5406005,93
"8557","ENSGALG00000018278","17",5319583,5319671,88
"8558","ENSGALG00000018281","2",32120651,32120718,67
"8559","ENSGALG00000018283","2",40676597,40676692,95
"8560","ENSGALG00000018284","2",45455218,45455301,83
"8561","ENSGALG00000018285","2",83611938,83612023,85
"8562","ENSGALG00000018286","2",84220816,84220899,83
"8563","ENSGALG00000018287","2",102515262,102515353,91
"8564","ENSGALG00000018288","2",102518390,102518474,84
"8565","ENSGALG00000018289","2",114301724,114301824,100
"8566","ENSGALG00000018290","2",142647738,142647801,63
"8567","ENSGALG00000018291","2",142644193,142644279,86
"8568","ENSGALG00000018293","20",8135529,8135624,95
"8569","ENSGALG00000018296","21",3272136,3272244,108
"8570","ENSGALG00000018299","23",4489739,4489802,63
"8571","ENSGALG00000018300","23",4489878,4489956,78
"8572","ENSGALG00000018301","23",5078843,5078938,95
"8573","ENSGALG00000018302","23",5080066,5080154,88
"8574","ENSGALG00000018303","24",3364558,3364645,87
"8575","ENSGALG00000018304","24",3372648,3372743,95
"8576","ENSGALG00000018305","24",5568839,5568922,83
"8577","ENSGALG00000018306","24",5569576,5569649,73
"8578","ENSGALG00000018307","26",1650716,1650798,82
"8579","ENSGALG00000018308","26",1650916,1650998,82
"8580","ENSGALG00000018309","26",2124446,2124541,95
"8581","ENSGALG00000018310","26",2699245,2699333,88
"8582","ENSGALG00000018311","26",2700156,2700235,79
"8583","ENSGALG00000018312","26",3076425,3076520,95
"8584","ENSGALG00000018313","27",6183421,6183515,94
"8585","ENSGALG00000018318","3",18902895,18902999,104
"8586","ENSGALG00000018320","3",82370040,82370118,78
"8587","ENSGALG00000018324","4",3967808,3967891,83
"8588","ENSGALG00000018325","4",3967939,3968019,80
"8589","ENSGALG00000018327","4",75040840,75040948,108
"8590","ENSGALG00000018329","5",50883048,50883145,97
"8591","ENSGALG00000018330","6",20232372,20232453,81
"8592","ENSGALG00000018331","7",16278907,16279016,109
"8593","ENSGALG00000018332","7",30614322,30614403,81
"8594","ENSGALG00000018336","8",12923059,12923154,95
"8595","ENSGALG00000018339","Z",78732007,78732100,93
"8596","ENSGALG00000018340","Z",761054,761130,76
"8597","ENSGALG00000018344","19",697445,697536,91
"8598","ENSGALG00000018346","Z",60673629,60673715,86
"8599","ENSGALG00000018350","Z",27510587,27510665,78
"8600","ENSGALG00000018352","Z",40089577,40089685,108
"8601","ENSGALG00000018353","Z",41660626,41660711,85
"8602","ENSGALG00000018354","Z",41660862,41660958,96
"8603","ENSGALG00000018355","Z",41661383,41661472,89
"8604","ENSGALG00000018415","25",316897,321806,4909
"8605","ENSGALG00000018439","7",17839144,17841101,1957
"8606","ENSGALG00000018503","22",2923619,2925165,1546
"8607","ENSGALG00000018534","Z",7124552,7137256,12704
"8608","ENSGALG00000018557","4",73665483,73667513,2030
"8609","ENSGALG00000018700","17",6447598,6458124,10526
"8610","ENSGALG00000018702","25",3764215,3767662,3447
"8611","ENSGALG00000018803","7",22071715,22074817,3102
"8612","ENSGALG00000018815","27",6812837,6820148,7311
"8613","ENSGALG00000018819","24",3593117,3606579,13462
"8614","ENSGALG00000018874","Z",81496699,81572966,76267
"8615","ENSGALG00000018942","24",328157,329913,1756
"8616","ENSGALG00000018946","12",15733036,15738143,5107
"8617","ENSGALG00000018976","10",9533322,9543751,10429
"8618","ENSGALG00000018977","21",4848704,4850283,1579
"8619","ENSGALG00000018998","13",11039033,11049134,10101
"8620","ENSGALG00000019003","4",49596691,49613503,16812
"8621","ENSGALG00000019018","22",2553090,2554367,1277
"8622","ENSGALG00000019019","25",2580674,2588284,7610
"8623","ENSGALG00000019026","4",88649940,88651459,1519
"8624","ENSGALG00000019030","1",197191480,197192442,962
"8625","ENSGALG00000019036","1",196002497,196007134,4637
"8626","ENSGALG00000019042","1",194292601,194303042,10441
"8627","ENSGALG00000019060","1",183804597,183812551,7954
"8628","ENSGALG00000019061","1",183793774,183800290,6516
"8629","ENSGALG00000019063","1",183766300,183772932,6632
"8630","ENSGALG00000019077","1",178515945,178724914,208969
"8631","ENSGALG00000019087","1",173784872,173795637,10765
"8632","ENSGALG00000019094","1",170550122,170564885,14763
"8633","ENSGALG00000019114","1",147451550,147510983,59433
"8634","ENSGALG00000019147","1",130499848,130512773,12925
"8635","ENSGALG00000019157","1",120533946,120578001,44055
"8636","ENSGALG00000019171","1",111636894,111658284,21390
"8637","ENSGALG00000019175","1",110980772,110999784,19012
"8638","ENSGALG00000019178","1",110390796,110421676,30880
"8639","ENSGALG00000019201","1",99458800,99466501,7701
"8640","ENSGALG00000019211","1",93236812,93258497,21685
"8641","ENSGALG00000019215","1",92636542,92655187,18645
"8642","ENSGALG00000019228","1",85232196,85239081,6885
"8643","ENSGALG00000019231","1",84562942,84585088,22146
"8644","ENSGALG00000019233","1",83879170,83892733,13563
"8645","ENSGALG00000019240","1",81587631,81590954,3323
"8646","ENSGALG00000019261","1",69831525,69908956,77431
"8647","ENSGALG00000019262","1",68331950,68332534,584
"8648","ENSGALG00000019276","1",65193673,65214941,21268
"8649","ENSGALG00000019277","1",65167287,65185448,18161
"8650","ENSGALG00000019284","1",62118528,62125904,7376
"8651","ENSGALG00000019286","1",62042662,62047569,4907
"8652","ENSGALG00000019290","1",60151819,60178280,26461
"8653","ENSGALG00000019291","1",60110714,60130980,20266
"8654","ENSGALG00000019300","1",55122085,55150578,28493
"8655","ENSGALG00000019304","1",53318634,53319200,566
"8656","ENSGALG00000019312","1",51121427,51122146,719
"8657","ENSGALG00000019316","1",50845194,50847064,1870
"8658","ENSGALG00000019322","1",49476737,49478344,1607
"8659","ENSGALG00000019325","1",49173031,49181295,8264
"8660","ENSGALG00000019331","1",46556024,46577957,21933
"8661","ENSGALG00000019336","1",45165398,45188550,23152
"8662","ENSGALG00000019352","1",35741016,35756749,15733
"8663","ENSGALG00000019355","1",35503179,35528253,25074
"8664","ENSGALG00000019358","1",34486674,34489660,2986
"8665","ENSGALG00000019361","1",32828666,32879723,51057
"8666","ENSGALG00000019384","1",20526985,20555609,28624
"8667","ENSGALG00000019397","1",16257553,16300910,43357
"8668","ENSGALG00000019484","2",106812257,106856788,44531
"8669","ENSGALG00000019489","2",104463815,104551433,87618
"8670","ENSGALG00000019509","2",94077436,94203306,125870
"8671","ENSGALG00000019514","2",91847137,91861414,14277
"8672","ENSGALG00000019527","2",85691001,85711341,20340
"8673","ENSGALG00000019543","2",76264871,76273509,8638
"8674","ENSGALG00000019551","2",67700354,67711715,11361
"8675","ENSGALG00000019552","2",67665297,67674062,8765
"8676","ENSGALG00000019553","2",67656284,67662678,6394
"8677","ENSGALG00000019554","2",67641034,67649937,8903
"8678","ENSGALG00000019555","2",67621788,67629938,8150
"8679","ENSGALG00000019568","2",64612878,64622922,10044
"8680","ENSGALG00000019570","2",63035106,63135497,100391
"8681","ENSGALG00000019622","2",40477423,40528745,51322
"8682","ENSGALG00000019651","2",28590281,28597092,6811
"8683","ENSGALG00000019662","2",20813825,20827731,13906
"8684","ENSGALG00000019663","2",20619979,20622930,2951
"8685","ENSGALG00000019690","2",6292140,6311275,19135
"8686","ENSGALG00000019696","2",4074457,4076222,1765
"8687","ENSGALG00000019715","27",7329801,7334241,4440
"8688","ENSGALG00000019716","27",7336035,7340414,4379
"8689","ENSGALG00000019718","27",7361940,7366365,4425
"8690","ENSGALG00000019719","27",7369267,7374026,4759
"8691","ENSGALG00000019736","18",10870598,10874997,4399
"8692","ENSGALG00000019738","27",6883005,6889815,6810
"8693","ENSGALG00000019741","27",7790586,7793494,2908
"8694","ENSGALG00000019755","18",10415825,10417773,1948
"8695","ENSGALG00000019756","Z",27814456,27819700,5244
"8696","ENSGALG00000019761","18",10351958,10359644,7686
"8697","ENSGALG00000019768","18",10339902,10375108,35206
"8698","ENSGALG00000019794","25",3611935,3614394,2459
"8699","ENSGALG00000019795","18",9875037,9878121,3084
"8700","ENSGALG00000019796","25",3601925,3610753,8828
"8701","ENSGALG00000019797","27",5243768,5247636,3868
"8702","ENSGALG00000019802","26",784348,786593,2245
"8703","ENSGALG00000019824","27",4598068,4598790,722
"8704","ENSGALG00000019835","16",2493004,2535671,42667
"8705","ENSGALG00000019842","3",108267469,108317357,49888
"8706","ENSGALG00000019844","3",107437997,107440666,2669
"8707","ENSGALG00000019845","3",107433951,107437008,3057
"8708","ENSGALG00000019846","3",107406231,107408849,2618
"8709","ENSGALG00000019847","3",107402570,107403775,1205
"8710","ENSGALG00000019848","3",107393000,107397608,4608
"8711","ENSGALG00000019866","3",104201718,104205041,3323
"8712","ENSGALG00000019867","3",104100480,104108106,7626
"8713","ENSGALG00000019873","3",100529313,100534481,5168
"8714","ENSGALG00000019894","3",88430716,88436533,5817
"8715","ENSGALG00000019921","3",72657213,72662193,4980
"8716","ENSGALG00000019932","3",66959618,67045327,85709
"8717","ENSGALG00000019941","3",63775429,63778379,2950
"8718","ENSGALG00000019958","3",58568355,58593304,24949
"8719","ENSGALG00000019961","3",56867709,56881574,13865
"8720","ENSGALG00000019967","3",55321006,55331784,10778
"8721","ENSGALG00000019976","3",52558946,52569466,10520
"8722","ENSGALG00000019979","3",52164989,52169351,4362
"8723","ENSGALG00000019987","3",48355508,48368306,12798
"8724","ENSGALG00000020002","3",45522548,45546115,23567
"8725","ENSGALG00000020003","3",45356209,45429063,72854
"8726","ENSGALG00000020005","3",42961543,42976660,15117
"8727","ENSGALG00000020049","3",29204412,29213740,9328
"8728","ENSGALG00000020057","3",26853522,26874011,20489
"8729","ENSGALG00000020067","3",21842847,21869197,26350
"8730","ENSGALG00000020078","3",17240827,17247359,6532
"8731","ENSGALG00000020084","3",8479768,8512438,32670
"8732","ENSGALG00000020108","4",86100563,86111021,10458
"8733","ENSGALG00000020139","4",70171192,70186328,15136
"8734","ENSGALG00000020143","4",67151128,67199608,48480
"8735","ENSGALG00000020151","4",65036791,65049180,12389
"8736","ENSGALG00000020160","4",59962436,59973183,10747
"8737","ENSGALG00000020164","4",58117523,58120305,2782
"8738","ENSGALG00000020193","4",46421939,46423376,1437
"8739","ENSGALG00000020201","4",43667177,43710808,43631
"8740","ENSGALG00000020210","4",39471077,39483120,12043
"8741","ENSGALG00000020249","4",22059886,22232141,172255
"8742","ENSGALG00000020251","4",21962143,22007886,45743
"8743","ENSGALG00000020253","4",20616732,20625403,8671
"8744","ENSGALG00000020260","4",16608757,16614220,5463
"8745","ENSGALG00000020261","4",16489504,16491587,2083
"8746","ENSGALG00000020262","4",16483185,16488068,4883
"8747","ENSGALG00000020292","4",10827137,10859217,32080
"8748","ENSGALG00000020316","4",2834589,2850667,16078
"8749","ENSGALG00000020320","4",2402026,2406120,4094
"8750","ENSGALG00000020322","4",2191580,2199755,8175
"8751","ENSGALG00000020331","4",1435125,1442502,7377
"8752","ENSGALG00000020340","5",58171089,58174934,3845
"8753","ENSGALG00000020342","5",58110070,58114838,4768
"8754","ENSGALG00000020359","5",54616844,54619695,2851
"8755","ENSGALG00000020386","5",46575153,46577714,2561
"8756","ENSGALG00000020388","5",45800125,45803318,3193
"8757","ENSGALG00000020390","5",45766602,45774064,7462
"8758","ENSGALG00000020391","5",45701184,45710860,9676
"8759","ENSGALG00000020392","5",45465233,45507935,42702
"8760","ENSGALG00000020402","5",43821392,43876997,55605
"8761","ENSGALG00000020410","5",39411840,39416882,5042
"8762","ENSGALG00000020415","5",38686021,38729635,43614
"8763","ENSGALG00000020417","5",38131606,38133298,1692
"8764","ENSGALG00000020419","5",37954400,37996720,42320
"8765","ENSGALG00000020438","5",32187079,32371107,184028
"8766","ENSGALG00000020449","5",27754919,27793755,38836
"8767","ENSGALG00000020454","5",26420941,26422805,1864
"8768","ENSGALG00000020458","5",25599967,25609281,9314
"8769","ENSGALG00000020479","5",17269101,17278700,9599
"8770","ENSGALG00000020485","5",16903727,16905290,1563
"8771","ENSGALG00000020486","5",16864148,16878250,14102
"8772","ENSGALG00000020488","5",16487057,16507835,20778
"8773","ENSGALG00000020505","5",12064883,12066076,1193
"8774","ENSGALG00000020510","5",9836264,9838519,2255
"8775","ENSGALG00000020523","Z",67319346,67323518,4172
"8776","ENSGALG00000020528","Z",66125224,66135708,10484
"8777","ENSGALG00000020534","Z",64365002,64369042,4040
"8778","ENSGALG00000020538","Z",52795221,52811746,16525
"8779","ENSGALG00000020554","Z",33117991,33546156,428165
"8780","ENSGALG00000020557","Z",28093889,28397186,303297
"8781","ENSGALG00000020561","Z",16555542,16594029,38487
"8782","ENSGALG00000020569","Z",19481987,19488829,6842
"8783","ENSGALG00000020575","7",36210187,36213483,3296
"8784","ENSGALG00000020582","28",3355194,3361525,6331
"8785","ENSGALG00000020590","8",30178113,30182424,4311
"8786","ENSGALG00000020615","6",35838879,35863626,24747
"8787","ENSGALG00000020626","9",22834860,22846130,11270
"8788","ENSGALG00000020647","8",25474003,25477526,3523
"8789","ENSGALG00000020656","6",30704497,30726370,21873
"8790","ENSGALG00000020679","6",28482182,28494460,12278
"8791","ENSGALG00000020688","8",22223376,22232044,8668
"8792","ENSGALG00000020703","7",20136713,20204198,67485
"8793","ENSGALG00000020716","8",21088565,21100451,11886
"8794","ENSGALG00000020726","6",24027735,24031075,3340
"8795","ENSGALG00000020729","3",12687919,12693207,5288
"8796","ENSGALG00000020736","7",18594485,18595219,734
"8797","ENSGALG00000020737","7",18586259,18590492,4233
"8798","ENSGALG00000020741","6",23501555,23504014,2459
"8799","ENSGALG00000020742","6",23460825,23470764,9939
"8800","ENSGALG00000020745","12",19916702,19919823,3121
"8801","ENSGALG00000020747","12",19878301,19881713,3412
"8802","ENSGALG00000020754","6",23061953,23063322,1369
"8803","ENSGALG00000020768","7",16333056,16334408,1352
"8804","ENSGALG00000020775","6",21964044,21983509,19465
"8805","ENSGALG00000020788","7",15082040,15139517,57477
"8806","ENSGALG00000020793","7",14518494,14574608,56114
"8807","ENSGALG00000020805","8",15392220,15422149,29929
"8808","ENSGALG00000020813","9",13815145,13849701,34556
"8809","ENSGALG00000020827","9",13237350,13270729,33379
"8810","ENSGALG00000020836","7",12428220,12435608,7388
"8811","ENSGALG00000020869","7",11365021,11371116,6095
"8812","ENSGALG00000020876","7",11237134,11279715,42581
"8813","ENSGALG00000020879","8",12141354,12164823,23469
"8814","ENSGALG00000020884","8",12080882,12112204,31322
"8815","ENSGALG00000020895","20",12079635,12100294,20659
"8816","ENSGALG00000020905","15",11497885,11545726,47841
"8817","ENSGALG00000020906","19",4527737,4529428,1691
"8818","ENSGALG00000020921","10",20487869,20499372,11503
"8819","ENSGALG00000020922","8",8212688,8298953,86265
"8820","ENSGALG00000020927","8",8004239,8010056,5817
"8821","ENSGALG00000020939","20",10726443,10731744,5301
"8822","ENSGALG00000020943","9",5044890,5048399,3509
"8823","ENSGALG00000020975","15",9936603,9950264,13661
"8824","ENSGALG00000020982","20",10310829,10316294,5465
"8825","ENSGALG00000020984","8",6487371,6488568,1197
"8826","ENSGALG00000020985","9",5450891,5456644,5753
"8827","ENSGALG00000020986","9",5471584,5475630,4046
"8828","ENSGALG00000020989","15",9655323,9657040,1717
"8829","ENSGALG00000020999","15",9572115,9574470,2355
"8830","ENSGALG00000021017","20",10068977,10076375,7398
"8831","ENSGALG00000021020","10",18251243,18252725,1482
"8832","ENSGALG00000021025","20",10009760,10015306,5546
"8833","ENSGALG00000021027","10",18187683,18191648,3965
"8834","ENSGALG00000021031","7",5066256,5071201,4945
"8835","ENSGALG00000021039","6",11554809,11571465,16656
"8836","ENSGALG00000021040","14",6435737,6439442,3705
"8837","ENSGALG00000021047","8",5375820,5440117,64297
"8838","ENSGALG00000021074","8",5107267,5109258,1991
"8839","ENSGALG00000021079","20",9335909,9349311,13402
"8840","ENSGALG00000021092","9",9675721,9683849,8128
"8841","ENSGALG00000021113","13",17424076,17425289,1213
"8842","ENSGALG00000021117","9",10416504,10422942,6438
"8843","ENSGALG00000021126","15",8319427,8327320,7893
"8844","ENSGALG00000021128","14",4589041,4595297,6256
"8845","ENSGALG00000021135","10",13483840,13488077,4237
"8846","ENSGALG00000021136","15",8243345,8244220,875
"8847","ENSGALG00000021143","8",4037595,4046218,8623
"8848","ENSGALG00000021158","11",9941798,9954055,12257
"8849","ENSGALG00000021163","Z",42401694,42410250,8556
"8850","ENSGALG00000021171","10",12742813,12791419,48606
"8851","ENSGALG00000021174","24",6256410,6281701,25291
"8852","ENSGALG00000021180","9",10760401,10761648,1247
"8853","ENSGALG00000021183","10",12600776,12605757,4981
"8854","ENSGALG00000021193","10",12543742,12547993,4251
"8855","ENSGALG00000021198","12",3495427,3502714,7287
"8856","ENSGALG00000021213","6",5935568,5951420,15852
"8857","ENSGALG00000021220","20",6868681,6870332,1651
"8858","ENSGALG00000021225","11",7727755,7733916,6161
"8859","ENSGALG00000021230","20",6698519,6707788,9269
"8860","ENSGALG00000021231","6",5819141,5824328,5187
"8861","ENSGALG00000021232","20",6677188,6690846,13658
"8862","ENSGALG00000021235","13",15167594,15168718,1124
"8863","ENSGALG00000021238","14",2656528,2663612,7084
"8864","ENSGALG00000021262","6",3825088,3833797,8709
"8865","ENSGALG00000021271","24",5465928,5471790,5862
"8866","ENSGALG00000021272","24",5455340,5458260,2920
"8867","ENSGALG00000021273","24",5421298,5428328,7030
"8868","ENSGALG00000021274","17",1297148,1303603,6455
"8869","ENSGALG00000021275","13",14213029,14217036,4007
"8870","ENSGALG00000021285","15",6946607,6950966,4359
"8871","ENSGALG00000021286","14",1435117,1438475,3358
"8872","ENSGALG00000021301","13",14045467,14050129,4662
"8873","ENSGALG00000021303","13",14032708,14037944,5236
"8874","ENSGALG00000021304","Z",11028611,11066332,37721
"8875","ENSGALG00000021314","14",1241795,1252146,10351
"8876","ENSGALG00000021340","Z",9225475,9236423,10948
"8877","ENSGALG00000021341","15",6541220,6543679,2459
"8878","ENSGALG00000021345","11",2432617,2439530,6913
"8879","ENSGALG00000021353","Z",9061604,9064699,3095
"8880","ENSGALG00000021355","Z",9015759,9024777,9018
"8881","ENSGALG00000021357","20",5107091,5112331,5240
"8882","ENSGALG00000021362","18",9131978,9135879,3901
"8883","ENSGALG00000021364","14",13580809,13582729,1920
"8884","ENSGALG00000021365","Z",7913360,7921570,8210
"8885","ENSGALG00000021378","Z",7543736,7574787,31051
"8886","ENSGALG00000021395","18",7924961,7946282,21321
"8887","ENSGALG00000021399","18",7902891,7923210,20319
"8888","ENSGALG00000021405","15",5927685,5935203,7518
"8889","ENSGALG00000021442","11",1139950,1156764,16814
"8890","ENSGALG00000021443","24",334541,338653,4112
"8891","ENSGALG00000021451","11",1044286,1046844,2558
"8892","ENSGALG00000021471","13",9223501,9228465,4964
"8893","ENSGALG00000021473","11",708886,719090,10204
"8894","ENSGALG00000021475","25",2955362,2966558,11196
"8895","ENSGALG00000021525","10",3054272,3057527,3255
"8896","ENSGALG00000021529","15",1077705,1080678,2973
"8897","ENSGALG00000021539","18",4438665,4461906,23241
"8898","ENSGALG00000021542","13",11057186,11060853,3667
"8899","ENSGALG00000021552","18",4067497,4068773,1276
"8900","ENSGALG00000021553","17",8569117,8571073,1956
"8901","ENSGALG00000021561","21",6393638,6396098,2460
"8902","ENSGALG00000021567","21",6118469,6146506,28037
"8903","ENSGALG00000021569","21",6079357,6081398,2041
"8904","ENSGALG00000021570","17",9108573,9110112,1539
"8905","ENSGALG00000021572","19",6233052,6271407,38355
"8906","ENSGALG00000021589","19",5615835,5617148,1313
"8907","ENSGALG00000021592","19",5511028,5514828,3800
"8908","ENSGALG00000021598","21",5258905,5263537,4632
"8909","ENSGALG00000021601","28",4442380,4476748,34368
"8910","ENSGALG00000021611","19",5181549,5200755,19206
"8911","ENSGALG00000021620","28",3971267,3976292,5025
"8912","ENSGALG00000021627","23",4490448,4491440,992
"8913","ENSGALG00000021634","23",4225505,4234046,8541
"8914","ENSGALG00000021636","19",4027300,4254453,227153
"8915","ENSGALG00000021637","28",2971390,2983042,11652
"8916","ENSGALG00000021647","28",1622219,1636765,14546
"8917","ENSGALG00000021653","19",3470554,3659524,188970
"8918","ENSGALG00000021656","26",3746839,3760199,13360
"8919","ENSGALG00000021658","23",3379579,3385804,6225
"8920","ENSGALG00000021665","19",2810151,2824405,14254
"8921","ENSGALG00000021676","21",2000431,2008534,8103
"8922","ENSGALG00000021679","28",2112947,2117081,4134
"8923","ENSGALG00000021683","21",1561165,1568555,7390
"8924","ENSGALG00000021685","23",722207,728463,6256
"8925","ENSGALG00000021686","23",709461,710346,885
"8926","ENSGALG00000021688","28",985592,989803,4211
"8927","ENSGALG00000021692","28",889570,892603,3033
"8928","ENSGALG00000021696","19",496901,500928,4027
"8929","ENSGALG00000021721","19",6010674,6010742,68
"8930","ENSGALG00000021722","28",3708388,3708475,87
"8931","ENSGALG00000021724","19",7339856,7339945,89
"8932","ENSGALG00000021727","2",8899843,8899933,90
"8933","ENSGALG00000021729","14",1167548,1167633,85
"8934","ENSGALG00000021731","14",1172355,1172464,109
"8935","ENSGALG00000021733","19",7513411,7513507,96
"8936","ENSGALG00000021734","1",57867696,57867792,96
"8937","ENSGALG00000021737","18",6430626,6430721,95
"8938","ENSGALG00000021738","19",5290906,5290980,74
"8939","ENSGALG00000021743","19",5036593,5036724,131
"8940","ENSGALG00000021748","1",197373098,197373189,91
"8941","ENSGALG00000021750","Z",1081141,1081208,67
"8942","ENSGALG00000021758","17",7167053,7167129,76
"8943","ENSGALG00000021762","Z",1080060,1080126,66
"8944","ENSGALG00000021766","1",197372419,197372509,90
"8945","ENSGALG00000021770","Z",16702879,16702964,85
"8946","ENSGALG00000021772","6",22456105,22456193,88
"8947","ENSGALG00000021775","19",7340144,7340237,93
"8948","ENSGALG00000021778","21",2598564,2598647,83
"8949","ENSGALG00000021782","6",24096323,24096427,104
"8950","ENSGALG00000021786","4",2699809,2699898,89
"8951","ENSGALG00000021788","2",76452144,76452225,81
"8952","ENSGALG00000021791","19",6010829,6010913,84
"8953","ENSGALG00000021843","Z",44218672,44328999,110327
"8954","ENSGALG00000021848","Z",9136599,9137711,1112
"8955","ENSGALG00000021855","9",17337013,17344782,7769
"8956","ENSGALG00000021856","7",18184607,18191212,6605
"8957","ENSGALG00000021869","8",24907072,24927370,20298
"8958","ENSGALG00000021883","28",4433844,4437586,3742
"8959","ENSGALG00000021884","28",3532747,3534622,1875
"8960","ENSGALG00000021908","13",8954755,8954870,115
"8961","ENSGALG00000021910","10",11118947,11119016,69
"8962","ENSGALG00000021931","23",2304003,2304207,204
"8963","ENSGALG00000021938","2",127366783,127366917,134
"8964","ENSGALG00000021952","27",6242486,6242565,79
"8965","ENSGALG00000021972","28",2639957,2642578,2621
"8966","ENSGALG00000022030","27",7042112,7045309,3197
"8967","ENSGALG00000022137","25",3860483,3861621,1138
"8968","ENSGALG00000022166","7",22556105,22558194,2089
"8969","ENSGALG00000022206","5",6004144,6009441,5297
"8970","ENSGALG00000022440","23",4202553,4203814,1261
"8971","ENSGALG00000022531","5",24237569,24241495,3926
"8972","ENSGALG00000022536","18",9127667,9129209,1542
"8973","ENSGALG00000022557","19",855485,857200,1715
"8974","ENSGALG00000022622","2",32608898,32611583,2685
"8975","ENSGALG00000022644","12",11908497,11924857,16360
"8976","ENSGALG00000022696","1",195858573,195860342,1769
"8977","ENSGALG00000022702","1",197033435,197037036,3601
"8978","ENSGALG00000022704","1",197389587,197391246,1659
"8979","ENSGALG00000022718","1",186918010,186919080,1070
"8980","ENSGALG00000022720","1",180296063,180296740,677
"8981","ENSGALG00000022733","1",170591228,170592318,1090
"8982","ENSGALG00000022739","1",167729811,167761561,31750
"8983","ENSGALG00000022750","1",146060187,146065582,5395
"8984","ENSGALG00000022758","1",145387493,145417076,29583
"8985","ENSGALG00000022762","1",142238918,142254571,15653
"8986","ENSGALG00000022804","1",111576236,111616455,40219
"8987","ENSGALG00000022813","1",110902176,110909972,7796
"8988","ENSGALG00000022815","3",107430692,107459717,29025
"8989","ENSGALG00000022827","2",111354977,111362925,7948
"8990","ENSGALG00000022850","3",104445655,104450689,5034
"8991","ENSGALG00000022866","1",90035289,90069147,33858
"8992","ENSGALG00000022871","1",88748622,88761403,12781
"8993","ENSGALG00000022874","2",98394180,98467538,73358
"8994","ENSGALG00000022875","2",98074041,98078558,4517
"8995","ENSGALG00000022882","2",91390441,91396404,5963
"8996","ENSGALG00000022887","3",90806171,90840392,34221
"8997","ENSGALG00000022891","1",81408455,81422616,14161
"8998","ENSGALG00000022896","2",86044965,86053142,8177
"8999","ENSGALG00000022909","2",84613361,84766062,152701
"9000","ENSGALG00000022920","4",89706420,89714666,8246
"9001","ENSGALG00000022926","1",77894615,77899113,4498
"9002","ENSGALG00000022950","4",85493267,85495164,1897
"9003","ENSGALG00000022976","2",63453370,63526595,73225
"9004","ENSGALG00000022980","1",72102062,72105400,3338
"9005","ENSGALG00000022991","4",73372750,73376776,4026
"9006","ENSGALG00000023032","4",68051862,68086837,34975
"9007","ENSGALG00000023036","Z",81787829,81793027,5198
"9008","ENSGALG00000023066","Z",70797443,70805858,8415
"9009","ENSGALG00000023070","5",45754128,45759449,5321
"9010","ENSGALG00000023083","Z",66163515,66184739,21224
"9011","ENSGALG00000023089","Z",63726084,63891888,165804
"9012","ENSGALG00000023099","5",39304781,39310965,6184
"9013","ENSGALG00000023120","4",51792613,51795126,2513
"9014","ENSGALG00000023122","4",51790372,51792467,2095
"9015","ENSGALG00000023131","1",51181690,51185095,3405
"9016","ENSGALG00000023135","5",36286791,36299804,13013
"9017","ENSGALG00000023142","8",29452244,29460129,7885
"9018","ENSGALG00000023157","Z",46072707,46095084,22377
"9019","ENSGALG00000023172","4",49567944,49579912,11968
"9020","ENSGALG00000023179","Z",42849105,42926929,77824
"9021","ENSGALG00000023189","2",24794127,24862531,68404
"9022","ENSGALG00000023191","4",46463751,46465918,2167
"9023","ENSGALG00000023193","1",49228299,49238706,10407
"9024","ENSGALG00000023195","2",24442691,24446535,3844
"9025","ENSGALG00000023199","4",46402176,46406523,4347
"9026","ENSGALG00000023256","3",30308983,30359625,50642
"9027","ENSGALG00000023279","18",10313614,10319264,5650
"9028","ENSGALG00000023294","15",9721482,9724691,3209
"9029","ENSGALG00000023296","8",22260965,22269319,8354
"9030","ENSGALG00000023303","3",26002837,26005896,3059
"9031","ENSGALG00000023335","4",34596009,34599582,3573
"9032","ENSGALG00000023338","18",9626841,9633475,6634
"9033","ENSGALG00000023348","8",21383947,21385536,1589
"9034","ENSGALG00000023354","18",9181817,9184606,2789
"9035","ENSGALG00000023355","4",33862692,33875050,12358
"9036","ENSGALG00000023359","18",9120847,9124152,3305
"9037","ENSGALG00000023364","18",9001409,9008787,7378
"9038","ENSGALG00000023379","Z",23491652,23495738,4086
"9039","ENSGALG00000023395","10",13263392,13268054,4662
"9040","ENSGALG00000023396","15",7425953,7432354,6401
"9041","ENSGALG00000023407","17",10555811,10564313,8502
"9042","ENSGALG00000023411","Z",21298598,21307258,8660
"9043","ENSGALG00000023415","6",32447795,32448904,1109
"9044","ENSGALG00000023419","7",16275972,16277643,1671
"9045","ENSGALG00000023420","7",16262309,16266918,4609
"9046","ENSGALG00000023435","10",11349046,11362107,13061
"9047","ENSGALG00000023436","10",11326310,11335670,9360
"9048","ENSGALG00000023437","11",19037098,19038957,1859
"9049","ENSGALG00000023439","7",15407598,15417032,9434
"9050","ENSGALG00000023440","10",11304508,11323918,19410
"9051","ENSGALG00000023443","Z",19017539,19020278,2739
"9052","ENSGALG00000023444","4",23781600,23784481,2881
"9053","ENSGALG00000023451","10",11241995,11274547,32552
"9054","ENSGALG00000023454","2",6264549,6270436,5887
"9055","ENSGALG00000023468","11",18769479,18771877,2398
"9056","ENSGALG00000023472","11",18746744,18748973,2229
"9057","ENSGALG00000023490","8",14618965,14626886,7921
"9058","ENSGALG00000023506","3",16499070,16516696,17626
"9059","ENSGALG00000023510","15",6557193,6561304,4111
"9060","ENSGALG00000023517","17",8036089,8043918,7829
"9061","ENSGALG00000023521","6",27190992,27192326,1334
"9062","ENSGALG00000023541","18",4429920,4435069,5149
"9063","ENSGALG00000023542","21",6603424,6609227,5803
"9064","ENSGALG00000023546","9",22401775,22412510,10735
"9065","ENSGALG00000023547","20",10541717,10549882,8165
"9066","ENSGALG00000023552","Z",10794665,10840965,46300
"9067","ENSGALG00000023554","19",8290811,8292659,1848
"9068","ENSGALG00000023571","9",22301097,22314263,13166
"9069","ENSGALG00000023576","1",19335370,19339085,3715
"9070","ENSGALG00000023580","21",6385630,6391605,5975
"9071","ENSGALG00000023581","18",3547374,3566558,19184
"9072","ENSGALG00000023584","1",17209559,17632970,423411
"9073","ENSGALG00000023601","3",13885030,13898284,13254
"9074","ENSGALG00000023612","6",24034163,24038052,3889
"9075","ENSGALG00000023616","9",20073998,20085147,11149
"9076","ENSGALG00000023621","6",24023221,24026439,3218
"9077","ENSGALG00000023622","Z",9152592,9154039,1447
"9078","ENSGALG00000023626","18",2045332,2093589,48257
"9079","ENSGALG00000023632","2",601952,610729,8777
"9080","ENSGALG00000023640","20",9886560,9892837,6277
"9081","ENSGALG00000023648","3",11868416,11901866,33450
"9082","ENSGALG00000023661","1",14881061,14892683,11622
"9083","ENSGALG00000023670","9",18476287,18824985,348698
"9084","ENSGALG00000023682","15",5235774,5240703,4929
"9085","ENSGALG00000023683","15",5227178,5235320,8142
"9086","ENSGALG00000023686","19",6597285,6607165,9880
"9087","ENSGALG00000023689","17",6180976,6201571,20595
"9088","ENSGALG00000023691","6",23064891,23068556,3665
"9089","ENSGALG00000023692","4",10993272,10994493,1221
"9090","ENSGALG00000023703","19",6209768,6217660,7892
"9091","ENSGALG00000023708","21",4848886,4856154,7268
"9092","ENSGALG00000023709","17",5990121,5992857,2736
"9093","ENSGALG00000023725","8",6182039,6182746,707
"9094","ENSGALG00000023740","14",12503627,12505300,1673
"9095","ENSGALG00000023742","7",6598427,6621152,22725
"9096","ENSGALG00000023749","8",5934400,5951009,16609
"9097","ENSGALG00000023757","19",5783014,5786054,3040
"9098","ENSGALG00000023760","26",5081076,5100133,19057
"9099","ENSGALG00000023763","26",5077888,5080553,2665
"9100","ENSGALG00000023772","21",4315567,4317250,1683
"9101","ENSGALG00000023773","3",4589332,4617178,27846
"9102","ENSGALG00000023780","26",4755127,4761551,6424
"9103","ENSGALG00000023781","26",4745842,4753272,7430
"9104","ENSGALG00000023787","19",5520091,5526773,6682
"9105","ENSGALG00000023806","19",5426346,5450009,23663
"9106","ENSGALG00000023812","13",17680388,17687210,6822
"9107","ENSGALG00000023818","27",7654604,7655550,946
"9108","ENSGALG00000023819","27",7653224,7653761,537
"9109","ENSGALG00000023821","27",7642263,7646075,3812
"9110","ENSGALG00000023824","6",19996152,20008824,12672
"9111","ENSGALG00000023834","20",5503054,5505222,2168
"9112","ENSGALG00000023843","4",3457255,3465447,8192
"9113","ENSGALG00000023844","20",5338568,5340103,1535
"9114","ENSGALG00000023847","27",7466900,7475380,8480
"9115","ENSGALG00000023866","9",15718312,15723444,5132
"9116","ENSGALG00000023872","17",2779784,2798309,18525
"9117","ENSGALG00000023881","27",6899093,6910109,11016
"9118","ENSGALG00000023882","3",3067991,3070900,2909
"9119","ENSGALG00000023886","7",1828066,1959021,130955
"9120","ENSGALG00000023897","8",4029203,4033033,3830
"9121","ENSGALG00000023898","11",1269388,1321969,52581
"9122","ENSGALG00000023904","5",3728374,3730202,1828
"9123","ENSGALG00000023909","17",2251947,2263808,11861
"9124","ENSGALG00000023920","13",14995062,15005975,10913
"9125","ENSGALG00000023933","26",3140579,3141464,885
"9126","ENSGALG00000023934","3",2164309,2210774,46465
"9127","ENSGALG00000023936","21",2230310,2238408,8098
"9128","ENSGALG00000023937","4",2176683,2182464,5781
"9129","ENSGALG00000023950","26",2656096,2664136,8040
"9130","ENSGALG00000023953","26",2635048,2641917,6869
"9131","ENSGALG00000024024","22",4160195,4172378,12183
"9132","ENSGALG00000024031","27",5054364,5059250,4886
"9133","ENSGALG00000024034","25",295925,309861,13936
"9134","ENSGALG00000024039","4",1617083,1622728,5645
"9135","ENSGALG00000024041","14",6449138,6450753,1615
"9136","ENSGALG00000024047","23",5680673,5684455,3782
"9137","ENSGALG00000024049","4",1567283,1571532,4249
"9138","ENSGALG00000024051","25",196453,210956,14503
"9139","ENSGALG00000024053","21",633126,636523,3397
"9140","ENSGALG00000024056","6",12683537,12689040,5503
"9141","ENSGALG00000024077","1",92747952,92757871,9919
"9142","ENSGALG00000024081","20",479315,484154,4839
"9143","ENSGALG00000024082","14",5493823,5499029,5206
"9144","ENSGALG00000024083","22",2793540,2795001,1461
"9145","ENSGALG00000024085","22",2775761,2780552,4791
"9146","ENSGALG00000024094","25",2888965,2910642,21677
"9147","ENSGALG00000024112","27",3891239,3898705,7466
"9148","ENSGALG00000024122","14",5052186,5055318,3132
"9149","ENSGALG00000024136","25",2266372,2267965,1593
"9150","ENSGALG00000024171","13",11170966,11176176,5210
"9151","ENSGALG00000024172","13",11143957,11147476,3519
"9152","ENSGALG00000024266","9",5724945,5763268,38323
"9153","ENSGALG00000024271","6",10065545,10067481,1936
"9154","ENSGALG00000024272","25",3296971,3298411,1440
"9155","ENSGALG00000024288","6",9931019,9935551,4532
"9156","ENSGALG00000024295","23",3409942,3412216,2274
"9157","ENSGALG00000024296","24",1457361,1463778,6417
"9158","ENSGALG00000024298","28",3331413,3336022,4609
"9159","ENSGALG00000024318","23",2822852,2824408,1556
"9160","ENSGALG00000024326","24",339199,343618,4419
"9161","ENSGALG00000024332","28",2764612,2770412,5800
"9162","ENSGALG00000024335","18",43337,45028,1691
"9163","ENSGALG00000024378","28",1838058,1841885,3827
"9164","ENSGALG00000024379","13",3147680,3166499,18819
"9165","ENSGALG00000024391","28",1133936,1138442,4506
"9166","ENSGALG00000024395","28",1022915,1024729,1814
"9167","ENSGALG00000024428","18",6256027,6262584,6557
"9168","ENSGALG00000024449","27",7849653,7851555,1902
"9169","ENSGALG00000024466","11",782460,783685,1225
"9170","ENSGALG00000024470","19",4937405,4939029,1624
"9171","ENSGALG00000024480","1",93698488,93704946,6458
"9172","ENSGALG00000024481","21",3735571,3738764,3193
"9173","ENSGALG00000024482","4",49238033,49242641,4608
"9174","ENSGALG00000024485","2",23396962,23403111,6149
"9175","ENSGALG00000024486","4",83117730,83129665,11935
"9176","ENSGALG00000024488","1",129862450,129887257,24807
"9177","ENSGALG00000024490","4",69443374,69469660,26286
"9178","ENSGALG00000024495","4",4044234,4044304,70
"9179","ENSGALG00000024497","4",88746692,88746820,128
"9180","ENSGALG00000024498","8",5026477,5026586,109
"9181","ENSGALG00000024500","20",8692479,8692576,97
"9182","ENSGALG00000024502","8",28612643,28612729,86
"9183","ENSGALG00000024504","4",4044594,4044681,87
"9184","ENSGALG00000024507","19",5528017,5528116,99
"9185","ENSGALG00000024525","5",39205123,39205240,117
"9186","ENSGALG00000024565","1",187124270,187124392,122
"9187","ENSGALG00000024572","5",13313435,13313563,128
"9188","ENSGALG00000024592","Z",9780966,9781102,136
"9189","ENSGALG00000024609","4",33239178,33239248,70
"9190","ENSGALG00000024628","23",2412598,2412724,126
"9191","ENSGALG00000024631","5",23664133,23664243,110
"9192","ENSGALG00000024676","1",50496807,50497132,325
"9193","ENSGALG00000024697","7",11782223,11782311,88
"9194","ENSGALG00000024701","23",597626,597706,80
"9195","ENSGALG00000024758","8",21123800,21123871,71
"9196","ENSGALG00000024871","19",5290059,5290132,73
"9197","ENSGALG00000024890","3",56860984,56861056,72
"9198","ENSGALG00000024933","23",1092929,1093045,116
"9199","ENSGALG00000024938","Z",1080614,1080682,68
"9200","ENSGALG00000024964","1",46701236,46701476,240
"9201","ENSGALG00000024979","Z",1078382,1078449,67
"9202","ENSGALG00000024984","8",7792061,7792138,77
"9203","ENSGALG00000025003","1",187135952,187136017,65
"9204","ENSGALG00000025021","19",4609982,4610079,97
"9205","ENSGALG00000025086","3",76868153,76868223,70
"9206","ENSGALG00000025089","11",18734571,18734652,81
"9207","ENSGALG00000025093","7",11786870,11786957,87
"9208","ENSGALG00000025103","5",13316814,13316934,120
"9209","ENSGALG00000025149","5",16028807,16028908,101
"9210","ENSGALG00000025150","13",2828076,2828159,83
"9211","ENSGALG00000025151","11",18388408,18388505,97
"9212","ENSGALG00000025152","2",114304737,114304812,75
"9213","ENSGALG00000025153","4",13437062,13437130,68
"9214","ENSGALG00000025156","14",7110572,7110664,92
"9215","ENSGALG00000025158","8",18847849,18847936,87
"9216","ENSGALG00000025163","4",38983525,38983594,69
"9217","ENSGALG00000025164","10",16308512,16308600,88
"9218","ENSGALG00000025166","8",7792880,7792946,66
"9219","ENSGALG00000025173","5",56602796,56602895,99
"9220","ENSGALG00000025174","5",51799321,51799406,85
"9221","ENSGALG00000025175","10",19507819,19507892,73
"9222","ENSGALG00000025177","1",95234292,95234376,84
"9223","ENSGALG00000025179","18",8658698,8658765,67
"9224","ENSGALG00000025181","13",12847630,12847702,72
"9225","ENSGALG00000025182","7",1309230,1309317,87
"9226","ENSGALG00000025184","19",5711603,5711692,89
"9227","ENSGALG00000025185","8",21124949,21125077,128
"9228","ENSGALG00000025187","17",2193803,2193898,95
"9229","ENSGALG00000025190","1",176539167,176539260,93
"9230","ENSGALG00000025192","1",133979056,133979173,117
"9231","ENSGALG00000025193","1",23274416,23274649,233
"9232","ENSGALG00000025194","1",51726988,51727070,82
"9233","ENSGALG00000025197","15",1045215,1045314,99
"9234","ENSGALG00000025198","1",196529629,196529722,93
"9235","ENSGALG00000025199","1",146371368,146371453,85
"9236","ENSGALG00000025200","8",5374871,5374944,73
"9237","ENSGALG00000025201","2",3910161,3910234,73
"9238","ENSGALG00000025202","15",5347054,5347113,59
"9239","ENSGALG00000025204","2",30881249,30881336,87
"9240","ENSGALG00000025205","1",177655665,177655740,75
"9241","ENSGALG00000025206","10",17518771,17518863,92
"9242","ENSGALG00000025207","4",8508594,8508703,109
"9243","ENSGALG00000025208","5",45341426,45341501,75
"9244","ENSGALG00000025212","4",20863055,20863184,129
"9245","ENSGALG00000025213","1",182304605,182304686,81
"9246","ENSGALG00000025219","Z",66646483,66646560,77
"9247","ENSGALG00000025221","Z",16703029,16703122,93
"9248","ENSGALG00000025224","1",49890625,49890725,100
"9249","ENSGALG00000025225","Z",70938728,70938825,97
"9250","ENSGALG00000025226","6",33290806,33290902,96
"9251","ENSGALG00000025230","17",3866934,3867008,74
"9252","ENSGALG00000025233","10",18288884,18288975,91
"9253","ENSGALG00000025234","19",5750493,5750562,69
"9254","ENSGALG00000025235","20",8643767,8643866,99
"9255","ENSGALG00000025238","7",16772506,16772605,99
"9256","ENSGALG00000025240","2",19801206,19801266,60
"9257","ENSGALG00000025241","8",4200608,4200710,102
"9258","ENSGALG00000025243","8",25001095,25001194,99
"9259","ENSGALG00000025245","8",7875908,7876006,98
"9260","ENSGALG00000025248","2",68485722,68485820,98
"9261","ENSGALG00000025250","4",51109070,51109157,87
"9262","ENSGALG00000025252","5",8386336,8386403,67
"9263","ENSGALG00000025253","7",5466110,5466207,97
"9264","ENSGALG00000025255","8",24516519,24516620,101
"9265","ENSGALG00000025257","6",23766962,23767057,95
"9266","ENSGALG00000025260","15",6080593,6080695,102
"9267","ENSGALG00000025261","Z",18874865,18874929,64
"9268","ENSGALG00000025264","4",12468266,12468338,72
"9269","ENSGALG00000025266","3",3796289,3796390,101
"9270","ENSGALG00000025269","21",1744561,1744667,106
"9271","ENSGALG00000025270","5",15990915,15991047,132
"9272","ENSGALG00000025275","7",23744568,23744672,104
"9273","ENSGALG00000025276","19",9516450,9516516,66
"9274","ENSGALG00000025278","Z",16704032,16704103,71
"9275","ENSGALG00000025283","6",11452153,11452216,63
"9276","ENSGALG00000025285","1",189595235,189595328,93
"9277","ENSGALG00000025287","8",7822231,7822309,78
"9278","ENSGALG00000025288","2",117455487,117455556,69
"9279","ENSGALG00000025289","5",55970260,55970329,69
"9280","ENSGALG00000025291","19",1977629,1977704,75
"9281","ENSGALG00000025294","15",7856941,7857020,79
"9282","ENSGALG00000025295","13",18641589,18641683,94
"9283","ENSGALG00000025298","4",50089448,50089537,89
"9284","ENSGALG00000025299","3",8420466,8420564,98
"9285","ENSGALG00000025300","6",11170704,11170772,68
"9286","ENSGALG00000025302","11",19781448,19781534,86
"9287","ENSGALG00000025305","2",40151376,40151472,96
"9288","ENSGALG00000025312","12",13251444,13251541,97
"9289","ENSGALG00000025313","8",5702256,5702350,94
"9290","ENSGALG00000025314","5",28533211,28533299,88
"9291","ENSGALG00000025322","4",48210684,48210776,92
"9292","ENSGALG00000025323","18",786461,786541,80
"9293","ENSGALG00000025326","11",18630358,18630461,103
"9294","ENSGALG00000025328","24",2042399,2042475,76
"9295","ENSGALG00000025329","4",2302454,2302574,120
"9296","ENSGALG00000025330","12",9206078,9206178,100
"9297","ENSGALG00000025331","6",30942859,30942982,123
"9298","ENSGALG00000025332","1",26866531,26866609,78
"9299","ENSGALG00000025334","19",9540162,9540265,103
"9300","ENSGALG00000025337","3",56859598,56859684,86
"9301","ENSGALG00000025338","5",28093442,28093521,79
"9302","ENSGALG00000025339","4",65978903,65979020,117
"9303","ENSGALG00000025342","15",10259176,10259266,90
"9304","ENSGALG00000025344","5",31657684,31657763,79
"9305","ENSGALG00000025348","14",5318953,5319025,72
"9306","ENSGALG00000025349","5",17322219,17322298,79
"9307","ENSGALG00000025353","4",46403124,46403206,82
"9308","ENSGALG00000025354","15",2528864,2528966,102
"9309","ENSGALG00000025355","2",4084116,4084257,141
"9310","ENSGALG00000025357","1",140535074,140535172,98
"9311","ENSGALG00000025361","2",4088474,4088610,136
"9312","ENSGALG00000025365","1",134884196,134884261,65
"9313","ENSGALG00000025367","20",9680397,9680492,95
"9314","ENSGALG00000025372","15",4990569,4990656,87
"9315","ENSGALG00000025374","3",96917352,96917446,94
"9316","ENSGALG00000025376","2",61629328,61629404,76
"9317","ENSGALG00000025378","10",13575805,13575869,64
"9318","ENSGALG00000025379","3",79223763,79223835,72
"9319","ENSGALG00000025381","1",191380411,191380524,113
"9320","ENSGALG00000025386","2",41308566,41308671,105
"9321","ENSGALG00000025388","1",49276706,49276791,85
"9322","ENSGALG00000025389","23",2702963,2703033,70
"9323","ENSGALG00000025390","1",187136123,187136205,82
"9324","ENSGALG00000025396","Z",62996232,62996321,89
"9325","ENSGALG00000025400","2",62527570,62527644,74
"9326","ENSGALG00000025404","6",13279449,13279547,98
"9327","ENSGALG00000025407","2",141177037,141177143,106
"9328","ENSGALG00000025412","1",141188851,141188941,90
"9329","ENSGALG00000025413","Z",71815867,71816174,307
"9330","ENSGALG00000025418","7",12573539,12573672,133
"9331","ENSGALG00000025419","14",14468246,14468347,101
"9332","ENSGALG00000025422","14",3720515,3720607,92
"9333","ENSGALG00000025423","6",16653366,16653440,74
"9334","ENSGALG00000025425","3",63019465,63019530,65
"9335","ENSGALG00000025426","1",180980122,180980196,74
"9336","ENSGALG00000025428","4",89198029,89198122,93
"9337","ENSGALG00000025429","4",1916483,1916579,96
"9338","ENSGALG00000025430","15",11722649,11722718,69
"9339","ENSGALG00000025433","Z",16452614,16452687,73
"9340","ENSGALG00000025435","6",3395649,3395715,66
"9341","ENSGALG00000025438","1",197485636,197485715,79
"9342","ENSGALG00000025441","1",6229359,6229448,89
"9343","ENSGALG00000025442","18",10255679,10255743,64
"9344","ENSGALG00000025443","28",3705481,3705551,70
"9345","ENSGALG00000025444","18",9627407,9627502,95
"9346","ENSGALG00000025447","12",1272490,1272578,88
"9347","ENSGALG00000025448","5",10458990,10459099,109
"9348","ENSGALG00000025450","2",24783232,24783319,87
"9349","ENSGALG00000025452","14",8128601,8128709,108
"9350","ENSGALG00000025454","7",10211434,10211520,86
"9351","ENSGALG00000025458","8",23039992,23040099,107
"9352","ENSGALG00000025462","23",5220902,5220977,75
"9353","ENSGALG00000025464","1",33724725,33724856,131
"9354","ENSGALG00000025469","2",137065543,137065629,86
"9355","ENSGALG00000025470","4",29524981,29525084,103
"9356","ENSGALG00000025473","1",6347545,6347634,89
"9357","ENSGALG00000025474","27",6797638,6797716,78
"9358","ENSGALG00000025475","4",1245199,1245295,96
"9359","ENSGALG00000025476","1",128273775,128273879,104
"9360","ENSGALG00000025477","12",2983357,2983442,85
"9361","ENSGALG00000025479","21",2378744,2378821,77
"9362","ENSGALG00000025481","7",16274151,16274249,98
"9363","ENSGALG00000025482","13",3526168,3526237,69
"9364","ENSGALG00000025485","7",19311628,19311705,77
"9365","ENSGALG00000025486","23",591667,591751,84
"9366","ENSGALG00000025491","26",3626795,3626885,90
"9367","ENSGALG00000025492","28",3706782,3706828,46
"9368","ENSGALG00000025493","11",1745667,1745746,79
"9369","ENSGALG00000025499","25",3636026,3636107,81
"9370","ENSGALG00000025501","17",9100604,9100693,89
"9371","ENSGALG00000025506","10",10362842,10362930,88
"9372","ENSGALG00000025508","5",58144371,58144459,88
"9373","ENSGALG00000025509","17",8468029,8468138,109
"9374","ENSGALG00000025510","7",1375484,1375559,75
"9375","ENSGALG00000025512","Z",34656766,34656851,85
"9376","ENSGALG00000025513","3",22958757,22958831,74
"9377","ENSGALG00000025515","7",23698655,23698743,88
"9378","ENSGALG00000025517","3",38288745,38288880,135
"9379","ENSGALG00000025520","20",13077816,13077906,90
"9380","ENSGALG00000025521","4",76253965,76254055,90
"9381","ENSGALG00000025522","1",106098897,106098987,90
"9382","ENSGALG00000025526","4",2169309,2169419,110
"9383","ENSGALG00000025527","8",7796377,7796455,78
"9384","ENSGALG00000025533","15",1058317,1058387,70
"9385","ENSGALG00000025534","4",10929464,10929559,95
"9386","ENSGALG00000025535","14",6193367,6193445,78
"9387","ENSGALG00000025538","19",8983867,8983957,90
"9388","ENSGALG00000025539","23",2914834,2914935,101
"9389","ENSGALG00000025541","3",56859181,56859317,136
"9390","ENSGALG00000025543","2",112907809,112907878,69
"9391","ENSGALG00000025544","Z",44908814,44908923,109
"9392","ENSGALG00000025545","2",88282364,88282468,104
"9393","ENSGALG00000025546","2",45359806,45359846,40
"9394","ENSGALG00000025547","1",158057107,158057209,102
"9395","ENSGALG00000025548","2",92556439,92556527,88
"9396","ENSGALG00000025550","28",1464724,1464802,78
"9397","ENSGALG00000025551","4",89080888,89080997,109
"9398","ENSGALG00000025552","18",6406849,6406933,84
"9399","ENSGALG00000025553","19",1984278,1984373,95
"9400","ENSGALG00000025554","18",10590779,10590851,72
"9401","ENSGALG00000025555","20",8125612,8125689,77
"9402","ENSGALG00000025556","8",28223422,28223513,91
"9403","ENSGALG00000025557","4",39825942,39826228,286
"9404","ENSGALG00000025559","3",73971334,73971406,72
"9405","ENSGALG00000025561","11",1941274,1941368,94
"9406","ENSGALG00000025562","3",42979566,42979624,58
"9407","ENSGALG00000025563","25",3559915,3560007,92
"9408","ENSGALG00000025564","1",196644577,196644713,136
"9409","ENSGALG00000025565","5",39448258,39448350,92
"9410","ENSGALG00000025566","14",5612805,5612894,89
"9411","ENSGALG00000025567","3",75576963,75577060,97
"9412","ENSGALG00000025569","5",55346124,55346190,66
"9413","ENSGALG00000025575","3",35727094,35727196,102
"9414","ENSGALG00000025576","14",14628438,14628539,101
"9415","ENSGALG00000025577","10",3004120,3004217,97
"9416","ENSGALG00000025579","5",57861604,57861708,104
"9417","ENSGALG00000025580","8",12119261,12119327,66
"9418","ENSGALG00000025582","2",30551289,30551411,122
"9419","ENSGALG00000025583","6",9978604,9978746,142
"9420","ENSGALG00000025585","8",7361204,7361336,132
"9421","ENSGALG00000025586","10",2856711,2856774,63
"9422","ENSGALG00000025587","15",1610908,1611040,132
"9423","ENSGALG00000025589","3",91863341,91863444,103
"9424","ENSGALG00000025590","18",4130687,4130856,169
"9425","ENSGALG00000025592","10",18899798,18899933,135
"9426","ENSGALG00000025593","19",5950616,5950688,72
"9427","ENSGALG00000025594","2",55672308,55672424,116
"9428","ENSGALG00000025597","13",2198380,2198457,77
"9429","ENSGALG00000025598","3",76866011,76866077,66
"9430","ENSGALG00000025602","23",2703833,2703961,128
"9431","ENSGALG00000025603","12",1170811,1170889,78
"9432","ENSGALG00000025605","4",83221508,83221638,130
"9433","ENSGALG00000025607","2",147673882,147674211,329
"9434","ENSGALG00000025608","1",178817521,178817622,101
"9435","ENSGALG00000025613","5",35396102,35396194,92
"9436","ENSGALG00000025614","10",11510505,11510635,130
"9437","ENSGALG00000025615","1",77659203,77659343,140
"9438","ENSGALG00000025616","1",119430992,119431122,130
"9439","ENSGALG00000025619","1",31143727,31143886,159
"9440","ENSGALG00000025620","25",2906712,2906845,133
"9441","ENSGALG00000025627","8",7797505,7797579,74
"9442","ENSGALG00000025629","3",45697790,45697922,132
"9443","ENSGALG00000025630","1",97040952,97041023,71
"9444","ENSGALG00000025633","19",5037737,5037868,131
"9445","ENSGALG00000025635","2",111205002,111205068,66
"9446","ENSGALG00000025639","1",169084693,169084828,135
"9447","ENSGALG00000025640","17",9340398,9340536,138
"9448","ENSGALG00000025641","Z",7441643,7441726,83
"9449","ENSGALG00000025643","6",21044801,21044898,97
"9450","ENSGALG00000025644","24",2189675,2189861,186
"9451","ENSGALG00000025646","12",1170345,1170417,72
"9452","ENSGALG00000025648","7",26201424,26201541,117
"9453","ENSGALG00000025649","Z",23310532,23310661,129
"9454","ENSGALG00000025650","8",7009858,7010179,321
"9455","ENSGALG00000025653","1",77588152,77588472,320
"9456","ENSGALG00000025654","17",6508888,6508974,86
"9457","ENSGALG00000025659","14",4402727,4402810,83
"9458","ENSGALG00000025660","Z",7438822,7438906,84
"9459","ENSGALG00000025661","17",8022019,8022151,132
"9460","ENSGALG00000025662","1",187120363,187120489,126
"9461","ENSGALG00000025667","Z",70800672,70800799,127
"9462","ENSGALG00000025668","8",7797718,7797796,78
"9463","ENSGALG00000025669","4",2123171,2123320,149
"9464","ENSGALG00000025671","23",1547448,1547613,165
"9465","ENSGALG00000025672","5",9017886,9018046,160
"9466","ENSGALG00000025674","5",58954474,58954559,85
"9467","ENSGALG00000025675","12",3915211,3915345,134
"9468","ENSGALG00000025677","Z",33591936,33592065,129
"9469","ENSGALG00000025678","4",4071148,4071292,144
"9470","ENSGALG00000025679","7",11789245,11789328,83
"9471","ENSGALG00000025680","1",187124742,187124873,131
"9472","ENSGALG00000025681","2",78590696,78590764,68
"9473","ENSGALG00000025684","22",2948459,2948627,168
"9474","ENSGALG00000025685","Z",70948204,70948292,88
"9475","ENSGALG00000025687","14",6542383,6542511,128
"9476","ENSGALG00000025689","15",11423929,11424033,104
"9477","ENSGALG00000025692","17",1925610,1925731,121
"9478","ENSGALG00000025693","Z",55204043,55204206,163
"9479","ENSGALG00000025694","Z",46405786,46405917,131
"9480","ENSGALG00000025695","5",46257405,46257677,272
"9481","ENSGALG00000025696","4",82337066,82337223,157
"9482","ENSGALG00000025699","8",7964909,7965071,162
"9483","ENSGALG00000025701","1",187119262,187119333,71
"9484","ENSGALG00000025710","4",3221587,3221696,109
"9485","ENSGALG00000025712","11",18845933,18850118,4185
"9486","ENSGALG00000025729","7",22365529,22366476,947
"9487","ENSGALG00000025735","1",47970260,47976073,5813
"9488","ENSGALG00000025738","3",39870601,39877069,6468
"9489","ENSGALG00000025743","14",9101306,9114177,12871
"9490","ENSGALG00000025747","2",66356656,66365541,8885
"9491","ENSGALG00000025748","1",179686487,179717720,31233
"9492","ENSGALG00000025751","28",1567936,1574937,7001
"9493","ENSGALG00000025755","5",36112405,36116717,4312
"9494","ENSGALG00000025759","9",10491970,10546388,54418
"9495","ENSGALG00000025762","4",79636353,79636525,172
"9496","ENSGALG00000025764","27",7499025,7504478,5453
"9497","ENSGALG00000025766","28",3681246,3684888,3642
"9498","ENSGALG00000025772","6",17632410,17636794,4384
"9499","ENSGALG00000025773","26",4412508,4414588,2080
"9500","ENSGALG00000025774","27",6277279,6280220,2941
"9501","ENSGALG00000025775","Z",8585251,8585389,138
"9502","ENSGALG00000025778","20",9801580,9807021,5441
"9503","ENSGALG00000025780","6",25217469,25219175,1706
"9504","ENSGALG00000025782","1",93765634,93765743,109
"9505","ENSGALG00000025788","27",6913922,6925806,11884
"9506","ENSGALG00000025789","4",13761996,13762105,109
"9507","ENSGALG00000025792","2",84289093,84296124,7031
"9508","ENSGALG00000025793","5",2161273,2161446,173
"9509","ENSGALG00000025796","3",93689037,93695541,6504
"9510","ENSGALG00000025800","21",6530136,6533418,3282
"9511","ENSGALG00000025804","9",16077580,16087791,10211
"9512","ENSGALG00000025806","2",77820308,77820384,76
"9513","ENSGALG00000025809","28",3731207,3735239,4032
"9514","ENSGALG00000025810","4",1834030,1837284,3254
"9515","ENSGALG00000025811","2",38726423,38770371,43948
"9516","ENSGALG00000025817","25",2427409,2432025,4616
"9517","ENSGALG00000025819","11",8114445,8118077,3632
"9518","ENSGALG00000025821","9",14079790,14085868,6078
"9519","ENSGALG00000025822","3",32039527,32044728,5201
"9520","ENSGALG00000025842","Z",9207127,9219170,12043
"9521","ENSGALG00000025844","12",2857183,2860820,3637
"9522","ENSGALG00000025851","4",35245520,35247760,2240
"9523","ENSGALG00000025852","20",13075092,13075200,108
"9524","ENSGALG00000025858","23",1789086,1797759,8673
"9525","ENSGALG00000025862","6",9221188,9235876,14688
"9526","ENSGALG00000025864","11",11041561,11112119,70558
"9527","ENSGALG00000025868","Z",9087724,9092161,4437
"9528","ENSGALG00000025872","20",6660421,6674076,13655
"9529","ENSGALG00000025876","9",16101153,16103316,2163
"9530","ENSGALG00000025881","1",51541954,51569755,27801
"9531","ENSGALG00000025882","24",5105623,5130006,24383
"9532","ENSGALG00000025884","7",8141846,8149927,8081
"9533","ENSGALG00000025886","12",7057412,7082243,24831
"9534","ENSGALG00000025889","1",46309161,46309362,201
"9535","ENSGALG00000025896","8",12637014,12664559,27545
"9536","ENSGALG00000025898","10",19113380,19141564,28184
"9537","ENSGALG00000025899","4",11318331,11323586,5255
"9538","ENSGALG00000025904","12",3382186,3396406,14220
"9539","ENSGALG00000025906","1",146995866,146996585,719
"9540","ENSGALG00000025907","28",1514344,1527534,13190
"9541","ENSGALG00000025915","Z",59536399,59549088,12689
"9542","ENSGALG00000025921","Z",7645535,7647631,2096
"9543","ENSGALG00000025922","1",59340940,59341048,108
"9544","ENSGALG00000025929","2",32617712,32624948,7236
"9545","ENSGALG00000025935","4",1638475,1643187,4712
"9546","ENSGALG00000025937","24",5408192,5416185,7993
"9547","ENSGALG00000025938","11",17751603,17760523,8920
"9548","ENSGALG00000025941","2",110314102,110333425,19323
"9549","ENSGALG00000025946","8",22179851,22194222,14371
"9550","ENSGALG00000025948","20",899945,902370,2425
"9551","ENSGALG00000025949","5",25254927,25255016,89
"9552","ENSGALG00000025950","18",7314859,7428270,113411
"9553","ENSGALG00000025951","15",7971407,7971516,109
"9554","ENSGALG00000025952","12",1168014,1168086,72
"9555","ENSGALG00000025957","5",45398322,45398484,162
"9556","ENSGALG00000025958","19",7225021,7225233,212
"9557","ENSGALG00000025959","12",5336741,5340965,4224
"9558","ENSGALG00000025977","8",29041359,29042869,1510
"9559","ENSGALG00000025991","4",11340030,11346550,6520
"9560","ENSGALG00000025996","6",34319708,34339712,20004
"9561","ENSGALG00000025998","4",3967348,3967428,80
"9562","ENSGALG00000025999","2",26015143,26019015,3872
"9563","ENSGALG00000026001","Z",35630701,35647859,17158
"9564","ENSGALG00000026005","5",40752235,40769122,16887
"9565","ENSGALG00000026007","17",5699487,5702190,2703
"9566","ENSGALG00000026009","3",17354064,17362366,8302
"9567","ENSGALG00000026011","2",90395819,90410898,15079
"9568","ENSGALG00000026015","18",10620124,10623789,3665
"9569","ENSGALG00000026019","6",12181167,12208613,27446
"9570","ENSGALG00000026028","Z",20202335,20211616,9281
"9571","ENSGALG00000026030","4",15556975,15557084,109
"9572","ENSGALG00000026031","19",8238203,8274620,36417
"9573","ENSGALG00000026033","26",677649,682861,5212
"9574","ENSGALG00000026034","3",49723870,49791807,67937
"9575","ENSGALG00000026037","13",11054902,11059020,4118
"9576","ENSGALG00000026038","14",15219039,15224073,5034
"9577","ENSGALG00000026039","25",461336,463673,2337
"9578","ENSGALG00000026043","11",1403054,1406514,3460
"9579","ENSGALG00000026055","28",2849820,2864572,14752
"9580","ENSGALG00000026056","8",21120518,21120602,84
"9581","ENSGALG00000026070","25",2598862,2602505,3643
"9582","ENSGALG00000026077","19",5884422,5888133,3711
"9583","ENSGALG00000026080","12",3823378,3827933,4555
"9584","ENSGALG00000026081","20",11615331,11629002,13671
"9585","ENSGALG00000026082","7",16689428,16689600,172
"9586","ENSGALG00000026086","15",7284658,7286811,2153
"9587","ENSGALG00000026089","12",9450392,9456151,5759
"9588","ENSGALG00000026091","18",7236970,7272838,35868
"9589","ENSGALG00000026092","2",103407604,103415054,7450
"9590","ENSGALG00000026098","4",50937659,50940883,3224
"9591","ENSGALG00000026105","10",10513512,10513691,179
"9592","ENSGALG00000026107","Z",70937421,70937492,71
"9593","ENSGALG00000026111","5",12669498,12687270,17772
"9594","ENSGALG00000026117","10",11221234,11221327,93
"9595","ENSGALG00000026119","15",7779109,7810799,31690
"9596","ENSGALG00000026137","Z",78858726,78862135,3409
"9597","ENSGALG00000026146","28",3979727,3985653,5926
"9598","ENSGALG00000026151","20",1216181,1250159,33978
"9599","ENSGALG00000026152","12",2699650,2704153,4503
"9600","ENSGALG00000026153","23",1303681,1319424,15743
"9601","ENSGALG00000026154","12",7037584,7054038,16454
"9602","ENSGALG00000026159","13",10873094,10890137,17043
"9603","ENSGALG00000026161","28",991209,993646,2437
"9604","ENSGALG00000026163","1",167840281,167860165,19884
"9605","ENSGALG00000026164","10",3146821,3146928,107
"9606","ENSGALG00000026167","18",1984539,2033615,49076
"9607","ENSGALG00000026170","11",18763979,18764088,109
"9608","ENSGALG00000026176","4",64987581,64993647,6066
"9609","ENSGALG00000026179","17",7291241,7301422,10181
"9610","ENSGALG00000026182","26",3457929,3474605,16676
"9611","ENSGALG00000026187","9",6113593,6134505,20912
"9612","ENSGALG00000026188","14",12517354,12531571,14217
"9613","ENSGALG00000026189","18",10111434,10114930,3496
"9614","ENSGALG00000026192","Z",50730982,50785339,54357
"9615","ENSGALG00000026195","Z",7943944,7946758,2814
"9616","ENSGALG00000026196","2",61596385,61596554,169
"9617","ENSGALG00000026201","10",13375338,13375423,85
"9618","ENSGALG00000026203","Z",50893677,50907440,13763
"9619","ENSGALG00000026207","5",17171471,17173042,1571
"9620","ENSGALG00000026210","4",34157923,34161966,4043
"9621","ENSGALG00000026214","1",61004967,61014569,9602
"9622","ENSGALG00000026215","5",28176306,28178384,2078
"9623","ENSGALG00000026221","17",5648970,5651113,2143
"9624","ENSGALG00000026225","18",7133290,7141299,8009
"9625","ENSGALG00000026229","4",35038892,35040286,1394
"9626","ENSGALG00000026231","28",2949235,2970919,21684
"9627","ENSGALG00000026238","15",7215879,7215988,109
"9628","ENSGALG00000026239","3",104502120,104506358,4238
"9629","ENSGALG00000026241","28",2984284,2988778,4494
"9630","ENSGALG00000026247","2",32581141,32581360,219
"9631","ENSGALG00000026253","4",21788910,21804879,15969
"9632","ENSGALG00000026258","11",14531508,14691257,159749
"9633","ENSGALG00000026261","5",38075783,38075892,109
"9634","ENSGALG00000026263","8",5960767,5974556,13789
"9635","ENSGALG00000026264","2",148652448,148654580,2132
"9636","ENSGALG00000026265","24",4813720,4813829,109
"9637","ENSGALG00000026271","10",6680735,6685539,4804
"9638","ENSGALG00000026276","20",9927639,9930059,2420
"9639","ENSGALG00000026278","4",1246644,1262465,15821
"9640","ENSGALG00000026279","4",66813979,66817962,3983
"9641","ENSGALG00000026284","1",46708114,46717148,9034
"9642","ENSGALG00000026293","9",23117488,23121392,3904
"9643","ENSGALG00000026294","9",12617353,12619381,2028
"9644","ENSGALG00000026295","18",10593558,10607717,14159
"9645","ENSGALG00000026297","1",183777824,183787626,9802
"9646","ENSGALG00000026298","3",10421943,10440264,18321
"9647","ENSGALG00000026299","1",89913297,89928361,15064
"9648","ENSGALG00000026300","Z",81753560,81755457,1897
"9649","ENSGALG00000026301","3",105691610,105702003,10393
"9650","ENSGALG00000026302","9",4758467,4765591,7124
"9651","ENSGALG00000026303","17",8018445,8020171,1726
"9652","ENSGALG00000026305","9",22089165,22092254,3089
"9653","ENSGALG00000026311","1",54179279,54183383,4104
"9654","ENSGALG00000026313","7",35008798,35022843,14045
"9655","ENSGALG00000026315","19",5946988,5949553,2565
"9656","ENSGALG00000026316","24",3812750,3816688,3938
"9657","ENSGALG00000026317","5",8230964,8231059,95
"9658","ENSGALG00000026322","3",48996729,49002709,5980
"9659","ENSGALG00000026324","21",6661287,6661455,168
"9660","ENSGALG00000026328","27",7055145,7056891,1746
"9661","ENSGALG00000026332","9",16024419,16027799,3380
"9662","ENSGALG00000026358","1",81546036,81546106,70
"9663","ENSGALG00000026359","3",22805740,22810788,5048
"9664","ENSGALG00000026360","1",138198427,138199914,1487
"9665","ENSGALG00000026361","1",150813519,150816383,2864
"9666","ENSGALG00000026363","2",80749031,80753201,4170
"9667","ENSGALG00000026364","4",62776696,62791934,15238
"9668","ENSGALG00000026367","21",4897133,4898298,1165
"9669","ENSGALG00000026372","1",72649269,72664039,14770
"9670","ENSGALG00000026373","1",66955605,66963463,7858
"9671","ENSGALG00000026374","25",480298,481938,1640
"9672","ENSGALG00000026380","20",10508145,10509354,1209
"9673","ENSGALG00000026383","1",124544398,124546072,1674
"9674","ENSGALG00000026384","28",3324485,3329567,5082
"9675","ENSGALG00000026385","3",19224622,19249885,25263
"9676","ENSGALG00000026392","19",6073342,6076209,2867
"9677","ENSGALG00000026395","Z",52981307,53065796,84489
"9678","ENSGALG00000026396","16",2549855,2554710,4855
"9679","ENSGALG00000026401","18",8983486,8992851,9365
"9680","ENSGALG00000026405","17",9814893,9815002,109
"9681","ENSGALG00000026407","1",46311328,46311591,263
"9682","ENSGALG00000026421","23",4418139,4426935,8796
"9683","ENSGALG00000026422","7",28217915,28235171,17256
"9684","ENSGALG00000026424","17",5296481,5300411,3930
"9685","ENSGALG00000026426","2",17356029,17357165,1136
"9686","ENSGALG00000026428","18",9335737,9341627,5890
"9687","ENSGALG00000026431","19",6058425,6064415,5990
"9688","ENSGALG00000026432","1",134916645,134916752,107
"9689","ENSGALG00000026443","13",11084545,11095710,11165
"9690","ENSGALG00000026445","5",44062715,44073491,10776
"9691","ENSGALG00000026446","10",2873547,2876106,2559
"9692","ENSGALG00000026448","10",20166772,20171502,4730
"9693","ENSGALG00000026449","12",9524603,9524983,380
"9694","ENSGALG00000026452","2",88738279,88751907,13628
"9695","ENSGALG00000026453","1",46331192,46331384,192
"9696","ENSGALG00000026460","7",26259270,26296906,37636
"9697","ENSGALG00000026465","18",6008187,6014208,6021
"9698","ENSGALG00000026467","10",20429099,20430583,1484
"9699","ENSGALG00000026468","10",17984884,18044858,59974
"9700","ENSGALG00000026470","4",77382523,77410076,27553
"9701","ENSGALG00000026471","8",4381280,4390638,9358
"9702","ENSGALG00000026482","1",131765367,131765540,173
"9703","ENSGALG00000026490","1",39833011,39835915,2904
"9704","ENSGALG00000026491","3",9728741,9733446,4705
"9705","ENSGALG00000026492","19",6786474,6788567,2093
"9706","ENSGALG00000026493","7",25506759,25546558,39799
"9707","ENSGALG00000026499","21",604215,606588,2373
"9708","ENSGALG00000026507","1",180901126,180917603,16477
"9709","ENSGALG00000026511","2",139458202,139458271,69
"9710","ENSGALG00000026516","8",24993120,25001166,8046
"9711","ENSGALG00000026517","15",11491954,11494693,2739
"9712","ENSGALG00000026518","27",5408265,5414247,5982
"9713","ENSGALG00000026536","26",4604661,4612635,7974
"9714","ENSGALG00000026542","20",6870517,6877317,6800
"9715","ENSGALG00000026547","Z",7102975,7126925,23950
"9716","ENSGALG00000026551","13",5450751,5450854,103
"9717","ENSGALG00000026553","Z",22126658,22173992,47334
"9718","ENSGALG00000026558","21",6507249,6510571,3322
"9719","ENSGALG00000026559","14",12384779,12387275,2496
"9720","ENSGALG00000026563","28",3641710,3645132,3422
"9721","ENSGALG00000026572","8",4072866,4079961,7095
"9722","ENSGALG00000026575","20",10944293,10944390,97
"9723","ENSGALG00000026578","2",2365901,2379396,13495
"9724","ENSGALG00000026584","5",25716503,25748002,31499
"9725","ENSGALG00000026585","26",3572398,3578659,6261
"9726","ENSGALG00000026589","27",6772538,6772647,109
"9727","ENSGALG00000026590","10",6022200,6048656,26456
"9728","ENSGALG00000026591","8",29045392,29063231,17839
"9729","ENSGALG00000026594","3",64588327,64784997,196670
"9730","ENSGALG00000026598","Z",43280188,43298496,18308
"9731","ENSGALG00000026599","7",31852753,31852925,172
"9732","ENSGALG00000026600","3",40608347,40628562,20215
"9733","ENSGALG00000026601","7",25267461,25267549,88
"9734","ENSGALG00000026605","3",86761744,86769254,7510
"9735","ENSGALG00000026607","10",11638978,11642570,3592
"9736","ENSGALG00000026613","25",3309972,3310726,754
"9737","ENSGALG00000026621","27",5780422,5780598,176
"9738","ENSGALG00000026625","Z",10605917,10606026,109
"9739","ENSGALG00000026627","4",58088312,58100247,11935
"9740","ENSGALG00000026631","2",32651349,32654714,3365
"9741","ENSGALG00000026635","Z",47794498,47794682,184
"9742","ENSGALG00000026638","13",2672071,2681448,9377
"9743","ENSGALG00000026639","1",187190153,187219427,29274
"9744","ENSGALG00000026650","8",11640957,11641061,104
"9745","ENSGALG00000026653","4",49261759,49263835,2076
"9746","ENSGALG00000026655","Z",9145291,9146416,1125
"9747","ENSGALG00000026658","21",5868982,5884383,15401
"9748","ENSGALG00000026661","1",34107213,34191038,83825
"9749","ENSGALG00000026663","11",771897,778309,6412
"9750","ENSGALG00000026673","Z",35191414,35191490,76
"9751","ENSGALG00000026674","10",4240576,4273507,32931
"9752","ENSGALG00000026676","3",104735864,104735945,81
"9753","ENSGALG00000026677","1",138924431,138937050,12619
"9754","ENSGALG00000026686","5",40660657,40660745,88
"9755","ENSGALG00000026687","7",22482907,22488774,5867
"9756","ENSGALG00000026692","26",3906092,3912495,6403
"9757","ENSGALG00000026698","7",22355711,22359607,3896
"9758","ENSGALG00000026704","Z",16696009,16699213,3204
"9759","ENSGALG00000026705","1",177259572,177259681,109
"9760","ENSGALG00000026707","2",97287930,97288039,109
"9761","ENSGALG00000026712","26",2853538,2853635,97
"9762","ENSGALG00000026715","18",10722713,10730032,7319
"9763","ENSGALG00000026716","28",1399710,1430678,30968
"9764","ENSGALG00000026722","15",9473283,9477076,3793
"9765","ENSGALG00000026724","6",23317903,23318012,109
"9766","ENSGALG00000026726","4",54276023,54276202,179
"9767","ENSGALG00000026727","3",18978772,18984357,5585
"9768","ENSGALG00000026728","9",1651793,1653690,1897
"9769","ENSGALG00000026733","6",21361310,21367038,5728
"9770","ENSGALG00000026734","25",234226,241847,7621
"9771","ENSGALG00000026736","12",3834014,3844075,10061
"9772","ENSGALG00000026739","3",27428257,27428361,104
"9773","ENSGALG00000026741","4",53633105,53638017,4912
"9774","ENSGALG00000026744","Z",23138813,23145672,6859
"9775","ENSGALG00000026747","3",8253719,8265723,12004
"9776","ENSGALG00000026751","7",16257315,16257411,96
"9777","ENSGALG00000026754","25",3126151,3147836,21685
"9778","ENSGALG00000026757","Z",64257247,64273299,16052
"9779","ENSGALG00000026759","28",1864556,1864666,110
"9780","ENSGALG00000026761","3",68903432,68979504,76072
"9781","ENSGALG00000026766","2",74833723,74833903,180
"9782","ENSGALG00000026768","Z",50341879,50367907,26028
"9783","ENSGALG00000026773","1",111966534,111966631,97
"9784","ENSGALG00000026776","1",73443329,73462784,19455
"9785","ENSGALG00000026780","28",2761469,2764317,2848
"9786","ENSGALG00000026781","1",176416571,176424666,8095
"9787","ENSGALG00000026789","27",7103740,7104594,854
"9788","ENSGALG00000026790","Z",26043308,26046918,3610
"9789","ENSGALG00000026791","3",107374146,107374255,109
"9790","ENSGALG00000026796","25",3344702,3346187,1485
"9791","ENSGALG00000026808","6",19964195,19969503,5308
"9792","ENSGALG00000026809","26",1158656,1164305,5649
"9793","ENSGALG00000026811","Z",51789418,51860187,70769
"9794","ENSGALG00000026816","18",7066866,7101589,34723
"9795","ENSGALG00000026817","14",9022422,9031525,9103
"9796","ENSGALG00000026820","3",59308247,59318622,10375
"9797","ENSGALG00000026822","19",5529902,5542776,12874
"9798","ENSGALG00000026834","28",1305150,1308975,3825
"9799","ENSGALG00000026836","23",5117515,5129007,11492
"9800","ENSGALG00000026837","3",22294308,22294417,109
"9801","ENSGALG00000026838","1",25905669,25955951,50282
"9802","ENSGALG00000026846","5",25361036,25367794,6758
"9803","ENSGALG00000026849","1",169217367,169254113,36746
"9804","ENSGALG00000026850","28",4961810,4965486,3676
"9805","ENSGALG00000026853","5",17872481,17877619,5138
"9806","ENSGALG00000026856","1",71469536,71469641,105
"9807","ENSGALG00000026862","9",14097822,14108342,10520
"9808","ENSGALG00000026864","6",12970502,13071911,101409
"9809","ENSGALG00000026865","2",6846550,6857229,10679
"9810","ENSGALG00000026875","21",2851243,2855925,4682
"9811","ENSGALG00000026884","Z",7161279,7165204,3925
"9812","ENSGALG00000026888","2",4090333,4090468,135
"9813","ENSGALG00000026889","5",35796623,35796800,177
"9814","ENSGALG00000026891","12",7012303,7029920,17617
"9815","ENSGALG00000026896","1",72023032,72032681,9649
"9816","ENSGALG00000026899","Z",45224245,45371237,146992
"9817","ENSGALG00000026902","15",10350984,10356368,5384
"9818","ENSGALG00000026903","11",1487565,1492223,4658
"9819","ENSGALG00000026906","20",13716784,13750656,33872
"9820","ENSGALG00000026907","9",13963184,13965036,1852
"9821","ENSGALG00000026914","13",10890327,10892838,2511
"9822","ENSGALG00000026928","Z",55788643,55792227,3584
"9823","ENSGALG00000026940","18",9102100,9109011,6911
"9824","ENSGALG00000026944","5",57851512,57852963,1451
"9825","ENSGALG00000026945","11",18370500,18371801,1301
"9826","ENSGALG00000026948","22",4084885,4104541,19656
"9827","ENSGALG00000026952","4",89054104,89055558,1454
"9828","ENSGALG00000026953","9",14069315,14073372,4057
"9829","ENSGALG00000026955","28",3364129,3364725,596
"9830","ENSGALG00000026957","6",24043811,24048263,4452
"9831","ENSGALG00000026958","8",29906699,29911129,4430
"9832","ENSGALG00000026966","25",394100,394209,109
"9833","ENSGALG00000026969","3",58121786,58121895,109
"9834","ENSGALG00000026970","5",1814210,1815550,1340
"9835","ENSGALG00000026971","3",75653938,75674113,20175
"9836","ENSGALG00000026973","3",104848397,104859189,10792
"9837","ENSGALG00000026978","12",967160,970056,2896
"9838","ENSGALG00000026981","3",54296597,54457695,161098
"9839","ENSGALG00000026983","9",16088106,16096383,8277
"9840","ENSGALG00000026987","25",2166606,2167586,980
"9841","ENSGALG00000026989","2",32633880,32637600,3720
"9842","ENSGALG00000026994","1",141812286,141815233,2947
"9843","ENSGALG00000026995","1",197093201,197097605,4404
"9844","ENSGALG00000026996","1",80718109,80718218,109
"9845","ENSGALG00000026999","3",5652612,5661394,8782
"9846","ENSGALG00000027000","3",107381351,107381460,109
"9847","ENSGALG00000027005","28",4387579,4387688,109
"9848","ENSGALG00000027018","3",17191460,17192793,1333
"9849","ENSGALG00000027019","4",34748234,34748343,109
"9850","ENSGALG00000027035","1",177652330,177658052,5722
"9851","ENSGALG00000027036","3",61297796,61352281,54485
"9852","ENSGALG00000027040","15",8722893,8723068,175
"9853","ENSGALG00000027044","2",6059235,6059407,172
"9854","ENSGALG00000027046","25",3364117,3395057,30940
"9855","ENSGALG00000027050","10",2022414,2025732,3318
"9856","ENSGALG00000027053","2",100257486,100276143,18657
"9857","ENSGALG00000027056","1",59404622,59411011,6389
"9858","ENSGALG00000027064","1",48172185,48173007,822
"9859","ENSGALG00000027068","28",2628379,2639290,10911
"9860","ENSGALG00000027069","4",1786951,1794312,7361
"9861","ENSGALG00000027070","18",9760746,9768563,7817
"9862","ENSGALG00000027071","3",16477231,16477340,109
"9863","ENSGALG00000027083","6",29792581,29801549,8968
"9864","ENSGALG00000027090","4",85928419,85937631,9212
"9865","ENSGALG00000027093","4",69506742,69512790,6048
"9866","ENSGALG00000027096","3",10338211,10344348,6137
"9867","ENSGALG00000027100","2",64365096,64365201,105
"9868","ENSGALG00000027103","1",41773256,41785441,12185
"9869","ENSGALG00000027122","1",54211821,54244951,33130
"9870","ENSGALG00000027124","1",186317303,186317402,99
"9871","ENSGALG00000027126","20",5086332,5093930,7598
"9872","ENSGALG00000027129","1",1543088,1543197,109
"9873","ENSGALG00000027132","28",4394336,4410108,15772
"9874","ENSGALG00000027138","25",2538236,2543668,5432
"9875","ENSGALG00000027140","Z",73210019,73217415,7396
"9876","ENSGALG00000027142","12",19875504,19877779,2275
"9877","ENSGALG00000027144","2",17415549,17417320,1771
"9878","ENSGALG00000027146","14",14951114,14965984,14870
"9879","ENSGALG00000027147","28",1395132,1397739,2607
"9880","ENSGALG00000027148","2",32666901,32667076,175
"9881","ENSGALG00000027151","20",9822122,9830129,8007
"9882","ENSGALG00000027152","18",7145327,7217148,71821
"9883","ENSGALG00000027159","3",50251379,50311064,59685
"9884","ENSGALG00000027165","6",9958422,9959631,1209
"9885","ENSGALG00000027166","1",195577182,195579267,2085
"9886","ENSGALG00000027167","25",3123320,3124408,1088
"9887","ENSGALG00000027173","14",15345874,15350850,4976
"9888","ENSGALG00000027179","4",44824491,44824600,109
"9889","ENSGALG00000027183","11",1191643,1196732,5089
"9890","ENSGALG00000027184","5",7557383,7566023,8640
"9891","ENSGALG00000027188","14",5307535,5318482,10947
"9892","ENSGALG00000027189","21",6536827,6537932,1105
"9893","ENSGALG00000027190","18",5833851,5836668,2817
"9894","ENSGALG00000027192","1",42207171,42220099,12928
"9895","ENSGALG00000027197","5",45384999,45385102,103
"9896","ENSGALG00000027198","1",115288951,115314447,25496
"9897","ENSGALG00000027199","4",4174122,4178846,4724
"9898","ENSGALG00000027202","19",5202806,5202915,109
"9899","ENSGALG00000027207","3",54597280,54606430,9150
"9900","ENSGALG00000027213","1",41898277,41919541,21264
"9901","ENSGALG00000027216","10",5385940,5386106,166
"9902","ENSGALG00000027219","27",7465724,7466372,648
"9903","ENSGALG00000027231","17",1016268,1016997,729
"9904","ENSGALG00000027232","13",8559183,8566692,7509
"9905","ENSGALG00000027234","2",32680060,32682168,2108
"9906","ENSGALG00000027236","3",67451188,67451297,109
"9907","ENSGALG00000027240","2",28543421,28560768,17347
"9908","ENSGALG00000027242","17",6819414,6827457,8043
"9909","ENSGALG00000027247","2",38541856,38546582,4726
"9910","ENSGALG00000027248","1",97024125,97024413,288
"9911","ENSGALG00000027255","5",39775061,40667438,892377
"9912","ENSGALG00000027256","8",28288793,28288950,157
"9913","ENSGALG00000027258","Z",44770074,44862339,92265
"9914","ENSGALG00000027260","20",12062013,12062990,977
"9915","ENSGALG00000027262","9",5571769,5606749,34980
"9916","ENSGALG00000027265","21",814137,816654,2517
"9917","ENSGALG00000027269","21",5835354,5841044,5690
"9918","ENSGALG00000027285","3",30466370,30466479,109
"9919","ENSGALG00000027287","13",11031368,11038638,7270
"9920","ENSGALG00000027292","Z",27711357,27711464,107
"9921","ENSGALG00000027295","Z",7613662,7620056,6394
"9922","ENSGALG00000027296","1",1595635,1599967,4332
"9923","ENSGALG00000027297","Z",16270690,16270858,168
"9924","ENSGALG00000027305","27",6335894,6459922,124028
"9925","ENSGALG00000027310","1",113933365,113933474,109
"9926","ENSGALG00000027314","Z",33559770,33565062,5292
"9927","ENSGALG00000027319","2",54753768,54753861,93
"9928","ENSGALG00000027320","2",4126905,4127036,131
"9929","ENSGALG00000027323","18",376311,398842,22531
"9930","ENSGALG00000027330","13",13797199,13806846,9647
"9931","ENSGALG00000027332","Z",63173581,63195118,21537
"9932","ENSGALG00000027334","Z",54798174,54807391,9217
"9933","ENSGALG00000027343","3",9232247,9232323,76
"9934","ENSGALG00000027345","Z",66053892,66060597,6705
"9935","ENSGALG00000027351","25",2565195,2567856,2661
"9936","ENSGALG00000027353","6",19504129,19508694,4565
"9937","ENSGALG00000027355","3",78230328,78231573,1245
"9938","ENSGALG00000027360","5",31523759,31523921,162
"9939","ENSGALG00000027363","21",2649964,2665120,15156
"9940","ENSGALG00000027365","23",919640,1029021,109381
"9941","ENSGALG00000027369","15",10369979,10376611,6632
"9942","ENSGALG00000027372","25",263062,276641,13579
"9943","ENSGALG00000027374","Z",35032928,35045290,12362
"9944","ENSGALG00000027375","28",3665339,3666687,1348
"9945","ENSGALG00000027389","Z",20155082,20189943,34861
"9946","ENSGALG00000027397","2",66410830,66433166,22336
"9947","ENSGALG00000027404","5",31596052,31596239,187
"9948","ENSGALG00000027407","5",52154934,52170189,15255
"9949","ENSGALG00000027410","20",10895483,10895592,109
"9950","ENSGALG00000027415","18",10495385,10504172,8787
"9951","ENSGALG00000027416","20",1061506,1063972,2466
"9952","ENSGALG00000027418","Z",9092401,9093974,1573
"9953","ENSGALG00000027422","24",3390275,3390369,94
"9954","ENSGALG00000027423","Z",53622721,53657488,34767
"9955","ENSGALG00000027428","Z",31657206,31700849,43643
"9956","ENSGALG00000027429","27",7781530,7782965,1435
"9957","ENSGALG00000027435","1",68016636,68024282,7646
"9958","ENSGALG00000027440","3",34801117,34805212,4095
"9959","ENSGALG00000027453","4",75987609,75991373,3764
"9960","ENSGALG00000027454","3",59672610,59679644,7034
"9961","ENSGALG00000027460","1",3308960,3309069,109
"9962","ENSGALG00000027462","27",7494350,7498376,4026
"9963","ENSGALG00000027464","10",1656062,1656171,109
"9964","ENSGALG00000027472","Z",55185287,55200427,15140
"9965","ENSGALG00000027476","21",591331,602862,11531
"9966","ENSGALG00000027482","11",18918695,18925489,6794
"9967","ENSGALG00000027483","Z",57547979,57556623,8644
"9968","ENSGALG00000027484","20",11271341,11303516,32175
"9969","ENSGALG00000027490","2",4076443,4077571,1128
"9970","ENSGALG00000027492","8",4306671,4368453,61782
"9971","ENSGALG00000027494","9",22104677,22113141,8464
"9972","ENSGALG00000027498","10",5695022,5699694,4672
"9973","ENSGALG00000027501","10",20435393,20443467,8074
"9974","ENSGALG00000027506","7",22194036,22198144,4108
"9975","ENSGALG00000027512","Z",50040254,50045272,5018
"9976","ENSGALG00000027513","7",16297348,16299201,1853
"9977","ENSGALG00000027514","1",155434827,155487164,52337
"9978","ENSGALG00000027517","18",6887225,6887348,123
"9979","ENSGALG00000027518","3",10670111,10670220,109
"9980","ENSGALG00000027519","5",23342594,23342703,109
"9981","ENSGALG00000027520","5",30262434,30276427,13993
"9982","ENSGALG00000027526","23",5019801,5030095,10294
"9983","ENSGALG00000027533","4",88515871,88524501,8630
"9984","ENSGALG00000027534","13",13715504,13722946,7442
"9985","ENSGALG00000027536","3",54615333,54632861,17528
"9986","ENSGALG00000027540","28",2244999,2251014,6015
"9987","ENSGALG00000027546","16",2465213,2467571,2358
"9988","ENSGALG00000027556","3",58635264,58635450,186
"9989","ENSGALG00000027560","25",2902463,2902540,77
"9990","ENSGALG00000027561","8",16965972,16968953,2981
"9991","ENSGALG00000027562","4",34666884,34667903,1019
"9992","ENSGALG00000027564","Z",18970571,19017369,46798
"9993","ENSGALG00000027565","8",28769250,28834409,65159
"9994","ENSGALG00000027571","1",48153914,48155235,1321
"9995","ENSGALG00000027579","1",106990188,107038093,47905
"9996","ENSGALG00000027583","3",62988800,62988958,158
"9997","ENSGALG00000027587","28",2646870,2647955,1085
"9998","ENSGALG00000027591","9",23808872,23832717,23845
"9999","ENSGALG00000027592","14",7302441,7311290,8849
"10000","ENSGALG00000027608","8",4905988,4906881,893
"10001","ENSGALG00000027611","28",1080534,1081935,1401
"10002","ENSGALG00000027620","2",24478712,24505959,27247
"10003","ENSGALG00000027629","5",58219426,58234374,14948
"10004","ENSGALG00000027630","Z",9096779,9106881,10102
"10005","ENSGALG00000027632","3",2880596,2928699,48103
"10006","ENSGALG00000027633","1",42160804,42190042,29238
"10007","ENSGALG00000027635","14",13627365,13630644,3279
"10008","ENSGALG00000027641","19",8728278,8740918,12640
"10009","ENSGALG00000027643","5",50768169,50771131,2962
"10010","ENSGALG00000027644","2",4966339,4966448,109
"10011","ENSGALG00000027645","7",25477633,25486533,8900
"10012","ENSGALG00000027654","2",79219935,79229716,9781
"10013","ENSGALG00000027655","8",22557337,22809760,252423
"10014","ENSGALG00000027658","Z",9047866,9055667,7801
"10015","ENSGALG00000027665","1",50677406,50687741,10335
"10016","ENSGALG00000027668","14",1163148,1163257,109
"10017","ENSGALG00000027673","26",1772483,1772583,100
"10018","ENSGALG00000027682","1",33715792,33724023,8231
"10019","ENSGALG00000027688","1",80601454,80605982,4528
"10020","ENSGALG00000027695","12",3544615,3548464,3849
"10021","ENSGALG00000027696","28",4163816,4165585,1769
"10022","ENSGALG00000027697","25",3769573,3769682,109
"10023","ENSGALG00000027698","14",2638847,2640844,1997
"10024","ENSGALG00000027700","25",3021113,3025802,4689
"10025","ENSGALG00000027702","2",5391945,5428473,36528
"10026","ENSGALG00000027707","Z",16626076,16634702,8626
"10027","ENSGALG00000027712","25",2516848,2520385,3537
"10028","ENSGALG00000027714","Z",63575834,63658645,82811
"10029","ENSGALG00000027716","5",12686682,12694704,8022
"10030","ENSGALG00000027722","9",15052590,15056735,4145
"10031","ENSGALG00000027728","Z",61441242,61441303,61
"10032","ENSGALG00000027734","17",5192531,5196343,3812
"10033","ENSGALG00000027736","14",4574511,4574594,83
"10034","ENSGALG00000027741","6",8612372,8612548,176
"10035","ENSGALG00000027742","28",883669,888721,5052
"10036","ENSGALG00000027747","Z",9025003,9030333,5330
"10037","ENSGALG00000027749","3",25941501,25941690,189
"10038","ENSGALG00000027757","2",26800481,26802605,2124
"10039","ENSGALG00000027758","15",9146100,9146209,109
"10040","ENSGALG00000027760","2",145646147,145646254,107
"10041","ENSGALG00000027761","Z",71820993,71861087,40094
"10042","ENSGALG00000027762","1",197076798,197090770,13972
"10043","ENSGALG00000027763","2",32684156,32684264,108
"10044","ENSGALG00000027765","2",19463738,19494337,30599
"10045","ENSGALG00000027768","7",22542856,22545509,2653
"10046","ENSGALG00000027771","18",7224009,7230394,6385
"10047","ENSGALG00000027772","1",75593243,75596024,2781
"10048","ENSGALG00000027777","28",3014287,3018726,4439
"10049","ENSGALG00000027778","5",1642349,1649022,6673
"10050","ENSGALG00000027785","Z",9303582,9323467,19885
"10051","ENSGALG00000027786","18",9837554,9839601,2047
"10052","ENSGALG00000027788","4",23889262,23935926,46664
"10053","ENSGALG00000027789","18",10425524,10435090,9566
"10054","ENSGALG00000027791","1",73425405,73429018,3613
"10055","ENSGALG00000027793","7",19505895,19543801,37906
"10056","ENSGALG00000027794","14",7688508,7688614,106
"10057","ENSGALG00000027802","8",29101959,29102068,109
"10058","ENSGALG00000027805","10",2800575,2802906,2331
"10059","ENSGALG00000027809","13",4803069,4804484,1415
"10060","ENSGALG00000027810","4",82647740,82647849,109
"10061","ENSGALG00000027822","18",9853301,9856295,2994
"10062","ENSGALG00000027823","14",13079902,13085810,5908
"10063","ENSGALG00000027826","20",2160706,2160815,109
"10064","ENSGALG00000027834","20",1188438,1212751,24313
"10065","ENSGALG00000027835","6",12328156,12329964,1808
"10066","ENSGALG00000027838","28",1148165,1152946,4781
"10067","ENSGALG00000027840","20",8414871,8414980,109
"10068","ENSGALG00000027850","12",2613922,2614101,179
"10069","ENSGALG00000027853","4",87427085,87823826,396741
"10070","ENSGALG00000027860","4",60944995,60952448,7453
"10071","ENSGALG00000027864","5",36403465,36406967,3502
"10072","ENSGALG00000027868","1",178476496,178478370,1874
"10073","ENSGALG00000027871","3",30977514,30981394,3880
"10074","ENSGALG00000027872","4",49898196,49899818,1622
"10075","ENSGALG00000027874","5",24667321,24669438,2117
"10076","ENSGALG00000027881","15",9716530,9716682,152
"10077","ENSGALG00000027885","4",69865532,69906586,41054
"10078","ENSGALG00000027886","4",65118589,65129371,10782
"10079","ENSGALG00000027887","Z",10370855,10387436,16581
"10080","ENSGALG00000027891","Z",46525374,46544858,19484
"10081","ENSGALG00000027894","2",126953661,126953739,78
"10082","ENSGALG00000027897","15",11471568,11477474,5906
"10083","ENSGALG00000027899","4",2115235,2116290,1055
"10084","ENSGALG00000027902","18",9863365,9865580,2215
"10085","ENSGALG00000027905","2",5319910,5325537,5627
"10086","ENSGALG00000027907","Z",58579552,58587854,8302
"10087","ENSGALG00000027908","4",37958015,37969284,11269
"10088","ENSGALG00000027909","23",1909543,1914406,4863
"10089","ENSGALG00000027915","3",9223715,9223793,78
"10090","ENSGALG00000027918","24",5217672,5225883,8211
"10091","ENSGALG00000027920","13",11149867,11150817,950
"10092","ENSGALG00000027922","3",11540824,11548744,7920
"10093","ENSGALG00000027925","2",32588887,32628505,39618
"10094","ENSGALG00000027932","Z",58014953,58053068,38115
"10095","ENSGALG00000027935","14",13547271,13547380,109
"10096","ENSGALG00000027940","1",70826784,70826964,180
"10097","ENSGALG00000027947","9",19459647,19464117,4470
"10098","ENSGALG00000027949","2",115276962,115277040,78
"10099","ENSGALG00000027950","19",9949970,9952624,2654
"10100","ENSGALG00000027960","1",123085239,123107985,22746
"10101","ENSGALG00000027961","28",1074042,1081172,7130
"10102","ENSGALG00000027963","Z",61440581,61443244,2663
"10103","ENSGALG00000027965","20",9251328,9263817,12489
"10104","ENSGALG00000027967","2",128823733,128823842,109
"10105","ENSGALG00000027973","2",4078678,4080170,1492
"10106","ENSGALG00000027980","6",30920353,30921117,764
"10107","ENSGALG00000027981","1",182413608,182437196,23588
"10108","ENSGALG00000027982","1",197145495,197154933,9438
"10109","ENSGALG00000027983","9",15106136,15126619,20483
"10110","ENSGALG00000027986","4",66564200,66574430,10230
"10111","ENSGALG00000027989","19",994862,999886,5024
"10112","ENSGALG00000027990","1",98602562,98602717,155
"10113","ENSGALG00000027991","7",22427870,22444823,16953
"10114","ENSGALG00000027994","3",9228020,9228103,83
"10115","ENSGALG00000028001","9",23940328,23945166,4838
"10116","ENSGALG00000028005","Z",43742056,43743702,1646
"10117","ENSGALG00000028009","12",19829649,19832174,2525
"10118","ENSGALG00000028010","6",33564676,33564785,109
"10119","ENSGALG00000028015","9",13092443,13093885,1442
"10120","ENSGALG00000028016","1",49166331,49172940,6609
"10121","ENSGALG00000028017","3",34734303,34757372,23069
"10122","ENSGALG00000028018","1",189576307,189596533,20226
"10123","ENSGALG00000028023","15",10355092,10361274,6182
"10124","ENSGALG00000028026","Z",16103569,16149274,45705
"10125","ENSGALG00000028031","27",3712055,3716130,4075
"10126","ENSGALG00000028032","3",106426632,106687390,260758
"10127","ENSGALG00000028037","5",38430793,38433702,2909
"10128","ENSGALG00000028039","Z",9149010,9150157,1147
"10129","ENSGALG00000028041","4",38131005,38252094,121089
"10130","ENSGALG00000028046","7",28833298,28841367,8069
"10131","ENSGALG00000028047","5",24508497,24512475,3978
"10132","ENSGALG00000028049","1",134361698,134361806,108
"10133","ENSGALG00000028056","3",4298433,4301268,2835
"10134","ENSGALG00000028059","2",32649875,32649968,93
"10135","ENSGALG00000028063","Z",81200691,81207932,7241
"10136","ENSGALG00000028069","1",23387565,23397783,10218
"10137","ENSGALG00000028074","5",33178294,33178377,83
"10138","ENSGALG00000028077","4",30919367,30919539,172
"10139","ENSGALG00000028078","1",90553085,90553255,170
"10140","ENSGALG00000028081","28",2384398,2401470,17072
"10141","ENSGALG00000028083","1",171764491,171790169,25678
"10142","ENSGALG00000028084","4",1811660,1817142,5482
"10143","ENSGALG00000028091","1",40085112,40086326,1214
"10144","ENSGALG00000028095","2",32577089,32578420,1331
"10145","ENSGALG00000028103","5",5717646,5717779,133
"10146","ENSGALG00000028115","23",1905027,1905821,794
"10147","ENSGALG00000028118","Z",9113971,9115313,1342
"10148","ENSGALG00000028119","25",226527,229835,3308
"10149","ENSGALG00000028121","18",5044525,5044621,96
"10150","ENSGALG00000028126","3",12627078,12627187,109
"10151","ENSGALG00000028133","2",108035114,108066857,31743
"10152","ENSGALG00000028135","Z",56523389,56533199,9810
"10153","ENSGALG00000028140","Z",8134527,8304301,169774
"10154","ENSGALG00000028141","10",19374076,19376537,2461
"10155","ENSGALG00000028142","Z",34263630,34278183,14553
"10156","ENSGALG00000028145","3",75832004,75833128,1124
"10157","ENSGALG00000028147","25",170395,173324,2929
"10158","ENSGALG00000028148","21",559614,564059,4445
"10159","ENSGALG00000028149","Z",23985494,23987189,1695
"10160","ENSGALG00000028153","8",22326174,22327334,1160
"10161","ENSGALG00000028155","1",71872763,71904322,31559
"10162","ENSGALG00000028158","10",10988962,11016023,27061
"10163","ENSGALG00000028165","Z",19516925,19517036,111
"10164","ENSGALG00000028167","17",9034618,9045434,10816
"10165","ENSGALG00000028172","14",13494491,13524475,29984
"10166","ENSGALG00000028173","10",19590883,19590982,99
"10167","ENSGALG00000028174","7",8198229,8205649,7420
"10168","ENSGALG00000028175","23",3407196,3408737,1541
"10169","ENSGALG00000028180","1",24877371,24877508,137
"10170","ENSGALG00000028183","9",16075993,16077237,1244
"10171","ENSGALG00000028186","1",62631477,62735236,103759
"10172","ENSGALG00000028187","1",112334358,112351015,16657
"10173","ENSGALG00000028191","10",19739670,19760970,21300
"10174","ENSGALG00000028197","14",15036611,15091332,54721
"10175","ENSGALG00000028203","5",30948808,31002826,54018
"10176","ENSGALG00000028204","12",3241004,3242538,1534
"10177","ENSGALG00000028205","25",3726213,3739244,13031
"10178","ENSGALG00000028207","9",20824691,20838810,14119
"10179","ENSGALG00000028209","3",101589684,101589863,179
"10180","ENSGALG00000028210","19",5945913,5947011,1098
"10181","ENSGALG00000028214","18",10560018,10566300,6282
"10182","ENSGALG00000028216","1",2368745,2368854,109
"10183","ENSGALG00000028222","4",10977328,10983991,6663
"10184","ENSGALG00000028225","20",8441138,8456537,15399
"10185","ENSGALG00000028227","12",12100869,12111865,10996
"10186","ENSGALG00000028228","19",8822023,8822132,109
"10187","ENSGALG00000028230","1",50809249,50814449,5200
"10188","ENSGALG00000028236","17",5954829,5971002,16173
"10189","ENSGALG00000028250","6",20008951,20032260,23309
"10190","ENSGALG00000028253","11",19748636,19750708,2072
"10191","ENSGALG00000028254","1",54247464,54284004,36540
"10192","ENSGALG00000028256","Z",8363698,8366694,2996
"10193","ENSGALG00000028262","26",4965879,4972282,6403
"10194","ENSGALG00000028265","17",7176124,7189309,13185
"10195","ENSGALG00000028267","Z",9666788,9696930,30142
"10196","ENSGALG00000028273","1",197283325,197284551,1226
"10197","ENSGALG00000028274","28",4808669,4808772,103
"10198","ENSGALG00000028277","Z",31100547,31100721,174
"10199","ENSGALG00000028283","19",9651525,9656855,5330
"10200","ENSGALG00000028284","9",22868801,22874363,5562
"10201","ENSGALG00000028290","1",100750283,100767075,16792
"10202","ENSGALG00000028294","9",16014299,16019307,5008
"10203","ENSGALG00000028295","10",20557985,20562103,4118
"10204","ENSGALG00000028296","24",3371186,3371294,108
"10205","ENSGALG00000028298","Z",32755378,32945968,190590
"10206","ENSGALG00000028301","18",4630255,4636230,5975
"10207","ENSGALG00000028302","13",17774734,17777062,2328
"10208","ENSGALG00000028304","2",19542337,19568271,25934
"10209","ENSGALG00000028308","27",7268694,7276039,7345
"10210","ENSGALG00000028316","2",115277568,115277646,78
"10211","ENSGALG00000028318","26",1599230,1602396,3166
"10212","ENSGALG00000028324","Z",49982405,50002009,19604
"10213","ENSGALG00000028325","1",194988574,194988646,72
"10214","ENSGALG00000028326","11",1364760,1374485,9725
"10215","ENSGALG00000028327","5",23120722,23131190,10468
"10216","ENSGALG00000028331","27",3923000,3923118,118
"10217","ENSGALG00000028336","2",79858774,79862773,3999
"10218","ENSGALG00000028340","Z",81822686,81831505,8819
"10219","ENSGALG00000028341","28",2756226,2762064,5838
"10220","ENSGALG00000028345","14",13538761,13543017,4256
"10221","ENSGALG00000028346","26",1576880,1580042,3162
"10222","ENSGALG00000028347","20",9829348,9834952,5604
"10223","ENSGALG00000028354","18",3085475,3106644,21169
"10224","ENSGALG00000028357","2",19428947,19462031,33084
"10225","ENSGALG00000028360","1",42251047,42358204,107157
"10226","ENSGALG00000028363","11",18702201,18732736,30535
"10227","ENSGALG00000028373","1",47377777,47392139,14362
"10228","ENSGALG00000028374","25",3156655,3157559,904
"10229","ENSGALG00000028376","5",17813609,17818546,4937
"10230","ENSGALG00000028380","Z",42064439,42064534,95
"10231","ENSGALG00000028382","1",107174347,107174462,115
"10232","ENSGALG00000028394","Z",15959934,15960039,105
"10233","ENSGALG00000028402","5",25690521,25695950,5429
"10234","ENSGALG00000028407","13",17770452,17773177,2725
"10235","ENSGALG00000028409","22",4143422,4146569,3147
"10236","ENSGALG00000028411","Z",9006673,9015300,8627
"10237","ENSGALG00000028415","9",5618012,5621025,3013
"10238","ENSGALG00000028420","3",47340007,47341418,1411
"10239","ENSGALG00000028423","8",16227040,16296312,69272
"10240","ENSGALG00000028424","23",4599328,4600206,878
"10241","ENSGALG00000028437","21",6524865,6528779,3914
"10242","ENSGALG00000028438","7",11298069,11305798,7729
"10243","ENSGALG00000028439","6",3395934,3435087,39153
"10244","ENSGALG00000028444","1",57035276,57246177,210901
"10245","ENSGALG00000028446","Z",35192621,35192724,103
"10246","ENSGALG00000028448","1",88856191,88866344,10153
"10247","ENSGALG00000028451","11",2118766,2120425,1659
"10248","ENSGALG00000028457","7",30490902,30497261,6359
"10249","ENSGALG00000028459","1",58331877,58360087,28210
"10250","ENSGALG00000028465","11",18413916,18418515,4599
"10251","ENSGALG00000028466","11",1717174,1721502,4328
"10252","ENSGALG00000028471","3",16131319,16133848,2529
"10253","ENSGALG00000028478","25",432852,440337,7485
"10254","ENSGALG00000028481","8",24838736,24838848,112
"10255","ENSGALG00000028483","5",36884558,36886207,1649
"10256","ENSGALG00000028484","Z",73196838,73203671,6833
"10257","ENSGALG00000028489","26",4941751,4944658,2907
"10258","ENSGALG00000028496","24",4335489,4342070,6581
"10259","ENSGALG00000028497","20",638622,638731,109
"10260","ENSGALG00000028499","25",215952,219810,3858
"10261","ENSGALG00000028501","4",50129586,50140105,10519
"10262","ENSGALG00000028505","25",278428,282487,4059
"10263","ENSGALG00000028506","4",1678056,1695829,17773
"10264","ENSGALG00000028512","6",23380202,23449798,69596
"10265","ENSGALG00000028517","27",7456332,7463267,6935
"10266","ENSGALG00000028519","27",7819486,7821867,2381
"10267","ENSGALG00000028520","3",15683584,15685913,2329
"10268","ENSGALG00000028530","8",17038653,17105179,66526
"10269","ENSGALG00000028537","5",44774281,44776779,2498
"10270","ENSGALG00000028539","3",63834724,63863461,28737
"10271","ENSGALG00000028543","13",10980845,10986852,6007
"10272","ENSGALG00000028549","26",2287799,2287908,109
"10273","ENSGALG00000028551","3",88395964,88419649,23685
"10274","ENSGALG00000028553","4",8640721,8640830,109
"10275","ENSGALG00000028556","1",195149253,195149430,177
"10276","ENSGALG00000028559","Z",19363797,19363888,91
"10277","ENSGALG00000028560","1",48037612,48043641,6029
"10278","ENSGALG00000028561","8",20069231,20123377,54146
"10279","ENSGALG00000028565","13",2579691,2627833,48142
"10280","ENSGALG00000028567","20",485851,492652,6801
"10281","ENSGALG00000028568","5",26378790,26392403,13613
"10282","ENSGALG00000028569","20",13700068,13700177,109
"10283","ENSGALG00000028570","26",3194811,3208765,13954
"10284","ENSGALG00000028573","3",29408937,29409820,883
"10285","ENSGALG00000028587","3",14723403,14749328,25925
"10286","ENSGALG00000028595","Z",16728157,16734527,6370
"10287","ENSGALG00000028596","4",3967495,3967577,82
"10288","ENSGALG00000028600","22",5209156,5212728,3572
"10289","ENSGALG00000028602","13",10211261,10285881,74620
"10290","ENSGALG00000028608","4",34617002,34622372,5370
"10291","ENSGALG00000028612","18",645073,662693,17620
"10292","ENSGALG00000028622","25",2572553,2577648,5095
"10293","ENSGALG00000028626","26",3770397,3772224,1827
"10294","ENSGALG00000028627","1",53094947,53127580,32633
"10295","ENSGALG00000028629","1",187042107,187056697,14590
"10296","ENSGALG00000028638","1",77615840,77617557,1717
"10297","ENSGALG00000028643","4",30838745,31010530,171785
"10298","ENSGALG00000028648","1",40766561,40772837,6276
"10299","ENSGALG00000028655","26",692323,692432,109
"10300","ENSGALG00000028658","1",182437515,182450316,12801
"10301","ENSGALG00000028659","16",2562353,2565190,2837
"10302","ENSGALG00000028660","2",148166244,148166313,69
"10303","ENSGALG00000028664","25",3020468,3021610,1142
"10304","ENSGALG00000028666","5",54973489,54984482,10993
"10305","ENSGALG00000028673","Z",56447630,56473532,25902
"10306","ENSGALG00000028675","Z",81885604,81989922,104318
"10307","ENSGALG00000028681","4",1260433,1265424,4991
"10308","ENSGALG00000028682","2",92619424,92624933,5509
"10309","ENSGALG00000028683","9",23034764,23038643,3879
"10310","ENSGALG00000028685","2",78655148,78914889,259741
"10311","ENSGALG00000028687","5",39339701,39339810,109
"10312","ENSGALG00000028691","14",12442148,12455061,12913
"10313","ENSGALG00000028696","5",12387716,12391494,3778
"10314","ENSGALG00000028697","12",3598978,3601688,2710
"10315","ENSGALG00000028709","3",95000776,95059703,58927
"10316","ENSGALG00000028720","1",99545973,99575148,29175
"10317","ENSGALG00000028721","26",1123454,1132975,9521
"10318","ENSGALG00000028725","2",75621042,75621134,92
"10319","ENSGALG00000028743","1",82528080,82528223,143
"10320","ENSGALG00000028744","3",92123483,92128189,4706
"10321","ENSGALG00000028749","18",9187889,9190934,3045
"10322","ENSGALG00000028759","7",34863519,34870762,7243
"10323","ENSGALG00000028762","5",29110081,29151380,41299
"10324","ENSGALG00000028770","7",25563774,25568147,4373
"10325","ENSGALG00000028774","25",464699,466723,2024
"10326","ENSGALG00000028775","5",55864933,55865054,121
"10327","ENSGALG00000028783","13",17546478,17546571,93
"10328","ENSGALG00000028790","8",16993720,17017021,23301
"10329","ENSGALG00000028798","3",104945207,104945308,101
"10330","ENSGALG00000028801","19",7369597,7400205,30608
"10331","ENSGALG00000028802","2",119191058,119191231,173
"10332","ENSGALG00000028803","15",6090645,6093060,2415
"10333","ENSGALG00000028807","4",57181658,57199844,18186
"10334","ENSGALG00000028809","6",16766053,16768405,2352
"10335","ENSGALG00000028810","15",8254366,8255372,1006
"10336","ENSGALG00000028814","8",5597362,5597471,109
"10337","ENSGALG00000028815","24",6293151,6302449,9298
"10338","ENSGALG00000028816","1",1553201,1553310,109
"10339","ENSGALG00000028817","3",9984822,9987580,2758
"10340","ENSGALG00000028818","1",180517114,180517212,98
"10341","ENSGALG00000028821","2",89742579,89767957,25378
"10342","ENSGALG00000028822","2",68496453,68505877,9424
"10343","ENSGALG00000028825","4",34026304,34026413,109
"10344","ENSGALG00000028830","15",10186978,10189770,2792
"10345","ENSGALG00000028837","20",8441317,8441423,106
"10346","ENSGALG00000028839","5",53583814,53585417,1603
"10347","ENSGALG00000028840","1",71281100,71299679,18579
"10348","ENSGALG00000028843","25",2150063,2183962,33899
"10349","ENSGALG00000028849","1",30985382,31016383,31001
"10350","ENSGALG00000028851","28",4524693,4537499,12806
"10351","ENSGALG00000028858","26",3145905,3149866,3961
"10352","ENSGALG00000028866","27",7783216,7791377,8161
"10353","ENSGALG00000028871","12",3614475,3623786,9311
"10354","ENSGALG00000028872","1",169085035,169089257,4222
"10355","ENSGALG00000028875","2",32667863,32668095,232
"10356","ENSGALG00000028876","14",1313219,1317821,4602
"10357","ENSGALG00000028879","1",57013385,57019526,6141
"10358","ENSGALG00000028880","25",3549515,3553094,3579
"10359","ENSGALG00000028886","3",45471260,45491688,20428
"10360","ENSGALG00000028888","10",2838125,2838234,109
"10361","ENSGALG00000028895","14",13226354,13229728,3374
"10362","ENSGALG00000028897","5",48778158,48850687,72529
"10363","ENSGALG00000028898","21",2342642,2344883,2241
"10364","ENSGALG00000028900","11",860584,882868,22284
"10365","ENSGALG00000028904","18",9307743,9307850,107
"10366","ENSGALG00000028906","10",19587135,19594243,7108
"10367","ENSGALG00000028908","2",32626024,32628685,2661
"10368","ENSGALG00000028912","20",9917640,9920382,2742
"10369","ENSGALG00000028916","10",15699576,15699720,144
"10370","ENSGALG00000028924","25",3315453,3320307,4854
"10371","ENSGALG00000028928","11",1034930,1041693,6763
"10372","ENSGALG00000028930","3",1688275,1688425,150
"10373","ENSGALG00000028935","8",16678843,16686682,7839
"10374","ENSGALG00000028937","28",723124,723863,739
"10375","ENSGALG00000028940","5",52393790,52445216,51426
"10376","ENSGALG00000028942","5",53091329,53095078,3749
"10377","ENSGALG00000028949","19",6226609,6231302,4693
"10378","ENSGALG00000028958","21",584539,589045,4506
"10379","ENSGALG00000028960","1",196009412,196013046,3634
"10380","ENSGALG00000028961","6",21029050,21029159,109
"10381","ENSGALG00000028967","3",105433631,105441373,7742
"10382","ENSGALG00000028971","27",7577987,7580140,2153
"10383","ENSGALG00000028974","11",570320,570429,109
"10384","ENSGALG00000028975","4",1944957,1966034,21077
"10385","ENSGALG00000028978","8",21144107,21149996,5889
"10386","ENSGALG00000028979","18",3353300,3359663,6363
"10387","ENSGALG00000028980","5",46605668,46605771,103
"10388","ENSGALG00000028982","3",94980479,94986009,5530
"10389","ENSGALG00000028983","2",32643254,32645922,2668
"10390","ENSGALG00000028985","2",592024,595243,3219
"10391","ENSGALG00000028988","1",195581771,195583012,1241
"10392","ENSGALG00000028989","1",50620500,50620712,212
"10393","ENSGALG00000028991","21",5573634,5574374,740
"10394","ENSGALG00000028994","13",12851689,12857517,5828
"10395","ENSGALG00000028996","Z",7940896,7943905,3009
"10396","ENSGALG00000028998","Z",70935594,70942308,6714
"10397","ENSGALG00000029000","12",3640843,3643608,2765
"10398","ENSGALG00000029001","23",3716700,3719411,2711
"10399","ENSGALG00000029002","1",129834286,129858036,23750
"10400","ENSGALG00000029006","1",14331311,14337554,6243
"10401","ENSGALG00000029011","3",63360401,63592181,231780
"10402","ENSGALG00000029012","3",110568078,110761454,193376
"10403","ENSGALG00000029015","28",3638982,3640925,1943
"10404","ENSGALG00000029017","11",1950400,1961281,10881
"10405","ENSGALG00000029020","6",31489421,31522011,32590
"10406","ENSGALG00000029022","5",35296092,35889962,593870
"10407","ENSGALG00000029023","8",25221808,25226828,5020
"10408","ENSGALG00000029024","3",56360381,56362566,2185
"10409","ENSGALG00000029027","14",13457248,13462102,4854
"10410","ENSGALG00000029033","20",626176,628289,2113
"10411","ENSGALG00000029034","Z",56727652,56728388,736
"10412","ENSGALG00000029035","Z",9069756,9071860,2104
"10413","ENSGALG00000029040","1",197186361,197187326,965
"10414","ENSGALG00000029047","14",14114192,14142038,27846
"10415","ENSGALG00000029056","Z",20906665,20934278,27613
"10416","ENSGALG00000029066","23",2392658,2412254,19596
"10417","ENSGALG00000029072","14",14359154,14386623,27469
"10418","ENSGALG00000029073","Z",42336632,42348496,11864
"10419","ENSGALG00000029077","24",4255942,4287074,31132
"10420","ENSGALG00000029083","7",31427110,31457806,30696
"10421","ENSGALG00000029095","6",30113636,30163671,50035
"10422","ENSGALG00000029102","9",6951131,7048776,97645
"10423","ENSGALG00000029104","2",32648693,32648793,100
"10424","ENSGALG00000029118","Z",81795195,81801734,6539
"10425","ENSGALG00000029125","1",46330886,46331047,161
"10426","ENSGALG00000029130","5",17312111,17315607,3496
"10427","ENSGALG00000029132","21",4633960,4634069,109
"10428","ENSGALG00000029135","1",35544311,35549594,5283
"10429","ENSGALG00000029137","2",6830869,6830974,105
"10430","ENSGALG00000029140","25",2633647,2636309,2662
"10431","ENSGALG00000029142","27",7109348,7115931,6583
"10432","ENSGALG00000029144","25",2261217,2262855,1638
"10433","ENSGALG00000029145","1",138728119,138751839,23720
"10434","ENSGALG00000029150","17",5248227,5254025,5798
"10435","ENSGALG00000029151","10",3060233,3063299,3066
"10436","ENSGALG00000029152","9",3603751,3609256,5505
"10437","ENSGALG00000029166","6",23282276,23286288,4012
"10438","ENSGALG00000029168","1",123281269,123301148,19879
"10439","ENSGALG00000029170","20",9240792,9260447,19655
"10440","ENSGALG00000029172","1",194303527,194307071,3544
"10441","ENSGALG00000029175","1",142513096,142555148,42052
"10442","ENSGALG00000029190","9",23532039,23579253,47214
"10443","ENSGALG00000029193","MT",5102,5172,70
"10444","ENSGALG00000029195","13",18677413,18699290,21877
"10445","ENSGALG00000029197","24",484288,720481,236193
"10446","ENSGALG00000029198","15",657677,671955,14278
"10447","ENSGALG00000029199","13",1592674,1594660,1986
"10448","ENSGALG00000029204","3",62645050,62702019,56969
"10449","ENSGALG00000029209","31",3213297,3214761,1464
"10450","ENSGALG00000029211","19",486460,494227,7767
"10451","ENSGALG00000029212","21",192800,201849,9049
"10452","ENSGALG00000029220","24",5239297,5255186,15889
"10453","ENSGALG00000029223","15",11393540,11405772,12232
"10454","ENSGALG00000029226","7",22238619,22242064,3445
"10455","ENSGALG00000029227","4",81683573,81748757,65184
"10456","ENSGALG00000029235","2",41858803,42075903,217100
"10457","ENSGALG00000029238","8",6449607,6455597,5990
"10458","ENSGALG00000029244","23",5030789,5043661,12872
"10459","ENSGALG00000029247","33",5786099,5793178,7079
"10460","ENSGALG00000029249","18",7748291,7752120,3829
"10461","ENSGALG00000029252","2",82242204,82267314,25110
"10462","ENSGALG00000029254","AADN05001348.1",8110,15623,7513
"10463","ENSGALG00000029256","2",46164553,46169831,5278
"10464","ENSGALG00000029260","5",16217236,16252397,35161
"10465","ENSGALG00000029261","3",2503066,2562071,59005
"10466","ENSGALG00000029264","2",118380780,118403137,22357
"10467","ENSGALG00000029266","2",43070481,43097452,26971
"10468","ENSGALG00000029268","11",568047,581354,13307
"10469","ENSGALG00000029270","1",4968059,4987014,18955
"10470","ENSGALG00000029276","27",5565869,5575947,10078
"10471","ENSGALG00000029278","11",17352502,17353413,911
"10472","ENSGALG00000029279","2",149268757,149288649,19892
"10473","ENSGALG00000029282","9",5874581,5875710,1129
"10474","ENSGALG00000029286","4",18074956,18076806,1850
"10475","ENSGALG00000029287","2",125754778,125783224,28446
"10476","ENSGALG00000029292","22",479245,482505,3260
"10477","ENSGALG00000029295","2",129117614,129143181,25567
"10478","ENSGALG00000029296","10",2855486,2858068,2582
"10479","ENSGALG00000029298","1",84730514,84766850,36336
"10480","ENSGALG00000029301","3",15202203,15229780,27577
"10481","ENSGALG00000029304","27",4124013,4130530,6517
"10482","ENSGALG00000029305","33",3808929,3808985,56
"10483","ENSGALG00000029308","1",69044299,69089535,45236
"10484","ENSGALG00000029316","23",145665,177912,32247
"10485","ENSGALG00000029319","2",126714498,126720504,6006
"10486","ENSGALG00000029322","19",10039242,10045919,6677
"10487","ENSGALG00000029324","11",313945,323201,9256
"10488","ENSGALG00000029329","4",9063544,9064635,1091
"10489","ENSGALG00000029330","32",146040,147421,1381
"10490","ENSGALG00000029331","20",12038114,12051206,13092
"10491","ENSGALG00000029332","5",1124770,1132730,7960
"10492","ENSGALG00000029333","3",4537243,4558787,21544
"10493","ENSGALG00000029341","1",1142788,1201181,58393
"10494","ENSGALG00000029343","32",67698,70052,2354
"10495","ENSGALG00000029346","13",1571184,1576508,5324
"10496","ENSGALG00000029354","30",437446,458592,21146
"10497","ENSGALG00000029360","14",8116712,8141697,24985
"10498","ENSGALG00000029367","11",18419385,18421364,1979
"10499","ENSGALG00000029375","8",28721901,28731753,9852
"10500","ENSGALG00000029378","2",48649047,48868823,219776
"10501","ENSGALG00000029379","1",18927212,18992907,65695
"10502","ENSGALG00000029380","8",6033495,6048260,14765
"10503","ENSGALG00000029381","16",2592345,2605843,13498
"10504","ENSGALG00000029382","24",1375288,1401419,26131
"10505","ENSGALG00000029383","KZ626834.1",152063,158251,6188
"10506","ENSGALG00000029387","13",2072835,2073818,983
"10507","ENSGALG00000029390","15",5354761,5356086,1325
"10508","ENSGALG00000029392","1",132652407,132762481,110074
"10509","ENSGALG00000029393","33",7585953,7590530,4577
"10510","ENSGALG00000029396","12",4889902,4897220,7318
"10511","ENSGALG00000029401","5",54593128,54595588,2460
"10512","ENSGALG00000029402","14",12551591,12627669,76078
"10513","ENSGALG00000029408","19",408113,457407,49294
"10514","ENSGALG00000029416","1",184326387,184418640,92253
"10515","ENSGALG00000029419","5",243858,244816,958
"10516","ENSGALG00000029423","24",2447399,2453834,6435
"10517","ENSGALG00000029424","11",17866563,17907521,40958
"10518","ENSGALG00000029426","2",17428334,17438089,9755
"10519","ENSGALG00000029429","13",15872416,15893088,20672
"10520","ENSGALG00000029432","9",18029692,18051031,21339
"10521","ENSGALG00000029435","2",114394053,114416525,22472
"10522","ENSGALG00000029439","33",7601322,7604178,2856
"10523","ENSGALG00000029444","25",3531904,3540945,9041
"10524","ENSGALG00000029445","18",10523477,10528464,4987
"10525","ENSGALG00000029446","1",4688854,4719036,30182
"10526","ENSGALG00000029449","19",2998206,3004488,6282
"10527","ENSGALG00000029450","25",2941413,2949623,8210
"10528","ENSGALG00000029454","5",25660348,25676021,15673
"10529","ENSGALG00000029462","4",11545349,11576801,31452
"10530","ENSGALG00000029469","6",32962719,32969923,7204
"10531","ENSGALG00000029474","2",106324490,106338771,14281
"10532","ENSGALG00000029476","3",2366625,2408562,41937
"10533","ENSGALG00000029480","5",331424,335364,3940
"10534","ENSGALG00000029484","1",53675196,53707480,32284
"10535","ENSGALG00000029485","20",9801519,9804421,2902
"10536","ENSGALG00000029494","23",6070881,6072078,1197
"10537","ENSGALG00000029498","11",9911033,9914941,3908
"10538","ENSGALG00000029500","MT",13071,14888,1817
"10539","ENSGALG00000029502","4",1823156,1828005,4849
"10540","ENSGALG00000029508","4",34167020,34169352,2332
"10541","ENSGALG00000029509","2",124557381,124612440,55059
"10542","ENSGALG00000029510","4",78931174,79053674,122500
"10543","ENSGALG00000029512","3",2697040,2819577,122537
"10544","ENSGALG00000029514","14",14658888,14729646,70758
"10545","ENSGALG00000029521","10",19503832,19506829,2997
"10546","ENSGALG00000029523","2",135540254,135564198,23944
"10547","ENSGALG00000029528","25",2487750,2508685,20935
"10548","ENSGALG00000029532","4",34987276,34989334,2058
"10549","ENSGALG00000029533","5",16539825,16667856,128031
"10550","ENSGALG00000029536","24",77314,151086,73772
"10551","ENSGALG00000029537","10",3144648,3153415,8767
"10552","ENSGALG00000029540","6",3319882,3332603,12721
"10553","ENSGALG00000029545","W",2602132,2628699,26567
"10554","ENSGALG00000029558","27",6555609,6557437,1828
"10555","ENSGALG00000029560","13",10456095,10473221,17126
"10556","ENSGALG00000029565","10",12668575,12676246,7671
"10557","ENSGALG00000029566","5",17002379,17009731,7352
"10558","ENSGALG00000029569","2",519057,520883,1826
"10559","ENSGALG00000029571","2",124638608,124662069,23461
"10560","ENSGALG00000029572","2",148409192,148420799,11607
"10561","ENSGALG00000029576","12",12224507,12228998,4491
"10562","ENSGALG00000029582","8",14456259,14525294,69035
"10563","ENSGALG00000029583","1",48905356,48942414,37058
"10564","ENSGALG00000029585","4",2168523,2173452,4929
"10565","ENSGALG00000029586","5",9161644,9200596,38952
"10566","ENSGALG00000029588","33",6904888,6907855,2967
"10567","ENSGALG00000029596","2",137356485,137374399,17914
"10568","ENSGALG00000029599","33",3279533,3294139,14606
"10569","ENSGALG00000029606","18",564255,586932,22677
"10570","ENSGALG00000029610","18",7720345,7747429,27084
"10571","ENSGALG00000029613","4",26829765,26868188,38423
"10572","ENSGALG00000029614","28",3183713,3186831,3118
"10573","ENSGALG00000029616","1",54651418,54674159,22741
"10574","ENSGALG00000029617","6",25087347,25127305,39958
"10575","ENSGALG00000029618","5",635160,635774,614
"10576","ENSGALG00000029621","12",3580056,3597490,17434
"10577","ENSGALG00000029624","1",68200,71633,3433
"10578","ENSGALG00000029631","AADN05001221.1",21,4446,4425
"10579","ENSGALG00000029632","12",10860472,10880643,20171
"10580","ENSGALG00000029635","19",4217506,4232562,15056
"10581","ENSGALG00000029644","1",106936221,106942055,5834
"10582","ENSGALG00000029646","22",3730269,3740099,9830
"10583","ENSGALG00000029648","5",13911444,13927845,16401
"10584","ENSGALG00000029652","4",501443,545893,44450
"10585","ENSGALG00000029653","23",2842969,2885597,42628
"10586","ENSGALG00000029657","25",2087629,2094399,6770
"10587","ENSGALG00000029659","2",66289353,66312310,22957
"10588","ENSGALG00000029660","18",346119,360643,14524
"10589","ENSGALG00000029664","2",136063201,136211928,148727
"10590","ENSGALG00000029669","21",6076987,6078857,1870
"10591","ENSGALG00000029670","1",106781894,106803562,21668
"10592","ENSGALG00000029672","7",22229319,22237930,8611
"10593","ENSGALG00000029673","4",73141416,73186510,45094
"10594","ENSGALG00000029674","19",506122,515095,8973
"10595","ENSGALG00000029675","7",23390686,23468470,77784
"10596","ENSGALG00000029677","2",46118596,46137481,18885
"10597","ENSGALG00000029678","2",121434274,121458256,23982
"10598","ENSGALG00000029679","5",11778632,11840720,62088
"10599","ENSGALG00000029680","12",5489003,5492583,3580
"10600","ENSGALG00000029691","32",99296,104093,4797
"10601","ENSGALG00000029692","13",16055691,16057147,1456
"10602","ENSGALG00000029694","20",2273668,2282345,8677
"10603","ENSGALG00000029695","27",6452171,6456221,4050
"10604","ENSGALG00000029701","7",12599657,12630183,30526
"10605","ENSGALG00000029702","5",623897,633480,9583
"10606","ENSGALG00000029704","1",58250511,58267353,16842
"10607","ENSGALG00000029706","13",14298629,14312127,13498
"10608","ENSGALG00000029709","1",133491845,133561055,69210
"10609","ENSGALG00000029714","10",20517576,20524803,7227
"10610","ENSGALG00000029721","23",3348448,3349790,1342
"10611","ENSGALG00000029724","2",41302040,41320388,18348
"10612","ENSGALG00000029731","1",197476191,197480661,4470
"10613","ENSGALG00000029735","1",141141195,141146316,5121
"10614","ENSGALG00000029740","4",8971088,8974755,3667
"10615","ENSGALG00000029743","5",27647878,27656405,8527
"10616","ENSGALG00000029746","1",54748399,54768748,20349
"10617","ENSGALG00000029747","24",473593,483311,9718
"10618","ENSGALG00000029760","2",149468979,149495570,26591
"10619","ENSGALG00000029761","32",98967,101825,2858
"10620","ENSGALG00000029764","4",600807,612498,11691
"10621","ENSGALG00000029766","7",27871850,27912771,40921
"10622","ENSGALG00000029768","5",58266782,58269815,3033
"10623","ENSGALG00000029779","1",177443306,177444251,945
"10624","ENSGALG00000029788","2",43773646,43778740,5094
"10625","ENSGALG00000029789","9",12836912,12849716,12804
"10626","ENSGALG00000029793","11",6651537,6657394,5857
"10627","ENSGALG00000029794","3",57483132,57554676,71544
"10628","ENSGALG00000029795","9",16073264,16078955,5691
"10629","ENSGALG00000029796","1",26308146,26460661,152515
"10630","ENSGALG00000029799","25",2335912,2338694,2782
"10631","ENSGALG00000029810","1",50591208,50594275,3067
"10632","ENSGALG00000029811","2",47461980,47608491,146511
"10633","ENSGALG00000029812","25",1553973,1559757,5784
"10634","ENSGALG00000029817","14",4960357,5048156,87799
"10635","ENSGALG00000029819","9",8387258,8389147,1889
"10636","ENSGALG00000029820","14",13144055,13148979,4924
"10637","ENSGALG00000029823","6",10068608,10068961,353
"10638","ENSGALG00000029827","14",14811415,14826780,15365
"10639","ENSGALG00000029829","6",10115541,10178635,63094
"10640","ENSGALG00000029830","3",30504194,30506377,2183
"10641","ENSGALG00000029831","21",4566343,4593205,26862
"10642","ENSGALG00000029832","10",13915487,13971883,56396
"10643","ENSGALG00000029834","17",6378663,6390710,12047
"10644","ENSGALG00000029836","2",57826956,57848803,21847
"10645","ENSGALG00000029837","3",104460533,104460646,113
"10646","ENSGALG00000029842","2",116364952,116400250,35298
"10647","ENSGALG00000029853","11",8377260,8384827,7567
"10648","ENSGALG00000029856","2",30874340,30878365,4025
"10649","ENSGALG00000029857","2",4138557,4140735,2178
"10650","ENSGALG00000029858","11",3379302,3399182,19880
"10651","ENSGALG00000029862","3",27397532,27407370,9838
"10652","ENSGALG00000029863","6",1366037,1398417,32380
"10653","ENSGALG00000029865","18",8590017,8744603,154586
"10654","ENSGALG00000029867","2",130731663,130807659,75996
"10655","ENSGALG00000029868","31",3255944,3257567,1623
"10656","ENSGALG00000029882","18",5058891,5060147,1256
"10657","ENSGALG00000029892","5",18658103,18665579,7476
"10658","ENSGALG00000029893","18",8976176,8984896,8720
"10659","ENSGALG00000029896","13",17179403,17281757,102354
"10660","ENSGALG00000029897","2",127365381,127369732,4351
"10661","ENSGALG00000029898","22",5249992,5252898,2906
"10662","ENSGALG00000029909","23",274496,283248,8752
"10663","ENSGALG00000029912","12",11875094,11877807,2713
"10664","ENSGALG00000029915","3",38280486,38284689,4203
"10665","ENSGALG00000029917","27",5558297,5564632,6335
"10666","ENSGALG00000029918","23",6073419,6093669,20250
"10667","ENSGALG00000029921","1",38319983,38328004,8021
"10668","ENSGALG00000029927","17",9197371,9251703,54332
"10669","ENSGALG00000029930","20",830535,838751,8216
"10670","ENSGALG00000029931","1",168842803,168850072,7269
"10671","ENSGALG00000029935","2",84402769,84415948,13179
"10672","ENSGALG00000029939","13",1719770,1740082,20312
"10673","ENSGALG00000029940","22",5171645,5173295,1650
"10674","ENSGALG00000029944","15",7119922,7130987,11065
"10675","ENSGALG00000029947","15",7064507,7068108,3601
"10676","ENSGALG00000029961","3",57371166,57371270,104
"10677","ENSGALG00000029966","1",77125917,77132207,6290
"10678","ENSGALG00000029968","28",3398994,3401884,2890
"10679","ENSGALG00000029970","1",137514695,137753423,238728
"10680","ENSGALG00000029971","30",763832,769606,5774
"10681","ENSGALG00000029980","12",11997117,12002006,4889
"10682","ENSGALG00000029983","2",131756078,131920640,164562
"10683","ENSGALG00000029985","12",350756,361583,10827
"10684","ENSGALG00000029989","15",702332,702427,95
"10685","ENSGALG00000029996","5",49547542,49621490,73948
"10686","ENSGALG00000029999","11",549883,554714,4831
"10687","ENSGALG00000030000","9",10508790,10523547,14757
"10688","ENSGALG00000030002","33",5401187,5408382,7195
"10689","ENSGALG00000030003","27",7802137,7809584,7447
"10690","ENSGALG00000030005","20",72048,75589,3541
"10691","ENSGALG00000030006","3",110476929,110513639,36710
"10692","ENSGALG00000030007","26",2670099,2686743,16644
"10693","ENSGALG00000030008","6",21666750,21671233,4483
"10694","ENSGALG00000030011","2",121005791,121083584,77793
"10695","ENSGALG00000030012","20",4974113,4980108,5995
"10696","ENSGALG00000030016","3",107370910,107378810,7900
"10697","ENSGALG00000030022","3",944350,972862,28512
"10698","ENSGALG00000030024","1",33026379,33090152,63773
"10699","ENSGALG00000030025","2",121349992,121353429,3437
"10700","ENSGALG00000030027","24",4240693,4250430,9737
"10701","ENSGALG00000030028","8",7476798,7479199,2401
"10702","ENSGALG00000030029","9",21517589,21543315,25726
"10703","ENSGALG00000030030","2",132071594,132172629,101035
"10704","ENSGALG00000030031","2",113806150,113819007,12857
"10705","ENSGALG00000030032","7",21180845,21299422,118577
"10706","ENSGALG00000030034","27",7903742,7906398,2656
"10707","ENSGALG00000030038","30",491364,674579,183215
"10708","ENSGALG00000030040","11",18561563,18609055,47492
"10709","ENSGALG00000030046","22",197998,198103,105
"10710","ENSGALG00000030051","15",746739,761662,14923
"10711","ENSGALG00000030054","2",8874767,9429088,554321
"10712","ENSGALG00000030055","11",1083964,1102095,18131
"10713","ENSGALG00000030056","1",161146747,161147079,332
"10714","ENSGALG00000030059","2",138039774,138050569,10795
"10715","ENSGALG00000030063","Z",808462,839415,30953
"10716","ENSGALG00000030064","4",2904832,2916879,12047
"10717","ENSGALG00000030065","4",40053454,40498128,444674
"10718","ENSGALG00000030068","28",4092302,4096097,3795
"10719","ENSGALG00000030070","4",75992057,76001311,9254
"10720","ENSGALG00000030075","KZ626838.1",155851,191216,35365
"10721","ENSGALG00000030076","10",18068294,18090172,21878
"10722","ENSGALG00000030081","2",32392815,32502297,109482
"10723","ENSGALG00000030084","2",43050101,43070368,20267
"10724","ENSGALG00000030086","33",7481175,7483850,2675
"10725","ENSGALG00000030087","30",937708,943152,5444
"10726","ENSGALG00000030088","5",33011772,33013712,1940
"10727","ENSGALG00000030095","4",91128367,91129565,1198
"10728","ENSGALG00000030096","21",5189649,5204441,14792
"10729","ENSGALG00000030097","23",2306659,2310531,3872
"10730","ENSGALG00000030099","33",6574142,6579564,5422
"10731","ENSGALG00000030101","1",49592788,49597177,4389
"10732","ENSGALG00000030102","Z",70979936,70980000,64
"10733","ENSGALG00000030111","2",44767691,44772484,4793
"10734","ENSGALG00000030112","2",113285505,113316802,31297
"10735","ENSGALG00000030115","2",141922045,141957880,35835
"10736","ENSGALG00000030118","4",90918030,90921683,3653
"10737","ENSGALG00000030120","10",11166145,11169393,3248
"10738","ENSGALG00000030121","15",8330780,8338969,8189
"10739","ENSGALG00000030125","1",140577901,140612165,34264
"10740","ENSGALG00000030128","2",141356443,141375407,18964
"10741","ENSGALG00000030129","KZ626834.1",260462,263848,3386
"10742","ENSGALG00000030139","24",5227593,5231535,3942
"10743","ENSGALG00000030140","1",7161428,7200482,39054
"10744","ENSGALG00000030141","4",89017003,89030199,13196
"10745","ENSGALG00000030147","13",17781440,17816519,35079
"10746","ENSGALG00000030148","4",90826518,90836978,10460
"10747","ENSGALG00000030151","5",1329073,1496599,167526
"10748","ENSGALG00000030153","5",640937,642930,1993
"10749","ENSGALG00000030155","4",68828411,68856574,28163
"10750","ENSGALG00000030157","10",15422025,15517080,95055
"10751","ENSGALG00000030160","11",510445,522708,12263
"10752","ENSGALG00000030162","10",20744794,20792797,48003
"10753","ENSGALG00000030164","32",88923,92453,3530
"10754","ENSGALG00000030165","20",12510109,12513114,3005
"10755","ENSGALG00000030173","1",24840450,24853779,13329
"10756","ENSGALG00000030175","2",44518220,44569669,51449
"10757","ENSGALG00000030176","17",2777985,2779542,1557
"10758","ENSGALG00000030179","6",12620516,12626469,5953
"10759","ENSGALG00000030185","2",126738656,126768617,29961
"10760","ENSGALG00000030187","5",18920696,18939330,18634
"10761","ENSGALG00000030194","9",899452,904547,5095
"10762","ENSGALG00000030195","1",72032827,72100787,67960
"10763","ENSGALG00000030200","22",239465,252244,12779
"10764","ENSGALG00000030206","19",6919911,6923523,3612
"10765","ENSGALG00000030209","4",81163250,81197855,34605
"10766","ENSGALG00000030220","11",1000784,1009243,8459
"10767","ENSGALG00000030226","1",77567295,77567395,100
"10768","ENSGALG00000030229","23",4766719,4994805,228086
"10769","ENSGALG00000030237","13",16307444,16321414,13970
"10770","ENSGALG00000030245","5",54739247,54749789,10542
"10771","ENSGALG00000030247","25",253773,258260,4487
"10772","ENSGALG00000030250","10",14650564,14672563,21999
"10773","ENSGALG00000030251","2",140875182,140993382,118200
"10774","ENSGALG00000030253","20",1079716,1091358,11642
"10775","ENSGALG00000030254","7",17843213,17885866,42653
"10776","ENSGALG00000030255","17",998671,1003940,5269
"10777","ENSGALG00000030259","18",1942703,1953196,10493
"10778","ENSGALG00000030261","23",4587121,4588260,1139
"10779","ENSGALG00000030263","17",944780,997393,52613
"10780","ENSGALG00000030266","5",7223638,7225765,2127
"10781","ENSGALG00000030267","10",15075945,15076015,70
"10782","ENSGALG00000030268","2",2020319,2058934,38615
"10783","ENSGALG00000030269","3",17663798,17672077,8279
"10784","ENSGALG00000030270","16",2665728,2668557,2829
"10785","ENSGALG00000030276","6",29935052,29990736,55684
"10786","ENSGALG00000030280","2",128496928,128511542,14614
"10787","ENSGALG00000030287","2",48553369,48578636,25267
"10788","ENSGALG00000030291","20",10063682,10066572,2890
"10789","ENSGALG00000030303","4",49546121,49550072,3951
"10790","ENSGALG00000030305","23",1579849,1582005,2156
"10791","ENSGALG00000030313","5",1172527,1180757,8230
"10792","ENSGALG00000030322","2",42130912,42147798,16886
"10793","ENSGALG00000030324","1",8136573,8180800,44227
"10794","ENSGALG00000030331","7",12574185,12574263,78
"10795","ENSGALG00000030338","5",17218808,17224561,5753
"10796","ENSGALG00000030342","33",5515547,5538000,22453
"10797","ENSGALG00000030344","28",4033885,4037361,3476
"10798","ENSGALG00000030350","9",5719637,5755791,36154
"10799","ENSGALG00000030351","30",46308,75977,29669
"10800","ENSGALG00000030353","1",141152094,141154399,2305
"10801","ENSGALG00000030356","4",78500599,78512725,12126
"10802","ENSGALG00000030357","8",6586590,6619960,33370
"10803","ENSGALG00000030363","1",106613562,106632348,18786
"10804","ENSGALG00000030372","25",3913006,3917776,4770
"10805","ENSGALG00000030376","21",5314485,5343907,29422
"10806","ENSGALG00000030377","26",4904800,4905285,485
"10807","ENSGALG00000030378","23",5714104,5718468,4364
"10808","ENSGALG00000030379","2",8517673,8568953,51280
"10809","ENSGALG00000030382","W",3970486,4106227,135741
"10810","ENSGALG00000030383","9",19298207,19363271,65064
"10811","ENSGALG00000030384","3",4365991,4385217,19226
"10812","ENSGALG00000030396","26",4415508,4417360,1852
"10813","ENSGALG00000030397","16",2513936,2518556,4620
"10814","ENSGALG00000030401","19",9945836,9949612,3776
"10815","ENSGALG00000030405","25",3145569,3148245,2676
"10816","ENSGALG00000030406","22",459936,478794,18858
"10817","ENSGALG00000030407","25",2927917,2933482,5565
"10818","ENSGALG00000030411","20",7735022,7741495,6473
"10819","ENSGALG00000030416","33",7640903,7643614,2711
"10820","ENSGALG00000030419","7",7856153,7908623,52470
"10821","ENSGALG00000030420","9",15727596,15733606,6010
"10822","ENSGALG00000030429","2",111230880,111235258,4378
"10823","ENSGALG00000030432","22",559504,571288,11784
"10824","ENSGALG00000030434","15",694743,694819,76
"10825","ENSGALG00000030436","MT",10776,11126,350
"10826","ENSGALG00000030442","2",66980694,66982274,1580
"10827","ENSGALG00000030450","19",2926988,2958776,31788
"10828","ENSGALG00000030451","33",7408725,7408899,174
"10829","ENSGALG00000030455","2",32987174,33160334,173160
"10830","ENSGALG00000030457","30",1091930,1094312,2382
"10831","ENSGALG00000030460","2",137916482,137941263,24781
"10832","ENSGALG00000030461","6",3352386,3354716,2330
"10833","ENSGALG00000030466","33",6957980,6962486,4506
"10834","ENSGALG00000030470","33",6534155,6534222,67
"10835","ENSGALG00000030475","18",687325,694323,6998
"10836","ENSGALG00000030481","14",13934815,13957363,22548
"10837","ENSGALG00000030487","12",11068883,11078082,9199
"10838","ENSGALG00000030489","17",2437879,2437941,62
"10839","ENSGALG00000030492","5",13869949,13870452,503
"10840","ENSGALG00000030493","2",41127304,41147533,20229
"10841","ENSGALG00000030499","5",14412214,14510673,98459
"10842","ENSGALG00000030501","3",53090817,53093019,2202
"10843","ENSGALG00000030502","25",3958394,3965648,7254
"10844","ENSGALG00000030506","1",78481425,78482360,935
"10845","ENSGALG00000030510","10",16241935,16246117,4182
"10846","ENSGALG00000030511","7",6682190,6687383,5193
"10847","ENSGALG00000030512","19",5943316,5945850,2534
"10848","ENSGALG00000030515","1",44872359,44891392,19033
"10849","ENSGALG00000030516","4",89848236,89855757,7521
"10850","ENSGALG00000030526","1",135138720,135153025,14305
"10851","ENSGALG00000030530","4",43384478,43385619,1141
"10852","ENSGALG00000030532","11",8335240,8359726,24486
"10853","ENSGALG00000030533","30",474865,478263,3398
"10854","ENSGALG00000030534","14",8822435,8852860,30425
"10855","ENSGALG00000030540","9",14491492,14491595,103
"10856","ENSGALG00000030542","10",10215219,10367585,152366
"10857","ENSGALG00000030545","3",55006646,55011097,4451
"10858","ENSGALG00000030546","14",8815486,8821411,5925
"10859","ENSGALG00000030548","5",227858,234140,6282
"10860","ENSGALG00000030550","1",43425751,43483144,57393
"10861","ENSGALG00000030552","2",41172440,41178958,6518
"10862","ENSGALG00000030554","25",2978863,2999591,20728
"10863","ENSGALG00000030561","17",651627,665120,13493
"10864","ENSGALG00000030563","21",4616401,4628543,12142
"10865","ENSGALG00000030564","KZ626832.1",174748,184313,9565
"10866","ENSGALG00000030566","3",3962718,3975313,12595
"10867","ENSGALG00000030569","16",2520198,2524870,4672
"10868","ENSGALG00000030571","1",168025737,168042111,16374
"10869","ENSGALG00000030576","10",20420143,20421618,1475
"10870","ENSGALG00000030580","5",44316009,44380668,64659
"10871","ENSGALG00000030585","2",111988156,112040871,52715
"10872","ENSGALG00000030587","3",30424069,30439118,15049
"10873","ENSGALG00000030588","4",42753708,43184699,430991
"10874","ENSGALG00000030590","3",38557631,38559258,1627
"10875","ENSGALG00000030592","17",5907392,5937106,29714
"10876","ENSGALG00000030597","6",21687983,21704004,16021
"10877","ENSGALG00000030598","6",21912396,21954114,41718
"10878","ENSGALG00000030599","30",178603,197548,18945
"10879","ENSGALG00000030602","4",89568221,89591688,23467
"10880","ENSGALG00000030603","22",293081,383689,90608
"10881","ENSGALG00000030605","25",3951607,3955011,3404
"10882","ENSGALG00000030607","1",54386968,54542011,155043
"10883","ENSGALG00000030609","17",7200310,7205006,4696
"10884","ENSGALG00000030613","13",13957973,13973578,15605
"10885","ENSGALG00000030614","4",59984686,59995027,10341
"10886","ENSGALG00000030626","2",129255284,129282543,27259
"10887","ENSGALG00000030629","33",5249338,5254464,5126
"10888","ENSGALG00000030636","AADN05001362.1",6536,7720,1184
"10889","ENSGALG00000030643","25",2442218,2446961,4743
"10890","ENSGALG00000030647","21",4415210,4419343,4133
"10891","ENSGALG00000030652","1",195806601,195807686,1085
"10892","ENSGALG00000030657","11",883170,883880,710
"10893","ENSGALG00000030660","2",114919024,114955857,36833
"10894","ENSGALG00000030661","33",6934615,6940207,5592
"10895","ENSGALG00000030672","10",1641249,1670289,29040
"10896","ENSGALG00000030673","5",50224769,50242138,17369
"10897","ENSGALG00000030676","26",1193543,1198156,4613
"10898","ENSGALG00000030677","6",18374424,18392107,17683
"10899","ENSGALG00000030683","33",6534693,6534818,125
"10900","ENSGALG00000030684","15",9086579,9099994,13415
"10901","ENSGALG00000030687","22",62899,68531,5632
"10902","ENSGALG00000030689","4",32322740,32351640,28900
"10903","ENSGALG00000030691","3",25523064,25581617,58553
"10904","ENSGALG00000030701","23",5310700,5313031,2331
"10905","ENSGALG00000030702","1",4800961,4815768,14807
"10906","ENSGALG00000030703","7",18009896,18018295,8399
"10907","ENSGALG00000030705","1",20383039,20415387,32348
"10908","ENSGALG00000030706","23",2046642,2056508,9866
"10909","ENSGALG00000030710","20",79511,98048,18537
"10910","ENSGALG00000030712","33",7292614,7310596,17982
"10911","ENSGALG00000030718","4",13177222,13181501,4279
"10912","ENSGALG00000030719","5",46093745,46160385,66640
"10913","ENSGALG00000030720","24",6307789,6314912,7123
"10914","ENSGALG00000030724","2",105029643,105031327,1684
"10915","ENSGALG00000030728","3",65631594,65760244,128650
"10916","ENSGALG00000030730","Z",7254427,7288141,33714
"10917","ENSGALG00000030732","5",24165051,24178161,13110
"10918","ENSGALG00000030739","27",7174983,7181673,6690
"10919","ENSGALG00000030759","24",428137,437185,9048
"10920","ENSGALG00000030767","2",111032635,111051679,19044
"10921","ENSGALG00000030773","9",24039075,24062914,23839
"10922","ENSGALG00000030775","2",2154713,2159697,4984
"10923","ENSGALG00000030776","33",3166725,3168701,1976
"10924","ENSGALG00000030780","1",133618531,133693798,75267
"10925","ENSGALG00000030781","2",122766240,122822370,56130
"10926","ENSGALG00000030783","1",50816874,50834079,17205
"10927","ENSGALG00000030789","7",10027482,10056518,29036
"10928","ENSGALG00000030791","4",5910181,5955619,45438
"10929","ENSGALG00000030792","19",4258521,4273329,14808
"10930","ENSGALG00000030793","1",107179121,107179498,377
"10931","ENSGALG00000030800","Z",16981247,17014499,33252
"10932","ENSGALG00000030801","4",73203371,73210227,6856
"10933","ENSGALG00000030802","1",126382713,126504702,121989
"10934","ENSGALG00000030803","11",16528447,16536007,7560
"10935","ENSGALG00000030808","19",4315220,4316601,1381
"10936","ENSGALG00000030809","3",9978565,9982156,3591
"10937","ENSGALG00000030810","3",209984,233725,23741
"10938","ENSGALG00000030812","10",1671681,1758511,86830
"10939","ENSGALG00000030821","20",12108431,12112972,4541
"10940","ENSGALG00000030822","6",19523159,19537670,14511
"10941","ENSGALG00000030824","3",45974680,45975584,904
"10942","ENSGALG00000030826","14",12684836,12701562,16726
"10943","ENSGALG00000030831","17",879847,892852,13005
"10944","ENSGALG00000030834","Z",334119,365812,31693
"10945","ENSGALG00000030836","13",1823948,1896054,72106
"10946","ENSGALG00000030843","2",115315596,115326952,11356
"10947","ENSGALG00000030844","1",8028172,8056726,28554
"10948","ENSGALG00000030845","Z",7905544,7906945,1401
"10949","ENSGALG00000030847","27",3904120,3905793,1673
"10950","ENSGALG00000030849","28",114505,118382,3877
"10951","ENSGALG00000030852","28",1638657,1663714,25057
"10952","ENSGALG00000030853","1",45996281,46037126,40845
"10953","ENSGALG00000030855","2",44047405,44131996,84591
"10954","ENSGALG00000030857","21",6569722,6593773,24051
"10955","ENSGALG00000030858","10",20298566,20337526,38960
"10956","ENSGALG00000030859","20",10918207,11045636,127429
"10957","ENSGALG00000030862","2",135774418,135791010,16592
"10958","ENSGALG00000030863","10",1337596,1344427,6831
"10959","ENSGALG00000030866","2",126884462,127048750,164288
"10960","ENSGALG00000030871","10",9346409,9349658,3249
"10961","ENSGALG00000030874","12",1171448,1171520,72
"10962","ENSGALG00000030875","6",32456013,32457729,1716
"10963","ENSGALG00000030877","14",13166921,13222048,55127
"10964","ENSGALG00000030878","2",145698580,145699798,1218
"10965","ENSGALG00000030879","4",451461,496067,44606
"10966","ENSGALG00000030885","1",197267483,197268442,959
"10967","ENSGALG00000030886","17",872551,874786,2235
"10968","ENSGALG00000030888","14",5509542,5511696,2154
"10969","ENSGALG00000030889","3",3366094,3369593,3499
"10970","ENSGALG00000030890","2",115081599,115082672,1073
"10971","ENSGALG00000030899","27",5455014,5459571,4557
"10972","ENSGALG00000030900","23",2696846,2700720,3874
"10973","ENSGALG00000030902","2",108430041,108432260,2219
"10974","ENSGALG00000030904","33",4683782,4739424,55642
"10975","ENSGALG00000030907","27",7128855,7130727,1872
"10976","ENSGALG00000030908","12",4161222,4410601,249379
"10977","ENSGALG00000030913","17",931648,934905,3257
"10978","ENSGALG00000030917","33",3409283,3412066,2783
"10979","ENSGALG00000030918","28",3176587,3182020,5433
"10980","ENSGALG00000030920","24",5139000,5139712,712
"10981","ENSGALG00000030925","6",32999470,33067777,68307
"10982","ENSGALG00000030929","3",105361343,105369458,8115
"10983","ENSGALG00000030931","4",90818664,90825690,7026
"10984","ENSGALG00000030932","6",23078002,23080276,2274
"10985","ENSGALG00000030933","1",54703831,54705113,1282
"10986","ENSGALG00000030940","16",2572332,2573868,1536
"10987","ENSGALG00000030941","26",1148302,1157441,9139
"10988","ENSGALG00000030943","1",67188237,67209122,20885
"10989","ENSGALG00000030944","9",8034728,8096205,61477
"10990","ENSGALG00000030955","9",15432264,15432345,81
"10991","ENSGALG00000030959","9",10813184,10813271,87
"10992","ENSGALG00000030960","3",40719341,40751814,32473
"10993","ENSGALG00000030964","6",12233307,12235990,2683
"10994","ENSGALG00000030966","26",169877,184131,14254
"10995","ENSGALG00000030968","3",65815585,65823074,7489
"10996","ENSGALG00000030969","2",43035072,43041839,6767
"10997","ENSGALG00000030976","20",5490828,5492034,1206
"10998","ENSGALG00000030979","19",341313,352434,11121
"10999","ENSGALG00000030982","19",8846492,8852834,6342
"11000","ENSGALG00000030985","20",2590986,2616556,25570
"11001","ENSGALG00000030988","10",1554284,1575874,21590
"11002","ENSGALG00000030991","2",87109992,87114778,4786
"11003","ENSGALG00000030994","25",2623109,2624227,1118
"11004","ENSGALG00000030996","15",6953787,6954986,1199
"11005","ENSGALG00000030998","33",6550475,6558280,7805
"11006","ENSGALG00000031000","11",18462849,18469131,6282
"11007","ENSGALG00000031002","25",3510287,3514320,4033
"11008","ENSGALG00000031009","1",140644742,140749677,104935
"11009","ENSGALG00000031010","1",106522741,106524533,1792
"11010","ENSGALG00000031013","31",5598840,5603322,4482
"11011","ENSGALG00000031016","17",6935885,6942642,6757
"11012","ENSGALG00000031018","Z",2043192,2082847,39655
"11013","ENSGALG00000031021","3",91475852,91541508,65656
"11014","ENSGALG00000031024","6",11461407,11484788,23381
"11015","ENSGALG00000031035","2",109465995,109509669,43674
"11016","ENSGALG00000031045","3",48091727,48100463,8736
"11017","ENSGALG00000031051","14",4856532,4867293,10761
"11018","ENSGALG00000031056","33",6841845,6846397,4552
"11019","ENSGALG00000031058","18",2562954,2584860,21906
"11020","ENSGALG00000031062","5",50598446,50603397,4951
"11021","ENSGALG00000031066","16",505178,506622,1444
"11022","ENSGALG00000031067","5",277276,281735,4459
"11023","ENSGALG00000031069","7",18603505,18612701,9196
"11024","ENSGALG00000031070","7",11026372,11030911,4539
"11025","ENSGALG00000031071","9",3627891,3633593,5702
"11026","ENSGALG00000031075","4",81080816,81124238,43422
"11027","ENSGALG00000031076","2",126080168,126109221,29053
"11028","ENSGALG00000031094","4",382800,392016,9216
"11029","ENSGALG00000031103","6",20916166,20921152,4986
"11030","ENSGALG00000031105","4",50212212,50372852,160640
"11031","ENSGALG00000031112","7",504980,619779,114799
"11032","ENSGALG00000031117","2",51496702,51521276,24574
"11033","ENSGALG00000031119","8",6476373,6478963,2590
"11034","ENSGALG00000031120","13",14281528,14298022,16494
"11035","ENSGALG00000031122","8",1215190,1359430,144240
"11036","ENSGALG00000031128","9",4610405,4623784,13379
"11037","ENSGALG00000031129","8",10922755,11113792,191037
"11038","ENSGALG00000031130","2",113791462,113802894,11432
"11039","ENSGALG00000031131","2",126048980,126075321,26341
"11040","ENSGALG00000031134","24",4427162,4441513,14351
"11041","ENSGALG00000031139","12",11198197,11200471,2274
"11042","ENSGALG00000031142","Z",985677,998088,12411
"11043","ENSGALG00000031143","24",450929,468974,18045
"11044","ENSGALG00000031144","4",4546836,4549231,2395
"11045","ENSGALG00000031149","26",2653131,2657536,4405
"11046","ENSGALG00000031158","6",32975013,32985638,10625
"11047","ENSGALG00000031159","1",48103557,48104467,910
"11048","ENSGALG00000031160","4",50079169,50085060,5891
"11049","ENSGALG00000031163","2",41213767,41265858,52091
"11050","ENSGALG00000031164","20",10480912,10485242,4330
"11051","ENSGALG00000031167","2",115326115,115356284,30169
"11052","ENSGALG00000031170","2",54710632,54882357,171725
"11053","ENSGALG00000031175","26",595820,614752,18932
"11054","ENSGALG00000031177","1",85325097,85334170,9073
"11055","ENSGALG00000031182","5",58878849,58944812,65963
"11056","ENSGALG00000031183","23",304549,312669,8120
"11057","ENSGALG00000031186","1",49517079,49526710,9631
"11058","ENSGALG00000031193","25",3867659,3878853,11194
"11059","ENSGALG00000031196","3",57431283,57438566,7283
"11060","ENSGALG00000031197","MT",8261,8329,68
"11061","ENSGALG00000031205","27",6045993,6048245,2252
"11062","ENSGALG00000031209","11",378242,382806,4564
"11063","ENSGALG00000031210","8",29389240,29401259,12019
"11064","ENSGALG00000031211","4",90933015,90936387,3372
"11065","ENSGALG00000031212","5",57745609,57747045,1436
"11066","ENSGALG00000031214","14",5177870,5181782,3912
"11067","ENSGALG00000031216","19",6012904,6026800,13896
"11068","ENSGALG00000031222","33",7194647,7198415,3768
"11069","ENSGALG00000031227","2",914017,929139,15122
"11070","ENSGALG00000031238","5",39564609,39567636,3027
"11071","ENSGALG00000031240","15",6492464,6506008,13544
"11072","ENSGALG00000031243","2",337915,344446,6531
"11073","ENSGALG00000031244","7",26948199,27144911,196712
"11074","ENSGALG00000031248","2",123036659,123049268,12609
"11075","ENSGALG00000031255","13",17962473,17978333,15860
"11076","ENSGALG00000031260","2",55554625,55556797,2172
"11077","ENSGALG00000031262","3",85506342,85591057,84715
"11078","ENSGALG00000031263","19",360634,364590,3956
"11079","ENSGALG00000031265","3",77845,88773,10928
"11080","ENSGALG00000031266","5",999180,1013225,14045
"11081","ENSGALG00000031270","10",2881824,2885383,3559
"11082","ENSGALG00000031274","33",5078182,5097737,19555
"11083","ENSGALG00000031275","2",97238238,97246235,7997
"11084","ENSGALG00000031281","3",104535958,104539304,3346
"11085","ENSGALG00000031282","2",128985552,129064019,78467
"11086","ENSGALG00000031284","2",98932396,99391529,459133
"11087","ENSGALG00000031286","5",19085949,19098880,12931
"11088","ENSGALG00000031289","KZ626836.1",402060,429502,27442
"11089","ENSGALG00000031293","1",65230075,65281262,51187
"11090","ENSGALG00000031294","2",49968143,49973072,4929
"11091","ENSGALG00000031296","9",904822,909473,4651
"11092","ENSGALG00000031298","22",3701007,3708828,7821
"11093","ENSGALG00000031300","25",2249761,2250249,488
"11094","ENSGALG00000031301","26",69390,73128,3738
"11095","ENSGALG00000031302","2",113900963,113915044,14081
"11096","ENSGALG00000031303","14",12643211,12658411,15200
"11097","ENSGALG00000031305","6",1278454,1365241,86787
"11098","ENSGALG00000031306","14",1509770,1512987,3217
"11099","ENSGALG00000031312","9",3833719,3837466,3747
"11100","ENSGALG00000031313","10",2064918,2075635,10717
"11101","ENSGALG00000031323","2",56708506,56875260,166754
"11102","ENSGALG00000031325","32",208994,283021,74027
"11103","ENSGALG00000031326","11",1440907,1441042,135
"11104","ENSGALG00000031328","32",122222,128380,6158
"11105","ENSGALG00000031331","20",5369809,5382599,12790
"11106","ENSGALG00000031332","27",6592624,6623648,31024
"11107","ENSGALG00000031336","21",2787796,2801842,14046
"11108","ENSGALG00000031338","4",81413376,81416418,3042
"11109","ENSGALG00000031340","1",38375611,38391308,15697
"11110","ENSGALG00000031341","KZ626839.1",681601,721084,39483
"11111","ENSGALG00000031343","21",6611137,6620377,9240
"11112","ENSGALG00000031348","10",11184028,11211748,27720
"11113","ENSGALG00000031349","9",5618394,5618478,84
"11114","ENSGALG00000031350","9",8280662,8282369,1707
"11115","ENSGALG00000031355","W",3025104,3417683,392579
"11116","ENSGALG00000031360","4",192612,196135,3523
"11117","ENSGALG00000031361","3",38329056,38430205,101149
"11118","ENSGALG00000031368","19",6029890,6058016,28126
"11119","ENSGALG00000031372","6",23244844,23250084,5240
"11120","ENSGALG00000031373","21",169471,175544,6073
"11121","ENSGALG00000031375","1",131623105,131624499,1394
"11122","ENSGALG00000031380","2",145987868,146024793,36925
"11123","ENSGALG00000031381","8",5094064,5106655,12591
"11124","ENSGALG00000031387","2",128539050,128565423,26373
"11125","ENSGALG00000031388","4",69391529,69417940,26411
"11126","ENSGALG00000031390","2",117793947,117958705,164758
"11127","ENSGALG00000031392","1",169717070,169741966,24896
"11128","ENSGALG00000031397","2",47912833,47937133,24300
"11129","ENSGALG00000031398","7",23251973,23253748,1775
"11130","ENSGALG00000031400","1",79737363,79740201,2838
"11131","ENSGALG00000031402","14",9554559,9587321,32762
"11132","ENSGALG00000031404","6",28953746,28984776,31030
"11133","ENSGALG00000031408","10",1522444,1539392,16948
"11134","ENSGALG00000031410","4",57825703,57859115,33412
"11135","ENSGALG00000031411","28",3455156,3460673,5517
"11136","ENSGALG00000031415","4",68331260,68355417,24157
"11137","ENSGALG00000031416","14",13632241,13656290,24049
"11138","ENSGALG00000031423","8",24139262,24140464,1202
"11139","ENSGALG00000031424","2",126817624,126874829,57205
"11140","ENSGALG00000031425","18",2313522,2327119,13597
"11141","ENSGALG00000031426","33",3337502,3343004,5502
"11142","ENSGALG00000031427","3",36299716,36441865,142149
"11143","ENSGALG00000031430","8",5495630,5502809,7179
"11144","ENSGALG00000031436","9",17023862,17023962,100
"11145","ENSGALG00000031440","23",2911566,3132209,220643
"11146","ENSGALG00000031447","22",4029440,4030474,1034
"11147","ENSGALG00000031448","10",9369546,9397799,28253
"11148","ENSGALG00000031449","2",132745681,132755803,10122
"11149","ENSGALG00000031450","1",194597369,194675601,78232
"11150","ENSGALG00000031457","1",54693128,54704028,10900
"11151","ENSGALG00000031461","2",56379948,56480039,100091
"11152","ENSGALG00000031473","1",835695,840350,4655
"11153","ENSGALG00000031474","6",33166337,33190434,24097
"11154","ENSGALG00000031475","18",9964527,9969556,5029
"11155","ENSGALG00000031482","17",823420,837030,13610
"11156","ENSGALG00000031485","9",21787586,21794194,6608
"11157","ENSGALG00000031487","13",16943722,17130245,186523
"11158","ENSGALG00000031493","26",4677456,4689316,11860
"11159","ENSGALG00000031495","2",76336588,76572049,235461
"11160","ENSGALG00000031496","13",11260862,11270908,10046
"11161","ENSGALG00000031497","6",918364,920573,2209
"11162","ENSGALG00000031503","1",71658494,71767227,108733
"11163","ENSGALG00000031511","15",5545598,5559938,14340
"11164","ENSGALG00000031512","33",6942174,6953679,11505
"11165","ENSGALG00000031518","33",4132597,4133942,1345
"11166","ENSGALG00000031519","2",143110108,143190853,80745
"11167","ENSGALG00000031520","28",1062419,1063717,1298
"11168","ENSGALG00000031524","2",136938855,136961057,22202
"11169","ENSGALG00000031525","2",148892100,148896528,4428
"11170","ENSGALG00000031527","1",22204054,22231720,27666
"11171","ENSGALG00000031529","27",7047943,7055207,7264
"11172","ENSGALG00000031532","20",4138763,4143853,5090
"11173","ENSGALG00000031533","1",197219745,197222528,2783
"11174","ENSGALG00000031534","6",8972573,9078848,106275
"11175","ENSGALG00000031538","4",73507588,73524378,16790
"11176","ENSGALG00000031542","5",21966267,22035594,69327
"11177","ENSGALG00000031546","5",245338,250177,4839
"11178","ENSGALG00000031548","23",1337205,1340938,3733
"11179","ENSGALG00000031551","4",1622479,1633101,10622
"11180","ENSGALG00000031553","27",3703173,3711099,7926
"11181","ENSGALG00000031560","1",80019464,80043397,23933
"11182","ENSGALG00000031563","14",12703654,12708714,5060
"11183","ENSGALG00000031564","3",59176175,59202569,26394
"11184","ENSGALG00000031565","2",18282264,18339795,57531
"11185","ENSGALG00000031567","1",168950859,168965698,14839
"11186","ENSGALG00000031570","4",90985865,90990383,4518
"11187","ENSGALG00000031571","1",48086441,48086884,443
"11188","ENSGALG00000031572","33",7416167,7419705,3538
"11189","ENSGALG00000031578","2",133608005,134026696,418691
"11190","ENSGALG00000031582","3",10574970,10588209,13239
"11191","ENSGALG00000031583","5",491492,492426,934
"11192","ENSGALG00000031589","10",1423341,1455021,31680
"11193","ENSGALG00000031590","3",82531592,82553686,22094
"11194","ENSGALG00000031593","4",1985097,1986199,1102
"11195","ENSGALG00000031594","33",6612541,6614227,1686
"11196","ENSGALG00000031597","14",12507333,12508287,954
"11197","ENSGALG00000031604","6",11386546,11421551,35005
"11198","ENSGALG00000031605","23",3613932,3615056,1124
"11199","ENSGALG00000031606","8",25436699,25452503,15804
"11200","ENSGALG00000031615","33",5144398,5159038,14640
"11201","ENSGALG00000031624","31",3145865,3146927,1062
"11202","ENSGALG00000031626","1",306746,316814,10068
"11203","ENSGALG00000031629","5",212702,215718,3016
"11204","ENSGALG00000031631","3",82667795,82674292,6497
"11205","ENSGALG00000031632","AADN05001510.1",551,3186,2635
"11206","ENSGALG00000031635","2",49268408,49377536,109128
"11207","ENSGALG00000031636","1",14479333,14493637,14304
"11208","ENSGALG00000031637","1",111698033,111710719,12686
"11209","ENSGALG00000031642","1",197467875,197473314,5439
"11210","ENSGALG00000031645","KZ626832.1",10930,25349,14419
"11211","ENSGALG00000031648","2",115362443,115376865,14422
"11212","ENSGALG00000031650","2",47626395,47911248,284853
"11213","ENSGALG00000031651","AADN05001418.1",936,5042,4106
"11214","ENSGALG00000031652","8",19432096,19518959,86863
"11215","ENSGALG00000031656","3",56480470,56633286,152816
"11216","ENSGALG00000031657","5",14337982,14344292,6310
"11217","ENSGALG00000031659","1",76321594,76344176,22582
"11218","ENSGALG00000031663","Z",899117,904371,5254
"11219","ENSGALG00000031666","1",72867675,73073035,205360
"11220","ENSGALG00000031667","3",336939,358651,21712
"11221","ENSGALG00000031679","28",1000601,1001975,1374
"11222","ENSGALG00000031681","1",75883096,75891432,8336
"11223","ENSGALG00000031684","21",159830,167820,7990
"11224","ENSGALG00000031689","6",22900942,22919904,18962
"11225","ENSGALG00000031693","2",117418542,117607402,188860
"11226","ENSGALG00000031699","1",46042534,46066135,23601
"11227","ENSGALG00000031700","2",134839746,135006696,166950
"11228","ENSGALG00000031702","33",7146897,7172921,26024
"11229","ENSGALG00000031707","33",7138224,7142774,4550
"11230","ENSGALG00000031709","30",1138890,1140429,1539
"11231","ENSGALG00000031713","2",49661337,49711121,49784
"11232","ENSGALG00000031714","14",4538807,4544935,6128
"11233","ENSGALG00000031718","11",406967,427224,20257
"11234","ENSGALG00000031720","6",21259882,21291555,31673
"11235","ENSGALG00000031723","33",6643744,6644738,994
"11236","ENSGALG00000031726","3",104543182,104547654,4472
"11237","ENSGALG00000031729","28",2214360,2217990,3630
"11238","ENSGALG00000031734","1",194448531,194462713,14182
"11239","ENSGALG00000031735","5",289584,293008,3424
"11240","ENSGALG00000031737","5",14975993,15006369,30376
"11241","ENSGALG00000031739","17",855861,856892,1031
"11242","ENSGALG00000031741","2",145702024,145887400,185376
"11243","ENSGALG00000031751","7",16906084,16914700,8616
"11244","ENSGALG00000031754","2",56269867,56341290,71423
"11245","ENSGALG00000031758","2",49975310,50303418,328108
"11246","ENSGALG00000031762","27",3982049,3984914,2865
"11247","ENSGALG00000031763","3",37838822,37857318,18496
"11248","ENSGALG00000031766","9",5097570,5113440,15870
"11249","ENSGALG00000031768","20",11647186,11658920,11734
"11250","ENSGALG00000031776","26",1900570,1977064,76494
"11251","ENSGALG00000031786","2",51589935,51620997,31062
"11252","ENSGALG00000031789","22",4038737,4050132,11395
"11253","ENSGALG00000031791","AADN05001465.1",2501,8496,5995
"11254","ENSGALG00000031794","Z",27685252,27700855,15603
"11255","ENSGALG00000031795","1",113996679,114004370,7691
"11256","ENSGALG00000031796","7",17080551,17110805,30254
"11257","ENSGALG00000031797","12",11888869,11890055,1186
"11258","ENSGALG00000031799","12",10567244,10582527,15283
"11259","ENSGALG00000031804","2",174543,175543,1000
"11260","ENSGALG00000031807","26",5096691,5103540,6849
"11261","ENSGALG00000031812","25",448788,451712,2924
"11262","ENSGALG00000031813","27",7181846,7191800,9954
"11263","ENSGALG00000031821","15",11722028,11727568,5540
"11264","ENSGALG00000031824","30",1168962,1176486,7524
"11265","ENSGALG00000031826","13",15119631,15132751,13120
"11266","ENSGALG00000031832","22",3034645,3047948,13303
"11267","ENSGALG00000031835","2",111010166,111029857,19691
"11268","ENSGALG00000031836","1",89083713,89274189,190476
"11269","ENSGALG00000031839","30",276665,280766,4101
"11270","ENSGALG00000031841","14",12836114,12860420,24306
"11271","ENSGALG00000031843","3",58109966,58167330,57364
"11272","ENSGALG00000031850","21",2643680,2648144,4464
"11273","ENSGALG00000031851","11",6592615,6627442,34827
"11274","ENSGALG00000031853","10",8432355,8432771,416
"11275","ENSGALG00000031859","4",77421793,77422754,961
"11276","ENSGALG00000031860","2",115083826,115099513,15687
"11277","ENSGALG00000031862","5",47979726,48071473,91747
"11278","ENSGALG00000031863","2",115267098,115271033,3935
"11279","ENSGALG00000031866","6",1616246,1623255,7009
"11280","ENSGALG00000031869","2",110575597,110697739,122142
"11281","ENSGALG00000031872","21",4912755,4915107,2352
"11282","ENSGALG00000031874","1",48151569,48152313,744
"11283","ENSGALG00000031876","3",478704,480667,1963
"11284","ENSGALG00000031890","1",79075430,79099949,24519
"11285","ENSGALG00000031893","2",49840373,49868304,27931
"11286","ENSGALG00000031894","21",4850781,4851888,1107
"11287","ENSGALG00000031895","18",9012993,9054883,41890
"11288","ENSGALG00000031896","11",17637205,17650300,13095
"11289","ENSGALG00000031900","15",6900405,6902056,1651
"11290","ENSGALG00000031901","25",3211210,3211964,754
"11291","ENSGALG00000031906","20",1334803,1358921,24118
"11292","ENSGALG00000031916","5",264555,268945,4390
"11293","ENSGALG00000031917","2",22533864,22614984,81120
"11294","ENSGALG00000031918","19",4622127,4626219,4092
"11295","ENSGALG00000031920","2",66892969,66897037,4068
"11296","ENSGALG00000031922","1",15848575,15860199,11624
"11297","ENSGALG00000031928","5",39473855,39531939,58084
"11298","ENSGALG00000031929","9",17771710,17887810,116100
"11299","ENSGALG00000031932","1",111540937,111555286,14349
"11300","ENSGALG00000031934","1",25316566,25342793,26227
"11301","ENSGALG00000031940","33",5538238,5540261,2023
"11302","ENSGALG00000031942","9",5151263,5151304,41
"11303","ENSGALG00000031947","2",75831410,75998658,167248
"11304","ENSGALG00000031958","33",6994057,7000389,6332
"11305","ENSGALG00000031960","4",37872665,37926777,54112
"11306","ENSGALG00000031966","5",55398603,55405966,7363
"11307","ENSGALG00000031971","2",53559937,54180710,620773
"11308","ENSGALG00000031973","33",6965630,6981019,15389
"11309","ENSGALG00000031974","27",3518937,3523069,4132
"11310","ENSGALG00000031975","1",1491840,1533752,41912
"11311","ENSGALG00000031977","1",51652325,51698867,46542
"11312","ENSGALG00000031978","2",49030132,49126360,96228
"11313","ENSGALG00000031982","15",678727,684344,5617
"11314","ENSGALG00000031983","11",15799465,15809344,9879
"11315","ENSGALG00000031987","10",9192218,9282305,90087
"11316","ENSGALG00000031991","Z",20606613,20610669,4056
"11317","ENSGALG00000031996","33",4119838,4126449,6611
"11318","ENSGALG00000031997","2",46095977,46105425,9448
"11319","ENSGALG00000032002","4",37708385,37711694,3309
"11320","ENSGALG00000032003","9",22340712,22340805,93
"11321","ENSGALG00000032004","33",4972497,4977693,5196
"11322","ENSGALG00000032011","KZ626833.1",387783,389099,1316
"11323","ENSGALG00000032022","2",72101114,72196923,95809
"11324","ENSGALG00000032028","1",173838414,173854684,16270
"11325","ENSGALG00000032029","3",4420800,4429440,8640
"11326","ENSGALG00000032031","2",123570466,123745959,175493
"11327","ENSGALG00000032036","1",80165233,80181262,16029
"11328","ENSGALG00000032039","7",16324760,16327333,2573
"11329","ENSGALG00000032041","31",3014597,3015686,1089
"11330","ENSGALG00000032042","2",127396674,127416687,20013
"11331","ENSGALG00000032051","5",330501,333446,2945
"11332","ENSGALG00000032052","33",7062646,7064050,1404
"11333","ENSGALG00000032053","9",6731256,6799209,67953
"11334","ENSGALG00000032057","33",6510196,6519412,9216
"11335","ENSGALG00000032059","MT",2273,2345,72
"11336","ENSGALG00000032060","21",629761,633043,3282
"11337","ENSGALG00000032061","Z",1753936,1756904,2968
"11338","ENSGALG00000032066","Z",59619650,59684887,65237
"11339","ENSGALG00000032073","10",13322631,13341683,19052
"11340","ENSGALG00000032079","MT",14893,16035,1142
"11341","ENSGALG00000032087","2",96558292,96559269,977
"11342","ENSGALG00000032090","1",133848484,133859438,10954
"11343","ENSGALG00000032092","2",98466594,98525361,58767
"11344","ENSGALG00000032094","8",2946722,2974883,28161
"11345","ENSGALG00000032097","2",47177036,47209228,32192
"11346","ENSGALG00000032098","8",20688080,20690861,2781
"11347","ENSGALG00000032108","24",3817531,3820521,2990
"11348","ENSGALG00000032111","9",15434727,15434795,68
"11349","ENSGALG00000032123","9",15313549,15313670,121
"11350","ENSGALG00000032125","5",50565840,50574531,8691
"11351","ENSGALG00000032131","2",47005500,47019659,14159
"11352","ENSGALG00000032142","MT",6645,8192,1547
"11353","ENSGALG00000032143","11",16909051,16934252,25201
"11354","ENSGALG00000032145","13",10815875,10817473,1598
"11355","ENSGALG00000032146","22",3876048,3897181,21133
"11356","ENSGALG00000032148","13",14243238,14260009,16771
"11357","ENSGALG00000032149","27",6530426,6537350,6924
"11358","ENSGALG00000032156","1",20464869,20488213,23344
"11359","ENSGALG00000032159","1",60884484,60885686,1202
"11360","ENSGALG00000032161","5",9744885,9778936,34051
"11361","ENSGALG00000032170","17",869297,871747,2450
"11362","ENSGALG00000032173","8",4701721,4719776,18055
"11363","ENSGALG00000032178","18",711826,800104,88278
"11364","ENSGALG00000032181","5",23544732,23622789,78057
"11365","ENSGALG00000032184","2",900452,906269,5817
"11366","ENSGALG00000032190","26",32473,39771,7298
"11367","ENSGALG00000032191","27",7858438,7865156,6718
"11368","ENSGALG00000032199","23",2209380,2218299,8919
"11369","ENSGALG00000032206","6",23264058,23264618,560
"11370","ENSGALG00000032207","23",269671,272909,3238
"11371","ENSGALG00000032215","10",2867525,2872682,5157
"11372","ENSGALG00000032219","KZ626839.1",490691,511711,21020
"11373","ENSGALG00000032220","19",943341,962273,18932
"11374","ENSGALG00000032223","32",282945,287424,4479
"11375","ENSGALG00000032231","16",2609635,2624278,14643
"11376","ENSGALG00000032234","6",21783366,21806151,22785
"11377","ENSGALG00000032239","5",1225084,1232835,7751
"11378","ENSGALG00000032247","1",81030190,81054213,24023
"11379","ENSGALG00000032249","5",559555,562395,2840
"11380","ENSGALG00000032250","33",6962507,6964561,2054
"11381","ENSGALG00000032257","1",50927995,50948440,20445
"11382","ENSGALG00000032259","3",25943217,25946344,3127
"11383","ENSGALG00000032260","24",5431090,5435123,4033
"11384","ENSGALG00000032270","22",3971808,3982438,10630
"11385","ENSGALG00000032273","3",16112592,16128910,16318
"11386","ENSGALG00000032278","8",4099583,4171618,72035
"11387","ENSGALG00000032280","19",3584186,3592527,8341
"11388","ENSGALG00000032282","2",124313161,124331362,18201
"11389","ENSGALG00000032287","15",5600483,5641499,41016
"11390","ENSGALG00000032289","6",32387130,32455794,68664
"11391","ENSGALG00000032296","3",63325657,63329062,3405
"11392","ENSGALG00000032298","3",22198898,22205075,6177
"11393","ENSGALG00000032305","27",5975588,5987591,12003
"11394","ENSGALG00000032307","33",3399045,3403944,4899
"11395","ENSGALG00000032308","6",14860666,15164432,303766
"11396","ENSGALG00000032311","22",119344,121193,1849
"11397","ENSGALG00000032313","1",50897173,50902317,5144
"11398","ENSGALG00000032315","12",9724102,9735561,11459
"11399","ENSGALG00000032316","2",42576015,42583429,7414
"11400","ENSGALG00000032319","8",14338839,14348894,10055
"11401","ENSGALG00000032320","5",673471,682120,8649
"11402","ENSGALG00000032329","6",23660511,23663708,3197
"11403","ENSGALG00000032335","23",5269045,5270797,1752
"11404","ENSGALG00000032336","18",9892751,9898217,5466
"11405","ENSGALG00000032338","9",16061948,16062024,76
"11406","ENSGALG00000032342","17",5757926,5770107,12181
"11407","ENSGALG00000032348","16",2660430,2661524,1094
"11408","ENSGALG00000032349","11",11518646,11547898,29252
"11409","ENSGALG00000032352","20",12553717,12553941,224
"11410","ENSGALG00000032359","1",114040831,114046018,5187
"11411","ENSGALG00000032361","1",80274239,80460066,185827
"11412","ENSGALG00000032363","2",46196971,46214555,17584
"11413","ENSGALG00000032365","11",10310202,10315738,5536
"11414","ENSGALG00000032366","10",17440756,17515525,74769
"11415","ENSGALG00000032370","MT",16039,16107,68
"11416","ENSGALG00000032371","8",269466,270926,1460
"11417","ENSGALG00000032372","5",7654194,7673796,19602
"11418","ENSGALG00000032373","6",32138744,32170025,31281
"11419","ENSGALG00000032375","4",91044880,91044950,70
"11420","ENSGALG00000032382","2",42275736,42283282,7546
"11421","ENSGALG00000032384","4",76352550,76363425,10875
"11422","ENSGALG00000032385","KZ626836.1",263831,268323,4492
"11423","ENSGALG00000032386","4",32762154,32837984,75830
"11424","ENSGALG00000032387","12",18902716,18903077,361
"11425","ENSGALG00000032398","8",2987284,3025151,37867
"11426","ENSGALG00000032400","2",135510776,135515223,4447
"11427","ENSGALG00000032402","11",8324532,8326905,2373
"11428","ENSGALG00000032403","25",3293488,3294274,786
"11429","ENSGALG00000032404","18",609685,626955,17270
"11430","ENSGALG00000032405","16",1729257,1745689,16432
"11431","ENSGALG00000032409","3",57927426,57946554,19128
"11432","ENSGALG00000032410","11",18525292,18544326,19034
"11433","ENSGALG00000032413","21",1976366,1999141,22775
"11434","ENSGALG00000032415","15",7396827,7423399,26572
"11435","ENSGALG00000032417","20",698847,715964,17117
"11436","ENSGALG00000032418","14",6793587,6812759,19172
"11437","ENSGALG00000032419","4",558434,599298,40864
"11438","ENSGALG00000032420","24",59463,64835,5372
"11439","ENSGALG00000032428","11",8389347,8396105,6758
"11440","ENSGALG00000032430","1",146550352,146587988,37636
"11441","ENSGALG00000032440","3",33691214,33705352,14138
"11442","ENSGALG00000032452","18",207371,310620,103249
"11443","ENSGALG00000032453","2",121340221,121344668,4447
"11444","ENSGALG00000032456","MT",8331,9014,683
"11445","ENSGALG00000032458","1",387716,392295,4579
"11446","ENSGALG00000032465","MT",9085,9249,164
"11447","ENSGALG00000032467","24",6229478,6236297,6819
"11448","ENSGALG00000032468","3",104430412,104436337,5925
"11449","ENSGALG00000032469","28",3019600,3031885,12285
"11450","ENSGALG00000032489","30",395953,400436,4483
"11451","ENSGALG00000032496","5",1847182,1851872,4690
"11452","ENSGALG00000032499","1",195634141,195636411,2270
"11453","ENSGALG00000032501","22",1611516,1620097,8581
"11454","ENSGALG00000032502","5",12693358,12712111,18753
"11455","ENSGALG00000032506","2",125926904,125935308,8404
"11456","ENSGALG00000032518","2",128779644,128829568,49924
"11457","ENSGALG00000032526","9",16457646,16473512,15866
"11458","ENSGALG00000032529","3",9215963,9237768,21805
"11459","ENSGALG00000032530","4",1634846,1637992,3146
"11460","ENSGALG00000032534","2",2173497,2346313,172816
"11461","ENSGALG00000032541","3",44112334,44134882,22548
"11462","ENSGALG00000032544","2",57814628,57824901,10273
"11463","ENSGALG00000032545","4",46797201,46798328,1127
"11464","ENSGALG00000032546","10",10503515,10521391,17876
"11465","ENSGALG00000032549","8",29988144,29991956,3812
"11466","ENSGALG00000032552","20",474770,478613,3843
"11467","ENSGALG00000032554","2",20120548,20125233,4685
"11468","ENSGALG00000032558","5",10855015,10936272,81257
"11469","ENSGALG00000032563","5",56391533,56427632,36099
"11470","ENSGALG00000032565","5",18651720,18657935,6215
"11471","ENSGALG00000032567","13",11304657,11306751,2094
"11472","ENSGALG00000032570","2",51744318,51778751,34433
"11473","ENSGALG00000032577","9",20136600,20436791,300191
"11474","ENSGALG00000032584","5",22046823,22071211,24388
"11475","ENSGALG00000032585","33",6895958,6896030,72
"11476","ENSGALG00000032588","14",4766374,4772041,5667
"11477","ENSGALG00000032590","14",7952787,7968427,15640
"11478","ENSGALG00000032592","2",21707589,21709626,2037
"11479","ENSGALG00000032595","1",56918175,56918981,806
"11480","ENSGALG00000032598","33",6846579,6855524,8945
"11481","ENSGALG00000032599","1",77755770,77781779,26009
"11482","ENSGALG00000032606","33",7432548,7433412,864
"11483","ENSGALG00000032610","27",7777863,7781732,3869
"11484","ENSGALG00000032614","1",196989275,196990942,1667
"11485","ENSGALG00000032618","6",26933849,26942958,9109
"11486","ENSGALG00000032619","26",1220863,1226254,5391
"11487","ENSGALG00000032627","17",8389052,8392671,3619
"11488","ENSGALG00000032628","27",6683855,6736329,52474
"11489","ENSGALG00000032632","7",26482244,26538765,56521
"11490","ENSGALG00000032634","11",431054,437662,6608
"11491","ENSGALG00000032638","3",50966932,50992353,25421
"11492","ENSGALG00000032640","3",32394497,32555854,161357
"11493","ENSGALG00000032642","2",830721,889591,58870
"11494","ENSGALG00000032644","KZ626836.1",235536,250933,15397
"11495","ENSGALG00000032645","1",48169497,48170081,584
"11496","ENSGALG00000032647","2",44615726,44749055,133329
"11497","ENSGALG00000032651","2",139107006,139121795,14789
"11498","ENSGALG00000032652","19",827968,828074,106
"11499","ENSGALG00000032658","27",3775310,3882647,107337
"11500","ENSGALG00000032659","1",19001040,19019216,18176
"11501","ENSGALG00000032660","1",106645075,106653536,8461
"11502","ENSGALG00000032664","13",16558683,16567580,8897
"11503","ENSGALG00000032672","33",5260250,5267112,6862
"11504","ENSGALG00000032679","11",15410692,15418047,7355
"11505","ENSGALG00000032681","1",191554511,191595817,41306
"11506","ENSGALG00000032683","2",62886571,62917186,30615
"11507","ENSGALG00000032684","14",1261498,1263977,2479
"11508","ENSGALG00000032685","15",6603817,6667047,63230
"11509","ENSGALG00000032687","5",13345327,13346837,1510
"11510","ENSGALG00000032690","15",8375819,8385478,9659
"11511","ENSGALG00000032696","15",12853582,12856256,2674
"11512","ENSGALG00000032699","33",7088723,7091089,2366
"11513","ENSGALG00000032701","2",118035819,118043555,7736
"11514","ENSGALG00000032702","27",5594292,5609665,15373
"11515","ENSGALG00000032712","1",89812122,89812155,33
"11516","ENSGALG00000032713","5",37377807,37382222,4415
"11517","ENSGALG00000032717","19",539445,570383,30938
"11518","ENSGALG00000032718","2",127457276,127487495,30219
"11519","ENSGALG00000032723","19",6219083,6225577,6494
"11520","ENSGALG00000032730","4",91041351,91046141,4790
"11521","ENSGALG00000032732","2",138702353,138724604,22251
"11522","ENSGALG00000032734","2",138468824,138475283,6459
"11523","ENSGALG00000032736","12",9973818,10066081,92263
"11524","ENSGALG00000032737","3",107113853,107114863,1010
"11525","ENSGALG00000032740","27",6207771,6211830,4059
"11526","ENSGALG00000032743","8",5454279,5470362,16083
"11527","ENSGALG00000032746","2",136526177,136595461,69284
"11528","ENSGALG00000032749","Z",2251594,2265400,13806
"11529","ENSGALG00000032750","26",1165982,1185894,19912
"11530","ENSGALG00000032763","23",2898792,2905063,6271
"11531","ENSGALG00000032765","16",1184102,1185570,1468
"11532","ENSGALG00000032768","1",65833774,66173568,339794
"11533","ENSGALG00000032770","3",899574,945193,45619
"11534","ENSGALG00000032773","1",113588068,113610373,22305
"11535","ENSGALG00000032774","13",18202127,18205820,3693
"11536","ENSGALG00000032776","Z",479701,592143,112442
"11537","ENSGALG00000032780","3",40629526,40666062,36536
"11538","ENSGALG00000032783","9",5334604,5336762,2158
"11539","ENSGALG00000032784","7",23194583,23204488,9905
"11540","ENSGALG00000032789","3",77240681,77263108,22427
"11541","ENSGALG00000032799","3",37816238,37820310,4072
"11542","ENSGALG00000032803","5",120674,122219,1545
"11543","ENSGALG00000032808","1",167247673,167276432,28759
"11544","ENSGALG00000032815","30",1094276,1107489,13213
"11545","ENSGALG00000032816","19",2983674,2987149,3475
"11546","ENSGALG00000032819","33",6997854,7006369,8515
"11547","ENSGALG00000032820","KZ626833.1",439713,567684,127971
"11548","ENSGALG00000032828","12",11885120,11885762,642
"11549","ENSGALG00000032830","2",46848093,46920608,72515
"11550","ENSGALG00000032832","21",4915877,4924567,8690
"11551","ENSGALG00000032836","1",112544502,112593382,48880
"11552","ENSGALG00000032838","6",9941677,9943868,2191
"11553","ENSGALG00000032840","3",38081417,38095847,14430
"11554","ENSGALG00000032841","2",94650692,94652536,1844
"11555","ENSGALG00000032843","33",7355723,7362680,6957
"11556","ENSGALG00000032845","2",185940,192393,6453
"11557","ENSGALG00000032847","25",2617131,2622609,5478
"11558","ENSGALG00000032850","2",127559850,127697598,137748
"11559","ENSGALG00000032852","3",107124474,107124973,499
"11560","ENSGALG00000032854","30",397120,399963,2843
"11561","ENSGALG00000032856","22",1714010,1734922,20912
"11562","ENSGALG00000032858","10",8465873,8475192,9319
"11563","ENSGALG00000032862","31",1951591,1952331,740
"11564","ENSGALG00000032863","3",8135042,8156712,21670
"11565","ENSGALG00000032868","1",1354962,1392842,37880
"11566","ENSGALG00000032875","28",3135591,3138048,2457
"11567","ENSGALG00000032882","1",106296563,106332939,36376
"11568","ENSGALG00000032887","31",5686719,5688541,1822
"11569","ENSGALG00000032889","18",9716580,9743410,26830
"11570","ENSGALG00000032893","26",1135370,1139505,4135
"11571","ENSGALG00000032903","5",17264187,17267580,3393
"11572","ENSGALG00000032914","2",126144580,126149290,4710
"11573","ENSGALG00000032915","7",22076940,22080290,3350
"11574","ENSGALG00000032916","15",8136784,8146875,10091
"11575","ENSGALG00000032922","26",1266391,1268447,2056
"11576","ENSGALG00000032925","23",4144405,4200815,56410
"11577","ENSGALG00000032930","9",15430541,15437975,7434
"11578","ENSGALG00000032937","3",91025897,91114765,88868
"11579","ENSGALG00000032941","3",106366798,106369785,2987
"11580","ENSGALG00000032955","25",400616,413399,12783
"11581","ENSGALG00000032957","4",29195831,29198493,2662
"11582","ENSGALG00000032958","2",49138836,49243786,104950
"11583","ENSGALG00000032964","3",3773453,3787531,14078
"11584","ENSGALG00000032974","13",14367414,14532703,165289
"11585","ENSGALG00000032975","2",79827645,79844144,16499
"11586","ENSGALG00000032978","1",1849044,1852908,3864
"11587","ENSGALG00000032980","23",4578052,4585150,7098
"11588","ENSGALG00000032984","10",12210959,12214007,3048
"11589","ENSGALG00000032986","1",24695865,24779958,84093
"11590","ENSGALG00000032988","5",1132931,1136917,3986
"11591","ENSGALG00000032992","13",18099574,18198040,98466
"11592","ENSGALG00000032993","27",4112494,4119316,6822
"11593","ENSGALG00000032994","2",110517253,110518918,1665
"11594","ENSGALG00000032997","2",101038793,101069808,31015
"11595","ENSGALG00000033001","14",4796009,4797562,1553
"11596","ENSGALG00000033002","4",2420962,2435623,14661
"11597","ENSGALG00000033009","5",24233124,24234390,1266
"11598","ENSGALG00000033012","13",17915699,17926509,10810
"11599","ENSGALG00000033014","22",3807124,3811864,4740
"11600","ENSGALG00000033017","7",226649,230837,4188
"11601","ENSGALG00000033025","12",16797267,16828199,30932
"11602","ENSGALG00000033033","3",109861619,109874229,12610
"11603","ENSGALG00000033034","21",4227199,4229664,2465
"11604","ENSGALG00000033036","AADN05001263.1",698,4650,3952
"11605","ENSGALG00000033038","2",45981247,46001437,20190
"11606","ENSGALG00000033039","17",5255485,5264795,9310
"11607","ENSGALG00000033051","1",6924409,7137720,213311
"11608","ENSGALG00000033054","2",103033379,103048687,15308
"11609","ENSGALG00000033055","5",10986580,11319241,332661
"11610","ENSGALG00000033058","2",306562,316269,9707
"11611","ENSGALG00000033061","22",5231576,5248343,16767
"11612","ENSGALG00000033062","9",15494956,15525201,30245
"11613","ENSGALG00000033063","11",17631261,17634750,3489
"11614","ENSGALG00000033064","24",5580358,5594291,13933
"11615","ENSGALG00000033068","11",323349,350122,26773
"11616","ENSGALG00000033074","1",30872872,30977443,104571
"11617","ENSGALG00000033075","4",91043518,91043649,131
"11618","ENSGALG00000033077","8",11257067,11277947,20880
"11619","ENSGALG00000033079","23",3411433,3421791,10358
"11620","ENSGALG00000033082","15",703549,703644,95
"11621","ENSGALG00000033083","4",85314167,85334055,19888
"11622","ENSGALG00000033087","7",7937367,7974968,37601
"11623","ENSGALG00000033089","2",126206530,126249421,42891
"11624","ENSGALG00000033090","33",7324160,7351020,26860
"11625","ENSGALG00000033091","2",124950602,125056942,106340
"11626","ENSGALG00000033092","22",3666803,3671212,4409
"11627","ENSGALG00000033093","21",4432087,4444598,12511
"11628","ENSGALG00000033094","28",1946200,1954967,8767
"11629","ENSGALG00000033098","Z",13273506,13276740,3234
"11630","ENSGALG00000033099","5",46671242,46711072,39830
"11631","ENSGALG00000033102","2",48965796,49016357,50561
"11632","ENSGALG00000033106","1",42888363,42945679,57316
"11633","ENSGALG00000033110","10",3153960,3157345,3385
"11634","ENSGALG00000033118","2",149289749,149300056,10307
"11635","ENSGALG00000033120","3",16639900,16647178,7278
"11636","ENSGALG00000033123","30",137877,145894,8017
"11637","ENSGALG00000033126","15",1582715,1593688,10973
"11638","ENSGALG00000033129","3",25092240,25094448,2208
"11639","ENSGALG00000033137","11",16763730,16776095,12365
"11640","ENSGALG00000033138","21",6447139,6456691,9552
"11641","ENSGALG00000033139","MT",6434,6506,72
"11642","ENSGALG00000033140","3",15469829,15471622,1793
"11643","ENSGALG00000033143","3",104475727,104477670,1943
"11644","ENSGALG00000033144","2",136385091,136405869,20778
"11645","ENSGALG00000033148","13",13615870,13624983,9113
"11646","ENSGALG00000033149","1",1103223,1108108,4885
"11647","ENSGALG00000033150","28",3146467,3172684,26217
"11648","ENSGALG00000033154","27",6151929,6153522,1593
"11649","ENSGALG00000033156","5",19295930,19313108,17178
"11650","ENSGALG00000033157","28",1861080,1896528,35448
"11651","ENSGALG00000033162","27",7122029,7127087,5058
"11652","ENSGALG00000033170","2",66990175,67383301,393126
"11653","ENSGALG00000033171","2",43102691,43113228,10537
"11654","ENSGALG00000033174","31",5654354,5657551,3197
"11655","ENSGALG00000033178","2",11821968,11830930,8962
"11656","ENSGALG00000033179","2",55933772,55966769,32997
"11657","ENSGALG00000033183","4",10644261,10711020,66759
"11658","ENSGALG00000033185","30",271207,272962,1755
"11659","ENSGALG00000033186","1",80695646,80706829,11183
"11660","ENSGALG00000033195","9",4590676,4607425,16749
"11661","ENSGALG00000033196","20",1668652,1681082,12430
"11662","ENSGALG00000033198","10",9286269,9316180,29911
"11663","ENSGALG00000033199","1",106676341,106692460,16119
"11664","ENSGALG00000033203","3",104507216,104512142,4926
"11665","ENSGALG00000033204","21",4680512,4684386,3874
"11666","ENSGALG00000033205","2",141692967,141740812,47845
"11667","ENSGALG00000033206","3",38297249,38300698,3449
"11668","ENSGALG00000033207","2",32837139,32919855,82716
"11669","ENSGALG00000033212","5",49673894,49685640,11746
"11670","ENSGALG00000033213","25",2230728,2231473,745
"11671","ENSGALG00000033220","4",264965,265064,99
"11672","ENSGALG00000033226","1",7825021,7888297,63276
"11673","ENSGALG00000033231","33",5826668,5834642,7974
"11674","ENSGALG00000033232","13",10817553,10823089,5536
"11675","ENSGALG00000033234","28",3422187,3433690,11503
"11676","ENSGALG00000033244","8",4915033,4976086,61053
"11677","ENSGALG00000033245","26",40921,44364,3443
"11678","ENSGALG00000033246","33",7221074,7224395,3321
"11679","ENSGALG00000033247","2",105579856,105581184,1328
"11680","ENSGALG00000033254","2",128297877,128312145,14268
"11681","ENSGALG00000033256","Z",37074185,37334639,260454
"11682","ENSGALG00000033259","5",28513728,28530404,16676
"11683","ENSGALG00000033260","4",85384333,85405148,20815
"11684","ENSGALG00000033270","28",3952631,3966017,13386
"11685","ENSGALG00000033271","33",7260322,7265353,5031
"11686","ENSGALG00000033277","12",3371417,3379046,7629
"11687","ENSGALG00000033278","14",13150266,13163527,13261
"11688","ENSGALG00000033279","Z",921298,923007,1709
"11689","ENSGALG00000033282","6",35257619,35260427,2808
"11690","ENSGALG00000033285","6",31941903,31969971,28068
"11691","ENSGALG00000033286","4",56443111,56482183,39072
"11692","ENSGALG00000033288","3",39967417,39968957,1540
"11693","ENSGALG00000033293","21",2384332,2446767,62435
"11694","ENSGALG00000033295","1",25223560,25231414,7854
"11695","ENSGALG00000033300","5",217280,222627,5347
"11696","ENSGALG00000033301","12",2643330,2691882,48552
"11697","ENSGALG00000033303","12",2905813,2909869,4056
"11698","ENSGALG00000033304","2",115139370,115162145,22775
"11699","ENSGALG00000033311","4",43386543,43396842,10299
"11700","ENSGALG00000033314","19",267870,272209,4339
"11701","ENSGALG00000033320","19",28899,199245,170346
"11702","ENSGALG00000033322","11",17367125,17381032,13907
"11703","ENSGALG00000033328","8",4465927,4530748,64821
"11704","ENSGALG00000033332","13",11166412,11169975,3563
"11705","ENSGALG00000033337","20",1422870,1422943,73
"11706","ENSGALG00000033338","11",7736012,7757979,21967
"11707","ENSGALG00000033339","33",3231989,3234142,2153
"11708","ENSGALG00000033340","21",212446,225700,13254
"11709","ENSGALG00000033351","2",129289492,129293860,4368
"11710","ENSGALG00000033353","Z",3471974,3658288,186314
"11711","ENSGALG00000033356","22",5346579,5348434,1855
"11712","ENSGALG00000033365","10",17875706,17910716,35010
"11713","ENSGALG00000033369","17",7510998,7513154,2156
"11714","ENSGALG00000033375","31",5913396,5916508,3112
"11715","ENSGALG00000033376","18",7441139,7448075,6936
"11716","ENSGALG00000033378","11",4976046,4988616,12570
"11717","ENSGALG00000033379","2",41331321,41350778,19457
"11718","ENSGALG00000033381","33",5348560,5351881,3321
"11719","ENSGALG00000033385","7",4967431,4976701,9270
"11720","ENSGALG00000033386","5",125372,126444,1072
"11721","ENSGALG00000033391","10",3800164,3803610,3446
"11722","ENSGALG00000033397","2",122905923,122915406,9483
"11723","ENSGALG00000033402","33",6895177,6895251,74
"11724","ENSGALG00000033404","33",7203263,7213958,10695
"11725","ENSGALG00000033405","13",10862418,10871777,9359
"11726","ENSGALG00000033407","8",8616647,8821232,204585
"11727","ENSGALG00000033408","Z",1392967,1495024,102057
"11728","ENSGALG00000033411","13",9045811,9048898,3087
"11729","ENSGALG00000033415","1",27017923,27035441,17518
"11730","ENSGALG00000033416","15",535526,604454,68928
"11731","ENSGALG00000033417","2",467007,502923,35916
"11732","ENSGALG00000033419","Z",76027214,76092402,65188
"11733","ENSGALG00000033428","2",122624567,122638462,13895
"11734","ENSGALG00000033432","1",81203444,81204741,1297
"11735","ENSGALG00000033439","2",116484466,116494659,10193
"11736","ENSGALG00000033441","33",5778644,5779174,530
"11737","ENSGALG00000033446","22",4031597,4032286,689
"11738","ENSGALG00000033447","22",4016011,4022377,6366
"11739","ENSGALG00000033452","7",22241867,22254632,12765
"11740","ENSGALG00000033453","2",139795075,139828980,33905
"11741","ENSGALG00000033460","8",5866469,5885446,18977
"11742","ENSGALG00000033461","7",31212705,31221718,9013
"11743","ENSGALG00000033462","MT",8124,8258,134
"11744","ENSGALG00000033463","AADN05001243.1",21,3594,3573
"11745","ENSGALG00000033469","23",1803534,1830587,27053
"11746","ENSGALG00000033470","4",74457009,74485585,28576
"11747","ENSGALG00000033471","1",62359691,62455538,95847
"11748","ENSGALG00000033484","4",85405305,85411604,6299
"11749","ENSGALG00000033489","1",195752282,195758036,5754
"11750","ENSGALG00000033497","26",4844099,4882420,38321
"11751","ENSGALG00000033498","5",16172352,16180740,8388
"11752","ENSGALG00000033499","3",53363536,53411837,48301
"11753","ENSGALG00000033500","2",44772953,44803244,30291
"11754","ENSGALG00000033507","11",15678088,15728004,49916
"11755","ENSGALG00000033510","33",7045208,7062029,16821
"11756","ENSGALG00000033512","13",10151257,10183669,32412
"11757","ENSGALG00000033513","28",3997087,4031848,34761
"11758","ENSGALG00000033515","7",22030366,22048976,18610
"11759","ENSGALG00000033517","5",38034850,38053777,18927
"11760","ENSGALG00000033520","2",129825673,129834748,9075
"11761","ENSGALG00000033521","2",79210863,79217888,7025
"11762","ENSGALG00000033522","27",7896286,7900911,4625
"11763","ENSGALG00000033526","15",695856,695976,120
"11764","ENSGALG00000033529","12",11855728,11874815,19087
"11765","ENSGALG00000033530","27",3973878,3978712,4834
"11766","ENSGALG00000033532","30",417783,422740,4957
"11767","ENSGALG00000033535","8",5981547,5987489,5942
"11768","ENSGALG00000033541","1",124929946,125232394,302448
"11769","ENSGALG00000033557","10",20363519,20369576,6057
"11770","ENSGALG00000033558","Z",37344034,37348214,4180
"11771","ENSGALG00000033561","2",27388794,27720368,331574
"11772","ENSGALG00000033566","10",16352045,16377454,25409
"11773","ENSGALG00000033567","3",4352906,4354031,1125
"11774","ENSGALG00000033568","2",118027530,118031704,4174
"11775","ENSGALG00000033569","21",508552,539804,31252
"11776","ENSGALG00000033570","24",252913,269196,16283
"11777","ENSGALG00000033572","26",1199219,1210535,11316
"11778","ENSGALG00000033573","26",5447786,5451967,4181
"11779","ENSGALG00000033575","3",104437575,104440741,3166
"11780","ENSGALG00000033577","AADN05001319.1",12776,13874,1098
"11781","ENSGALG00000033579","3",99105783,99208450,102667
"11782","ENSGALG00000033589","1",53021721,53223751,202030
"11783","ENSGALG00000033591","13",4215241,4225180,9939
"11784","ENSGALG00000033593","2",36805788,37055784,249996
"11785","ENSGALG00000033597","17",7205751,7218582,12831
"11786","ENSGALG00000033598","15",928866,956965,28099
"11787","ENSGALG00000033599","4",82811172,82811234,62
"11788","ENSGALG00000033603","14",10511222,10519988,8766
"11789","ENSGALG00000033604","9",15771814,15771904,90
"11790","ENSGALG00000033608","2",98873968,98897463,23495
"11791","ENSGALG00000033609","33",6876344,6886461,10117
"11792","ENSGALG00000033614","33",5630143,5641609,11466
"11793","ENSGALG00000033618","10",1858212,2010750,152538
"11794","ENSGALG00000033619","1",137725174,137735180,10006
"11795","ENSGALG00000033622","2",148900799,148901276,477
"11796","ENSGALG00000033626","2",149327378,149342545,15167
"11797","ENSGALG00000033630","2",129872670,129924271,51601
"11798","ENSGALG00000033631","2",139734098,139738744,4646
"11799","ENSGALG00000033634","8",6501698,6514705,13007
"11800","ENSGALG00000033635","8",10713267,10722126,8859
"11801","ENSGALG00000033638","2",124712148,124778783,66635
"11802","ENSGALG00000033639","15",10695613,10699192,3579
"11803","ENSGALG00000033641","13",1900625,2052540,151915
"11804","ENSGALG00000033647","5",36213359,36218028,4669
"11805","ENSGALG00000033653","25",3540966,3548428,7462
"11806","ENSGALG00000033656","4",90893195,90900224,7029
"11807","ENSGALG00000033660","24",1532447,1565663,33216
"11808","ENSGALG00000033663","22",1892937,1902337,9400
"11809","ENSGALG00000033664","1",20276230,20312309,36079
"11810","ENSGALG00000033666","13",10806496,10808329,1833
"11811","ENSGALG00000033671","1",172661162,172776030,114868
"11812","ENSGALG00000033675","5",1072537,1085377,12840
"11813","ENSGALG00000033677","20",1530286,1555018,24732
"11814","ENSGALG00000033678","17",2354126,2451108,96982
"11815","ENSGALG00000033683","27",6034509,6040276,5767
"11816","ENSGALG00000033690","14",509591,515418,5827
"11817","ENSGALG00000033694","28",4098288,4100719,2431
"11818","ENSGALG00000033695","6",21525301,21528367,3066
"11819","ENSGALG00000033696","20",1689083,1801951,112868
"11820","ENSGALG00000033698","2",43559727,43594328,34601
"11821","ENSGALG00000033700","2",122678180,122689749,11569
"11822","ENSGALG00000033701","2",132483774,132498269,14495
"11823","ENSGALG00000033705","W",3607613,3662450,54837
"11824","ENSGALG00000033709","1",45725939,45740752,14813
"11825","ENSGALG00000033716","1",183057549,183082064,24515
"11826","ENSGALG00000033720","11",11311725,11319529,7804
"11827","ENSGALG00000033729","31",3499258,3500775,1517
"11828","ENSGALG00000033730","5",21936956,21959269,22313
"11829","ENSGALG00000033739","1",136262887,136264224,1337
"11830","ENSGALG00000033744","4",18082789,18082855,66
"11831","ENSGALG00000033752","33",2766360,2767466,1106
"11832","ENSGALG00000033753","5",19099003,19134736,35733
"11833","ENSGALG00000033754","17",7169104,7172719,3615
"11834","ENSGALG00000033758","1",119638154,119650880,12726
"11835","ENSGALG00000033759","8",28520087,28548992,28905
"11836","ENSGALG00000033760","17",5476114,5481591,5477
"11837","ENSGALG00000033766","7",15348183,15348257,74
"11838","ENSGALG00000033767","9",13852162,13855980,3818
"11839","ENSGALG00000033769","1",38115186,38116670,1484
"11840","ENSGALG00000033770","Z",52037,137423,85386
"11841","ENSGALG00000033772","1",6753645,6801597,47952
"11842","ENSGALG00000033780","10",11154128,11166446,12318
"11843","ENSGALG00000033781","5",488088,490498,2410
"11844","ENSGALG00000033783","2",138205878,138288568,82690
"11845","ENSGALG00000033786","3",17192986,17193939,953
"11846","ENSGALG00000033787","31",3774720,3775734,1014
"11847","ENSGALG00000033788","1",8040729,8040884,155
"11848","ENSGALG00000033789","1",54708818,54718953,10135
"11849","ENSGALG00000033790","10",20526224,20534706,8482
"11850","ENSGALG00000033791","33",7418420,7424048,5628
"11851","ENSGALG00000033792","19",202497,207056,4559
"11852","ENSGALG00000033806","14",8862186,8867077,4891
"11853","ENSGALG00000033807","6",12212304,12215247,2943
"11854","ENSGALG00000033811","7",22183985,22193854,9869
"11855","ENSGALG00000033813","5",52935364,52938063,2699
"11856","ENSGALG00000033816","1",155899968,155900945,977
"11857","ENSGALG00000033819","1",197559405,197563684,4279
"11858","ENSGALG00000033827","W",2117833,2119764,1931
"11859","ENSGALG00000033828","2",148887321,148890498,3177
"11860","ENSGALG00000033834","2",55539174,55554509,15335
"11861","ENSGALG00000033849","2",63385417,63397960,12543
"11862","ENSGALG00000033854","26",1287074,1293880,6806
"11863","ENSGALG00000033855","1",65337341,65349940,12599
"11864","ENSGALG00000033857","4",91064240,91068815,4575
"11865","ENSGALG00000033862","Z",593051,607663,14612
"11866","ENSGALG00000033867","30",968845,973293,4448
"11867","ENSGALG00000033877","33",3350652,3362288,11636
"11868","ENSGALG00000033879","1",34900551,34930163,29612
"11869","ENSGALG00000033880","2",118477237,118542230,64993
"11870","ENSGALG00000033883","4",71575850,71827560,251710
"11871","ENSGALG00000033884","28",1553131,1561535,8404
"11872","ENSGALG00000033885","19",9665263,9716788,51525
"11873","ENSGALG00000033887","1",61607575,61627406,19831
"11874","ENSGALG00000033888","4",91045474,91054683,9209
"11875","ENSGALG00000033889","1",79997432,80017359,19927
"11876","ENSGALG00000033894","3",4273783,4274889,1106
"11877","ENSGALG00000033901","2",37908216,37944961,36745
"11878","ENSGALG00000033902","4",39358703,39365278,6575
"11879","ENSGALG00000033908","4",66445833,66452314,6481
"11880","ENSGALG00000033919","1",458409,703182,244773
"11881","ENSGALG00000033920","17",608979,632013,23034
"11882","ENSGALG00000033925","4",83135257,83149163,13906
"11883","ENSGALG00000033926","27",6468627,6476586,7959
"11884","ENSGALG00000033927","33",7200842,7202344,1502
"11885","ENSGALG00000033932","16",2565405,2595262,29857
"11886","ENSGALG00000033938","13",17989659,18090319,100660
"11887","ENSGALG00000033941","25",452387,460153,7766
"11888","ENSGALG00000033943","8",20123832,20126561,2729
"11889","ENSGALG00000033950","2",137901055,137916461,15406
"11890","ENSGALG00000033953","4",1850541,1858865,8324
"11891","ENSGALG00000033954","19",5210558,5216526,5968
"11892","ENSGALG00000033956","13",10739324,10774389,35065
"11893","ENSGALG00000033957","33",5447898,5465635,17737
"11894","ENSGALG00000033960","2",147556277,147834791,278514
"11895","ENSGALG00000033965","1",106003474,106047070,43596
"11896","ENSGALG00000033966","1",193461898,193803700,341802
"11897","ENSGALG00000033971","28",1324567,1326492,1925
"11898","ENSGALG00000033973","5",26881176,26889527,8351
"11899","ENSGALG00000033974","1",10800773,10860504,59731
"11900","ENSGALG00000033989","22",1592652,1603593,10941
"11901","ENSGALG00000033993","20",1359815,1367201,7386
"11902","ENSGALG00000033996","18",696091,702623,6532
"11903","ENSGALG00000033997","1",21022425,21036546,14121
"11904","ENSGALG00000034000","6",30225591,30229444,3853
"11905","ENSGALG00000034001","18",9982908,10039589,56681
"11906","ENSGALG00000034003","3",38194654,38276962,82308
"11907","ENSGALG00000034004","1",197413487,197430567,17080
"11908","ENSGALG00000034005","13",2720629,2725601,4972
"11909","ENSGALG00000034007","7",17715353,17831994,116641
"11910","ENSGALG00000034009","26",1259073,1266107,7034
"11911","ENSGALG00000034011","7",292975,334171,41196
"11912","ENSGALG00000034013","6",33109088,33118538,9450
"11913","ENSGALG00000034014","24",35022,63087,28065
"11914","ENSGALG00000034016","32",466808,471728,4920
"11915","ENSGALG00000034020","22",1422776,1431392,8616
"11916","ENSGALG00000034021","10",12607096,12628542,21446
"11917","ENSGALG00000034022","MT",12934,12998,64
"11918","ENSGALG00000034024","2",30628323,30744614,116291
"11919","ENSGALG00000034025","33",5798329,5813145,14816
"11920","ENSGALG00000034029","5",18629829,18649356,19527
"11921","ENSGALG00000034030","3",57964558,58039567,75009
"11922","ENSGALG00000034040","3",31128994,31154096,25102
"11923","ENSGALG00000034042","25",2811684,2829968,18284
"11924","ENSGALG00000034044","6",21022888,21057755,34867
"11925","ENSGALG00000034048","3",1875922,1931759,55837
"11926","ENSGALG00000034050","2",127179558,127211005,31447
"11927","ENSGALG00000034054","27",7422082,7426747,4665
"11928","ENSGALG00000034065","4",83916252,83928157,11905
"11929","ENSGALG00000034067","26",5133300,5139900,6600
"11930","ENSGALG00000034069","33",7312520,7316977,4457
"11931","ENSGALG00000034070","7",18202368,18226959,24591
"11932","ENSGALG00000034076","30",1116756,1126242,9486
"11933","ENSGALG00000034077","3",29310781,29341097,30316
"11934","ENSGALG00000034078","1",54676399,54693423,17024
"11935","ENSGALG00000034081","3",35071502,35216609,145107
"11936","ENSGALG00000034083","1",107189808,107190174,366
"11937","ENSGALG00000034085","20",1160252,1181245,20993
"11938","ENSGALG00000034086","1",1006230,1014073,7843
"11939","ENSGALG00000034094","7",18254139,18255999,1860
"11940","ENSGALG00000034099","2",129172101,129193565,21464
"11941","ENSGALG00000034100","10",20049223,20076407,27184
"11942","ENSGALG00000034104","6",12152752,12167828,15076
"11943","ENSGALG00000034107","23",3365953,3371497,5544
"11944","ENSGALG00000034109","4",15743145,15884846,141701
"11945","ENSGALG00000034111","11",17392339,17395059,2720
"11946","ENSGALG00000034115","18",4949928,4961301,11373
"11947","ENSGALG00000034116","4",9895862,9901494,5632
"11948","ENSGALG00000034118","20",9380605,9384135,3530
"11949","ENSGALG00000034119","2",55820349,55923163,102814
"11950","ENSGALG00000034124","5",666668,692319,25651
"11951","ENSGALG00000034132","17",7226419,7232634,6215
"11952","ENSGALG00000034133","6",14166640,14211806,45166
"11953","ENSGALG00000034134","18",55594,58969,3375
"11954","ENSGALG00000034137","3",104519630,104520726,1096
"11955","ENSGALG00000034139","7",22192576,22192667,91
"11956","ENSGALG00000034140","3",105668513,105674399,5886
"11957","ENSGALG00000034144","5",14925899,14930919,5020
"11958","ENSGALG00000034146","1",147272815,147273159,344
"11959","ENSGALG00000034150","2",4072545,4073720,1175
"11960","ENSGALG00000034163","2",44415479,44436885,21406
"11961","ENSGALG00000034166","11",17808079,17849306,41227
"11962","ENSGALG00000034168","12",8303804,8315223,11419
"11963","ENSGALG00000034171","20",187712,255976,68264
"11964","ENSGALG00000034179","11",3481861,3534945,53084
"11965","ENSGALG00000034183","AADN05001288.1",76,23170,23094
"11966","ENSGALG00000034187","13",17685799,17723558,37759
"11967","ENSGALG00000034188","2",121112771,121187441,74670
"11968","ENSGALG00000034196","26",3495149,3506642,11493
"11969","ENSGALG00000034197","1",145728851,145731717,2866
"11970","ENSGALG00000034198","1",7248738,7263920,15182
"11971","ENSGALG00000034204","27",7412912,7417642,4730
"11972","ENSGALG00000034206","3",58099863,58109619,9756
"11973","ENSGALG00000034210","18",9342248,9461097,118849
"11974","ENSGALG00000034212","7",22324052,22340990,16938
"11975","ENSGALG00000034213","21",5453941,5467117,13176
"11976","ENSGALG00000034216","11",11442872,11451819,8947
"11977","ENSGALG00000034218","33",7035739,7044711,8972
"11978","ENSGALG00000034224","2",115110507,115125929,15422
"11979","ENSGALG00000034225","5",766241,785440,19199
"11980","ENSGALG00000034229","22",2479921,2481932,2011
"11981","ENSGALG00000034230","8",11220083,11257043,36960
"11982","ENSGALG00000034232","6",20279683,20287917,8234
"11983","ENSGALG00000034236","33",6857104,6859115,2011
"11984","ENSGALG00000034237","2",90085602,90085661,59
"11985","ENSGALG00000034244","9",16359427,16359556,129
"11986","ENSGALG00000034250","4",3594161,3693891,99730
"11987","ENSGALG00000034251","23",1975369,1994253,18884
"11988","ENSGALG00000034253","8",15007036,15055304,48268
"11989","ENSGALG00000034258","25",2885181,2888873,3692
"11990","ENSGALG00000034262","27",7851805,7855186,3381
"11991","ENSGALG00000034264","5",36329806,36367941,38135
"11992","ENSGALG00000034265","1",175938760,175941165,2405
"11993","ENSGALG00000034267","2",35103844,35127620,23776
"11994","ENSGALG00000034271","28",4931452,4945091,13639
"11995","ENSGALG00000034274","1",16089628,16136090,46462
"11996","ENSGALG00000034275","1",68517361,68520677,3316
"11997","ENSGALG00000034278","15",6912999,6930693,17694
"11998","ENSGALG00000034279","1",113826540,113830912,4372
"11999","ENSGALG00000034281","26",2046617,2067198,20581
"12000","ENSGALG00000034282","32",478107,503835,25728
"12001","ENSGALG00000034284","2",316447,325524,9077
"12002","ENSGALG00000034288","10",1671614,1672374,760
"12003","ENSGALG00000034289","12",10886479,10909611,23132
"12004","ENSGALG00000034294","2",122936917,122954777,17860
"12005","ENSGALG00000034295","3",67556766,67569292,12526
"12006","ENSGALG00000034297","19",7778745,7786908,8163
"12007","ENSGALG00000034301","8",6468993,6470862,1869
"12008","ENSGALG00000034303","3",18739694,18743264,3570
"12009","ENSGALG00000034305","13",14540431,14545143,4712
"12010","ENSGALG00000034306","33",5982748,5983859,1111
"12011","ENSGALG00000034311","5",45267540,45296772,29232
"12012","ENSGALG00000034315","2",91806228,91806391,163
"12013","ENSGALG00000034316","13",14554411,14581358,26947
"12014","ENSGALG00000034317","1",106352462,106410917,58455
"12015","ENSGALG00000034319","16",1904805,1907716,2911
"12016","ENSGALG00000034325","14",11259785,11527885,268100
"12017","ENSGALG00000034326","2",42973622,42974929,1307
"12018","ENSGALG00000034328","30",747981,756332,8351
"12019","ENSGALG00000034337","2",148431659,148455296,23637
"12020","ENSGALG00000034340","2",41622054,41669122,47068
"12021","ENSGALG00000034344","22",3867465,3874049,6584
"12022","ENSGALG00000034345","27",7870154,7870780,626
"12023","ENSGALG00000034346","2",117729843,117755436,25593
"12024","ENSGALG00000034347","26",289608,321420,31812
"12025","ENSGALG00000034348","2",138006974,138039753,32779
"12026","ENSGALG00000034349","27",7394650,7402317,7667
"12027","ENSGALG00000034351","33",3354646,3354780,134
"12028","ENSGALG00000034352","6",24041933,24042609,676
"12029","ENSGALG00000034354","5",38537213,38539497,2284
"12030","ENSGALG00000034357","13",3102700,3108614,5914
"12031","ENSGALG00000034358","22",5321205,5327645,6440
"12032","ENSGALG00000034363","7",17197115,17213069,15954
"12033","ENSGALG00000034366","1",403384,404958,1574
"12034","ENSGALG00000034369","33",347037,348047,1010
"12035","ENSGALG00000034373","11",491168,508560,17392
"12036","ENSGALG00000034374","3",56943699,56975701,32002
"12037","ENSGALG00000034376","2",120907231,120926733,19502
"12038","ENSGALG00000034377","2",135661556,135682093,20537
"12039","ENSGALG00000034380","14",12719002,12725543,6541
"12040","ENSGALG00000034383","4",2102457,2109268,6811
"12041","ENSGALG00000034392","2",149509595,149546787,37192
"12042","ENSGALG00000034395","11",13961809,13964827,3018
"12043","ENSGALG00000034396","1",106654681,106665913,11232
"12044","ENSGALG00000034397","3",57282901,57314067,31166
"12045","ENSGALG00000034399","33",7183295,7192128,8833
"12046","ENSGALG00000034406","17",8022005,8022101,96
"12047","ENSGALG00000034411","31",3420029,3421933,1904
"12048","ENSGALG00000034412","15",5648484,5659729,11245
"12049","ENSGALG00000034413","28",1538611,1551616,13005
"12050","ENSGALG00000034414","13",8542803,8553940,11137
"12051","ENSGALG00000034421","33",7267803,7281369,13566
"12052","ENSGALG00000034424","2",115289879,115308471,18592
"12053","ENSGALG00000034426","17",3686290,3688232,1942
"12054","ENSGALG00000034427","27",4047358,4076818,29460
"12055","ENSGALG00000034430","11",15361192,15370037,8845
"12056","ENSGALG00000034434","10",20466253,20469686,3433
"12057","ENSGALG00000034436","17",7073101,7078463,5362
"12058","ENSGALG00000034438","1",77917296,77922102,4806
"12059","ENSGALG00000034440","1",572202,572311,109
"12060","ENSGALG00000034453","21",2922203,2982448,60245
"12061","ENSGALG00000034456","26",5152468,5174115,21647
"12062","ENSGALG00000034458","25",3328411,3329269,858
"12063","ENSGALG00000034461","2",42590764,42613882,23118
"12064","ENSGALG00000034473","1",180569335,180612944,43609
"12065","ENSGALG00000034474","3",108694660,108706327,11667
"12066","ENSGALG00000034475","30",1010526,1018772,8246
"12067","ENSGALG00000034478","19",576608,578177,1569
"12068","ENSGALG00000034487","2",121389232,121401025,11793
"12069","ENSGALG00000034488","W",5154797,5259594,104797
"12070","ENSGALG00000034493","2",45849153,45873663,24510
"12071","ENSGALG00000034498","20",9712482,9714009,1527
"12072","ENSGALG00000034500","2",97261548,97270754,9206
"12073","ENSGALG00000034501","25",2912978,2925997,13019
"12074","ENSGALG00000034502","4",46361293,46379016,17723
"12075","ENSGALG00000034504","1",50804147,50810942,6795
"12076","ENSGALG00000034505","Z",78846780,78856728,9948
"12077","ENSGALG00000034507","9",10824480,10825763,1283
"12078","ENSGALG00000034509","20",1436200,1441694,5494
"12079","ENSGALG00000034510","4",91054483,91063630,9147
"12080","ENSGALG00000034511","1",56624328,56633715,9387
"12081","ENSGALG00000034512","9",648810,655576,6766
"12082","ENSGALG00000034516","18",1261759,1271456,9697
"12083","ENSGALG00000034527","KZ626819.1",66321,77139,10818
"12084","ENSGALG00000034528","2",136964312,137072200,107888
"12085","ENSGALG00000034533","1",13874934,13901605,26671
"12086","ENSGALG00000034534","11",9974099,9992643,18544
"12087","ENSGALG00000034536","1",137104763,137123590,18827
"12088","ENSGALG00000034548","6",32213030,32229347,16317
"12089","ENSGALG00000034549","10",8188331,8216127,27796
"12090","ENSGALG00000034550","10",7695351,7699580,4229
"12091","ENSGALG00000034552","1",38390486,38394399,3913
"12092","ENSGALG00000034560","15",10382834,10395241,12407
"12093","ENSGALG00000034561","2",115821712,115984273,162561
"12094","ENSGALG00000034562","9",15851768,15863643,11875
"12095","ENSGALG00000034564","3",72057277,72120770,63493
"12096","ENSGALG00000034572","12",519002,594617,75615
"12097","ENSGALG00000034573","2",159572,241719,82147
"12098","ENSGALG00000034574","1",24799631,24836289,36658
"12099","ENSGALG00000034575","30",1401250,1406051,4801
"12100","ENSGALG00000034580","5",57615599,57617453,1854
"12101","ENSGALG00000034584","Z",612902,742092,129190
"12102","ENSGALG00000034585","2",42556661,42572127,15466
"12103","ENSGALG00000034586","2",42300009,42312550,12541
"12104","ENSGALG00000034587","3",74612334,74832219,219885
"12105","ENSGALG00000034590","1",6143111,6513417,370306
"12106","ENSGALG00000034591","2",62112883,62119192,6309
"12107","ENSGALG00000034605","5",875773,882206,6433
"12108","ENSGALG00000034610","2",115379044,115463018,83974
"12109","ENSGALG00000034615","28",3514797,3523166,8369
"12110","ENSGALG00000034616","2",50572648,50587618,14970
"12111","ENSGALG00000034618","2",129309738,129332643,22905
"12112","ENSGALG00000034621","4",74767885,74948420,180535
"12113","ENSGALG00000034625","23",5719446,5731936,12490
"12114","ENSGALG00000034628","2",85678766,85684086,5320
"12115","ENSGALG00000034630","26",1188685,1191601,2916
"12116","ENSGALG00000034631","1",48129286,48135414,6128
"12117","ENSGALG00000034645","6",24561150,24564969,3819
"12118","ENSGALG00000034649","11",5223979,5345307,121328
"12119","ENSGALG00000034655","6",36292713,36326373,33660
"12120","ENSGALG00000034659","2",95935769,95935858,89
"12121","ENSGALG00000034661","20",10006753,10007982,1229
"12122","ENSGALG00000034671","33",6527097,6532561,5464
"12123","ENSGALG00000034673","4",80855311,80877258,21947
"12124","ENSGALG00000034675","2",116774238,116782120,7882
"12125","ENSGALG00000034684","3",33132810,33141334,8524
"12126","ENSGALG00000034688","33",6926210,6933386,7176
"12127","ENSGALG00000034689","13",1591112,1591205,93
"12128","ENSGALG00000034693","27",6774936,6812051,37115
"12129","ENSGALG00000034694","9",17502102,17502205,103
"12130","ENSGALG00000034697","KZ626827.1",54807,60401,5594
"12131","ENSGALG00000034698","1",79164856,79169339,4483
"12132","ENSGALG00000034701","33",6867525,6869862,2337
"12133","ENSGALG00000034708","1",177672597,177703974,31377
"12134","ENSGALG00000034709","4",28669625,28751964,82339
"12135","ENSGALG00000034713","17",4038886,4077699,38813
"12136","ENSGALG00000034716","3",59938390,59947701,9311
"12137","ENSGALG00000034722","4",20020334,20028633,8299
"12138","ENSGALG00000034725","30",504317,527127,22810
"12139","ENSGALG00000034735","6",3364213,3395369,31156
"12140","ENSGALG00000034737","14",13089512,13093771,4259
"12141","ENSGALG00000034741","4",37653712,37666930,13218
"12142","ENSGALG00000034742","33",5732899,5757902,25003
"12143","ENSGALG00000034747","32",189129,195670,6541
"12144","ENSGALG00000034749","9",3837546,3837578,32
"12145","ENSGALG00000034751","2",117290673,117324784,34111
"12146","ENSGALG00000034756","23",2734269,2742975,8706
"12147","ENSGALG00000034761","21",4937114,4940088,2974
"12148","ENSGALG00000034768","3",4523961,4542289,18328
"12149","ENSGALG00000034769","4",12248585,12276877,28292
"12150","ENSGALG00000034772","31",5674839,5682712,7873
"12151","ENSGALG00000034773","5",58968105,59000025,31920
"12152","ENSGALG00000034777","21",5365044,5450011,84967
"12153","ENSGALG00000034788","1",38018609,38025170,6561
"12154","ENSGALG00000034801","Z",1757627,1765532,7905
"12155","ENSGALG00000034802","5",48144128,48197477,53349
"12156","ENSGALG00000034803","2",126031779,126041077,9298
"12157","ENSGALG00000034806","2",124192826,124215149,22323
"12158","ENSGALG00000034811","5",15988312,15993624,5312
"12159","ENSGALG00000034813","MT",6508,6573,65
"12160","ENSGALG00000034821","Z",943082,962645,19563
"12161","ENSGALG00000034829","14",449210,477081,27871
"12162","ENSGALG00000034831","23",2380602,2393352,12750
"12163","ENSGALG00000034834","1",126239162,126334970,95808
"12164","ENSGALG00000034850","8",3879102,3881630,2528
"12165","ENSGALG00000034855","22",4049954,4131577,81623
"12166","ENSGALG00000034859","5",19638910,19646040,7130
"12167","ENSGALG00000034860","9",21107790,21154158,46368
"12168","ENSGALG00000034868","33",5216371,5226040,9669
"12169","ENSGALG00000034876","2",125806946,125814561,7615
"12170","ENSGALG00000034889","5",55982611,55988753,6142
"12171","ENSGALG00000034894","5",10579952,10582670,2718
"12172","ENSGALG00000034898","5",45101764,45230310,128546
"12173","ENSGALG00000034899","2",113438291,113768197,329906
"12174","ENSGALG00000034903","2",555450,559965,4515
"12175","ENSGALG00000034907","27",6226468,6229290,2822
"12176","ENSGALG00000034910","23",1891058,1902151,11093
"12177","ENSGALG00000034917","30",431986,435668,3682
"12178","ENSGALG00000034918","28",3986267,3987462,1195
"12179","ENSGALG00000034919","15",5338142,5353602,15460
"12180","ENSGALG00000034932","1",110162856,110213264,50408
"12181","ENSGALG00000034934","26",101626,102258,632
"12182","ENSGALG00000034939","5",656839,659426,2587
"12183","ENSGALG00000034944","1",133189234,133229871,40637
"12184","ENSGALG00000034948","17",719281,734578,15297
"12185","ENSGALG00000034950","11",160633,252673,92040
"12186","ENSGALG00000034952","4",52447368,52481215,33847
"12187","ENSGALG00000034955","33",3802569,3810752,8183
"12188","ENSGALG00000034960","19",365079,380126,15047
"12189","ENSGALG00000034962","12",11048700,11048801,101
"12190","ENSGALG00000034964","23",2037711,2046628,8917
"12191","ENSGALG00000034965","33",5645989,5704717,58728
"12192","ENSGALG00000034967","1",196720426,196844343,123917
"12193","ENSGALG00000034970","1",4260357,4290775,30418
"12194","ENSGALG00000034971","2",146035610,146065241,29631
"12195","ENSGALG00000034973","7",11682384,11685456,3072
"12196","ENSGALG00000034975","17",817872,821031,3159
"12197","ENSGALG00000034982","10",3014290,3018506,4216
"12198","ENSGALG00000034983","1",177395776,177399233,3457
"12199","ENSGALG00000034986","23",5629441,5635866,6425
"12200","ENSGALG00000034988","33",5486658,5490654,3996
"12201","ENSGALG00000034989","18",7450622,7589963,139341
"12202","ENSGALG00000034992","1",7410004,7438493,28489
"12203","ENSGALG00000034994","8",12961396,13078957,117561
"12204","ENSGALG00000034999","2",137983356,137985977,2621
"12205","ENSGALG00000035007","1",194252394,194279388,26994
"12206","ENSGALG00000035009","1",24533867,24566966,33099
"12207","ENSGALG00000035013","6",31607830,31641276,33446
"12208","ENSGALG00000035016","3",95853920,95856597,2677
"12209","ENSGALG00000035017","21",2682333,2709511,27178
"12210","ENSGALG00000035023","5",56658775,56665015,6240
"12211","ENSGALG00000035026","13",17526608,17541439,14831
"12212","ENSGALG00000035027","1",136264468,136266080,1612
"12213","ENSGALG00000035028","33",6827441,6840335,12894
"12214","ENSGALG00000035029","14",14621928,14630009,8081
"12215","ENSGALG00000035030","13",10772874,10782719,9845
"12216","ENSGALG00000035031","2",120664931,120667575,2644
"12217","ENSGALG00000035035","19",4488661,4494197,5536
"12218","ENSGALG00000035045","12",8795166,8824160,28994
"12219","ENSGALG00000035047","3",4388382,4391639,3257
"12220","ENSGALG00000035048","12",11293918,11306142,12224
"12221","ENSGALG00000035049","15",7145274,7150170,4896
"12222","ENSGALG00000035050","2",55319904,55333431,13527
"12223","ENSGALG00000035051","1",50411518,50559544,148026
"12224","ENSGALG00000035052","4",45457337,45471666,14329
"12225","ENSGALG00000035057","27",5745950,5749615,3665
"12226","ENSGALG00000035058","12",2991079,2994178,3099
"12227","ENSGALG00000035060","33",3412284,3412858,574
"12228","ENSGALG00000035063","3",4303092,4304030,938
"12229","ENSGALG00000035064","5",1689669,1697446,7777
"12230","ENSGALG00000035065","2",111903414,111904526,1112
"12231","ENSGALG00000035068","2",42198570,42245119,46549
"12232","ENSGALG00000035075","16",2596216,2601012,4796
"12233","ENSGALG00000035079","2",44295275,44300137,4862
"12234","ENSGALG00000035080","13",1576666,1588007,11341
"12235","ENSGALG00000035081","4",88843675,88853569,9894
"12236","ENSGALG00000035085","1",1178464,1178547,83
"12237","ENSGALG00000035086","33",7016255,7020910,4655
"12238","ENSGALG00000035094","2",125879843,125906330,26487
"12239","ENSGALG00000035099","12",18676313,18693042,16729
"12240","ENSGALG00000035100","25",3186153,3187058,905
"12241","ENSGALG00000035104","13",12838861,12839962,1101
"12242","ENSGALG00000035108","1",56677151,56731558,54407
"12243","ENSGALG00000035111","20",10088285,10089305,1020
"12244","ENSGALG00000035113","14",9457936,9465166,7230
"12245","ENSGALG00000035115","14",12803269,12809414,6145
"12246","ENSGALG00000035116","9",731617,798526,66909
"12247","ENSGALG00000035117","24",5103539,5104579,1040
"12248","ENSGALG00000035129","2",125747442,125753939,6497
"12249","ENSGALG00000035131","19",859638,866958,7320
"12250","ENSGALG00000035134","4",88659037,88674174,15137
"12251","ENSGALG00000035136","Z",66555133,66586861,31728
"12252","ENSGALG00000035137","3",32573890,32663640,89750
"12253","ENSGALG00000035138","30",1057898,1059913,2015
"12254","ENSGALG00000035140","2",26570971,26585564,14593
"12255","ENSGALG00000035152","15",6944042,6946525,2483
"12256","ENSGALG00000035153","5",238695,243213,4518
"12257","ENSGALG00000035156","4",91002966,91042364,39398
"12258","ENSGALG00000035157","1",147835785,147836627,842
"12259","ENSGALG00000035182","15",6777719,6785231,7512
"12260","ENSGALG00000035184","23",549584,568556,18972
"12261","ENSGALG00000035185","19",979982,986427,6445
"12262","ENSGALG00000035187","23",3639624,3665292,25668
"12263","ENSGALG00000035188","2",75118971,75131655,12684
"12264","ENSGALG00000035191","5",1117620,1118735,1115
"12265","ENSGALG00000035194","22",437194,453936,16742
"12266","ENSGALG00000035198","17",3489221,3492418,3197
"12267","ENSGALG00000035199","2",129063965,129086910,22945
"12268","ENSGALG00000035201","1",7970728,7981610,10882
"12269","ENSGALG00000035202","10",1820338,1830950,10612
"12270","ENSGALG00000035203","33",5465823,5468889,3066
"12271","ENSGALG00000035205","1",94132947,94189131,56184
"12272","ENSGALG00000035206","33",6953700,6955539,1839
"12273","ENSGALG00000035207","4",20868112,20906890,38778
"12274","ENSGALG00000035211","21",562589,570964,8375
"12275","ENSGALG00000035217","3",84814802,84870232,55430
"12276","ENSGALG00000035219","4",50822578,50848867,26289
"12277","ENSGALG00000035221","4",90710259,90715195,4936
"12278","ENSGALG00000035223","1",49418419,49420291,1872
"12279","ENSGALG00000035228","1",79791824,79866172,74348
"12280","ENSGALG00000035230","3",89801439,90172395,370956
"12281","ENSGALG00000035236","30",268916,271158,2242
"12282","ENSGALG00000035237","7",17346163,17429748,83585
"12283","ENSGALG00000035239","2",24891742,24943662,51920
"12284","ENSGALG00000035242","5",1191915,1220816,28901
"12285","ENSGALG00000035244","1",48117646,48118846,1200
"12286","ENSGALG00000035246","10",1484706,1490507,5801
"12287","ENSGALG00000035252","2",117723223,117730489,7266
"12288","ENSGALG00000035254","KZ626837.1",1770103,1791304,21201
"12289","ENSGALG00000035260","33",6344648,6351623,6975
"12290","ENSGALG00000035266","1",127043815,127168755,124940
"12291","ENSGALG00000035270","26",3479308,3501096,21788
"12292","ENSGALG00000035275","4",5346739,5428483,81744
"12293","ENSGALG00000035281","2",15339469,15395461,55992
"12294","ENSGALG00000035282","5",13971786,13980128,8342
"12295","ENSGALG00000035287","2",19642963,19659497,16534
"12296","ENSGALG00000035293","6",17818307,17825305,6998
"12297","ENSGALG00000035295","26",3763945,3770521,6576
"12298","ENSGALG00000035299","3",38288126,38295275,7149
"12299","ENSGALG00000035302","8",22135742,22143839,8097
"12300","ENSGALG00000035309","1",197275578,197277208,1630
"12301","ENSGALG00000035317","23",2367262,2369164,1902
"12302","ENSGALG00000035325","Z",9445555,9446532,977
"12303","ENSGALG00000035332","6",30163885,30166316,2431
"12304","ENSGALG00000035334","MT",9923,10706,783
"12305","ENSGALG00000035337","3",30320173,30336985,16812
"12306","ENSGALG00000035345","1",54584006,54620980,36974
"12307","ENSGALG00000035350","33",7092009,7095774,3765
"12308","ENSGALG00000035351","1",141461074,141463479,2405
"12309","ENSGALG00000035352","21",4307880,4313921,6041
"12310","ENSGALG00000035360","14",13353454,13401167,47713
"12311","ENSGALG00000035362","21",4404710,4414378,9668
"12312","ENSGALG00000035365","33",6047356,6051680,4324
"12313","ENSGALG00000035368","11",976722,978830,2108
"12314","ENSGALG00000035369","27",5900473,5907537,7064
"12315","ENSGALG00000035378","20",9520452,9536619,16167
"12316","ENSGALG00000035383","20",9273708,9291072,17364
"12317","ENSGALG00000035384","2",102931795,103017782,85987
"12318","ENSGALG00000035386","33",6036926,6046319,9393
"12319","ENSGALG00000035387","21",2146691,2153720,7029
"12320","ENSGALG00000035389","9",22456160,22458847,2687
"12321","ENSGALG00000035392","MT",6362,6430,68
"12322","ENSGALG00000035393","2",55800159,55802701,2542
"12323","ENSGALG00000035406","30",1110787,1116428,5641
"12324","ENSGALG00000035412","9",1359847,1360108,261
"12325","ENSGALG00000035417","2",118013141,118026920,13779
"12326","ENSGALG00000035419","24",354765,382201,27436
"12327","ENSGALG00000035421","20",10750391,10753196,2805
"12328","ENSGALG00000035425","9",9132083,9145997,13914
"12329","ENSGALG00000035429","2",110760621,110984213,223592
"12330","ENSGALG00000035432","9",16344365,16344474,109
"12331","ENSGALG00000035438","10",12451004,12474039,23035
"12332","ENSGALG00000035439","9",23772937,23773042,105
"12333","ENSGALG00000035441","1",154908040,154909848,1808
"12334","ENSGALG00000035447","14",7689162,7703329,14167
"12335","ENSGALG00000035453","2",47971867,47979912,8045
"12336","ENSGALG00000035461","1",188868223,188880800,12577
"12337","ENSGALG00000035462","10",4111782,4133567,21785
"12338","ENSGALG00000035464","19",5591755,5596919,5164
"12339","ENSGALG00000035465","10",20339739,20346194,6455
"12340","ENSGALG00000035466","7",35329301,35401729,72428
"12341","ENSGALG00000035472","3",76522206,76576110,53904
"12342","ENSGALG00000035476","13",14163592,14167146,3554
"12343","ENSGALG00000035478","2",138155067,138178819,23752
"12344","ENSGALG00000035482","4",37267897,37308644,40747
"12345","ENSGALG00000035487","33",7377090,7392549,15459
"12346","ENSGALG00000035490","5",56465775,56474283,8508
"12347","ENSGALG00000035492","2",46322705,46587483,264778
"12348","ENSGALG00000035493","1",43360803,43404429,43626
"12349","ENSGALG00000035498","9",1294733,1337979,43246
"12350","ENSGALG00000035499","26",501760,510830,9070
"12351","ENSGALG00000035500","6",13485282,13559882,74600
"12352","ENSGALG00000035502","33",6859136,6861250,2114
"12353","ENSGALG00000035504","2",27273383,27337505,64122
"12354","ENSGALG00000035505","2",46604093,46670393,66300
"12355","ENSGALG00000035506","33",6629529,6630228,699
"12356","ENSGALG00000035530","33",4984673,4997389,12716
"12357","ENSGALG00000035533","1",60925606,60965997,40391
"12358","ENSGALG00000035535","9",24095782,24111128,15346
"12359","ENSGALG00000035537","5",27663942,27672072,8130
"12360","ENSGALG00000035539","33",7661545,7663344,1799
"12361","ENSGALG00000035554","27",3757594,3761429,3835
"12362","ENSGALG00000035557","12",6536825,6539305,2480
"12363","ENSGALG00000035560","3",64200926,64234280,33354
"12364","ENSGALG00000035561","2",123049325,123074961,25636
"12365","ENSGALG00000035563","1",6569105,6679372,110267
"12366","ENSGALG00000035565","4",66443983,66445269,1286
"12367","ENSGALG00000035568","17",1939844,1942382,2538
"12368","ENSGALG00000035569","2",96511484,96522203,10719
"12369","ENSGALG00000035575","11",287947,294610,6663
"12370","ENSGALG00000035576","17",5268864,5275754,6890
"12371","ENSGALG00000035578","12",3015936,3126611,110675
"12372","ENSGALG00000035579","6",11039430,11106034,66604
"12373","ENSGALG00000035580","27",8012005,8018369,6364
"12374","ENSGALG00000035584","7",618031,671774,53743
"12375","ENSGALG00000035589","19",9178482,9181084,2602
"12376","ENSGALG00000035594","19",56925,70995,14070
"12377","ENSGALG00000035595","Z",2279305,2293812,14507
"12378","ENSGALG00000035596","12",1075941,1100520,24579
"12379","ENSGALG00000035599","3",68013742,68017684,3942
"12380","ENSGALG00000035602","11",8735364,8961629,226265
"12381","ENSGALG00000035604","11",449045,453768,4723
"12382","ENSGALG00000035605","7",18539532,18572441,32909
"12383","ENSGALG00000035610","19",8099842,8120568,20726
"12384","ENSGALG00000035619","4",60028589,60056286,27697
"12385","ENSGALG00000035623","2",42801514,42824483,22969
"12386","ENSGALG00000035624","17",5861537,5872810,11273
"12387","ENSGALG00000035625","2",96924967,96981295,56328
"12388","ENSGALG00000035626","27",2275923,2278771,2848
"12389","ENSGALG00000035629","1",83813954,83865313,51359
"12390","ENSGALG00000035630","2",44571672,44615705,44033
"12391","ENSGALG00000035635","33",3272217,3278783,6566
"12392","ENSGALG00000035636","1",7269227,7281113,11886
"12393","ENSGALG00000035641","32",104489,107615,3126
"12394","ENSGALG00000035645","12",3601923,3612996,11073
"12395","ENSGALG00000035650","4",84414007,84423443,9436
"12396","ENSGALG00000035654","28",1557064,1557140,76
"12397","ENSGALG00000035667","6",21058455,21075606,17151
"12398","ENSGALG00000035669","2",56051752,56063679,11927
"12399","ENSGALG00000035673","27",3641617,3651847,10230
"12400","ENSGALG00000035675","18",4884946,4908417,23471
"12401","ENSGALG00000035676","5",692121,702078,9957
"12402","ENSGALG00000035677","17",9823212,9826911,3699
"12403","ENSGALG00000035679","5",10352793,10399602,46809
"12404","ENSGALG00000035685","MT",6280,6355,75
"12405","ENSGALG00000035690","27",7192660,7197653,4993
"12406","ENSGALG00000035696","1",111336046,111358043,21997
"12407","ENSGALG00000035699","2",78272433,78316254,43821
"12408","ENSGALG00000035701","10",19226176,19287985,61809
"12409","ENSGALG00000035717","21",6542875,6568734,25859
"12410","ENSGALG00000035718","4",90778761,90785762,7001
"12411","ENSGALG00000035725","2",30161118,30163980,2862
"12412","ENSGALG00000035726","1",177364966,177389179,24213
"12413","ENSGALG00000035733","27",7287727,7296472,8745
"12414","ENSGALG00000035734","33",7066119,7075742,9623
"12415","ENSGALG00000035737","5",56938937,56940101,1164
"12416","ENSGALG00000035743","11",16741738,16763431,21693
"12417","ENSGALG00000035749","10",1298372,1306712,8340
"12418","ENSGALG00000035751","Z",409420,424419,14999
"12419","ENSGALG00000035752","2",119484870,119507975,23105
"12420","ENSGALG00000035760","KZ626836.1",51829,59253,7424
"12421","ENSGALG00000035761","2",22635251,22646949,11698
"12422","ENSGALG00000035762","28",2847048,2850872,3824
"12423","ENSGALG00000035768","2",930719,981286,50567
"12424","ENSGALG00000035769","3",57621418,57662363,40945
"12425","ENSGALG00000035773","Z",3984326,4085724,101398
"12426","ENSGALG00000035774","5",18089360,18134968,45608
"12427","ENSGALG00000035783","KZ626835.1",842353,935679,93326
"12428","ENSGALG00000035784","10",15133533,15135306,1773
"12429","ENSGALG00000035785","W",2140283,2214915,74632
"12430","ENSGALG00000035799","14",727561,869064,141503
"12431","ENSGALG00000035800","3",25620462,25819300,198838
"12432","ENSGALG00000035803","1",194317270,194318711,1441
"12433","ENSGALG00000035804","13",14167413,14171830,4417
"12434","ENSGALG00000035807","5",42320487,42342961,22474
"12435","ENSGALG00000035814","27",3631523,3641626,10103
"12436","ENSGALG00000035816","18",10513328,10522618,9290
"12437","ENSGALG00000035817","22",3663104,3667638,4534
"12438","ENSGALG00000035818","33",4895192,4926729,31537
"12439","ENSGALG00000035819","21",4955139,4962579,7440
"12440","ENSGALG00000035824","1",395826,401417,5591
"12441","ENSGALG00000035825","28",4140403,4143309,2906
"12442","ENSGALG00000035828","2",64280488,64294715,14227
"12443","ENSGALG00000035835","3",3543643,3544746,1103
"12444","ENSGALG00000035836","1",67031006,67040698,9692
"12445","ENSGALG00000035839","1",138554082,138617238,63156
"12446","ENSGALG00000035841","8",5114656,5179873,65217
"12447","ENSGALG00000035842","24",243549,252197,8648
"12448","ENSGALG00000035845","2",118111383,118189824,78441
"12449","ENSGALG00000035850","33",7224089,7228779,4690
"12450","ENSGALG00000035853","27",6522600,6525557,2957
"12451","ENSGALG00000035854","2",41532339,41538738,6399
"12452","ENSGALG00000035856","25",2468024,2470555,2531
"12453","ENSGALG00000035857","5",33429087,33453512,24425
"12454","ENSGALG00000035867","5",18954568,18964262,9694
"12455","ENSGALG00000035869","21",2160478,2177662,17184
"12456","ENSGALG00000035873","10",12827948,12836704,8756
"12457","ENSGALG00000035879","33",5470014,5483465,13451
"12458","ENSGALG00000035882","11",18880781,18908065,27284
"12459","ENSGALG00000035883","12",1855699,1863549,7850
"12460","ENSGALG00000035886","4",27570893,27607864,36971
"12461","ENSGALG00000035901","2",126678752,126686707,7955
"12462","ENSGALG00000035903","3",78460986,78465358,4372
"12463","ENSGALG00000035904","1",124885136,124890404,5268
"12464","ENSGALG00000035906","4",51746647,51768995,22348
"12465","ENSGALG00000035908","17",6353166,6355461,2295
"12466","ENSGALG00000035911","18",9601368,9605211,3843
"12467","ENSGALG00000035912","Z",1281331,1371901,90570
"12468","ENSGALG00000035913","18",9912545,9915105,2560
"12469","ENSGALG00000035914","9",13354574,13380712,26138
"12470","ENSGALG00000035916","5",18179810,18393764,213954
"12471","ENSGALG00000035919","14",5576295,5631053,54758
"12472","ENSGALG00000035923","25",1834861,1842786,7925
"12473","ENSGALG00000035925","2",78327060,78338570,11510
"12474","ENSGALG00000035927","Z",1821762,1881535,59773
"12475","ENSGALG00000035930","20",6735552,6830610,95058
"12476","ENSGALG00000035932","2",120286814,120304293,17479
"12477","ENSGALG00000035935","10",8592962,8676758,83796
"12478","ENSGALG00000035940","1",15243988,15377569,133581
"12479","ENSGALG00000035945","11",1196515,1201519,5004
"12480","ENSGALG00000035946","4",20752419,20809491,57072
"12481","ENSGALG00000035949","2",42247131,42275377,28246
"12482","ENSGALG00000035950","27",5831662,5843100,11438
"12483","ENSGALG00000035951","20",9973708,9974565,857
"12484","ENSGALG00000035952","2",43164073,43170238,6165
"12485","ENSGALG00000035960","KZ626838.1",225080,242676,17596
"12486","ENSGALG00000035963","8",5470226,5471907,1681
"12487","ENSGALG00000035966","4",1137054,1191044,53990
"12488","ENSGALG00000035970","1",71078664,71102509,23845
"12489","ENSGALG00000035972","33",5241761,5245597,3836
"12490","ENSGALG00000035973","4",546494,550690,4196
"12491","ENSGALG00000035975","MT",5025,5096,71
"12492","ENSGALG00000035976","22",136626,140199,3573
"12493","ENSGALG00000035977","17",1536862,1538400,1538
"12494","ENSGALG00000035978","2",30557467,30567159,9692
"12495","ENSGALG00000035980","24",4595093,4602005,6912
"12496","ENSGALG00000035981","4",89715756,89719228,3472
"12497","ENSGALG00000035985","8",2683103,2685907,2804
"12498","ENSGALG00000035993","33",7079848,7081224,1376
"12499","ENSGALG00000035994","2",23309985,23395584,85599
"12500","ENSGALG00000035996","2",128186637,128192313,5676
"12501","ENSGALG00000035998","W",1840623,1896773,56150
"12502","ENSGALG00000036001","Z",1515751,1557445,41694
"12503","ENSGALG00000036004","28",3499544,3501388,1844
"12504","ENSGALG00000036005","3",50592818,50678098,85280
"12505","ENSGALG00000036017","2",116504849,116596399,91550
"12506","ENSGALG00000036019","2",128294085,128297283,3198
"12507","ENSGALG00000036021","4",63086800,63130477,43677
"12508","ENSGALG00000036022","23",285905,297198,11293
"12509","ENSGALG00000036028","18",7752309,7776703,24394
"12510","ENSGALG00000036040","23",260089,265299,5210
"12511","ENSGALG00000036042","33",6232509,6234653,2144
"12512","ENSGALG00000036043","15",12495131,12505106,9975
"12513","ENSGALG00000036044","5",539900,553657,13757
"12514","ENSGALG00000036049","22",2637855,2642014,4159
"12515","ENSGALG00000036056","5",765972,766085,113
"12516","ENSGALG00000036064","2",7745717,7797697,51980
"12517","ENSGALG00000036067","2",56089456,56104549,15093
"12518","ENSGALG00000036069","5",526897,533211,6314
"12519","ENSGALG00000036074","2",65547548,65559310,11762
"12520","ENSGALG00000036075","13",10549811,10554512,4701
"12521","ENSGALG00000036076","1",133610586,133613996,3410
"12522","ENSGALG00000036079","33",2414676,2607189,192513
"12523","ENSGALG00000036085","2",148823679,148841111,17432
"12524","ENSGALG00000036086","25",3881435,3885725,4290
"12525","ENSGALG00000036089","12",2860143,2862268,2125
"12526","ENSGALG00000036091","20",9968214,9970486,2272
"12527","ENSGALG00000036093","26",367531,376406,8875
"12528","ENSGALG00000036095","6",1492814,1589295,96481
"12529","ENSGALG00000036097","2",74190751,74441847,251096
"12530","ENSGALG00000036101","32",653072,661537,8465
"12531","ENSGALG00000036106","1",197398635,197402615,3980
"12532","ENSGALG00000036107","5",59267284,59323141,55857
"12533","ENSGALG00000036109","2",104349962,104368488,18526
"12534","ENSGALG00000036110","2",43409098,43430679,21581
"12535","ENSGALG00000036111","9",5541385,5557609,16224
"12536","ENSGALG00000036114","1",1339503,1348245,8742
"12537","ENSGALG00000036117","23",1964543,1971801,7258
"12538","ENSGALG00000036120","24",1743425,1756593,13168
"12539","ENSGALG00000036125","25",2934855,2940187,5332
"12540","ENSGALG00000036128","2",91466387,91808773,342386
"12541","ENSGALG00000036130","11",18682695,18682796,101
"12542","ENSGALG00000036131","1",52337315,52477165,139850
"12543","ENSGALG00000036133","12",11023383,11032726,9343
"12544","ENSGALG00000036140","1",1560601,1566838,6237
"12545","ENSGALG00000036142","4",90807622,90816116,8494
"12546","ENSGALG00000036148","2",38772550,38774145,1595
"12547","ENSGALG00000036160","7",10286424,10311523,25099
"12548","ENSGALG00000036163","10",20457103,20464813,7710
"12549","ENSGALG00000036171","2",41671431,41675062,3631
"12550","ENSGALG00000036175","22",5281520,5284629,3109
"12551","ENSGALG00000036189","3",88592498,88638346,45848
"12552","ENSGALG00000036190","2",394586,398027,3441
"12553","ENSGALG00000036191","31",2520904,2557318,36414
"12554","ENSGALG00000036195","9",17035914,17036175,261
"12555","ENSGALG00000036196","5",637579,640303,2724
"12556","ENSGALG00000036201","10",10905606,10954565,48959
"12557","ENSGALG00000036204","3",72293898,72433758,139860
"12558","ENSGALG00000036214","21",264289,271465,7176
"12559","ENSGALG00000036218","3",40043583,40064101,20518
"12560","ENSGALG00000036219","20",9768420,9783320,14900
"12561","ENSGALG00000036220","17",735789,737180,1391
"12562","ENSGALG00000036222","1",73876048,73911421,35373
"12563","ENSGALG00000036223","26",5474295,5483266,8971
"12564","ENSGALG00000036226","1",119902097,119930627,28530
"12565","ENSGALG00000036229","MT",11486,12863,1377
"12566","ENSGALG00000036234","11",1864173,1885632,21459
"12567","ENSGALG00000036238","1",49121234,49152488,31254
"12568","ENSGALG00000036240","3",48927875,48943197,15322
"12569","ENSGALG00000036244","2",105465974,105467104,1130
"12570","ENSGALG00000036252","4",43303894,43309926,6032
"12571","ENSGALG00000036255","1",70750805,70843717,92912
"12572","ENSGALG00000036257","7",334115,340825,6710
"12573","ENSGALG00000036258","1",167019707,167023223,3516
"12574","ENSGALG00000036259","Z",2188460,2215272,26812
"12575","ENSGALG00000036263","12",2849850,2853236,3386
"12576","ENSGALG00000036264","8",5441379,5454440,13061
"12577","ENSGALG00000036272","AADN05001188.1",14135,20294,6159
"12578","ENSGALG00000036283","25",1987363,1989827,2464
"12579","ENSGALG00000036284","1",114234012,114298065,64053
"12580","ENSGALG00000036286","5",48336527,48353084,16557
"12581","ENSGALG00000036288","10",1594204,1604118,9914
"12582","ENSGALG00000036292","2",96055647,96082504,26857
"12583","ENSGALG00000036293","2",132562852,132582862,20010
"12584","ENSGALG00000036294","23",5701544,5708612,7068
"12585","ENSGALG00000036295","21",920754,923687,2933
"12586","ENSGALG00000036297","28",3491426,3494556,3130
"12587","ENSGALG00000036300","1",6834525,6850141,15616
"12588","ENSGALG00000036301","2",46711259,46733681,22422
"12589","ENSGALG00000036306","2",67390638,67439725,49087
"12590","ENSGALG00000036309","2",42834944,42919794,84850
"12591","ENSGALG00000036310","13",2117081,2139580,22499
"12592","ENSGALG00000036322","4",2359332,2389967,30635
"12593","ENSGALG00000036327","9",1232430,1255560,23130
"12594","ENSGALG00000036346","28",2107519,2111709,4190
"12595","ENSGALG00000036355","1",58399989,58406158,6169
"12596","ENSGALG00000036356","9",2775390,2816964,41574
"12597","ENSGALG00000036358","1",63351924,63412998,61074
"12598","ENSGALG00000036359","33",6729804,6740831,11027
"12599","ENSGALG00000036360","15",7134583,7140352,5769
"12600","ENSGALG00000036364","5",33738911,33740749,1838
"12601","ENSGALG00000036365","25",365295,381988,16693
"12602","ENSGALG00000036373","14",12224104,12282303,58199
"12603","ENSGALG00000036378","7",21367600,21373226,5626
"12604","ENSGALG00000036380","33",5929622,5940135,10513
"12605","ENSGALG00000036383","5",22946864,22966730,19866
"12606","ENSGALG00000036390","2",48424506,48443357,18851
"12607","ENSGALG00000036391","22",254899,283905,29006
"12608","ENSGALG00000036395","27",2272709,2649530,376821
"12609","ENSGALG00000036399","9",8543615,8548205,4590
"12610","ENSGALG00000036412","2",42447408,42553652,106244
"12611","ENSGALG00000036417","15",9543987,9559530,15543
"12612","ENSGALG00000036418","2",138127619,138151268,23649
"12613","ENSGALG00000036432","5",1233066,1249387,16321
"12614","ENSGALG00000036436","1",100103067,100116897,13830
"12615","ENSGALG00000036441","7",16834579,16863607,29028
"12616","ENSGALG00000036443","5",22842140,22884540,42400
"12617","ENSGALG00000036447","1",75760373,75776389,16016
"12618","ENSGALG00000036452","27",6492112,6496060,3948
"12619","ENSGALG00000036455","31",1724996,1726030,1034
"12620","ENSGALG00000036456","2",138859505,138862431,2926
"12621","ENSGALG00000036459","31",5671218,5675226,4008
"12622","ENSGALG00000036466","2",75520204,75645279,125075
"12623","ENSGALG00000036471","7",10250112,10278917,28805
"12624","ENSGALG00000036474","28",4517934,4519217,1283
"12625","ENSGALG00000036477","2",154470,159009,4539
"12626","ENSGALG00000036484","28",3646452,3659364,12912
"12627","ENSGALG00000036488","1",23926874,23965348,38474
"12628","ENSGALG00000036490","2",140462096,140559056,96960
"12629","ENSGALG00000036491","26",1067102,1075345,8243
"12630","ENSGALG00000036492","5",404784,434339,29555
"12631","ENSGALG00000036496","32",69421,88066,18645
"12632","ENSGALG00000036497","2",58890036,58891801,1765
"12633","ENSGALG00000036498","32",229101,238499,9398
"12634","ENSGALG00000036500","27",7058342,7063125,4783
"12635","ENSGALG00000036502","14",12807823,12817482,9659
"12636","ENSGALG00000036504","5",54623560,54651291,27731
"12637","ENSGALG00000036511","10",1492675,1499114,6439
"12638","ENSGALG00000036514","18",2703603,2710776,7173
"12639","ENSGALG00000036520","4",83607409,83620631,13222
"12640","ENSGALG00000036522","8",27107541,27184837,77296
"12641","ENSGALG00000036527","2",132583836,132627922,44086
"12642","ENSGALG00000036530","5",269082,273260,4178
"12643","ENSGALG00000036539","4",1025394,1070879,45485
"12644","ENSGALG00000036543","9",10354529,10364902,10373
"12645","ENSGALG00000036547","4",90839747,90892554,52807
"12646","ENSGALG00000036550","33",3160563,3165510,4947
"12647","ENSGALG00000036551","19",7761737,7767886,6149
"12648","ENSGALG00000036552","14",4772825,4781135,8310
"12649","ENSGALG00000036556","1",107973719,108001586,27867
"12650","ENSGALG00000036566","4",200826,216542,15716
"12651","ENSGALG00000036567","2",114773595,114803982,30387
"12652","ENSGALG00000036568","19",3088946,3089008,62
"12653","ENSGALG00000036577","14",13548049,13549783,1734
"12654","ENSGALG00000036582","14",14637209,14639715,2506
"12655","ENSGALG00000036587","8",6358451,6366057,7606
"12656","ENSGALG00000036589","4",89326506,89392084,65578
"12657","ENSGALG00000036593","11",17360006,17361528,1522
"12658","ENSGALG00000036598","1",69294587,69354684,60097
"12659","ENSGALG00000036604","3",107117279,107117937,658
"12660","ENSGALG00000036613","1",105419702,105424680,4978
"12661","ENSGALG00000036616","26",2075202,2083441,8239
"12662","ENSGALG00000036621","4",73496003,73506423,10420
"12663","ENSGALG00000036625","2",98648740,98662638,13898
"12664","ENSGALG00000036627","7",22588095,22590196,2101
"12665","ENSGALG00000036635","2",149653922,149658321,4399
"12666","ENSGALG00000036638","22",3951091,3963204,12113
"12667","ENSGALG00000036642","5",199870,202415,2545
"12668","ENSGALG00000036645","2",43128699,43164052,35353
"12669","ENSGALG00000036647","19",356636,360244,3608
"12670","ENSGALG00000036659","18",9254816,9255426,610
"12671","ENSGALG00000036666","13",17833844,17843987,10143
"12672","ENSGALG00000036677","1",106830197,106917416,87219
"12673","ENSGALG00000036678","27",5959008,5971321,12313
"12674","ENSGALG00000036680","10",7706624,7752653,46029
"12675","ENSGALG00000036683","27",6498559,6500829,2270
"12676","ENSGALG00000036686","20",10532982,10538372,5390
"12677","ENSGALG00000036687","9",909477,909533,56
"12678","ENSGALG00000036710","5",856457,865851,9394
"12679","ENSGALG00000036711","25",2386866,2388673,1807
"12680","ENSGALG00000036714","3",110405642,110423975,18333
"12681","ENSGALG00000036725","5",9824339,9827275,2936
"12682","ENSGALG00000036728","21",1044071,1242675,198604
"12683","ENSGALG00000036730","1",72622696,72644857,22161
"12684","ENSGALG00000036731","15",11428579,11434430,5851
"12685","ENSGALG00000036736","28",3989910,3991254,1344
"12686","ENSGALG00000036738","1",93596025,93648691,52666
"12687","ENSGALG00000036739","15",638245,655870,17625
"12688","ENSGALG00000036742","19",2690575,2780557,89982
"12689","ENSGALG00000036743","1",50628618,50645593,16975
"12690","ENSGALG00000036747","4",90938865,90943532,4667
"12691","ENSGALG00000036749","2",120718609,120796159,77550
"12692","ENSGALG00000036751","14",16007197,16010781,3584
"12693","ENSGALG00000036754","5",16353075,16372300,19225
"12694","ENSGALG00000036763","12",9422730,9446670,23940
"12695","ENSGALG00000036774","Z",1077920,1081538,3618
"12696","ENSGALG00000036775","Z",2630793,2878710,247917
"12697","ENSGALG00000036780","3",26020435,26086284,65849
"12698","ENSGALG00000036782","23",2316905,2322177,5272
"12699","ENSGALG00000036783","8",4645426,4658534,13108
"12700","ENSGALG00000036785","6",24231051,24250341,19290
"12701","ENSGALG00000036787","5",21812534,21884849,72315
"12702","ENSGALG00000036788","18",7107645,7117999,10354
"12703","ENSGALG00000036789","8",17785587,18095888,310301
"12704","ENSGALG00000036790","3",74821,76716,1895
"12705","ENSGALG00000036791","1",133608232,133610582,2350
"12706","ENSGALG00000036792","2",148883622,148885622,2000
"12707","ENSGALG00000036796","24",342190,348186,5996
"12708","ENSGALG00000036798","1",140138678,140249096,110418
"12709","ENSGALG00000036805","5",577103,590550,13447
"12710","ENSGALG00000036806","33",5499569,5507669,8100
"12711","ENSGALG00000036807","2",41184789,41205075,20286
"12712","ENSGALG00000036821","2",130889827,130993771,103944
"12713","ENSGALG00000036823","1",106505764,106511201,5437
"12714","ENSGALG00000036824","6",12523595,12618142,94547
"12715","ENSGALG00000036828","13",10077391,10080180,2789
"12716","ENSGALG00000036829","2",55980846,56043283,62437
"12717","ENSGALG00000036831","32",604736,612908,8172
"12718","ENSGALG00000036833","1",106416580,106440775,24195
"12719","ENSGALG00000036836","2",28399735,28403638,3903
"12720","ENSGALG00000036837","33",6885732,6894210,8478
"12721","ENSGALG00000036838","20",9036712,9076856,40144
"12722","ENSGALG00000036839","KZ626835.1",1142370,1144523,2153
"12723","ENSGALG00000036843","1",141277993,141287623,9630
"12724","ENSGALG00000036846","27",7405857,7408187,2330
"12725","ENSGALG00000036847","6",5866783,5876999,10216
"12726","ENSGALG00000036848","4",38524016,38536178,12162
"12727","ENSGALG00000036850","10",4188720,4194426,5706
"12728","ENSGALG00000036852","1",77963727,77964914,1187
"12729","ENSGALG00000036854","22",1387717,1393363,5646
"12730","ENSGALG00000036856","33",7718770,7720615,1845
"12731","ENSGALG00000036861","5",16338759,16351099,12340
"12732","ENSGALG00000036867","1",50770186,50778021,7835
"12733","ENSGALG00000036869","3",3523328,3524365,1037
"12734","ENSGALG00000036870","2",565634,585108,19474
"12735","ENSGALG00000036871","8",4221758,4251652,29894
"12736","ENSGALG00000036873","24",89438,130728,41290
"12737","ENSGALG00000036876","22",484297,499838,15541
"12738","ENSGALG00000036877","1",154617566,154814374,196808
"12739","ENSGALG00000036883","1",25059910,25147690,87780
"12740","ENSGALG00000036892","5",824101,848390,24289
"12741","ENSGALG00000036894","17",781741,814817,33076
"12742","ENSGALG00000036896","6",25152751,25192289,39538
"12743","ENSGALG00000036897","1",51008968,51016634,7666
"12744","ENSGALG00000036901","5",22331177,22412191,81014
"12745","ENSGALG00000036908","1",48095687,48096067,380
"12746","ENSGALG00000036909","8",23047528,23885562,838034
"12747","ENSGALG00000036915","2",138683095,138697225,14130
"12748","ENSGALG00000036916","12",5797936,5969305,171369
"12749","ENSGALG00000036920","13",17545410,17564407,18997
"12750","ENSGALG00000036925","25",3840941,3854221,13280
"12751","ENSGALG00000036927","9",5059745,5059815,70
"12752","ENSGALG00000036931","8",5909183,5933209,24026
"12753","ENSGALG00000036932","21",4251057,4306551,55494
"12754","ENSGALG00000036935","5",258436,260326,1890
"12755","ENSGALG00000036938","2",122124955,122502774,377819
"12756","ENSGALG00000036941","2",54231119,54279066,47947
"12757","ENSGALG00000036942","26",1492029,1493771,1742
"12758","ENSGALG00000036944","9",16359093,16359220,127
"12759","ENSGALG00000036949","23",2336751,2352001,15250
"12760","ENSGALG00000036950","22",5316782,5319574,2792
"12761","ENSGALG00000036955","25",3464052,3466360,2308
"12762","ENSGALG00000036956","MT",1297,2272,975
"12763","ENSGALG00000036958","1",56736039,56747697,11658
"12764","ENSGALG00000036962","27",6572282,6591811,19529
"12765","ENSGALG00000036964","1",60970968,61033953,62985
"12766","ENSGALG00000036965","17",5807399,5830881,23482
"12767","ENSGALG00000036969","2",106576892,106637507,60615
"12768","ENSGALG00000036970","MT",13000,13070,70
"12769","ENSGALG00000036971","9",13490727,13679765,189038
"12770","ENSGALG00000036976","12",12044166,12051724,7558
"12771","ENSGALG00000036990","2",124297207,124306416,9209
"12772","ENSGALG00000036993","24",5255669,5264130,8461
"12773","ENSGALG00000037002","15",322561,322625,64
"12774","ENSGALG00000037011","28",3540874,3544871,3997
"12775","ENSGALG00000037014","2",146916969,147397126,480157
"12776","ENSGALG00000037015","1",158037290,158403765,366475
"12777","ENSGALG00000037018","18",9768623,9777344,8721
"12778","ENSGALG00000037020","5",799481,804288,4807
"12779","ENSGALG00000037026","25",2449884,2452245,2361
"12780","ENSGALG00000037029","28",4087493,4091666,4173
"12781","ENSGALG00000037030","1",71960834,71970851,10017
"12782","ENSGALG00000037031","17",2821411,2832640,11229
"12783","ENSGALG00000037035","6",31015797,31015859,62
"12784","ENSGALG00000037040","4",34326767,34329010,2243
"12785","ENSGALG00000037043","26",1792379,1811826,19447
"12786","ENSGALG00000037050","23",703621,707046,3425
"12787","ENSGALG00000037051","19",175202,256177,80975
"12788","ENSGALG00000037052","23",5303936,5306330,2394
"12789","ENSGALG00000037064","1",113943617,113966641,23024
"12790","ENSGALG00000037065","24",3559479,3564721,5242
"12791","ENSGALG00000037067","2",132199298,132219771,20473
"12792","ENSGALG00000037070","6",20868111,20875710,7599
"12793","ENSGALG00000037071","12",20177222,20180293,3071
"12794","ENSGALG00000037072","1",190445981,190454372,8391
"12795","ENSGALG00000037076","1",106695142,106733810,38668
"12796","ENSGALG00000037077","2",42617494,42623187,5693
"12797","ENSGALG00000037079","17",1927925,1931386,3461
"12798","ENSGALG00000037082","1",55066348,55068233,1885
"12799","ENSGALG00000037087","3",66300751,66313307,12556
"12800","ENSGALG00000037094","4",31572704,31574342,1638
"12801","ENSGALG00000037097","15",7293042,7338049,45007
"12802","ENSGALG00000037111","20",9305461,9308288,2827
"12803","ENSGALG00000037112","2",49812139,49826641,14502
"12804","ENSGALG00000037124","2",92987987,92998716,10729
"12805","ENSGALG00000037129","4",57218817,57223543,4726
"12806","ENSGALG00000037131","30",1413471,1450243,36772
"12807","ENSGALG00000037136","23",226738,257437,30699
"12808","ENSGALG00000037138","5",13429698,13749553,319855
"12809","ENSGALG00000037148","2",115011152,115012145,993
"12810","ENSGALG00000037156","2",56105317,56110599,5282
"12811","ENSGALG00000037160","Z",1243251,1267913,24662
"12812","ENSGALG00000037163","15",7187636,7198456,10820
"12813","ENSGALG00000037164","2",119316650,119443316,126666
"12814","ENSGALG00000037166","5",115674,120614,4940
"12815","ENSGALG00000037167","1",48129573,48130279,706
"12816","ENSGALG00000037170","16",2499936,2503957,4021
"12817","ENSGALG00000037171","2",75720839,75727791,6952
"12818","ENSGALG00000037172","13",1594995,1603346,8351
"12819","ENSGALG00000037177","3",39754269,39776050,21781
"12820","ENSGALG00000037186","33",5540473,5541999,1526
"12821","ENSGALG00000037193","2",51253986,51485303,231317
"12822","ENSGALG00000037194","3",101704564,101729881,25317
"12823","ENSGALG00000037195","5",712496,717693,5197
"12824","ENSGALG00000037200","3",5066010,5424543,358533
"12825","ENSGALG00000037203","2",43386278,43407735,21457
"12826","ENSGALG00000037206","1",24857853,24995430,137577
"12827","ENSGALG00000037214","4",82748685,82786006,37321
"12828","ENSGALG00000037219","8",8413404,8429525,16121
"12829","ENSGALG00000037220","5",22587180,22599063,11883
"12830","ENSGALG00000037223","9",5485166,5487957,2791
"12831","ENSGALG00000037238","9",698705,726916,28211
"12832","ENSGALG00000037241","21",673711,691341,17630
"12833","ENSGALG00000037242","2",41677647,41708292,30645
"12834","ENSGALG00000037246","2",54476377,54526547,50170
"12835","ENSGALG00000037249","3",81557621,81816578,258957
"12836","ENSGALG00000037253","30",1063731,1067912,4181
"12837","ENSGALG00000037256","28",3525115,3527452,2337
"12838","ENSGALG00000037257","3",18695571,18698897,3326
"12839","ENSGALG00000037258","2",51155641,51158032,2391
"12840","ENSGALG00000037261","28",3667243,3672270,5027
"12841","ENSGALG00000037262","33",7605746,7616596,10850
"12842","ENSGALG00000037267","3",110526856,110558612,31756
"12843","ENSGALG00000037269","27",7811095,7817612,6517
"12844","ENSGALG00000037272","7",16290965,16292885,1920
"12845","ENSGALG00000037273","1",183720748,183721251,503
"12846","ENSGALG00000037274","20",9836467,9847105,10638
"12847","ENSGALG00000037283","6",23054105,23058446,4341
"12848","ENSGALG00000037285","2",145014229,145093521,79292
"12849","ENSGALG00000037286","7",22534108,22539376,5268
"12850","ENSGALG00000037289","3",16526269,16562752,36483
"12851","ENSGALG00000037290","16",1357815,1360043,2228
"12852","ENSGALG00000037295","33",5067640,5074745,7105
"12853","ENSGALG00000037299","Z",44895083,44911110,16027
"12854","ENSGALG00000037301","7",36257915,36304135,46220
"12855","ENSGALG00000037307","15",11049339,11055778,6439
"12856","ENSGALG00000037310","2",32714893,32718158,3265
"12857","ENSGALG00000037314","19",7143830,7169704,25874
"12858","ENSGALG00000037315","11",17912569,17940191,27622
"12859","ENSGALG00000037316","28",3463016,3469363,6347
"12860","ENSGALG00000037322","1",48095104,48095606,502
"12861","ENSGALG00000037325","9",23804524,23806330,1806
"12862","ENSGALG00000037326","5",27522846,27570512,47666
"12863","ENSGALG00000037327","7",18022075,18040268,18193
"12864","ENSGALG00000037329","4",61460241,61468387,8146
"12865","ENSGALG00000037332","4",49164561,49178507,13946
"12866","ENSGALG00000037336","10",8280309,8366833,86524
"12867","ENSGALG00000037339","4",37126690,37168037,41347
"12868","ENSGALG00000037349","4",4554679,4559547,4868
"12869","ENSGALG00000037352","9",4377193,4378149,956
"12870","ENSGALG00000037353","1",133387917,133479417,91500
"12871","ENSGALG00000037360","1",50877655,50894778,17123
"12872","ENSGALG00000037361","4",11462832,11470583,7751
"12873","ENSGALG00000037363","20",4554039,4560927,6888
"12874","ENSGALG00000037366","6",2370600,2675359,304759
"12875","ENSGALG00000037369","MT",11128,11195,67
"12876","ENSGALG00000037370","26",629113,668761,39648
"12877","ENSGALG00000037371","2",138402887,138435037,32150
"12878","ENSGALG00000037374","9",24122589,24125592,3003
"12879","ENSGALG00000037375","17",695350,714591,19241
"12880","ENSGALG00000037377","3",52002017,52109904,107887
"12881","ENSGALG00000037378","7",35627600,35628125,525
"12882","ENSGALG00000037380","9",17074665,17074889,224
"12883","ENSGALG00000037387","9",6462980,6534772,71792
"12884","ENSGALG00000037390","4",339230,344366,5136
"12885","ENSGALG00000037393","20",3597655,3602400,4745
"12886","ENSGALG00000037395","13",9468139,9520611,52472
"12887","ENSGALG00000037396","33",7256756,7259786,3030
"12888","ENSGALG00000037400","14",7133469,7135314,1845
"12889","ENSGALG00000037401","10",4228395,4240381,11986
"12890","ENSGALG00000037402","3",57245588,57248925,3337
"12891","ENSGALG00000037407","24",437306,446379,9073
"12892","ENSGALG00000037408","28",993850,996088,2238
"12893","ENSGALG00000037410","4",297485,319373,21888
"12894","ENSGALG00000037413","2",120316700,120326139,9439
"12895","ENSGALG00000037414","1",106666798,106669729,2931
"12896","ENSGALG00000037423","3",58645835,59035307,389472
"12897","ENSGALG00000037426","Z",1086906,1234537,147631
"12898","ENSGALG00000037435","1",9888360,9896316,7956
"12899","ENSGALG00000037437","22",1507943,1510090,2147
"12900","ENSGALG00000037439","1",135246919,135278427,31508
"12901","ENSGALG00000037441","25",2843844,2844777,933
"12902","ENSGALG00000037443","17",5794050,5805077,11027
"12903","ENSGALG00000037453","2",117620664,117643435,22771
"12904","ENSGALG00000037455","12",1105932,1164786,58854
"12905","ENSGALG00000037457","4",86075690,86078546,2856
"12906","ENSGALG00000037464","3",41241478,41308726,67248
"12907","ENSGALG00000037467","9",1255143,1289866,34723
"12908","ENSGALG00000037479","21",51064,84269,33205
"12909","ENSGALG00000037480","25",3682741,3686986,4245
"12910","ENSGALG00000037483","28",1828004,1835141,7137
"12911","ENSGALG00000037485","1",83770540,83782730,12190
"12912","ENSGALG00000037492","14",12746596,12794827,48231
"12913","ENSGALG00000037493","5",31427653,31433615,5962
"12914","ENSGALG00000037494","13",15042075,15046001,3926
"12915","ENSGALG00000037496","4",65987993,66011858,23865
"12916","ENSGALG00000037497","5",646633,649212,2579
"12917","ENSGALG00000037504","3",190028,207682,17654
"12918","ENSGALG00000037506","3",39259121,39362915,103794
"12919","ENSGALG00000037510","19",281710,286777,5067
"12920","ENSGALG00000037519","2",2443556,2446966,3410
"12921","ENSGALG00000037520","1",191549710,191552051,2341
"12922","ENSGALG00000037521","1",190297679,190326959,29280
"12923","ENSGALG00000037522","28",3038438,3080297,41859
"12924","ENSGALG00000037523","13",18263915,18269248,5333
"12925","ENSGALG00000037525","4",85064209,85229240,165031
"12926","ENSGALG00000037526","28",3481883,3484882,2999
"12927","ENSGALG00000037527","30",1195123,1205791,10668
"12928","ENSGALG00000037533","2",41103488,41108709,5221
"12929","ENSGALG00000037540","25",115212,131015,15803
"12930","ENSGALG00000037545","12",11417142,11482054,64912
"12931","ENSGALG00000037546","26",108265,127274,19009
"12932","ENSGALG00000037548","AADN05001240.1",21,2025,2004
"12933","ENSGALG00000037549","33",6558794,6566265,7471
"12934","ENSGALG00000037553","10",1456985,1466170,9185
"12935","ENSGALG00000037556","5",19262646,19335831,73185
"12936","ENSGALG00000037558","28",3688008,3697772,9764
"12937","ENSGALG00000037572","3",1479826,1484876,5050
"12938","ENSGALG00000037576","3",16155290,16157946,2656
"12939","ENSGALG00000037581","7",29372614,29386421,13807
"12940","ENSGALG00000037587","3",57331049,57364433,33384
"12941","ENSGALG00000037593","21",4905099,4911725,6626
"12942","ENSGALG00000037595","25",11783,20242,8459
"12943","ENSGALG00000037596","12",19128744,19137636,8892
"12944","ENSGALG00000037597","26",2615310,2619004,3694
"12945","ENSGALG00000037599","25",3312351,3314646,2295
"12946","ENSGALG00000037601","30",286191,290414,4223
"12947","ENSGALG00000037603","23",2253610,2261049,7439
"12948","ENSGALG00000037611","Z",9259275,9283017,23742
"12949","ENSGALG00000037616","6",26929409,26933520,4111
"12950","ENSGALG00000037618","2",140568060,140731190,163130
"12951","ENSGALG00000037619","27",6221058,6223348,2290
"12952","ENSGALG00000037625","28",367087,488932,121845
"12953","ENSGALG00000037626","2",141407537,141592762,185225
"12954","ENSGALG00000037628","3",42984395,43024501,40106
"12955","ENSGALG00000037629","2",45896594,45935972,39378
"12956","ENSGALG00000037632","5",36840166,36842654,2488
"12957","ENSGALG00000037633","27",7205604,7209687,4083
"12958","ENSGALG00000037641","MT",6573,6643,70
"12959","ENSGALG00000037642","13",3188490,3191561,3071
"12960","ENSGALG00000037644","2",123078084,123111520,33436
"12961","ENSGALG00000037646","13",10782893,10798225,15332
"12962","ENSGALG00000037650","31",3126824,3129589,2765
"12963","ENSGALG00000037655","1",93792988,93803389,10401
"12964","ENSGALG00000037656","1",75447599,75455190,7591
"12965","ENSGALG00000037665","33",7130977,7136376,5399
"12966","ENSGALG00000037666","1",48162705,48168220,5515
"12967","ENSGALG00000037669","2",47941766,47957624,15858
"12968","ENSGALG00000037671","1",56805534,56829441,23907
"12969","ENSGALG00000037675","2",136788122,136908061,119939
"12970","ENSGALG00000037678","7",9690707,9694285,3578
"12971","ENSGALG00000037682","6",1634831,1751717,116886
"12972","ENSGALG00000037686","2",124273535,124294981,21446
"12973","ENSGALG00000037687","2",128751881,128771842,19961
"12974","ENSGALG00000037688","33",7351137,7354128,2991
"12975","ENSGALG00000037692","5",33736447,33738298,1851
"12976","ENSGALG00000037695","2",127712044,127714882,2838
"12977","ENSGALG00000037697","1",138832131,138850368,18237
"12978","ENSGALG00000037698","2",142538178,142625924,87746
"12979","ENSGALG00000037699","4",84434100,84481849,47749
"12980","ENSGALG00000037701","2",115062643,115062700,57
"12981","ENSGALG00000037709","19",5914173,5916257,2084
"12982","ENSGALG00000037712","28",3414427,3446334,31907
"12983","ENSGALG00000037713","21",2117091,2117738,647
"12984","ENSGALG00000037714","6",27109662,27112589,2927
"12985","ENSGALG00000037716","28",3987709,3988751,1042
"12986","ENSGALG00000037717","18",8855389,8892932,37543
"12987","ENSGALG00000037723","10",8044920,8090289,45369
"12988","ENSGALG00000037726","3",64899435,64901566,2131
"12989","ENSGALG00000037727","7",340287,351967,11680
"12990","ENSGALG00000037731","KZ626836.1",609891,781621,171730
"12991","ENSGALG00000037733","28",1561863,1566931,5068
"12992","ENSGALG00000037734","10",8423876,8432081,8205
"12993","ENSGALG00000037735","16",2624745,2626354,1609
"12994","ENSGALG00000037737","20",1451744,1455590,3846
"12995","ENSGALG00000037739","9",5240006,5256309,16303
"12996","ENSGALG00000037740","4",54070856,54090538,19682
"12997","ENSGALG00000037742","1",134912417,134912499,82
"12998","ENSGALG00000037744","26",260153,289532,29379
"12999","ENSGALG00000037747","5",53474760,53493274,18514
"13000","ENSGALG00000037758","8",7048588,7060468,11880
"13001","ENSGALG00000037769","2",18124237,18368109,243872
"13002","ENSGALG00000037773","2",142083463,142108042,24579
"13003","ENSGALG00000037776","13",1605141,1611755,6614
"13004","ENSGALG00000037777","2",117209361,117210782,1421
"13005","ENSGALG00000037778","7",93419,111688,18269
"13006","ENSGALG00000037780","20",11499475,11529472,29997
"13007","ENSGALG00000037781","4",34623429,34628330,4901
"13008","ENSGALG00000037784","12",2862603,2898532,35929
"13009","ENSGALG00000037787","25",2742938,2796048,53110
"13010","ENSGALG00000037791","12",15745789,15810437,64648
"13011","ENSGALG00000037802","25",1556898,1565379,8481
"13012","ENSGALG00000037805","KZ626826.1",5251,9454,4203
"13013","ENSGALG00000037807","1",77649727,77654873,5146
"13014","ENSGALG00000037810","9",10007773,10030126,22353
"13015","ENSGALG00000037811","2",57938760,57945892,7132
"13016","ENSGALG00000037812","18",2202453,2210330,7877
"13017","ENSGALG00000037816","4",11198473,11214867,16394
"13018","ENSGALG00000037819","1",191809016,191813781,4765
"13019","ENSGALG00000037826","33",6001570,6007297,5727
"13020","ENSGALG00000037828","19",7007733,7015663,7930
"13021","ENSGALG00000037829","Z",1917367,2035364,117997
"13022","ENSGALG00000037837","14",13973612,13994515,20903
"13023","ENSGALG00000037838","MT",16184,16705,521
"13024","ENSGALG00000037839","1",197432706,197438520,5814
"13025","ENSGALG00000037841","12",19261785,19486230,224445
"13026","ENSGALG00000037842","1",1997923,2047067,49144
"13027","ENSGALG00000037851","13",17430079,17432050,1971
"13028","ENSGALG00000037852","8",4187219,4193131,5912
"13029","ENSGALG00000037854","5",326516,330167,3651
"13030","ENSGALG00000037856","12",17603136,17707996,104860
"13031","ENSGALG00000037860","22",3850881,3853124,2243
"13032","ENSGALG00000037863","2",52114901,52118653,3752
"13033","ENSGALG00000037864","18",458826,477172,18346
"13034","ENSGALG00000037867","2",121261331,121266050,4719
"13035","ENSGALG00000037869","25",3351408,3362735,11327
"13036","ENSGALG00000037870","7",23202420,23229758,27338
"13037","ENSGALG00000037872","3",103966616,104035930,69314
"13038","ENSGALG00000037875","9",6093531,6111344,17813
"13039","ENSGALG00000037878","33",5128764,5133194,4430
"13040","ENSGALG00000037879","32",142936,145809,2873
"13041","ENSGALG00000037880","Z",2151248,2159334,8086
"13042","ENSGALG00000037888","28",1140092,1145539,5447
"13043","ENSGALG00000037889","20",2838132,3266482,428350
"13044","ENSGALG00000037894","3",31801608,31831040,29432
"13045","ENSGALG00000037896","32",409176,413350,4174
"13046","ENSGALG00000037901","3",269054,321343,52289
"13047","ENSGALG00000037904","6",12236270,12237861,1591
"13048","ENSGALG00000037913","2",129101240,129103618,2378
"13049","ENSGALG00000037919","3",101740045,101811358,71313
"13050","ENSGALG00000037925","33",3405483,3409262,3779
"13051","ENSGALG00000037929","33",5033336,5044090,10754
"13052","ENSGALG00000037932","22",5261832,5267833,6001
"13053","ENSGALG00000037933","2",126004801,126011030,6229
"13054","ENSGALG00000037935","27",7217090,7233200,16110
"13055","ENSGALG00000037939","11",532295,541816,9521
"13056","ENSGALG00000037940","2",54930529,54947966,17437
"13057","ENSGALG00000037941","33",7030948,7033033,2085
"13058","ENSGALG00000037943","14",7057348,7132158,74810
"13059","ENSGALG00000037944","7",16367466,16405079,37613
"13060","ENSGALG00000037946","33",6353086,6357287,4201
"13061","ENSGALG00000037950","10",1343617,1375029,31412
"13062","ENSGALG00000037953","33",7117397,7121192,3795
"13063","ENSGALG00000037955","2",126250048,126274919,24871
"13064","ENSGALG00000037957","3",2452397,2454234,1837
"13065","ENSGALG00000037962","1",106340924,106348250,7326
"13066","ENSGALG00000037968","5",21645014,21658978,13964
"13067","ENSGALG00000037975","2",122705158,122724398,19240
"13068","ENSGALG00000037980","16",711839,736706,24867
"13069","ENSGALG00000037983","14",12661871,12678159,16288
"13070","ENSGALG00000037985","7",12574184,12574260,76
"13071","ENSGALG00000037989","1",106593970,106604799,10829
"13072","ENSGALG00000037991","12",9530099,9530746,647
"13073","ENSGALG00000037992","2",124616036,124623485,7449
"13074","ENSGALG00000037995","26",1318282,1330732,12450
"13075","ENSGALG00000037996","3",24007333,24012394,5061
"13076","ENSGALG00000037997","2",128211045,128243190,32145
"13077","ENSGALG00000037998","15",7141836,7143997,2161
"13078","ENSGALG00000038000","2",44330678,44340445,9767
"13079","ENSGALG00000038003","17",913858,917057,3199
"13080","ENSGALG00000038018","30",993798,1011458,17660
"13081","ENSGALG00000038021","24",5995765,6024815,29050
"13082","ENSGALG00000038022","2",144555101,144755284,200183
"13083","ENSGALG00000038026","1",64536241,64585951,49710
"13084","ENSGALG00000038032","10",10589918,10600015,10097
"13085","ENSGALG00000038034","KZ626838.1",778994,791905,12911
"13086","ENSGALG00000038041","2",26038888,26193651,154763
"13087","ENSGALG00000038042","13",7778960,7849986,71026
"13088","ENSGALG00000038043","6",20620876,20653897,33021
"13089","ENSGALG00000038044","1",383297,387604,4307
"13090","ENSGALG00000038054","6",33119433,33136522,17089
"13091","ENSGALG00000038058","3",41420583,41425931,5348
"13092","ENSGALG00000038059","5",23351916,23379900,27984
"13093","ENSGALG00000038065","32",170673,178234,7561
"13094","ENSGALG00000038069","2",44316108,44319487,3379
"13095","ENSGALG00000038075","1",77794127,77801247,7120
"13096","ENSGALG00000038084","26",1254072,1257466,3394
"13097","ENSGALG00000038087","14",7139995,7157615,17620
"13098","ENSGALG00000038089","2",51811980,51959426,147446
"13099","ENSGALG00000038090","1",25554762,25711679,156917
"13100","ENSGALG00000038096","19",9342031,9361245,19214
"13101","ENSGALG00000038097","24",417755,426121,8366
"13102","ENSGALG00000038102","2",4081290,4090691,9401
"13103","ENSGALG00000038109","27",6625586,6629571,3985
"13104","ENSGALG00000038110","33",7096155,7101414,5259
"13105","ENSGALG00000038128","13",1638996,1671253,32257
"13106","ENSGALG00000038129","27",7912340,7914343,2003
"13107","ENSGALG00000038133","13",13767717,13769325,1608
"13108","ENSGALG00000038138","21",2786418,2789859,3441
"13109","ENSGALG00000038141","1",51574103,51584520,10417
"13110","ENSGALG00000038143","5",562529,566539,4010
"13111","ENSGALG00000038145","17",672266,692114,19848
"13112","ENSGALG00000038146","19",558650,564550,5900
"13113","ENSGALG00000038152","14",8092682,8116502,23820
"13114","ENSGALG00000038154","1",183975461,184057285,81824
"13115","ENSGALG00000038155","22",3012151,3020886,8735
"13116","ENSGALG00000038160","4",85439553,85464361,24808
"13117","ENSGALG00000038162","3",63853190,63861087,7897
"13118","ENSGALG00000038167","17",8021486,8021626,140
"13119","ENSGALG00000038174","2",61066426,61066531,105
"13120","ENSGALG00000038175","2",148856866,148862408,5542
"13121","ENSGALG00000038187","1",1976735,1988947,12212
"13122","ENSGALG00000038188","3",57527019,57529448,2429
"13123","ENSGALG00000038189","28",3485092,3488497,3405
"13124","ENSGALG00000038191","3",104724033,104740102,16069
"13125","ENSGALG00000038192","12",3704691,3710258,5567
"13126","ENSGALG00000038201","28",5084146,5090404,6258
"13127","ENSGALG00000038202","13",8632094,8645206,13112
"13128","ENSGALG00000038207","22",99432,102735,3303
"13129","ENSGALG00000038209","16",2510124,2514505,4381
"13130","ENSGALG00000038217","5",22211473,22245391,33918
"13131","ENSGALG00000038218","23",2313058,2316246,3188
"13132","ENSGALG00000038219","33",6301741,6305520,3779
"13133","ENSGALG00000038222","18",7022413,7043136,20723
"13134","ENSGALG00000038223","17",2832458,2858968,26510
"13135","ENSGALG00000038225","1",9659444,9790390,130946
"13136","ENSGALG00000038229","33",6294936,6301279,6343
"13137","ENSGALG00000038231","25",3902218,3904457,2239
"13138","ENSGALG00000038238","4",21199389,21203422,4033
"13139","ENSGALG00000038241","Z",73348208,73349070,862
"13140","ENSGALG00000038242","12",1874442,2001509,127067
"13141","ENSGALG00000038243","MT",10708,10775,67
"13142","ENSGALG00000038254","6",32353434,32362063,8629
"13143","ENSGALG00000038256","33",3679355,3679929,574
"13144","ENSGALG00000038257","31",2432061,2432362,301
"13145","ENSGALG00000038260","Z",25250237,25266771,16534
"13146","ENSGALG00000038265","2",33231086,33475464,244378
"13147","ENSGALG00000038266","10",10527174,10532107,4933
"13148","ENSGALG00000038269","5",514262,515368,1106
"13149","ENSGALG00000038275","9",23692780,23692876,96
"13150","ENSGALG00000038278","16",2349021,2458853,109832
"13151","ENSGALG00000038283","MT",9016,9083,67
"13152","ENSGALG00000038284","1",149443787,149445663,1876
"13153","ENSGALG00000038286","10",9577361,9595610,18249
"13154","ENSGALG00000038290","18",9917130,9925495,8365
"13155","ENSGALG00000038292","5",485844,487737,1893
"13156","ENSGALG00000038299","22",5212638,5230538,17900
"13157","ENSGALG00000038301","15",11387752,11393899,6147
"13158","ENSGALG00000038311","7",6651455,6681167,29712
"13159","ENSGALG00000038313","21",4933765,4936536,2771
"13160","ENSGALG00000038320","8",8110184,8142724,32540
"13161","ENSGALG00000038325","14",13094421,13131792,37371
"13162","ENSGALG00000038328","2",78183490,78221561,38071
"13163","ENSGALG00000038330","2",344557,351751,7194
"13164","ENSGALG00000038336","4",34169543,34226959,57416
"13165","ENSGALG00000038338","14",14737250,14761104,23854
"13166","ENSGALG00000038340","2",100241333,100243364,2031
"13167","ENSGALG00000038355","20",1255929,1258984,3055
"13168","ENSGALG00000038363","19",285302,285438,136
"13169","ENSGALG00000038364","2",136482292,136487586,5294
"13170","ENSGALG00000038372","4",45315298,45317252,1954
"13171","ENSGALG00000038374","11",6176432,6187342,10910
"13172","ENSGALG00000038377","24",1005794,1014040,8246
"13173","ENSGALG00000038385","2",114804766,114825447,20681
"13174","ENSGALG00000038391","8",24306274,24323332,17058
"13175","ENSGALG00000038393","16",2589290,2592336,3046
"13176","ENSGALG00000038395","2",114828582,114898800,70218
"13177","ENSGALG00000038396","6",32278486,32298582,20096
"13178","ENSGALG00000038399","26",1736524,1776457,39933
"13179","ENSGALG00000038400","25",3926370,3929942,3572
"13180","ENSGALG00000038405","1",77388128,77429662,41534
"13181","ENSGALG00000038411","8",5931414,5934325,2911
"13182","ENSGALG00000038413","17",7155688,7158407,2719
"13183","ENSGALG00000038416","6",20291235,20309081,17846
"13184","ENSGALG00000038420","3",61386544,61409041,22497
"13185","ENSGALG00000038421","8",13715182,13724764,9582
"13186","ENSGALG00000038425","3",71751287,71752564,1277
"13187","ENSGALG00000038426","Z",937525,940652,3127
"13188","ENSGALG00000038428","26",5153922,5163862,9940
"13189","ENSGALG00000038432","3",9011945,9069715,57770
"13190","ENSGALG00000038433","4",84851297,84898911,47614
"13191","ENSGALG00000038440","7",10211054,10219664,8610
"13192","ENSGALG00000038448","3",106368937,106369017,80
"13193","ENSGALG00000038454","1",177407378,177413286,5908
"13194","ENSGALG00000038458","10",2780867,2794265,13398
"13195","ENSGALG00000038461","Z",380895,391872,10977
"13196","ENSGALG00000038462","28",5000580,5009430,8850
"13197","ENSGALG00000038467","1",20448935,20462470,13535
"13198","ENSGALG00000038469","2",629830,642787,12957
"13199","ENSGALG00000038480","6",33491715,33502673,10958
"13200","ENSGALG00000038481","23",505940,513174,7234
"13201","ENSGALG00000038484","20",5378160,5380769,2609
"13202","ENSGALG00000038488","23",2395539,2404208,8669
"13203","ENSGALG00000038494","11",15556046,15651941,95895
"13204","ENSGALG00000038495","3",96396186,96484432,88246
"13205","ENSGALG00000038502","14",14610473,14620528,10055
"13206","ENSGALG00000038504","1",125930064,126095986,165922
"13207","ENSGALG00000038506","30",461847,463739,1892
"13208","ENSGALG00000038512","9",12538281,12559258,20977
"13209","ENSGALG00000038513","6",17794633,17800998,6365
"13210","ENSGALG00000038515","14",3626463,3636842,10379
"13211","ENSGALG00000038520","1",1393886,1407780,13894
"13212","ENSGALG00000038522","2",981517,991608,10091
"13213","ENSGALG00000038523","33",7441628,7441689,61
"13214","ENSGALG00000038527","1",75379,90530,15151
"13215","ENSGALG00000038528","3",16629075,16635829,6754
"13216","ENSGALG00000038529","28",2923340,2926579,3239
"13217","ENSGALG00000038532","21",614052,618958,4906
"13218","ENSGALG00000038536","23",328673,330558,1885
"13219","ENSGALG00000038540","24",4498522,4569876,71354
"13220","ENSGALG00000038541","5",292983,296816,3833
"13221","ENSGALG00000038543","7",20946474,21036251,89777
"13222","ENSGALG00000038546","1",12697292,12704118,6826
"13223","ENSGALG00000038549","3",2416491,2431112,14621
"13224","ENSGALG00000038550","10",635399,798787,163388
"13225","ENSGALG00000038551","1",195122972,195127235,4263
"13226","ENSGALG00000038556","1",51221544,51223454,1910
"13227","ENSGALG00000038559","4",85657238,85736578,79340
"13228","ENSGALG00000038561","4",77044422,77139060,94638
"13229","ENSGALG00000038574","18",4814672,4820273,5601
"13230","ENSGALG00000038575","18",9216876,9219065,2189
"13231","ENSGALG00000038576","13",12088961,12092118,3157
"13232","ENSGALG00000038579","33",5356373,5369524,13151
"13233","ENSGALG00000038580","2",119293610,119306556,12946
"13234","ENSGALG00000038582","13",13702288,13714011,11723
"13235","ENSGALG00000038583","7",3763346,3781055,17709
"13236","ENSGALG00000038584","20",1125492,1158276,32784
"13237","ENSGALG00000038585","4",49197876,49203385,5509
"13238","ENSGALG00000038589","12",3541944,3542857,913
"13239","ENSGALG00000038593","6",8764963,8765694,731
"13240","ENSGALG00000038595","16",1750463,1753075,2612
"13241","ENSGALG00000038596","5",46461828,46487764,25936
"13242","ENSGALG00000038598","31",5637353,5647299,9946
"13243","ENSGALG00000038599","1",49586528,49592119,5591
"13244","ENSGALG00000038601","9",3823425,3834615,11190
"13245","ENSGALG00000038604","27",5989394,5993522,4128
"13246","ENSGALG00000038606","6",25190105,25192520,2415
"13247","ENSGALG00000038608","8",25461925,25466172,4247
"13248","ENSGALG00000038612","9",9559175,9583851,24676
"13249","ENSGALG00000038613","1",168890631,168903728,13097
"13250","ENSGALG00000038614","9",16358585,16358765,180
"13251","ENSGALG00000038618","10",9103713,9114499,10786
"13252","ENSGALG00000038624","12",3548415,3550704,2289
"13253","ENSGALG00000038627","13",8904856,8925377,20521
"13254","ENSGALG00000038629","28",3202721,3234192,31471
"13255","ENSGALG00000038634","4",65269770,65321836,52066
"13256","ENSGALG00000038635","2",100866009,100872937,6928
"13257","ENSGALG00000038636","23",380586,395018,14432
"13258","ENSGALG00000038637","10",1314077,1328544,14467
"13259","ENSGALG00000038639","3",104451464,104458538,7074
"13260","ENSGALG00000038645","27",5798929,5800802,1873
"13261","ENSGALG00000038646","2",43911603,43920633,9030
"13262","ENSGALG00000038648","33",7470778,7470842,64
"13263","ENSGALG00000038649","1",106776186,106781484,5298
"13264","ENSGALG00000038650","22",1933141,1935249,2108
"13265","ENSGALG00000038652","3",88407353,88419645,12292
"13266","ENSGALG00000038657","2",613636,620567,6931
"13267","ENSGALG00000038666","30",1059726,1062070,2344
"13268","ENSGALG00000038667","32",107756,108482,726
"13269","ENSGALG00000038668","13",842607,844093,1486
"13270","ENSGALG00000038671","18",9873216,9874223,1007
"13271","ENSGALG00000038672","23",1656008,1656514,506
"13272","ENSGALG00000038678","2",100148458,100212328,63870
"13273","ENSGALG00000038681","4",2181979,2182561,582
"13274","ENSGALG00000038683","1",56545979,56551799,5820
"13275","ENSGALG00000038684","12",9789679,9901939,112260
"13276","ENSGALG00000038688","10",17545577,17715273,169696
"13277","ENSGALG00000038692","33",3635712,3636999,1287
"13278","ENSGALG00000038704","2",47997352,48010957,13605
"13279","ENSGALG00000038707","1",596813,596909,96
"13280","ENSGALG00000038708","23",5088088,5103045,14957
"13281","ENSGALG00000038710","1",71797826,71804003,6177
"13282","ENSGALG00000038714","30",901099,904843,3744
"13283","ENSGALG00000038720","3",65887688,65893668,5980
"13284","ENSGALG00000038721","20",1406123,1432543,26420
"13285","ENSGALG00000038722","6",17155446,17276941,121495
"13286","ENSGALG00000038723","Z",7909086,7911236,2150
"13287","ENSGALG00000038727","3",2484038,2494920,10882
"13288","ENSGALG00000038728","4",361731,375459,13728
"13289","ENSGALG00000038730","9",1161552,1223346,61794
"13290","ENSGALG00000038733","2",43663532,43767508,103976
"13291","ENSGALG00000038740","8",440100,444521,4421
"13292","ENSGALG00000038745","2",116753612,116766886,13274
"13293","ENSGALG00000038747","9",24036053,24042090,6037
"13294","ENSGALG00000038748","23",2551024,2555961,4937
"13295","ENSGALG00000038752","12",7333284,7346198,12914
"13296","ENSGALG00000038753","13",16440102,16452190,12088
"13297","ENSGALG00000038755","28",3716519,3728552,12033
"13298","ENSGALG00000038757","33",6916898,6919982,3084
"13299","ENSGALG00000038758","11",444251,449004,4753
"13300","ENSGALG00000038760","MT",5172,5240,68
"13301","ENSGALG00000038763","1",180756469,180805958,49489
"13302","ENSGALG00000038767","5",524540,527691,3151
"13303","ENSGALG00000038768","14",2130706,2182145,51439
"13304","ENSGALG00000038769","18",10539931,10546076,6145
"13305","ENSGALG00000038771","4",49079391,49136257,56866
"13306","ENSGALG00000038772","2",128339132,128375825,36693
"13307","ENSGALG00000038775","5",6640438,6815435,174997
"13308","ENSGALG00000038776","8",16703837,16727351,23514
"13309","ENSGALG00000038780","21",5129879,5166706,36827
"13310","ENSGALG00000038782","3",48204075,48212692,8617
"13311","ENSGALG00000038783","22",5139565,5148912,9347
"13312","ENSGALG00000038787","4",88341840,88377988,36148
"13313","ENSGALG00000038789","17",778807,781437,2630
"13314","ENSGALG00000038797","20",5056201,5061578,5377
"13315","ENSGALG00000038799","6",20761634,20762959,1325
"13316","ENSGALG00000038801","33",6893346,6897535,4189
"13317","ENSGALG00000038806","1",15402105,15407388,5283
"13318","ENSGALG00000038810","25",3955647,3958419,2772
"13319","ENSGALG00000038812","18",10388535,10391785,3250
"13320","ENSGALG00000038813","7",18661647,18671004,9357
"13321","ENSGALG00000038817","Z",43564225,43567168,2943
"13322","ENSGALG00000038820","2",2440971,2443401,2430
"13323","ENSGALG00000038834","1",11833981,12556826,722845
"13324","ENSGALG00000038838","2",112065704,112096272,30568
"13325","ENSGALG00000038848","13",10514513,10519859,5346
"13326","ENSGALG00000038850","12",6869736,6975801,106065
"13327","ENSGALG00000038853","18",9546614,9551309,4695
"13328","ENSGALG00000038858","20",12991935,13000019,8084
"13329","ENSGALG00000038865","11",270345,287908,17563
"13330","ENSGALG00000038873","18",5868146,5903595,35449
"13331","ENSGALG00000038875","18",9866479,9871615,5136
"13332","ENSGALG00000038884","14",13059180,13078199,19019
"13333","ENSGALG00000038885","24",154552,164455,9903
"13334","ENSGALG00000038896","23",5366529,5372344,5815
"13335","ENSGALG00000038902","26",238271,241790,3519
"13336","ENSGALG00000038904","12",15721935,15731462,9527
"13337","ENSGALG00000038913","5",19507937,19608245,100308
"13338","ENSGALG00000038915","2",122608915,122621351,12436
"13339","ENSGALG00000038918","4",85905885,85907049,1164
"13340","ENSGALG00000038919","20",3658590,3661843,3253
"13341","ENSGALG00000038920","1",64739100,64766110,27010
"13342","ENSGALG00000038923","11",11180971,11193897,12926
"13343","ENSGALG00000038924","6",21719516,21764342,44826
"13344","ENSGALG00000038926","2",446008,452615,6607
"13345","ENSGALG00000038930","Z",6156148,6256742,100594
"13346","ENSGALG00000038933","3",61282801,61286154,3353
"13347","ENSGALG00000038935","1",51030714,51033021,2307
"13348","ENSGALG00000038936","1",135354534,135378734,24200
"13349","ENSGALG00000038939","33",7426174,7432012,5838
"13350","ENSGALG00000038940","2",128283220,128303620,20400
"13351","ENSGALG00000038943","26",2489952,2508040,18088
"13352","ENSGALG00000038946","2",138114616,138119541,4925
"13353","ENSGALG00000038948","26",544801,573605,28804
"13354","ENSGALG00000038951","12",1850401,1855177,4776
"13355","ENSGALG00000038952","15",11087868,11094901,7033
"13356","ENSGALG00000038954","13",12004367,12008463,4096
"13357","ENSGALG00000038957","11",11323708,11336053,12345
"13358","ENSGALG00000038964","9",2840729,2861736,21007
"13359","ENSGALG00000038966","1",51286157,51332983,46826
"13360","ENSGALG00000038969","1",48088780,48089278,498
"13361","ENSGALG00000038971","2",126377895,126392868,14973
"13362","ENSGALG00000038972","3",4433333,4455831,22498
"13363","ENSGALG00000038975","AADN05001505.1",14603,19437,4834
"13364","ENSGALG00000038978","2",47233382,47280252,46870
"13365","ENSGALG00000038981","1",14949364,14955883,6519
"13366","ENSGALG00000038984","23",5603905,5610641,6736
"13367","ENSGALG00000038994","32",181451,189326,7875
"13368","ENSGALG00000038995","1",182497747,182719908,222161
"13369","ENSGALG00000039001","3",80691191,80766290,75099
"13370","ENSGALG00000039005","14",10525431,10535948,10517
"13371","ENSGALG00000039008","11",17036585,17046954,10369
"13372","ENSGALG00000039011","2",129839389,129867420,28031
"13373","ENSGALG00000039013","2",135873550,136036349,162799
"13374","ENSGALG00000039016","1",65599976,65602263,2287
"13375","ENSGALG00000039022","33",6022235,6034993,12758
"13376","ENSGALG00000039023","W",4790077,4947834,157757
"13377","ENSGALG00000039029","1",192365090,192366025,935
"13378","ENSGALG00000039032","5",19419316,19420470,1154
"13379","ENSGALG00000039034","2",88407284,88439989,32705
"13380","ENSGALG00000039037","1",191633098,191693907,60809
"13381","ENSGALG00000039040","3",3491748,3495862,4114
"13382","ENSGALG00000039048","2",586056,590634,4578
"13383","ENSGALG00000039051","33",7622308,7637089,14781
"13384","ENSGALG00000039061","17",929291,930911,1620
"13385","ENSGALG00000039068","1",194375025,194427283,52258
"13386","ENSGALG00000039071","25",3456765,3465111,8346
"13387","ENSGALG00000039072","25",2640456,2644375,3919
"13388","ENSGALG00000039074","4",68388976,68395232,6256
"13389","ENSGALG00000039080","5",19191268,19248208,56940
"13390","ENSGALG00000039084","19",9173852,9177498,3646
"13391","ENSGALG00000039088","30",241789,247265,5476
"13392","ENSGALG00000039092","2",45701178,45771546,70368
"13393","ENSGALG00000039097","14",15178646,15188586,9940
"13394","ENSGALG00000039099","13",14644938,14665124,20186
"13395","ENSGALG00000039101","20",1567219,1596889,29670
"13396","ENSGALG00000039102","2",112154197,112372740,218543
"13397","ENSGALG00000039107","9",15448940,15451498,2558
"13398","ENSGALG00000039108","28",3402522,3411879,9357
"13399","ENSGALG00000039116","11",3231854,3236432,4578
"13400","ENSGALG00000039118","5",31437974,31606534,168560
"13401","ENSGALG00000039120","2",3930912,3957545,26633
"13402","ENSGALG00000039121","15",761641,774934,13293
"13403","ENSGALG00000039124","13",15192905,15230246,37341
"13404","ENSGALG00000039125","27",5506855,5508435,1580
"13405","ENSGALG00000039130","26",218391,232994,14603
"13406","ENSGALG00000039134","33",7434990,7463320,28330
"13407","ENSGALG00000039139","2",55050336,55235133,184797
"13408","ENSGALG00000039140","13",1613067,1614464,1397
"13409","ENSGALG00000039141","25",211764,215402,3638
"13410","ENSGALG00000039145","2",112701443,112753254,51811
"13411","ENSGALG00000039146","2",44348127,44354228,6101
"13412","ENSGALG00000039151","Z",434806,439882,5076
"13413","ENSGALG00000039152","7",33413850,33413965,115
"13414","ENSGALG00000039155","20",4936185,4966601,30416
"13415","ENSGALG00000039156","30",770562,784767,14205
"13416","ENSGALG00000039159","8",21957162,21965167,8005
"13417","ENSGALG00000039160","32",149457,157061,7604
"13418","ENSGALG00000039161","6",11300093,11315071,14978
"13419","ENSGALG00000039163","25",2543327,2564329,21002
"13420","ENSGALG00000039164","10",1382052,1406178,24126
"13421","ENSGALG00000039168","4",65762016,65941747,179731
"13422","ENSGALG00000039169","2",45962364,45978539,16175
"13423","ENSGALG00000039170","26",103162,106478,3316
"13424","ENSGALG00000039171","1",60533520,60546631,13111
"13425","ENSGALG00000039172","18",5007553,5044674,37121
"13426","ENSGALG00000039173","10",15117634,15137240,19606
"13427","ENSGALG00000039177","4",69043854,69050522,6668
"13428","ENSGALG00000039178","11",5015742,5089734,73992
"13429","ENSGALG00000039182","9",18059871,18184272,124401
"13430","ENSGALG00000039186","2",15395223,15398367,3144
"13431","ENSGALG00000039187","22",405357,409427,4070
"13432","ENSGALG00000039190","5",649566,650442,876
"13433","ENSGALG00000039193","21",2712119,2775214,63095
"13434","ENSGALG00000039196","24",4061201,4131571,70370
"13435","ENSGALG00000039200","18",7613207,7634458,21251
"13436","ENSGALG00000039203","22",3861634,3867074,5440
"13437","ENSGALG00000039205","25",2074652,2086546,11894
"13438","ENSGALG00000039206","22",3788778,3793564,4786
"13439","ENSGALG00000039208","12",6697998,6778773,80775
"13440","ENSGALG00000039209","1",34002232,34044011,41779
"13441","ENSGALG00000039212","28",3554000,3555101,1101
"13442","ENSGALG00000039216","7",6782467,6808501,26034
"13443","ENSGALG00000039219","6",12257165,12275117,17952
"13444","ENSGALG00000039221","5",16259485,16322745,63260
"13445","ENSGALG00000039222","2",126174227,126200357,26130
"13446","ENSGALG00000039224","2",141378615,141394013,15398
"13447","ENSGALG00000039228","5",28553320,28555369,2049
"13448","ENSGALG00000039238","11",5932736,5950003,17267
"13449","ENSGALG00000039239","15",409259,417626,8367
"13450","ENSGALG00000039242","5",300441,302636,2195
"13451","ENSGALG00000039245","1",54771871,54848374,76503
"13452","ENSGALG00000039246","24",6287427,6288922,1495
"13453","ENSGALG00000039249","MT",16708,16775,67
"13454","ENSGALG00000039250","33",2198600,2201661,3061
"13455","ENSGALG00000039251","25",702860,704590,1730
"13456","ENSGALG00000039254","5",3034548,3063413,28865
"13457","ENSGALG00000039256","3",29348180,29371990,23810
"13458","ENSGALG00000039257","30",756102,763625,7523
"13459","ENSGALG00000039263","18",9139537,9141169,1632
"13460","ENSGALG00000039264","2",141829134,141867820,38686
"13461","ENSGALG00000039269","18",9489328,9537525,48197
"13462","ENSGALG00000039284","10",3646331,3657327,10996
"13463","ENSGALG00000039288","12",3555325,3570961,15636
"13464","ENSGALG00000039292","14",2802364,2804239,1875
"13465","ENSGALG00000039294","9",680308,692677,12369
"13466","ENSGALG00000039298","8",316040,317856,1816
"13467","ENSGALG00000039299","27",6858767,6878686,19919
"13468","ENSGALG00000039300","11",18970250,19029815,59565
"13469","ENSGALG00000039302","1",92756502,92771499,14997
"13470","ENSGALG00000039307","10",9323769,9344819,21050
"13471","ENSGALG00000039311","33",5028317,5029596,1279
"13472","ENSGALG00000039312","18",1678958,1689569,10611
"13473","ENSGALG00000039315","33",4126282,4132659,6377
"13474","ENSGALG00000039316","12",6788334,6838558,50224
"13475","ENSGALG00000039320","3",109877939,109899864,21925
"13476","ENSGALG00000039322","8",4193000,4199382,6382
"13477","ENSGALG00000039326","2",56182216,56185408,3192
"13478","ENSGALG00000039327","8",1386094,1534129,148035
"13479","ENSGALG00000039329","21",4397447,4404899,7452
"13480","ENSGALG00000039333","2",42755283,42766499,11216
"13481","ENSGALG00000039334","5",939736,975245,35509
"13482","ENSGALG00000039335","5",16016176,16051789,35613
"13483","ENSGALG00000039336","32",255198,258745,3547
"13484","ENSGALG00000039337","2",41391821,41434407,42586
"13485","ENSGALG00000039344","25",3288182,3290545,2363
"13486","ENSGALG00000039346","2",149036336,149118741,82405
"13487","ENSGALG00000039349","3",39543722,39731527,187805
"13488","ENSGALG00000039354","8",18989399,19032035,42636
"13489","ENSGALG00000039355","1",10360153,10375841,15688
"13490","ENSGALG00000039356","24",269631,274676,5045
"13491","ENSGALG00000039363","12",10777616,10797343,19727
"13492","ENSGALG00000039376","1",85034495,85061724,27229
"13493","ENSGALG00000039380","4",69696354,69792663,96309
"13494","ENSGALG00000039387","2",51148712,51155283,6571
"13495","ENSGALG00000039391","4",88185,95888,7703
"13496","ENSGALG00000039394","4",69799127,69815816,16689
"13497","ENSGALG00000039403","1",21072336,21395611,323275
"13498","ENSGALG00000039406","21",4931592,4933495,1903
"13499","ENSGALG00000039408","30",729916,746283,16367
"13500","ENSGALG00000039409","33",6490052,6498311,8259
"13501","ENSGALG00000039411","4",37577006,37642586,65580
"13502","ENSGALG00000039416","3",44037704,44052918,15214
"13503","ENSGALG00000039420","1",1323611,1333029,9418
"13504","ENSGALG00000039424","2",79184684,79211008,26324
"13505","ENSGALG00000039427","20",8543461,8549148,5687
"13506","ENSGALG00000039432","9",23681494,23683248,1754
"13507","ENSGALG00000039434","Z",1785332,1812672,27340
"13508","ENSGALG00000039436","7",17833099,17834041,942
"13509","ENSGALG00000039440","2",43625547,43626903,1356
"13510","ENSGALG00000039447","27",7349549,7359237,9688
"13511","ENSGALG00000039448","1",77587505,77611310,23805
"13512","ENSGALG00000039450","3",16713669,16754548,40879
"13513","ENSGALG00000039452","1",93831630,93850776,19146
"13514","ENSGALG00000039454","2",30405181,30428488,23307
"13515","ENSGALG00000039455","2",98345430,98375779,30349
"13516","ENSGALG00000039458","7",252348,257840,5492
"13517","ENSGALG00000039461","1",80183729,80196654,12925
"13518","ENSGALG00000039468","9",22422446,22447957,25511
"13519","ENSGALG00000039472","15",6802701,6816972,14271
"13520","ENSGALG00000039473","32",239381,243656,4275
"13521","ENSGALG00000039474","2",59731678,59733512,1834
"13522","ENSGALG00000039477","4",89679418,89688532,9114
"13523","ENSGALG00000039479","1",53270492,53286236,15744
"13524","ENSGALG00000039480","16",2404886,2405986,1100
"13525","ENSGALG00000039497","23",4435349,4450593,15244
"13526","ENSGALG00000039498","4",60301963,60491846,189883
"13527","ENSGALG00000039499","2",122586026,122605336,19310
"13528","ENSGALG00000039500","14",521014,546530,25516
"13529","ENSGALG00000039504","KZ626836.1",499549,611312,111763
"13530","ENSGALG00000039509","2",141763786,141794386,30600
"13531","ENSGALG00000039523","19",8338870,8344937,6067
"13532","ENSGALG00000039525","21",319229,343648,24419
"13533","ENSGALG00000039528","6",21081566,21200763,119197
"13534","ENSGALG00000039529","1",79206807,79285987,79180
"13535","ENSGALG00000039532","21",6504558,6505987,1429
"13536","ENSGALG00000039533","2",141286783,141354033,67250
"13537","ENSGALG00000039534","1",73858709,73876956,18247
"13538","ENSGALG00000039535","9",4934110,4943942,9832
"13539","ENSGALG00000039536","2",108494837,108497336,2499
"13540","ENSGALG00000039538","1",84300602,84309903,9301
"13541","ENSGALG00000039541","17",5730631,5755696,25065
"13542","ENSGALG00000039549","4",73376533,73408302,31769
"13543","ENSGALG00000039553","2",116289225,116346778,57553
"13544","ENSGALG00000039554","19",592731,604393,11662
"13545","ENSGALG00000039558","5",21660460,21713198,52738
"13546","ENSGALG00000039563","1",134748547,134759240,10693
"13547","ENSGALG00000039571","33",5425817,5426967,1150
"13548","ENSGALG00000039572","21",178543,188276,9733
"13549","ENSGALG00000039573","30",792438,834813,42375
"13550","ENSGALG00000039575","3",66336846,66352648,15802
"13551","ENSGALG00000039576","5",1014454,1019743,5289
"13552","ENSGALG00000039582","1",37933532,37969782,36250
"13553","ENSGALG00000039583","12",15882966,15968266,85300
"13554","ENSGALG00000039585","2",148375349,148379359,4010
"13555","ENSGALG00000039587","3",15796600,15900738,104138
"13556","ENSGALG00000039589","2",55305607,55312884,7277
"13557","ENSGALG00000039590","2",137959944,137968039,8095
"13558","ENSGALG00000039595","1",53377416,53545431,168015
"13559","ENSGALG00000039606","3",90980907,90987501,6594
"13560","ENSGALG00000039611","14",2988243,2996758,8515
"13561","ENSGALG00000039615","4",147238,187944,40706
"13562","ENSGALG00000039617","2",56115222,56123911,8689
"13563","ENSGALG00000039624","26",1212369,1221114,8745
"13564","ENSGALG00000039628","13",9243530,9261669,18139
"13565","ENSGALG00000039629","7",16312439,16313967,1528
"13566","ENSGALG00000039633","27",7002801,7003871,1070
"13567","ENSGALG00000039634","33",5188564,5202555,13991
"13568","ENSGALG00000039643","23",6094430,6096856,2426
"13569","ENSGALG00000039648","5",335480,337897,2417
"13570","ENSGALG00000039652","13",9145396,9152907,7511
"13571","ENSGALG00000039656","10",2087630,2092273,4643
"13572","ENSGALG00000039658","1",51196551,51205052,8501
"13573","ENSGALG00000039659","1",9908004,10213943,305939
"13574","ENSGALG00000039673","11",18470242,18514508,44266
"13575","ENSGALG00000039682","1",359020,371025,12005
"13576","ENSGALG00000039684","33",7660057,7660137,80
"13577","ENSGALG00000039685","20",9717686,9728495,10809
"13578","ENSGALG00000039687","13",12058552,12067941,9389
"13579","ENSGALG00000039688","4",53109436,53355868,246432
"13580","ENSGALG00000039690","2",120607154,120640534,33380
"13581","ENSGALG00000039696","17",765767,773576,7809
"13582","ENSGALG00000039698","13",10742348,10745744,3396
"13583","ENSGALG00000039701","KZ626819.1",96605,99211,2606
"13584","ENSGALG00000039704","8",4531000,4539897,8897
"13585","ENSGALG00000039705","13",14628119,14644387,16268
"13586","ENSGALG00000039708","28",1003379,1008537,5158
"13587","ENSGALG00000039710","33",5847783,5910234,62451
"13588","ENSGALG00000039712","18",118956,128669,9713
"13589","ENSGALG00000039713","23",4358966,4370617,11651
"13590","ENSGALG00000039720","3",16759348,16843993,84645
"13591","ENSGALG00000039724","15",5914102,5923066,8964
"13592","ENSGALG00000039727","6",1251914,1267478,15564
"13593","ENSGALG00000039733","28",1181751,1184394,2643
"13594","ENSGALG00000039734","33",5759528,5777842,18314
"13595","ENSGALG00000039735","5",48411424,48530200,118776
"13596","ENSGALG00000039738","2",55720265,55781809,61544
"13597","ENSGALG00000039741","21",5470172,5483241,13069
"13598","ENSGALG00000039742","16",2626854,2630699,3845
"13599","ENSGALG00000039751","1",186976289,186995037,18748
"13600","ENSGALG00000039754","2",50907225,50925523,18298
"13601","ENSGALG00000039755","KZ626837.1",1807723,1814054,6331
"13602","ENSGALG00000039756","3",60319457,60834072,514615
"13603","ENSGALG00000039764","1",76277358,76319559,42201
"13604","ENSGALG00000039772","3",35972263,36229904,257641
"13605","ENSGALG00000039773","30",851280,866661,15381
"13606","ENSGALG00000039774","2",113842567,113864467,21900
"13607","ENSGALG00000039775","25",3010170,3014866,4696
"13608","ENSGALG00000039779","14",12743712,12746237,2525
"13609","ENSGALG00000039780","8",7992152,7992425,273
"13610","ENSGALG00000039781","13",16368629,16373813,5184
"13611","ENSGALG00000039783","1",179929406,179931454,2048
"13612","ENSGALG00000039786","22",2646153,2661037,14884
"13613","ENSGALG00000039791","17",5775799,5788840,13041
"13614","ENSGALG00000039803","27",5493406,5496254,2848
"13615","ENSGALG00000039811","1",131761291,131775917,14626
"13616","ENSGALG00000039812","4",12282691,12284175,1484
"13617","ENSGALG00000039815","14",7930108,7951239,21131
"13618","ENSGALG00000039816","25",3791789,3805310,13521
"13619","ENSGALG00000039817","14",14405252,14405875,623
"13620","ENSGALG00000039818","11",1805278,1860794,55516
"13621","ENSGALG00000039822","5",7961978,7963360,1382
"13622","ENSGALG00000039826","1",133236289,133256347,20058
"13623","ENSGALG00000039830","2",772888,805221,32333
"13624","ENSGALG00000039831","2",144265089,144447528,182439
"13625","ENSGALG00000039837","1",197392646,197395026,2380
"13626","ENSGALG00000039839","18",3507166,3514650,7484
"13627","ENSGALG00000039843","2",128271931,128274318,2387
"13628","ENSGALG00000039855","14",554241,629731,75490
"13629","ENSGALG00000039861","1",20649179,20822048,172869
"13630","ENSGALG00000039863","19",164665,172742,8077
"13631","ENSGALG00000039864","22",4022734,4025741,3007
"13632","ENSGALG00000039865","25",2911727,2913531,1804
"13633","ENSGALG00000039866","31",4158743,4159570,827
"13634","ENSGALG00000039869","4",35039467,35039990,523
"13635","ENSGALG00000039872","13",17488920,17519533,30613
"13636","ENSGALG00000039878","26",4925640,4939940,14300
"13637","ENSGALG00000039880","2",6331554,6363279,31725
"13638","ENSGALG00000039882","2",129295113,129309973,14860
"13639","ENSGALG00000039883","23",135545,140954,5409
"13640","ENSGALG00000039887","25",3862075,3863720,1645
"13641","ENSGALG00000039891","25",639275,652509,13234
"13642","ENSGALG00000039895","21",4324111,4330758,6647
"13643","ENSGALG00000039896","4",9103864,9106821,2957
"13644","ENSGALG00000039897","10",3943582,3950138,6556
"13645","ENSGALG00000039899","AADN05001187.1",18168,20667,2499
"13646","ENSGALG00000039900","2",60571714,60591771,20057
"13647","ENSGALG00000039901","2",149437442,149465150,27708
"13648","ENSGALG00000039903","15",10179817,10186819,7002
"13649","ENSGALG00000039917","6",23305911,23307580,1669
"13650","ENSGALG00000039919","KZ626835.1",99172,123252,24080
"13651","ENSGALG00000039920","2",40962383,40987688,25305
"13652","ENSGALG00000039923","2",107155022,107156950,1928
"13653","ENSGALG00000039924","10",9715714,9764625,48911
"13654","ENSGALG00000039935","2",48126705,48416766,290061
"13655","ENSGALG00000039936","22",1737582,1778261,40679
"13656","ENSGALG00000039942","4",84541204,84762592,221388
"13657","ENSGALG00000039951","14",12871040,12889227,18187
"13658","ENSGALG00000039958","1",177480164,177499171,19007
"13659","ENSGALG00000039964","16",2333312,2337847,4535
"13660","ENSGALG00000039965","2",99975826,99983369,7543
"13661","ENSGALG00000039967","21",4856555,4863754,7199
"13662","ENSGALG00000039970","33",5965254,5972154,6900
"13663","ENSGALG00000039974","30",836758,847756,10998
"13664","ENSGALG00000039977","18",499232,517534,18302
"13665","ENSGALG00000039978","27",5419090,5434440,15350
"13666","ENSGALG00000039979","1",141449287,141454491,5204
"13667","ENSGALG00000039982","1",1303775,1313361,9586
"13668","ENSGALG00000039983","2",46739295,46798842,59547
"13669","ENSGALG00000039985","11",12119543,12198657,79114
"13670","ENSGALG00000039989","9",20022139,20024015,1876
"13671","ENSGALG00000039990","17",3013995,3098173,84178
"13672","ENSGALG00000039995","13",10056312,10061282,4970
"13673","ENSGALG00000039999","2",12843397,12845408,2011
"13674","ENSGALG00000040000","3",37863579,37889231,25652
"13675","ENSGALG00000040001","1",100328305,100430000,101695
"13676","ENSGALG00000040002","25",2471754,2479000,7246
"13677","ENSGALG00000040003","17",2804710,2819836,15126
"13678","ENSGALG00000040005","3",4249995,4271262,21267
"13679","ENSGALG00000040006","1",126545073,126745367,200294
"13680","ENSGALG00000040007","1",180137515,180137865,350
"13681","ENSGALG00000040008","28",3095142,3129760,34618
"13682","ENSGALG00000040010","6",34545736,34558940,13204
"13683","ENSGALG00000040015","4",79278653,79281441,2788
"13684","ENSGALG00000040016","5",202236,204543,2307
"13685","ENSGALG00000040017","27",7106164,7164078,57914
"13686","ENSGALG00000040018","1",197038928,197076757,37829
"13687","ENSGALG00000040021","2",32662566,32666093,3527
"13688","ENSGALG00000040023","1",20565752,20594690,28938
"13689","ENSGALG00000040026","5",53031545,53041637,10092
"13690","ENSGALG00000040028","2",44367312,44413014,45702
"13691","ENSGALG00000040030","24",5691034,5714141,23107
"13692","ENSGALG00000040031","9",892848,898559,5711
"13693","ENSGALG00000040035","13",9348431,9371027,22596
"13694","ENSGALG00000040038","1",20257352,20275372,18020
"13695","ENSGALG00000040041","13",1621409,1623826,2417
"13696","ENSGALG00000040044","32",244036,246753,2717
"13697","ENSGALG00000040045","17",7312155,7320900,8745
"13698","ENSGALG00000040050","27",7431893,7433484,1591
"13699","ENSGALG00000040051","5",33186355,33206970,20615
"13700","ENSGALG00000040055","6",787301,790494,3193
"13701","ENSGALG00000040059","1",106444683,106445360,677
"13702","ENSGALG00000040060","1",1439043,1475012,35969
"13703","ENSGALG00000040063","5",54121201,54149274,28073
"13704","ENSGALG00000040065","19",5404924,5408244,3320
"13705","ENSGALG00000040068","KZ626836.1",267494,271025,3531
"13706","ENSGALG00000040070","14",12628861,12633440,4579
"13707","ENSGALG00000040079","2",130175913,130483288,307375
"13708","ENSGALG00000040084","2",57852221,57864434,12213
"13709","ENSGALG00000040086","W",4704235,4724025,19790
"13710","ENSGALG00000040087","10",1604895,1646564,41669
"13711","ENSGALG00000040089","9",24057105,24083265,26160
"13712","ENSGALG00000040097","2",117972239,118005082,32843
"13713","ENSGALG00000040098","2",148865563,148883104,17541
"13714","ENSGALG00000040101","16",2272154,2410307,138153
"13715","ENSGALG00000040109","13",12764337,12803848,39511
"13716","ENSGALG00000040113","9",1566800,1567411,611
"13717","ENSGALG00000040114","1",23044093,23176470,132377
"13718","ENSGALG00000040115","2",104902183,104957421,55238
"13719","ENSGALG00000040120","5",178109,184568,6459
"13720","ENSGALG00000040128","15",378574,387640,9066
"13721","ENSGALG00000040130","20",10880794,10885745,4951
"13722","ENSGALG00000040131","15",5736465,5747274,10809
"13723","ENSGALG00000040133","KZ626835.1",418070,420043,1973
"13724","ENSGALG00000040136","Z",2160803,2176161,15358
"13725","ENSGALG00000040141","13",16116567,16161844,45277
"13726","ENSGALG00000040152","13",8569417,8591200,21783
"13727","ENSGALG00000040153","8",21486247,21487425,1178
"13728","ENSGALG00000040155","24",5490620,5500101,9481
"13729","ENSGALG00000040156","5",44452433,44535237,82804
"13730","ENSGALG00000040157","14",6377467,6388772,11305
"13731","ENSGALG00000040159","10",1115982,1118608,2626
"13732","ENSGALG00000040161","2",51141125,51145397,4272
"13733","ENSGALG00000040167","2",120793736,120829098,35362
"13734","ENSGALG00000040168","26",1239193,1240533,1340
"13735","ENSGALG00000040173","5",534391,536046,1655
"13736","ENSGALG00000040178","7",36717555,36721350,3795
"13737","ENSGALG00000040180","2",107911432,107912427,995
"13738","ENSGALG00000040181","10",2903249,2925374,22125
"13739","ENSGALG00000040182","28",3270292,3274542,4250
"13740","ENSGALG00000040184","1",75676381,75723185,46804
"13741","ENSGALG00000040185","16",2341445,2347657,6212
"13742","ENSGALG00000040189","1",110342171,110362181,20010
"13743","ENSGALG00000040194","33",6255193,6255244,51
"13744","ENSGALG00000040195","6",11801208,11805457,4249
"13745","ENSGALG00000040205","13",4183048,4211094,28046
"13746","ENSGALG00000040212","2",42699453,42723188,23735
"13747","ENSGALG00000040221","Z",9072456,9075192,2736
"13748","ENSGALG00000040224","24",445576,450171,4595
"13749","ENSGALG00000040238","3",109841102,109841659,557
"13750","ENSGALG00000040241","10",13669102,13847266,178164
"13751","ENSGALG00000040244","18",3765314,3832983,67669
"13752","ENSGALG00000040247","5",659384,661828,2444
"13753","ENSGALG00000040248","2",126348499,126364242,15743
"13754","ENSGALG00000040249","2",114381432,114383485,2053
"13755","ENSGALG00000040254","20",1275553,1328730,53177
"13756","ENSGALG00000040256","2",129350229,129792370,442141
"13757","ENSGALG00000040258","30",424835,428758,3923
"13758","ENSGALG00000040260","33",7109678,7113350,3672
"13759","ENSGALG00000040264","9",1225609,1232084,6475
"13760","ENSGALG00000040265","15",6932850,6943173,10323
"13761","ENSGALG00000040266","2",50700827,50894639,193812
"13762","ENSGALG00000040267","5",1019913,1035629,15716
"13763","ENSGALG00000040269","20",6483833,6496693,12860
"13764","ENSGALG00000040270","25",287155,294351,7196
"13765","ENSGALG00000040272","1",15818747,15825318,6571
"13766","ENSGALG00000040275","1",92961990,92997116,35126
"13767","ENSGALG00000040276","3",109295891,109443058,147167
"13768","ENSGALG00000040279","23",2538276,2544293,6017
"13769","ENSGALG00000040291","4",90975706,90984000,8294
"13770","ENSGALG00000040292","8",5180248,5184770,4522
"13771","ENSGALG00000040296","MT",3967,4040,73
"13772","ENSGALG00000040297","21",4771780,4781256,9476
"13773","ENSGALG00000040298","2",52664034,53001435,337401
"13774","ENSGALG00000040307","3",16669538,16674256,4718
"13775","ENSGALG00000040308","18",9193416,9208314,14898
"13776","ENSGALG00000040313","27",7546919,7549248,2329
"13777","ENSGALG00000040316","9",2867618,3029975,162357
"13778","ENSGALG00000040320","27",6203738,6205370,1632
"13779","ENSGALG00000040325","2",132270544,132336875,66331
"13780","ENSGALG00000040335","3",33619522,33634859,15337
"13781","ENSGALG00000040336","25",3761139,3764402,3263
"13782","ENSGALG00000040340","13",9229239,9231860,2621
"13783","ENSGALG00000040342","1",104340407,104345964,5557
"13784","ENSGALG00000040348","3",9788250,9983993,195743
"13785","ENSGALG00000040351","KZ626839.1",660043,672952,12909
"13786","ENSGALG00000040355","2",115280942,115286441,5499
"13787","ENSGALG00000040360","13",9770031,9772644,2613
"13788","ENSGALG00000040363","2",40792849,40822455,29606
"13789","ENSGALG00000040364","2",46955704,46975413,19709
"13790","ENSGALG00000040366","2",126322389,126339724,17335
"13791","ENSGALG00000040367","9",23707719,23714978,7259
"13792","ENSGALG00000040368","30",422263,424991,2728
"13793","ENSGALG00000040369","1",4138801,4175957,37156
"13794","ENSGALG00000040371","5",18622009,18627613,5604
"13795","ENSGALG00000040373","17",6263125,6267630,4505
"13796","ENSGALG00000040380","19",7228177,7240979,12802
"13797","ENSGALG00000040384","2",633512,633609,97
"13798","ENSGALG00000040388","1",127826528,127886710,60182
"13799","ENSGALG00000040393","1",71806841,71868149,61308
"13800","ENSGALG00000040397","Z",2139149,2148094,8945
"13801","ENSGALG00000040415","5",18554978,18570650,15672
"13802","ENSGALG00000040416","6",20939030,20949450,10420
"13803","ENSGALG00000040418","1",196969914,196986048,16134
"13804","ENSGALG00000040420","3",108831791,108845887,14096
"13805","ENSGALG00000040421","2",110368788,110378439,9651
"13806","ENSGALG00000040424","1",77568659,77576825,8166
"13807","ENSGALG00000040426","1",93005542,93010409,4867
"13808","ENSGALG00000040428","4",88534786,88542860,8074
"13809","ENSGALG00000040432","8",7158790,7231728,72938
"13810","ENSGALG00000040433","1",187120478,187166088,45610
"13811","ENSGALG00000040434","27",5894430,5900399,5969
"13812","ENSGALG00000040436","2",16267297,16299782,32485
"13813","ENSGALG00000040442","11",4170918,4172725,1807
"13814","ENSGALG00000040444","1",11192619,11310904,118285
"13815","ENSGALG00000040447","2",43004556,43025574,21018
"13816","ENSGALG00000040453","13",2307715,2309520,1805
"13817","ENSGALG00000040463","15",11335501,11339583,4082
"13818","ENSGALG00000040464","5",34478143,34531295,53152
"13819","ENSGALG00000040465","7",33308256,33416501,108245
"13820","ENSGALG00000040468","AADN05001220.1",1082,7239,6157
"13821","ENSGALG00000040471","28",118450,128225,9775
"13822","ENSGALG00000040474","20",1461454,1496155,34701
"13823","ENSGALG00000040475","11",15378075,15387131,9056
"13824","ENSGALG00000040478","1",194700308,194747859,47551
"13825","ENSGALG00000040479","5",17278697,17281798,3101
"13826","ENSGALG00000040480","KZ626836.1",261483,263819,2336
"13827","ENSGALG00000040484","4",46324923,46359132,34209
"13828","ENSGALG00000040489","33",6332302,6336644,4342
"13829","ENSGALG00000040492","28",774504,790392,15888
"13830","ENSGALG00000040493","1",57668138,57738114,69976
"13831","ENSGALG00000040498","26",130061,146496,16435
"13832","ENSGALG00000040504","15",8643118,8659668,16550
"13833","ENSGALG00000040506","Z",366942,378517,11575
"13834","ENSGALG00000040511","2",126722210,126739489,17279
"13835","ENSGALG00000040519","23",5114632,5116781,2149
"13836","ENSGALG00000040521","2",32582774,32584616,1842
"13837","ENSGALG00000040522","2",135418685,135499641,80956
"13838","ENSGALG00000040527","5",23928040,23929847,1807
"13839","ENSGALG00000040528","14",4404816,4414092,9276
"13840","ENSGALG00000040529","27",5613835,5618641,4806
"13841","ENSGALG00000040530","5",15268800,15289906,21106
"13842","ENSGALG00000040532","9",12074565,12078458,3893
"13843","ENSGALG00000040536","17",1163581,1164814,1233
"13844","ENSGALG00000040541","3",104480205,104484164,3959
"13845","ENSGALG00000040546","20",12526611,12531997,5386
"13846","ENSGALG00000040549","6",20428998,20451074,22076
"13847","ENSGALG00000040553","30",464384,474546,10162
"13848","ENSGALG00000040557","1",25367738,25492784,125046
"13849","ENSGALG00000040561","9",23717093,23720109,3016
"13850","ENSGALG00000040567","1",33419044,33421641,2597
"13851","ENSGALG00000040573","8",5192817,5199230,6413
"13852","ENSGALG00000040582","17",10356719,10450700,93981
"13853","ENSGALG00000040585","7",16194231,16206865,12634
"13854","ENSGALG00000040586","26",526440,534597,8157
"13855","ENSGALG00000040594","13",17876802,17881810,5008
"13856","ENSGALG00000040606","18",4988188,4993464,5276
"13857","ENSGALG00000040607","3",57369361,57403385,34024
"13858","ENSGALG00000040613","20",8213907,8216222,2315
"13859","ENSGALG00000040619","5",261217,263311,2094
"13860","ENSGALG00000040620","1",82041116,83002376,961260
"13861","ENSGALG00000040621","1",135205160,135223617,18457
"13862","ENSGALG00000040622","25",2218816,2219564,748
"13863","ENSGALG00000040626","13",1603439,1604914,1475
"13864","ENSGALG00000040632","5",344653,346341,1688
"13865","ENSGALG00000040641","2",149148123,149149986,1863
"13866","ENSGALG00000040644","17",876650,879509,2859
"13867","ENSGALG00000040646","4",90957760,90959374,1614
"13868","ENSGALG00000040648","14",12636579,12640641,4062
"13869","ENSGALG00000040651","10",17124105,17264663,140558
"13870","ENSGALG00000040655","18",7870926,7880080,9154
"13871","ENSGALG00000040662","4",282370,297464,15094
"13872","ENSGALG00000040663","21",6780200,6799170,18970
"13873","ENSGALG00000040665","2",41350205,41358935,8730
"13874","ENSGALG00000040666","1",56329183,56352026,22843
"13875","ENSGALG00000040672","27",7262040,7267335,5295
"13876","ENSGALG00000040680","1",134737011,134748160,11149
"13877","ENSGALG00000040681","1",73738390,73740231,1841
"13878","ENSGALG00000040685","25",2100996,2106345,5349
"13879","ENSGALG00000040687","25",414167,430286,16119
"13880","ENSGALG00000040689","6",12766187,12772970,6783
"13881","ENSGALG00000040696","25",2606875,2615791,8916
"13882","ENSGALG00000040699","9",1356546,1356817,271
"13883","ENSGALG00000040702","3",79052924,79163325,110401
"13884","ENSGALG00000040703","16",2727011,2754145,27134
"13885","ENSGALG00000040704","W",5944392,6052596,108204
"13886","ENSGALG00000040705","18",8739093,8784406,45313
"13887","ENSGALG00000040709","1",133283029,133309570,26541
"13888","ENSGALG00000040710","4",82799542,82816120,16578
"13889","ENSGALG00000040713","11",18925808,18929114,3306
"13890","ENSGALG00000040716","7",4813216,4814151,935
"13891","ENSGALG00000040718","7",15544424,15546108,1684
"13892","ENSGALG00000040720","14",6919108,6940848,21740
"13893","ENSGALG00000040724","2",22394327,22493500,99173
"13894","ENSGALG00000040725","11",10737538,10867724,130186
"13895","ENSGALG00000040728","KZ626831.1",239344,299005,59661
"13896","ENSGALG00000040729","5",15995179,15997679,2500
"13897","ENSGALG00000040730","8",5512946,5535929,22983
"13898","ENSGALG00000040732","4",11506127,11536174,30047
"13899","ENSGALG00000040733","1",94483926,94540226,56300
"13900","ENSGALG00000040737","6",784909,948546,163637
"13901","ENSGALG00000040739","2",56166284,56177528,11244
"13902","ENSGALG00000040741","30",89765,111142,21377
"13903","ENSGALG00000040746","4",1522233,1528834,6601
"13904","ENSGALG00000040754","5",1183120,1184856,1736
"13905","ENSGALG00000040755","20",9893704,9900319,6615
"13906","ENSGALG00000040756","15",387835,443753,55918
"13907","ENSGALG00000040758","28",4218437,4253117,34680
"13908","ENSGALG00000040759","4",91069174,91078804,9630
"13909","ENSGALG00000040761","5",785916,791818,5902
"13910","ENSGALG00000040768","2",136421910,136433628,11718
"13911","ENSGALG00000040769","2",78222754,78236850,14096
"13912","ENSGALG00000040770","14",4486367,4494276,7909
"13913","ENSGALG00000040771","17",639798,647430,7632
"13914","ENSGALG00000040773","17",8017252,8018376,1124
"13915","ENSGALG00000040783","2",657524,768914,111390
"13916","ENSGALG00000040784","4",14195244,14202404,7160
"13917","ENSGALG00000040787","13",10899230,10907657,8427
"13918","ENSGALG00000040793","14",9192165,9204073,11908
"13919","ENSGALG00000040794","2",126274821,126285443,10622
"13920","ENSGALG00000040796","Z",41487298,41662718,175420
"13921","ENSGALG00000040801","9",16063158,16063235,77
"13922","ENSGALG00000040802","13",17730598,17732517,1919
"13923","ENSGALG00000040805","4",84908686,84927893,19207
"13924","ENSGALG00000040807","22",1641150,1647926,6776
"13925","ENSGALG00000040808","1",167221111,167247253,26142
"13926","ENSGALG00000040811","30",1086365,1087058,693
"13927","ENSGALG00000040817","7",134720,148394,13674
"13928","ENSGALG00000040823","2",145630986,145634567,3581
"13929","ENSGALG00000040828","22",3057041,3061680,4639
"13930","ENSGALG00000040832","28",2928051,2932763,4712
"13931","ENSGALG00000040833","7",17331574,17339738,8164
"13932","ENSGALG00000040834","5",3874462,3933136,58674
"13933","ENSGALG00000040836","6",33940818,33970463,29645
"13934","ENSGALG00000040840","1",51508596,51511452,2856
"13935","ENSGALG00000040842","24",6227008,6259713,32705
"13936","ENSGALG00000040844","15",7152710,7176141,23431
"13937","ENSGALG00000040847","25",3246649,3248252,1603
"13938","ENSGALG00000040854","14",667031,706514,39483
"13939","ENSGALG00000040855","1",36025156,36168865,143709
"13940","ENSGALG00000040856","20",1079706,1122140,42434
"13941","ENSGALG00000040857","24",3565031,3587794,22763
"13942","ENSGALG00000040864","26",3212283,3216013,3730
"13943","ENSGALG00000040866","9",14139404,14193800,54396
"13944","ENSGALG00000040869","15",9561568,9563173,1605
"13945","ENSGALG00000040870","1",98098558,98211183,112625
"13946","ENSGALG00000040873","2",41826161,41853984,27823
"13947","ENSGALG00000040875","11",913222,944949,31727
"13948","ENSGALG00000040877","18",4470815,4474662,3847
"13949","ENSGALG00000040878","11",1010737,1016448,5711
"13950","ENSGALG00000040879","2",132522302,132547557,25255
"13951","ENSGALG00000040880","20",10803308,10815864,12556
"13952","ENSGALG00000040882","13",17851237,17868185,16948
"13953","ENSGALG00000040886","20",12531871,12538744,6873
"13954","ENSGALG00000040889","9",546576,606673,60097
"13955","ENSGALG00000040890","4",13800702,13801013,311
"13956","ENSGALG00000040891","2",19999990,20097489,97499
"13957","ENSGALG00000040896","18",4912089,4948124,36035
"13958","ENSGALG00000040899","22",5339097,5346586,7489
"13959","ENSGALG00000040902","2",42772384,42796918,24534
"13960","ENSGALG00000040905","14",478502,485920,7418
"13961","ENSGALG00000040908","19",517714,538445,20731
"13962","ENSGALG00000040909","4",34668440,34710571,42131
"13963","ENSGALG00000040910","8",24856006,24858084,2078
"13964","ENSGALG00000040912","18",6417109,6417185,76
"13965","ENSGALG00000040917","2",41543820,41566508,22688
"13966","ENSGALG00000040921","2",128963480,128978291,14811
"13967","ENSGALG00000040923","17",6951416,7014742,63326
"13968","ENSGALG00000040925","15",11099233,11103629,4396
"13969","ENSGALG00000040926","1",99493728,99545821,52093
"13970","ENSGALG00000040929","5",1234372,1236870,2498
"13971","ENSGALG00000040937","2",125567349,125580298,12949
"13972","ENSGALG00000040938","9",18880997,19157283,276286
"13973","ENSGALG00000040942","19",6306821,6333842,27021
"13974","ENSGALG00000040945","4",77332619,77354240,21621
"13975","ENSGALG00000040947","1",134789668,134805086,15418
"13976","ENSGALG00000040948","9",17734339,17742730,8391
"13977","ENSGALG00000040949","1",92269020,92294139,25119
"13978","ENSGALG00000040954","1",21985328,21998153,12825
"13979","ENSGALG00000040956","4",12120945,12139732,18787
"13980","ENSGALG00000040957","2",145648583,145692109,43526
"13981","ENSGALG00000040959","Z",911841,916760,4919
"13982","ENSGALG00000040962","5",339181,344733,5552
"13983","ENSGALG00000040969","2",146250438,146256664,6226
"13984","ENSGALG00000040971","6",8758662,8761245,2583
"13985","ENSGALG00000040976","1",47242444,47251617,9173
"13986","ENSGALG00000040979","33",5702496,5702585,89
"13987","ENSGALG00000040986","23",2233892,2247898,14006
"13988","ENSGALG00000040987","17",9003054,9005858,2804
"13989","ENSGALG00000040992","7",28438645,28440603,1958
"13990","ENSGALG00000040993","2",15314201,15318325,4124
"13991","ENSGALG00000040995","7",35186646,35234514,47868
"13992","ENSGALG00000040999","14",3509391,3525587,16196
"13993","ENSGALG00000041008","30",1368520,1377961,9441
"13994","ENSGALG00000041010","6",24317980,24339647,21667
"13995","ENSGALG00000041013","7",22607293,22645929,38636
"13996","ENSGALG00000041014","5",25968320,26021800,53480
"13997","ENSGALG00000041015","3",25929192,25938177,8985
"13998","ENSGALG00000041025","18",4495739,4501676,5937
"13999","ENSGALG00000041028","3",104550333,104557734,7401
"14000","ENSGALG00000041030","33",7403368,7415765,12397
"14001","ENSGALG00000041034","3",18129346,18155431,26085
"14002","ENSGALG00000041036","11",4645274,4873781,228507
"14003","ENSGALG00000041037","3",31034155,31039220,5065
"14004","ENSGALG00000041042","1",132259464,132561163,301699
"14005","ENSGALG00000041043","2",131587261,131592411,5150
"14006","ENSGALG00000041044","17",9188534,9193915,5381
"14007","ENSGALG00000041048","23",554177,554263,86
"14008","ENSGALG00000041052","Z",852388,890389,38001
"14009","ENSGALG00000041054","4",33954634,33963875,9241
"14010","ENSGALG00000041066","14",12712359,12718382,6023
"14011","ENSGALG00000041072","2",138475436,138488953,13517
"14012","ENSGALG00000041074","3",4291347,4299319,7972
"14013","ENSGALG00000041077","3",16986720,16986776,56
"14014","ENSGALG00000041078","1",114046400,114047548,1148
"14015","ENSGALG00000041080","2",112915343,113003232,87889
"14016","ENSGALG00000041081","Z",2087185,2131134,43949
"14017","ENSGALG00000041083","1",145718083,145721881,3798
"14018","ENSGALG00000041086","2",110380891,110389410,8519
"14019","ENSGALG00000041091","MT",9240,9923,683
"14020","ENSGALG00000041093","20",1366610,1412554,45944
"14021","ENSGALG00000041094","1",39190683,39534902,344219
"14022","ENSGALG00000041098","5",26035757,26045756,9999
"14023","ENSGALG00000041101","33",5048685,5068444,19759
"14024","ENSGALG00000041102","17",4867667,4892148,24481
"14025","ENSGALG00000041103","6",3686230,3687798,1568
"14026","ENSGALG00000041104","17",6008701,6025801,17100
"14027","ENSGALG00000041111","17",6391825,6428984,37159
"14028","ENSGALG00000041112","2",116734716,116749942,15226
"14029","ENSGALG00000041114","2",48887179,48948151,60972
"14030","ENSGALG00000041115","7",11734462,11736445,1983
"14031","ENSGALG00000041120","3",66578513,66621450,42937
"14032","ENSGALG00000041121","4",74981753,75225786,244033
"14033","ENSGALG00000041122","1",47293203,47318899,25696
"14034","ENSGALG00000041123","26",2026552,2046592,20040
"14035","ENSGALG00000041124","6",17600886,17610385,9499
"14036","ENSGALG00000041129","13",1632171,1635152,2981
"14037","ENSGALG00000041139","3",106825944,106887182,61238
"14038","ENSGALG00000041140","6",32231327,32259800,28473
"14039","ENSGALG00000041143","11",523838,527803,3965
"14040","ENSGALG00000041153","15",6394628,6397044,2416
"14041","ENSGALG00000041154","2",8624610,8627626,3016
"14042","ENSGALG00000041161","22",5154950,5165163,10213
"14043","ENSGALG00000041163","28",2319159,2324421,5262
"14044","ENSGALG00000041179","2",127950434,128016215,65781
"14045","ENSGALG00000041181","14",14230658,14236004,5346
"14046","ENSGALG00000041182","15",1219854,1227550,7696
"14047","ENSGALG00000041183","5",53432324,53447350,15026
"14048","ENSGALG00000041184","2",92477284,92544228,66944
"14049","ENSGALG00000041191","9",22340887,22340977,90
"14050","ENSGALG00000041192","7",21044187,21071090,26903
"14051","ENSGALG00000041193","1",54631916,54646904,14988
"14052","ENSGALG00000041200","2",128622765,128629538,6773
"14053","ENSGALG00000041202","2",138061819,138086470,24651
"14054","ENSGALG00000041203","4",79205107,79249597,44490
"14055","ENSGALG00000041204","27",6056993,6081137,24144
"14056","ENSGALG00000041205","4",90996281,90999472,3191
"14057","ENSGALG00000041213","14",6973994,7014564,40570
"14058","ENSGALG00000041216","5",1137173,1140552,3379
"14059","ENSGALG00000041222","2",112027114,112034638,7524
"14060","ENSGALG00000041225","1",190561287,190630341,69054
"14061","ENSGALG00000041226","4",11471654,11485646,13992
"14062","ENSGALG00000041228","8",21380392,21382596,2204
"14063","ENSGALG00000041229","10",1283318,1284292,974
"14064","ENSGALG00000041232","33",6508637,6509706,1069
"14065","ENSGALG00000041233","2",139290743,139291645,902
"14066","ENSGALG00000041236","1",50752535,50761418,8883
"14067","ENSGALG00000041238","17",8964516,8989416,24900
"14068","ENSGALG00000041248","3",107121338,107121833,495
"14069","ENSGALG00000041249","5",509330,510343,1013
"14070","ENSGALG00000041251","1",20492465,20502957,10492
"14071","ENSGALG00000041253","5",446077,478889,32812
"14072","ENSGALG00000041255","6",33533589,33704427,170838
"14073","ENSGALG00000041257","7",36236395,36252054,15659
"14074","ENSGALG00000041258","23",2371447,2379435,7988
"14075","ENSGALG00000041263","1",174079522,174312779,233257
"14076","ENSGALG00000041266","30",392257,395386,3129
"14077","ENSGALG00000041267","2",17732934,17742871,9937
"14078","ENSGALG00000041273","2",57762227,57813142,50915
"14079","ENSGALG00000041275","2",44310282,44314964,4682
"14080","ENSGALG00000041277","15",4807593,4809113,1520
"14081","ENSGALG00000041280","32",549342,554130,4788
"14082","ENSGALG00000041285","14",4892654,4914369,21715
"14083","ENSGALG00000041294","4",46430335,46437404,7069
"14084","ENSGALG00000041296","3",106816449,106818809,2360
"14085","ENSGALG00000041298","14",15396046,15412161,16115
"14086","ENSGALG00000041299","5",1931486,1939176,7690
"14087","ENSGALG00000041303","2",87177820,87206013,28193
"14088","ENSGALG00000041309","5",21884897,21900048,15151
"14089","ENSGALG00000041311","1",146954675,146960092,5417
"14090","ENSGALG00000041312","3",80106902,80199236,92334
"14091","ENSGALG00000041323","30",137049,137805,756
"14092","ENSGALG00000041325","KZ626839.1",1087719,1128985,41266
"14093","ENSGALG00000041327","2",114973276,115009947,36671
"14094","ENSGALG00000041331","6",23310320,23319634,9314
"14095","ENSGALG00000041334","2",42767078,42771975,4897
"14096","ENSGALG00000041337","2",124677733,124686647,8914
"14097","ENSGALG00000041338","12",1848128,1850254,2126
"14098","ENSGALG00000041342","KZ626836.1",817241,818127,886
"14099","ENSGALG00000041344","2",121272547,121278022,5475
"14100","ENSGALG00000041346","6",19850341,19864037,13696
"14101","ENSGALG00000041347","22",591452,597992,6540
"14102","ENSGALG00000041352","AADN05001236.1",21,1674,1653
"14103","ENSGALG00000041353","2",126295052,126306005,10953
"14104","ENSGALG00000041361","4",33886867,33929204,42337
"14105","ENSGALG00000041362","10",10853650,10867379,13729
"14106","ENSGALG00000041365","20",13087625,13101795,14170
"14107","ENSGALG00000041370","20",10556080,10566117,10037
"14108","ENSGALG00000041371","28",1263417,1290391,26974
"14109","ENSGALG00000041372","2",43943919,43986021,42102
"14110","ENSGALG00000041373","4",70204006,70312564,108558
"14111","ENSGALG00000041380","16",2606528,2609057,2529
"14112","ENSGALG00000041384","32",689685,700016,10331
"14113","ENSGALG00000041390","17",774999,776726,1727
"14114","ENSGALG00000041392","9",13359489,13361946,2457
"14115","ENSGALG00000041397","4",4114935,4125868,10933
"14116","ENSGALG00000041400","21",5269524,5273140,3616
"14117","ENSGALG00000041401","21",202192,210610,8418
"14118","ENSGALG00000041403","10",18527246,18563975,36729
"14119","ENSGALG00000041404","2",56919289,56938680,19391
"14120","ENSGALG00000041405","12",16583878,16643856,59978
"14121","ENSGALG00000041407","2",47986042,47993015,6973
"14122","ENSGALG00000041408","11",17697775,17723497,25722
"14123","ENSGALG00000041413","22",1573328,1590750,17422
"14124","ENSGALG00000041417","6",32401514,32418773,17259
"14125","ENSGALG00000041418","25",3965916,3972235,6319
"14126","ENSGALG00000041419","12",11989501,11994547,5046
"14127","ENSGALG00000041420","5",26110050,26112842,2792
"14128","ENSGALG00000041422","3",39805911,39835770,29859
"14129","ENSGALG00000041423","4",4233599,4268871,35272
"14130","ENSGALG00000041428","12",1184932,1201802,16870
"14131","ENSGALG00000041429","28",4096033,4097503,1470
"14132","ENSGALG00000041432","14",13543813,13547615,3802
"14133","ENSGALG00000041433","1",125362428,125384741,22313
"14134","ENSGALG00000041435","25",2844773,2862713,17940
"14135","ENSGALG00000041437","4",1105128,1120637,15509
"14136","ENSGALG00000041442","27",7380163,7390151,9988
"14137","ENSGALG00000041445","2",128451103,128467721,16618
"14138","ENSGALG00000041449","5",24740037,24756678,16641
"14139","ENSGALG00000041454","3",104568030,104584279,16249
"14140","ENSGALG00000041456","6",21239403,21244771,5368
"14141","ENSGALG00000041459","6",12170562,12174718,4156
"14142","ENSGALG00000041461","20",10249947,10263322,13375
"14143","ENSGALG00000041463","22",3047217,3056376,9159
"14144","ENSGALG00000041470","1",71237629,71271740,34111
"14145","ENSGALG00000041471","16",2738933,2745467,6534
"14146","ENSGALG00000041473","17",6893819,6935800,41981
"14147","ENSGALG00000041475","11",32332,265781,233449
"14148","ENSGALG00000041483","25",2226898,2227559,661
"14149","ENSGALG00000041491","2",42256779,42262620,5841
"14150","ENSGALG00000041493","2",125727025,125734631,7606
"14151","ENSGALG00000041494","1",323123,357594,34471
"14152","ENSGALG00000041501","9",2695875,2698820,2945
"14153","ENSGALG00000041502","19",389999,391788,1789
"14154","ENSGALG00000041505","17",6484730,6515927,31197
"14155","ENSGALG00000041510","10",1504415,1521465,17050
"14156","ENSGALG00000041511","12",360573,368373,7800
"14157","ENSGALG00000041512","6",1237323,1244618,7295
"14158","ENSGALG00000041514","17",604426,608188,3762
"14159","ENSGALG00000041520","28",1502517,1506898,4381
"14160","ENSGALG00000041522","5",189639,197959,8320
"14161","ENSGALG00000041524","2",333108,334327,1219
"14162","ENSGALG00000041528","1",1284583,1291147,6564
"14163","ENSGALG00000041533","33",4895801,4954711,58910
"14164","ENSGALG00000041547","12",7384085,7412900,28815
"14165","ENSGALG00000041553","2",132417822,132418772,950
"14166","ENSGALG00000041555","27",5538288,5555467,17179
"14167","ENSGALG00000041556","27",3911372,3976990,65618
"14168","ENSGALG00000041558","3",16649673,16656261,6588
"14169","ENSGALG00000041560","KZ626826.1",32345,40432,8087
"14170","ENSGALG00000041563","7",2587734,2706504,118770
"14171","ENSGALG00000041564","1",77147561,77281468,133907
"14172","ENSGALG00000041565","5",51927665,51942266,14601
"14173","ENSGALG00000041568","2",48018175,48053287,35112
"14174","ENSGALG00000041573","2",111584670,111601427,16757
"14175","ENSGALG00000041575","3",48424046,48474322,50276
"14176","ENSGALG00000041577","7",14320204,14351730,31526
"14177","ENSGALG00000041592","33",7007292,7016199,8907
"14178","ENSGALG00000041604","1",50786323,50790986,4663
"14179","ENSGALG00000041611","23",313700,315602,1902
"14180","ENSGALG00000041612","2",122573529,122579864,6335
"14181","ENSGALG00000041613","11",6633285,6652274,18989
"14182","ENSGALG00000041616","5",39226156,39228381,2225
"14183","ENSGALG00000041618","2",622297,628878,6581
"14184","ENSGALG00000041619","1",58205713,58243481,37768
"14185","ENSGALG00000041621","2",148338397,148344678,6281
"14186","ENSGALG00000041622","8",21872226,21880404,8178
"14187","ENSGALG00000041624","4",66972525,66980538,8013
"14188","ENSGALG00000041625","2",48055794,48060576,4782
"14189","ENSGALG00000041626","3",11084141,11176485,92344
"14190","ENSGALG00000041630","30",402432,415709,13277
"14191","ENSGALG00000041634","22",3827641,3830849,3208
"14192","ENSGALG00000041635","4",56534692,56694206,159514
"14193","ENSGALG00000041640","2",29565482,29567600,2118
"14194","ENSGALG00000041641","10",3415290,3452730,37440
"14195","ENSGALG00000041643","28",1203420,1242963,39543
"14196","ENSGALG00000041644","1",139115577,139175402,59825
"14197","ENSGALG00000041650","12",641955,649309,7354
"14198","ENSGALG00000041659","20",9609738,9613178,3440
"14199","ENSGALG00000041661","4",57064116,57068075,3959
"14200","ENSGALG00000041662","4",37229825,37254071,24246
"14201","ENSGALG00000041663","4",69297198,69312286,15088
"14202","ENSGALG00000041666","7",352539,359266,6727
"14203","ENSGALG00000041676","KZ626836.1",271434,278171,6737
"14204","ENSGALG00000041680","8",3084537,3190916,106379
"14205","ENSGALG00000041684","3",46644883,46659412,14529
"14206","ENSGALG00000041685","33",6580953,6593372,12419
"14207","ENSGALG00000041687","1",49494257,49513013,18756
"14208","ENSGALG00000041688","3",69150141,69190801,40660
"14209","ENSGALG00000041690","13",7462908,7709896,246988
"14210","ENSGALG00000041693","18",8972420,8974651,2231
"14211","ENSGALG00000041700","26",1241168,1253846,12678
"14212","ENSGALG00000041706","13",15065226,15105799,40573
"14213","ENSGALG00000041708","21",6313309,6325046,11737
"14214","ENSGALG00000041709","9",5392189,5392281,92
"14215","ENSGALG00000041717","4",69534263,69590715,56452
"14216","ENSGALG00000041718","16",1618415,1619513,1098
"14217","ENSGALG00000041722","19",288961,335181,46220
"14218","ENSGALG00000041730","2",146163339,146186941,23602
"14219","ENSGALG00000041731","2",41440864,41464606,23742
"14220","ENSGALG00000041732","20",10179082,10225102,46020
"14221","ENSGALG00000041736","4",22803369,23067251,263882
"14222","ENSGALG00000041744","9",5386182,5392731,6549
"14223","ENSGALG00000041746","13",1560388,1571326,10938
"14224","ENSGALG00000041748","2",137945143,137954809,9666
"14225","ENSGALG00000041750","12",14132885,14195481,62596
"14226","ENSGALG00000041752","23",2057919,2062446,4527
"14227","ENSGALG00000041754","13",10808774,10813473,4699
"14228","ENSGALG00000041755","15",9589351,9606972,17621
"14229","ENSGALG00000041760","15",337036,375258,38222
"14230","ENSGALG00000041762","1",197098805,197144902,46097
"14231","ENSGALG00000041763","18",693631,697542,3911
"14232","ENSGALG00000041764","2",82266243,82292941,26698
"14233","ENSGALG00000041766","1",50835273,50842533,7260
"14234","ENSGALG00000041768","18",9722497,9722555,58
"14235","ENSGALG00000041774","5",16795996,16811042,15046
"14236","ENSGALG00000041775","5",38847495,38965455,117960
"14237","ENSGALG00000041778","18",4315516,4319187,3671
"14238","ENSGALG00000041782","7",33727145,33917358,190213
"14239","ENSGALG00000041783","1",36512612,36525747,13135
"14240","ENSGALG00000041787","11",72924,90885,17961
"14241","ENSGALG00000041790","5",56558643,56624336,65693
"14242","ENSGALG00000041791","2",7565007,7718788,153781
"14243","ENSGALG00000041792","26",4311807,4343652,31845
"14244","ENSGALG00000041794","5",43511006,43514994,3988
"14245","ENSGALG00000041795","2",122974548,123034608,60060
"14246","ENSGALG00000041797","25",3523539,3530669,7130
"14247","ENSGALG00000041800","18",153378,196496,43118
"14248","ENSGALG00000041802","19",9375787,9405036,29249
"14249","ENSGALG00000041808","5",17981909,18053418,71509
"14250","ENSGALG00000041812","1",106924128,106927541,3413
"14251","ENSGALG00000041814","1",183536862,183673100,136238
"14252","ENSGALG00000041820","2",47315630,47378660,63030
"14253","ENSGALG00000041821","15",6563515,6588861,25346
"14254","ENSGALG00000041822","28",2814162,2817295,3133
"14255","ENSGALG00000041823","1",51019143,51030492,11349
"14256","ENSGALG00000041826","25",3308021,3309315,1294
"14257","ENSGALG00000041830","3",52571888,52587931,16043
"14258","ENSGALG00000041833","19",260878,275236,14358
"14259","ENSGALG00000041834","22",5268107,5279496,11389
"14260","ENSGALG00000041838","10",15688548,15882715,194167
"14261","ENSGALG00000041844","19",3564078,3568195,4117
"14262","ENSGALG00000041845","16",2446991,2453265,6274
"14263","ENSGALG00000041847","13",17281084,17284094,3010
"14264","ENSGALG00000041854","4",75928638,75968534,39896
"14265","ENSGALG00000041857","7",1406701,1418831,12130
"14266","ENSGALG00000041858","27",7388618,7391528,2910
"14267","ENSGALG00000041861","15",6275510,6287842,12332
"14268","ENSGALG00000041863","2",136911020,136937314,26294
"14269","ENSGALG00000041867","1",106580169,106592227,12058
"14270","ENSGALG00000041873","9",17665771,17684776,19005
"14271","ENSGALG00000041878","33",5116552,5120291,3739
"14272","ENSGALG00000041880","4",1710592,1713688,3096
"14273","ENSGALG00000041882","Z",1766202,1782160,15958
"14274","ENSGALG00000041884","7",151197,173251,22054
"14275","ENSGALG00000041888","4",88723574,88738928,15354
"14276","ENSGALG00000041895","1",172799824,172829085,29261
"14277","ENSGALG00000041896","10",8190607,8207615,17008
"14278","ENSGALG00000041897","28",3548245,3555517,7272
"14279","ENSGALG00000041898","9",12971183,12972271,1088
"14280","ENSGALG00000041900","4",2475257,2530889,55632
"14281","ENSGALG00000041901","13",634162,664468,30306
"14282","ENSGALG00000041906","3",33963055,33965873,2818
"14283","ENSGALG00000041907","27",3889864,3890766,902
"14284","ENSGALG00000041909","33",6871003,6873186,2183
"14285","ENSGALG00000041911","22",173612,227990,54378
"14286","ENSGALG00000041914","14",1513300,1550614,37314
"14287","ENSGALG00000041918","2",115482232,115569184,86952
"14288","ENSGALG00000041921","4",66225776,66250961,25185
"14289","ENSGALG00000041922","MT",1228,1296,68
"14290","ENSGALG00000041923","33",7234736,7246033,11297
"14291","ENSGALG00000041924","33",7246423,7248726,2303
"14292","ENSGALG00000041926","27",3752626,3757369,4743
"14293","ENSGALG00000041927","19",460506,462675,2169
"14294","ENSGALG00000041932","28",3433225,3437733,4508
"14295","ENSGALG00000041934","28",3340026,3346818,6792
"14296","ENSGALG00000041938","3",79937436,80007134,69698
"14297","ENSGALG00000041939","19",5978442,5985142,6700
"14298","ENSGALG00000041948","19",8356269,8375641,19372
"14299","ENSGALG00000041949","1",194367094,194374727,7633
"14300","ENSGALG00000041950","20",9213984,9217305,3321
"14301","ENSGALG00000041953","5",127773,160743,32970
"14302","ENSGALG00000041955","5",16144139,16175492,31353
"14303","ENSGALG00000041959","14",2904031,2925554,21523
"14304","ENSGALG00000041960","31",3760195,3794136,33941
"14305","ENSGALG00000041961","31",3837390,3838127,737
"14306","ENSGALG00000041962","5",39363123,39387660,24537
"14307","ENSGALG00000041965","1",1281583,1284116,2533
"14308","ENSGALG00000041969","2",138494790,138611280,116490
"14309","ENSGALG00000041972","11",8355856,8358687,2831
"14310","ENSGALG00000041973","33",6873422,6876341,2919
"14311","ENSGALG00000041977","4",17326690,17364019,37329
"14312","ENSGALG00000041978","1",4059566,4071675,12109
"14313","ENSGALG00000041981","13",10860859,10861648,789
"14314","ENSGALG00000041988","1",111210237,111222987,12750
"14315","ENSGALG00000041989","14",486854,501055,14201
"14316","ENSGALG00000041993","4",69259518,69275146,15628
"14317","ENSGALG00000041996","3",20270287,20278490,8203
"14318","ENSGALG00000042001","4",35025993,35044154,18161
"14319","ENSGALG00000042003","15",3714868,3717110,2242
"14320","ENSGALG00000042005","3",104522770,104531481,8711
"14321","ENSGALG00000042008","26",1269132,1271731,2599
"14322","ENSGALG00000042009","13",7439877,7452170,12293
"14323","ENSGALG00000042011","33",7724030,7729606,5576
"14324","ENSGALG00000042016","33",3314755,3318625,3870
"14325","ENSGALG00000042020","4",49726591,49735575,8984
"14326","ENSGALG00000042022","18",133417,148498,15081
"14327","ENSGALG00000042023","1",39057,42408,3351
"14328","ENSGALG00000042029","10",20563554,20567888,4334
"14329","ENSGALG00000042030","1",196016274,196022241,5967
"14330","ENSGALG00000042032","25",2270409,2275481,5072
"14331","ENSGALG00000042045","11",4547408,4548987,1579
"14332","ENSGALG00000042051","2",3969529,4022831,53302
"14333","ENSGALG00000042052","15",859517,928110,68593
"14334","ENSGALG00000042055","17",7577223,7651643,74420
"14335","ENSGALG00000042056","9",23087173,23087262,89
"14336","ENSGALG00000042062","4",81409978,81412649,2671
"14337","ENSGALG00000042063","2",46065864,46094828,28964
"14338","ENSGALG00000042067","4",53357901,53358866,965
"14339","ENSGALG00000042071","19",7086471,7135399,48928
"14340","ENSGALG00000042073","7",4565508,4568105,2597
"14341","ENSGALG00000042075","9",1074554,1074669,115
"14342","ENSGALG00000042077","19",5668833,5673549,4716
"14343","ENSGALG00000042079","3",37941890,37973181,31291
"14344","ENSGALG00000042080","28",4061609,4068098,6489
"14345","ENSGALG00000042082","2",111223762,111224811,1049
"14346","ENSGALG00000042086","21",6765805,6771872,6067
"14347","ENSGALG00000042088","5",46604362,46646278,41916
"14348","ENSGALG00000042095","25",3921569,3926396,4827
"14349","ENSGALG00000042099","4",21111910,21170957,59047
"14350","ENSGALG00000042103","5",21907061,21908044,983
"14351","ENSGALG00000042105","5",887703,923778,36075
"14352","ENSGALG00000042112","4",59888200,59909081,20881
"14353","ENSGALG00000042116","3",72904936,73020779,115843
"14354","ENSGALG00000042119","33",6923910,6925702,1792
"14355","ENSGALG00000042122","33",5705222,5725015,19793
"14356","ENSGALG00000042123","4",49580673,49581374,701
"14357","ENSGALG00000042125","19",4540796,4601920,61124
"14358","ENSGALG00000042128","17",6727970,6736633,8663
"14359","ENSGALG00000042129","25",3329954,3344000,14046
"14360","ENSGALG00000042132","28",3618639,3636374,17735
"14361","ENSGALG00000042134","2",97729887,98023150,293263
"14362","ENSGALG00000042137","26",2201344,2214140,12796
"14363","ENSGALG00000042148","26",76711,94225,17514
"14364","ENSGALG00000042150","7",6437386,6457969,20583
"14365","ENSGALG00000042151","4",8703252,8712457,9205
"14366","ENSGALG00000042153","28",3303239,3316252,13013
"14367","ENSGALG00000042159","9",21273430,21276090,2660
"14368","ENSGALG00000042165","10",20845911,20862864,16953
"14369","ENSGALG00000042168","8",26974401,26980880,6479
"14370","ENSGALG00000042177","33",6864240,6865337,1097
"14371","ENSGALG00000042181","22",2589755,2597822,8067
"14372","ENSGALG00000042182","2",131316861,131581649,264788
"14373","ENSGALG00000042184","21",4552112,4559784,7672
"14374","ENSGALG00000042193","3",107467262,107468665,1403
"14375","ENSGALG00000042197","7",428113,444820,16707
"14376","ENSGALG00000042199","20",10577212,10600763,23551
"14377","ENSGALG00000042201","10",20696527,20727419,30892
"14378","ENSGALG00000042210","17",9887675,9889962,2287
"14379","ENSGALG00000042213","15",11413717,11427176,13459
"14380","ENSGALG00000042214","25",1539153,1550485,11332
"14381","ENSGALG00000042215","18",9174889,9180847,5958
"14382","ENSGALG00000042220","25",222992,226212,3220
"14383","ENSGALG00000042222","28",4410213,4412337,2124
"14384","ENSGALG00000042227","22",5262428,5263904,1476
"14385","ENSGALG00000042228","12",15594740,15637018,42278
"14386","ENSGALG00000042232","2",66263596,66268560,4964
"14387","ENSGALG00000042238","9",8105208,8110348,5140
"14388","ENSGALG00000042241","2",206228,212235,6007
"14389","ENSGALG00000042242","2",138488838,138493410,4572
"14390","ENSGALG00000042244","1",15461078,15478179,17101
"14391","ENSGALG00000042246","32",264782,270998,6216
"14392","ENSGALG00000042254","6",11499639,11508328,8689
"14393","ENSGALG00000042256","27",4717950,4718285,335
"14394","ENSGALG00000042257","18",407275,424203,16928
"14395","ENSGALG00000042259","6",33870466,34118007,247541
"14396","ENSGALG00000042269","1",40772949,40828590,55641
"14397","ENSGALG00000042275","28",1315392,1323490,8098
"14398","ENSGALG00000042279","20",12348508,12355844,7336
"14399","ENSGALG00000042289","2",44446651,44489221,42570
"14400","ENSGALG00000042293","3",24920461,24942628,22167
"14401","ENSGALG00000042297","5",168034,176919,8885
"14402","ENSGALG00000042308","3",105834156,105886228,52072
"14403","ENSGALG00000042309","5",572360,574129,1769
"14404","ENSGALG00000042313","3",22315660,22354674,39014
"14405","ENSGALG00000042320","1",80503134,80556121,52987
"14406","ENSGALG00000042321","2",111134283,111181422,47139
"14407","ENSGALG00000042322","14",12733908,12739669,5761
"14408","ENSGALG00000042325","17",5454603,5472762,18159
"14409","ENSGALG00000042330","7",17655687,17697085,41398
"14410","ENSGALG00000042333","5",312880,326196,13316
"14411","ENSGALG00000042334","1",141216202,141226614,10412
"14412","ENSGALG00000042336","2",116177072,116204605,27533
"14413","ENSGALG00000042338","13",17844032,17850628,6596
"14414","ENSGALG00000042339","1",175449309,175545587,96278
"14415","ENSGALG00000042340","5",12716288,12734783,18495
"14416","ENSGALG00000042351","18",1955815,1973637,17822
"14417","ENSGALG00000042354","2",115620395,115787873,167478
"14418","ENSGALG00000042356","28",2836616,2844024,7408
"14419","ENSGALG00000042357","5",23690228,23712610,22382
"14420","ENSGALG00000042358","10",1213803,1256295,42492
"14421","ENSGALG00000042360","24",3898255,3922124,23869
"14422","ENSGALG00000042365","1",51238459,51251963,13504
"14423","ENSGALG00000042371","2",40838346,40955310,116964
"14424","ENSGALG00000042372","1",109739049,109833478,94429
"14425","ENSGALG00000042374","7",15549638,15673377,123739
"14426","ENSGALG00000042375","2",131213171,131252088,38917
"14427","ENSGALG00000042376","3",3407644,3409255,1611
"14428","ENSGALG00000042383","4",29928099,29945877,17778
"14429","ENSGALG00000042387","12",11896869,11901359,4490
"14430","ENSGALG00000042388","3",58251920,58452855,200935
"14431","ENSGALG00000042389","7",28518095,28521131,3036
"14432","ENSGALG00000042392","13",3854616,3898173,43557
"14433","ENSGALG00000042396","2",55454629,55529287,74658
"14434","ENSGALG00000042400","1",113092779,113289308,196529
"14435","ENSGALG00000042411","4",21769983,21785966,15983
"14436","ENSGALG00000042415","11",2128470,2143535,15065
"14437","ENSGALG00000042418","24",406480,410226,3746
"14438","ENSGALG00000042419","1",51449865,51500512,50647
"14439","ENSGALG00000042422","33",5544436,5553014,8578
"14440","ENSGALG00000042423","13",3121547,3131473,9926
"14441","ENSGALG00000042431","4",39371968,39389039,17071
"14442","ENSGALG00000042439","7",12103359,12123828,20469
"14443","ENSGALG00000042443","2",26647211,26670962,23751
"14444","ENSGALG00000042446","14",14826694,14843917,17223
"14445","ENSGALG00000042449","KZ626819.1",113827,121489,7662
"14446","ENSGALG00000042452","7",21138002,21176764,38762
"14447","ENSGALG00000042454","2",57871050,57926992,55942
"14448","ENSGALG00000042458","5",28427292,28508904,81612
"14449","ENSGALG00000042460","17",5264945,5268508,3563
"14450","ENSGALG00000042462","20",1184661,1186998,2337
"14451","ENSGALG00000042469","2",107917056,108001222,84166
"14452","ENSGALG00000042471","1",4077855,4094276,16421
"14453","ENSGALG00000042474","8",22337943,22339289,1346
"14454","ENSGALG00000042476","10",8114611,8131839,17228
"14455","ENSGALG00000042478","MT",11196,11492,296
"14456","ENSGALG00000042479","1",67156142,67156196,54
"14457","ENSGALG00000042481","2",65202325,65441059,238734
"14458","ENSGALG00000042482","33",7083020,7087396,4376
"14459","ENSGALG00000042483","3",4123537,4130696,7159
"14460","ENSGALG00000042484","1",136041159,136181751,140592
"14461","ENSGALG00000042485","23",2297594,2302162,4568
"14462","ENSGALG00000042488","3",96387312,96396962,9650
"14463","ENSGALG00000042491","1",48135982,48136474,492
"14464","ENSGALG00000042492","4",57785050,57798938,13888
"14465","ENSGALG00000042494","2",147967971,147990650,22679
"14466","ENSGALG00000042500","31",3738213,3740679,2466
"14467","ENSGALG00000042503","KZ626836.1",77531,79994,2463
"14468","ENSGALG00000042505","2",94652557,94656207,3650
"14469","ENSGALG00000042511","3",23428366,23460375,32009
"14470","ENSGALG00000042521","27",5874275,5891329,17054
"14471","ENSGALG00000042522","11",17017722,17033254,15532
"14472","ENSGALG00000042524","17",3217173,3243579,26406
"14473","ENSGALG00000042528","19",8380239,8387778,7539
"14474","ENSGALG00000042533","19",632011,693404,61393
"14475","ENSGALG00000042534","2",56572958,56689906,116948
"14476","ENSGALG00000042538","18",9298043,9330926,32883
"14477","ENSGALG00000042548","2",141638052,141668463,30411
"14478","ENSGALG00000042551","6",17777177,17804920,27743
"14479","ENSGALG00000042552","10",6475758,6544834,69076
"14480","ENSGALG00000042553","9",23486507,23490259,3752
"14481","ENSGALG00000042554","1",15407886,15449742,41856
"14482","ENSGALG00000042555","22",3812208,3824691,12483
"14483","ENSGALG00000042557","3",3642217,3647151,4934
"14484","ENSGALG00000042564","17",8453385,8469840,16455
"14485","ENSGALG00000042565","11",18143304,18152865,9561
"14486","ENSGALG00000042570","1",176815363,176825041,9678
"14487","ENSGALG00000042572","1",197438849,197439910,1061
"14488","ENSGALG00000042575","31",4029642,4030830,1188
"14489","ENSGALG00000042576","9",7778011,7778117,106
"14490","ENSGALG00000042577","1",84357507,84390333,32826
"14491","ENSGALG00000042584","2",75767746,75798868,31122
"14492","ENSGALG00000042587","13",17569480,17581193,11713
"14493","ENSGALG00000042588","5",51676313,51689178,12865
"14494","ENSGALG00000042589","26",1145714,1146845,1131
"14495","ENSGALG00000042598","23",573168,641876,68708
"14496","ENSGALG00000042599","2",124514641,124525878,11237
"14497","ENSGALG00000042604","1",119266982,119271182,4200
"14498","ENSGALG00000042606","13",1548787,1552955,4168
"14499","ENSGALG00000042607","3",59341241,59399436,58195
"14500","ENSGALG00000042611","1",194198,197450,3252
"14501","ENSGALG00000042612","9",15737715,15748501,10786
"14502","ENSGALG00000042613","20",6627370,6636060,8690
"14503","ENSGALG00000042614","3",98774986,98935374,160388
"14504","ENSGALG00000042617","13",2935162,2950227,15065
"14505","ENSGALG00000042619","3",38516694,38522830,6136
"14506","ENSGALG00000042621","2",118700641,118730662,30021
"14507","ENSGALG00000042624","23",332583,343552,10969
"14508","ENSGALG00000042626","Z",3410646,3419037,8391
"14509","ENSGALG00000042639","1",92794718,92832017,37299
"14510","ENSGALG00000042640","18",6789045,6789181,136
"14511","ENSGALG00000042641","5",233987,238674,4687
"14512","ENSGALG00000042642","2",457092,458880,1788
"14513","ENSGALG00000042645","7",12763689,13129732,366043
"14514","ENSGALG00000042647","11",465776,474369,8593
"14515","ENSGALG00000042651","2",22512900,22533249,20349
"14516","ENSGALG00000042652","2",99495997,99496893,896
"14517","ENSGALG00000042656","KZ626829.1",166960,176474,9514
"14518","ENSGALG00000042657","2",2551903,2634749,82846
"14519","ENSGALG00000042661","30",1105911,1110595,4684
"14520","ENSGALG00000042664","11",7039119,7041568,2449
"14521","ENSGALG00000042669","5",1205493,1205583,90
"14522","ENSGALG00000042677","MT",16108,16177,69
"14523","ENSGALG00000042678","1",75519330,75521806,2476
"14524","ENSGALG00000042679","2",75668730,75718107,49377
"14525","ENSGALG00000042684","16",1991627,1993010,1383
"14526","ENSGALG00000042686","8",28132665,28133855,1190
"14527","ENSGALG00000042692","AADN05001348.1",2319,7554,5235
"14528","ENSGALG00000042705","3",105215798,105226949,11151
"14529","ENSGALG00000042706","2",44255631,44282079,26448
"14530","ENSGALG00000042708","16",850033,852546,2513
"14531","ENSGALG00000042715","2",127373051,127386084,13033
"14532","ENSGALG00000042723","9",22291577,22291900,323
"14533","ENSGALG00000042725","4",68230,79447,11217
"14534","ENSGALG00000042726","4",64610177,64635020,24843
"14535","ENSGALG00000042730","24",409708,417284,7576
"14536","ENSGALG00000042733","25",72263,73811,1548
"14537","ENSGALG00000042739","22",2694182,2712580,18398
"14538","ENSGALG00000042741","5",161370,167878,6508
"14539","ENSGALG00000042744","8",3955424,3958244,2820
"14540","ENSGALG00000042748","22",26405,41651,15246
"14541","ENSGALG00000042750","MT",4050,5024,974
"14542","ENSGALG00000042752","7",27261906,27292084,30178
"14543","ENSGALG00000042759","1",129430004,129482027,52023
"14544","ENSGALG00000042761","21",4892668,4895817,3149
"14545","ENSGALG00000042762","17",9112305,9117979,5674
"14546","ENSGALG00000042764","1",14697142,14881357,184215
"14547","ENSGALG00000042766","2",145414286,145625236,210950
"14548","ENSGALG00000042767","30",1128565,1137195,8630
"14549","ENSGALG00000042771","1",96501042,96681455,180413
"14550","ENSGALG00000042773","2",51667752,51737491,69739
"14551","ENSGALG00000042782","13",3232427,3233694,1267
"14552","ENSGALG00000042784","2",55608568,55657394,48826
"14553","ENSGALG00000042786","3",5705855,5729959,24104
"14554","ENSGALG00000042794","2",121404192,121410278,6086
"14555","ENSGALG00000042796","27",7558533,7578198,19665
"14556","ENSGALG00000042797","3",27820731,27874634,53903
"14557","ENSGALG00000042798","2",118205626,118212272,6646
"14558","ENSGALG00000042804","32",136980,141334,4354
"14559","ENSGALG00000042809","5",642932,645731,2799
"14560","ENSGALG00000042810","14",15043163,15046202,3039
"14561","ENSGALG00000042814","18",9910288,9913104,2816
"14562","ENSGALG00000042816","3",17738450,17778887,40437
"14563","ENSGALG00000042819","19",376520,407568,31048
"14564","ENSGALG00000042822","2",32936040,32986423,50383
"14565","ENSGALG00000042833","26",148699,169260,20561
"14566","ENSGALG00000042836","2",362630,393535,30905
"14567","ENSGALG00000042838","17",895590,912182,16592
"14568","ENSGALG00000042839","10",9133006,9176492,43486
"14569","ENSGALG00000042840","2",124252530,124264647,12117
"14570","ENSGALG00000042845","2",63573759,63594156,20397
"14571","ENSGALG00000042846","23",1273535,1277081,3546
"14572","ENSGALG00000042850","31",1824121,1839705,15584
"14573","ENSGALG00000042851","4",73938490,74100704,162214
"14574","ENSGALG00000042853","3",38176341,38193355,17014
"14575","ENSGALG00000042858","2",62032429,62037354,4925
"14576","ENSGALG00000042863","12",1100608,1101574,966
"14577","ENSGALG00000042868","KZ626825.1",29,2019,1990
"14578","ENSGALG00000042871","6",23344960,23376231,31271
"14579","ENSGALG00000042875","1",176457890,176499190,41300
"14580","ENSGALG00000042878","5",7786825,7790904,4079
"14581","ENSGALG00000042881","3",34935191,34941029,5838
"14582","ENSGALG00000042883","2",115177217,115191152,13935
"14583","ENSGALG00000042890","30",1055772,1057605,1833
"14584","ENSGALG00000042894","27",5403407,5407823,4416
"14585","ENSGALG00000042895","11",1973371,1978777,5406
"14586","ENSGALG00000042897","3",9779027,9780354,1327
"14587","ENSGALG00000042900","28",3557584,3601481,43897
"14588","ENSGALG00000042908","2",528924,533328,4404
"14589","ENSGALG00000042928","7",18844717,18852677,7960
"14590","ENSGALG00000042929","7",22051500,22053693,2193
"14591","ENSGALG00000042936","1",79105078,79108598,3520
"14592","ENSGALG00000042939","24",66306,77077,10771
"14593","ENSGALG00000042941","25",443960,446995,3035
"14594","ENSGALG00000042944","1",194312916,194313335,419
"14595","ENSGALG00000042948","28",2819899,2829312,9413
"14596","ENSGALG00000042949","6",34943123,35085265,142142
"14597","ENSGALG00000042956","27",2933584,2934597,1013
"14598","ENSGALG00000042963","27",2222448,2250786,28338
"14599","ENSGALG00000042967","23",1366629,1381926,15297
"14600","ENSGALG00000042969","4",34542785,34549193,6408
"14601","ENSGALG00000042976","27",5440998,5453609,12611
"14602","ENSGALG00000042984","12",3535461,3540337,4876
"14603","ENSGALG00000042986","8",5989880,5995320,5440
"14604","ENSGALG00000042990","1",51627090,51635098,8008
"14605","ENSGALG00000042992","1",190815780,191167322,351542
"14606","ENSGALG00000042994","13",10892512,10899511,6999
"14607","ENSGALG00000042995","26",2214429,2216731,2302
"14608","ENSGALG00000043002","26",4985093,4986115,1022
"14609","ENSGALG00000043006","2",54400025,54411534,11509
"14610","ENSGALG00000043009","33",3422447,3427906,5459
"14611","ENSGALG00000043010","28",3470292,3476425,6133
"14612","ENSGALG00000043012","AADN05001408.1",2018,3306,1288
"14613","ENSGALG00000043015","20",10059031,10063374,4343
"14614","ENSGALG00000043016","5",283574,288430,4856
"14615","ENSGALG00000043018","6",14052274,14146920,94646
"14616","ENSGALG00000043021","25",3671693,3678692,6999
"14617","ENSGALG00000043025","5",725593,731173,5580
"14618","ENSGALG00000043026","24",6333315,6339570,6255
"14619","ENSGALG00000043027","1",186999629,187029048,29419
"14620","ENSGALG00000043033","2",116925618,117074063,148445
"14621","ENSGALG00000043034","11",481503,490062,8559
"14622","ENSGALG00000043035","1",178373699,178377553,3854
"14623","ENSGALG00000043036","5",39074525,39084657,10132
"14624","ENSGALG00000043039","11",16627313,16629994,2681
"14625","ENSGALG00000043041","2",65116070,65122819,6749
"14626","ENSGALG00000043044","1",135111322,135129457,18135
"14627","ENSGALG00000043047","3",67724491,67834185,109694
"14628","ENSGALG00000043052","16",2662153,2664893,2740
"14629","ENSGALG00000043053","15",6902659,6911582,8923
"14630","ENSGALG00000043055","20",5527707,5535779,8072
"14631","ENSGALG00000043056","5",59225570,59249341,23771
"14632","ENSGALG00000043058","1",16325266,16480222,154956
"14633","ENSGALG00000043064","17",865358,868425,3067
"14634","ENSGALG00000043072","33",4999482,5006921,7439
"14635","ENSGALG00000043073","4",75226129,75235810,9681
"14636","ENSGALG00000043074","5",602722,622068,19346
"14637","ENSGALG00000043077","KZ626838.1",793819,801605,7786
"14638","ENSGALG00000043079","7",16938757,16941586,2829
"14639","ENSGALG00000043080","3",414617,476460,61843
"14640","ENSGALG00000043081","3",17629538,17657173,27635
"14641","ENSGALG00000043082","9",23339007,23355944,16937
"14642","ENSGALG00000043085","13",17868579,17875462,6883
"14643","ENSGALG00000043087","8",14392869,14415870,23001
"14644","ENSGALG00000043088","24",274136,280913,6777
"14645","ENSGALG00000043089","5",305839,310594,4755
"14646","ENSGALG00000043092","1",51752609,51820554,67945
"14647","ENSGALG00000043100","1",114302896,114343550,40654
"14648","ENSGALG00000043103","24",167963,188765,20802
"14649","ENSGALG00000043106","4",44309648,44347593,37945
"14650","ENSGALG00000043118","1",132986041,133096377,110336
"14651","ENSGALG00000043126","11",18930459,18933187,2728
"14652","ENSGALG00000043128","21",135941,156749,20808
"14653","ENSGALG00000043129","25",468686,476770,8084
"14654","ENSGALG00000043130","6",730713,973717,243004
"14655","ENSGALG00000043133","14",12661769,12661839,70
"14656","ENSGALG00000043137","2",62116,147153,85037
"14657","ENSGALG00000043139","5",351861,366567,14706
"14658","ENSGALG00000043141","4",31189212,31192236,3024
"14659","ENSGALG00000043142","13",1438620,1451031,12411
"14660","ENSGALG00000043143","12",11958500,11959644,1144
"14661","ENSGALG00000043148","27",5497391,5499583,2192
"14662","ENSGALG00000043163","24",297265,317771,20506
"14663","ENSGALG00000043164","4",49377706,49484024,106318
"14664","ENSGALG00000043167","2",136321689,136339558,17869
"14665","ENSGALG00000043172","2",113184668,113281852,97184
"14666","ENSGALG00000043178","1",1216193,1275443,59250
"14667","ENSGALG00000043185","23",355962,372948,16986
"14668","ENSGALG00000043190","1",79846657,79883832,37175
"14669","ENSGALG00000043193","2",136617993,136673043,55050
"14670","ENSGALG00000043198","7",22137902,22168699,30797
"14671","ENSGALG00000043204","21",4449679,4535824,86145
"14672","ENSGALG00000043208","15",6590284,6599691,9407
"14673","ENSGALG00000043209","23",5139803,5162948,23145
"14674","ENSGALG00000043213","6",21531354,21536861,5507
"14675","ENSGALG00000043217","17",6883357,6889065,5708
"14676","ENSGALG00000043219","27",6260733,6271956,11223
"14677","ENSGALG00000043223","19",3673296,3828129,154833
"14678","ENSGALG00000043225","KZ626837.1",1841875,1905100,63225
"14679","ENSGALG00000043227","2",44992215,44996161,3946
"14680","ENSGALG00000043234","14",12510348,12511196,848
"14681","ENSGALG00000043240","2",45391067,45490043,98976
"14682","ENSGALG00000043243","2",49886907,49939510,52603
"14683","ENSGALG00000043252","2",67714111,67721182,7071
"14684","ENSGALG00000043254","19",615901,627255,11354
"14685","ENSGALG00000043256","4",46473486,46495672,22186
"14686","ENSGALG00000043257","1",133819265,133823382,4117
"14687","ENSGALG00000043258","8",10348449,10356499,8050
"14688","ENSGALG00000043260","AADN05001288.1",76,23170,23094
"14689","ENSGALG00000043265","2",148657782,148813559,155777
"14690","ENSGALG00000043268","7",2257279,2263751,6472
"14691","ENSGALG00000043280","3",39848255,39851675,3420
"14692","ENSGALG00000043283","4",73567819,73587984,20165
"14693","ENSGALG00000043285","27",7870892,7875550,4658
"14694","ENSGALG00000043287","1",25201248,25216271,15023
"14695","ENSGALG00000043290","3",16134059,16134772,713
"14696","ENSGALG00000043302","19",3007530,3016349,8819
"14697","ENSGALG00000043307","7",187764,224770,37006
"14698","ENSGALG00000043314","9",15431560,15431701,141
"14699","ENSGALG00000043318","21",3588412,3592563,4151
"14700","ENSGALG00000043327","21",6500073,6502229,2156
"14701","ENSGALG00000043329","9",15480961,15489074,8113
"14702","ENSGALG00000043336","33",7735364,7740331,4967
"14703","ENSGALG00000043352","28",194557,243536,48979
"14704","ENSGALG00000043355","1",15869289,16025693,156404
"14705","ENSGALG00000043357","15",7176576,7188824,12248
"14706","ENSGALG00000043359","12",514664,517975,3311
"14707","ENSGALG00000043363","14",12293603,12347992,54389
"14708","ENSGALG00000043367","1",13612065,13772223,160158
"14709","ENSGALG00000043368","1",94403620,94448933,45313
"14710","ENSGALG00000043370","33",6538217,6544142,5925
"14711","ENSGALG00000043372","23",2591781,2635428,43647
"14712","ENSGALG00000043373","15",1353112,1541582,188470
"14713","ENSGALG00000043379","2",41121646,41124715,3069
"14714","ENSGALG00000043381","2",43931993,43936917,4924
"14715","ENSGALG00000043383","1",191707498,191716146,8648
"14716","ENSGALG00000043386","9",17441931,17531426,89495
"14717","ENSGALG00000043388","9",10833569,10917743,84174
"14718","ENSGALG00000043389","13",9099977,9136125,36148
"14719","ENSGALG00000043392","6",1028705,1030144,1439
"14720","ENSGALG00000043393","1",94731886,94975094,243208
"14721","ENSGALG00000043394","17",5692033,5729186,37153
"14722","ENSGALG00000043399","2",54282326,54331241,48915
"14723","ENSGALG00000043400","33",5164024,5168544,4520
"14724","ENSGALG00000043405","22",669570,683049,13479
"14725","ENSGALG00000043408","5",497608,498546,938
"14726","ENSGALG00000043415","2",42151939,42170575,18636
"14727","ENSGALG00000043416","25",3701387,3709503,8116
"14728","ENSGALG00000043421","1",180409378,180447674,38296
"14729","ENSGALG00000043433","2",130828340,130839147,10807
"14730","ENSGALG00000043435","5",205918,211190,5272
"14731","ENSGALG00000043437","1",25007205,25036960,29755
"14732","ENSGALG00000043439","2",138725194,138851718,126524
"14733","ENSGALG00000043441","3",3945074,3953163,8089
"14734","ENSGALG00000043447","4",102382,128172,25790
"14735","ENSGALG00000043448","4",80649049,80786524,137475
"14736","ENSGALG00000043451","1",50795054,50799331,4277
"14737","ENSGALG00000043456","28",4391143,4393274,2131
"14738","ENSGALG00000043460","9",17025522,17026706,1184
"14739","ENSGALG00000043468","1",77945286,77949479,4193
"14740","ENSGALG00000043469","5",55228305,55251475,23170
"14741","ENSGALG00000043474","5",17730365,17758240,27875
"14742","ENSGALG00000043476","1",1096008,1102807,6799
"14743","ENSGALG00000043480","4",44148957,44291635,142678
"14744","ENSGALG00000043493","2",54916522,54922765,6243
"14745","ENSGALG00000043496","9",14044709,14044806,97
"14746","ENSGALG00000043499","17",8044471,8059104,14633
"14747","ENSGALG00000043506","10",1476303,1479577,3274
"14748","ENSGALG00000043510","33",1149140,1151650,2510
"14749","ENSGALG00000043513","26",47040,65837,18797
"14750","ENSGALG00000043524","3",97608096,97642230,34134
"14751","ENSGALG00000043529","4",33964564,33969346,4782
"14752","ENSGALG00000043532","2",117642593,117653773,11180
"14753","ENSGALG00000043535","2",124171738,124191159,19421
"14754","ENSGALG00000043541","Z",20851888,20875921,24033
"14755","ENSGALG00000043544","28",3402915,3403596,681
"14756","ENSGALG00000043545","3",234360,253444,19084
"14757","ENSGALG00000043555","4",38549409,38592266,42857
"14758","ENSGALG00000043556","Z",59778403,59879799,101396
"14759","ENSGALG00000043569","13",15019063,15029058,9995
"14760","ENSGALG00000043570","2",115207256,115264028,56772
"14761","ENSGALG00000043572","3",40687395,40693437,6042
"14762","ENSGALG00000043573","2",121412494,121426540,14046
"14763","ENSGALG00000043575","33",580300,581262,962
"14764","ENSGALG00000043576","2",218278,296609,78331
"14765","ENSGALG00000043582","2",148366525,148371835,5310
"14766","ENSGALG00000043583","10",9546288,9573569,27281
"14767","ENSGALG00000043584","3",82935508,83074937,139429
"14768","ENSGALG00000043587","3",96212,167859,71647
"14769","ENSGALG00000043591","5",25782297,25801921,19624
"14770","ENSGALG00000043593","1",7384177,7401613,17436
"14771","ENSGALG00000043596","9",5058062,5076194,18132
"14772","ENSGALG00000043597","2",125967941,126027308,59367
"14773","ENSGALG00000043598","MT",2346,3966,1620
"14774","ENSGALG00000043603","19",582380,583600,1220
"14775","ENSGALG00000043605","8",21126881,21131102,4221
"14776","ENSGALG00000043606","33",7229176,7232142,2966
"14777","ENSGALG00000043607","18",5003097,5006173,3076
"14778","ENSGALG00000043610","KZ626838.1",144669,159138,14469
"14779","ENSGALG00000043611","1",154076014,154157778,81764
"14780","ENSGALG00000043613","5",58291084,58332931,41847
"14781","ENSGALG00000043618","7",388116,402901,14785
"14782","ENSGALG00000043623","9",22259518,22261234,1716
"14783","ENSGALG00000043628","31",5630460,5636404,5944
"14784","ENSGALG00000043630","1",153464867,153537471,72604
"14785","ENSGALG00000043632","9",1900582,1903197,2615
"14786","ENSGALG00000043636","2",49804209,49839009,34800
"14787","ENSGALG00000043637","2",25813055,25858502,45447
"14788","ENSGALG00000043641","28",4077792,4078763,971
"14789","ENSGALG00000043642","2",46674840,46702450,27610
"14790","ENSGALG00000043650","8",14533300,14542952,9652
"14791","ENSGALG00000043654","27",2358040,2428061,70021
"14792","ENSGALG00000043657","3",40001158,40021495,20337
"14793","ENSGALG00000043662","11",352125,367971,15846
"14794","ENSGALG00000043669","4",46876386,47053196,176810
"14795","ENSGALG00000043671","16",1391736,1651259,259523
"14796","ENSGALG00000043672","12",1023267,1074387,51120
"14797","ENSGALG00000043674","18",4130668,4130777,109
"14798","ENSGALG00000043675","4",45202097,45302156,100059
"14799","ENSGALG00000043676","2",111284526,111289537,5011
"14800","ENSGALG00000043681","4",60099126,60121038,21912
"14801","ENSGALG00000043684","5",1838329,1847181,8852
"14802","ENSGALG00000043689","33",5271596,5276678,5082
"14803","ENSGALG00000043690","1",136717949,136721234,3285
"14804","ENSGALG00000043693","14",5436664,5454222,17558
"14805","ENSGALG00000043694","7",17440138,17583383,143245
"14806","ENSGALG00000043701","1",45781188,45815586,34398
"14807","ENSGALG00000043711","23",4307437,4329236,21799
"14808","ENSGALG00000043724","2",55368341,55428626,60285
"14809","ENSGALG00000043725","11",18437635,18452602,14967
"14810","ENSGALG00000043727","33",3308221,3313864,5643
"14811","ENSGALG00000043728","33",3182574,3222222,39648
"14812","ENSGALG00000043731","3",96250282,96258760,8478
"14813","ENSGALG00000043733","23",2546014,2550924,4910
"14814","ENSGALG00000043734","Z",1061896,1069535,7639
"14815","ENSGALG00000043735","31",5208704,5213525,4821
"14816","ENSGALG00000043736","33",5586870,5605814,18944
"14817","ENSGALG00000043744","13",17886252,17900470,14218
"14818","ENSGALG00000043754","8",6012850,6022834,9984
"14819","ENSGALG00000043756","28",4159762,4161927,2165
"14820","ENSGALG00000043763","10",18944945,18945015,70
"14821","ENSGALG00000043764","2",127547149,127548766,1617
"14822","ENSGALG00000043765","14",7834361,7869665,35304
"14823","ENSGALG00000043768","MT",5241,6279,1038
"14824","ENSGALG00000043771","1",1110497,1128266,17769
"14825","ENSGALG00000043772","27",2264729,2273025,8296
"14826","ENSGALG00000043775","33",5949842,5963192,13350
"14827","ENSGALG00000043785","2",130419407,130428964,9557
"14828","ENSGALG00000043787","2",136698116,136770823,72707
"14829","ENSGALG00000043797","9",609812,618447,8635
"14830","ENSGALG00000043799","2",136674584,136685316,10732
"14831","ENSGALG00000043800","1",31169553,31184130,14577
"14832","ENSGALG00000043806","15",5158427,5211083,52656
"14833","ENSGALG00000043816","21",5032125,5113478,81353
"14834","ENSGALG00000043823","30",389402,392236,2834
"14835","ENSGALG00000043825","12",982813,1016928,34115
"14836","ENSGALG00000043826","6",5877972,5897241,19269
"14837","ENSGALG00000043827","2",137877361,137879853,2492
"14838","ENSGALG00000043828","10",2074833,2084851,10018
"14839","ENSGALG00000043829","23",3374678,3380844,6166
"14840","ENSGALG00000043831","3",31044021,31050599,6578
