"","ensembl_gene_id","chromosome_name","start_position","end_position","length"
"1","ENSG00000000003","X",100627109,100639991,12882
"2","ENSG00000000005","X",100584936,100599885,14949
"3","ENSG00000000419","20",50934867,50958555,23688
"4","ENSG00000000457","1",169849631,169894267,44636
"5","ENSG00000000460","1",169662007,169854080,192073
"6","ENSG00000000938","1",27612064,27635185,23121
"7","ENSG00000000971","1",196651878,196747504,95626
"8","ENSG00000001036","6",143494811,143511690,16879
"9","ENSG00000001084","6",53497341,53616970,119629
"10","ENSG00000001167","6",41072945,41099976,27031
"11","ENSG00000001460","1",24356999,24416934,59935
"12","ENSG00000001461","1",24415802,24472976,57174
"13","ENSG00000001497","X",65512582,65534775,22193
"14","ENSG00000001561","6",46129989,46146688,16699
"15","ENSG00000001617","3",50155045,50189075,34030
"16","ENSG00000001626","7",117465784,117715971,250187
"17","ENSG00000001629","7",92245974,92401383,155409
"18","ENSG00000001630","7",92112153,92134803,22650
"19","ENSG00000001631","7",92198969,92246166,47197
"20","ENSG00000002016","12",912077,990053,77976
"21","ENSG00000002079","7",99238829,99311130,72301
"22","ENSG00000002330","11",64269830,64284704,14874
"23","ENSG00000002549","4",17577192,17607972,30780
"24","ENSG00000002586","X",2691187,2741309,50122
"25","ENSG00000002587","4",11393150,11429564,36414
"26","ENSG00000002726","7",150824627,150861504,36877
"27","ENSG00000002745","7",121325367,121341104,15737
"28","ENSG00000002746","7",43112629,43566001,453372
"29","ENSG00000002822","7",1815793,2233243,417450
"30","ENSG00000002834","17",38869859,38921770,51911
"31","ENSG00000002919","17",48103357,48123074,19717
"32","ENSG00000002933","7",150800403,150805118,4715
"33","ENSG00000003056","12",8940361,8949761,9400
"34","ENSG00000003096","X",117897813,118117340,219527
"35","ENSG00000003137","2",72129238,72148038,18800
"36","ENSG00000003147","7",8113184,8262687,149503
"37","ENSG00000003249","16",90004865,90020128,15263
"38","ENSG00000003393","2",201700267,201780956,80689
"39","ENSG00000003400","2",201182881,201229406,46525
"40","ENSG00000003402","2",201116154,201176687,60533
"41","ENSG00000003436","2",187464230,187565760,101530
"42","ENSG00000003509","2",37231631,37253403,21772
"43","ENSG00000003756","3",50088908,50119021,30113
"44","ENSG00000003987","8",17296794,17413528,116734
"45","ENSG00000003989","8",17497088,17570573,73485
"46","ENSG00000004059","7",127588386,127591700,3314
"47","ENSG00000004139","17",28364356,28404049,39693
"48","ENSG00000004142","17",28346633,28357527,10894
"49","ENSG00000004399","3",129555175,129606818,51643
"50","ENSG00000004455","1",33007940,33080996,73056
"51","ENSG00000004468","4",15778275,15853232,74957
"52","ENSG00000004478","12",2794970,2805423,10453
"53","ENSG00000004487","1",23019443,23083689,64246
"54","ENSG00000004534","3",49940007,50100045,160038
"55","ENSG00000004660","17",3860315,3894891,34576
"56","ENSG00000004700","12",21468910,21501669,32759
"57","ENSG00000004766","7",93232340,93361123,128783
"58","ENSG00000004776","19",35754566,35758079,3513
"59","ENSG00000004777","19",35774532,35788822,14290
"60","ENSG00000004779","16",23581014,23596316,15302
"61","ENSG00000004799","7",95583499,95596516,13017
"62","ENSG00000004809","6",110424687,110476641,51954
"63","ENSG00000004838","3",50341110,50345732,4622
"64","ENSG00000004846","7",20615207,20777038,161831
"65","ENSG00000004848","X",25003694,25016420,12726
"66","ENSG00000004864","7",96120220,96322147,201927
"67","ENSG00000004866","7",116953238,117230103,276865
"68","ENSG00000004897","17",47117703,47189422,71719
"69","ENSG00000004939","17",44248390,44268141,19751
"70","ENSG00000004948","7",93424487,93574730,150243
"71","ENSG00000004961","X",11111301,11123086,11785
"72","ENSG00000004975","17",7225342,7234517,9175
"73","ENSG00000005001","16",2852730,2858170,5440
"74","ENSG00000005007","19",18831938,18868236,36298
"75","ENSG00000005020","7",26667068,26995239,328171
"76","ENSG00000005022","X",119468422,119471396,2974
"77","ENSG00000005059","4",109560209,109688719,128510
"78","ENSG00000005073","7",27181510,27185223,3713
"79","ENSG00000005075","7",102473118,102478907,5789
"80","ENSG00000005100","17",5440917,5468982,28065
"81","ENSG00000005102","17",43640389,43661922,21533
"82","ENSG00000005108","7",11370365,11832198,461833
"83","ENSG00000005156","17",34980494,35009743,29249
"84","ENSG00000005175","12",47661249,47706030,44781
"85","ENSG00000005187","16",20610243,20797581,187338
"86","ENSG00000005189","16",20806429,20849668,43239
"87","ENSG00000005194","16",57428187,57447420,19233
"88","ENSG00000005206","19",2328615,2355095,26480
"89","ENSG00000005238","9",35104112,35116341,12229
"90","ENSG00000005243","17",48026167,48038030,11863
"91","ENSG00000005249","7",107044705,107161811,117106
"92","ENSG00000005302","X",11758159,11775772,17613
"93","ENSG00000005339","16",3725054,3880726,155672
"94","ENSG00000005379","17",58301228,58328795,27567
"95","ENSG00000005381","17",58269856,58280935,11079
"96","ENSG00000005421","7",95297676,95324707,27031
"97","ENSG00000005436","2",75652000,75710989,58989
"98","ENSG00000005448","2",74421678,74425755,4077
"99","ENSG00000005469","7",87345681,87399795,54114
"100","ENSG00000005471","7",87401697,87480435,78738
"101","ENSG00000005483","7",105014190,105115019,100829
"102","ENSG00000005486","7",75842602,75888926,46324
"103","ENSG00000005513","16",981770,986979,5209
"104","ENSG00000005700","6",82169986,82247754,77768
"105","ENSG00000005801","11",3339261,3379222,39961
"106","ENSG00000005810","13",77044657,77327094,282437
"107","ENSG00000005812","13",76992598,77027195,34597
"108","ENSG00000005844","16",30472658,30523185,50527
"109","ENSG00000005882","17",50094737,50112152,17415
"110","ENSG00000005884","17",50055968,50090481,34513
"111","ENSG00000005889","X",24149173,24216255,67082
"112","ENSG00000005893","X",120427827,120469365,41538
"113","ENSG00000005961","17",44372180,44389505,17325
"114","ENSG00000005981","7",95478444,95540233,61789
"115","ENSG00000006007","16",19501693,19522123,20430
"116","ENSG00000006015","19",18588685,18592336,3651
"117","ENSG00000006016","19",18572220,18607741,35521
"118","ENSG00000006025","17",47807372,47821834,14462
"119","ENSG00000006042","17",32927910,32945106,17196
"120","ENSG00000006047","17",7288263,7294639,6376
"121","ENSG00000006059","17",41346092,41350812,4720
"122","ENSG00000006062","17",45263119,45317029,53910
"123","ENSG00000006071","11",17392498,17476879,84381
"124","ENSG00000006116","16",24255553,24362801,107248
"125","ENSG00000006118","11",60924463,60937159,12696
"126","ENSG00000006125","17",35578046,35726413,148367
"127","ENSG00000006128","7",97732084,97740472,8388
"128","ENSG00000006194","16",3263800,3301401,37601
"129","ENSG00000006210","16",57372477,57385044,12567
"130","ENSG00000006282","17",50543058,50555852,12794
"131","ENSG00000006283","17",50560715,50627474,66759
"132","ENSG00000006327","16",3018445,3022383,3938
"133","ENSG00000006377","7",97005553,97011040,5487
"134","ENSG00000006432","14",70722526,70809534,87008
"135","ENSG00000006451","7",39623565,39708120,84555
"136","ENSG00000006453","7",98291650,98401090,109440
"137","ENSG00000006459","7",140084746,140176983,92237
"138","ENSG00000006468","7",13891229,13991425,100196
"139","ENSG00000006530","7",141551278,141655244,103966
"140","ENSG00000006534","11",68008578,68029282,20704
"141","ENSG00000006555","1",54779712,54801323,21611
"142","ENSG00000006576","7",77798792,77957503,158711
"143","ENSG00000006606","7",75769533,75789896,20363
"144","ENSG00000006607","2",241356285,241494841,138556
"145","ENSG00000006611","11",17493895,17544416,50521
"146","ENSG00000006625","7",30496621,30504841,8220
"147","ENSG00000006634","7",87876216,87909553,33337
"148","ENSG00000006638","19",3594506,3606840,12334
"149","ENSG00000006652","7",112422968,112481017,58049
"150","ENSG00000006659","19",39704481,39709444,4963
"151","ENSG00000006695","17",14069490,14231736,162246
"152","ENSG00000006704","7",74453790,74602604,148814
"153","ENSG00000006712","19",39385629,39391154,5525
"154","ENSG00000006715","7",38722974,38932394,209420
"155","ENSG00000006740","17",12789498,12991643,202145
"156","ENSG00000006744","17",12991612,13018065,26453
"157","ENSG00000006747","7",12570577,12660182,89605
"158","ENSG00000006756","X",2903972,2929349,25377
"159","ENSG00000006757","X",7898247,7927739,29492
"160","ENSG00000006788","17",10300865,10373130,72265
"161","ENSG00000006831","12",1688574,1788674,100100
"162","ENSG00000006837","5",134286350,134371047,84697
"163","ENSG00000007001","2",157876702,158136154,259452
"164","ENSG00000007038","16",2817180,2826304,9124
"165","ENSG00000007047","19",45079288,45305284,225996
"166","ENSG00000007062","4",15963076,16084378,121302
"167","ENSG00000007080","19",17933015,17943991,10976
"168","ENSG00000007129","19",41549518,41586844,37326
"169","ENSG00000007168","17",2593210,2685615,92405
"170","ENSG00000007171","17",27756766,27800499,43733
"171","ENSG00000007174","17",11598470,11969748,371278
"172","ENSG00000007202","17",28614446,28645454,31008
"173","ENSG00000007216","17",28473293,28497781,24488
"174","ENSG00000007237","17",9910609,10198551,287942
"175","ENSG00000007255","19",45162928,45178237,15309
"176","ENSG00000007264","19",3777970,3802129,24159
"177","ENSG00000007306","19",41673303,41706976,33673
"178","ENSG00000007312","17",63928740,63932354,3614
"179","ENSG00000007314","17",63938554,63972918,34364
"180","ENSG00000007341","1",112523514,112620825,97311
"181","ENSG00000007350","X",154295795,154330350,34555
"182","ENSG00000007372","11",31784779,31817961,33182
"183","ENSG00000007376","16",784974,788397,3423
"184","ENSG00000007384","16",58059,76355,18296
"185","ENSG00000007392","16",188969,229463,40494
"186","ENSG00000007402","3",50362799,50504244,141445
"187","ENSG00000007516","16",1333601,1349441,15840
"188","ENSG00000007520","16",1349240,1351878,2638
"189","ENSG00000007541","16",566995,584136,17141
"190","ENSG00000007545","16",1612325,1677908,65583
"191","ENSG00000007866","6",35473597,35497079,23482
"192","ENSG00000007908","1",169722640,169764705,42065
"193","ENSG00000007923","1",6634168,6701924,67756
"194","ENSG00000007933","1",171090901,171117819,26918
"195","ENSG00000007944","6",16129086,16148248,19162
"196","ENSG00000007952","X",100843324,100874359,31035
"197","ENSG00000007968","1",23506438,23531233,24795
"198","ENSG00000008018","6",170535120,170553307,18187
"199","ENSG00000008056","X",47571901,47619857,47956
"200","ENSG00000008083","6",15246069,15522042,275973
"201","ENSG00000008086","X",18425583,18653629,228046
"202","ENSG00000008118","1",209583714,209613939,30225
"203","ENSG00000008128","1",1702379,1724357,21978
"204","ENSG00000008130","1",1751232,1780457,29225
"205","ENSG00000008196","6",50818723,50847619,28896
"206","ENSG00000008197","6",50713828,50772988,59160
"207","ENSG00000008226","3",38039205,38124025,84820
"208","ENSG00000008256","7",6161776,6272644,110868
"209","ENSG00000008277","7",87934143,88202889,268746
"210","ENSG00000008282","7",106090503,106112576,22073
"211","ENSG00000008283","17",63432304,63446354,14050
"212","ENSG00000008294","17",50962174,51120868,158694
"213","ENSG00000008300","3",48636463,48662886,26423
"214","ENSG00000008311","7",122073549,122144255,70706
"215","ENSG00000008323","12",6310436,6328506,18070
"216","ENSG00000008324","3",42581840,42595114,13274
"217","ENSG00000008382","19",4343527,4360086,16559
"218","ENSG00000008394","12",16347142,16609259,262117
"219","ENSG00000008405","12",106991364,107093549,102185
"220","ENSG00000008438","19",46019153,46023053,3900
"221","ENSG00000008441","19",12995608,13098796,103188
"222","ENSG00000008513","8",133454848,133571940,117092
"223","ENSG00000008516","16",3046561,3060726,14165
"224","ENSG00000008517","16",3065297,3082192,16895
"225","ENSG00000008710","16",2088710,2135898,47188
"226","ENSG00000008735","22",50600793,50613981,13188
"227","ENSG00000008838","17",40019097,40061215,42118
"228","ENSG00000008853","8",22987417,23020199,32782
"229","ENSG00000008869","2",36968383,37084372,115989
"230","ENSG00000008952","3",169966635,169998373,31738
"231","ENSG00000008988","8",56067295,56074581,7286
"232","ENSG00000009307","1",114716913,114758676,41763
"233","ENSG00000009335","7",157138916,157269370,130454
"234","ENSG00000009413","6",111299028,111483715,184687
"235","ENSG00000009694","X",124375903,124963817,587914
"236","ENSG00000009709","1",18630846,18748866,118020
"237","ENSG00000009724","1",11026523,11047233,20710
"238","ENSG00000009765","6",150368892,150405969,37077
"239","ENSG00000009780","1",27725979,27763122,37143
"240","ENSG00000009790","1",209756032,209782320,26288
"241","ENSG00000009830","14",77274956,77320884,45928
"242","ENSG00000009844","6",142147162,142224685,77523
"243","ENSG00000009950","7",73593194,73624543,31349
"244","ENSG00000009954","7",73440406,73522293,81887
"245","ENSG00000010017","6",13621498,13711835,90337
"246","ENSG00000010030","6",36354091,36387800,33709
"247","ENSG00000010072","1",231337104,231355023,17919
"248","ENSG00000010165","1",171781660,171814023,32363
"249","ENSG00000010219","12",4562204,4615302,53098
"250","ENSG00000010244","17",32350117,32381886,31769
"251","ENSG00000010256","3",48599002,48610976,11974
"252","ENSG00000010270","7",38178222,38230671,52449
"253","ENSG00000010278","12",6199715,6238271,38556
"254","ENSG00000010282","3",42692663,42702827,10164
"255","ENSG00000010292","12",6493356,6531955,38599
"256","ENSG00000010295","12",6538375,6556083,17708
"257","ENSG00000010310","19",45668221,45683722,15501
"258","ENSG00000010318","3",52410660,52423641,12981
"259","ENSG00000010319","3",52433053,52445085,12032
"260","ENSG00000010322","3",52455118,52493068,37950
"261","ENSG00000010327","3",52495338,52524495,29157
"262","ENSG00000010361","19",49806869,49817376,10507
"263","ENSG00000010379","12",220621,262873,42252
"264","ENSG00000010404","X",149476988,149521096,44108
"265","ENSG00000010438","9",33750466,33799231,48765
"266","ENSG00000010539","16",3222325,3236221,13896
"267","ENSG00000010610","12",6786858,6820799,33941
"268","ENSG00000010626","12",6873569,6914241,40672
"269","ENSG00000010671","X",101349447,101390796,41349
"270","ENSG00000010704","6",26087281,26098343,11062
"271","ENSG00000010803","1",41027200,41242154,214954
"272","ENSG00000010810","6",111660332,111873452,213120
"273","ENSG00000010818","6",142751469,142956698,205229
"274","ENSG00000010932","1",171248471,171285978,37507
"275","ENSG00000011007","1",23743155,23762059,18904
"276","ENSG00000011009","1",23791145,23795539,4394
"277","ENSG00000011021","1",11806096,11848079,41983
"278","ENSG00000011028","17",62627670,62693597,65927
"279","ENSG00000011052","17",51153590,51171744,18154
"280","ENSG00000011083","5",150190062,150222788,32726
"281","ENSG00000011105","12",3077355,3286564,209209
"282","ENSG00000011114","14",93237550,93333092,95542
"283","ENSG00000011132","19",3750772,3761692,10920
"284","ENSG00000011143","17",58205437,58219605,14168
"285","ENSG00000011198","3",43690108,43734371,44263
"286","ENSG00000011201","X",8528874,8732137,203263
"287","ENSG00000011243","19",15380050,15419141,39091
"288","ENSG00000011258","17",51177425,51260163,82738
"289","ENSG00000011260","17",51260546,51297936,37390
"290","ENSG00000011275","7",5620047,5781739,161692
"291","ENSG00000011295","17",15999784,16045015,45231
"292","ENSG00000011304","19",797075,812327,15252
"293","ENSG00000011332","19",38211006,38229714,18708
"294","ENSG00000011347","11",61515313,61581148,65835
"295","ENSG00000011376","3",45388561,45554726,166165
"296","ENSG00000011405","11",17077730,17207983,130253
"297","ENSG00000011422","19",43646095,43670547,24452
"298","ENSG00000011426","7",36389821,36453791,63970
"299","ENSG00000011451","19",15419980,15449951,29971
"300","ENSG00000011454","9",122940833,123104866,164033
"301","ENSG00000011465","12",91140484,91182824,42340
"302","ENSG00000011478","19",45692666,45703989,11323
"303","ENSG00000011485","19",46346994,46392981,45987
"304","ENSG00000011523","2",65056366,65087004,30638
"305","ENSG00000011566","2",39249266,39437301,188035
"306","ENSG00000011590","19",35704558,35717038,12480
"307","ENSG00000011600","19",35904401,35908295,3894
"308","ENSG00000011638","16",21158377,21180616,22239
"309","ENSG00000011677","X",152166234,152451315,285081
"310","ENSG00000012048","17",43044295,43170245,125950
"311","ENSG00000012061","19",45407333,45478828,71495
"312","ENSG00000012124","19",35319261,35347361,28100
"313","ENSG00000012171","3",50267558,50277546,9988
"314","ENSG00000012174","X",21839617,21885423,45806
"315","ENSG00000012211","X",49174802,49186528,11726
"316","ENSG00000012223","3",46435645,46485234,49589
"317","ENSG00000012232","8",28600469,28755599,155130
"318","ENSG00000012504","12",100473708,100564414,90706
"319","ENSG00000012660","6",53267398,53349179,81781
"320","ENSG00000012779","10",45374176,45446119,71943
"321","ENSG00000012817","Y",19703865,19744939,41074
"322","ENSG00000012822","12",53708517,53727745,19228
"323","ENSG00000012963","14",93207241,93229215,21974
"324","ENSG00000012983","14",50418501,50561126,142625
"325","ENSG00000013016","2",31234152,31269451,35299
"326","ENSG00000013275","19",39971005,39981441,10436
"327","ENSG00000013288","4",6575175,6623362,48187
"328","ENSG00000013293","3",170459548,170586075,126527
"329","ENSG00000013297","3",170418865,170454733,35868
"330","ENSG00000013306","17",44319625,44324870,5245
"331","ENSG00000013364","16",29820394,29848039,27645
"332","ENSG00000013374","7",151341699,151378449,36750
"333","ENSG00000013375","6",83161150,83193936,32786
"334","ENSG00000013392","6",83193357,83198935,5578
"335","ENSG00000013441","2",200853009,200864744,11735
"336","ENSG00000013503","12",106357748,106510198,152450
"337","ENSG00000013523","14",76786178,76826246,40068
"338","ENSG00000013561","5",141958328,141990292,31964
"339","ENSG00000013563","X",154401236,154412112,10876
"340","ENSG00000013573","12",31073860,31104799,30939
"341","ENSG00000013583","12",12974870,13000265,25395
"342","ENSG00000013588","12",12890782,12917937,27155
"343","ENSG00000013619","X",150361422,150514178,152756
"344","ENSG00000013725","11",60971680,61020377,48697
"345","ENSG00000013810","4",1712891,1745176,32285
"346","ENSG00000014123","6",96521595,96555276,33681
"347","ENSG00000014138","11",65261920,65305589,43669
"348","ENSG00000014164","8",143437659,143541447,103788
"349","ENSG00000014216","11",65180566,65212006,31440
"350","ENSG00000014257","3",132317369,132368298,50929
"351","ENSG00000014641","2",63588609,63607197,18588
"352","ENSG00000014824","4",41990502,42090461,99959
"353","ENSG00000014914","1",149928651,149936879,8228
"354","ENSG00000014919","10",99711844,99732100,20256
"355","ENSG00000015133","14",91271323,91417844,146521
"356","ENSG00000015153","12",42157104,42238349,81245
"357","ENSG00000015171","10",134465,254637,120172
"358","ENSG00000015285","X",48676596,48691427,14831
"359","ENSG00000015413","16",89613308,89638456,25148
"360","ENSG00000015475","22",17734138,17774770,40632
"361","ENSG00000015479","5",139293648,139331677,38029
"362","ENSG00000015520","7",44512535,44541315,28780
"363","ENSG00000015532","17",50346092,50363138,17046
"364","ENSG00000015568","2",109792758,109857705,64947
"365","ENSG00000015592","8",27235323,27258420,23097
"366","ENSG00000015676","7",44379119,44490658,111539
"367","ENSG00000016082","5",51383448,51394730,11282
"368","ENSG00000016391","3",53812335,53846419,34084
"369","ENSG00000016402","6",136999971,137045180,45209
"370","ENSG00000016490","1",86468368,86500289,31921
"371","ENSG00000016602","1",86547078,86580754,33676
"372","ENSG00000016864","3",52694488,52706032,11544
"373","ENSG00000017260","3",130850595,131016712,166117
"374","ENSG00000017427","12",102395874,102481744,85870
"375","ENSG00000017483","X",48458537,48470260,11723
"376","ENSG00000017797","18",9475009,9538114,63105
"377","ENSG00000018189","4",70704204,70808619,104415
"378","ENSG00000018236","12",40692439,41072415,379976
"379","ENSG00000018280","2",218382029,218396894,14865
"380","ENSG00000018408","3",149517235,149736714,219479
"381","ENSG00000018510","2",177392768,177559299,166531
"382","ENSG00000018607","2",132309309,132318736,9427
"383","ENSG00000018610","X",119538149,119565408,27259
"384","ENSG00000018625","1",160115759,160143591,27832
"385","ENSG00000018699","2",32628032,32821051,193019
"386","ENSG00000018869","19",56375846,56393545,17699
"387","ENSG00000019102","11",124747474,124752255,4781
"388","ENSG00000019144","11",118606440,118658031,51591
"389","ENSG00000019169","2",118942166,118994660,52494
"390","ENSG00000019186","20",54153446,54173986,20540
"391","ENSG00000019485","11",45095806,45235110,139304
"392","ENSG00000019505","11",45240302,45286341,46039
"393","ENSG00000019549","8",48917598,48921740,4142
"394","ENSG00000019582","5",150400041,150412929,12888
"395","ENSG00000019991","7",81699010,81770438,71428
"396","ENSG00000019995","10",124942123,124988189,46066
"397","ENSG00000020129","1",35557473,35567274,9801
"398","ENSG00000020181","8",37784191,37844896,60705
"399","ENSG00000020219","7",152445477,152447150,1673
"400","ENSG00000020256","20",52051663,52204308,152645
"401","ENSG00000020426","14",60734742,60969965,235223
"402","ENSG00000020577","14",54567097,54793315,226218
"403","ENSG00000020633","1",24899511,24965121,65610
"404","ENSG00000020922","11",94415578,94493908,78330
"405","ENSG00000021300","11",73646178,73662819,16641
"406","ENSG00000021355","6",2832332,2841959,9627
"407","ENSG00000021461","7",99828013,99866102,38089
"408","ENSG00000021488","19",32830509,32869767,39258
"409","ENSG00000021574","2",32063547,32157637,94090
"410","ENSG00000021645","14",78170373,79868290,1697917
"411","ENSG00000021762","11",3087107,3166739,79632
"412","ENSG00000021776","15",34851782,34969742,117960
"413","ENSG00000021826","2",210477682,210679107,201425
"414","ENSG00000021852","1",56929207,56966140,36933
"415","ENSG00000022267","X",136146702,136211359,64657
"416","ENSG00000022277","20",56468585,56519449,50864
"417","ENSG00000022355","5",161847063,161899981,52918
"418","ENSG00000022556","19",54953130,55001142,48012
"419","ENSG00000022567","8",141207166,141308305,101139
"420","ENSG00000022840","12",120533480,120577588,44108
"421","ENSG00000022976","14",102317377,102342702,25325
"422","ENSG00000023041","10",112424428,112446917,22489
"423","ENSG00000023171","11",123358428,123627774,269346
"424","ENSG00000023191","11",494512,507300,12788
"425","ENSG00000023228","2",206114817,206159509,44692
"426","ENSG00000023287","8",52622458,52745843,123385
"427","ENSG00000023318","9",99979185,100099000,119815
"428","ENSG00000023330","3",52198086,52214327,16241
"429","ENSG00000023445","11",102317450,102339403,21953
"430","ENSG00000023516","13",42272152,42323261,51109
"431","ENSG00000023572","1",193090866,193106114,15248
"432","ENSG00000023608","14",61762420,61796428,34008
"433","ENSG00000023697","12",15911302,16037381,126079
"434","ENSG00000023734","12",15882387,15903478,21091
"435","ENSG00000023839","10",99782640,99852594,69954
"436","ENSG00000023892","6",35297818,35321771,23953
"437","ENSG00000023902","1",150149183,150164720,15537
"438","ENSG00000023909","1",93885199,93909456,24257
"439","ENSG00000024048","6",42564062,42693504,129442
"440","ENSG00000024422","19",47713422,47743134,29712
"441","ENSG00000024526","1",68474152,68497221,23069
"442","ENSG00000024862","6",138773509,138793319,19810
"443","ENSG00000025039","6",89364636,89412270,47634
"444","ENSG00000025156","6",122399546,122433119,33573
"445","ENSG00000025293","20",35771974,35950370,178396
"446","ENSG00000025423","12",56752161,56787790,35629
"447","ENSG00000025434","11",47248300,47269033,20733
"448","ENSG00000025708","22",50525752,50530032,4280
"449","ENSG00000025770","22",50508224,50524780,16556
"450","ENSG00000025772","20",44942130,44960397,18267
"451","ENSG00000025796","6",107867756,107958208,90452
"452","ENSG00000025800","1",32108056,32176563,68507
"453","ENSG00000026025","10",17228241,17237593,9352
"454","ENSG00000026036","20",63659300,63698684,39384
"455","ENSG00000026103","10",88990531,89017059,26528
"456","ENSG00000026297","6",166929504,166957191,27687
"457","ENSG00000026508","11",35138870,35232402,93532
"458","ENSG00000026559","20",51003656,51023107,19451
"459","ENSG00000026652","6",161129967,161274061,144094
"460","ENSG00000026751","1",160739057,160754821,15764
"461","ENSG00000026950","6",26402237,26415208,12971
"462","ENSG00000027001","13",23730189,23889400,159211
"463","ENSG00000027075","14",61187559,61550976,363417
"464","ENSG00000027644","1",156840063,156859117,19054
"465","ENSG00000027697","6",137197484,137219449,21965
"466","ENSG00000027847","5",177600132,177610330,10198
"467","ENSG00000027869","1",156806243,156816862,10619
"468","ENSG00000028116","2",57907629,58159920,252291
"469","ENSG00000028137","1",12166991,12209228,42237
"470","ENSG00000028203","12",95217746,95302799,85053
"471","ENSG00000028277","19",42086110,42196585,110475
"472","ENSG00000028310","5",850291,892801,42510
"473","ENSG00000028528","15",64094123,64146090,51967
"474","ENSG00000028839","6",133952170,133990432,38262
"475","ENSG00000029153","12",27332854,27425289,92435
"476","ENSG00000029363","6",136256627,136289851,33224
"477","ENSG00000029364","14",69398015,69462390,64375
"478","ENSG00000029534","8",41653220,41896762,243542
"479","ENSG00000029559","4",87799554,87812435,12881
"480","ENSG00000029639","6",155256134,155314493,58359
"481","ENSG00000029725","17",5282265,5386340,104075
"482","ENSG00000029993","X",150980509,150990771,10262
"483","ENSG00000030066","11",47778087,47848555,70468
"484","ENSG00000030110","6",33572547,33580293,7746
"485","ENSG00000030304","9",110668771,110801620,132849
"486","ENSG00000030419","2",212999691,213152427,152736
"487","ENSG00000030582","17",44345246,44353106,7860
"488","ENSG00000031003","5",137937960,138051961,114001
"489","ENSG00000031081","3",119294373,119420714,126341
"490","ENSG00000031691","6",49463370,49493107,29737
"491","ENSG00000031698","1",109213918,109238182,24264
"492","ENSG00000031823","19",5916139,5978142,62003
"493","ENSG00000032219","14",58298385,58373887,75502
"494","ENSG00000032389","2",3188925,3377882,188957
"495","ENSG00000032444","19",7534004,7561764,27760
"496","ENSG00000032742","13",20567069,20691437,124368
"497","ENSG00000033011","16",5033923,5087379,53456
"498","ENSG00000033030","12",122471600,122501073,29473
"499","ENSG00000033050","7",151211484,151227205,15721
"500","ENSG00000033100","7",151232489,151238827,6338
"501","ENSG00000033122","1",69568261,70151945,583684
"502","ENSG00000033170","14",65410592,65744121,333529
"503","ENSG00000033178","4",67612652,67701155,88503
"504","ENSG00000033327","11",78215293,78418348,203055
"505","ENSG00000033627","17",42458844,42522611,63767
"506","ENSG00000033800","15",68054179,68198603,144424
"507","ENSG00000033867","3",27372721,27484420,111699
"508","ENSG00000034053","15",28884483,29118315,233832
"509","ENSG00000034152","17",21284672,21315240,30568
"510","ENSG00000034239","8",48710789,48735311,24522
"511","ENSG00000034510","2",84905656,84906671,1015
"512","ENSG00000034533","3",131013875,131027649,13774
"513","ENSG00000034677","8",100257060,100336218,79158
"514","ENSG00000034693","6",143450805,143490616,39811
"515","ENSG00000034713","16",75566375,75577881,11506
"516","ENSG00000034971","1",171635417,171652688,17271
"517","ENSG00000035115","2",217730,266398,48668
"518","ENSG00000035141","2",70295975,70302090,6115
"519","ENSG00000035403","10",73995193,74121363,126170
"520","ENSG00000035499","5",60596912,60700190,103278
"521","ENSG00000035664","15",63907036,64072033,164997
"522","ENSG00000035681","8",58583508,58659853,76345
"523","ENSG00000035687","1",244408494,244451909,43415
"524","ENSG00000035720","4",67558727,67607337,48610
"525","ENSG00000035862","17",78852977,78925387,72410
"526","ENSG00000035928","4",39287456,39366375,78919
"527","ENSG00000036054","3",100260992,100325251,64259
"528","ENSG00000036257","2",224470150,224585397,115247
"529","ENSG00000036448","8",2045046,2165552,120506
"530","ENSG00000036473","X",38352586,38421446,68860
"531","ENSG00000036530","14",99684304,99727301,42997
"532","ENSG00000036549","1",77562416,77683419,121003
"533","ENSG00000036565","8",20144855,20183206,38351
"534","ENSG00000036672","11",119355215,119381711,26496
"535","ENSG00000036828","3",122183683,122291629,107946
"536","ENSG00000037042","17",42659284,42667006,7722
"537","ENSG00000037241","5",172958729,172969771,11042
"538","ENSG00000037280","5",180601506,180649624,48118
"539","ENSG00000037474","5",6599239,6633291,34052
"540","ENSG00000037637","1",16246840,16352480,105640
"541","ENSG00000037749","5",154038906,154220478,181572
"542","ENSG00000037757","19",13764522,13774282,9760
"543","ENSG00000037897","12",57768471,57772119,3648
"544","ENSG00000037965","12",54008985,54012769,3784
"545","ENSG00000038002","4",177430774,177442437,11663
"546","ENSG00000038210","4",25160663,25279204,118541
"547","ENSG00000038219","4",13568738,13627725,58987
"548","ENSG00000038274","5",163503114,163519354,16240
"549","ENSG00000038295","4",165873237,166104457,231220
"550","ENSG00000038358","16",67873052,67884499,11447
"551","ENSG00000038382","5",14143342,14532128,388786
"552","ENSG00000038427","5",83471618,83582303,110685
"553","ENSG00000038532","16",10944564,11182186,237622
"554","ENSG00000038945","8",16107878,16567490,459612
"555","ENSG00000039068","16",68737292,68835541,98249
"556","ENSG00000039123","5",55307989,55425579,117590
"557","ENSG00000039139","5",13690331,13944543,254212
"558","ENSG00000039319","5",80408013,80483379,75366
"559","ENSG00000039523","16",67518418,67546788,28370
"560","ENSG00000039537","5",41142234,41261438,119204
"561","ENSG00000039560","5",34656328,34832612,176284
"562","ENSG00000039600","5",157625679,157671480,45801
"563","ENSG00000039650","19",49859882,49878351,18469
"564","ENSG00000039987","19",12751702,12758458,6756
"565","ENSG00000040199","16",71637835,71724701,86866
"566","ENSG00000040275","5",169583636,169604778,21142
"567","ENSG00000040341","8",73420369,73747708,327339
"568","ENSG00000040487","1",19312326,19329300,16974
"569","ENSG00000040531","17",3636468,3661542,25074
"570","ENSG00000040608","22",20241415,20283246,41831
"571","ENSG00000040633","17",7235029,7239722,4693
"572","ENSG00000040731","5",24487100,24644978,157878
"573","ENSG00000040933","2",98444854,98594390,149536
"574","ENSG00000041353","18",54717860,54895516,177656
"575","ENSG00000041357","15",78540405,78552417,12012
"576","ENSG00000041515","13",108596152,109208005,611853
"577","ENSG00000041802","3",194640791,194672463,31672
"578","ENSG00000041880","3",51942345,51948867,6522
"579","ENSG00000041982","9",115019575,115118257,98682
"580","ENSG00000041988","1",6624866,6635586,10720
"581","ENSG00000042062","20",50586108,50691527,105419
"582","ENSG00000042088","14",89954939,90044768,89829
"583","ENSG00000042286","10",70098223,70132934,34711
"584","ENSG00000042304","2",227610090,227648606,38516
"585","ENSG00000042317","14",88384924,88470350,85426
"586","ENSG00000042429","11",93784227,93814963,30736
"587","ENSG00000042445","2",85341955,85354531,12576
"588","ENSG00000042493","2",85394753,85418432,23679
"589","ENSG00000042753","19",46838136,46850992,12856
"590","ENSG00000042781","1",215622891,216423448,800557
"591","ENSG00000042813","7",49850421,50121329,270908
"592","ENSG00000042832","8",132866958,133134903,267945
"593","ENSG00000042980","8",24294040,24359018,64978
"594","ENSG00000043039","11",129375940,129452279,76339
"595","ENSG00000043093","3",182938074,182985953,47879
"596","ENSG00000043143","5",134524312,134583230,58918
"597","ENSG00000043355","13",99981784,99986765,4981
"598","ENSG00000043462","5",170246233,170297818,51585
"599","ENSG00000043514","1",39838110,39883511,45401
"600","ENSG00000043591","10",114044056,114046908,2852
"601","ENSG00000044012","1",42153410,42155820,2410
"602","ENSG00000044090","6",43037617,43053945,16328
"603","ENSG00000044115","5",138610967,138935034,324067
"604","ENSG00000044446","X",18892300,18984598,92298
"605","ENSG00000044459","9",17134982,17503923,368941
"606","ENSG00000044524","3",89107621,89482134,374513
"607","ENSG00000044574","9",125234853,125241343,6490
"608","ENSG00000046604","18",31498177,31549008,50831
"609","ENSG00000046647","X",14008279,14029893,21614
"610","ENSG00000046651","X",13734745,13769357,34612
"611","ENSG00000046653","X",13770939,13938638,167699
"612","ENSG00000046774","X",142202342,142205290,2948
"613","ENSG00000046889","8",67952046,68237032,284986
"614","ENSG00000047056","10",1049538,1132384,82846
"615","ENSG00000047188","5",113513694,113595285,81591
"616","ENSG00000047230","X",16587999,16712936,124937
"617","ENSG00000047249","8",53715543,53843558,128015
"618","ENSG00000047315","4",56977722,57031158,53436
"619","ENSG00000047346","15",52581317,52709817,128500
"620","ENSG00000047365","4",35948221,36244514,296293
"621","ENSG00000047410","1",186311652,186375693,64041
"622","ENSG00000047457","3",149162410,149221829,59419
"623","ENSG00000047578","16",27550133,27780369,230236
"624","ENSG00000047579","6",15522801,15663058,140257
"625","ENSG00000047597","X",37685791,37732130,46339
"626","ENSG00000047617","12",5531869,5946232,414363
"627","ENSG00000047621","12",4487735,4538508,50773
"628","ENSG00000047634","X",17737449,17754988,17539
"629","ENSG00000047644","X",10015562,10144478,128916
"630","ENSG00000047648","X",11117651,11665920,548269
"631","ENSG00000047662","4",17629306,17781512,152206
"632","ENSG00000047849","3",47850690,48089272,238582
"633","ENSG00000047932","6",117560269,117602542,42273
"634","ENSG00000047936","6",117288300,117425855,137555
"635","ENSG00000048028","11",113797874,113875570,77696
"636","ENSG00000048052","7",18086949,19002416,915467
"637","ENSG00000048140","5",176647387,176659054,11667
"638","ENSG00000048162","5",176383938,176388975,5037
"639","ENSG00000048342","4",15469865,15601557,131692
"640","ENSG00000048392","8",102204502,102239118,34616
"641","ENSG00000048405","7",127346790,127431924,85134
"642","ENSG00000048462","16",11965210,11968068,2858
"643","ENSG00000048471","16",11976734,12574287,597553
"644","ENSG00000048540","12",16548372,16610594,62222
"645","ENSG00000048544","6",42206807,42217861,11054
"646","ENSG00000048545","6",42155406,42180049,24643
"647","ENSG00000048649","11",77659996,77821017,161021
"648","ENSG00000048707","1",12230030,12512047,282017
"649","ENSG00000048740","10",10798397,11336675,538278
"650","ENSG00000048828","9",93451685,93566112,114427
"651","ENSG00000048991","2",135531455,135725270,193815
"652","ENSG00000049089","1",40300489,40317813,17324
"653","ENSG00000049130","12",88492793,88580851,88058
"654","ENSG00000049167","5",60873831,60945073,71242
"655","ENSG00000049192","5",65148738,65481920,333182
"656","ENSG00000049239","1",9234775,9271337,36562
"657","ENSG00000049245","1",7771296,7781432,10136
"658","ENSG00000049246","1",7784320,7845177,60857
"659","ENSG00000049247","1",7843083,7853512,10429
"660","ENSG00000049249","1",7915894,7943165,27271
"661","ENSG00000049283","17",50532682,50543750,11068
"662","ENSG00000049323","2",32946953,33399509,452556
"663","ENSG00000049449","11",32090904,32105755,14851
"664","ENSG00000049540","7",74027789,74069907,42118
"665","ENSG00000049541","7",74231499,74254458,22959
"666","ENSG00000049618","6",156776020,157210779,434759
"667","ENSG00000049656","5",1317752,1345099,27347
"668","ENSG00000049759","18",58044226,58401540,357314
"669","ENSG00000049768","X",49250436,49270477,20041
"670","ENSG00000049769","X",49269843,49301461,31618
"671","ENSG00000049860","5",74640023,74722647,82624
"672","ENSG00000049883","5",72320367,72368395,48028
"673","ENSG00000050030","X",74732856,74925485,192629
"674","ENSG00000050130","14",59484443,59505410,20967
"675","ENSG00000050165","11",11963106,12009769,46663
"676","ENSG00000050327","7",144355288,144380632,25344
"677","ENSG00000050344","7",26152198,26187137,34939
"678","ENSG00000050393","6",13786557,13814568,28011
"679","ENSG00000050405","12",50175788,50283546,107758
"680","ENSG00000050426","12",51047962,51060424,12462
"681","ENSG00000050438","12",51391317,51515763,124446
"682","ENSG00000050555","9",131009174,131094473,85299
"683","ENSG00000050628","1",70852353,71047808,195455
"684","ENSG00000050730","4",121131408,121227466,96058
"685","ENSG00000050748","5",180233143,180292099,58956
"686","ENSG00000050767","5",178237618,178590393,352775
"687","ENSG00000050820","16",75228181,75268053,39872
"688","ENSG00000051009","11",6211335,6234711,23376
"689","ENSG00000051108","16",56932142,56944864,12722
"690","ENSG00000051128","19",18929201,18941261,12060
"691","ENSG00000051180","15",40694774,40732340,37566
"692","ENSG00000051341","3",121431427,121546641,115214
"693","ENSG00000051382","3",138652699,138834938,182239
"694","ENSG00000051523","16",88643289,88651054,7765
"695","ENSG00000051596","5",175917873,176034680,116807
"696","ENSG00000051620","6",138403531,138422197,18666
"697","ENSG00000051825","12",123152320,123244014,91694
"698","ENSG00000052126","12",19129752,19376400,246648
"699","ENSG00000052344","16",31131433,31135727,4294
"700","ENSG00000052723","1",114769479,114780685,11206
"701","ENSG00000052749","10",97356358,97426076,69718
"702","ENSG00000052795","4",158769026,158908050,139024
"703","ENSG00000052802","4",165327667,165343164,15497
"704","ENSG00000052841","11",43358920,43494933,136013
"705","ENSG00000052850","11",44260440,44310139,49699
"706","ENSG00000053108","5",133196455,133612541,416086
"707","ENSG00000053254","14",89124871,89619149,494278
"708","ENSG00000053328","6",110245928,110358272,112344
"709","ENSG00000053371","1",19303965,19312146,8181
"710","ENSG00000053372","1",19251805,19260128,8323
"711","ENSG00000053438","20",37521206,37523690,2484
"712","ENSG00000053501","19",17215346,17219829,4483
"713","ENSG00000053524","3",183178043,183428778,250735
"714","ENSG00000053702","12",2825348,2835544,10196
"715","ENSG00000053747","18",23689443,23956222,266779
"716","ENSG00000053770","14",57268924,57298742,29818
"717","ENSG00000053900","4",25377213,25418498,41285
"718","ENSG00000053918","11",2444684,2849110,404426
"719","ENSG00000054116","1",36136570,36156053,19483
"720","ENSG00000054118","1",36224432,36305357,80925
"721","ENSG00000054148","9",136848724,136851027,2303
"722","ENSG00000054179","9",137048107,137054061,5954
"723","ENSG00000054219","2",159803355,159904756,101401
"724","ENSG00000054267","1",235131634,235328219,196585
"725","ENSG00000054277","1",241590102,241677376,87274
"726","ENSG00000054282","1",243256034,243500091,244057
"727","ENSG00000054356","2",219289623,219309648,20025
"728","ENSG00000054392","1",210328252,210676296,348044
"729","ENSG00000054523","1",10210805,10381603,170798
"730","ENSG00000054598","6",1609915,1613897,3982
"731","ENSG00000054611","22",46762617,47175699,413082
"732","ENSG00000054654","14",63852983,64226433,373450
"733","ENSG00000054690","14",67533301,67589612,56311
"734","ENSG00000054793","20",51596514,51768634,172120
"735","ENSG00000054796","20",57329759,57343994,14235
"736","ENSG00000054803","20",55997440,56005472,8032
"737","ENSG00000054938","11",74696429,74731385,34956
"738","ENSG00000054965","11",73400487,73598189,197702
"739","ENSG00000054967","11",73376399,73397474,21075
"740","ENSG00000054983","14",87837820,87993665,155845
"741","ENSG00000055044","2",202265736,202303661,37925
"742","ENSG00000055070","1",16352575,16398145,45570
"743","ENSG00000055118","7",150944961,150978315,33354
"744","ENSG00000055130","7",148697914,148801110,103196
"745","ENSG00000055147","5",153990148,154038936,48788
"746","ENSG00000055163","5",157266079,157395595,129516
"747","ENSG00000055208","6",149218641,149411613,192972
"748","ENSG00000055211","6",149566294,149591748,25454
"749","ENSG00000055332","2",37099210,37157065,57855
"750","ENSG00000055483","17",78787381,78841441,54060
"751","ENSG00000055609","7",152134922,152436005,301083
"752","ENSG00000055732","1",85018082,85048500,30418
"753","ENSG00000055813","2",56183990,56386172,202182
"754","ENSG00000055917","2",20248691,20352234,103543
"755","ENSG00000055950","10",100969458,100987515,18057
"756","ENSG00000055955","3",52812975,52830739,17764
"757","ENSG00000055957","3",52777595,52792068,14473
"758","ENSG00000056050","4",169729470,169757944,28474
"759","ENSG00000056097","5",32354350,32444740,90390
"760","ENSG00000056277","X",130202707,130268899,66192
"761","ENSG00000056291","4",72031804,72148067,116263
"762","ENSG00000056487","22",44881162,45010005,128843
"763","ENSG00000056558","9",120902393,120929173,26780
"764","ENSG00000056586","9",122844556,122905359,60803
"765","ENSG00000056736","3",53846568,53865794,19226
"766","ENSG00000056972","6",111555381,111606906,51525
"767","ENSG00000056998","X",2828822,2882820,53998
"768","ENSG00000057019","3",98795941,98901695,105754
"769","ENSG00000057149","18",63655197,63661893,6696
"770","ENSG00000057252","1",179293714,179358680,64966
"771","ENSG00000057294","12",32790745,32896840,106095
"772","ENSG00000057468","1",75796882,75913242,116360
"773","ENSG00000057593","13",113105788,113120681,14893
"774","ENSG00000057608","10",5765223,5842132,76909
"775","ENSG00000057657","6",105993463,106109939,116476
"776","ENSG00000057663","6",106045423,106325791,280368
"777","ENSG00000057704","12",94567122,94650557,83435
"778","ENSG00000057757","1",23778418,23788232,9814
"779","ENSG00000057935","2",42494569,42756947,262378
"780","ENSG00000058056","3",179653040,179789401,136361
"781","ENSG00000058063","3",182793503,182921629,128126
"782","ENSG00000058085","1",183186238,183244900,58662
"783","ENSG00000058091","7",90466424,91210590,744166
"784","ENSG00000058262","3",128051641,128071683,20042
"785","ENSG00000058272","12",79773563,79935460,161897
"786","ENSG00000058335","15",78959947,79090773,130826
"787","ENSG00000058404","7",44217150,44334577,117427
"788","ENSG00000058453","1",16740273,16972964,232691
"789","ENSG00000058600","16",22297375,22335101,37726
"790","ENSG00000058668","1",203626561,203744081,117520
"791","ENSG00000058673","1",203795654,203854999,59345
"792","ENSG00000058729","5",97160867,97183247,22380
"793","ENSG00000058799","1",53851719,53889798,38079
"794","ENSG00000058804","1",53765478,53838463,72985
"795","ENSG00000058866","3",186105668,186362234,256566
"796","ENSG00000059122","16",2911937,2951208,39271
"797","ENSG00000059145","16",1363205,1414751,51546
"798","ENSG00000059377","7",139777051,140020325,243274
"799","ENSG00000059378","7",140023744,140063721,39977
"800","ENSG00000059573","10",95605941,95656711,50770
"801","ENSG00000059588","1",234391313,234479179,87866
"802","ENSG00000059691","4",151670504,151761007,90503
"803","ENSG00000059728","2",69897688,69942945,45257
"804","ENSG00000059758","12",96278261,96400480,122219
"805","ENSG00000059769","9",111631334,111654351,23017
"806","ENSG00000059804","12",7919230,7936187,16957
"807","ENSG00000059915","10",102402617,102421539,18922
"808","ENSG00000060069","18",79679801,79756623,76822
"809","ENSG00000060138","12",10699089,10723323,24234
"810","ENSG00000060140","12",10618923,10674318,55395
"811","ENSG00000060237","12",752579,911452,158873
"812","ENSG00000060303","6",50857255,50857662,407
"813","ENSG00000060339","10",68721012,68792377,71365
"814","ENSG00000060491","20",62804835,62814000,9165
"815","ENSG00000060558","19",3136193,3163769,27576
"816","ENSG00000060566","19",4153631,4173054,19423
"817","ENSG00000060642","1",26787472,26798398,10926
"818","ENSG00000060656","1",29236516,29326813,90297
"819","ENSG00000060688","1",31259568,31296788,37220
"820","ENSG00000060709","12",130396137,130716281,320144
"821","ENSG00000060718","1",102876467,103108872,232405
"822","ENSG00000060749","11",32892820,32993316,100496
"823","ENSG00000060762","6",166364919,166383013,18094
"824","ENSG00000060971","3",38103129,38137242,34113
"825","ENSG00000060982","12",24810024,24949101,139077
"826","ENSG00000061273","12",47782722,47833132,50410
"827","ENSG00000061337","8",20246165,20303963,57798
"828","ENSG00000061455","5",123089241,123194266,105025
"829","ENSG00000061492","5",138083892,138092365,8473
"830","ENSG00000061656","20",35615892,35621049,5157
"831","ENSG00000061676","2",182909115,183038858,129743
"832","ENSG00000061794","12",27710822,27756295,45473
"833","ENSG00000061918","4",155758992,155807774,48782
"834","ENSG00000061936","12",131711081,131799737,88656
"835","ENSG00000061938","3",195863365,195909009,45644
"836","ENSG00000061987","12",62466817,62600476,133659
"837","ENSG00000062038","16",68636189,68722616,86427
"838","ENSG00000062096","X",3041471,3112726,71255
"839","ENSG00000062194","5",57173948,57264679,90731
"840","ENSG00000062282","11",75759512,75801535,42023
"841","ENSG00000062370","19",44326555,44367217,40662
"842","ENSG00000062485","12",56271699,56300391,28692
"843","ENSG00000062524","15",41503637,41513887,10250
"844","ENSG00000062582","7",43866558,43869893,3335
"845","ENSG00000062598","20",46366050,46432985,66935
"846","ENSG00000062650","10",86435256,86521792,86536
"847","ENSG00000062716","17",59707192,59842255,135063
"848","ENSG00000062725","17",60443158,60526242,83084
"849","ENSG00000062822","19",50384204,50418018,33814
"850","ENSG00000063015","17",28954901,29006440,51539
"851","ENSG00000063046","12",53006158,53042209,36051
"852","ENSG00000063127","19",49289638,49325225,35587
"853","ENSG00000063169","19",47608196,47703277,95081
"854","ENSG00000063176","19",48619291,48630717,11426
"855","ENSG00000063177","19",48615328,48619184,3856
"856","ENSG00000063180","19",48637946,48646187,8241
"857","ENSG00000063241","19",55452985,55462343,9358
"858","ENSG00000063244","19",55654146,55674715,20569
"859","ENSG00000063245","19",55675226,55709858,34632
"860","ENSG00000063322","19",39391303,39400637,9334
"861","ENSG00000063438","5",321759,435110,113351
"862","ENSG00000063515","22",19148576,19150283,1707
"863","ENSG00000063587","X",153334147,153360110,25963
"864","ENSG00000063601","X",150692971,150765108,72137
"865","ENSG00000063660","2",240435663,240468076,32413
"866","ENSG00000063761","14",77800109,77935014,134905
"867","ENSG00000063854","16",1795620,1827157,31537
"868","ENSG00000063978","4",2462220,2625320,163100
"869","ENSG00000064012","2",201233443,201287711,54268
"870","ENSG00000064042","4",41359607,41700044,340437
"871","ENSG00000064102","12",26905181,26938326,33145
"872","ENSG00000064115","12",26971579,27014434,42855
"873","ENSG00000064195","17",49990005,49995224,5219
"874","ENSG00000064199","11",124673798,124697518,23720
"875","ENSG00000064201","11",2301997,2318200,16203
"876","ENSG00000064205","20",44714844,44728509,13665
"877","ENSG00000064218","9",976655,991732,15077
"878","ENSG00000064225","3",98732236,98821201,88965
"879","ENSG00000064270","16",84368527,84464187,95660
"880","ENSG00000064300","17",49495293,49515008,19715
"881","ENSG00000064309","11",125955796,126063335,107539
"882","ENSG00000064313","8",119730774,119832841,102067
"883","ENSG00000064393","7",139561570,139777998,216428
"884","ENSG00000064419","7",128954180,129055173,100993
"885","ENSG00000064489","19",19145569,19192158,46589
"886","ENSG00000064490","19",19192229,19201869,9640
"887","ENSG00000064545","19",19119169,19138513,19344
"888","ENSG00000064547","19",19623655,19628930,5275
"889","ENSG00000064601","20",45890144,45898820,8676
"890","ENSG00000064607","19",18990888,19034023,43135
"891","ENSG00000064651","5",128083766,128189677,105911
"892","ENSG00000064652","5",122843439,123029354,185915
"893","ENSG00000064655","20",46894624,47188844,294220
"894","ENSG00000064666","19",1026586,1039068,12482
"895","ENSG00000064687","19",1040101,1065572,25471
"896","ENSG00000064692","5",122311354,122464219,152865
"897","ENSG00000064703","1",111755245,111768000,12755
"898","ENSG00000064726","15",83016422,83067354,50932
"899","ENSG00000064763","12",29149103,29340980,191877
"900","ENSG00000064787","20",53936777,54070594,133817
"901","ENSG00000064835","3",87259404,87276587,17183
"902","ENSG00000064886","1",111200771,111243440,42669
"903","ENSG00000064932","19",1107637,1174268,66631
"904","ENSG00000064933","2",189784085,189877629,93544
"905","ENSG00000064961","19",3572777,3579088,6311
"906","ENSG00000064989","2",187341964,187448460,106496
"907","ENSG00000064995","6",34877462,34888089,10627
"908","ENSG00000064999","6",34889255,35091406,202151
"909","ENSG00000065000","19",2100988,2164468,63480
"910","ENSG00000065029","6",35258909,35295985,37076
"911","ENSG00000065054","16",2025356,2039026,13670
"912","ENSG00000065057","16",2039815,2047866,8051
"913","ENSG00000065060","6",34792015,34883138,91123
"914","ENSG00000065135","1",109548615,109618324,69709
"915","ENSG00000065150","13",97953658,98024297,70639
"916","ENSG00000065154","10",124397303,124418976,21673
"917","ENSG00000065183","1",117929720,117966543,36823
"918","ENSG00000065243","1",88684222,88836255,152033
"919","ENSG00000065268","19",984271,998438,14167
"920","ENSG00000065308","6",52497408,52577060,79652
"921","ENSG00000065320","17",9021510,9244000,222490
"922","ENSG00000065325","17",9822206,9892099,69893
"923","ENSG00000065328","10",13161554,13211104,49550
"924","ENSG00000065357","12",55927319,55954027,26708
"925","ENSG00000065361","12",56076799,56103505,26706
"926","ENSG00000065371","3",123968521,123992178,23657
"927","ENSG00000065413","2",196967017,197311173,344156
"928","ENSG00000065427","16",75627474,75648643,21169
"929","ENSG00000065457","16",75596981,75623300,26319
"930","ENSG00000065485","3",123067025,123225227,158202
"931","ENSG00000065491","6",37257772,37332970,75198
"932","ENSG00000065518","3",120596328,120602507,6179
"933","ENSG00000065526","1",15847707,15940456,92749
"934","ENSG00000065534","3",123610049,123884331,274282
"935","ENSG00000065548","2",186486253,186509361,23108
"936","ENSG00000065559","17",12020829,12143830,123001
"937","ENSG00000065600","1",212363931,212414901,50970
"938","ENSG00000065609","6",83552880,83709691,156811
"939","ENSG00000065613","10",103967140,104029233,62093
"940","ENSG00000065615","6",83859656,83967423,107767
"941","ENSG00000065618","10",104031286,104085880,54594
"942","ENSG00000065621","10",104268873,104304950,36077
"943","ENSG00000065665","10",12129637,12169961,40324
"944","ENSG00000065675","10",6427143,6580301,153158
"945","ENSG00000065717","19",2997639,3047635,49996
"946","ENSG00000065802","2",238426742,238452250,25508
"947","ENSG00000065809","10",14518557,14774897,256340
"948","ENSG00000065833","6",83210402,83431051,220649
"949","ENSG00000065882","4",37891084,38139175,248091
"950","ENSG00000065883","7",39950121,40099580,149459
"951","ENSG00000065911","2",74198610,74217565,18955
"952","ENSG00000065923","X",46599251,46759118,159867
"953","ENSG00000065970","12",8032716,8055517,22801
"954","ENSG00000065978","1",42682418,42703805,21387
"955","ENSG00000065989","19",10416773,10469630,52857
"956","ENSG00000066027","1",212285410,212361853,76443
"957","ENSG00000066032","2",79185231,80648861,1463630
"958","ENSG00000066044","19",7958573,8005659,47086
"959","ENSG00000066056","1",43300982,43323108,22126
"960","ENSG00000066084","12",50504985,50748657,243672
"961","ENSG00000066117","12",50084972,50100712,15740
"962","ENSG00000066135","1",43650149,43705518,55369
"963","ENSG00000066136","1",40691648,40771603,79955
"964","ENSG00000066185","1",42430329,42456253,25924
"965","ENSG00000066230","5",470458,524332,53874
"966","ENSG00000066248","2",232878701,233013256,134555
"967","ENSG00000066279","1",197084127,197146694,62567
"968","ENSG00000066294","1",160541095,160579516,38421
"969","ENSG00000066322","1",43363398,43368074,4676
"970","ENSG00000066336","11",47354860,47378576,23716
"971","ENSG00000066379","6",30058899,30064909,6010
"972","ENSG00000066382","11",30384493,30586872,202379
"973","ENSG00000066405","3",137998735,138033655,34920
"974","ENSG00000066422","3",101648889,101677495,28606
"975","ENSG00000066427","14",92044496,92106621,62125
"976","ENSG00000066455","14",92794305,92839947,45642
"977","ENSG00000066468","10",121478334,121598458,120124
"978","ENSG00000066557","1",70144805,70205579,60774
"979","ENSG00000066583","5",129094749,129114028,19279
"980","ENSG00000066629","14",99737693,99942060,204367
"981","ENSG00000066651","6",125986479,126203817,217338
"982","ENSG00000066654","16",20702816,20742084,39268
"983","ENSG00000066697","9",100427156,100451711,24555
"984","ENSG00000066735","14",104138723,104180894,42171
"985","ENSG00000066739","14",96279195,96363341,84146
"986","ENSG00000066777","8",67173511,67343781,170270
"987","ENSG00000066813","16",20536226,20576427,40201
"988","ENSG00000066827","8",134477788,134713049,235261
"989","ENSG00000066855","8",65644734,65771261,126527
"990","ENSG00000066923","7",100177563,100221488,43925
"991","ENSG00000066926","18",57544389,57586702,42313
"992","ENSG00000066933","15",71822291,72118577,296286
"993","ENSG00000067048","Y",12904108,12920478,16370
"994","ENSG00000067057","10",3066333,3137718,71385
"995","ENSG00000067064","10",1039152,1049170,10018
"996","ENSG00000067066","2",230415942,230545606,129664
"997","ENSG00000067082","10",3775996,3785281,9285
"998","ENSG00000067113","5",55424854,55534969,110115
"999","ENSG00000067141","15",73051710,73305205,253495
"1000","ENSG00000067167","8",70573218,70608416,35198
"1001","ENSG00000067177","X",72578814,72714319,135505
"1002","ENSG00000067182","12",6328757,6342114,13357
"1003","ENSG00000067191","17",39173453,39197703,24250
"1004","ENSG00000067208","1",92508696,92792404,283708
"1005","ENSG00000067221","15",73978926,73994622,15696
"1006","ENSG00000067225","15",72199029,72231822,32793
"1007","ENSG00000067248","5",55256055,55307694,51639
"1008","ENSG00000067334","1",93866284,93879918,13634
"1009","ENSG00000067365","16",8621683,8649654,27971
"1010","ENSG00000067369","15",43403061,43510728,107667
"1011","ENSG00000067445","X",54920462,54931431,10969
"1012","ENSG00000067533","1",218285293,218337983,52690
"1013","ENSG00000067560","3",49359145,49412998,53853
"1014","ENSG00000067596","17",43483865,43610338,126473
"1015","ENSG00000067601","7",67287541,67302419,14878
"1016","ENSG00000067606","1",2050411,2185395,134984
"1017","ENSG00000067646","Y",2935281,2982506,47225
"1018","ENSG00000067704","1",220094132,220148041,53909
"1019","ENSG00000067715","12",78863993,79452008,588015
"1020","ENSG00000067798","12",77324641,78213010,888369
"1021","ENSG00000067829","X",153785766,153794523,8757
"1022","ENSG00000067836","16",4796968,4802950,5982
"1023","ENSG00000067840","X",153802166,153830565,28399
"1024","ENSG00000067842","X",153517676,153582939,65263
"1025","ENSG00000067900","18",20946906,21111813,164907
"1026","ENSG00000067955","16",67028984,67101058,72074
"1027","ENSG00000067992","X",24465221,24550466,85245
"1028","ENSG00000068001","3",50317790,50322782,4992
"1029","ENSG00000068024","2",239048168,239401654,353486
"1030","ENSG00000068028","3",50329782,50340980,11198
"1031","ENSG00000068078","4",1793293,1808872,15579
"1032","ENSG00000068079","17",43006725,43014456,7731
"1033","ENSG00000068097","17",60043194,60078931,35737
"1034","ENSG00000068120","17",42561467,42566277,4810
"1035","ENSG00000068137","17",42667914,42676994,9080
"1036","ENSG00000068305","15",99565417,99716466,151049
"1037","ENSG00000068308","X",48922028,48958386,36358
"1038","ENSG00000068323","X",49028726,49043410,14684
"1039","ENSG00000068354","X",48539714,48562609,22895
"1040","ENSG00000068366","X",109624244,109733403,109159
"1041","ENSG00000068383","10",132537787,132783480,245693
"1042","ENSG00000068394","X",49113407,49123735,10328
"1043","ENSG00000068400","X",48973720,49002264,28544
"1044","ENSG00000068438","X",48476021,48486364,10343
"1045","ENSG00000068489","17",59155499,59204705,49206
"1046","ENSG00000068615","2",86213993,86338083,124090
"1047","ENSG00000068650","13",112690329,112887168,196839
"1048","ENSG00000068654","2",86020216,86106155,85939
"1049","ENSG00000068697","2",20032650,20051628,18978
"1050","ENSG00000068724","2",46916157,47076137,159980
"1051","ENSG00000068745","3",48688003,48740353,52350
"1052","ENSG00000068781","2",48529925,48776517,246592
"1053","ENSG00000068784","2",45388680,45612165,223485
"1054","ENSG00000068796","5",62306162,62537249,231087
"1055","ENSG00000068831","11",64726911,64745456,18545
"1056","ENSG00000068878","2",53864069,53970993,106924
"1057","ENSG00000068885","3",160256986,160399880,142894
"1058","ENSG00000068903","19",38878555,38899862,21307
"1059","ENSG00000068912","2",53787044,53818819,31775
"1060","ENSG00000068971","11",64917553,64934475,16922
"1061","ENSG00000068976","11",64746389,64759974,13585
"1062","ENSG00000068985","X",49687447,49695984,8537
"1063","ENSG00000069011","5",135027734,135034813,7079
"1064","ENSG00000069018","5",136213320,136365545,152225
"1065","ENSG00000069020","5",66596361,67169595,573234
"1066","ENSG00000069122","6",46852522,46954943,102421
"1067","ENSG00000069188","17",73334384,73644445,310061
"1068","ENSG00000069206","8",24440930,24526970,86040
"1069","ENSG00000069248","1",229440259,229508341,68082
"1070","ENSG00000069275","1",205712822,205750182,37360
"1071","ENSG00000069329","16",46656132,46689518,33386
"1072","ENSG00000069345","16",46955362,46973674,18312
"1073","ENSG00000069399","19",44747705,44760044,12339
"1074","ENSG00000069424","1",5990927,6101193,110266
"1075","ENSG00000069431","12",21797401,21942529,145128
"1076","ENSG00000069482","11",68683779,68691175,7396
"1077","ENSG00000069493","12",9664969,9699553,34584
"1078","ENSG00000069509","X",44523639,44542859,19220
"1079","ENSG00000069535","X",43766610,43882450,115840
"1080","ENSG00000069667","15",60488284,61229302,741018
"1081","ENSG00000069696","11",637293,640706,3413
"1082","ENSG00000069702","1",91680343,91906335,225992
"1083","ENSG00000069764","16",14672545,14694669,22124
"1084","ENSG00000069812","1",6412418,6424670,12252
"1085","ENSG00000069849","3",141876124,141926549,50425
"1086","ENSG00000069869","15",55826922,55993746,166824
"1087","ENSG00000069943","15",55318960,55355648,36688
"1088","ENSG00000069956","15",51952106,52067375,115269
"1089","ENSG00000069966","15",52115105,52191369,76264
"1090","ENSG00000069974","15",55202966,55319113,116147
"1091","ENSG00000069998","22",17137511,17165287,27776
"1092","ENSG00000070010","22",19449911,19479202,29291
"1093","ENSG00000070018","12",12116025,12267044,151019
"1094","ENSG00000070019","12",14612632,14696599,83967
"1095","ENSG00000070031","11",626309,627181,872
"1096","ENSG00000070047","11",576470,612222,35752
"1097","ENSG00000070061","9",108867517,108934124,66607
"1098","ENSG00000070081","11",17208153,17349980,141827
"1099","ENSG00000070087","3",149964904,150050788,85884
"1100","ENSG00000070159","9",109375466,109498313,122847
"1101","ENSG00000070182","14",64746283,64879907,133624
"1102","ENSG00000070190","4",99816827,99870190,53363
"1103","ENSG00000070193","5",44303544,44389706,86162
"1104","ENSG00000070214","9",105244622,105439171,194549
"1105","ENSG00000070269","14",56488354,56650606,162252
"1106","ENSG00000070366","17",2059839,2303785,243946
"1107","ENSG00000070367","14",57200507,57268905,68398
"1108","ENSG00000070371","22",19179473,19291719,112246
"1109","ENSG00000070388","19",639879,644371,4492
"1110","ENSG00000070404","19",676392,683392,7000
"1111","ENSG00000070413","22",19036282,19122454,86172
"1112","ENSG00000070423","19",647526,663233,15707
"1113","ENSG00000070444","17",2384073,2401104,17031
"1114","ENSG00000070476","3",126437601,126475891,38290
"1115","ENSG00000070495","17",76712832,76726799,13967
"1116","ENSG00000070501","8",42338454,42371808,33354
"1117","ENSG00000070526","17",76624761,76643786,19025
"1118","ENSG00000070540","17",68420948,68457513,36565
"1119","ENSG00000070601","9",37650954,37746904,95950
"1120","ENSG00000070610","9",35736866,35749228,12362
"1121","ENSG00000070614","5",150485818,150558211,72393
"1122","ENSG00000070669","7",97851677,97872542,20865
"1123","ENSG00000070718","8",42152946,42171673,18727
"1124","ENSG00000070729","16",57882340,57971116,88776
"1125","ENSG00000070731","17",76565379,76586956,21577
"1126","ENSG00000070748","10",49609095,49665104,56009
"1127","ENSG00000070756","8",100685816,100722809,36993
"1128","ENSG00000070759","1",45343883,45491163,147280
"1129","ENSG00000070761","16",58113592,58129381,15789
"1130","ENSG00000070770","16",58157907,58198106,40199
"1131","ENSG00000070778","14",88465778,88555007,89229
"1132","ENSG00000070785","1",44850522,44986722,136200
"1133","ENSG00000070808","5",150219491,150290291,70800
"1134","ENSG00000070814","5",150357629,150400308,42679
"1135","ENSG00000070831","1",22025511,22101360,75849
"1136","ENSG00000070882","7",24796540,24981634,185094
"1137","ENSG00000070886","1",22563489,22603595,40106
"1138","ENSG00000070915","16",56865207,56915850,50643
"1139","ENSG00000070950","3",8775402,8963773,188371
"1140","ENSG00000070961","12",89588049,89709300,121251
"1141","ENSG00000070985","11",2404515,2423045,18530
"1142","ENSG00000071051","2",105744912,105894274,149362
"1143","ENSG00000071054","2",101696850,101894689,197839
"1144","ENSG00000071073","2",98619106,98731132,112026
"1145","ENSG00000071082","2",101002229,101024032,21803
"1146","ENSG00000071127","4",10074339,10116949,42610
"1147","ENSG00000071189","7",17790761,17940501,149740
"1148","ENSG00000071203","11",60492778,60507430,14652
"1149","ENSG00000071205","4",147732063,148072780,340717
"1150","ENSG00000071242","6",166409364,166906451,497087
"1151","ENSG00000071243","7",120950763,120977216,26453
"1152","ENSG00000071246","14",76761468,76783015,21547
"1153","ENSG00000071282","3",8501807,8574668,72861
"1154","ENSG00000071462","7",73683025,73705161,22136
"1155","ENSG00000071537","14",81471547,81533853,62306
"1156","ENSG00000071539","5",892884,919357,26473
"1157","ENSG00000071553","X",154428645,154436516,7871
"1158","ENSG00000071564","19",1609290,1652615,43325
"1159","ENSG00000071575","2",12716889,12742734,25845
"1160","ENSG00000071626","19",1407569,1435687,28118
"1161","ENSG00000071655","19",1573596,1592865,19269
"1162","ENSG00000071677","2",237566574,237567175,601
"1163","ENSG00000071794","3",149030127,149086554,56427
"1164","ENSG00000071859","X",154444141,154450654,6513
"1165","ENSG00000071889","X",154506159,154516242,10083
"1166","ENSG00000071894","8",144393229,144409335,16106
"1167","ENSG00000071909","2",170178145,170655171,477026
"1168","ENSG00000071967","2",171522247,171558129,35882
"1169","ENSG00000071991","18",66501083,66604138,103055
"1170","ENSG00000071994","6",170575295,170584692,9397
"1171","ENSG00000072041","12",84859491,84913615,54124
"1172","ENSG00000072042","14",67676800,67695793,18993
"1173","ENSG00000072062","19",14091688,14118084,26396
"1174","ENSG00000072071","19",14147743,14206187,58444
"1175","ENSG00000072080","2",234050679,234077134,26455
"1176","ENSG00000072110","14",68874143,68979440,105297
"1177","ENSG00000072121","14",67727374,67816590,89216
"1178","ENSG00000072133","X",84058346,84188199,129853
"1179","ENSG00000072134","17",19215615,19336715,121100
"1180","ENSG00000072135","2",130356045,130375405,19360
"1181","ENSG00000072163","2",127638381,127681786,43405
"1182","ENSG00000072182","2",219514170,219538772,24602
"1183","ENSG00000072195","2",219434843,219493629,58786
"1184","ENSG00000072201","4",53459301,53701405,242104
"1185","ENSG00000072210","17",19648136,19677598,29462
"1186","ENSG00000072274","3",196027183,196082096,54913
"1187","ENSG00000072310","17",17810399,17837011,26612
"1188","ENSG00000072315","X",111774315,112082776,308461
"1189","ENSG00000072364","5",132875395,132963634,88239
"1190","ENSG00000072401","10",58334979,58370751,35772
"1191","ENSG00000072415","14",67241109,67335819,94710
"1192","ENSG00000072422","10",60869438,61001440,132002
"1193","ENSG00000072501","X",53374149,53422728,48579
"1194","ENSG00000072506","X",53431258,53434373,3115
"1195","ENSG00000072518","11",63838928,63911019,72091
"1196","ENSG00000072571","5",163460203,163491941,31738
"1197","ENSG00000072609","12",132822187,132956304,134117
"1198","ENSG00000072657","12",72087266,72670757,583491
"1199","ENSG00000072682","5",132191838,132295315,103477
"1200","ENSG00000072694","1",161663147,161678654,15507
"1201","ENSG00000072736","16",68084751,68229259,144508
"1202","ENSG00000072756","3",3126933,3150879,23946
"1203","ENSG00000072778","17",7217125,7225266,8141
"1204","ENSG00000072786","5",172042079,172188224,146145
"1205","ENSG00000072803","5",171861549,172006873,145324
"1206","ENSG00000072818","17",7336529,7351477,14948
"1207","ENSG00000072832","4",5748084,5893058,144974
"1208","ENSG00000072840","4",5711201,5814305,103104
"1209","ENSG00000072849","17",5471254,5486811,15557
"1210","ENSG00000072858","3",113532296,113629578,97282
"1211","ENSG00000072864","16",15643267,15726353,83086
"1212","ENSG00000072952","11",10573091,10693988,120897
"1213","ENSG00000072954","19",16661139,16690023,28884
"1214","ENSG00000072958","19",16197578,16245907,48329
"1215","ENSG00000073008","19",44643798,44666162,22364
"1216","ENSG00000073050","19",43543040,43580473,37433
"1217","ENSG00000073060","12",124776856,124882668,105812
"1218","ENSG00000073067","7",983181,989640,6459
"1219","ENSG00000073111","3",127598410,127622436,24026
"1220","ENSG00000073146","22",50089879,50161690,71811
"1221","ENSG00000073150","22",50170731,50180294,9563
"1222","ENSG00000073169","22",50200979,50217616,16637
"1223","ENSG00000073282","3",189631389,189897276,265887
"1224","ENSG00000073331","4",112285509,112442621,157112
"1225","ENSG00000073350","17",75525080,75575208,50128
"1226","ENSG00000073417","15",84980440,85139145,158705
"1227","ENSG00000073464","X",10156945,10237660,80715
"1228","ENSG00000073536","17",35128730,35142304,13574
"1229","ENSG00000073578","5",218241,257082,38841
"1230","ENSG00000073584","17",40624962,40648654,23692
"1231","ENSG00000073598","17",35121615,35130732,9117
"1232","ENSG00000073605","17",39904595,39919854,15259
"1233","ENSG00000073614","12",280129,389454,109325
"1234","ENSG00000073670","17",44758988,44781846,22858
"1235","ENSG00000073711","3",135965728,136147894,182166
"1236","ENSG00000073712","14",52857268,52952435,95167
"1237","ENSG00000073734","2",168915498,169031324,115826
"1238","ENSG00000073737","2",169064789,169096167,31378
"1239","ENSG00000073754","1",157830911,157898256,67345
"1240","ENSG00000073756","1",186671791,186680423,8632
"1241","ENSG00000073792","3",185643739,185825056,181317
"1242","ENSG00000073803","3",185282941,185489094,206153
"1243","ENSG00000073849","3",186930502,187078553,148051
"1244","ENSG00000073861","17",47733236,47746122,12886
"1245","ENSG00000073905","X",80929500,80930347,847
"1246","ENSG00000073910","13",31846713,32299122,452409
"1247","ENSG00000073921","11",85957175,86069882,112707
"1248","ENSG00000073969","17",46590669,46757464,166795
"1249","ENSG00000074047","2",120735623,120992653,257030
"1250","ENSG00000074054","2",121337776,121649587,311811
"1251","ENSG00000074071","16",1771890,1773155,1265
"1252","ENSG00000074181","19",15159038,15200995,41957
"1253","ENSG00000074201","11",77514936,77637805,122869
"1254","ENSG00000074211","4",6320578,6563600,243022
"1255","ENSG00000074219","19",49340595,49362457,21862
"1256","ENSG00000074266","11",86244753,86278813,34060
"1257","ENSG00000074276","5",176542511,176595974,53463
"1258","ENSG00000074317","5",176620082,176630556,10474
"1259","ENSG00000074319","11",18468336,18526951,58615
"1260","ENSG00000074356","17",3802158,3846246,44088
"1261","ENSG00000074370","17",3923870,3964464,40594
"1262","ENSG00000074410","15",63321378,63381846,60468
"1263","ENSG00000074416","3",127689062,128052190,363128
"1264","ENSG00000074527","12",95657807,95791152,133345
"1265","ENSG00000074582","2",218658764,218663443,4679
"1266","ENSG00000074590","12",106063340,106140033,76693
"1267","ENSG00000074603","15",65442463,65517704,75241
"1268","ENSG00000074621","15",65611366,65660995,49629
"1269","ENSG00000074657","18",58862600,58986480,123880
"1270","ENSG00000074660","17",1633858,1645744,11886
"1271","ENSG00000074695","18",59327823,59359265,31442
"1272","ENSG00000074696","15",65530418,65578349,47931
"1273","ENSG00000074706","6",154154496,154356792,202296
"1274","ENSG00000074755","17",4004445,4143030,138585
"1275","ENSG00000074771","6",155395370,155455903,60533
"1276","ENSG00000074800","1",8861000,8879190,18190
"1277","ENSG00000074803","15",48178438,48304078,125640
"1278","ENSG00000074842","19",4641374,4670370,28996
"1279","ENSG00000074855","19",17323223,17334855,11632
"1280","ENSG00000074935","6",112070663,112087529,16866
"1281","ENSG00000074964","1",17539698,17697874,158176
"1282","ENSG00000074966","4",48066393,48134250,67857
"1283","ENSG00000075035","12",108129288,108250537,121249
"1284","ENSG00000075043","20",63400210,63472677,72467
"1285","ENSG00000075073","10",69403903,69416867,12964
"1286","ENSG00000075089","12",100199122,100241865,42743
"1287","ENSG00000075131","15",66336191,66386746,50555
"1288","ENSG00000075142","7",88205118,88226993,21875
"1289","ENSG00000075151","1",20806292,21176888,370596
"1290","ENSG00000075188","12",102073103,102120120,47017
"1291","ENSG00000075213","7",83955777,84492724,536947
"1292","ENSG00000075218","22",46296870,46330810,33940
"1293","ENSG00000075223","7",80742538,80922359,179821
"1294","ENSG00000075234","22",46267961,46294008,26047
"1295","ENSG00000075239","11",108121516,108147776,26260
"1296","ENSG00000075240","22",46576012,46679790,103778
"1297","ENSG00000075275","22",46360834,46537170,176336
"1298","ENSG00000075290","10",100463041,100483744,20703
"1299","ENSG00000075292","2",71276561,71435069,158508
"1300","ENSG00000075303","7",87833568,87876360,42792
"1301","ENSG00000075336","18",74148523,74160531,12008
"1302","ENSG00000075340","2",70607618,70768225,160607
"1303","ENSG00000075388","11",69771022,69775341,4319
"1304","ENSG00000075391","1",178094141,178484147,390006
"1305","ENSG00000075399","16",89707134,89720898,13764
"1306","ENSG00000075407","10",38094334,38150293,55959
"1307","ENSG00000075413","14",103385392,103503831,118439
"1308","ENSG00000075415","12",98593591,98606379,12788
"1309","ENSG00000075420","3",172039578,172401669,362091
"1310","ENSG00000075426","2",28392448,28417317,24869
"1311","ENSG00000075429","17",66835117,66885486,50369
"1312","ENSG00000075461","17",66964707,67033398,68691
"1313","ENSG00000075539","4",48497361,48780322,282961
"1314","ENSG00000075568","2",97756333,97995948,239615
"1315","ENSG00000075618","7",5592816,5606655,13839
"1316","ENSG00000075624","7",5527148,5563784,36636
"1317","ENSG00000075643","18",36187497,36272157,84660
"1318","ENSG00000075651","3",171600404,171810950,210546
"1319","ENSG00000075673","13",24680411,24712493,32082
"1320","ENSG00000075702","19",36054881,36105108,50227
"1321","ENSG00000075711","3",197042560,197299330,256770
"1322","ENSG00000075785","3",128726122,128814796,88674
"1323","ENSG00000075790","7",107579977,107629170,49193
"1324","ENSG00000075826","10",100486646,100519864,33218
"1325","ENSG00000075856","12",108522214,108561400,39186
"1326","ENSG00000075884","2",143091362,143768352,676990
"1327","ENSG00000075886","2",131476119,131482934,6815
"1328","ENSG00000075891","10",100735603,100829941,94338
"1329","ENSG00000075914","3",44975241,45036066,60825
"1330","ENSG00000075945","1",169921326,170085208,163882
"1331","ENSG00000075975","3",12557087,12583713,26626
"1332","ENSG00000076003","2",135839626,135876443,36817
"1333","ENSG00000076043","11",114439386,114450279,10893
"1334","ENSG00000076053","11",114400030,114414203,14173
"1335","ENSG00000076067","12",56521820,56596193,74373
"1336","ENSG00000076108","12",56595596,56636816,41220
"1337","ENSG00000076201","3",47381011,47413435,32424
"1338","ENSG00000076242","3",36993332,37050918,57586
"1339","ENSG00000076248","12",109097574,109110992,13418
"1340","ENSG00000076258","1",171314183,171342084,27901
"1341","ENSG00000076321","1",173714941,173786692,71751
"1342","ENSG00000076344","16",268301,275980,7679
"1343","ENSG00000076351","17",28394642,28407197,12555
"1344","ENSG00000076356","1",208022242,208244384,222142
"1345","ENSG00000076382","17",28577565,28599025,21460
"1346","ENSG00000076513","12",109999186,110039763,40577
"1347","ENSG00000076554","8",80034745,80231232,196487
"1348","ENSG00000076555","12",109116595,109268226,151631
"1349","ENSG00000076604","17",28744005,28750956,6951
"1350","ENSG00000076641","8",80967810,81112068,144258
"1351","ENSG00000076650","19",33080880,33130542,49662
"1352","ENSG00000076662","19",10333776,10339661,5885
"1353","ENSG00000076685","10",103088017,103193306,105289
"1354","ENSG00000076706","11",119308529,119321521,12992
"1355","ENSG00000076716","X",133300103,133415489,115386
"1356","ENSG00000076770","X",132369317,132489968,120651
"1357","ENSG00000076826","19",7595902,7618304,22402
"1358","ENSG00000076864","1",21596215,21669363,73148
"1359","ENSG00000076924","19",7619525,7629545,10020
"1360","ENSG00000076928","19",41883161,41930150,46989
"1361","ENSG00000076944","19",7636881,7647873,10992
"1362","ENSG00000076984","19",7903843,7914478,10635
"1363","ENSG00000077009","19",3933103,3942416,9313
"1364","ENSG00000077044","2",233354507,233472104,117597
"1365","ENSG00000077063","7",117710651,117874139,163488
"1366","ENSG00000077080","7",100643097,100656461,13364
"1367","ENSG00000077092","3",25174332,25597932,423600
"1368","ENSG00000077097","3",25597905,25664907,67002
"1369","ENSG00000077147","10",96518110,96587452,69342
"1370","ENSG00000077150","10",102394110,102402524,8414
"1371","ENSG00000077152","1",202331657,202341980,10323
"1372","ENSG00000077157","1",202348699,202592706,244007
"1373","ENSG00000077232","2",182716041,182794464,78423
"1374","ENSG00000077235","16",27459555,27549913,90358
"1375","ENSG00000077238","16",27313668,27364778,51110
"1376","ENSG00000077254","1",77695987,77759852,63865
"1377","ENSG00000077264","X",110944285,111227361,283076
"1378","ENSG00000077274","X",111245099,111270483,25384
"1379","ENSG00000077279","X",111293779,111412429,118650
"1380","ENSG00000077312","19",40750637,40765389,14752
"1381","ENSG00000077327","10",22345445,22454224,108779
"1382","ENSG00000077348","19",41386374,41397359,10985
"1383","ENSG00000077380","2",171687409,171748420,61011
"1384","ENSG00000077420","10",26438341,26567803,129462
"1385","ENSG00000077454","7",100574011,100586129,12118
"1386","ENSG00000077458","11",95768953,95790409,21456
"1387","ENSG00000077463","19",4174109,4182566,8457
"1388","ENSG00000077498","11",89177875,89295759,117884
"1389","ENSG00000077514","11",74493851,74669117,175266
"1390","ENSG00000077522","1",236664141,236764631,100490
"1391","ENSG00000077549","1",19338775,19485539,146764
"1392","ENSG00000077585","1",236142505,236221865,79360
"1393","ENSG00000077616","11",90131515,90192894,61379
"1394","ENSG00000077684","4",128809700,128875224,65524
"1395","ENSG00000077713","X",119399336,119454478,55142
"1396","ENSG00000077721","X",119574536,119591083,16547
"1397","ENSG00000077782","8",38400215,38468834,68619
"1398","ENSG00000077800","7",73328161,73358637,30476
"1399","ENSG00000077935","22",45344063,45413619,69556
"1400","ENSG00000077942","22",45502238,45601135,98897
"1401","ENSG00000077943","10",15513954,15719922,205968
"1402","ENSG00000077984","20",24949269,24959928,10659
"1403","ENSG00000078018","2",209424058,209734118,310060
"1404","ENSG00000078043","18",46803218,46920160,116942
"1405","ENSG00000078053","7",38383704,38631420,247716
"1406","ENSG00000078061","X",47561100,47571920,10820
"1407","ENSG00000078070","3",183015218,183116075,100857
"1408","ENSG00000078081","3",183122215,183163839,41624
"1409","ENSG00000078098","2",162170684,162245151,74467
"1410","ENSG00000078114","10",20779973,21174187,394214
"1411","ENSG00000078124","11",76860867,77026797,165930
"1412","ENSG00000078140","4",39698109,39782792,84683
"1413","ENSG00000078142","18",41955234,42087830,132596
"1414","ENSG00000078177","4",40056850,40158252,101402
"1415","ENSG00000078237","12",4307763,4360028,52265
"1416","ENSG00000078246","12",2877223,2941138,63915
"1417","ENSG00000078269","6",157981863,158099176,117313
"1418","ENSG00000078295","5",7396208,7830081,433873
"1419","ENSG00000078304","14",101761798,101927989,166191
"1420","ENSG00000078319","7",100320992,100341908,20916
"1421","ENSG00000078328","16",5239802,7713338,2473536
"1422","ENSG00000078369","1",1785285,1891117,105832
"1423","ENSG00000078399","7",27162438,27175180,12742
"1424","ENSG00000078401","6",12290361,12297194,6833
"1425","ENSG00000078403","10",21524646,21743630,218984
"1426","ENSG00000078487","7",100400826,100428992,28166
"1427","ENSG00000078549","7",31052461,31111479,59018
"1428","ENSG00000078579","8",16992181,17002345,10164
"1429","ENSG00000078589","X",78945332,78963727,18395
"1430","ENSG00000078596","X",79360384,79367667,7283
"1431","ENSG00000078618","1",51789191,51878937,89746
"1432","ENSG00000078668","8",42391624,42405937,14313
"1433","ENSG00000078674","8",17922840,18029944,107104
"1434","ENSG00000078687","17",77959240,78108835,149595
"1435","ENSG00000078699","20",33490075,33650036,159961
"1436","ENSG00000078725","9",119153458,119369435,215977
"1437","ENSG00000078747","20",34363241,34540748,177507
"1438","ENSG00000078795","5",137887968,137942747,54779
"1439","ENSG00000078804","20",34704339,34713439,9100
"1440","ENSG00000078808","1",1216908,1232067,15159
"1441","ENSG00000078814","20",34975403,35002437,27034
"1442","ENSG00000078898","20",33007704,33023703,15999
"1443","ENSG00000078900","1",3652516,3736201,83685
"1444","ENSG00000078902","11",1274371,1309654,35283
"1445","ENSG00000078967","7",43926436,43956136,29700
"1446","ENSG00000079101","18",596988,650334,53346
"1447","ENSG00000079102","8",91954967,92103286,148319
"1448","ENSG00000079112","8",94127162,94217303,90141
"1449","ENSG00000079134","18",214520,268050,53530
"1450","ENSG00000079150","2",178463664,178478600,14936
"1451","ENSG00000079156","2",178194481,178402893,208412
"1452","ENSG00000079215","5",36606355,36688334,81979
"1453","ENSG00000079246","2",216107464,216206303,98839
"1454","ENSG00000079257","3",158645822,158672648,26826
"1455","ENSG00000079263","2",230203110,230313215,110105
"1456","ENSG00000079277","1",46557408,46616843,59435
"1457","ENSG00000079308","2",217799588,218033982,234394
"1458","ENSG00000079313","19",1815248,1848483,33235
"1459","ENSG00000079332","10",70147289,70170523,23234
"1460","ENSG00000079335","1",100345001,100520277,175276
"1461","ENSG00000079337","12",47734363,47771040,36677
"1462","ENSG00000079385","19",42507304,42561234,53930
"1463","ENSG00000079387","12",48042897,48106079,63182
"1464","ENSG00000079393","10",75094432,75109221,14789
"1465","ENSG00000079432","19",42268537,42295797,27260
"1466","ENSG00000079435","19",42401514,42427388,25874
"1467","ENSG00000079459","8",11795573,11839304,43731
"1468","ENSG00000079462","19",42297033,42303546,6513
"1469","ENSG00000079482","X",68042344,68433913,391569
"1470","ENSG00000079557","4",73481745,73504001,22256
"1471","ENSG00000079616","16",29790719,29805385,14666
"1472","ENSG00000079689","6",25652201,25701783,49582
"1473","ENSG00000079691","6",25279078,25620530,341452
"1474","ENSG00000079739","1",63593411,63660245,66834
"1475","ENSG00000079785","2",15591178,15631111,39933
"1476","ENSG00000079805","19",10718079,10833488,115409
"1477","ENSG00000079819","6",130839347,131063322,223975
"1478","ENSG00000079841","6",71886703,72403143,516440
"1479","ENSG00000079931","6",132296055,132401475,105420
"1480","ENSG00000079950","6",132445867,132513198,67331
"1481","ENSG00000079974","22",50767501,50783663,16162
"1482","ENSG00000079999","19",10486125,10503558,17433
"1483","ENSG00000080007","6",73394828,73417566,22738
"1484","ENSG00000080031","19",55181247,55209506,28259
"1485","ENSG00000080166","13",94436811,94479682,42871
"1486","ENSG00000080189","20",46345980,46364458,18478
"1487","ENSG00000080200","3",97822011,97944984,122973
"1488","ENSG00000080224","3",96814581,97752460,937879
"1489","ENSG00000080293","2",119439843,119525301,85458
"1490","ENSG00000080298","9",3218297,3526004,307707
"1491","ENSG00000080345","2",151409883,151508013,98130
"1492","ENSG00000080371","12",71754863,71800286,45423
"1493","ENSG00000080493","4",71062667,71572087,509420
"1494","ENSG00000080503","9",1980290,2193624,213334
"1495","ENSG00000080511","19",10013249,10022279,9030
"1496","ENSG00000080546","6",108986437,109094819,108382
"1497","ENSG00000080561","X",107825755,107927193,101438
"1498","ENSG00000080572","X",107206632,107244243,37611
"1499","ENSG00000080573","19",9959561,10010504,50943
"1500","ENSG00000080603","16",30698209,30741409,43200
"1501","ENSG00000080608","9",2720469,2844095,123626
"1502","ENSG00000080618","13",46053186,46105033,51847
"1503","ENSG00000080644","15",78593052,78621295,28243
"1504","ENSG00000080709","5",114055545,114496500,440955
"1505","ENSG00000080802","7",135361795,135510127,148332
"1506","ENSG00000080815","14",73136418,73223691,87273
"1507","ENSG00000080819","3",98579446,98593648,14202
"1508","ENSG00000080822","3",98497912,98523066,25154
"1509","ENSG00000080823","14",102224500,102305190,80690
"1510","ENSG00000080824","14",102080738,102139699,58961
"1511","ENSG00000080839","20",36996349,37095995,99646
"1512","ENSG00000080845","20",36306336,36528637,222301
"1513","ENSG00000080854","11",133908564,133956985,48421
"1514","ENSG00000080910","1",196943738,196959622,15884
"1515","ENSG00000080947","1",16467436,16499257,31821
"1516","ENSG00000080986","18",2571557,2616635,45078
"1517","ENSG00000081014","15",50908672,51005895,97223
"1518","ENSG00000081019","1",113761832,113812476,50644
"1519","ENSG00000081026","1",113390515,113685923,295408
"1520","ENSG00000081041","4",74097040,74099196,2156
"1521","ENSG00000081051","4",73431138,73456174,25036
"1522","ENSG00000081052","2",227002711,227164453,161742
"1523","ENSG00000081059","5",134114681,134151865,37184
"1524","ENSG00000081087","6",108041409,108165854,124445
"1525","ENSG00000081138","18",65750252,65890337,140085
"1526","ENSG00000081148","3",101222546,101320575,98029
"1527","ENSG00000081154","3",101574095,101594437,20342
"1528","ENSG00000081177","14",69191511,69244020,52509
"1529","ENSG00000081181","14",67619920,67651708,31788
"1530","ENSG00000081189","5",88717117,88904257,187140
"1531","ENSG00000081237","1",198638457,198757476,119019
"1532","ENSG00000081248","1",201039512,201112451,72939
"1533","ENSG00000081277","1",201283452,201332993,49541
"1534","ENSG00000081307","3",132654446,132678097,23651
"1535","ENSG00000081320","2",196133583,196176503,42920
"1536","ENSG00000081377","9",96490241,96619830,129589
"1537","ENSG00000081386","9",96755865,96778129,22264
"1538","ENSG00000081479","2",169127109,169362534,235425
"1539","ENSG00000081665","19",19785839,19821751,35912
"1540","ENSG00000081692","1",227730425,227735411,4986
"1541","ENSG00000081721","1",161749758,161757238,7480
"1542","ENSG00000081760","12",125065434,125143333,77899
"1543","ENSG00000081791","5",141923855,141942047,18192
"1544","ENSG00000081800","7",123113531,123199972,86441
"1545","ENSG00000081803","7",122318411,122886759,568348
"1546","ENSG00000081818","5",141121799,141125623,3824
"1547","ENSG00000081842","5",140827958,141012347,184389
"1548","ENSG00000081853","5",141338760,141512975,174215
"1549","ENSG00000081870","1",53916574,53945929,29355
"1550","ENSG00000081913","18",62715541,62980433,264892
"1551","ENSG00000081923","18",57646426,57803315,156889
"1552","ENSG00000081985","1",67307364,67397090,89726
"1553","ENSG00000082014","7",151238764,151277896,39132
"1554","ENSG00000082068","5",37379212,37753435,374223
"1555","ENSG00000082074","5",39105252,39274528,169276
"1556","ENSG00000082126","2",201644870,201698694,53824
"1557","ENSG00000082146","2",201387858,201480846,92988
"1558","ENSG00000082153","2",200810594,200827338,16744
"1559","ENSG00000082175","11",101029624,101130524,100900
"1560","ENSG00000082196","5",34019448,34043832,24384
"1561","ENSG00000082212","18",50879080,50954257,75177
"1562","ENSG00000082213","5",31532287,31555053,22766
"1563","ENSG00000082258","2",134918235,134959342,41107
"1564","ENSG00000082269","6",70412941,70561174,148233
"1565","ENSG00000082293","6",69866556,70212468,345912
"1566","ENSG00000082397","18",5392381,5630700,238319
"1567","ENSG00000082438","2",164653624,164843679,190055
"1568","ENSG00000082458","X",70444835,70505490,60655
"1569","ENSG00000082482","1",215005775,215237093,231318
"1570","ENSG00000082497","1",210232796,210246631,13835
"1571","ENSG00000082512","1",211326615,211374946,48331
"1572","ENSG00000082515","5",154941073,154969411,28338
"1573","ENSG00000082516","5",154887411,154938211,50800
"1574","ENSG00000082556","8",53225716,53251697,25981
"1575","ENSG00000082641","17",48048329,48061545,13216
"1576","ENSG00000082684","3",122909082,123028605,119523
"1577","ENSG00000082701","3",119821323,120094417,273094
"1578","ENSG00000082781","3",124761948,124901418,139470
"1579","ENSG00000082805","12",990509,1495933,505424
"1580","ENSG00000082898","2",61477849,61538626,60777
"1581","ENSG00000082929","4",5524569,5527801,3232
"1582","ENSG00000082996","3",149812708,149962139,149431
"1583","ENSG00000083067","9",70529063,71446904,917841
"1584","ENSG00000083093","16",23603160,23641310,38150
"1585","ENSG00000083097","6",83067666,83171350,103684
"1586","ENSG00000083099","6",89568144,89638749,70605
"1587","ENSG00000083123","6",80106647,80346270,239623
"1588","ENSG00000083168","8",41929479,42051994,122515
"1589","ENSG00000083223","9",86287733,86354454,66721
"1590","ENSG00000083290","17",19770829,19867936,97107
"1591","ENSG00000083307","8",101492439,101669726,177287
"1592","ENSG00000083312","5",72816312,72916733,100421
"1593","ENSG00000083444","1",11934205,11975538,41333
"1594","ENSG00000083454","17",3672199,3696240,24041
"1595","ENSG00000083457","17",3714628,3801188,86560
"1596","ENSG00000083520","13",72752169,72782096,29927
"1597","ENSG00000083535","13",72782133,73016461,234328
"1598","ENSG00000083544","13",60396457,60573878,177421
"1599","ENSG00000083622","7",117604791,117647415,42624
"1600","ENSG00000083635","13",44939249,44989471,50222
"1601","ENSG00000083642","13",32586452,32778019,191567
"1602","ENSG00000083720","5",41730065,41870425,140360
"1603","ENSG00000083750","X",55717739,55758774,41035
"1604","ENSG00000083782","12",90963682,91005026,41344
"1605","ENSG00000083799","16",50742050,50801935,59885
"1606","ENSG00000083807","19",58479512,58512413,32901
"1607","ENSG00000083812","19",58467045,58475436,8391
"1608","ENSG00000083814","19",57719751,57727624,7873
"1609","ENSG00000083817","19",57571566,57578911,7345
"1610","ENSG00000083828","19",57769655,57819939,50284
"1611","ENSG00000083838","19",58474017,58481230,7213
"1612","ENSG00000083844","19",57191500,57222846,31346
"1613","ENSG00000083845","19",58386400,58394806,8406
"1614","ENSG00000083857","4",186587794,186726722,138928
"1615","ENSG00000083896","4",68310387,68350089,39702
"1616","ENSG00000083937","3",87227271,87255556,28285
"1617","ENSG00000084070","1",40344850,40423326,78476
"1618","ENSG00000084072","1",39692182,39763914,71732
"1619","ENSG00000084073","1",40258236,40294180,35944
"1620","ENSG00000084090","2",96184859,96208825,23966
"1621","ENSG00000084092","4",56963350,56977606,14256
"1622","ENSG00000084093","4",56907876,56966678,58802
"1623","ENSG00000084110","12",95972662,95996365,23703
"1624","ENSG00000084112","12",108778191,108857590,79399
"1625","ENSG00000084207","11",67583595,67586656,3061
"1626","ENSG00000084234","11",130068147,130144811,76664
"1627","ENSG00000084444","12",13044381,13142521,98140
"1628","ENSG00000084453","12",21264600,21419594,154994
"1629","ENSG00000084463","12",14784582,14803486,18904
"1630","ENSG00000084623","1",32221928,32231604,9676
"1631","ENSG00000084628","1",31179745,31239887,60142
"1632","ENSG00000084636","1",31652263,31704319,52056
"1633","ENSG00000084652","1",32179675,32198285,18610
"1634","ENSG00000084674","2",21001429,21044073,42644
"1635","ENSG00000084676","2",24491914,24770702,278788
"1636","ENSG00000084693","2",27042364,27070622,28258
"1637","ENSG00000084710","2",25042076,25159135,117059
"1638","ENSG00000084731","2",25926598,25982749,56151
"1639","ENSG00000084733","2",26034084,26137454,103370
"1640","ENSG00000084734","2",27496839,27523684,26845
"1641","ENSG00000084754","2",26190635,26244672,54037
"1642","ENSG00000084764","2",26970612,27027196,56584
"1643","ENSG00000084774","2",27217369,27243943,26574
"1644","ENSG00000085063","11",33703010,33736491,33481
"1645","ENSG00000085117","11",44564427,44620358,55931
"1646","ENSG00000085185","X",129981107,130058083,76976
"1647","ENSG00000085224","X",77504878,77786233,281355
"1648","ENSG00000085231","5",69350984,69370013,19029
"1649","ENSG00000085265","9",134903232,134917912,14680
"1650","ENSG00000085274","3",169772831,169789716,16885
"1651","ENSG00000085276","3",169083499,169663775,580276
"1652","ENSG00000085365","5",78360611,78480739,120128
"1653","ENSG00000085377","6",105273220,105454062,180842
"1654","ENSG00000085382","6",104728094,104859919,131825
"1655","ENSG00000085415","18",12947133,12987536,40403
"1656","ENSG00000085433","1",108970214,109042113,71899
"1657","ENSG00000085449","2",223855716,223945357,89641
"1658","ENSG00000085465","1",111414314,111427777,13463
"1659","ENSG00000085491","1",108134043,108200849,66806
"1660","ENSG00000085511","6",160991727,161117385,125658
"1661","ENSG00000085514","7",100367530,100400096,32566
"1662","ENSG00000085552","1",159927039,159945613,18574
"1663","ENSG00000085563","7",87503633,87713323,209690
"1664","ENSG00000085644","16",3129777,3142805,13028
"1665","ENSG00000085662","7",134442356,134459284,16928
"1666","ENSG00000085719","8",86514435,86561498,47063
"1667","ENSG00000085721","16",15060022,15094317,34295
"1668","ENSG00000085733","11",70398404,70436584,38180
"1669","ENSG00000085741","11",76186325,76210736,24411
"1670","ENSG00000085760","2",55236595,55269347,32752
"1671","ENSG00000085788","8",38225218,38275558,50340
"1672","ENSG00000085831","1",51287258,51345116,57858
"1673","ENSG00000085832","1",51354263,51519266,165003
"1674","ENSG00000085840","1",52372829,52404423,31594
"1675","ENSG00000085871","4",139665768,139740745,74977
"1676","ENSG00000085872","19",16517894,16542437,24543
"1677","ENSG00000085978","2",233210051,233295674,85623
"1678","ENSG00000085982","2",233475520,233566782,91262
"1679","ENSG00000085998","1",46188682,46220305,31623
"1680","ENSG00000085999","1",46246461,46278480,32019
"1681","ENSG00000086015","1",45786987,46036122,249135
"1682","ENSG00000086061","9",33025273,33039907,14634
"1683","ENSG00000086062","9",33104082,33167356,63274
"1684","ENSG00000086065","9",33264879,33282070,17191
"1685","ENSG00000086102","9",33290512,33371157,80645
"1686","ENSG00000086159","12",49967194,49977139,9945
"1687","ENSG00000086189","5",62347284,62403939,56655
"1688","ENSG00000086200","5",62403972,62628582,224610
"1689","ENSG00000086205","11",49145092,49208638,63546
"1690","ENSG00000086232","7",6022247,6059175,36928
"1691","ENSG00000086288","7",37848597,37900401,51804
"1692","ENSG00000086289","7",37683843,37951936,268093
"1693","ENSG00000086300","7",26291895,26374329,82434
"1694","ENSG00000086475","10",13317428,13348298,30870
"1695","ENSG00000086504","16",366969,371289,4320
"1696","ENSG00000086506","16",180459,181179,720
"1697","ENSG00000086544","19",40717112,40740860,23748
"1698","ENSG00000086548","19",41750977,41772211,21234
"1699","ENSG00000086570","5",151504093,151568944,64851
"1700","ENSG00000086589","5",150690792,150701077,10285
"1701","ENSG00000086598","12",123584533,123598582,14049
"1702","ENSG00000086619","1",236215555,236281985,66430
"1703","ENSG00000086666","15",80059568,80138393,78825
"1704","ENSG00000086696","16",82035004,82098534,63530
"1705","ENSG00000086712","X",16786432,16844519,58087
"1706","ENSG00000086717","X",18675909,18827921,152012
"1707","ENSG00000086730","7",74199652,74229834,30182
"1708","ENSG00000086758","X",53532096,53686728,154632
"1709","ENSG00000086827","11",113733187,113773735,40548
"1710","ENSG00000086848","11",111782195,111871581,89386
"1711","ENSG00000086967","19",50432892,50466321,33429
"1712","ENSG00000086991","11",89324353,89498187,173834
"1713","ENSG00000087008","4",8366282,8440723,74441
"1714","ENSG00000087053","11",95832882,95925315,92433
"1715","ENSG00000087074","19",48872421,48876058,3637
"1716","ENSG00000087076","19",48813018,48836510,23492
"1717","ENSG00000087077","7",100867387,100873454,6067
"1718","ENSG00000087085","7",100889994,100896974,6980
"1719","ENSG00000087086","19",48965309,48966879,1570
"1720","ENSG00000087087","7",100875103,100888664,13561
"1721","ENSG00000087088","19",48954815,48961798,6983
"1722","ENSG00000087095","17",28041737,28196381,154644
"1723","ENSG00000087111","17",28553383,28571794,18411
"1724","ENSG00000087116","5",179110853,179345461,234608
"1725","ENSG00000087128","4",68447463,68497604,50141
"1726","ENSG00000087152","17",44191805,44200113,8308
"1727","ENSG00000087157","17",78378649,78425114,46465
"1728","ENSG00000087191","17",63827152,63832026,4874
"1729","ENSG00000087206","5",176905005,177022633,117628
"1730","ENSG00000087237","16",56961923,56983845,21922
"1731","ENSG00000087245","16",55389700,55506691,116991
"1732","ENSG00000087250","16",56589074,56591088,2014
"1733","ENSG00000087253","16",55509072,55586666,77594
"1734","ENSG00000087258","16",56191489,56357444,165955
"1735","ENSG00000087263","16",56451490,56479100,27610
"1736","ENSG00000087266","4",2793071,2841098,48027
"1737","ENSG00000087269","4",2937933,2963406,25473
"1738","ENSG00000087274","4",2843857,2930076,86219
"1739","ENSG00000087299","14",50237563,50312229,74666
"1740","ENSG00000087301","14",52430596,52552522,121926
"1741","ENSG00000087302","14",51989514,52010694,21180
"1742","ENSG00000087303","14",52004803,52069228,64425
"1743","ENSG00000087338","2",69829660,69881384,51724
"1744","ENSG00000087365","11",66050729,66069308,18579
"1745","ENSG00000087448","12",27780048,27803040,22992
"1746","ENSG00000087460","20",58839718,58911192,71474
"1747","ENSG00000087470","12",32679200,32745650,66450
"1748","ENSG00000087494","12",27958084,27972705,14621
"1749","ENSG00000087495","20",59577509,59847711,270202
"1750","ENSG00000087502","12",29337352,29381189,43837
"1751","ENSG00000087510","20",56629306,56639283,9977
"1752","ENSG00000087586","20",56369389,56392337,22948
"1753","ENSG00000087589","20",56412112,56460387,48275
"1754","ENSG00000087842","X",15384799,15493564,108765
"1755","ENSG00000087884","11",77821109,77918432,97323
"1756","ENSG00000087903","19",5993164,6199572,206408
"1757","ENSG00000087995","17",62423867,62450822,26955
"1758","ENSG00000088002","19",48552075,48599425,47350
"1759","ENSG00000088035","1",63367575,63438553,70978
"1760","ENSG00000088038","19",54137749,54155681,17932
"1761","ENSG00000088053","19",55013705,55038264,24559
"1762","ENSG00000088179","2",119759922,119984899,224977
"1763","ENSG00000088205","2",117814691,117832377,17686
"1764","ENSG00000088247","19",6413348,6424794,11446
"1765","ENSG00000088256","19",3094362,3123999,29637
"1766","ENSG00000088280","1",23428563,23484568,56005
"1767","ENSG00000088298","20",35115364,35147336,31972
"1768","ENSG00000088305","20",32762385,32809356,46971
"1769","ENSG00000088320","20",31475288,31484895,9607
"1770","ENSG00000088325","20",31739271,31801805,62534
"1771","ENSG00000088340","20",35558737,35607562,48825
"1772","ENSG00000088356","20",31944337,31952046,7709
"1773","ENSG00000088367","20",36091504,36232799,141295
"1774","ENSG00000088386","13",98683801,98752672,68871
"1775","ENSG00000088387","13",98793429,99086625,293196
"1776","ENSG00000088448","13",110878540,110915069,36529
"1777","ENSG00000088451","13",94574054,94596242,22188
"1778","ENSG00000088538","3",50674927,51384198,709271
"1779","ENSG00000088543","3",50558025,50571027,13002
"1780","ENSG00000088682","16",57447425,57461270,13845
"1781","ENSG00000088726","3",12733528,12769457,35929
"1782","ENSG00000088727","3",47228026,47283451,55425
"1783","ENSG00000088756","18",6729718,6915716,185998
"1784","ENSG00000088766","20",6006090,6040053,33963
"1785","ENSG00000088782","20",157470,159163,1693
"1786","ENSG00000088808","14",103733195,103847590,114395
"1787","ENSG00000088812","20",3471018,3651118,180100
"1788","ENSG00000088826","20",4120980,4187747,66767
"1789","ENSG00000088827","20",3686970,3707128,20158
"1790","ENSG00000088832","20",1368978,1393172,24194
"1791","ENSG00000088833","20",1442162,1473842,31680
"1792","ENSG00000088836","20",3227417,3239559,12142
"1793","ENSG00000088854","20",3249305,3407625,158320
"1794","ENSG00000088876","20",2481817,2524702,42885
"1795","ENSG00000088881","20",2692878,2760108,67230
"1796","ENSG00000088882","20",2794074,2800627,6553
"1797","ENSG00000088888","20",3846799,3876123,29324
"1798","ENSG00000088899","20",3162617,3173592,10975
"1799","ENSG00000088926","4",186265945,186288806,22861
"1800","ENSG00000088930","20",21303331,21389825,86494
"1801","ENSG00000088970","20",21125983,21246622,120639
"1802","ENSG00000088986","12",120469850,120498493,28643
"1803","ENSG00000088992","12",117038923,117099479,60556
"1804","ENSG00000089006","20",17941597,17968980,27383
"1805","ENSG00000089009","12",112405190,112418838,13648
"1806","ENSG00000089012","20",1629152,1657779,28627
"1807","ENSG00000089022","12",111842228,111902222,59994
"1808","ENSG00000089041","12",121132819,121188032,55213
"1809","ENSG00000089048","20",13714322,13784886,70564
"1810","ENSG00000089050","20",18486540,18497225,10685
"1811","ENSG00000089053","12",121308245,121399896,91651
"1812","ENSG00000089057","20",4852356,5010293,157937
"1813","ENSG00000089060","12",113298759,113359493,60734
"1814","ENSG00000089063","20",5068232,5113103,44871
"1815","ENSG00000089091","20",18383367,18467281,83914
"1816","ENSG00000089094","12",121429096,121581023,151927
"1817","ENSG00000089101","20",20052514,20360698,308184
"1818","ENSG00000089116","12",113462033,113472280,10247
"1819","ENSG00000089123","20",13389392,13638932,249540
"1820","ENSG00000089127","12",112906783,112933222,26439
"1821","ENSG00000089154","12",120127202,120194715,67513
"1822","ENSG00000089157","12",120196699,120201235,4536
"1823","ENSG00000089159","12",120210439,120265771,55332
"1824","ENSG00000089163","12",120302316,120313249,10933
"1825","ENSG00000089169","12",112570380,112898881,328501
"1826","ENSG00000089177","20",16272104,16573434,301330
"1827","ENSG00000089195","20",5937228,5950558,13330
"1828","ENSG00000089199","20",5911510,5925353,13843
"1829","ENSG00000089220","12",118136124,118145584,9460
"1830","ENSG00000089225","12",114353931,114408442,54511
"1831","ENSG00000089234","12",111642146,111685956,43810
"1832","ENSG00000089248","12",112013348,112023449,10101
"1833","ENSG00000089250","12",117208142,117452170,244028
"1834","ENSG00000089280","16",31180110,31194871,14761
"1835","ENSG00000089289","X",70133447,70166324,32877
"1836","ENSG00000089327","19",35154730,35169883,15153
"1837","ENSG00000089335","19",34677639,34686397,8758
"1838","ENSG00000089351","19",34994784,35026471,31687
"1839","ENSG00000089356","19",35115879,35124324,8445
"1840","ENSG00000089472","X",66162549,66268867,106318
"1841","ENSG00000089486","16",4510669,4538828,28159
"1842","ENSG00000089505","16",66566393,66579137,12744
"1843","ENSG00000089558","17",42156891,42181142,24251
"1844","ENSG00000089597","11",62624826,62646726,21900
"1845","ENSG00000089639","19",19629476,19643657,14181
"1846","ENSG00000089682","X",107064420,107118823,54403
"1847","ENSG00000089685","17",78214186,78225636,11450
"1848","ENSG00000089692","12",6772512,6778455,5943
"1849","ENSG00000089693","12",6747996,6767475,19479
"1850","ENSG00000089723","14",94026340,94048930,22590
"1851","ENSG00000089737","14",94048287,94081212,32925
"1852","ENSG00000089775","14",64449106,64505213,56107
"1853","ENSG00000089818","12",8076939,8097881,20942
"1854","ENSG00000089820","X",153907367,153934999,27632
"1855","ENSG00000089847","19",4183354,4224814,41460
"1856","ENSG00000089876","10",125836337,125896436,60099
"1857","ENSG00000089902","14",102592649,102730561,137912
"1858","ENSG00000089916","14",76151916,76254342,102426
"1859","ENSG00000090006","19",40592883,40629818,36935
"1860","ENSG00000090013","19",40447765,40465840,18075
"1861","ENSG00000090020","1",27098809,27166981,68172
"1862","ENSG00000090054","9",92000087,92115413,115326
"1863","ENSG00000090060","14",96501433,96567111,65678
"1864","ENSG00000090061","14",99481169,99535044,53875
"1865","ENSG00000090097","3",51957454,51974016,16562
"1866","ENSG00000090104","1",192575763,192580024,4261
"1867","ENSG00000090238","16",30092314,30096915,4601
"1868","ENSG00000090263","7",141002610,141015228,12618
"1869","ENSG00000090266","7",140690777,140722790,32013
"1870","ENSG00000090273","1",26900238,26946871,46633
"1871","ENSG00000090316","4",1289887,1340147,50260
"1872","ENSG00000090339","19",10271093,10286615,15522
"1873","ENSG00000090372","19",46719511,46746994,27483
"1874","ENSG00000090376","12",66188879,66254622,65743
"1875","ENSG00000090382","12",69348341,69354234,5893
"1876","ENSG00000090402","3",164978898,165078496,99598
"1877","ENSG00000090432","1",20499448,20508151,8703
"1878","ENSG00000090447","16",4257186,4273075,15889
"1879","ENSG00000090470","15",65117379,65133808,16429
"1880","ENSG00000090487","15",64963022,64990310,27288
"1881","ENSG00000090512","3",186635969,186653141,17172
"1882","ENSG00000090520","3",186567403,186585800,18397
"1883","ENSG00000090530","3",189956728,190122437,165709
"1884","ENSG00000090534","3",184371935,184381968,10033
"1885","ENSG00000090539","3",184380073,184390736,10663
"1886","ENSG00000090554","19",49474207,49486231,12024
"1887","ENSG00000090565","16",425649,523011,97362
"1888","ENSG00000090581","16",1351931,1364113,12182
"1889","ENSG00000090612","12",133181409,133214831,33422
"1890","ENSG00000090615","12",132768914,132829078,60164
"1891","ENSG00000090621","1",39560816,39576790,15974
"1892","ENSG00000090659","19",7739993,7747564,7571
"1893","ENSG00000090661","19",8206736,8262421,55685
"1894","ENSG00000090674","19",7522624,7534009,11385
"1895","ENSG00000090686","1",21678298,21783606,105308
"1896","ENSG00000090776","X",68829021,68842160,13139
"1897","ENSG00000090857","16",70113626,70162537,48911
"1898","ENSG00000090861","16",70252295,70289543,37248
"1899","ENSG00000090863","16",74447427,74607144,159717
"1900","ENSG00000090889","X",70290104,70420886,130782
"1901","ENSG00000090905","16",24610209,24827632,217423
"1902","ENSG00000090924","19",39412669,39428415,15746
"1903","ENSG00000090932","19",39498895,39508481,9586
"1904","ENSG00000090971","19",55485188,55487568,2380
"1905","ENSG00000090975","12",122983480,123150015,166535
"1906","ENSG00000090989","4",55853648,55905086,51438
"1907","ENSG00000091009","5",146203605,146289223,85618
"1908","ENSG00000091010","5",146338839,146341728,2889
"1909","ENSG00000091039","12",76351797,76559809,208012
"1910","ENSG00000091073","7",76461676,76505995,44319
"1911","ENSG00000091106","2",32224453,32265732,41279
"1912","ENSG00000091127","7",105439661,105522271,82610
"1913","ENSG00000091128","7",108023548,108130361,106813
"1914","ENSG00000091129","7",108147623,108456717,309094
"1915","ENSG00000091136","7",107923799,108003187,79388
"1916","ENSG00000091137","7",107660828,107717782,56954
"1917","ENSG00000091138","7",107765467,107803225,37758
"1918","ENSG00000091140","7",107891162,107931730,40568
"1919","ENSG00000091157","18",56651343,57036606,385263
"1920","ENSG00000091164","18",56597209,56651600,54391
"1921","ENSG00000091181","3",3066326,3126613,60287
"1922","ENSG00000091262","16",16148928,16223522,74594
"1923","ENSG00000091317","3",32481312,32502852,21540
"1924","ENSG00000091409","2",172427354,172506459,79105
"1925","ENSG00000091428","2",172735274,173052893,317619
"1926","ENSG00000091436","2",173075435,173268015,192580
"1927","ENSG00000091482","X",21705978,21758116,52138
"1928","ENSG00000091483","1",241497603,241519761,22158
"1929","ENSG00000091490","4",25747433,25863760,116327
"1930","ENSG00000091513","3",133746040,133796641,50601
"1931","ENSG00000091527","3",133573730,133590261,16531
"1932","ENSG00000091536","17",18108706,18179802,71096
"1933","ENSG00000091542","17",18183078,18209954,26876
"1934","ENSG00000091583","17",66212033,66256525,44492
"1935","ENSG00000091592","17",5499427,5619424,119997
"1936","ENSG00000091622","17",6451263,6556555,105292
"1937","ENSG00000091640","17",4959226,4967817,8591
"1938","ENSG00000091651","16",46689643,46698394,8751
"1939","ENSG00000091656","8",76681239,76867285,186046
"1940","ENSG00000091664","11",22338097,22379503,41406
"1941","ENSG00000091704","7",130380339,130388114,7775
"1942","ENSG00000091732","7",130018286,130051451,33165
"1943","ENSG00000091831","6",151656691,152129619,472928
"1944","ENSG00000091844","6",153004459,153131282,126823
"1945","ENSG00000091879","8",6499651,6563409,63758
"1946","ENSG00000091947","17",44011188,44023946,12758
"1947","ENSG00000091972","3",112332347,112362812,30465
"1948","ENSG00000091986","3",112596794,112649530,52736
"1949","ENSG00000092009","14",24505353,24508265,2912
"1950","ENSG00000092010","14",24136163,24138967,2804
"1951","ENSG00000092020","14",35085467,35122517,37050
"1952","ENSG00000092036","14",22946228,22957161,10933
"1953","ENSG00000092051","14",23568035,23578790,10755
"1954","ENSG00000092054","14",23412740,23435660,22920
"1955","ENSG00000092067","14",23117304,23119616,2312
"1956","ENSG00000092068","14",23125295,23183674,58379
"1957","ENSG00000092094","14",20446401,20455089,8688
"1958","ENSG00000092096","14",23346306,23352912,6606
"1959","ENSG00000092098","14",24146683,24160660,13977
"1960","ENSG00000092108","14",30622112,30735812,113700
"1961","ENSG00000092140","14",30559158,30620064,60906
"1962","ENSG00000092148","14",31100112,31207804,107692
"1963","ENSG00000092199","14",21209136,21269494,60358
"1964","ENSG00000092200","14",21287939,21351301,63362
"1965","ENSG00000092201","14",21351476,21384019,32543
"1966","ENSG00000092203","14",21476597,21499175,22578
"1967","ENSG00000092208","14",39114223,39136973,22750
"1968","ENSG00000092295","14",24249114,24264432,15318
"1969","ENSG00000092330","14",24239643,24242674,3031
"1970","ENSG00000092345","3",16586792,16670306,83514
"1971","ENSG00000092377","Y",6910686,7101970,191284
"1972","ENSG00000092421","5",116443616,116574934,131318
"1973","ENSG00000092439","15",50552473,50686797,134324
"1974","ENSG00000092445","15",41557675,41583589,25914
"1975","ENSG00000092470","15",43826980,43868412,41432
"1976","ENSG00000092529","15",42359500,42412318,52818
"1977","ENSG00000092531","15",42491233,42545356,54123
"1978","ENSG00000092607","1",118883046,118989556,106510
"1979","ENSG00000092621","1",119648411,119744226,95815
"1980","ENSG00000092758","20",62816244,62841159,24915
"1981","ENSG00000092820","6",158765741,158819368,53627
"1982","ENSG00000092841","12",56158161,56163496,5335
"1983","ENSG00000092847","1",35869808,35930532,60724
"1984","ENSG00000092850","1",36084094,36088275,4181
"1985","ENSG00000092853","1",35720218,35769978,49760
"1986","ENSG00000092871","17",35005990,35089319,83329
"1987","ENSG00000092929","17",75827225,75844717,17492
"1988","ENSG00000092931","17",76735865,76781449,45584
"1989","ENSG00000092964","8",26514031,26658178,144147
"1990","ENSG00000092969","1",218345336,218444619,99283
"1991","ENSG00000092978","1",217426992,217631090,204098
"1992","ENSG00000093000","22",45163925,45188017,24092
"1993","ENSG00000093009","22",19479459,19520612,41153
"1994","ENSG00000093010","22",19941607,19969975,28368
"1995","ENSG00000093072","22",17178790,17258235,79445
"1996","ENSG00000093100","22",17787652,17811497,23845
"1997","ENSG00000093134","6",132722787,132734765,11978
"1998","ENSG00000093144","6",127288712,127343609,54897
"1999","ENSG00000093167","3",37052626,37183689,131063
"2000","ENSG00000093183","3",42547969,42601080,53111
"2001","ENSG00000093217","3",38346760,38421348,74588
"2002","ENSG00000094631","X",48801377,48824982,23605
"2003","ENSG00000094661","19",15082211,15092970,10759
"2004","ENSG00000094755","5",170763350,170814047,50697
"2005","ENSG00000094796","17",41393721,41397608,3887
"2006","ENSG00000094804","17",40287879,40304657,16778
"2007","ENSG00000094841","X",75156388,75304885,148497
"2008","ENSG00000094880","5",138187650,138213343,25693
"2009","ENSG00000094914","12",53307457,53324864,17407
"2010","ENSG00000094916","12",54230942,54280133,49191
"2011","ENSG00000094963","1",171185249,171212686,27437
"2012","ENSG00000094975","1",172532349,172611833,79484
"2013","ENSG00000095002","2",47402969,47663146,260177
"2014","ENSG00000095015","5",56815549,56896152,80603
"2015","ENSG00000095059","19",12675717,12681880,6163
"2016","ENSG00000095066","19",12763003,12872740,109737
"2017","ENSG00000095110","11",114521645,114559895,38250
"2018","ENSG00000095139","11",118572390,118603033,30643
"2019","ENSG00000095203","9",109171975,109320964,148989
"2020","ENSG00000095209","9",105694541,105776629,82088
"2021","ENSG00000095261","9",120815496,120842951,27455
"2022","ENSG00000095303","9",122370530,122395703,25173
"2023","ENSG00000095319","9",128947699,129007096,59397
"2024","ENSG00000095321","9",129094794,129111189,16395
"2025","ENSG00000095370","9",127738317,127778710,40393
"2026","ENSG00000095380","9",98056732,98083077,26345
"2027","ENSG00000095383","9",98199011,98255649,56638
"2028","ENSG00000095397","9",114402080,114505473,103393
"2029","ENSG00000095464","10",93612588,93666010,53422
"2030","ENSG00000095485","10",100232298,100267680,35382
"2031","ENSG00000095539","10",100969518,100985871,16353
"2032","ENSG00000095564","10",91923770,92030325,106555
"2033","ENSG00000095574","10",122990806,123008817,18011
"2034","ENSG00000095585","10",96191702,96271587,79885
"2035","ENSG00000095587","10",96364608,96513926,149318
"2036","ENSG00000095596","10",93073475,93077885,4410
"2037","ENSG00000095627","10",114179270,114232304,53034
"2038","ENSG00000095637","10",95311771,95561414,249643
"2039","ENSG00000095713","10",97865000,98030828,165828
"2040","ENSG00000095739","10",28677510,28682932,5422
"2041","ENSG00000095752","19",55364382,55370463,6081
"2042","ENSG00000095777","10",25934229,26212532,278303
"2043","ENSG00000095787","10",28532493,28623112,90619
"2044","ENSG00000095794","10",35126791,35212958,86167
"2045","ENSG00000095906","16",1782932,1789186,6254
"2046","ENSG00000095917","16",1256059,1259008,2949
"2047","ENSG00000095932","19",3473986,3480542,6556
"2048","ENSG00000095951","6",12008762,12164999,156237
"2049","ENSG00000095970","6",41158506,41163186,4680
"2050","ENSG00000095981","6",39314698,39322968,8270
"2051","ENSG00000096006","6",49727384,49744437,17053
"2052","ENSG00000096060","6",35573585,35728583,154998
"2053","ENSG00000096063","6",35832966,35921342,88376
"2054","ENSG00000096070","6",36196744,36232790,36046
"2055","ENSG00000096080","6",43671303,43687791,16488
"2056","ENSG00000096088","6",41736711,41754109,17398
"2057","ENSG00000096092","6",52671113,52686588,15475
"2058","ENSG00000096093","6",52362123,52529886,167763
"2059","ENSG00000096264","6",41335608,41350889,15281
"2060","ENSG00000096384","6",44246166,44253888,7722
"2061","ENSG00000096395","6",33794673,33804003,9330
"2062","ENSG00000096401","6",44387706,44450425,62719
"2063","ENSG00000096433","6",33620365,33696574,76209
"2064","ENSG00000096654","6",27450743,27473118,22375
"2065","ENSG00000096696","6",7541617,7586714,45097
"2066","ENSG00000096717","10",67884656,67918390,33734
"2067","ENSG00000096746","10",68331174,68343191,12017
"2068","ENSG00000096872","9",26947039,27062930,115891
"2069","ENSG00000096968","9",4984390,5128183,143793
"2070","ENSG00000096996","19",18058995,18098944,39949
"2071","ENSG00000097007","9",130713946,130887675,173729
"2072","ENSG00000097021","1",6264269,6394391,130122
"2073","ENSG00000097033","1",86704570,86748184,43614
"2074","ENSG00000097046","1",91500851,91525764,24913
"2075","ENSG00000097096","1",85156889,85201016,44127
"2076","ENSG00000099139","9",75890644,76362339,471695
"2077","ENSG00000099194","10",100347233,100364826,17593
"2078","ENSG00000099203","19",10832067,10836318,4251
"2079","ENSG00000099204","10",114431113,114768061,336948
"2080","ENSG00000099219","9",5765076,5833117,68041
"2081","ENSG00000099246","10",27504174,27542237,38063
"2082","ENSG00000099250","10",33177492,33336262,158770
"2083","ENSG00000099251","10",38356380,38378505,22125
"2084","ENSG00000099256","10",24848614,24952606,103992
"2085","ENSG00000099260","1",99646113,99694541,48428
"2086","ENSG00000099282","10",69451465,69507666,56201
"2087","ENSG00000099284","10",70052846,70112282,59436
"2088","ENSG00000099290","10",50067888,50133509,65621
"2089","ENSG00000099308","19",18097793,18151692,53899
"2090","ENSG00000099326","19",58561931,58573575,11644
"2091","ENSG00000099330","19",17226213,17229219,3006
"2092","ENSG00000099331","19",17075781,17214537,138756
"2093","ENSG00000099337","19",38319845,38332076,12231
"2094","ENSG00000099338","19",38335775,38370943,35168
"2095","ENSG00000099341","19",38374536,38383824,9288
"2096","ENSG00000099364","16",30923055,30948783,25728
"2097","ENSG00000099365","16",30989256,31010638,21382
"2098","ENSG00000099377","16",30985207,30989147,3940
"2099","ENSG00000099381","16",30957754,30984664,26910
"2100","ENSG00000099385","16",30833626,30894960,61334
"2101","ENSG00000099399","X",30215563,30220089,4526
"2102","ENSG00000099617","19",1285873,1301431,15558
"2103","ENSG00000099622","19",1259384,1274880,15496
"2104","ENSG00000099624","19",1241746,1244825,3079
"2105","ENSG00000099625","19",1228287,1238027,9740
"2106","ENSG00000099715","Y",5000226,5742224,741998
"2107","ENSG00000099721","Y",6865918,6911774,45856
"2108","ENSG00000099725","Y",7273972,7381548,107576
"2109","ENSG00000099769","16",1790413,1794971,4558
"2110","ENSG00000099783","19",8444767,8489114,44347
"2111","ENSG00000099785","19",8413270,8439017,25747
"2112","ENSG00000099795","19",14566078,14572066,5988
"2113","ENSG00000099797","19",14517085,14565980,48895
"2114","ENSG00000099800","19",2425625,2427586,1961
"2115","ENSG00000099804","19",531760,542092,10332
"2116","ENSG00000099810","9",21802636,21937651,135015
"2117","ENSG00000099812","19",751112,764318,13206
"2118","ENSG00000099814","14",104865268,104896770,31502
"2119","ENSG00000099817","19",1086574,1095380,8806
"2120","ENSG00000099821","19",617221,633537,16316
"2121","ENSG00000099822","19",589881,617159,27278
"2122","ENSG00000099834","11",616565,626078,9513
"2123","ENSG00000099840","19",2096429,2099593,3164
"2124","ENSG00000099849","11",560404,564025,3621
"2125","ENSG00000099860","19",2476122,2478259,2137
"2126","ENSG00000099864","19",708935,748329,39394
"2127","ENSG00000099866","19",489176,505343,16167
"2128","ENSG00000099869","11",2140501,2148666,8165
"2129","ENSG00000099875","19",2037465,2051244,13779
"2130","ENSG00000099889","22",19969896,20016823,46927
"2131","ENSG00000099899","22",20111875,20117392,5517
"2132","ENSG00000099901","22",20115938,20127355,11417
"2133","ENSG00000099904","22",20129456,20148007,18551
"2134","ENSG00000099910","22",20441519,20495844,54325
"2135","ENSG00000099917","22",20495913,20587632,91719
"2136","ENSG00000099937","22",20774113,20787720,13607
"2137","ENSG00000099940","22",20859007,20891214,32207
"2138","ENSG00000099942","22",20917407,20953747,36340
"2139","ENSG00000099949","22",20982269,20999032,16763
"2140","ENSG00000099953","22",23768226,23784316,16090
"2141","ENSG00000099954","22",17359949,17558149,198200
"2142","ENSG00000099956","22",23786931,23838008,51077
"2143","ENSG00000099957","22",21009808,21028830,19022
"2144","ENSG00000099958","22",23834503,23839128,4625
"2145","ENSG00000099960","22",21028718,21032840,4122
"2146","ENSG00000099968","22",17628855,17730855,102000
"2147","ENSG00000099974","22",23966888,23972556,5668
"2148","ENSG00000099977","22",23971365,23979828,8463
"2149","ENSG00000099984","22",23980058,23983915,3857
"2150","ENSG00000099985","22",30262829,30266851,4022
"2151","ENSG00000099991","22",24011192,24178628,167436
"2152","ENSG00000099992","22",30291990,30327046,35056
"2153","ENSG00000099994","22",24181487,24189106,7619
"2154","ENSG00000099995","22",30331988,30356919,24931
"2155","ENSG00000099998","22",24219654,24245142,25488
"2156","ENSG00000099999","22",30368811,30421771,52960
"2157","ENSG00000100003","22",30396941,30425303,28362
"2158","ENSG00000100012","22",30447959,30472049,24090
"2159","ENSG00000100014","22",24270817,24417739,146922
"2160","ENSG00000100023","22",21666009,21700015,34006
"2161","ENSG00000100024","22",24494107,24528390,34283
"2162","ENSG00000100027","22",21697536,21735794,38258
"2163","ENSG00000100028","22",24555958,24582052,26094
"2164","ENSG00000100029","22",30576625,30607083,30458
"2165","ENSG00000100030","22",21754500,21867680,113180
"2166","ENSG00000100031","22",24594811,24629005,34194
"2167","ENSG00000100033","22",18912777,18936553,23776
"2168","ENSG00000100034","22",21919425,21952848,33423
"2169","ENSG00000100036","22",30635781,30669016,33235
"2170","ENSG00000100038","22",21957025,21982816,25791
"2171","ENSG00000100053","22",25199858,25207359,7501
"2172","ENSG00000100055","22",37282027,37315341,33314
"2173","ENSG00000100056","22",19130279,19144684,14405
"2174","ENSG00000100058","22",25448105,25520854,72749
"2175","ENSG00000100060","22",37469063,37486401,17338
"2176","ENSG00000100065","22",37490362,37519542,29180
"2177","ENSG00000100068","22",25351418,25405377,53959
"2178","ENSG00000100075","22",19175581,19178739,3158
"2179","ENSG00000100077","22",25564675,25729294,164619
"2180","ENSG00000100078","22",31134807,31140508,5701
"2181","ENSG00000100079","22",37570248,37582616,12368
"2182","ENSG00000100083","22",37608725,37633564,24839
"2183","ENSG00000100084","22",19330698,19447450,116752
"2184","ENSG00000100092","22",37634654,37656119,21465
"2185","ENSG00000100095","22",26169462,26383597,214135
"2186","ENSG00000100097","22",37675636,37679802,4166
"2187","ENSG00000100099","22",26443423,26483837,40414
"2188","ENSG00000100100","22",31281593,31292534,10941
"2189","ENSG00000100104","22",26483877,26494658,10781
"2190","ENSG00000100105","22",31325804,31346346,20542
"2191","ENSG00000100106","22",37697048,37776556,79508
"2192","ENSG00000100109","22",26491225,26512505,21280
"2193","ENSG00000100116","22",37807905,37817176,9271
"2194","ENSG00000100121","22",22644475,22647903,3428
"2195","ENSG00000100122","22",26599278,26618027,18749
"2196","ENSG00000100124","22",37830855,37849327,18472
"2197","ENSG00000100129","22",37848868,37889407,40539
"2198","ENSG00000100138","22",41673933,41690504,16571
"2199","ENSG00000100139","22",37905657,37942822,37165
"2200","ENSG00000100142","22",37952607,38041915,89308
"2201","ENSG00000100147","22",41800679,41826299,25620
"2202","ENSG00000100150","22",31753867,31908033,154166
"2203","ENSG00000100151","22",38056311,38075701,19390
"2204","ENSG00000100154","22",27978014,28679865,701851
"2205","ENSG00000100156","22",38078134,38084093,5959
"2206","ENSG00000100162","22",41938737,41947152,8415
"2207","ENSG00000100167","22",41969475,41998221,28746
"2208","ENSG00000100170","22",32043032,32113029,69997
"2209","ENSG00000100181","22",16601887,16698742,96855
"2210","ENSG00000100191","22",32218476,32255341,36865
"2211","ENSG00000100196","22",38468078,38483447,15369
"2212","ENSG00000100197","22",42126499,42130881,4382
"2213","ENSG00000100201","22",38483438,38507660,24222
"2214","ENSG00000100206","22",38518948,38570204,51256
"2215","ENSG00000100207","22",42160013,42343616,183603
"2216","ENSG00000100209","22",28742039,28757515,15476
"2217","ENSG00000100211","22",38656636,38673854,17218
"2218","ENSG00000100216","22",38681957,38685421,3464
"2219","ENSG00000100218","22",23059415,23145021,85606
"2220","ENSG00000100220","22",32387582,32412248,24666
"2221","ENSG00000100221","22",38685543,38701556,16013
"2222","ENSG00000100225","22",32474676,32498829,24153
"2223","ENSG00000100226","22",38705742,38738299,32557
"2224","ENSG00000100227","22",42583721,42614962,31241
"2225","ENSG00000100228","22",23145326,23164350,19024
"2226","ENSG00000100234","22",32801701,32863043,61342
"2227","ENSG00000100239","22",50343304,50445090,101786
"2228","ENSG00000100241","22",50445000,50475035,30035
"2229","ENSG00000100242","22",38734725,38794143,59418
"2230","ENSG00000100243","22",42617840,42649392,31552
"2231","ENSG00000100246","22",38778508,38794198,15690
"2232","ENSG00000100253","22",50486784,50490648,3864
"2233","ENSG00000100258","22",50502949,50507702,4753
"2234","ENSG00000100263","22",29259872,29268209,8337
"2235","ENSG00000100266","22",42835412,43015149,179737
"2236","ENSG00000100271","22",43039516,43089419,49903
"2237","ENSG00000100276","22",29312933,29319679,6746
"2238","ENSG00000100280","22",29327680,29423179,95499
"2239","ENSG00000100281","22",35257452,35295807,38355
"2240","ENSG00000100284","22",35299275,35347992,48717
"2241","ENSG00000100285","22",29480230,29491390,11160
"2242","ENSG00000100288","22",50578949,50601455,22506
"2243","ENSG00000100290","22",43110750,43129712,18962
"2244","ENSG00000100292","22",35380361,35394207,13846
"2245","ENSG00000100294","22",43132206,43143394,11188
"2246","ENSG00000100296","22",29505879,29555216,49337
"2247","ENSG00000100297","22",35400134,35425431,25297
"2248","ENSG00000100298","22",39097224,39104067,6843
"2249","ENSG00000100299","22",50622754,50628173,5419
"2250","ENSG00000100300","22",43151547,43163242,11695
"2251","ENSG00000100302","22",35540831,35553999,13168
"2252","ENSG00000100304","22",43166622,43187134,20512
"2253","ENSG00000100307","22",39120167,39152680,32513
"2254","ENSG00000100311","22",39223359,39244751,21392
"2255","ENSG00000100312","22",50738196,50745334,7138
"2256","ENSG00000100314","22",29720003,29731833,11830
"2257","ENSG00000100316","22",39312882,39320389,7507
"2258","ENSG00000100319","22",29730956,29767011,36055
"2259","ENSG00000100320","22",35738736,36028824,290088
"2260","ENSG00000100321","22",39349925,39385575,35650
"2261","ENSG00000100324","22",39399778,39437060,37282
"2262","ENSG00000100325","22",29788609,29838304,49695
"2263","ENSG00000100330","22",29883155,30030866,147711
"2264","ENSG00000100335","22",39499432,39518132,18700
"2265","ENSG00000100336","22",36189124,36204840,15716
"2266","ENSG00000100341","22",43879678,43892013,12335
"2267","ENSG00000100342","22",36253010,36267530,14520
"2268","ENSG00000100344","22",43923739,43964488,40749
"2269","ENSG00000100345","22",36281277,36388067,106790
"2270","ENSG00000100346","22",39570753,39689737,118984
"2271","ENSG00000100347","22",43955442,44010531,55089
"2272","ENSG00000100348","22",36467046,36481640,14594
"2273","ENSG00000100350","22",36487190,36507101,19911
"2274","ENSG00000100351","22",39901082,39973721,72639
"2275","ENSG00000100353","22",36510855,36529184,18329
"2276","ENSG00000100354","22",40044817,40335808,290991
"2277","ENSG00000100359","22",40370591,40410289,39698
"2278","ENSG00000100360","22",36758202,36776256,18054
"2279","ENSG00000100362","22",36800684,36819479,18795
"2280","ENSG00000100364","22",45190338,45240769,50431
"2281","ENSG00000100365","22",36860988,36878017,17029
"2282","ENSG00000100368","22",36913628,36940439,26811
"2283","ENSG00000100372","22",40769630,40819399,49769
"2284","ENSG00000100373","22",45284949,45295874,10925
"2285","ENSG00000100376","22",45308968,45341955,32987
"2286","ENSG00000100379","22",37051736,37063390,11654
"2287","ENSG00000100380","22",40824535,40856639,32104
"2288","ENSG00000100385","22",37125843,37175054,49211
"2289","ENSG00000100387","22",40951347,40973309,21962
"2290","ENSG00000100393","22",41092592,41180077,87485
"2291","ENSG00000100395","22",41205282,41231271,25989
"2292","ENSG00000100399","22",41229510,41240931,11421
"2293","ENSG00000100401","22",41245611,41286251,40640
"2294","ENSG00000100403","22",41301525,41360147,58622
"2295","ENSG00000100410","22",41459717,41468692,8975
"2296","ENSG00000100412","22",41469117,41528989,59872
"2297","ENSG00000100413","22",41525799,41544606,18807
"2298","ENSG00000100416","22",46330875,46357340,26465
"2299","ENSG00000100417","22",41576900,41589871,12971
"2300","ENSG00000100418","22",41598028,41621043,23015
"2301","ENSG00000100422","22",46684410,46738252,53842
"2302","ENSG00000100425","22",49773283,49827512,54229
"2303","ENSG00000100426","22",49853844,49890080,36236
"2304","ENSG00000100427","22",50059391,50085902,26511
"2305","ENSG00000100429","22",50245183,50251405,6222
"2306","ENSG00000100433","14",88180103,88326907,146804
"2307","ENSG00000100439","14",22598237,22613215,14978
"2308","ENSG00000100441","14",24429286,24441843,12557
"2309","ENSG00000100442","14",45115599,45135319,19720
"2310","ENSG00000100445","14",24439766,24442905,3139
"2311","ENSG00000100448","14",24573518,24576250,2732
"2312","ENSG00000100450","14",24606480,24609699,3219
"2313","ENSG00000100453","14",24630954,24634267,3313
"2314","ENSG00000100461","14",22893204,22919182,25978
"2315","ENSG00000100462","14",22920525,22929408,8883
"2316","ENSG00000100473","14",30874514,30895065,20551
"2317","ENSG00000100478","14",31025106,31096450,71344
"2318","ENSG00000100479","14",49643555,49688422,44867
"2319","ENSG00000100483","14",50108632,50116600,7968
"2320","ENSG00000100485","14",50117130,50231578,114448
"2321","ENSG00000100490","14",50329404,50416461,87057
"2322","ENSG00000100503","14",50719763,50831121,111358
"2323","ENSG00000100504","14",50857891,50944483,86592
"2324","ENSG00000100505","14",50975262,51096061,120799
"2325","ENSG00000100519","14",52707178,52728590,21412
"2326","ENSG00000100522","14",52775193,52791668,16475
"2327","ENSG00000100523","14",53036745,53153282,116537
"2328","ENSG00000100526","14",54396849,54420218,23369
"2329","ENSG00000100528","14",54423561,54441391,17830
"2330","ENSG00000100532","14",54509812,54539292,29480
"2331","ENSG00000100554","14",67294371,67360265,65894
"2332","ENSG00000100557","14",57469301,57493867,24566
"2333","ENSG00000100558","14",67386984,67412167,25183
"2334","ENSG00000100564","14",67581955,67600286,18331
"2335","ENSG00000100565","14",76826372,76870302,43930
"2336","ENSG00000100567","14",58244843,58272012,27169
"2337","ENSG00000100568","14",67647085,67674820,27735
"2338","ENSG00000100575","14",58408495,58427531,19036
"2339","ENSG00000100577","14",77320996,77331597,10601
"2340","ENSG00000100578","14",58427385,58551289,123904
"2341","ENSG00000100580","14",77335029,77377094,42065
"2342","ENSG00000100583","14",77376689,77391497,14808
"2343","ENSG00000100591","14",77457870,77469472,11602
"2344","ENSG00000100592","14",59188646,59371405,182759
"2345","ENSG00000100593","14",77474394,77498816,24422
"2346","ENSG00000100596","14",77505997,77616773,110776
"2347","ENSG00000100599","14",92513781,92688994,175213
"2348","ENSG00000100600","14",92703807,92748679,44872
"2349","ENSG00000100601","14",77672404,77708023,35619
"2350","ENSG00000100603","14",77717599,77761207,43608
"2351","ENSG00000100604","14",92923150,92935285,12135
"2352","ENSG00000100605","14",92936914,93116320,179406
"2353","ENSG00000100612","14",60144119,60169856,25737
"2354","ENSG00000100614","14",60245752,60299087,53335
"2355","ENSG00000100625","14",60709539,60724351,14812
"2356","ENSG00000100626","14",69259277,69357033,97756
"2357","ENSG00000100628","14",93934153,93976791,42638
"2358","ENSG00000100629","14",80476983,80959517,482534
"2359","ENSG00000100632","14",69380128,69398299,18171
"2360","ENSG00000100644","14",61695513,61748259,52746
"2361","ENSG00000100647","14",69611596,69715144,103548
"2362","ENSG00000100650","14",69726900,69772005,45105
"2363","ENSG00000100652","14",69775416,69797241,21825
"2364","ENSG00000100664","14",103333544,103345025,11481
"2365","ENSG00000100665","14",94561442,94569913,8471
"2366","ENSG00000100678","14",70044217,70189070,144853
"2367","ENSG00000100697","14",95086228,95158010,71782
"2368","ENSG00000100711","14",103715730,103733668,17938
"2369","ENSG00000100714","14",64388031,64463457,75426
"2370","ENSG00000100721","14",95709947,95714196,4249
"2371","ENSG00000100722","14",88562970,88627596,64626
"2372","ENSG00000100726","16",1493344,1510457,17113
"2373","ENSG00000100731","14",70907405,71115382,207977
"2374","ENSG00000100739","14",96256210,96268967,12757
"2375","ENSG00000100744","14",96363452,96387288,23836
"2376","ENSG00000100749","14",96797382,96931722,134340
"2377","ENSG00000100764","14",90256527,90275429,18902
"2378","ENSG00000100767","14",73237497,73274640,37143
"2379","ENSG00000100784","14",90847861,91060641,212780
"2380","ENSG00000100796","14",91457611,91510554,52943
"2381","ENSG00000100802","14",22985894,23010166,24272
"2382","ENSG00000100804","14",23016543,23035230,18687
"2383","ENSG00000100811","14",100238298,100282792,44494
"2384","ENSG00000100813","14",23058564,23095614,37050
"2385","ENSG00000100814","14",20311368,20333312,21944
"2386","ENSG00000100815","14",91965991,92040896,74905
"2387","ENSG00000100823","14",20455191,20457772,2581
"2388","ENSG00000100836","14",23321289,23326185,4896
"2389","ENSG00000100842","14",23356403,23365752,9349
"2390","ENSG00000100852","14",32076114,32159728,83614
"2391","ENSG00000100865","14",102341102,102362916,21814
"2392","ENSG00000100867","14",23630115,23645639,15524
"2393","ENSG00000100883","14",34981957,35029567,47610
"2394","ENSG00000100884","14",24070837,24078100,7263
"2395","ENSG00000100888","14",21385194,21456126,70932
"2396","ENSG00000100889","14",24094053,24110598,16545
"2397","ENSG00000100890","14",35121846,35277614,155768
"2398","ENSG00000100897","14",24114195,24125242,11047
"2399","ENSG00000100902","14",35278633,35317493,38860
"2400","ENSG00000100906","14",35401511,35404749,3238
"2401","ENSG00000100908","14",24138959,24141591,2632
"2402","ENSG00000100911","14",24143362,24147570,4208
"2403","ENSG00000100916","14",35826338,35932325,105987
"2404","ENSG00000100918","14",24171853,24180257,8404
"2405","ENSG00000100926","14",24189149,24195687,6538
"2406","ENSG00000100934","14",39031919,39109646,77727
"2407","ENSG00000100938","14",24232422,24239242,6820
"2408","ENSG00000100941","14",39175183,39183220,8037
"2409","ENSG00000100949","14",24265538,24271739,6201
"2410","ENSG00000100968","14",24365673,24379604,13931
"2411","ENSG00000100979","20",45898621,45912155,13534
"2412","ENSG00000100982","20",45934683,45948023,13340
"2413","ENSG00000100983","20",34928432,34956027,27595
"2414","ENSG00000100985","20",46008908,46016561,7653
"2415","ENSG00000100987","20",25070885,25082365,11480
"2416","ENSG00000100991","20",35002404,35092807,90403
"2417","ENSG00000100994","20",25248085,25298012,49927
"2418","ENSG00000100997","20",25294743,25390983,96240
"2419","ENSG00000101000","20",35172072,35216240,44168
"2420","ENSG00000101003","20",25407673,25452628,44955
"2421","ENSG00000101004","20",25452697,25585531,132834
"2422","ENSG00000101017","20",46118272,46129863,11591
"2423","ENSG00000101019","20",35302566,35412031,109465
"2424","ENSG00000101040","20",47209214,47356889,147675
"2425","ENSG00000101049","20",43558968,43588237,29269
"2426","ENSG00000101052","20",43590931,43647296,56365
"2427","ENSG00000101057","20",43667019,43716495,49476
"2428","ENSG00000101074","20",44336986,44351242,14256
"2429","ENSG00000101076","20",44355700,44434596,78896
"2430","ENSG00000101079","20",36651766,36746090,94324
"2431","ENSG00000101082","20",36612318,36646196,33878
"2432","ENSG00000101084","20",36605779,36612557,6778
"2433","ENSG00000101096","20",51386957,51562831,175874
"2434","ENSG00000101098","20",44751808,44810338,58530
"2435","ENSG00000101104","20",44910062,44959035,48973
"2436","ENSG00000101109","20",44966479,45080021,113542
"2437","ENSG00000101115","20",51782331,51802521,20190
"2438","ENSG00000101126","20",50888916,50931437,42521
"2439","ENSG00000101132","20",54208087,54228052,19965
"2440","ENSG00000101134","20",54475597,54651171,175574
"2441","ENSG00000101138","20",56392371,56406369,13998
"2442","ENSG00000101144","20",57168753,57266641,97888
"2443","ENSG00000101146","20",57351223,57379211,27988
"2444","ENSG00000101150","20",63865228,63891545,26317
"2445","ENSG00000101152","20",63895126,63936031,40905
"2446","ENSG00000101158","20",58981208,58995133,13925
"2447","ENSG00000101160","20",58995185,59007254,12069
"2448","ENSG00000101161","20",63981132,64033100,51968
"2449","ENSG00000101162","20",59019254,59026654,7400
"2450","ENSG00000101166","20",59033145,59042809,9664
"2451","ENSG00000101180","20",62214960,62220278,5318
"2452","ENSG00000101181","20",62183029,62203568,20539
"2453","ENSG00000101182","20",62136733,62143440,6707
"2454","ENSG00000101187","20",62642503,62685785,43282
"2455","ENSG00000101188","20",62708836,62762771,53935
"2456","ENSG00000101189","20",62796473,62801729,5256
"2457","ENSG00000101190","20",62841115,62861763,20648
"2458","ENSG00000101191","20",62877738,62937952,60214
"2459","ENSG00000101193","20",62938147,62948475,10328
"2460","ENSG00000101194","20",62952707,62969585,16878
"2461","ENSG00000101197","20",63235883,63240495,4612
"2462","ENSG00000101198","20",63240784,63272694,31910
"2463","ENSG00000101199","20",63272785,63289790,17005
"2464","ENSG00000101200","20",3082556,3084724,2168
"2465","ENSG00000101203","20",63293186,63334851,41665
"2466","ENSG00000101204","20",63343223,63378401,35178
"2467","ENSG00000101210","20",63488014,63499185,11171
"2468","ENSG00000101213","20",63528001,63537376,9375
"2469","ENSG00000101216","20",63587602,63627101,39499
"2470","ENSG00000101220","20",3753508,3768387,14879
"2471","ENSG00000101222","20",3777504,3781448,3944
"2472","ENSG00000101224","20",3786772,3806121,19349
"2473","ENSG00000101230","20",13221274,13300651,79377
"2474","ENSG00000101236","20",3927309,4015558,88249
"2475","ENSG00000101246","20",63698642,63708025,9383
"2476","ENSG00000101247","20",13785007,13821580,36573
"2477","ENSG00000101251","20",13849247,13996443,147196
"2478","ENSG00000101255","20",362835,397559,34724
"2479","ENSG00000101265","20",4780023,4823608,43585
"2480","ENSG00000101266","20",472498,543835,71337
"2481","ENSG00000101276","20",760080,776015,15935
"2482","ENSG00000101278","20",839447,839977,530
"2483","ENSG00000101280","20",869900,916334,46434
"2484","ENSG00000101282","20",958452,1002311,43859
"2485","ENSG00000101290","20",5126879,5197887,71008
"2486","ENSG00000101292","20",5302040,5314369,12329
"2487","ENSG00000101294","20",31514410,31577923,63513
"2488","ENSG00000101298","20",1266280,1309328,43048
"2489","ENSG00000101306","20",31819308,31834689,15381
"2490","ENSG00000101307","20",1563521,1620061,56540
"2491","ENSG00000101310","20",18507520,18561415,53895
"2492","ENSG00000101311","20",6074845,6123544,48699
"2493","ENSG00000101323","20",7882985,7940458,57473
"2494","ENSG00000101327","20",1978757,1994285,15528
"2495","ENSG00000101331","20",32010450,32032180,21730
"2496","ENSG00000101333","20",9068763,9481242,412479
"2497","ENSG00000101335","20",36541497,36551447,9950
"2498","ENSG00000101336","20",32052188,32101856,49668
"2499","ENSG00000101337","20",32109506,32167258,57752
"2500","ENSG00000101342","20",36876121,36894235,18114
"2501","ENSG00000101343","20",20034368,20056046,21678
"2502","ENSG00000101346","20",32207880,32238658,30778
"2503","ENSG00000101347","20",36889773,36951901,62128
"2504","ENSG00000101349","20",9537389,9839041,301652
"2505","ENSG00000101350","20",32277651,32335011,57360
"2506","ENSG00000101353","20",37101226,37179588,78362
"2507","ENSG00000101361","20",2652593,2658393,5800
"2508","ENSG00000101363","20",37289638,37317260,27622
"2509","ENSG00000101365","20",2658395,2664219,5824
"2510","ENSG00000101367","20",32819954,32850405,30451
"2511","ENSG00000101384","20",10637684,10673999,36315
"2512","ENSG00000101391","20",33358839,33401561,42722
"2513","ENSG00000101400","20",33407955,33443892,35937
"2514","ENSG00000101405","20",3071620,3072517,897
"2515","ENSG00000101407","20",37983007,38033461,50454
"2516","ENSG00000101412","20",33675477,33686385,10908
"2517","ENSG00000101413","20",38033546,38127780,94234
"2518","ENSG00000101417","20",33702758,33720319,17561
"2519","ENSG00000101421","20",33811348,33854366,43018
"2520","ENSG00000101425","20",38304123,38337505,33382
"2521","ENSG00000101435","20",23564732,23568484,3752
"2522","ENSG00000101438","20",38724486,38729372,4886
"2523","ENSG00000101439","20",23626706,23638473,11767
"2524","ENSG00000101440","20",34194569,34269344,74775
"2525","ENSG00000101441","20",23685640,23689040,3400
"2526","ENSG00000101442","20",38748460,38772520,24060
"2527","ENSG00000101443","20",45469753,45481532,11779
"2528","ENSG00000101444","20",34280268,34311802,31534
"2529","ENSG00000101445","20",38805697,38923024,117327
"2530","ENSG00000101446","20",45512461,45515624,3163
"2531","ENSG00000101447","20",38926312,38953106,26794
"2532","ENSG00000101448","20",45540626,45547752,7126
"2533","ENSG00000101452","20",38962299,39039723,77424
"2534","ENSG00000101457","20",45791954,45811427,19473
"2535","ENSG00000101460","20",34546854,34560345,13491
"2536","ENSG00000101463","20",24469629,24666616,196987
"2537","ENSG00000101464","20",34560542,34698790,138248
"2538","ENSG00000101470","20",45823214,45833745,10531
"2539","ENSG00000101473","20",45841721,45857405,15684
"2540","ENSG00000101474","20",24962925,24992751,29826
"2541","ENSG00000101489","18",37243040,37565827,322787
"2542","ENSG00000101493","18",76357682,76495242,137560
"2543","ENSG00000101542","18",61333430,61555779,222349
"2544","ENSG00000101544","18",80109262,80147523,38261
"2545","ENSG00000101546","18",80034389,80050651,16262
"2546","ENSG00000101557","18",158383,214629,56246
"2547","ENSG00000101558","18",9914002,9960021,46019
"2548","ENSG00000101574","18",2537525,2571509,33984
"2549","ENSG00000101577","18",2916994,3013315,96321
"2550","ENSG00000101596","18",2655738,2805017,149279
"2551","ENSG00000101605","18",3066807,3220108,153301
"2552","ENSG00000101608","18",3247481,3256236,8755
"2553","ENSG00000101624","18",12661833,12702777,40944
"2554","ENSG00000101638","18",46667821,46759257,91436
"2555","ENSG00000101639","18",12991362,13125052,133690
"2556","ENSG00000101654","18",13726660,13764558,37898
"2557","ENSG00000101665","18",48919853,48952052,32199
"2558","ENSG00000101670","18",49560699,49599185,38486
"2559","ENSG00000101680","18",6941742,7117797,176055
"2560","ENSG00000101695","18",32018825,32073219,54394
"2561","ENSG00000101745","18",9136228,9285985,149757
"2562","ENSG00000101746","18",33851100,34224952,373852
"2563","ENSG00000101751","18",54269404,54321266,51862
"2564","ENSG00000101752","18",21704957,21870957,166000
"2565","ENSG00000101773","18",22798261,23026488,228227
"2566","ENSG00000101782","18",23453287,23486603,33316
"2567","ENSG00000101811","X",100820359,100840932,20573
"2568","ENSG00000101812","X",104039949,104042454,2505
"2569","ENSG00000101825","X",3308565,3346652,38087
"2570","ENSG00000101842","X",108044970,108079184,34214
"2571","ENSG00000101843","X",108084207,108091549,7342
"2572","ENSG00000101844","X",108091668,108154671,63003
"2573","ENSG00000101846","X",7147237,7804358,657121
"2574","ENSG00000101849","X",9463295,9741037,277742
"2575","ENSG00000101850","X",9725346,9786297,60951
"2576","ENSG00000101856","X",119236245,119244466,8221
"2577","ENSG00000101868","X",24693919,24996986,303067
"2578","ENSG00000101871","X",10445310,10833654,388344
"2579","ENSG00000101882","X",119920672,119943751,23079
"2580","ENSG00000101883","X",120109053,120115937,6884
"2581","ENSG00000101888","X",109535781,109544690,8909
"2582","ENSG00000101890","X",109372906,109482072,109166
"2583","ENSG00000101892","X",120362085,120383249,21164
"2584","ENSG00000101898","20",31547412,31548081,669
"2585","ENSG00000101901","X",111665811,111760649,94838
"2586","ENSG00000101911","X",12791355,12824222,32867
"2587","ENSG00000101916","X",12906620,12923169,16549
"2588","ENSG00000101928","X",134887632,134915257,27625
"2589","ENSG00000101935","X",110194186,110440233,246047
"2590","ENSG00000101938","X",110673856,110795819,121963
"2591","ENSG00000101940","X",48590042,48608869,18827
"2592","ENSG00000101945","X",48695554,48709012,13458
"2593","ENSG00000101951","X",49829260,49833973,4713
"2594","ENSG00000101955","X",38149336,38220924,71588
"2595","ENSG00000101958","X",14529298,14731812,202514
"2596","ENSG00000101966","X",123859724,123913979,54255
"2597","ENSG00000101972","X",123960212,124422664,462452
"2598","ENSG00000101974","X",139726346,139945276,218930
"2599","ENSG00000101977","X",139581770,139708227,126457
"2600","ENSG00000101981","X",139530758,139563458,32700
"2601","ENSG00000101986","X",153724856,153744755,19899
"2602","ENSG00000101997","X",49235470,49250520,15050
"2603","ENSG00000102001","X",49205063,49233371,28308
"2604","ENSG00000102003","X",49187804,49200259,12455
"2605","ENSG00000102007","X",49171898,49175235,3337
"2606","ENSG00000102010","X",15464246,15556529,92283
"2607","ENSG00000102021","X",115289715,115307563,17848
"2608","ENSG00000102024","X",115561174,115650861,89687
"2609","ENSG00000102030","X",153929225,153935080,5855
"2610","ENSG00000102032","X",153935269,153944687,9418
"2611","ENSG00000102034","X",130064874,130110716,45842
"2612","ENSG00000102038","X",129446501,129523500,76999
"2613","ENSG00000102043","X",64268081,64395452,127371
"2614","ENSG00000102048","X",15235288,15270467,35179
"2615","ENSG00000102053","X",65366638,65507887,141249
"2616","ENSG00000102054","X",16839283,16870414,31131
"2617","ENSG00000102055","X",42777368,42778247,879
"2618","ENSG00000102057","X",48961378,48971844,10466
"2619","ENSG00000102078","X",130339888,130373361,33473
"2620","ENSG00000102081","X",147911951,147951125,39174
"2621","ENSG00000102096","X",48913182,48919024,5842
"2622","ENSG00000102098","X",18239313,18354688,115375
"2623","ENSG00000102100","X",48903180,48911958,8778
"2624","ENSG00000102103","X",48890197,48903143,12946
"2625","ENSG00000102104","X",18639910,18672109,32199
"2626","ENSG00000102109","X",48831096,48835610,4514
"2627","ENSG00000102119","X",154379197,154381523,2326
"2628","ENSG00000102125","X",154411524,154421726,10202
"2629","ENSG00000102128","X",102937272,102938300,1028
"2630","ENSG00000102144","X",77910739,78129295,218556
"2631","ENSG00000102145","X",48786554,48794311,7757
"2632","ENSG00000102158","X",77826364,77895593,69229
"2633","ENSG00000102172","X",21940709,21994837,54128
"2634","ENSG00000102174","X",22032325,22251310,218985
"2635","ENSG00000102178","X",154483717,154486615,2898
"2636","ENSG00000102181","X",150766336,150898816,132480
"2637","ENSG00000102189","12",92770637,92929331,158694
"2638","ENSG00000102195","X",151176653,151181465,4812
"2639","ENSG00000102218","X",46837043,46882358,45315
"2640","ENSG00000102221","X",46912276,47061242,148966
"2641","ENSG00000102225","X",47217860,47229997,12137
"2642","ENSG00000102226","X",47232690,47248328,15638
"2643","ENSG00000102230","X",24558087,24672677,114590
"2644","ENSG00000102239","X",136487947,136493780,5833
"2645","ENSG00000102241","X",136497079,136512346,15267
"2646","ENSG00000102243","X",136532215,136556807,24592
"2647","ENSG00000102245","X",136648193,136660390,12197
"2648","ENSG00000102265","X",47582408,47586789,4381
"2649","ENSG00000102271","X",87517409,87670050,152641
"2650","ENSG00000102287","X",151953124,151974680,21556
"2651","ENSG00000102290","X",91779261,92623230,843969
"2652","ENSG00000102302","X",54445454,54496234,50780
"2653","ENSG00000102309","X",72181353,72302926,121573
"2654","ENSG00000102312","X",48508962,48520814,11852
"2655","ENSG00000102313","X",54748899,54798240,49341
"2656","ENSG00000102316","X",54807599,54816015,8416
"2657","ENSG00000102317","X",48574449,48581162,6713
"2658","ENSG00000102349","X",56232356,56291531,59175
"2659","ENSG00000102359","X",100644195,100675788,31593
"2660","ENSG00000102362","X",100674491,100732123,57632
"2661","ENSG00000102383","X",75368427,75523502,155075
"2662","ENSG00000102384","X",101098218,101163681,65463
"2663","ENSG00000102385","X",101219769,101264497,44728
"2664","ENSG00000102387","X",101268253,101293057,24804
"2665","ENSG00000102390","X",76172936,76178204,5268
"2666","ENSG00000102393","X",101397803,101408012,10209
"2667","ENSG00000102401","X",101622797,101627843,5046
"2668","ENSG00000102409","X",103215108,103217246,2138
"2669","ENSG00000102445","13",46342000,46438190,96190
"2670","ENSG00000102452","13",101053776,101416508,362732
"2671","ENSG00000102466","13",101710804,102402457,691653
"2672","ENSG00000102468","13",46831550,46897076,65526
"2673","ENSG00000102471","13",79481124,79556075,74951
"2674","ENSG00000102524","13",108251240,108308484,57244
"2675","ENSG00000102531","13",48975912,49209779,233867
"2676","ENSG00000102539","13",49220338,49222377,2039
"2677","ENSG00000102543","13",49247925,49293485,45560
"2678","ENSG00000102547","13",49308650,49444064,135414
"2679","ENSG00000102554","13",73054976,73077541,22565
"2680","ENSG00000102572","13",98445185,98577940,132755
"2681","ENSG00000102575","19",11574660,11579008,4348
"2682","ENSG00000102580","13",95677139,95794988,117849
"2683","ENSG00000102595","13",95801580,96053482,251902
"2684","ENSG00000102606","13",111114559,111305737,191178
"2685","ENSG00000102678","13",21671383,21704498,33115
"2686","ENSG00000102683","13",23180952,23325165,144213
"2687","ENSG00000102699","13",24420931,24512778,91847
"2688","ENSG00000102710","13",37009312,37059713,50401
"2689","ENSG00000102738","13",40729135,40771173,42038
"2690","ENSG00000102743","13",40789412,40812460,23048
"2691","ENSG00000102753","13",49699320,49792682,93362
"2692","ENSG00000102755","13",28300346,28495145,194799
"2693","ENSG00000102760","13",41457550,41470871,13321
"2694","ENSG00000102763","13",41566835,41961120,394285
"2695","ENSG00000102780","13",42040036,42256578,216542
"2696","ENSG00000102781","13",30202630,30307551,104921
"2697","ENSG00000102786","13",51354077,51454264,100187
"2698","ENSG00000102794","13",76948497,76958642,10145
"2699","ENSG00000102796","13",51767993,51804162,36169
"2700","ENSG00000102802","13",30906271,30925572,19301
"2701","ENSG00000102804","13",44432143,44577147,145004
"2702","ENSG00000102805","13",76990660,77019143,28483
"2703","ENSG00000102837","13",53028813,53052057,23244
"2704","ENSG00000102854","16",760734,768865,8131
"2705","ENSG00000102858","16",4616493,4690974,74481
"2706","ENSG00000102870","16",30778456,30787205,8749
"2707","ENSG00000102871","16",67154185,67159909,5724
"2708","ENSG00000102878","16",67164681,67169945,5264
"2709","ENSG00000102879","16",30182827,30189076,6249
"2710","ENSG00000102882","16",30114105,30123506,9401
"2711","ENSG00000102886","16",30104810,30113537,8727
"2712","ENSG00000102890","16",67199111,67204029,4918
"2713","ENSG00000102891","16",56565049,56568957,3908
"2714","ENSG00000102893","16",47461123,47701523,240400
"2715","ENSG00000102897","16",20899868,20925006,25138
"2716","ENSG00000102898","16",67846923,67872567,25644
"2717","ENSG00000102900","16",56730118,56850286,120168
"2718","ENSG00000102901","16",67828157,67847811,19654
"2719","ENSG00000102904","16",67806765,67832148,25383
"2720","ENSG00000102908","16",69565094,69704666,139572
"2721","ENSG00000102910","16",48244296,48363122,118826
"2722","ENSG00000102921","16",48538726,48620148,81422
"2723","ENSG00000102924","16",49277917,49281838,3921
"2724","ENSG00000102931","16",57245259,57253635,8376
"2725","ENSG00000102934","16",57248547,57284672,36125
"2726","ENSG00000102935","16",49487524,49857919,370395
"2727","ENSG00000102962","16",57358783,57366189,7406
"2728","ENSG00000102967","16",72008588,72027664,19076
"2729","ENSG00000102970","16",57404767,57416062,11295
"2730","ENSG00000102974","16",67562467,67639177,76710
"2731","ENSG00000102977","16",67657512,67660815,3303
"2732","ENSG00000102978","16",57462660,57472009,9349
"2733","ENSG00000102981","16",67660946,67662778,1832
"2734","ENSG00000102984","16",71859680,71895336,35656
"2735","ENSG00000102996","16",58025754,58046901,21147
"2736","ENSG00000103005","16",57999546,58021618,22072
"2737","ENSG00000103018","16",69424525,69466266,41741
"2738","ENSG00000103021","16",58231157,58283836,52679
"2739","ENSG00000103023","16",58279997,58295047,15050
"2740","ENSG00000103024","16",1770286,1771730,1444
"2741","ENSG00000103034","16",58462846,58513628,50782
"2742","ENSG00000103035","16",74296814,74306288,9474
"2743","ENSG00000103037","16",58515479,58521181,5702
"2744","ENSG00000103042","16",58665109,58684770,19661
"2745","ENSG00000103043","16",70687439,70801160,113721
"2746","ENSG00000103044","16",69105653,69118719,13066
"2747","ENSG00000103047","16",68843531,69085182,241651
"2748","ENSG00000103051","16",70480568,70523558,42990
"2749","ENSG00000103056","16",68358327,68448508,90181
"2750","ENSG00000103061","16",68284503,68310946,26443
"2751","ENSG00000103064","16",68264516,68301823,37307
"2752","ENSG00000103066","16",68245304,68261058,15754
"2753","ENSG00000103067","16",68229111,68238102,8991
"2754","ENSG00000103089","16",74712955,74774831,61876
"2755","ENSG00000103091","16",74871362,75000173,128811
"2756","ENSG00000103111","16",77190835,77202405,11570
"2757","ENSG00000103121","16",80966448,81020270,53822
"2758","ENSG00000103126","16",287440,352723,65283
"2759","ENSG00000103145","16",3022620,3024286,1666
"2760","ENSG00000103148","16",84271,138860,54589
"2761","ENSG00000103150","16",83899115,83927031,27916
"2762","ENSG00000103152","16",77007,85853,8846
"2763","ENSG00000103154","16",83968632,84002776,34144
"2764","ENSG00000103160","16",84122141,84145192,23051
"2765","ENSG00000103168","16",84177847,84187070,9223
"2766","ENSG00000103174","16",5024844,5034141,9297
"2767","ENSG00000103175","16",84294846,84329844,34998
"2768","ENSG00000103184","16",4958330,5019157,60827
"2769","ENSG00000103187","16",84565596,84618078,52482
"2770","ENSG00000103194","16",84699978,84779922,79944
"2771","ENSG00000103196","16",84819985,84920768,100783
"2772","ENSG00000103197","16",2047967,2089491,41524
"2773","ENSG00000103199","16",4748239,4767624,19385
"2774","ENSG00000103200","7",140435316,140435787,471
"2775","ENSG00000103202","16",396725,410367,13642
"2776","ENSG00000103222","16",15949577,16143074,193497
"2777","ENSG00000103226","16",16232528,16294811,62283
"2778","ENSG00000103227","16",853634,981318,127684
"2779","ENSG00000103241","16",86510527,86515422,4895
"2780","ENSG00000103245","16",729760,741329,11569
"2781","ENSG00000103248","16",86530176,86555235,25059
"2782","ENSG00000103249","16",1444934,1475084,30150
"2783","ENSG00000103253","16",726936,735525,8589
"2784","ENSG00000103254","16",720581,722590,2009
"2785","ENSG00000103257","16",87830023,87869507,39484
"2786","ENSG00000103260","16",715118,719655,4537
"2787","ENSG00000103264","16",87326987,87392142,65155
"2788","ENSG00000103266","16",680224,682870,2646
"2789","ENSG00000103269","16",675666,678268,2602
"2790","ENSG00000103274","16",10743786,10769351,25565
"2791","ENSG00000103275","16",1308880,1327018,18138
"2792","ENSG00000103310","16",21197450,21214510,17060
"2793","ENSG00000103313","16",3242028,3256627,14599
"2794","ENSG00000103316","16",21238874,21303083,64209
"2795","ENSG00000103319","16",22206278,22288738,82460
"2796","ENSG00000103326","16",527712,554636,26924
"2797","ENSG00000103335","16",88715338,88785220,69882
"2798","ENSG00000103342","16",11868128,11916082,47954
"2799","ENSG00000103343","16",3401215,3409364,8149
"2800","ENSG00000103351","16",3500976,3539048,38072
"2801","ENSG00000103353","16",23557721,23574389,16668
"2802","ENSG00000103355","16",2783953,2787948,3995
"2803","ENSG00000103356","16",23522014,23557731,35717
"2804","ENSG00000103363","16",2771414,2777297,5883
"2805","ENSG00000103365","16",23463542,23521995,58453
"2806","ENSG00000103375","16",25215731,25228932,13201
"2807","ENSG00000103381","16",12659799,12803887,144088
"2808","ENSG00000103404","16",23061406,23149270,87864
"2809","ENSG00000103415","16",4474690,4510347,35657
"2810","ENSG00000103423","16",4425805,4456775,30970
"2811","ENSG00000103426","16",4340251,4420494,80243
"2812","ENSG00000103429","16",14632931,14669236,36305
"2813","ENSG00000103449","16",51135975,51151367,15392
"2814","ENSG00000103460","16",52436417,52547802,111385
"2815","ENSG00000103472","16",29074976,29116718,41742
"2816","ENSG00000103479","16",53433977,53491648,57671
"2817","ENSG00000103485","16",29663279,29698699,35420
"2818","ENSG00000103489","16",17101769,17470881,369112
"2819","ENSG00000103490","16",31201486,31203450,1964
"2820","ENSG00000103494","16",53598153,53703938,105785
"2821","ENSG00000103495","16",29806106,29811164,5058
"2822","ENSG00000103496","16",31032889,31042975,10086
"2823","ENSG00000103502","16",29858357,29863414,5057
"2824","ENSG00000103507","16",31106107,31112791,6684
"2825","ENSG00000103510","16",31114489,31131393,16904
"2826","ENSG00000103512","16",14833721,14896157,62436
"2827","ENSG00000103522","16",27402174,27452042,49868
"2828","ENSG00000103528","16",19167971,19268332,100361
"2829","ENSG00000103534","16",19410496,19499113,88617
"2830","ENSG00000103540","16",19523811,19553408,29597
"2831","ENSG00000103544","16",19555240,19706793,151553
"2832","ENSG00000103546","16",55655604,55706192,50588
"2833","ENSG00000103549","16",30761745,30776307,14562
"2834","ENSG00000103550","16",19701937,19718235,16298
"2835","ENSG00000103569","15",58138169,58185911,47742
"2836","ENSG00000103591","15",67201033,67255195,54162
"2837","ENSG00000103599","15",67254786,67502260,247474
"2838","ENSG00000103642","15",63121833,63142061,20228
"2839","ENSG00000103647","15",68578969,68727806,148837
"2840","ENSG00000103653","15",74782057,74803198,21141
"2841","ENSG00000103657","15",63608618,63833948,225330
"2842","ENSG00000103671","15",64387748,64455303,67555
"2843","ENSG00000103707","15",65001512,65029639,28127
"2844","ENSG00000103710","15",65053337,65076690,23353
"2845","ENSG00000103723","15",82659280,82710156,50876
"2846","ENSG00000103740","15",78167468,78245688,78220
"2847","ENSG00000103742","15",65381484,65422947,41463
"2848","ENSG00000103769","15",65726054,65891989,165935
"2849","ENSG00000103811","15",78921058,78949574,28516
"2850","ENSG00000103832","15",30791573,30801859,10286
"2851","ENSG00000103852","15",99136323,99251223,114900
"2852","ENSG00000103855","15",73683966,73714514,30548
"2853","ENSG00000103876","15",80152490,80186946,34456
"2854","ENSG00000103888","15",80779343,80951776,172433
"2855","ENSG00000103932","15",41517176,41544269,27093
"2856","ENSG00000103942","15",82836946,82986153,149207
"2857","ENSG00000103966","15",41895933,41972557,76624
"2858","ENSG00000103978","15",42210452,42273663,63211
"2859","ENSG00000103994","15",42412823,42491141,78318
"2860","ENSG00000103995","15",48712928,48811146,98218
"2861","ENSG00000104043","15",49858238,50182817,324579
"2862","ENSG00000104044","15",27754875,28099315,344440
"2863","ENSG00000104047","15",49621037,49656232,35195
"2864","ENSG00000104055","15",43232595,43266857,34262
"2865","ENSG00000104059","15",29120254,29570723,450469
"2866","ENSG00000104064","15",50275392,50355408,80016
"2867","ENSG00000104067","15",29699367,29968865,269498
"2868","ENSG00000104081","15",40087890,40108892,21002
"2869","ENSG00000104093","15",51447711,51622833,175122
"2870","ENSG00000104112","15",51681492,51721026,39534
"2871","ENSG00000104129","15",40765161,40807478,42317
"2872","ENSG00000104131","15",44537125,44563029,25904
"2873","ENSG00000104133","15",44562696,44663678,100982
"2874","ENSG00000104140","15",40872214,40874234,2020
"2875","ENSG00000104142","15",40894450,40903975,9525
"2876","ENSG00000104147","15",41309273,41332591,23318
"2877","ENSG00000104154","15",45479606,45522755,43149
"2878","ENSG00000104164","15",45587123,45615999,28876
"2879","ENSG00000104177","15",48134632,48178353,43721
"2880","ENSG00000104205","8",66667552,66862022,194470
"2881","ENSG00000104213","8",17576433,17644071,67638
"2882","ENSG00000104218","8",67062426,67196263,133837
"2883","ENSG00000104219","8",17156482,17224799,68317
"2884","ENSG00000104221","8",37843268,37849904,6636
"2885","ENSG00000104228","8",27284886,27311272,26386
"2886","ENSG00000104231","8",81701334,81732903,31569
"2887","ENSG00000104237","8",54509422,54871720,362298
"2888","ENSG00000104267","8",85463968,85481493,17525
"2889","ENSG00000104290","8",28494205,28574267,80062
"2890","ENSG00000104299","8",28767661,28890242,122581
"2891","ENSG00000104312","8",89757806,89791064,33258
"2892","ENSG00000104313","8",71197433,71592025,394592
"2893","ENSG00000104320","8",89933336,90003228,69892
"2894","ENSG00000104321","8",72019917,72075584,55667
"2895","ENSG00000104324","8",96645242,97149654,504412
"2896","ENSG00000104325","8",90001405,90053633,52228
"2897","ENSG00000104327","8",90058608,90095475,36867
"2898","ENSG00000104331","8",56957931,56993867,35936
"2899","ENSG00000104332","8",41261962,41309473,47511
"2900","ENSG00000104341","8",97775057,97853013,77956
"2901","ENSG00000104343","8",73780097,73878910,98813
"2902","ENSG00000104356","8",98117293,98159835,42542
"2903","ENSG00000104361","8",98189826,98294393,104567
"2904","ENSG00000104365","8",42271302,42332653,61351
"2905","ENSG00000104368","8",42175233,42207724,32491
"2906","ENSG00000104369","8",74234700,74321540,86840
"2907","ENSG00000104371","8",42374063,42377229,3166
"2908","ENSG00000104375","8",98371228,98942827,571599
"2909","ENSG00000104381","8",74321130,74488872,167742
"2910","ENSG00000104388","8",60516936,60623644,106708
"2911","ENSG00000104408","8",108201216,108435333,234117
"2912","ENSG00000104412","8",108443601,108489196,45595
"2913","ENSG00000104413","8",94641074,94707466,66392
"2914","ENSG00000104415","8",133191039,133231690,40651
"2915","ENSG00000104419","8",133237171,133302022,64851
"2916","ENSG00000104427","8",78666089,78719765,53676
"2917","ENSG00000104432","8",78675743,78805523,129780
"2918","ENSG00000104435","8",79610814,79666175,55361
"2919","ENSG00000104442","8",65602458,65634217,31759
"2920","ENSG00000104447","8",115408496,115809673,401177
"2921","ENSG00000104450","8",100157906,100259278,101372
"2922","ENSG00000104472","8",140511311,140517154,5843
"2923","ENSG00000104490","8",101686542,102124907,438365
"2924","ENSG00000104497","8",81799581,81842866,43285
"2925","ENSG00000104499","8",142834247,142916506,82259
"2926","ENSG00000104517","8",102252273,102412759,160486
"2927","ENSG00000104518","8",143553207,143563062,9855
"2928","ENSG00000104522","8",143612618,143618048,5430
"2929","ENSG00000104524","8",143603210,143609773,6563
"2930","ENSG00000104529","8",143579697,143599541,19844
"2931","ENSG00000104537","8",123680794,123737402,56608
"2932","ENSG00000104549","8",124998497,125022283,23786
"2933","ENSG00000104611","8",19313693,19396218,82525
"2934","ENSG00000104613","8",19817391,19852083,34692
"2935","ENSG00000104626","8",9002147,9116746,114599
"2936","ENSG00000104635","8",22367249,22434129,66880
"2937","ENSG00000104643","8",11284816,11328146,43330
"2938","ENSG00000104660","8",30095398,30177208,81810
"2939","ENSG00000104671","8",30156319,30183639,27320
"2940","ENSG00000104679","8",23270120,23296279,26159
"2941","ENSG00000104687","8",30678066,30727846,49780
"2942","ENSG00000104689","8",23190452,23225126,34674
"2943","ENSG00000104691","8",30732247,30767006,34759
"2944","ENSG00000104695","8",30774457,30814314,39857
"2945","ENSG00000104714","8",614746,738106,123360
"2946","ENSG00000104722","8",24913758,24919098,5340
"2947","ENSG00000104723","8",15417215,15766649,349434
"2948","ENSG00000104728","8",1823926,1958641,134715
"2949","ENSG00000104731","16",87696485,87765992,69507
"2950","ENSG00000104738","8",47960185,47978160,17975
"2951","ENSG00000104755","8",39743735,39838289,94554
"2952","ENSG00000104756","8",25427847,25458476,30629
"2953","ENSG00000104760","8",17864380,17910365,45985
"2954","ENSG00000104763","8",18055992,18084998,29006
"2955","ENSG00000104765","8",26383054,26505636,122582
"2956","ENSG00000104774","19",12646511,12666742,20231
"2957","ENSG00000104783","19",43766533,43781257,14724
"2958","ENSG00000104804","19",48880965,48898733,17768
"2959","ENSG00000104805","19",48900312,48923372,23060
"2960","ENSG00000104808","19",48933699,48944969,11270
"2961","ENSG00000104812","19",48968130,48993310,25180
"2962","ENSG00000104814","19",38587641,38618882,31241
"2963","ENSG00000104818","19",49031912,49033238,1326
"2964","ENSG00000104823","19",38815422,38831841,16419
"2965","ENSG00000104824","19",38836388,38852347,15959
"2966","ENSG00000104825","19",38899700,38908893,9193
"2967","ENSG00000104826","19",49015980,49017090,1110
"2968","ENSG00000104827","19",49022869,49024333,1464
"2969","ENSG00000104833","19",6494319,6502848,8529
"2970","ENSG00000104835","19",38915266,38930896,15630
"2971","ENSG00000104848","19",49067418,49072941,5523
"2972","ENSG00000104852","19",49085419,49108605,23186
"2973","ENSG00000104853","19",44954585,44993341,38756
"2974","ENSG00000104856","19",45001449,45038198,36749
"2975","ENSG00000104859","19",45039045,45070956,31911
"2976","ENSG00000104863","19",49114324,49118460,4136
"2977","ENSG00000104866","19",45091396,45148077,56681
"2978","ENSG00000104870","19",49506816,49526333,19517
"2979","ENSG00000104872","19",49446298,49453497,7199
"2980","ENSG00000104879","19",45306413,45322875,16462
"2981","ENSG00000104880","19",7395113,7472484,77371
"2982","ENSG00000104881","19",45379638,45406349,26711
"2983","ENSG00000104883","19",7476875,7497449,20574
"2984","ENSG00000104884","19",45349837,45370918,21081
"2985","ENSG00000104885","19",2163933,2232578,68645
"2986","ENSG00000104886","19",2230084,2237704,7620
"2987","ENSG00000104888","19",49429401,49442360,12959
"2988","ENSG00000104889","19",12806556,12815201,8645
"2989","ENSG00000104892","19",45333434,45351520,18086
"2990","ENSG00000104894","19",49335171,49343335,8164
"2991","ENSG00000104897","19",2236824,2248655,11831
"2992","ENSG00000104899","19",2249309,2252073,2764
"2993","ENSG00000104901","19",49361783,49375116,13333
"2994","ENSG00000104903","19",13099033,13103161,4128
"2995","ENSG00000104904","19",2269509,2273490,3981
"2996","ENSG00000104907","19",13104902,13117567,12665
"2997","ENSG00000104915","19",13144058,13150383,6325
"2998","ENSG00000104918","19",7669049,7670455,1406
"2999","ENSG00000104921","19",7688758,7702146,13388
"3000","ENSG00000104936","19",45769717,45782552,12835
"3001","ENSG00000104938","19",7763149,7769605,6456
"3002","ENSG00000104941","19",45795713,45815308,19595
"3003","ENSG00000104946","19",49877425,49888750,11325
"3004","ENSG00000104951","19",49889654,49929539,39885
"3005","ENSG00000104953","19",2977538,2995179,17641
"3006","ENSG00000104957","19",13731760,13763296,31536
"3007","ENSG00000104960","19",49850735,49860744,10009
"3008","ENSG00000104964","19",3052910,3063107,10197
"3009","ENSG00000104967","19",45933734,45973865,40131
"3010","ENSG00000104969","19",2754715,2783282,28567
"3011","ENSG00000104970","19",54532692,54545771,13079
"3012","ENSG00000104972","19",54617158,54637528,20370
"3013","ENSG00000104973","19",49818279,49840383,22104
"3014","ENSG00000104974","19",54593582,54602090,8508
"3015","ENSG00000104976","19",7920338,7923250,2912
"3016","ENSG00000104979","19",13774456,13778773,4317
"3017","ENSG00000104980","19",7926718,7943667,16949
"3018","ENSG00000104983","19",45995461,46021318,25857
"3019","ENSG00000104998","19",14031762,14053218,21456
"3020","ENSG00000105011","19",14119512,14136613,17101
"3021","ENSG00000105048","19",55132698,55149206,16508
"3022","ENSG00000105053","19",49976468,50025946,49478
"3023","ENSG00000105058","19",16185380,16192046,6666
"3024","ENSG00000105063","19",55229779,55259017,29238
"3025","ENSG00000105072","19",16496394,16521352,24958
"3026","ENSG00000105085","19",16574907,16629062,54155
"3027","ENSG00000105088","19",9853718,9936552,82834
"3028","ENSG00000105122","19",15451624,15464544,12920
"3029","ENSG00000105127","19",15353385,15379798,26413
"3030","ENSG00000105131","19",15226919,15233435,6516
"3031","ENSG00000105135","19",15114984,15125786,10802
"3032","ENSG00000105136","19",57487711,57496097,8386
"3033","ENSG00000105137","19",15107401,15114985,7584
"3034","ENSG00000105141","19",15049480,15058293,8813
"3035","ENSG00000105143","19",14950034,15022990,72956
"3036","ENSG00000105146","19",57230802,57235548,4746
"3037","ENSG00000105171","19",29606283,29617237,10954
"3038","ENSG00000105173","19",29811991,29824312,12321
"3039","ENSG00000105176","19",29923644,30016612,92968
"3040","ENSG00000105185","19",32581190,32587453,6263
"3041","ENSG00000105186","19",32597006,32676597,79591
"3042","ENSG00000105193","19",39433137,39435949,2812
"3043","ENSG00000105197","19",39480412,39493785,13373
"3044","ENSG00000105198","19",39602501,39607474,4973
"3045","ENSG00000105202","19",39834458,39846379,11921
"3046","ENSG00000105204","19",39825350,39834201,8851
"3047","ENSG00000105205","19",39731255,39738029,6774
"3048","ENSG00000105219","19",40222208,40226697,4489
"3049","ENSG00000105220","19",34359480,34402413,42933
"3050","ENSG00000105221","19",40230317,40285536,55219
"3051","ENSG00000105223","19",40348456,40380439,31983
"3052","ENSG00000105227","19",40393768,40413366,19598
"3053","ENSG00000105229","19",4007736,4039386,31650
"3054","ENSG00000105245","19",40665905,40690972,25067
"3055","ENSG00000105246","19",4229523,4237528,8005
"3056","ENSG00000105248","19",4247080,4269088,22008
"3057","ENSG00000105251","19",4278601,4290724,12123
"3058","ENSG00000105254","19",36114289,36125947,11658
"3059","ENSG00000105255","19",4304598,4323843,19245
"3060","ENSG00000105258","19",36113709,36115213,1504
"3061","ENSG00000105261","19",36111151,36113711,2560
"3062","ENSG00000105270","19",36014660,36033343,18683
"3063","ENSG00000105278","19",3804024,3869038,65014
"3064","ENSG00000105281","19",46774883,46788594,13711
"3065","ENSG00000105287","19",46674275,46717127,42852
"3066","ENSG00000105289","19",3708362,3750813,42451
"3067","ENSG00000105290","19",35867899,35879791,11892
"3068","ENSG00000105298","19",3610645,3626815,16170
"3069","ENSG00000105321","19",47255980,47273701,17721
"3070","ENSG00000105323","19",41262496,41307598,45102
"3071","ENSG00000105325","19",3506273,3538330,32057
"3072","ENSG00000105327","19",47220822,47232766,11944
"3073","ENSG00000105329","19",41301587,41353911,52324
"3074","ENSG00000105339","8",141117278,141195808,78530
"3075","ENSG00000105341","19",41431318,41440717,9399
"3076","ENSG00000105352","19",41618971,41627074,8103
"3077","ENSG00000105355","19",4838341,4867694,29353
"3078","ENSG00000105357","19",50188186,50310542,122356
"3079","ENSG00000105364","19",10251901,10260045,8144
"3080","ENSG00000105366","19",51450847,51458456,7609
"3081","ENSG00000105369","19",41877120,41881372,4252
"3082","ENSG00000105370","19",51379909,51387960,8051
"3083","ENSG00000105372","19",41859918,41872926,13008
"3084","ENSG00000105373","19",47745546,47757058,11512
"3085","ENSG00000105374","19",51371606,51372701,1095
"3086","ENSG00000105376","19",10289952,10296778,6826
"3087","ENSG00000105379","19",51345169,51366418,21249
"3088","ENSG00000105383","19",51225064,51243860,18796
"3089","ENSG00000105388","19",41708585,41729798,21213
"3090","ENSG00000105392","19",47819779,47843330,23551
"3091","ENSG00000105393","19",17267376,17281249,13873
"3092","ENSG00000105397","19",10350529,10380676,30147
"3093","ENSG00000105398","19",47870467,47886315,15848
"3094","ENSG00000105401","19",10391133,10420121,28988
"3095","ENSG00000105402","19",47487637,47515091,27454
"3096","ENSG00000105404","19",41956681,41959321,2640
"3097","ENSG00000105409","19",41966582,41997497,30915
"3098","ENSG00000105419","19",47403124,47419523,16399
"3099","ENSG00000105426","19",5158495,5340803,182308
"3100","ENSG00000105427","19",42387019,42390297,3278
"3101","ENSG00000105428","19",5455431,5456856,1425
"3102","ENSG00000105429","19",42325609,42378769,53160
"3103","ENSG00000105438","19",48382575,48391551,8976
"3104","ENSG00000105443","19",48469208,48482314,13106
"3105","ENSG00000105447","19",48445773,48457022,11249
"3106","ENSG00000105464","19",48394875,48444931,50056
"3107","ENSG00000105467","19",48364395,48376376,11981
"3108","ENSG00000105472","19",50723364,50725718,2354
"3109","ENSG00000105479","19",48296457,48321894,25437
"3110","ENSG00000105483","19",48180770,48255946,75176
"3111","ENSG00000105486","19",48115445,48170603,55158
"3112","ENSG00000105492","19",51517819,51531856,14037
"3113","ENSG00000105497","19",51571283,51592510,21227
"3114","ENSG00000105499","19",48047843,48110817,62974
"3115","ENSG00000105501","19",51611927,51645545,33618
"3116","ENSG00000105507","19",48029953,48044053,14100
"3117","ENSG00000105509","19",51713112,51723994,10882
"3118","ENSG00000105514","19",11322068,11346270,24202
"3119","ENSG00000105516","19",48630030,48637438,7408
"3120","ENSG00000105518","19",11342776,11346518,3742
"3121","ENSG00000105519","19",5911375,5915877,4502
"3122","ENSG00000105520","19",11355386,11365698,10312
"3123","ENSG00000105523","19",48600810,48614854,14044
"3124","ENSG00000105538","19",48720585,48740610,20025
"3125","ENSG00000105549","19",361747,376670,14923
"3126","ENSG00000105550","19",48755559,48758333,2774
"3127","ENSG00000105552","19",48795062,48811029,15967
"3128","ENSG00000105556","19",301444,344815,43371
"3129","ENSG00000105559","19",48837097,48868617,31520
"3130","ENSG00000105568","19",52190048,52229518,39470
"3131","ENSG00000105576","19",12699194,12724011,24817
"3132","ENSG00000105583","19",12668073,12669415,1342
"3133","ENSG00000105605","19",53909335,53943941,34606
"3134","ENSG00000105607","19",12891160,12914207,23047
"3135","ENSG00000105609","19",54249431,54257301,7870
"3136","ENSG00000105610","19",12884422,12887199,2777
"3137","ENSG00000105612","19",12875209,12881466,6257
"3138","ENSG00000105613","19",12833951,12874952,41001
"3139","ENSG00000105617","19",54155161,54159882,4721
"3140","ENSG00000105618","19",54115410,54131719,16309
"3141","ENSG00000105619","19",54107013,54115675,8662
"3142","ENSG00000105639","19",17824780,17848071,23291
"3143","ENSG00000105640","19",17859910,17864153,4243
"3144","ENSG00000105641","19",17871945,17895174,23229
"3145","ENSG00000105642","19",17951293,18000080,48787
"3146","ENSG00000105643","19",18001132,18014102,12970
"3147","ENSG00000105647","19",18153163,18170532,17369
"3148","ENSG00000105649","19",18196784,18204074,7290
"3149","ENSG00000105650","19",18208652,18248200,39548
"3150","ENSG00000105655","19",18434388,18438301,3913
"3151","ENSG00000105656","19",18442663,18522116,79453
"3152","ENSG00000105662","19",18683678,18782333,98655
"3153","ENSG00000105664","19",18782773,18791305,8532
"3154","ENSG00000105668","19",35666516,35678483,11967
"3155","ENSG00000105669","19",18899514,18919387,19873
"3156","ENSG00000105671","19",18919705,18929189,9484
"3157","ENSG00000105672","19",35641745,35644871,3126
"3158","ENSG00000105675","19",35550043,35563658,13615
"3159","ENSG00000105676","19",19033575,19060311,26736
"3160","ENSG00000105677","19",35545600,35547526,1926
"3161","ENSG00000105679","19",35533455,35545319,11864
"3162","ENSG00000105694","19",2538112,2538754,642
"3163","ENSG00000105695","19",35292125,35313807,21682
"3164","ENSG00000105696","19",18607430,18621039,13609
"3165","ENSG00000105697","19",35280716,35285143,4427
"3166","ENSG00000105698","19",35268962,35279821,10859
"3167","ENSG00000105699","19",35248330,35267964,19634
"3168","ENSG00000105700","19",18557762,18569387,11625
"3169","ENSG00000105701","19",18531751,18544077,12326
"3170","ENSG00000105705","19",19276018,19320509,44491
"3171","ENSG00000105707","19",35040506,35066571,26065
"3172","ENSG00000105708","19",19710472,19733112,22640
"3173","ENSG00000105711","19",35030470,35040449,9979
"3174","ENSG00000105717","19",19561707,19618693,56986
"3175","ENSG00000105722","19",42247569,42255128,7559
"3176","ENSG00000105723","19",42230190,42242625,12435
"3177","ENSG00000105726","19",19645198,19663676,18478
"3178","ENSG00000105732","19",42068477,42081552,13075
"3179","ENSG00000105737","19",41998321,42069498,71177
"3180","ENSG00000105738","19",37907208,38208369,301161
"3181","ENSG00000105750","19",20923222,20950697,27475
"3182","ENSG00000105755","19",43506719,43527230,20511
"3183","ENSG00000105767","19",43622368,43639850,17482
"3184","ENSG00000105771","19",43727983,43754962,26979
"3185","ENSG00000105778","7",32495426,32588726,93300
"3186","ENSG00000105784","7",87627548,87832296,204748
"3187","ENSG00000105792","7",90245174,90311063,65889
"3188","ENSG00000105793","7",90335223,90391455,56232
"3189","ENSG00000105808","7",102573807,102616757,42950
"3190","ENSG00000105810","7",92604921,92836594,231673
"3191","ENSG00000105819","7",103297435,103329511,32076
"3192","ENSG00000105821","7",103312289,103344830,32541
"3193","ENSG00000105825","7",93885396,93890753,5357
"3194","ENSG00000105829","7",93962762,94004382,41620
"3195","ENSG00000105835","7",106248298,106286326,38028
"3196","ENSG00000105849","7",19695461,19709037,13576
"3197","ENSG00000105851","7",106865278,106908980,43702
"3198","ENSG00000105852","7",95359872,95396375,36503
"3199","ENSG00000105854","7",95404862,95435329,30467
"3200","ENSG00000105855","7",20330702,20415754,85052
"3201","ENSG00000105856","7",107168961,107202522,33561
"3202","ENSG00000105865","7",107563484,107578523,15039
"3203","ENSG00000105866","7",21428043,21514822,86779
"3204","ENSG00000105875","7",135183839,135211534,27695
"3205","ENSG00000105877","7",21543039,21901839,358800
"3206","ENSG00000105879","7",107743949,107761667,17718
"3207","ENSG00000105880","7",97020396,97024950,4554
"3208","ENSG00000105887","7",135926760,135977359,50599
"3209","ENSG00000105889","7",22419444,22727613,308169
"3210","ENSG00000105894","7",137227341,137343865,116524
"3211","ENSG00000105926","7",24573268,24694193,120925
"3212","ENSG00000105928","7",24698355,24757940,59585
"3213","ENSG00000105929","7",138706294,138799560,93266
"3214","ENSG00000105939","7",139043515,139109720,66205
"3215","ENSG00000105948","7",139133744,139191986,58242
"3216","ENSG00000105953","7",44606572,44709066,102494
"3217","ENSG00000105963","7",897900,955407,57507
"3218","ENSG00000105967","7",115935148,116159896,224748
"3219","ENSG00000105968","7",44826791,44848083,21292
"3220","ENSG00000105971","7",116287380,116508541,221161
"3221","ENSG00000105974","7",116525001,116561184,36183
"3222","ENSG00000105976","7",116672196,116798386,126190
"3223","ENSG00000105982","7",156640281,156677130,36849
"3224","ENSG00000105983","7",156668946,156893230,224284
"3225","ENSG00000105988","10",92216332,92216793,461
"3226","ENSG00000105989","7",117275451,117323289,47838
"3227","ENSG00000105991","7",27093313,27095996,2683
"3228","ENSG00000105993","7",157335381,157417439,82058
"3229","ENSG00000105996","7",27100354,27102686,2332
"3230","ENSG00000105997","7",27106184,27152581,46397
"3231","ENSG00000106003","7",2512529,2529177,16648
"3232","ENSG00000106004","7",27141052,27143681,2629
"3233","ENSG00000106006","7",27145396,27150603,5207
"3234","ENSG00000106009","7",2537810,2555694,17884
"3235","ENSG00000106012","7",2558972,2614733,55761
"3236","ENSG00000106013","7",118214669,118496171,281502
"3237","ENSG00000106018","7",159028175,159144867,116692
"3238","ENSG00000106025","7",120787320,120858402,71082
"3239","ENSG00000106028","7",141738334,141787922,49588
"3240","ENSG00000106031","7",27193503,27200091,6588
"3241","ENSG00000106034","7",120988697,121297442,308745
"3242","ENSG00000106038","7",27242700,27250493,7793
"3243","ENSG00000106049","7",27525442,27662883,137441
"3244","ENSG00000106052","7",27739331,27844564,105233
"3245","ENSG00000106066","7",28995235,29195451,200216
"3246","ENSG00000106069","7",29146569,29514328,367759
"3247","ENSG00000106070","7",50590063,50793462,203399
"3248","ENSG00000106077","7",73736094,73738867,2773
"3249","ENSG00000106078","7",51016212,51316818,300606
"3250","ENSG00000106080","7",30010587,30026684,16097
"3251","ENSG00000106086","7",30027404,30130483,103079
"3252","ENSG00000106089","7",73699206,73719672,20466
"3253","ENSG00000106100","7",30424527,30478784,54257
"3254","ENSG00000106105","7",30594838,30634033,39195
"3255","ENSG00000106113","7",30651942,30700129,48187
"3256","ENSG00000106123","7",142855061,142871094,16033
"3257","ENSG00000106125","7",30771417,30892387,120970
"3258","ENSG00000106128","7",30938669,30993254,54585
"3259","ENSG00000106133","7",72947581,72954790,7209
"3260","ENSG00000106144","7",143288215,143307696,19481
"3261","ENSG00000106153","7",56101573,56106476,4903
"3262","ENSG00000106178","7",75811665,75823356,11691
"3263","ENSG00000106211","7",76302673,76304295,1622
"3264","ENSG00000106236","7",98617285,98629869,12584
"3265","ENSG00000106244","7",99392048,99408597,16549
"3266","ENSG00000106245","7",99408641,99419616,10975
"3267","ENSG00000106246","7",99416739,99466163,49424
"3268","ENSG00000106258","7",99648194,99679998,31804
"3269","ENSG00000106261","7",100015572,100041689,26117
"3270","ENSG00000106263","7",2354086,2380745,26659
"3271","ENSG00000106266","7",2251770,2354318,102548
"3272","ENSG00000106268","7",2242222,2251146,8924
"3273","ENSG00000106278","7",121873089,122062036,188947
"3274","ENSG00000106290","7",100107070,100119841,12771
"3275","ENSG00000106299","7",123681943,123749003,67060
"3276","ENSG00000106302","7",123828983,123877478,48495
"3277","ENSG00000106304","7",123925237,123971414,46177
"3278","ENSG00000106305","7",6009255,6023834,14579
"3279","ENSG00000106327","7",100620416,100642779,22363
"3280","ENSG00000106328","7",127591409,127602144,10735
"3281","ENSG00000106330","7",100612102,100615384,3282
"3282","ENSG00000106331","7",127610292,127618075,7783
"3283","ENSG00000106333","7",100602363,100608175,5812
"3284","ENSG00000106336","7",100583982,100601117,17135
"3285","ENSG00000106341","7",31687215,31708455,21240
"3286","ENSG00000106344","7",128297685,128343908,46223
"3287","ENSG00000106346","7",6104884,6161564,56680
"3288","ENSG00000106348","7",128392277,128410252,17975
"3289","ENSG00000106351","7",100539203,100568220,29017
"3290","ENSG00000106355","7",32485338,32495283,9945
"3291","ENSG00000106366","7",101127089,101139266,12177
"3292","ENSG00000106367","7",101154456,101161596,7140
"3293","ENSG00000106384","7",101195007,101201038,6031
"3294","ENSG00000106392","7",7156934,7248651,91717
"3295","ENSG00000106397","7",101205977,101218420,12443
"3296","ENSG00000106399","7",7636518,7718607,82089
"3297","ENSG00000106400","7",101218165,101224190,6025
"3298","ENSG00000106404","7",101232092,101238820,6728
"3299","ENSG00000106410","7",144397240,144410227,12987
"3300","ENSG00000106415","7",7968796,8094272,125476
"3301","ENSG00000106436","7",101613325,101629296,15971
"3302","ENSG00000106443","7",10973336,11169630,196294
"3303","ENSG00000106459","7",129611720,129757082,145362
"3304","ENSG00000106460","7",12211270,12243367,32097
"3305","ENSG00000106462","7",148807383,148884321,76938
"3306","ENSG00000106477","7",130393771,130442433,48662
"3307","ENSG00000106479","7",149838375,149867479,29104
"3308","ENSG00000106483","7",37905932,38025695,119763
"3309","ENSG00000106484","7",130486171,130506465,20294
"3310","ENSG00000106511","7",15611212,15686683,75471
"3311","ENSG00000106524","7",16599779,16645817,46038
"3312","ENSG00000106526","7",150243916,150323725,79809
"3313","ENSG00000106536","7",38977998,39493095,515097
"3314","ENSG00000106537","7",16753755,16784536,30781
"3315","ENSG00000106538","7",150338317,150341662,3345
"3316","ENSG00000106541","7",16791811,16833433,41622
"3317","ENSG00000106546","7",16916359,17346152,429793
"3318","ENSG00000106554","7",132784870,133082090,297220
"3319","ENSG00000106560","7",150685697,150693641,7944
"3320","ENSG00000106565","7",150791285,150801360,10075
"3321","ENSG00000106571","7",41960949,42237870,276921
"3322","ENSG00000106588","7",42916861,42932185,15324
"3323","ENSG00000106591","7",42932376,42948958,16582
"3324","ENSG00000106603","7",43608456,43729717,121261
"3325","ENSG00000106605","7",43758680,43807342,48662
"3326","ENSG00000106608","7",43875894,43926411,50517
"3327","ENSG00000106609","7",66921225,66958551,37326
"3328","ENSG00000106610","7",67302621,67362950,60329
"3329","ENSG00000106615","7",151466012,151520120,54108
"3330","ENSG00000106617","7",151556124,151877125,321001
"3331","ENSG00000106624","7",44104345,44114562,10217
"3332","ENSG00000106628","7",44114681,44124358,9677
"3333","ENSG00000106631","7",44138864,44141332,2468
"3334","ENSG00000106633","7",44144271,44198170,53899
"3335","ENSG00000106635","7",73536356,73557690,21334
"3336","ENSG00000106636","7",44200968,44214294,13326
"3337","ENSG00000106638","7",73567533,73578791,11258
"3338","ENSG00000106648","7",151956379,152019929,63550
"3339","ENSG00000106665","7",74289475,74405943,116468
"3340","ENSG00000106682","7",74174245,74197101,22856
"3341","ENSG00000106683","7",74082933,74122525,39592
"3342","ENSG00000106686","9",4553386,4666674,113288
"3343","ENSG00000106688","9",4490468,4587469,97001
"3344","ENSG00000106689","9",124001670,124033301,31631
"3345","ENSG00000106692","9",105558130,105641118,82988
"3346","ENSG00000106701","9",105447796,105552433,104637
"3347","ENSG00000106714","9",39072767,39288315,215548
"3348","ENSG00000106723","9",88388430,88478694,90264
"3349","ENSG00000106733","9",75060573,75088217,27644
"3350","ENSG00000106771","9",109015135,109119947,104812
"3351","ENSG00000106772","9",76611376,76906114,294738
"3352","ENSG00000106780","9",120600811,120714470,113659
"3353","ENSG00000106785","9",98069275,98119222,49947
"3354","ENSG00000106789","9",98120975,98192637,71662
"3355","ENSG00000106799","9",99104038,99154192,50154
"3356","ENSG00000106803","9",99222064,99230615,8551
"3357","ENSG00000106804","9",120952335,121050276,97941
"3358","ENSG00000106809","9",92383268,92404696,21428
"3359","ENSG00000106819","9",92456205,92482506,26301
"3360","ENSG00000106823","9",92493554,92536655,43101
"3361","ENSG00000106829","9",79571773,79726882,155109
"3362","ENSG00000106852","9",122202577,122229626,27049
"3363","ENSG00000106853","9",111549722,111599893,50171
"3364","ENSG00000106868","9",112040785,112175408,134623
"3365","ENSG00000106927","9",114060127,114078328,18201
"3366","ENSG00000106948","9",114334156,114394405,60249
"3367","ENSG00000106952","9",114893343,114930595,37252
"3368","ENSG00000106976","9",128191655,128255248,63593
"3369","ENSG00000106991","9",127815012,127854756,39744
"3370","ENSG00000106992","9",127866486,127877675,11189
"3371","ENSG00000106993","9",4679559,4708399,28840
"3372","ENSG00000107014","9",5299864,5304716,4852
"3373","ENSG00000107018","9",5334930,5339876,4946
"3374","ENSG00000107020","9",5357971,5437925,79954
"3375","ENSG00000107021","9",128787253,128810430,23177
"3376","ENSG00000107036","9",5629025,5776557,147532
"3377","ENSG00000107077","9",6720863,7175648,454785
"3378","ENSG00000107099","9",214854,465259,250405
"3379","ENSG00000107104","9",470291,746106,275815
"3380","ENSG00000107105","9",23690104,23826337,136233
"3381","ENSG00000107130","9",130172404,130237303,64899
"3382","ENSG00000107140","9",35605262,35610041,4779
"3383","ENSG00000107147","9",135702185,135795508,93323
"3384","ENSG00000107159","9",35673918,35681159,7241
"3385","ENSG00000107164","9",130578965,130638352,59387
"3386","ENSG00000107165","9",12685439,12710290,24851
"3387","ENSG00000107175","9",35732598,35736999,4401
"3388","ENSG00000107185","9",35749287,35758575,9288
"3389","ENSG00000107186","9",13105704,13279590,173886
"3390","ENSG00000107187","9",136196250,136205128,8878
"3391","ENSG00000107201","9",32455302,32526208,70906
"3392","ENSG00000107223","9",136862119,136866308,4189
"3393","ENSG00000107242","9",68705240,69009176,303936
"3394","ENSG00000107249","9",3824127,4348392,524265
"3395","ENSG00000107262","9",33247820,33264720,16900
"3396","ENSG00000107263","9",131576770,131740074,163304
"3397","ENSG00000107281","9",137039463,137046179,6716
"3398","ENSG00000107282","9",69427532,69672371,244839
"3399","ENSG00000107290","9",132261356,132354986,93630
"3400","ENSG00000107295","9",17579066,17797124,218058
"3401","ENSG00000107317","9",136975092,136981742,6650
"3402","ENSG00000107331","9",137007234,137028922,21688
"3403","ENSG00000107338","9",37915898,38069227,153329
"3404","ENSG00000107341","9",33817160,33920399,103239
"3405","ENSG00000107362","9",71862452,71910931,48479
"3406","ENSG00000107371","9",37766978,37801437,34459
"3407","ENSG00000107372","9",72351413,72365235,13822
"3408","ENSG00000107404","1",1335276,1349418,14142
"3409","ENSG00000107438","10",95237572,95291012,53440
"3410","ENSG00000107443","10",96043394,96060870,17476
"3411","ENSG00000107447","10",96304409,96338564,34155
"3412","ENSG00000107485","10",8045378,8075198,29820
"3413","ENSG00000107518","10",115093365,115948999,855634
"3414","ENSG00000107521","10",98416198,98446947,30749
"3415","ENSG00000107537","10",13277796,13302412,24616
"3416","ENSG00000107551","10",44959407,44995891,36484
"3417","ENSG00000107554","10",99875577,100009947,134370
"3418","ENSG00000107560","10",118004916,118046941,42025
"3419","ENSG00000107562","10",44370165,44386493,16328
"3420","ENSG00000107566","10",100150094,100186033,35939
"3421","ENSG00000107581","10",119033670,119080823,47153
"3422","ENSG00000107593","10",100288149,100330264,42115
"3423","ENSG00000107611","10",16823966,17129817,305851
"3424","ENSG00000107614","10",17137336,17202054,64718
"3425","ENSG00000107625","10",68901286,68946847,45561
"3426","ENSG00000107643","10",48306639,48439360,132721
"3427","ENSG00000107651","10",119892730,119944657,51927
"3428","ENSG00000107669","10",121740421,121928801,188380
"3429","ENSG00000107672","10",121957091,121975217,18126
"3430","ENSG00000107679","10",122374696,122442602,67906
"3431","ENSG00000107719","10",70478767,70568450,89683
"3432","ENSG00000107731","10",71212570,71302864,90294
"3433","ENSG00000107736","10",71396934,71815947,419013
"3434","ENSG00000107738","10",71747556,71773520,25964
"3435","ENSG00000107742","10",72059034,72089032,29998
"3436","ENSG00000107745","10",72367327,72626191,258864
"3437","ENSG00000107758","10",73436428,73496024,59596
"3438","ENSG00000107771","10",84328586,84518521,189935
"3439","ENSG00000107779","10",86756601,86932838,176237
"3440","ENSG00000107789","10",87504875,87553461,48586
"3441","ENSG00000107796","10",88935074,88991339,56265
"3442","ENSG00000107798","10",89213569,89414557,200988
"3443","ENSG00000107807","10",101131300,101137789,6489
"3444","ENSG00000107815","10",100987367,100994403,7036
"3445","ENSG00000107816","10",100996618,101007836,11218
"3446","ENSG00000107819","10",101031234,101041244,10010
"3447","ENSG00000107821","10",101061841,101068131,6290
"3448","ENSG00000107829","10",101610664,101695295,84631
"3449","ENSG00000107831","10",101770130,101780369,10239
"3450","ENSG00000107833","10",101781325,101783413,2088
"3451","ENSG00000107854","10",91798426,91865475,67049
"3452","ENSG00000107859","10",102230186,102241512,11326
"3453","ENSG00000107862","10",102245532,102382899,137367
"3454","ENSG00000107863","10",24583609,24723887,140278
"3455","ENSG00000107864","10",92046692,92291078,244386
"3456","ENSG00000107872","10",102419189,102423136,3947
"3457","ENSG00000107874","10",102423245,102432584,9339
"3458","ENSG00000107882","10",102503987,102633535,129548
"3459","ENSG00000107890","10",26991914,27100498,108584
"3460","ENSG00000107897","10",27195214,27242130,46916
"3461","ENSG00000107902","10",124461823,124617888,156065
"3462","ENSG00000107929","10",806914,931705,124791
"3463","ENSG00000107937","10",988434,1019932,31498
"3464","ENSG00000107938","10",125719515,125764143,44628
"3465","ENSG00000107949","10",125823546,125853695,30149
"3466","ENSG00000107951","10",30309801,30374448,64647
"3467","ENSG00000107954","10",103493979,103592552,98573
"3468","ENSG00000107957","10",103594027,103855543,261516
"3469","ENSG00000107959","10",3137728,3172841,35113
"3470","ENSG00000107960","10",103877569,103918184,40615
"3471","ENSG00000107968","10",30434021,30461833,27812
"3472","ENSG00000107984","10",52314281,52318042,3761
"3473","ENSG00000108001","10",129835283,129963841,128558
"3474","ENSG00000108010","10",130136391,130184521,48130
"3475","ENSG00000108018","10",106573663,107164534,590871
"3476","ENSG00000108021","10",5684838,5763740,78902
"3477","ENSG00000108039","10",109864766,109923553,58787
"3478","ENSG00000108055","10",110567691,110604636,36945
"3479","ENSG00000108061","10",110919547,111013667,94120
"3480","ENSG00000108064","10",58385345,58399220,13875
"3481","ENSG00000108091","10",59788747,59906556,117809
"3482","ENSG00000108094","10",35008551,35090642,82091
"3483","ENSG00000108100","10",35247025,35572669,325644
"3484","ENSG00000108106","19",55399745,55407788,8043
"3485","ENSG00000108107","19",55385345,55403250,17905
"3486","ENSG00000108175","10",79068966,79316528,247562
"3487","ENSG00000108176","10",67796669,67838188,41519
"3488","ENSG00000108179","10",79347469,79355334,7865
"3489","ENSG00000108187","10",68282660,68333049,50389
"3490","ENSG00000108219","10",80454166,80533124,78958
"3491","ENSG00000108231","10",93757840,93806272,48432
"3492","ENSG00000108239","10",94402504,94535930,133426
"3493","ENSG00000108242","10",94683729,94736190,52461
"3494","ENSG00000108244","17",40922696,40937634,14938
"3495","ENSG00000108255","17",29246863,29254494,7631
"3496","ENSG00000108256","17",29255839,29294148,38309
"3497","ENSG00000108262","17",29573469,29594054,20585
"3498","ENSG00000108298","17",39200283,39204732,4449
"3499","ENSG00000108306","17",39252663,39402523,149860
"3500","ENSG00000108309","17",44308413,44318670,10257
"3501","ENSG00000108312","17",44205033,44221626,16593
"3502","ENSG00000108342","17",40015361,40017813,2452
"3503","ENSG00000108344","17",39980807,39997959,17152
"3504","ENSG00000108349","17",40140318,40172171,31853
"3505","ENSG00000108352","17",40177010,40195656,18646
"3506","ENSG00000108370","17",65100812,65227703,126891
"3507","ENSG00000108375","17",58352500,58417595,65095
"3508","ENSG00000108379","17",46762506,46833154,70648
"3509","ENSG00000108381","17",3472374,3503405,31031
"3510","ENSG00000108384","17",58692573,58735611,43038
"3511","ENSG00000108387","17",58520250,58540818,20568
"3512","ENSG00000108389","17",58489529,58517905,28376
"3513","ENSG00000108395","17",58982638,59106921,124283
"3514","ENSG00000108405","17",3896592,3916476,19884
"3515","ENSG00000108406","17",59565558,59608345,42787
"3516","ENSG00000108417","17",41420753,41424523,3770
"3517","ENSG00000108423","17",59859479,59892945,33466
"3518","ENSG00000108424","17",47649476,47685505,36029
"3519","ENSG00000108433","17",46923075,46975524,52449
"3520","ENSG00000108439","17",47941506,47949308,7802
"3521","ENSG00000108442","2",74628328,74628942,614
"3522","ENSG00000108443","17",59893046,59950574,57528
"3523","ENSG00000108448","17",18697998,18736118,38120
"3524","ENSG00000108452","17",15675476,15675643,167
"3525","ENSG00000108465","17",47967810,47981781,13971
"3526","ENSG00000108468","17",48070052,48101478,31426
"3527","ENSG00000108469","17",75626845,75667189,40344
"3528","ENSG00000108474","17",16217191,16351797,134606
"3529","ENSG00000108479","17",75751594,75765711,14117
"3530","ENSG00000108506","17",61865367,61928016,62649
"3531","ENSG00000108509","17",4967992,4987675,19683
"3532","ENSG00000108510","17",61942605,62065278,122673
"3533","ENSG00000108511","17",48595751,48604992,9241
"3534","ENSG00000108515","17",4948092,4957131,9039
"3535","ENSG00000108518","17",4945652,4949061,3409
"3536","ENSG00000108523","17",4940008,4945222,5214
"3537","ENSG00000108528","17",4937130,4940053,2923
"3538","ENSG00000108551","17",17494437,17496395,1958
"3539","ENSG00000108556","17",4897771,4934438,36667
"3540","ENSG00000108557","17",17681458,17811453,129995
"3541","ENSG00000108559","17",5360963,5419676,58713
"3542","ENSG00000108561","17",5432777,5448830,16053
"3543","ENSG00000108576","17",30194319,30236002,41683
"3544","ENSG00000108578","17",30248203,30292056,43853
"3545","ENSG00000108582","17",30378927,30469989,91062
"3546","ENSG00000108587","17",30477362,30527592,50230
"3547","ENSG00000108588","17",63745255,63776351,31096
"3548","ENSG00000108590","17",6643311,6651634,8323
"3549","ENSG00000108591","17",18087892,18107970,20078
"3550","ENSG00000108592","17",63819433,63830012,10579
"3551","ENSG00000108599","17",19904302,19978343,74041
"3552","ENSG00000108602","17",19737984,19748943,10959
"3553","ENSG00000108604","17",63832081,63843065,10984
"3554","ENSG00000108622","17",64002594,64020634,18040
"3555","ENSG00000108639","17",78168558,78173527,4969
"3556","ENSG00000108641","17",19334308,19378193,43885
"3557","ENSG00000108651","17",31860904,31901708,40804
"3558","ENSG00000108654","17",64499616,64508199,8583
"3559","ENSG00000108666","17",32324565,32350023,25458
"3560","ENSG00000108669","17",78674048,78782297,108249
"3561","ENSG00000108671","17",32444379,32483319,38940
"3562","ENSG00000108679","17",78971238,78979947,8709
"3563","ENSG00000108684","17",33013087,34174964,1161877
"3564","ENSG00000108688","17",34270221,34272242,2021
"3565","ENSG00000108691","17",34255218,34257203,1985
"3566","ENSG00000108700","17",34319435,34321402,1967
"3567","ENSG00000108702","17",34360328,34363231,2903
"3568","ENSG00000108733","17",35574795,35578863,4068
"3569","ENSG00000108759","17",41459811,41467429,7618
"3570","ENSG00000108771","17",42101404,42112714,11310
"3571","ENSG00000108773","17",42113111,42121367,8256
"3572","ENSG00000108774","17",42124976,42155044,30068
"3573","ENSG00000108784","17",42536241,42544449,8208
"3574","ENSG00000108785","17",42546764,42548706,1942
"3575","ENSG00000108786","17",42549214,42555213,5999
"3576","ENSG00000108788","17",42567068,42573239,6171
"3577","ENSG00000108797","17",42682531,42699993,17462
"3578","ENSG00000108798","17",49210411,49223225,12814
"3579","ENSG00000108799","17",42700275,42745049,44774
"3580","ENSG00000108813","17",49968970,49974959,5989
"3581","ENSG00000108819","17",50133737,50150677,16940
"3582","ENSG00000108821","17",50183289,50201632,18343
"3583","ENSG00000108823","17",50164214,50175928,11714
"3584","ENSG00000108825","17",42950526,42980528,30002
"3585","ENSG00000108826","17",50367857,50373207,5350
"3586","ENSG00000108828","17",43014607,43025123,10516
"3587","ENSG00000108829","17",50375059,50397523,22464
"3588","ENSG00000108830","17",43025231,43032041,6810
"3589","ENSG00000108839","17",6996049,7010754,14705
"3590","ENSG00000108840","17",44076746,44123702,46956
"3591","ENSG00000108846","17",50634777,50692253,57476
"3592","ENSG00000108848","17",50719565,50756219,36654
"3593","ENSG00000108849","17",43940804,43942468,1664
"3594","ENSG00000108852","17",43875357,43909711,34354
"3595","ENSG00000108854","17",64542282,64662307,120025
"3596","ENSG00000108861","17",43766125,43778977,12852
"3597","ENSG00000108878","17",67044554,67056797,12243
"3598","ENSG00000108883","17",44849948,44899445,49497
"3599","ENSG00000108924","17",55264960,55325187,60227
"3600","ENSG00000108932","17",68267026,68291267,24241
"3601","ENSG00000108946","17",68511780,68551319,39539
"3602","ENSG00000108947","17",7705202,7711372,6170
"3603","ENSG00000108950","17",68535113,68601367,66254
"3604","ENSG00000108953","17",1344275,1400222,55947
"3605","ENSG00000108958","17",1858039,1858446,407
"3606","ENSG00000108960","17",55392622,55421924,29302
"3607","ENSG00000108961","17",8288654,8290092,1438
"3608","ENSG00000108963","17",2030110,2043430,13320
"3609","ENSG00000108984","17",69414697,69553865,139168
"3610","ENSG00000109016","17",21123364,21193265,69901
"3611","ENSG00000109046","17",27294076,27315926,21850
"3612","ENSG00000109047","17",9896320,9905621,9301
"3613","ENSG00000109061","17",10492307,10518542,26235
"3614","ENSG00000109062","17",74748628,74769353,20725
"3615","ENSG00000109063","17",10628526,10657309,28783
"3616","ENSG00000109065","17",74770547,74776367,5820
"3617","ENSG00000109066","17",74776483,74839779,63296
"3618","ENSG00000109072","17",28367284,28373091,5807
"3619","ENSG00000109079","17",28335602,28347009,11407
"3620","ENSG00000109083","17",28328325,28335489,7164
"3621","ENSG00000109084","17",28319200,28328685,9485
"3622","ENSG00000109089","17",74987632,75005800,18168
"3623","ENSG00000109099","17",15229777,15265326,35549
"3624","ENSG00000109101","17",28506243,28538896,32653
"3625","ENSG00000109103","17",28546707,28552668,5961
"3626","ENSG00000109107","17",28573115,28576948,3833
"3627","ENSG00000109111","17",28662198,28702679,40481
"3628","ENSG00000109113","17",28714281,28718429,4148
"3629","ENSG00000109118","17",28905250,28951771,46521
"3630","ENSG00000109132","4",41744082,41748970,4888
"3631","ENSG00000109133","4",41935129,41960803,25674
"3632","ENSG00000109158","4",46918900,46993581,74681
"3633","ENSG00000109163","4",67739328,67754360,15032
"3634","ENSG00000109171","4",48341529,48426201,84672
"3635","ENSG00000109180","4",48805212,48861817,56605
"3636","ENSG00000109181","4",68815994,68832023,16029
"3637","ENSG00000109182","4",48986275,49062081,75806
"3638","ENSG00000109184","4",51843000,51916837,73837
"3639","ENSG00000109189","4",52590960,52659301,68341
"3640","ENSG00000109193","4",69841212,69860145,18933
"3641","ENSG00000109205","4",70196496,70204576,8080
"3642","ENSG00000109208","4",70360761,70367158,6397
"3643","ENSG00000109220","4",54009789,54064605,54816
"3644","ENSG00000109255","4",55595229,55636698,41469
"3645","ENSG00000109265","4",56049073,56328625,279552
"3646","ENSG00000109270","4",99878336,99894428,16092
"3647","ENSG00000109272","4",73853296,73854483,1187
"3648","ENSG00000109320","4",102501331,102617302,115971
"3649","ENSG00000109321","4",74445136,74455005,9869
"3650","ENSG00000109323","4",102630770,102760994,130224
"3651","ENSG00000109332","4",102794383,102868896,74513
"3652","ENSG00000109339","4",85990007,86594625,604618
"3653","ENSG00000109381","4",139028112,139177218,149106
"3654","ENSG00000109390","4",139266880,139302551,35671
"3655","ENSG00000109424","4",140559431,140568961,9530
"3656","ENSG00000109436","4",140620782,140756385,135603
"3657","ENSG00000109445","4",141220887,141234697,13810
"3658","ENSG00000109452","4",142023160,142847432,824272
"3659","ENSG00000109458","4",143336762,143474568,137806
"3660","ENSG00000109466","4",165207561,165323156,115595
"3661","ENSG00000109471","4",122451470,122456725,5255
"3662","ENSG00000109472","4",165361194,165498547,137353
"3663","ENSG00000109475","4",108620566,108630412,9846
"3664","ENSG00000109501","4",6269849,6303265,33416
"3665","ENSG00000109511","4",168092515,168187690,95175
"3666","ENSG00000109519","4",7058895,7068064,9169
"3667","ENSG00000109534","4",109815510,109824740,9230
"3668","ENSG00000109536","4",189940870,189963202,22332
"3669","ENSG00000109572","4",169612633,169723673,111040
"3670","ENSG00000109576","4",170060222,170091699,31477
"3671","ENSG00000109586","4",173168811,173323967,155156
"3672","ENSG00000109606","4",24517441,24584554,67113
"3673","ENSG00000109610","4",24789912,24800842,10930
"3674","ENSG00000109618","4",25120014,25160449,40435
"3675","ENSG00000109625","4",8592660,8619759,27099
"3676","ENSG00000109654","4",153152342,153339317,186975
"3677","ENSG00000109667","4",9771153,10054936,283783
"3678","ENSG00000109670","4",152320544,152536092,215548
"3679","ENSG00000109674","4",177309874,177362936,53062
"3680","ENSG00000109680","4",26576437,26756223,179786
"3681","ENSG00000109684","4",10486395,10684768,198373
"3682","ENSG00000109685","4",1871393,1982207,110814
"3683","ENSG00000109686","4",151102751,151325632,222881
"3684","ENSG00000109689","4",26857601,27025381,167780
"3685","ENSG00000109705","4",13540830,13545050,4220
"3686","ENSG00000109736","4",2930561,2934834,4273
"3687","ENSG00000109738","4",157076125,157172090,95965
"3688","ENSG00000109743","4",15703065,15738313,35248
"3689","ENSG00000109756","4",159103013,159360174,257161
"3690","ENSG00000109758","4",3441887,3449495,7608
"3691","ENSG00000109762","4",185204237,185370185,165948
"3692","ENSG00000109771","4",185363879,185395899,32020
"3693","ENSG00000109775","4",185399537,185425979,26442
"3694","ENSG00000109787","4",38664197,38701517,37320
"3695","ENSG00000109790","4",39045039,39126857,81818
"3696","ENSG00000109794","4",186104419,186172667,68248
"3697","ENSG00000109805","4",17810979,17844865,33886
"3698","ENSG00000109814","4",39498755,39528311,29556
"3699","ENSG00000109819","4",23755041,23904089,149048
"3700","ENSG00000109832","11",125903348,125943702,40354
"3701","ENSG00000109846","11",111908619,111923722,15103
"3702","ENSG00000109851","11",20156155,20160613,4458
"3703","ENSG00000109854","11",20363685,20383783,20098
"3704","ENSG00000109861","11",88293592,88337761,44169
"3705","ENSG00000109881","11",27330827,27363234,32407
"3706","ENSG00000109906","11",114059593,114250676,191083
"3707","ENSG00000109911","11",31509755,31790324,280569
"3708","ENSG00000109917","11",116773799,116788039,14240
"3709","ENSG00000109919","11",47617315,47642607,25292
"3710","ENSG00000109920","11",47716517,47767443,50926
"3711","ENSG00000109927","11",121101173,121191493,90320
"3712","ENSG00000109929","11",121292681,121313410,20729
"3713","ENSG00000109943","11",122838500,122872643,34143
"3714","ENSG00000109944","11",122882528,122959798,77270
"3715","ENSG00000109956","11",134378504,134412242,33738
"3716","ENSG00000109971","11",123057489,123063230,5741
"3717","ENSG00000109991","11",57338374,57370600,32226
"3718","ENSG00000110002","11",124115362,124147721,32359
"3719","ENSG00000110011","11",64230278,64234286,4008
"3720","ENSG00000110013","11",124633113,124695707,62594
"3721","ENSG00000110025","11",65027439,65040572,13133
"3722","ENSG00000110031","11",58526871,58578220,51349
"3723","ENSG00000110042","11",59171430,59208588,37158
"3724","ENSG00000110046","11",64894546,64917211,22665
"3725","ENSG00000110047","11",64851642,64888296,36654
"3726","ENSG00000110048","11",59574398,59615774,41376
"3727","ENSG00000110057","11",67991100,68004982,13882
"3728","ENSG00000110060","11",125893485,125903221,9736
"3729","ENSG00000110063","11",126304060,126350005,45945
"3730","ENSG00000110066","11",68154863,68213828,58965
"3731","ENSG00000110074","11",126269055,126278131,9076
"3732","ENSG00000110075","11",68460731,68615334,154603
"3733","ENSG00000110076","11",64606174,64723188,117014
"3734","ENSG00000110077","11",60172014,60184666,12652
"3735","ENSG00000110079","11",60185702,60317944,132242
"3736","ENSG00000110080","11",126355640,126440344,84704
"3737","ENSG00000110090","11",68754620,68844410,89790
"3738","ENSG00000110092","11",69641087,69654474,13387
"3739","ENSG00000110104","11",60842113,60851081,8968
"3740","ENSG00000110107","11",60890547,60906585,16038
"3741","ENSG00000110108","11",60914158,60923443,9285
"3742","ENSG00000110148","11",6259806,6272127,12321
"3743","ENSG00000110169","11",6431049,6442617,11568
"3744","ENSG00000110171","11",6448613,6474459,25846
"3745","ENSG00000110172","11",90200429,90223077,22648
"3746","ENSG00000110195","11",72189558,72196323,6765
"3747","ENSG00000110200","11",72106378,72112780,6402
"3748","ENSG00000110203","11",72114869,72139892,25023
"3749","ENSG00000110218","11",94128841,94181968,53127
"3750","ENSG00000110237","11",73308289,73369388,61099
"3751","ENSG00000110243","11",116789367,116792420,3053
"3752","ENSG00000110244","11",116820700,116823304,2604
"3753","ENSG00000110245","11",116829706,116833072,3366
"3754","ENSG00000110274","11",117314557,117413266,98709
"3755","ENSG00000110315","11",10511673,10541230,29557
"3756","ENSG00000110318","11",101915012,102001058,86046
"3757","ENSG00000110321","11",10797050,10808940,11890
"3758","ENSG00000110324","11",117986348,118003037,16689
"3759","ENSG00000110328","11",11270877,11622005,351128
"3760","ENSG00000110330","11",102347211,102378670,31459
"3761","ENSG00000110344","11",118359585,118399211,39626
"3762","ENSG00000110367","11",118747763,118791164,43401
"3763","ENSG00000110375","11",118925164,118958559,33395
"3764","ENSG00000110395","11",119206276,119313926,107650
"3765","ENSG00000110400","11",119623408,119729200,105792
"3766","ENSG00000110422","11",33256672,33357023,100351
"3767","ENSG00000110427","11",33376083,33674102,298019
"3768","ENSG00000110429","11",33740939,33774543,33604
"3769","ENSG00000110435","11",34915829,35020591,104762
"3770","ENSG00000110436","11",35251205,35420063,168858
"3771","ENSG00000110442","11",36269284,36289449,20165
"3772","ENSG00000110446","11",60937084,60952530,15446
"3773","ENSG00000110448","11",61102489,61127852,25363
"3774","ENSG00000110455","11",44065925,44084222,18297
"3775","ENSG00000110484","11",62270158,62273160,3002
"3776","ENSG00000110492","11",46380756,46383837,3081
"3777","ENSG00000110497","11",46396414,46594125,197711
"3778","ENSG00000110514","11",47269161,47330031,60870
"3779","ENSG00000110536","11",47565430,47573461,8031
"3780","ENSG00000110583","11",63938959,63957319,18360
"3781","ENSG00000110619","11",3000922,3057613,56691
"3782","ENSG00000110628","11",2899721,2925246,25525
"3783","ENSG00000110651","11",2376177,2397419,21242
"3784","ENSG00000110660","11",107790991,107928293,137302
"3785","ENSG00000110665","11",2295645,2303049,7404
"3786","ENSG00000110675","11",107591091,107666779,75688
"3787","ENSG00000110680","11",14966668,14972354,5686
"3788","ENSG00000110693","11",15966449,16739591,773142
"3789","ENSG00000110696","11",16613132,16758340,145208
"3790","ENSG00000110697","11",67491768,67506263,14495
"3791","ENSG00000110700","11",17074388,17077715,3327
"3792","ENSG00000110711","11",67483026,67491103,8077
"3793","ENSG00000110713","11",3671083,3797792,126709
"3794","ENSG00000110717","11",68030617,68036644,6027
"3795","ENSG00000110719","11",68039025,68050895,11870
"3796","ENSG00000110721","11",68052859,68121444,68585
"3797","ENSG00000110723","11",108505435,108593768,88333
"3798","ENSG00000110756","11",18278668,18322198,43530
"3799","ENSG00000110768","11",18322295,18367045,44750
"3800","ENSG00000110777","11",111352255,111455630,103375
"3801","ENSG00000110786","11",18727928,18792721,64793
"3802","ENSG00000110799","12",5948874,6124770,175896
"3803","ENSG00000110801","12",121888731,121918297,29566
"3804","ENSG00000110811","12",6828407,6839847,11440
"3805","ENSG00000110841","12",27523431,27695564,172133
"3806","ENSG00000110844","12",49568218,49644666,76448
"3807","ENSG00000110848","12",9752486,9760901,8415
"3808","ENSG00000110851","12",107732871,107761272,28401
"3809","ENSG00000110852","12",9852984,9870136,17152
"3810","ENSG00000110871","12",120503279,120534434,31155
"3811","ENSG00000110876","12",108622277,108633959,11682
"3812","ENSG00000110880","12",108645109,108731596,86487
"3813","ENSG00000110881","12",50057548,50083611,26063
"3814","ENSG00000110887","12",108858932,108901043,42111
"3815","ENSG00000110888","12",30709552,30754951,45399
"3816","ENSG00000110900","12",30926428,30996602,70174
"3817","ENSG00000110906","12",109448655,109477359,28704
"3818","ENSG00000110911","12",50979401,51028566,49165
"3819","ENSG00000110917","12",120687149,120701859,14710
"3820","ENSG00000110921","12",109573255,109598125,24870
"3821","ENSG00000110925","12",51061205,51083664,22459
"3822","ENSG00000110931","12",121237675,121298308,60633
"3823","ENSG00000110934","12",51281038,51324668,43630
"3824","ENSG00000110944","12",56334174,56340410,6236
"3825","ENSG00000110955","12",56638175,56645984,7809
"3826","ENSG00000110958","12",56663341,56688408,25067
"3827","ENSG00000110975","12",33374238,33439819,65581
"3828","ENSG00000110987","12",122019422,122062044,42622
"3829","ENSG00000111011","12",122503454,122527000,23546
"3830","ENSG00000111012","12",57762334,57768986,6652
"3831","ENSG00000111046","12",80707634,80709474,1840
"3832","ENSG00000111049","12",80716912,80719671,2759
"3833","ENSG00000111052","12",80792520,80937925,145405
"3834","ENSG00000111057","12",52948871,52952906,4035
"3835","ENSG00000111058","12",80936414,81261210,324796
"3836","ENSG00000111077","12",53046969,53064372,17403
"3837","ENSG00000111087","12",57459785,57472268,12483
"3838","ENSG00000111110","12",62643994,62935150,291156
"3839","ENSG00000111142","12",95473520,95515839,42319
"3840","ENSG00000111144","12",96000753,96043520,42767
"3841","ENSG00000111145","12",96194375,96269824,75449
"3842","ENSG00000111181","12",190077,214570,24493
"3843","ENSG00000111186","12",1529891,1647212,117321
"3844","ENSG00000111196","12",10604193,10613609,9416
"3845","ENSG00000111199","12",109783085,109833401,50316
"3846","ENSG00000111203","12",2812622,2859791,47169
"3847","ENSG00000111206","12",2857681,2877155,19474
"3848","ENSG00000111215","12",10845849,10849475,3626
"3849","ENSG00000111218","12",3381349,3593973,212624
"3850","ENSG00000111224","12",3791047,3873448,82401
"3851","ENSG00000111229","12",110434823,110450422,15599
"3852","ENSG00000111231","12",110452486,110469268,16782
"3853","ENSG00000111237","12",110491097,110502117,11020
"3854","ENSG00000111241","12",4428155,4445614,17459
"3855","ENSG00000111245","12",110910819,110921443,10624
"3856","ENSG00000111247","12",4538798,4560048,21250
"3857","ENSG00000111249","12",111034165,111350554,316389
"3858","ENSG00000111252","12",111405948,111451623,45675
"3859","ENSG00000111254","12",4615508,4649051,33543
"3860","ENSG00000111261","12",12326056,12350242,24186
"3861","ENSG00000111262","12",4909905,4918256,8351
"3862","ENSG00000111266","12",12474210,12562383,88173
"3863","ENSG00000111269","12",12611827,12645108,33281
"3864","ENSG00000111271","12",111686056,111757107,71051
"3865","ENSG00000111275","12",111766887,111817532,50645
"3866","ENSG00000111276","12",12715058,12722369,7311
"3867","ENSG00000111291","12",12940775,12952147,11372
"3868","ENSG00000111300","12",112026689,112108796,82107
"3869","ENSG00000111305","12",13083532,13103683,20151
"3870","ENSG00000111319","12",6346843,6377730,30887
"3871","ENSG00000111321","12",6375045,6391571,16526
"3872","ENSG00000111325","12",122974580,122980043,5463
"3873","ENSG00000111328","12",123250112,123272334,22222
"3874","ENSG00000111331","12",112938444,112973251,34807
"3875","ENSG00000111335","12",112978395,113011723,33328
"3876","ENSG00000111339","12",14825569,14843526,17957
"3877","ENSG00000111341","12",14881181,14885926,4745
"3878","ENSG00000111344","12",113098819,113136239,37420
"3879","ENSG00000111348","12",14942031,14961728,19697
"3880","ENSG00000111358","12",123633739,123662604,28865
"3881","ENSG00000111361","12",123620406,123633766,13360
"3882","ENSG00000111364","12",123602077,123620943,18866
"3883","ENSG00000111371","12",46183063,46270017,86954
"3884","ENSG00000111404","12",18080869,18320107,239238
"3885","ENSG00000111405","12",47709734,47725567,15833
"3886","ENSG00000111412","12",116710171,116738070,27899
"3887","ENSG00000111424","12",47841537,47943048,101511
"3888","ENSG00000111432","12",130162459,130165740,3281
"3889","ENSG00000111445","12",118013588,118033130,19542
"3890","ENSG00000111450","12",130789600,130839266,49666
"3891","ENSG00000111452","12",130953907,131141469,187562
"3892","ENSG00000111481","12",54301202,54351846,50644
"3893","ENSG00000111490","12",64780516,64881032,100516
"3894","ENSG00000111530","12",67269358,67319953,50595
"3895","ENSG00000111536","12",68201349,68225810,24461
"3896","ENSG00000111537","12",68154768,68159740,4972
"3897","ENSG00000111540","12",55973913,55996683,22770
"3898","ENSG00000111554","12",68272443,68332381,59938
"3899","ENSG00000111581","12",68686951,68745809,58858
"3900","ENSG00000111596","12",70242994,70354993,111999
"3901","ENSG00000111602","12",56416363,56449426,33063
"3902","ENSG00000111605","12",69239569,69274358,34789
"3903","ENSG00000111615","12",75490863,75511636,20773
"3904","ENSG00000111639","12",6491886,6493841,1955
"3905","ENSG00000111640","12",6534512,6538374,3862
"3906","ENSG00000111641","12",6556863,6568691,11828
"3907","ENSG00000111642","12",6570082,6614524,44442
"3908","ENSG00000111644","12",6638075,6647433,9358
"3909","ENSG00000111647","12",100028455,100142874,114419
"3910","ENSG00000111652","12",6724014,6731875,7861
"3911","ENSG00000111653","12",6650301,6663142,12841
"3912","ENSG00000111664","12",6839954,6847393,7439
"3913","ENSG00000111665","12",6844793,6852066,7273
"3914","ENSG00000111666","12",101696947,101744140,47193
"3915","ENSG00000111667","12",6852128,6866632,14504
"3916","ENSG00000111669","12",6867119,6870948,3829
"3917","ENSG00000111670","12",101745499,101830959,85460
"3918","ENSG00000111671","12",6870935,6889358,18423
"3919","ENSG00000111674","12",6913745,6923698,9953
"3920","ENSG00000111676","12",6924463,6942321,17858
"3921","ENSG00000111678","12",6942978,6946003,3025
"3922","ENSG00000111679","12",6946468,6961316,14848
"3923","ENSG00000111684","12",6976185,7018477,42292
"3924","ENSG00000111696","12",103770453,103841234,70781
"3925","ENSG00000111700","12",20810702,20916911,106209
"3926","ENSG00000111701","12",7649400,7665908,16508
"3927","ENSG00000111704","12",7787794,7799146,11352
"3928","ENSG00000111707","12",118376555,118418033,41478
"3929","ENSG00000111711","12",21501781,21518408,16627
"3930","ENSG00000111713","12",21536189,21604847,68658
"3931","ENSG00000111716","12",21635342,21757857,122515
"3932","ENSG00000111725","12",119667864,119681624,13760
"3933","ENSG00000111726","12",22046218,22065674,19456
"3934","ENSG00000111727","12",104064531,104106524,41993
"3935","ENSG00000111728","12",22063773,22437041,373268
"3936","ENSG00000111729","12",8123632,8138607,14975
"3937","ENSG00000111731","12",22448583,22544546,95963
"3938","ENSG00000111732","12",8602170,8612867,10697
"3939","ENSG00000111737","12",120095099,120117502,22403
"3940","ENSG00000111752","12",8913896,8941467,27571
"3941","ENSG00000111775","12",120438090,120440737,2647
"3942","ENSG00000111780","12",120438198,120460006,21808
"3943","ENSG00000111783","12",106582907,106762803,179896
"3944","ENSG00000111785","12",106774621,106889316,114695
"3945","ENSG00000111786","12",120461672,120469748,8076
"3946","ENSG00000111788","12",9277235,9313241,36006
"3947","ENSG00000111790","12",26938470,26966650,28180
"3948","ENSG00000111796","12",9594551,9607886,13335
"3949","ENSG00000111799","6",75084326,75206053,121727
"3950","ENSG00000111801","6",26440472,26453415,12943
"3951","ENSG00000111802","6",24649979,24666930,16951
"3952","ENSG00000111816","6",115931149,116060891,129742
"3953","ENSG00000111817","6",116254173,116444860,190687
"3954","ENSG00000111832","6",116571409,116597675,26266
"3955","ENSG00000111834","6",116616479,116632985,16506
"3956","ENSG00000111837","6",10762723,10838555,75832
"3957","ENSG00000111843","6",10722915,10731129,8214
"3958","ENSG00000111845","6",10694972,10709782,14810
"3959","ENSG00000111846","6",10492223,10629368,137145
"3960","ENSG00000111850","6",87322583,87399749,77166
"3961","ENSG00000111859","6",11183298,11382348,199050
"3962","ENSG00000111860","6",118460772,118710075,249303
"3963","ENSG00000111863","6",11712054,11807046,94992
"3964","ENSG00000111875","6",118894152,118909171,15019
"3965","ENSG00000111877","6",118813442,118935162,121720
"3966","ENSG00000111879","6",118959763,119149387,189624
"3967","ENSG00000111880","6",88609897,88963618,353721
"3968","ENSG00000111885","6",119177205,119349761,172556
"3969","ENSG00000111886","6",89257208,89315299,58091
"3970","ENSG00000111897","6",122443351,122471807,28456
"3971","ENSG00000111906","6",125219962,125302078,82116
"3972","ENSG00000111907","6",125119049,125264407,145358
"3973","ENSG00000111911","6",125956770,125980244,23474
"3974","ENSG00000111912","6",125781161,125932034,150873
"3975","ENSG00000111913","6",24804282,25042170,237888
"3976","ENSG00000111961","6",148272304,148552048,279744
"3977","ENSG00000111962","6",148747030,149076990,329960
"3978","ENSG00000111981","6",149963943,149973715,9772
"3979","ENSG00000112029","6",152970519,152983579,13060
"3980","ENSG00000112031","6",152987362,153002709,15347
"3981","ENSG00000112033","6",35342558,35428191,85633
"3982","ENSG00000112038","6",154010496,154246867,236371
"3983","ENSG00000112039","6",35452356,35467103,14747
"3984","ENSG00000112041","6",35497874,35512896,15022
"3985","ENSG00000112053","6",35943514,36024868,81354
"3986","ENSG00000112062","6",36027677,36111236,83559
"3987","ENSG00000112077","6",49605158,49636884,31726
"3988","ENSG00000112078","6",36442767,36491143,48376
"3989","ENSG00000112079","6",36493892,36547479,53587
"3990","ENSG00000112081","6",36594353,36605600,11247
"3991","ENSG00000112096","6",159669069,159745186,76117
"3992","ENSG00000112110","6",159789812,159798436,8624
"3993","ENSG00000112115","6",52186375,52190638,4263
"3994","ENSG00000112116","6",52236681,52244537,7856
"3995","ENSG00000112118","6",52264009,52284881,20872
"3996","ENSG00000112130","6",37353979,37394734,40755
"3997","ENSG00000112137","6",12716805,13290484,573679
"3998","ENSG00000112139","6",37630679,37699306,68627
"3999","ENSG00000112144","6",53001279,53061802,60523
"4000","ENSG00000112146","6",53051991,53100873,48882
"4001","ENSG00000112149","6",14117256,14136918,19662
"4002","ENSG00000112159","6",89642498,89819794,177296
"4003","ENSG00000112164","6",39048781,39091303,42522
"4004","ENSG00000112167","6",39104063,39115186,11123
"4005","ENSG00000112175","6",55753653,55875590,121937
"4006","ENSG00000112182","6",89926528,90296908,370380
"4007","ENSG00000112183","6",17281361,17293871,12510
"4008","ENSG00000112186","6",17393505,17557790,164285
"4009","ENSG00000112195","6",41189749,41201149,11400
"4010","ENSG00000112200","6",57086844,57170305,83461
"4011","ENSG00000112208","6",57172326,57189833,17507
"4012","ENSG00000112210","6",57186992,57222307,35315
"4013","ENSG00000112212","6",41042467,41044337,1870
"4014","ENSG00000112214","6",96562548,96616636,54088
"4015","ENSG00000112218","6",96794125,96837477,43352
"4016","ENSG00000112232","6",61679961,62286225,606264
"4017","ENSG00000112234","6",98868535,98948006,79471
"4018","ENSG00000112237","6",99542387,99568825,26438
"4019","ENSG00000112238","6",99606730,99615578,8848
"4020","ENSG00000112242","6",20401879,20493714,91835
"4021","ENSG00000112245","6",63521746,63583377,61631
"4022","ENSG00000112246","6",100385015,100464929,79914
"4023","ENSG00000112249","6",100508194,100881372,373178
"4024","ENSG00000112273","6",22569493,22571666,2173
"4025","ENSG00000112276","6",105096822,105137157,40335
"4026","ENSG00000112280","6",70215061,70303083,88022
"4027","ENSG00000112282","6",131573966,131628242,54276
"4028","ENSG00000112290","6",110099819,110180004,80185
"4029","ENSG00000112293","6",24424565,24495205,70640
"4030","ENSG00000112294","6",24494852,24537207,42355
"4031","ENSG00000112297","6",106360808,106571978,211170
"4032","ENSG00000112299","6",132680849,132714055,33206
"4033","ENSG00000112303","6",132743870,132763459,19589
"4034","ENSG00000112304","6",24667035,24705065,38030
"4035","ENSG00000112305","6",70667776,70862015,194239
"4036","ENSG00000112306","6",132814569,132817564,2995
"4037","ENSG00000112308","6",24704861,24719998,15137
"4038","ENSG00000112309","6",70856679,70957038,100359
"4039","ENSG00000112312","6",24774931,24786099,11168
"4040","ENSG00000112319","6",133240598,133532128,291530
"4041","ENSG00000112320","6",107490106,107661306,171200
"4042","ENSG00000112333","6",108166058,108188809,22751
"4043","ENSG00000112335","6",108211222,108261246,50024
"4044","ENSG00000112337","6",25912754,25930726,17972
"4045","ENSG00000112339","6",134960378,135103056,142678
"4046","ENSG00000112343","6",25962802,25991231,28429
"4047","ENSG00000112357","6",136822564,136913934,91370
"4048","ENSG00000112365","6",109462594,109483237,20643
"4049","ENSG00000112367","6",109691312,109825428,134116
"4050","ENSG00000112378","6",138088505,138107419,18914
"4051","ENSG00000112379","6",138161939,138344663,182724
"4052","ENSG00000112394","6",111087503,111231194,143691
"4053","ENSG00000112406","6",139135080,139180802,45722
"4054","ENSG00000112414","6",142301854,142446266,144412
"4055","ENSG00000112419","6",143536845,143831185,294340
"4056","ENSG00000112425","6",145382535,145736023,353488
"4057","ENSG00000112473","6",33200445,33204439,3994
"4058","ENSG00000112486","6",167111807,167139696,27889
"4059","ENSG00000112494","6",167271169,167316014,44845
"4060","ENSG00000112499","6",160171061,160277638,106577
"4061","ENSG00000112511","6",33410399,33416453,6054
"4062","ENSG00000112514","6",33416442,33418317,1875
"4063","ENSG00000112530","6",162727132,163315492,588360
"4064","ENSG00000112531","6",163414000,163578592,164592
"4065","ENSG00000112539","6",165279664,165309605,29941
"4066","ENSG00000112541","6",165327287,165988078,660791
"4067","ENSG00000112559","6",41636882,41654246,17364
"4068","ENSG00000112561","6",41683978,41736259,52281
"4069","ENSG00000112562","6",168441151,168673445,232294
"4070","ENSG00000112576","6",41934933,42050357,115424
"4071","ENSG00000112578","6",41921499,41933046,11547
"4072","ENSG00000112584","6",170290703,170407065,116362
"4073","ENSG00000112592","6",170554302,170572870,18568
"4074","ENSG00000112599","6",42183284,42194956,11672
"4075","ENSG00000112619","6",42696598,42722597,25999
"4076","ENSG00000112624","6",42746958,42868560,121602
"4077","ENSG00000112640","6",42984553,43012342,27789
"4078","ENSG00000112651","6",43054029,43059438,5409
"4079","ENSG00000112655","6",43076307,43161719,85412
"4080","ENSG00000112658","6",43171269,43181506,10237
"4081","ENSG00000112659","6",43182184,43224587,42403
"4082","ENSG00000112667","6",43225629,43229484,3855
"4083","ENSG00000112679","6",291630,351355,59725
"4084","ENSG00000112685","6",485154,693139,207985
"4085","ENSG00000112695","6",75237675,75250323,12648
"4086","ENSG00000112697","6",75252924,75284948,32024
"4087","ENSG00000112699","6",1623806,2245605,621799
"4088","ENSG00000112701","6",75601509,75718281,116772
"4089","ENSG00000112706","6",75921114,76072678,151564
"4090","ENSG00000112715","6",43770184,43786487,16303
"4091","ENSG00000112739","6",4021267,4064983,43716
"4092","ENSG00000112742","6",80003887,80042527,38640
"4093","ENSG00000112759","6",44219505,44234151,14646
"4094","ENSG00000112761","6",112054072,112070969,16897
"4095","ENSG00000112763","6",26457904,26476621,18717
"4096","ENSG00000112769","6",112108757,112254939,146182
"4097","ENSG00000112773","6",81491439,81752774,261335
"4098","ENSG00000112782","6",45880827,46080348,199521
"4099","ENSG00000112787","12",132489551,132585188,95637
"4100","ENSG00000112796","6",46159185,46170980,11795
"4101","ENSG00000112799","6",6588108,6654983,66875
"4102","ENSG00000112812","6",27247701,27256624,8923
"4103","ENSG00000112818","6",46793389,46839782,46393
"4104","ENSG00000112837","6",84687351,84764598,77247
"4105","ENSG00000112851","5",65926475,66082549,156074
"4106","ENSG00000112852","5",141094578,141098703,4125
"4107","ENSG00000112855","5",140691430,140699305,7875
"4108","ENSG00000112874","5",103548855,103562790,13935
"4109","ENSG00000112877","5",612340,667168,54828
"4110","ENSG00000112893","5",109689366,109869625,180259
"4111","ENSG00000112902","5",9035033,9546075,511042
"4112","ENSG00000112936","5",40909252,40982939,73687
"4113","ENSG00000112941","5",6713432,6757044,43612
"4114","ENSG00000112964","5",42423439,42721878,298439
"4115","ENSG00000112972","5",43287470,43313512,26042
"4116","ENSG00000112977","5",10679230,10761272,82042
"4117","ENSG00000112981","5",138115175,138139443,24268
"4118","ENSG00000112983","5",138139766,138178986,39220
"4119","ENSG00000112984","5",138178719,138187723,9004
"4120","ENSG00000112992","5",43602692,43707405,104713
"4121","ENSG00000112996","5",44808947,44820428,11481
"4122","ENSG00000113013","5",138553756,138575416,21660
"4123","ENSG00000113048","5",72219409,72320646,101237
"4124","ENSG00000113068","5",140245039,140303121,58082
"4125","ENSG00000113070","5",140332843,140346603,13760
"4126","ENSG00000113073","5",140360194,140375141,14947
"4127","ENSG00000113083","5",122063195,122078360,15165
"4128","ENSG00000113088","5",55024253,55034570,10317
"4129","ENSG00000113100","5",26880597,27121150,240553
"4130","ENSG00000113108","5",140558268,140564781,6513
"4131","ENSG00000113119","5",140639427,140645408,5981
"4132","ENSG00000113140","5",151661096,151686975,25879
"4133","ENSG00000113141","5",140647058,140662480,15422
"4134","ENSG00000113161","5",75336329,75362101,25772
"4135","ENSG00000113163","5",75356345,75512138,155793
"4136","ENSG00000113194","5",176447628,176510074,62446
"4137","ENSG00000113196","5",154474972,154478227,3255
"4138","ENSG00000113205","5",141100473,141103827,3354
"4139","ENSG00000113209","5",141135218,141138625,3407
"4140","ENSG00000113211","5",141150022,141153287,3265
"4141","ENSG00000113212","5",141172619,141176383,3764
"4142","ENSG00000113231","5",77210449,77429807,219358
"4143","ENSG00000113240","5",178602664,178630615,27951
"4144","ENSG00000113248","5",141245395,141249365,3970
"4145","ENSG00000113249","5",157029413,157059119,29706
"4146","ENSG00000113262","5",178977587,178996206,18619
"4147","ENSG00000113263","5",157142933,157255191,112258
"4148","ENSG00000113269","5",179911651,180072113,160462
"4149","ENSG00000113272","5",157731420,157741449,10029
"4150","ENSG00000113273","5",78777209,78986087,208878
"4151","ENSG00000113282","5",157785743,157859175,73432
"4152","ENSG00000113296","5",79991311,80083287,91976
"4153","ENSG00000113300","5",180494379,180578405,84026
"4154","ENSG00000113302","5",159314783,159330887,16104
"4155","ENSG00000113303","5",180899077,180950906,51829
"4156","ENSG00000113312","5",160009113,160065543,56430
"4157","ENSG00000113318","5",80654652,80876815,222163
"4158","ENSG00000113319","5",80960363,81230162,269799
"4159","ENSG00000113327","5",162000057,162162977,162920
"4160","ENSG00000113328","5",163437569,163446151,8582
"4161","ENSG00000113356","5",90471748,90514557,42809
"4162","ENSG00000113360","5",31400497,31532196,131699
"4163","ENSG00000113361","5",31193686,31329146,135460
"4164","ENSG00000113368","5",126776623,126837020,60397
"4165","ENSG00000113369","5",91368631,91383317,14686
"4166","ENSG00000113384","5",32124716,32174319,49603
"4167","ENSG00000113387","5",32531633,32604079,72446
"4168","ENSG00000113389","5",32689070,32791724,102654
"4169","ENSG00000113391","5",93617725,94111699,493974
"4170","ENSG00000113396","5",128538013,129033642,495629
"4171","ENSG00000113407","5",33440696,33469539,28843
"4172","ENSG00000113430","5",1877413,1887236,9823
"4173","ENSG00000113441","5",96935394,97037513,102119
"4174","ENSG00000113448","5",58969038,60522120,1553082
"4175","ENSG00000113456","5",34905260,34918989,13729
"4176","ENSG00000113460","5",34915376,34925996,10620
"4177","ENSG00000113492","5",34998101,35048135,50034
"4178","ENSG00000113494","5",35048756,35230487,181731
"4179","ENSG00000113504","5",1050384,1112063,61679
"4180","ENSG00000113520","5",132673986,132682678,8692
"4181","ENSG00000113522","5",132556019,132646349,90330
"4182","ENSG00000113525","5",132541445,132556838,15393
"4183","ENSG00000113532","5",100806933,100903282,96349
"4184","ENSG00000113552","5",141991749,142013041,21292
"4185","ENSG00000113555","5",141943585,141969741,26156
"4186","ENSG00000113558","5",134148935,134177038,28103
"4187","ENSG00000113569","5",37288137,37371106,82969
"4188","ENSG00000113575","5",134194332,134226073,31741
"4189","ENSG00000113578","5",142592178,142698070,105892
"4190","ENSG00000113580","5",143277931,143435512,157581
"4191","ENSG00000113583","5",133955510,133968674,13164
"4192","ENSG00000113593","5",65563236,65587549,24313
"4193","ENSG00000113594","5",38474668,38608354,133686
"4194","ENSG00000113595","5",65589690,65625975,36285
"4195","ENSG00000113597","5",65625004,65666233,41229
"4196","ENSG00000113600","5",39284140,39424868,140728
"4197","ENSG00000113615","5",134648785,134727909,79124
"4198","ENSG00000113621","5",134873803,134901525,27722
"4199","ENSG00000113638","5",40512333,40755963,243630
"4200","ENSG00000113643","5",168486451,168519301,32850
"4201","ENSG00000113645","5",168291651,168472303,180652
"4202","ENSG00000113648","5",135333900,135399914,66014
"4203","ENSG00000113649","5",146447311,146511961,64650
"4204","ENSG00000113657","5",147390808,147510068,119260
"4205","ENSG00000113658","5",136132845,136188747,55902
"4206","ENSG00000113712","5",149492982,149551471,58489
"4207","ENSG00000113716","5",150000046,150053142,53096
"4208","ENSG00000113719","5",172834251,172952683,118432
"4209","ENSG00000113721","5",150113839,150155872,42033
"4210","ENSG00000113722","5",150166795,150184558,17763
"4211","ENSG00000113732","5",172983771,173035445,51674
"4212","ENSG00000113734","5",173144442,173164387,19945
"4213","ENSG00000113739","5",173314713,173329503,14790
"4214","ENSG00000113742","5",173888349,173961980,73631
"4215","ENSG00000113749","5",175658030,175710756,52726
"4216","ENSG00000113758","5",177456608,177474401,17793
"4217","ENSG00000113761","5",177022696,177081189,58493
"4218","ENSG00000113763","5",176810519,176880898,70379
"4219","ENSG00000113790","3",185190624,185281990,91366
"4220","ENSG00000113805","3",74262568,74521140,258572
"4221","ENSG00000113810","3",160399274,160434954,35680
"4222","ENSG00000113811","3",53884417,53891962,7545
"4223","ENSG00000113812","3",53867066,53882152,15086
"4224","ENSG00000113838","3",186546067,186570543,24476
"4225","ENSG00000113845","3",119498532,119525090,26558
"4226","ENSG00000113851","3",3144628,3179727,35099
"4227","ENSG00000113889","3",186717348,186744410,27062
"4228","ENSG00000113905","3",186660216,186678240,18024
"4229","ENSG00000113916","3",187721377,187745725,24348
"4230","ENSG00000113924","3",120628172,120682269,54097
"4231","ENSG00000113946","3",190322541,190412143,89602
"4232","ENSG00000113966","3",97764521,97801229,36708
"4233","ENSG00000113971","3",132680609,132722414,41805
"4234","ENSG00000114013","3",122055362,122121139,65777
"4235","ENSG00000114019","3",134355874,134375479,19605
"4236","ENSG00000114021","3",100334739,100361635,26896
"4237","ENSG00000114023","3",122384176,122412334,28158
"4238","ENSG00000114026","3",9749944,9788219,38275
"4239","ENSG00000114030","3",122421902,122514945,93043
"4240","ENSG00000114054","3",136250340,136337896,87556
"4241","ENSG00000114062","15",25333728,25439051,105323
"4242","ENSG00000114098","3",138187248,138298389,111141
"4243","ENSG00000114107","3",138494344,138594538,100194
"4244","ENSG00000114113","3",139452884,139480747,27863
"4245","ENSG00000114115","3",139517434,139539829,22395
"4246","ENSG00000114120","3",140941830,140980961,39131
"4247","ENSG00000114124","3",141778148,141818490,40342
"4248","ENSG00000114125","3",141738249,141747560,9311
"4249","ENSG00000114126","3",141944428,142149544,205116
"4250","ENSG00000114127","3",142306607,142448062,141455
"4251","ENSG00000114166","3",20040446,20154404,113958
"4252","ENSG00000114200","3",165772904,165837462,64558
"4253","ENSG00000114204","3",167441789,167479004,37215
"4254","ENSG00000114209","3",167683298,167734939,51641
"4255","ENSG00000114248","3",169839179,169869930,30751
"4256","ENSG00000114251","3",55465715,55490539,24824
"4257","ENSG00000114268","3",48517684,48562015,44331
"4258","ENSG00000114270","3",48564073,48595267,31194
"4259","ENSG00000114279","3",192139395,192767764,628369
"4260","ENSG00000114302","3",48744597,48847874,103277
"4261","ENSG00000114315","3",194136148,194138732,2584
"4262","ENSG00000114316","3",49277831,49340712,62881
"4263","ENSG00000114331","3",195274745,195443044,168299
"4264","ENSG00000114346","3",172750682,172821474,70792
"4265","ENSG00000114349","3",50191612,50196516,4904
"4266","ENSG00000114353","3",50226292,50259362,33070
"4267","ENSG00000114354","3",100709331,100748964,39633
"4268","ENSG00000114374","Y",12537650,12860839,323189
"4269","ENSG00000114378","3",50299890,50312381,12491
"4270","ENSG00000114383","3",50320027,50328251,8224
"4271","ENSG00000114388","3",50347330,50351091,3761
"4272","ENSG00000114391","3",101681091,101686718,5627
"4273","ENSG00000114395","3",50350695,50358460,7765
"4274","ENSG00000114405","3",62318973,62336213,17240
"4275","ENSG00000114416","3",180868141,180982753,114612
"4276","ENSG00000114423","3",105655461,105869552,214091
"4277","ENSG00000114439","3",107522936,107811339,288403
"4278","ENSG00000114446","3",108160812,108222435,61623
"4279","ENSG00000114450","3",179396088,179451476,55388
"4280","ENSG00000114455","3",108296490,108378285,81795
"4281","ENSG00000114473","3",197889077,197960142,71065
"4282","ENSG00000114480","3",81489703,81761645,271942
"4283","ENSG00000114487","3",108958239,109118142,159903
"4284","ENSG00000114491","3",124730433,124749273,18840
"4285","ENSG00000114503","3",196935402,196942594,7192
"4286","ENSG00000114520","3",125446650,125520202,73552
"4287","ENSG00000114529","3",112086335,112131004,44669
"4288","ENSG00000114541","3",69168782,69542583,373801
"4289","ENSG00000114544","3",126006355,126101561,95206
"4290","ENSG00000114547","3",125969160,125983454,14294
"4291","ENSG00000114554","3",126988594,127037392,48798
"4292","ENSG00000114573","3",113747033,113812056,65023
"4293","ENSG00000114626","3",127672935,127680926,7991
"4294","ENSG00000114631","3",127629185,127672802,43617
"4295","ENSG00000114638","3",119173517,119205143,31626
"4296","ENSG00000114646","3",47562238,47580792,18554
"4297","ENSG00000114648","3",47282917,47346816,63899
"4298","ENSG00000114650","3",47413681,47477126,63445
"4299","ENSG00000114654","3",129001629,129040742,39113
"4300","ENSG00000114656","3",128909866,129002690,92824
"4301","ENSG00000114670","3",131026850,131350465,323615
"4302","ENSG00000114686","3",131462212,131502983,40771
"4303","ENSG00000114698","3",146192335,146251179,58844
"4304","ENSG00000114735","3",50569152,50596168,27016
"4305","ENSG00000114737","3",50606490,50611831,5341
"4306","ENSG00000114738","3",50611520,50649291,37771
"4307","ENSG00000114739","3",38453890,38493142,39252
"4308","ENSG00000114742","3",39052013,39096671,44658
"4309","ENSG00000114744","3",149738472,149752495,14023
"4310","ENSG00000114745","3",39096659,39108363,11704
"4311","ENSG00000114757","3",179794958,180037053,242095
"4312","ENSG00000114767","3",51933429,51941904,8475
"4313","ENSG00000114770","3",183919934,184017939,98005
"4314","ENSG00000114771","3",151814073,151828488,14415
"4315","ENSG00000114779","3",51968510,51983409,14899
"4316","ENSG00000114784","3",40309707,40312424,2717
"4317","ENSG00000114786","3",51974706,51989183,14477
"4318","ENSG00000114790","3",154121003,154257827,136824
"4319","ENSG00000114796","3",183635610,183684519,48909
"4320","ENSG00000114805","3",155375580,155745067,369487
"4321","ENSG00000114812","3",42489299,42537573,48274
"4322","ENSG00000114841","3",52316319,52400491,84172
"4323","ENSG00000114850","3",156540140,156555184,15044
"4324","ENSG00000114853","3",42653697,42667580,13883
"4325","ENSG00000114854","3",52451102,52454070,2968
"4326","ENSG00000114857","3",42600655,42648735,48080
"4327","ENSG00000114859","3",184346185,184361650,15465
"4328","ENSG00000114861","3",70952817,71583993,631176
"4329","ENSG00000114867","3",184314495,184335358,20863
"4330","ENSG00000114902","3",52704955,52711148,6193
"4331","ENSG00000114904","3",52708444,52770946,62502
"4332","ENSG00000114923","2",219627394,219641980,14586
"4333","ENSG00000114933","2",205993721,206086303,92582
"4334","ENSG00000114942","2",206159585,206162928,3343
"4335","ENSG00000114948","2",206443532,206621127,177595
"4336","ENSG00000114956","2",73926826,73958961,32135
"4337","ENSG00000114978","2",74152528,74178898,26370
"4338","ENSG00000114982","2",96593170,96642787,49617
"4339","ENSG00000114988","2",96705929,96740064,34135
"4340","ENSG00000114993","2",74425836,74442422,16586
"4341","ENSG00000114999","2",112482156,112541739,59583
"4342","ENSG00000115008","2",112773915,112784590,10675
"4343","ENSG00000115009","2",227805739,227817564,11825
"4344","ENSG00000115020","2",208266255,208358746,92491
"4345","ENSG00000115041","2",95297327,95386077,88750
"4346","ENSG00000115042","2",95402708,95416616,13908
"4347","ENSG00000115053","2",231453531,231483641,30110
"4348","ENSG00000115073","2",97655963,97664107,8144
"4349","ENSG00000115084","2",113705011,113756693,51682
"4350","ENSG00000115085","2",97713560,97739862,26302
"4351","ENSG00000115091","2",113889960,113962596,72636
"4352","ENSG00000115107","2",119223831,119265652,41821
"4353","ENSG00000115109","2",120013077,120179119,166042
"4354","ENSG00000115112","2",121216587,121285202,68615
"4355","ENSG00000115128","2",24067586,24076373,8787
"4356","ENSG00000115129","2",24077433,24085861,8428
"4357","ENSG00000115137","2",24943636,24972094,28458
"4358","ENSG00000115138","2",25160853,25168903,8050
"4359","ENSG00000115145","2",152116801,152175763,58962
"4360","ENSG00000115155","2",26457203,26558698,101495
"4361","ENSG00000115159","2",156435290,156613735,178445
"4362","ENSG00000115163","2",26764289,26801067,36778
"4363","ENSG00000115165","2",157414619,157488961,74342
"4364","ENSG00000115170","2",157736444,157875862,139418
"4365","ENSG00000115183","2",158968640,159232659,264019
"4366","ENSG00000115194","2",27253684,27275817,22133
"4367","ENSG00000115204","2",27309492,27325680,16188
"4368","ENSG00000115207","2",27325849,27357034,31185
"4369","ENSG00000115211","2",27364352,27370486,6134
"4370","ENSG00000115216","2",27427790,27442259,14469
"4371","ENSG00000115221","2",160099667,160200313,100646
"4372","ENSG00000115226","2",27491883,27495200,3317
"4373","ENSG00000115232","2",181457202,181538940,81738
"4374","ENSG00000115233","2",161308425,161411717,103292
"4375","ENSG00000115234","2",27370496,27377535,7039
"4376","ENSG00000115239","2",53532672,53860160,327488
"4377","ENSG00000115241","2",27381195,27409591,28396
"4378","ENSG00000115252","2",182140036,182523192,383156
"4379","ENSG00000115255","19",1491166,1497927,6761
"4380","ENSG00000115257","19",1481428,1490752,9324
"4381","ENSG00000115263","2",162142882,162152404,9522
"4382","ENSG00000115266","19",1446302,1473244,26942
"4383","ENSG00000115267","2",162267074,162318684,51610
"4384","ENSG00000115268","19",1438358,1440494,2136
"4385","ENSG00000115271","2",162318840,162371595,52755
"4386","ENSG00000115274","2",74455087,74457944,2857
"4387","ENSG00000115275","2",74461057,74465410,4353
"4388","ENSG00000115282","2",74483073,74494886,11813
"4389","ENSG00000115286","19",1383527,1395589,12062
"4390","ENSG00000115289","2",74505043,74507695,2652
"4391","ENSG00000115290","2",164492812,164621848,129036
"4392","ENSG00000115295","2",29097705,29189643,91938
"4393","ENSG00000115297","2",74513463,74517148,3685
"4394","ENSG00000115306","2",54456317,54671446,215129
"4395","ENSG00000115307","2",74526645,74529760,3115
"4396","ENSG00000115310","2",54972187,55112621,140434
"4397","ENSG00000115317","2",74529377,74533348,3971
"4398","ENSG00000115318","2",74532258,74555690,23432
"4399","ENSG00000115325","2",74549026,74557554,8528
"4400","ENSG00000115339","2",165747591,165794682,47091
"4401","ENSG00000115350","2",74958492,74970128,11636
"4402","ENSG00000115353","2",75046463,75199520,153057
"4403","ENSG00000115355","2",55287842,55419895,132053
"4404","ENSG00000115361","2",210187126,210225447,38321
"4405","ENSG00000115363","2",75469302,75569722,100420
"4406","ENSG00000115364","2",75646783,75690851,44068
"4407","ENSG00000115365","2",210431249,210477652,46403
"4408","ENSG00000115368","2",189441446,189475552,34106
"4409","ENSG00000115380","2",55865967,55924139,58172
"4410","ENSG00000115386","2",79120362,79123409,3047
"4411","ENSG00000115392","2",58159243,58241372,82129
"4412","ENSG00000115414","2",215360440,215436073,75633
"4413","ENSG00000115415","2",190964358,191020960,56602
"4414","ENSG00000115419","2",190880827,190965552,84725
"4415","ENSG00000115421","2",60756253,60802086,45833
"4416","ENSG00000115423","2",84516455,84819589,303134
"4417","ENSG00000115425","2",215996329,216082955,86626
"4418","ENSG00000115446","2",98608579,98618515,9936
"4419","ENSG00000115457","2",216632828,216664436,31608
"4420","ENSG00000115459","2",85354394,85391752,37358
"4421","ENSG00000115461","2",216672105,216695549,23444
"4422","ENSG00000115464","2",61187463,61470769,283306
"4423","ENSG00000115468","2",232606057,232682780,76723
"4424","ENSG00000115474","2",232766464,232776568,10104
"4425","ENSG00000115484","2",61868085,61888671,20586
"4426","ENSG00000115486","2",85544720,85561547,16827
"4427","ENSG00000115504","2",62673851,63046487,372636
"4428","ENSG00000115507","2",63050057,63057836,7779
"4429","ENSG00000115514","2",99318982,99340702,21720
"4430","ENSG00000115520","2",197453423,197475308,21885
"4431","ENSG00000115523","2",85685175,85698854,13679
"4432","ENSG00000115524","2",197388515,197435091,46576
"4433","ENSG00000115525","2",85837120,85905199,68079
"4434","ENSG00000115526","2",100391860,100417668,25808
"4435","ENSG00000115539","2",100562993,100576739,13746
"4436","ENSG00000115540","2",197515571,197553699,38128
"4437","ENSG00000115541","2",197500140,197503449,3309
"4438","ENSG00000115548","2",86440647,86492716,52069
"4439","ENSG00000115556","2",218607855,218637184,29329
"4440","ENSG00000115561","2",86503430,86563479,60049
"4441","ENSG00000115568","2",218637916,218659655,21739
"4442","ENSG00000115590","2",101991960,102028544,36584
"4443","ENSG00000115592","2",218822383,218832086,9703
"4444","ENSG00000115593","2",88067825,88113384,45559
"4445","ENSG00000115594","2",102064544,102179874,115330
"4446","ENSG00000115596","2",218859805,218874233,14428
"4447","ENSG00000115598","2",102187006,102240002,52996
"4448","ENSG00000115602","2",102311502,102352037,40535
"4449","ENSG00000115604","2",102311529,102398775,87246
"4450","ENSG00000115607","2",102418689,102452565,33876
"4451","ENSG00000115616","2",102619707,102711318,91611
"4452","ENSG00000115641","2",105357712,105438513,80801
"4453","ENSG00000115648","2",237485428,237555322,69894
"4454","ENSG00000115649","2",219171897,219178106,6209
"4455","ENSG00000115652","2",106093303,106194339,101036
"4456","ENSG00000115657","2",219209772,219218994,9222
"4457","ENSG00000115661","2",219245455,219250337,4882
"4458","ENSG00000115665","2",107986523,108013994,27471
"4459","ENSG00000115677","2",241227264,241317061,89797
"4460","ENSG00000115685","2",241149576,241183652,34076
"4461","ENSG00000115687","2",241106099,241150264,44165
"4462","ENSG00000115694","2",241492670,241509730,17060
"4463","ENSG00000115705","2",1374066,1543711,169645
"4464","ENSG00000115718","2",127418427,127429246,10819
"4465","ENSG00000115738","2",8678845,8684461,5616
"4466","ENSG00000115750","2",9843443,9934416,90973
"4467","ENSG00000115756","2",10302889,10427617,124728
"4468","ENSG00000115758","2",10439968,10448327,8359
"4469","ENSG00000115760","2",32357028,32618899,261871
"4470","ENSG00000115761","2",10570754,10689987,119233
"4471","ENSG00000115762","2",131104847,131353709,248862
"4472","ENSG00000115806","2",170928464,170967130,38666
"4473","ENSG00000115808","2",36837698,36966536,128838
"4474","ENSG00000115816","2",37201612,37231596,29984
"4475","ENSG00000115825","2",37250502,37324808,74306
"4476","ENSG00000115827","2",171434217,171485052,50835
"4477","ENSG00000115828","2",37342827,37373322,30495
"4478","ENSG00000115839","2",135052265,135176394,124129
"4479","ENSG00000115840","2",171783405,171999859,216454
"4480","ENSG00000115841","2",37923187,38067142,143955
"4481","ENSG00000115844","2",172099438,172102900,3462
"4482","ENSG00000115850","2",135787850,135837184,49334
"4483","ENSG00000115866","2",135905881,135986100,80219
"4484","ENSG00000115875","2",38743599,38751494,7895
"4485","ENSG00000115884","2",20200797,20225433,24636
"4486","ENSG00000115896","2",197804593,198572581,767988
"4487","ENSG00000115902","2",64988477,65023865,35388
"4488","ENSG00000115904","2",38981396,39124345,142949
"4489","ENSG00000115919","2",142877657,143055833,178176
"4490","ENSG00000115934","12",23181334,23251499,70165
"4491","ENSG00000115935","2",174559572,174682916,123344
"4492","ENSG00000115942","2",200908977,200963680,54703
"4493","ENSG00000115944","2",42333546,42425088,91542
"4494","ENSG00000115946","2",68157888,68176238,18350
"4495","ENSG00000115947","2",147930397,148021604,91207
"4496","ENSG00000115956","2",68365282,68397453,32171
"4497","ENSG00000115963","2",150468195,150539011,70816
"4498","ENSG00000115966","2",175072250,175168382,96132
"4499","ENSG00000115970","2",43230836,43596046,365210
"4500","ENSG00000115977","2",69457997,69674349,216352
"4501","ENSG00000115993","2",201377207,201451500,74293
"4502","ENSG00000115998","2",70149880,70248615,98735
"4503","ENSG00000116001","2",70209444,70248660,39216
"4504","ENSG00000116005","2",70257386,70281185,23799
"4505","ENSG00000116014","19",917287,921005,3718
"4506","ENSG00000116016","2",46293667,46386697,93030
"4507","ENSG00000116017","19",925781,975939,50158
"4508","ENSG00000116030","2",202206180,202238608,32428
"4509","ENSG00000116031","2",70830211,70835816,5605
"4510","ENSG00000116032","19",1000419,1009732,9313
"4511","ENSG00000116035","2",70900576,70965373,64797
"4512","ENSG00000116039","2",70935900,70965431,29531
"4513","ENSG00000116044","2",177227595,177392697,165102
"4514","ENSG00000116062","2",47695530,47810101,114571
"4515","ENSG00000116095","2",178480457,178516463,36006
"4516","ENSG00000116096","2",72887382,72892158,4776
"4517","ENSG00000116106","2",221418027,221574202,156175
"4518","ENSG00000116117","2",204545475,205620162,1074687
"4519","ENSG00000116120","2",222566899,222656337,89438
"4520","ENSG00000116127","2",73385758,73625166,239408
"4521","ENSG00000116128","1",147541501,147626216,84715
"4522","ENSG00000116132","1",170662728,170739421,76693
"4523","ENSG00000116133","1",54849627,54887195,37568
"4524","ENSG00000116138","1",15526813,15592379,65566
"4525","ENSG00000116141","1",220528183,220664461,136278
"4526","ENSG00000116147","1",175315194,175743616,428422
"4527","ENSG00000116151","1",2321253,2391707,70454
"4528","ENSG00000116157","1",52602371,52609051,6680
"4529","ENSG00000116161","1",174999163,175011715,12552
"4530","ENSG00000116171","1",52927276,53051698,124422
"4531","ENSG00000116176","16",1221651,1225257,3606
"4532","ENSG00000116183","1",176463171,176845601,382430
"4533","ENSG00000116191","1",178725147,178921841,196694
"4534","ENSG00000116194","1",178849535,178871077,21542
"4535","ENSG00000116198","1",3812086,3857214,45128
"4536","ENSG00000116199","1",179025804,179076567,50763
"4537","ENSG00000116205","1",54053584,54112519,58935
"4538","ENSG00000116209","1",54026681,54053504,26823
"4539","ENSG00000116212","1",53946085,53968168,22083
"4540","ENSG00000116213","1",3630767,3652761,21994
"4541","ENSG00000116218","1",179550539,179575952,25413
"4542","ENSG00000116221","1",54184041,54225464,41423
"4543","ENSG00000116237","1",6221193,6235972,14779
"4544","ENSG00000116251","1",6185020,6209389,24369
"4545","ENSG00000116254","1",6101787,6180321,78534
"4546","ENSG00000116260","1",180154869,180204030,49161
"4547","ENSG00000116266","1",108746674,108809523,62849
"4548","ENSG00000116273","1",6613731,6624030,10299
"4549","ENSG00000116285","1",8004404,8026309,21905
"4550","ENSG00000116288","1",7954291,7985505,31214
"4551","ENSG00000116299","1",109113679,109206781,93102
"4552","ENSG00000116329","1",28812142,28871267,59125
"4553","ENSG00000116337","1",109616104,109632053,15949
"4554","ENSG00000116350","1",29147743,29181900,34157
"4555","ENSG00000116353","1",29192873,29230942,38069
"4556","ENSG00000116396","1",110211343,110283100,71757
"4557","ENSG00000116406","1",184690237,184754907,64670
"4558","ENSG00000116455","1",111439890,111449256,9366
"4559","ENSG00000116459","1",111448864,111462773,13909
"4560","ENSG00000116473","1",111542218,111716691,174473
"4561","ENSG00000116478","1",32292083,32333635,41552
"4562","ENSG00000116489","1",112619805,112671616,51811
"4563","ENSG00000116497","1",32816767,32858875,42108
"4564","ENSG00000116514","1",32936445,32964685,28240
"4565","ENSG00000116521","1",155255979,155262430,6451
"4566","ENSG00000116525","1",33145399,33182059,36660
"4567","ENSG00000116539","1",155335268,155562807,227539
"4568","ENSG00000116544","1",34865436,34929650,64214
"4569","ENSG00000116560","1",35176378,35193145,16767
"4570","ENSG00000116574","1",228735479,228746664,11185
"4571","ENSG00000116580","1",155749662,155859400,109738
"4572","ENSG00000116584","1",155946851,156007070,60219
"4573","ENSG00000116586","1",156054752,156058510,3758
"4574","ENSG00000116604","1",156463727,156500779,37052
"4575","ENSG00000116641","1",62454298,62688368,234070
"4576","ENSG00000116649","1",11054584,11060020,5436
"4577","ENSG00000116652","1",63547082,63550636,3554
"4578","ENSG00000116661","1",11637018,11655785,18767
"4579","ENSG00000116663","1",11664200,11674354,10154
"4580","ENSG00000116667","1",184387029,184629019,241990
"4581","ENSG00000116668","1",185157080,185291781,134701
"4582","ENSG00000116670","1",11674480,11691650,17170
"4583","ENSG00000116675","1",65248219,65415871,167652
"4584","ENSG00000116678","1",65420652,65641559,220907
"4585","ENSG00000116679","1",185296388,185317273,20885
"4586","ENSG00000116685","1",11919591,11926428,6837
"4587","ENSG00000116688","1",11980181,12013514,33333
"4588","ENSG00000116690","1",186296279,186314562,18283
"4589","ENSG00000116691","1",12019466,12032045,12579
"4590","ENSG00000116698","1",183472216,183598246,126030
"4591","ENSG00000116701","1",183555563,183590876,35313
"4592","ENSG00000116703","1",186443566,186461122,17556
"4593","ENSG00000116704","1",66999350,67054148,54798
"4594","ENSG00000116711","1",186828949,186988981,160032
"4595","ENSG00000116717","1",67685201,67688334,3133
"4596","ENSG00000116721","1",12791397,12796628,5231
"4597","ENSG00000116726","1",12774841,12777906,3065
"4598","ENSG00000116729","1",68098473,68233120,134647
"4599","ENSG00000116731","1",13700198,13825079,124881
"4600","ENSG00000116741","1",192809039,192812275,3236
"4601","ENSG00000116745","1",68428822,68449954,21132
"4602","ENSG00000116747","1",193059422,193091777,32355
"4603","ENSG00000116748","1",114673090,114695618,22528
"4604","ENSG00000116750","1",193012250,193060080,47830
"4605","ENSG00000116752","1",114567557,114581629,14072
"4606","ENSG00000116754","1",70205682,70253052,47370
"4607","ENSG00000116761","1",70411218,70439851,28633
"4608","ENSG00000116771","1",15571699,15585051,13352
"4609","ENSG00000116774","1",113979391,114035572,56181
"4610","ENSG00000116783","1",74235387,74544428,309041
"4611","ENSG00000116785","1",196774795,196795406,20611
"4612","ENSG00000116786","1",15684320,15734769,50449
"4613","ENSG00000116791","1",74705482,74733408,27926
"4614","ENSG00000116793","1",113696831,113759489,62658
"4615","ENSG00000116809","1",15941869,15976132,34263
"4616","ENSG00000116815","1",116514534,116571039,56505
"4617","ENSG00000116819","1",35573314,35595328,22014
"4618","ENSG00000116824","1",116754430,116769229,14799
"4619","ENSG00000116830","1",117060326,117107453,47127
"4620","ENSG00000116833","1",200027614,200177420,149806
"4621","ENSG00000116852","1",200969390,201023700,54310
"4622","ENSG00000116857","1",201134772,201171574,36802
"4623","ENSG00000116863","1",36088892,36093932,5040
"4624","ENSG00000116871","1",36155579,36180849,25270
"4625","ENSG00000116874","1",119031216,119140671,109455
"4626","ENSG00000116882","1",119368779,119394130,25351
"4627","ENSG00000116883","1",36323734,36329221,5487
"4628","ENSG00000116885","1",36415827,36450451,34624
"4629","ENSG00000116898","1",36455718,36464384,8666
"4630","ENSG00000116903","1",231332753,231337852,5099
"4631","ENSG00000116906","1",231241207,231277973,36766
"4632","ENSG00000116918","1",231528541,231566524,37983
"4633","ENSG00000116922","1",37681570,37692249,10679
"4634","ENSG00000116954","1",38838198,38859772,21574
"4635","ENSG00000116962","1",235975830,236065109,89279
"4636","ENSG00000116977","1",236518000,236552981,34981
"4637","ENSG00000116981","1",39659121,39672038,12917
"4638","ENSG00000116983","1",39678648,39691485,12837
"4639","ENSG00000116984","1",236795292,236921278,125986
"4640","ENSG00000116985","1",39757182,39788865,31683
"4641","ENSG00000116990","1",39895426,39902256,6830
"4642","ENSG00000116991","1",232397965,232561558,163593
"4643","ENSG00000117000","1",40161387,40240921,79534
"4644","ENSG00000117009","1",241532134,241595642,63508
"4645","ENSG00000117010","1",40531573,40548167,16594
"4646","ENSG00000117013","1",40783787,40840452,56665
"4647","ENSG00000117016","1",40620680,40665682,45002
"4648","ENSG00000117020","1",243488233,243851079,362846
"4649","ENSG00000117036","1",157121191,157138474,17283
"4650","ENSG00000117054","1",75724347,75787575,63228
"4651","ENSG00000117069","1",76867480,77067546,200066
"4652","ENSG00000117090","1",160608106,160647295,39189
"4653","ENSG00000117091","1",160678746,160711831,33085
"4654","ENSG00000117114","1",81306160,81992436,686276
"4655","ENSG00000117115","1",17066761,17119451,52690
"4656","ENSG00000117118","1",17018722,17054170,35448
"4657","ENSG00000117122","1",16974502,16980835,6333
"4658","ENSG00000117133","1",84479259,84498352,19093
"4659","ENSG00000117139","1",202724495,202809470,84975
"4660","ENSG00000117143","1",162561506,162599842,38336
"4661","ENSG00000117148","1",17755333,17827063,71730
"4662","ENSG00000117151","1",84549611,84574480,24869
"4663","ENSG00000117152","1",163068775,163076802,8027
"4664","ENSG00000117153","1",202891116,202928636,37520
"4665","ENSG00000117154","1",18107798,18378483,270685
"4666","ENSG00000117155","1",84643707,84690803,47096
"4667","ENSG00000117174","1",85649417,85708433,59016
"4668","ENSG00000117215","1",20111939,20119566,7627
"4669","ENSG00000117222","1",205086142,205122015,35873
"4670","ENSG00000117226","1",89006679,89022894,16215
"4671","ENSG00000117228","1",89052319,89065230,12911
"4672","ENSG00000117242","1",20642657,20652193,9536
"4673","ENSG00000117245","1",20664014,20718017,54003
"4674","ENSG00000117262","1",145607988,145670650,62662
"4675","ENSG00000117266","1",205504595,205532793,28198
"4676","ENSG00000117280","1",205767986,205775482,7496
"4677","ENSG00000117281","1",145719471,145739288,19817
"4678","ENSG00000117298","1",21217247,21345572,128325
"4679","ENSG00000117305","1",23801885,23838620,36735
"4680","ENSG00000117308","1",23795599,23800781,5182
"4681","ENSG00000117318","1",23557926,23559501,1575
"4682","ENSG00000117322","1",207454230,207489895,35665
"4683","ENSG00000117335","1",207752057,207795513,43456
"4684","ENSG00000117360","1",150321479,150353233,31754
"4685","ENSG00000117362","1",150265399,150269580,4181
"4686","ENSG00000117385","1",42746335,42767084,20749
"4687","ENSG00000117394","1",42925375,42959176,33801
"4688","ENSG00000117395","1",43164175,43270936,106761
"4689","ENSG00000117399","1",43358981,43363203,4222
"4690","ENSG00000117400","1",43337849,43352772,14923
"4691","ENSG00000117407","1",43933320,43937240,3920
"4692","ENSG00000117408","1",43946950,43968022,21072
"4693","ENSG00000117410","1",43974487,43978295,3808
"4694","ENSG00000117411","1",43978943,43991170,12227
"4695","ENSG00000117419","1",44221070,44355260,134190
"4696","ENSG00000117425","1",44819844,44843253,23409
"4697","ENSG00000117448","1",45550543,45570049,19506
"4698","ENSG00000117450","1",45511036,45523047,12011
"4699","ENSG00000117461","1",46040140,46133036,92896
"4700","ENSG00000117472","1",46175073,46185962,10889
"4701","ENSG00000117475","1",169367970,169396540,28570
"4702","ENSG00000117477","1",169394870,169460669,65799
"4703","ENSG00000117479","1",169463909,169485944,22035
"4704","ENSG00000117480","1",46394317,46413848,19531
"4705","ENSG00000117481","1",46340177,46365152,24975
"4706","ENSG00000117500","1",93149742,93180516,30774
"4707","ENSG00000117501","1",170935471,171064765,129294
"4708","ENSG00000117505","1",93345907,93369493,23586
"4709","ENSG00000117507","1",171137740,171161568,23828
"4710","ENSG00000117519","1",94896949,94927223,30274
"4711","ENSG00000117523","1",171485551,171593511,107960
"4712","ENSG00000117525","1",94529173,94541759,12586
"4713","ENSG00000117528","1",94418389,94518666,100277
"4714","ENSG00000117533","1",171700160,171742074,41914
"4715","ENSG00000117543","1",100989623,101026088,36465
"4716","ENSG00000117560","1",172659103,172666876,7773
"4717","ENSG00000117569","1",96721665,96823738,102073
"4718","ENSG00000117586","1",173183731,173207331,23600
"4719","ENSG00000117592","1",173477330,173488815,11485
"4720","ENSG00000117593","1",173824653,173858808,34155
"4721","ENSG00000117594","1",209686178,209734949,48771
"4722","ENSG00000117595","1",209785617,209806175,20558
"4723","ENSG00000117597","1",209827972,209857565,29593
"4724","ENSG00000117598","1",98890245,99005032,114787
"4725","ENSG00000117600","1",99263953,99309590,45637
"4726","ENSG00000117601","1",173903804,173917378,13574
"4727","ENSG00000117602","1",24502351,24541040,38689
"4728","ENSG00000117614","1",25222276,25232502,10226
"4729","ENSG00000117616","1",25242249,25338213,95964
"4730","ENSG00000117620","1",99969351,100035634,66283
"4731","ENSG00000117625","1",211258377,211316385,58008
"4732","ENSG00000117632","1",25884181,25906991,22810
"4733","ENSG00000117640","1",25818640,25832942,14302
"4734","ENSG00000117643","1",25617468,25786207,168739
"4735","ENSG00000117650","1",211658657,211675630,16973
"4736","ENSG00000117676","1",26529761,26575030,45269
"4737","ENSG00000117682","1",26432282,26471306,39024
"4738","ENSG00000117691","1",212432920,212446379,13459
"4739","ENSG00000117697","1",212726153,212791782,65629
"4740","ENSG00000117707","1",213983181,214041502,58321
"4741","ENSG00000117713","1",26693236,26782104,88868
"4742","ENSG00000117724","1",214603195,214664571,61376
"4743","ENSG00000117748","1",27891524,27914746,23222
"4744","ENSG00000117751","1",27830782,27851676,20894
"4745","ENSG00000117758","1",27773219,27824443,51224
"4746","ENSG00000117791","1",220748225,220784815,36590
"4747","ENSG00000117834","1",48222685,48248644,25959
"4748","ENSG00000117859","1",51577179,51798427,221248
"4749","ENSG00000117862","1",52020131,52056171,36040
"4750","ENSG00000117868","7",158730995,158830253,99258
"4751","ENSG00000117877","19",45406209,45410766,4557
"4752","ENSG00000117899","15",80946289,80989828,43539
"4753","ENSG00000117906","15",76931738,76954393,22655
"4754","ENSG00000117971","15",78624111,78727754,103643
"4755","ENSG00000117983","11",1223066,1262172,39106
"4756","ENSG00000117984","11",1752755,1764573,11818
"4757","ENSG00000118004","2",3594832,3644644,49812
"4758","ENSG00000118007","3",136336236,136752403,416167
"4759","ENSG00000118017","3",138123718,138132387,8669
"4760","ENSG00000118046","19",1177558,1228435,50877
"4761","ENSG00000118058","11",118436464,118526832,90368
"4762","ENSG00000118094","11",118657316,118679690,22374
"4763","ENSG00000118096","11",118544528,118572970,28442
"4764","ENSG00000118113","11",102711796,102727050,15254
"4765","ENSG00000118137","11",116835751,116837950,2199
"4766","ENSG00000118156","19",47520685,47555856,35171
"4767","ENSG00000118160","19",47428017,47471893,43876
"4768","ENSG00000118162","19",47475150,47484265,9115
"4769","ENSG00000118181","11",119015712,119018691,2979
"4770","ENSG00000118193","1",200551497,200620751,69254
"4771","ENSG00000118194","1",201359008,201377764,18756
"4772","ENSG00000118197","1",200623896,200669907,46011
"4773","ENSG00000118200","1",200739558,200860704,121146
"4774","ENSG00000118217","1",161766320,161964070,197750
"4775","ENSG00000118231","2",208121607,208124524,2917
"4776","ENSG00000118242","2",215942584,216034096,91512
"4777","ENSG00000118245","2",216859458,216860064,606
"4778","ENSG00000118246","2",206765357,206796189,30832
"4779","ENSG00000118257","2",205681990,205798133,116143
"4780","ENSG00000118260","2",207529737,207605988,76251
"4781","ENSG00000118263","2",207074137,207167267,93130
"4782","ENSG00000118271","18",31557010,31599021,42011
"4783","ENSG00000118276","18",31622247,31685836,63589
"4784","ENSG00000118292","1",150268200,150280916,12716
"4785","ENSG00000118298","1",150257251,150265078,7827
"4786","ENSG00000118307","12",25108289,25195162,86873
"4787","ENSG00000118308","12",25004342,25108334,103992
"4788","ENSG00000118322","5",160563120,160852214,289094
"4789","ENSG00000118363","11",74949247,74979033,29786
"4790","ENSG00000118369","11",78188812,78215232,26420
"4791","ENSG00000118402","6",79914814,79947553,32739
"4792","ENSG00000118407","6",75291859,75493800,201941
"4793","ENSG00000118412","6",89829894,89874436,44542
"4794","ENSG00000118418","6",79201245,79234738,33493
"4795","ENSG00000118420","6",82892390,83065841,173451
"4796","ENSG00000118432","6",88139864,88166359,26495
"4797","ENSG00000118434","6",88047841,88066838,18997
"4798","ENSG00000118454","1",70258999,70354734,95735
"4799","ENSG00000118473","1",66533383,66751139,217756
"4800","ENSG00000118482","6",63635820,63779336,143516
"4801","ENSG00000118491","6",143864436,143938356,73920
"4802","ENSG00000118492","6",146598967,146815462,216495
"4803","ENSG00000118495","6",143940300,144064599,124299
"4804","ENSG00000118496","6",145793502,145814795,21293
"4805","ENSG00000118503","6",137867214,137883312,16098
"4806","ENSG00000118507","6",131135467,131283535,148068
"4807","ENSG00000118508","6",146543833,146554953,11120
"4808","ENSG00000118513","6",135181308,135219173,37865
"4809","ENSG00000118514","6",134917393,134950115,32722
"4810","ENSG00000118515","6",134169246,134318112,148866
"4811","ENSG00000118518","6",127266610,127288567,21957
"4812","ENSG00000118520","6",131573144,131584332,11188
"4813","ENSG00000118523","6",131948176,131951372,3196
"4814","ENSG00000118526","6",133889138,133895553,6415
"4815","ENSG00000118557","16",72112157,72176878,64721
"4816","ENSG00000118564","4",15604539,15681679,77140
"4817","ENSG00000118579","4",17614641,17634105,19464
"4818","ENSG00000118596","12",59596029,59789855,193826
"4819","ENSG00000118600","12",63779803,63809558,29755
"4820","ENSG00000118620","19",21020634,21060050,39416
"4821","ENSG00000118640","2",85561562,85582031,20469
"4822","ENSG00000118655","1",113905213,113914086,8873
"4823","ENSG00000118680","18",3261479,3278431,16952
"4824","ENSG00000118689","6",108559835,108684774,124939
"4825","ENSG00000118690","6",108848416,108974476,126060
"4826","ENSG00000118702","20",37251082,37261835,10753
"4827","ENSG00000118705","20",37178410,37241619,63209
"4828","ENSG00000118707","20",36573488,36593950,20462
"4829","ENSG00000118729","1",115700007,115768781,68774
"4830","ENSG00000118733","1",101802574,101997030,194456
"4831","ENSG00000118762","4",88007635,88077777,70142
"4832","ENSG00000118777","4",88090150,88231628,141478
"4833","ENSG00000118785","4",87975650,87983426,7776
"4834","ENSG00000118804","4",76306026,76311599,5573
"4835","ENSG00000118816","4",77047155,77075989,28834
"4836","ENSG00000118849","3",158696892,158732489,35597
"4837","ENSG00000118855","3",158732198,158829719,97521
"4838","ENSG00000118873","1",220148293,220272453,124160
"4839","ENSG00000118894","16",5084304,5097808,13504
"4840","ENSG00000118898","16",4882507,4960741,78234
"4841","ENSG00000118900","16",4846665,4882360,35695
"4842","ENSG00000118903","13",76928066,76928836,770
"4843","ENSG00000118922","13",73686089,73995056,308967
"4844","ENSG00000118939","13",75549480,75606020,56540
"4845","ENSG00000118946","13",57631744,57729311,97567
"4846","ENSG00000118960","2",20560448,20651130,90682
"4847","ENSG00000118961","2",20684014,20823130,139116
"4848","ENSG00000118965","2",19910260,19990131,79871
"4849","ENSG00000118971","12",4273762,4305353,31591
"4850","ENSG00000118972","12",4368227,4379728,11501
"4851","ENSG00000118976","12",3839459,3842525,3066
"4852","ENSG00000118985","5",95885098,95961851,76753
"4853","ENSG00000118990","5",161751448,161751768,320
"4854","ENSG00000118997","2",195737703,196068837,331134
"4855","ENSG00000119004","2",203238940,203305611,66671
"4856","ENSG00000119013","2",201071433,201085750,14317
"4857","ENSG00000119041","2",196763035,196799725,36690
"4858","ENSG00000119042","2",199269500,199471266,201766
"4859","ENSG00000119048","5",134371179,134391992,20813
"4860","ENSG00000119121","9",74722495,74888094,165599
"4861","ENSG00000119125","9",72114595,72257193,142598
"4862","ENSG00000119138","9",70384597,70414624,30027
"4863","ENSG00000119139","9",69121264,69274615,153351
"4864","ENSG00000119147","2",106063246,106078155,14909
"4865","ENSG00000119185","2",9403475,9423547,20072
"4866","ENSG00000119203","2",9423651,9473101,49450
"4867","ENSG00000119227","3",196946356,196969060,22704
"4868","ENSG00000119231","3",196867856,196934714,66858
"4869","ENSG00000119242","12",123918660,123972831,54171
"4870","ENSG00000119280","1",230837119,230869589,32470
"4871","ENSG00000119283","1",231162112,231221556,59444
"4872","ENSG00000119285","1",236549005,236604516,55511
"4873","ENSG00000119314","9",112217716,112333667,115951
"4874","ENSG00000119318","9",107283137,107332192,49055
"4875","ENSG00000119321","9",113161006,113221318,60312
"4876","ENSG00000119326","9",108942569,109013522,70953
"4877","ENSG00000119328","9",108934400,108950744,16344
"4878","ENSG00000119333","9",128633661,128656787,23126
"4879","ENSG00000119335","9",128683424,128696400,12976
"4880","ENSG00000119383","9",129110950,129148946,37996
"4881","ENSG00000119392","9",128504700,128542288,37588
"4882","ENSG00000119396","9",121178133,121223014,44881
"4883","ENSG00000119397","9",121074863,121177610,102747
"4884","ENSG00000119401","9",116687302,116701300,13998
"4885","ENSG00000119402","9",120751978,120793416,41438
"4886","ENSG00000119403","9",120855651,120894896,39245
"4887","ENSG00000119408","9",124257606,124353307,95701
"4888","ENSG00000119411","9",113349541,113371233,21692
"4889","ENSG00000119414","9",125146573,125189939,43366
"4890","ENSG00000119421","9",122144058,122159779,15721
"4891","ENSG00000119431","9",113373419,113376999,3580
"4892","ENSG00000119440","9",133224905,133228591,3686
"4893","ENSG00000119446","9",122237622,122264840,27218
"4894","ENSG00000119457","9",112878920,112890876,11956
"4895","ENSG00000119471","9",112380080,112472405,92325
"4896","ENSG00000119487","9",125437393,125707234,269841
"4897","ENSG00000119508","9",99821855,99866891,45036
"4898","ENSG00000119509","9",100099243,100302175,202932
"4899","ENSG00000119514","9",98807670,98850081,42411
"4900","ENSG00000119522","9",123379654,123930152,550498
"4901","ENSG00000119523","9",99216425,99221942,5517
"4902","ENSG00000119535","1",36466043,36483278,17235
"4903","ENSG00000119537","18",63327726,63367228,39502
"4904","ENSG00000119541","18",63389190,63422483,33293
"4905","ENSG00000119547","18",57435374,57491298,55924
"4906","ENSG00000119559","19",1461143,1479556,18413
"4907","ENSG00000119574","19",58513530,58538911,25381
"4908","ENSG00000119596","14",74763316,74859435,96119
"4909","ENSG00000119599","14",72926332,72959703,33371
"4910","ENSG00000119608","14",74852871,74871940,19069
"4911","ENSG00000119614","14",74239449,74262738,23289
"4912","ENSG00000119616","14",74713144,74738620,25476
"4913","ENSG00000119630","14",74941834,74955626,13792
"4914","ENSG00000119632","14",94127779,94130253,2474
"4915","ENSG00000119636","14",74019349,74082863,63514
"4916","ENSG00000119638","14",75079353,75127344,47991
"4917","ENSG00000119640","14",75053237,75069483,16246
"4918","ENSG00000119650","14",75902136,76084585,182449
"4919","ENSG00000119655","14",74476192,74494177,17985
"4920","ENSG00000119661","14",73644875,73703732,58857
"4921","ENSG00000119669","14",77024543,77028708,4165
"4922","ENSG00000119673","14",73567620,73575658,8038
"4923","ENSG00000119681","14",74498183,74612378,114195
"4924","ENSG00000119682","14",74653437,74713108,59671
"4925","ENSG00000119684","14",75013764,75051532,37768
"4926","ENSG00000119685","14",75633625,75955079,321454
"4927","ENSG00000119686","14",75578620,75663214,84594
"4928","ENSG00000119688","14",74285269,74303055,17786
"4929","ENSG00000119689","14",74881891,74903743,21852
"4930","ENSG00000119698","14",94146128,94279734,133606
"4931","ENSG00000119699","14",75958099,75982991,24892
"4932","ENSG00000119703","14",75064170,75079988,15818
"4933","ENSG00000119705","14",77708071,77761104,53033
"4934","ENSG00000119707","14",73058532,73123899,65367
"4935","ENSG00000119711","14",74056850,74084493,27643
"4936","ENSG00000119714","14",91232532,91253925,21393
"4937","ENSG00000119715","14",76310712,76501837,191125
"4938","ENSG00000119718","14",75002921,75012366,9445
"4939","ENSG00000119720","14",90267860,90331969,64109
"4940","ENSG00000119723","14",73949926,73963670,13744
"4941","ENSG00000119725","14",73886617,73932511,45894
"4942","ENSG00000119729","2",46541806,46584688,42882
"4943","ENSG00000119737","2",53852913,53859989,7076
"4944","ENSG00000119760","2",27650809,27663840,13031
"4945","ENSG00000119771","2",23385179,23708611,323432
"4946","ENSG00000119772","2",25227855,25342590,114735
"4947","ENSG00000119777","2",27032910,27041694,8784
"4948","ENSG00000119778","2",23748664,23927123,178459
"4949","ENSG00000119782","2",24049701,24063681,13980
"4950","ENSG00000119787","2",38293954,38377285,83331
"4951","ENSG00000119801","2",30146941,30160533,13592
"4952","ENSG00000119812","2",33583660,33599382,15722
"4953","ENSG00000119820","2",32277904,32316594,38690
"4954","ENSG00000119844","2",64524305,64593005,68700
"4955","ENSG00000119862","2",64453969,64461381,7412
"4956","ENSG00000119865","2",68284171,68320051,35880
"4957","ENSG00000119866","2",60450520,60555154,104634
"4958","ENSG00000119878","2",46616416,46625742,9326
"4959","ENSG00000119888","2",47345158,47387601,42443
"4960","ENSG00000119899","6",73593379,73653992,60613
"4961","ENSG00000119900","6",71288811,71309059,20248
"4962","ENSG00000119906","10",100912963,100965134,52171
"4963","ENSG00000119912","10",92451684,92574076,122392
"4964","ENSG00000119913","10",112283400,112305038,21638
"4965","ENSG00000119915","10",102226299,102229589,3290
"4966","ENSG00000119917","10",89327997,89340971,12974
"4967","ENSG00000119919","10",99532942,99536524,3582
"4968","ENSG00000119922","10",89283694,89309271,25577
"4969","ENSG00000119927","10",112149865,112215377,65512
"4970","ENSG00000119929","10",99702558,99756134,53576
"4971","ENSG00000119938","10",91628442,91633071,4629
"4972","ENSG00000119943","10",98383565,98415182,31617
"4973","ENSG00000119946","10",99329356,99394330,64974
"4974","ENSG00000119950","10",110207605,110287365,79760
"4975","ENSG00000119953","10",110290730,110304951,14221
"4976","ENSG00000119965","10",122930901,122954311,23410
"4977","ENSG00000119969","10",94501434,94613905,112471
"4978","ENSG00000119973","10",118589997,118595648,5651
"4979","ENSG00000119977","10",95663396,95694143,30747
"4980","ENSG00000119979","10",119104086,119137984,33898
"4981","ENSG00000119986","10",97677424,97687241,9817
"4982","ENSG00000120008","10",120851305,120909524,58219
"4983","ENSG00000120029","10",101845599,102056193,210594
"4984","ENSG00000120049","10",101825974,101843920,17946
"4985","ENSG00000120051","10",104353833,104455102,101269
"4986","ENSG00000120053","10",99396870,99430624,33754
"4987","ENSG00000120054","10",100042193,100081877,39684
"4988","ENSG00000120055","10",102449837,102451543,1706
"4989","ENSG00000120057","10",97766751,97771999,5248
"4990","ENSG00000120063","17",65009289,65056740,47451
"4991","ENSG00000120068","17",48611377,48614939,3562
"4992","ENSG00000120071","17",46029916,46225389,195473
"4993","ENSG00000120075","17",48591257,48593961,2704
"4994","ENSG00000120088","17",45784280,45835828,51548
"4995","ENSG00000120093","17",48548870,48604912,56042
"4996","ENSG00000120094","17",48528526,48531011,2485
"4997","ENSG00000120129","5",172768096,172771195,3099
"4998","ENSG00000120137","5",168548495,168579368,30873
"4999","ENSG00000120149","5",174724582,174730896,6314
"5000","ENSG00000120156","9",27109141,27230174,121033
"5001","ENSG00000120158","9",4792944,4885917,92973
"5002","ENSG00000120159","9",26840685,26892803,52118
"5003","ENSG00000120160","9",27284654,27297150,12496
"5004","ENSG00000120162","9",27325209,27529814,204605
"5005","ENSG00000120210","9",5123880,5185647,61767
"5006","ENSG00000120211","9",5231419,5235304,3885
"5007","ENSG00000120215","9",5890802,5910606,19804
"5008","ENSG00000120217","9",5450503,5470566,20063
"5009","ENSG00000120235","9",21349835,21351378,1543
"5010","ENSG00000120251","4",157204182,157366075,161893
"5011","ENSG00000120253","6",149724315,149749665,25350
"5012","ENSG00000120254","6",150865549,151101887,236338
"5013","ENSG00000120256","6",149818798,149864026,45228
"5014","ENSG00000120262","6",151494017,151621193,127176
"5015","ENSG00000120265","6",149749443,149811420,61977
"5016","ENSG00000120278","6",150599883,150843665,243782
"5017","ENSG00000120279","6",152697895,152724567,26672
"5018","ENSG00000120280","X",30558824,30577844,19020
"5019","ENSG00000120289","X",30242052,30244193,2141
"5020","ENSG00000120306","5",140175156,140282052,106896
"5021","ENSG00000120314","5",140664676,140674124,9448
"5022","ENSG00000120318","5",141653401,141682230,28829
"5023","ENSG00000120322","5",141177790,141180529,2739
"5024","ENSG00000120324","5",141192353,141195642,3289
"5025","ENSG00000120327","5",141222932,141227759,4827
"5026","ENSG00000120328","5",141208697,141212571,3874
"5027","ENSG00000120329","5",141302629,141304045,1416
"5028","ENSG00000120332","1",175067858,175148066,80208
"5029","ENSG00000120333","1",175010789,175023425,12636
"5030","ENSG00000120334","1",173799550,173824720,25170
"5031","ENSG00000120337","1",173039960,173050963,11003
"5032","ENSG00000120341","1",177923956,177984303,60347
"5033","ENSG00000120370","1",170532129,170553446,21317
"5034","ENSG00000120436","6",167156271,167158329,2058
"5035","ENSG00000120437","6",159760328,159779055,18727
"5036","ENSG00000120438","6",159778498,159789703,11205
"5037","ENSG00000120440","6",167325071,167359503,34432
"5038","ENSG00000120451","11",130875436,130916509,41073
"5039","ENSG00000120457","11",128891356,128921163,29807
"5040","ENSG00000120458","11",124766498,124800673,34175
"5041","ENSG00000120471","11",128934731,128943399,8668
"5042","ENSG00000120498","X",70528940,70908731,379791
"5043","ENSG00000120500","X",70268305,70281840,13535
"5044","ENSG00000120509","X",70286595,70290514,3919
"5045","ENSG00000120519","4",146253975,146521964,267989
"5046","ENSG00000120526","8",109240919,109334118,93199
"5047","ENSG00000120533","8",109334324,109345954,11630
"5048","ENSG00000120539","10",27154824,27186924,32100
"5049","ENSG00000120549","10",23694746,24547848,853102
"5050","ENSG00000120555","10",38383069,38402916,19847
"5051","ENSG00000120563","10",29289061,29318328,29267
"5052","ENSG00000120594","10",19816239,20289856,473617
"5053","ENSG00000120616","10",32267751,32378798,111047
"5054","ENSG00000120645","12",66765,178460,111695
"5055","ENSG00000120647","12",389273,442642,53369
"5056","ENSG00000120656","1",28589323,28643085,53762
"5057","ENSG00000120658","13",43213518,43786908,573390
"5058","ENSG00000120659","13",42562736,42608013,45277
"5059","ENSG00000120662","13",41216369,41263577,47208
"5060","ENSG00000120664","13",36346431,36369601,23170
"5061","ENSG00000120669","13",36168217,36214588,46371
"5062","ENSG00000120675","13",43023203,43114213,91010
"5063","ENSG00000120685","13",39009865,39038089,28224
"5064","ENSG00000120686","13",38349849,38363619,13770
"5065","ENSG00000120688","13",41061509,41084006,22497
"5066","ENSG00000120690","13",40931924,41061440,129516
"5067","ENSG00000120693","13",36844831,36920765,75934
"5068","ENSG00000120694","13",31134974,31162388,27414
"5069","ENSG00000120696","13",41189833,41194566,4733
"5070","ENSG00000120697","13",36949738,37000261,50523
"5071","ENSG00000120699","13",36998816,37009614,10798
"5072","ENSG00000120705","5",138506095,138543236,37141
"5073","ENSG00000120708","5",136028988,136063818,34830
"5074","ENSG00000120709","5",138331935,138349729,17794
"5075","ENSG00000120725","5",138946724,139293557,346833
"5076","ENSG00000120727","5",139341587,139369720,28133
"5077","ENSG00000120729","5",137867791,137887851,20060
"5078","ENSG00000120733","5",138352685,138437028,84343
"5079","ENSG00000120738","5",138465479,138469303,3824
"5080","ENSG00000120742","3",150541998,150603228,61230
"5081","ENSG00000120756","3",142596393,142713664,117271
"5082","ENSG00000120784","19",37613749,37692337,78588
"5083","ENSG00000120798","12",95020229,95073628,53399
"5084","ENSG00000120800","12",101280105,101386618,106513
"5085","ENSG00000120802","12",98515512,98550379,34867
"5086","ENSG00000120805","12",101393116,101407772,14656
"5087","ENSG00000120820","12",103988984,104064183,75199
"5088","ENSG00000120832","12",106977277,106987160,9883
"5089","ENSG00000120833","12",93569814,93583487,13673
"5090","ENSG00000120837","12",104117086,104138241,21155
"5091","ENSG00000120860","12",102012927,102062149,49222
"5092","ENSG00000120868","12",98645141,98735433,90292
"5093","ENSG00000120875","8",29333064,29350684,17620
"5094","ENSG00000120885","8",27596917,27615031,18114
"5095","ENSG00000120889","8",23020133,23069031,48898
"5096","ENSG00000120896","8",22544986,22575788,30802
"5097","ENSG00000120899","8",27311482,27459391,147909
"5098","ENSG00000120903","8",27459756,27479883,20127
"5099","ENSG00000120907","8",26748150,26867273,119123
"5100","ENSG00000120910","8",22440819,22541142,100323
"5101","ENSG00000120913","8",22578279,22598025,19746
"5102","ENSG00000120915","8",27490779,27545564,54785
"5103","ENSG00000120925","8",42849637,42897290,47653
"5104","ENSG00000120937","1",11857464,11858945,1481
"5105","ENSG00000120942","1",11273206,11296049,22843
"5106","ENSG00000120948","1",11012344,11026420,14076
"5107","ENSG00000120949","1",12063303,12144207,80904
"5108","ENSG00000120952","1",12857086,12861909,4823
"5109","ENSG00000120963","8",101177878,101206193,28315
"5110","ENSG00000120992","8",54046367,54102017,55650
"5111","ENSG00000121005","8",74984505,75034558,50053
"5112","ENSG00000121022","8",67043079,67083783,40704
"5113","ENSG00000121039","8",73294602,73325281,30679
"5114","ENSG00000121053","17",58192726,58205174,12448
"5115","ENSG00000121057","17",57085092,57121346,36254
"5116","ENSG00000121058","17",56938199,56961050,22851
"5117","ENSG00000121060","17",56836387,56914080,77693
"5118","ENSG00000121064","17",56978105,57006768,28663
"5119","ENSG00000121067","17",49598884,49678163,79279
"5120","ENSG00000121068","17",61399843,61409466,9623
"5121","ENSG00000121073","17",49700934,49709014,8080
"5122","ENSG00000121075","17",61452404,61485110,32706
"5123","ENSG00000121089","4",164943290,164943937,647
"5124","ENSG00000121101","17",58556678,58692055,135377
"5125","ENSG00000121104","17",49710332,49789180,78848
"5126","ENSG00000121152","2",96335766,96377091,41325
"5127","ENSG00000121207","4",154626945,154753120,126175
"5128","ENSG00000121210","4",153466346,153636711,170365
"5129","ENSG00000121211","4",153344649,153415118,70469
"5130","ENSG00000121236","11",5596109,5612958,16849
"5131","ENSG00000121270","16",48166910,48247568,80658
"5132","ENSG00000121274","16",50152918,50235310,82392
"5133","ENSG00000121281","16",50246137,50318135,71998
"5134","ENSG00000121289","19",32875925,32971991,96066
"5135","ENSG00000121297","19",31149979,31349547,199568
"5136","ENSG00000121310","1",52895910,52927212,31302
"5137","ENSG00000121314","12",10806051,10807293,1242
"5138","ENSG00000121316","12",14503661,14567883,64222
"5139","ENSG00000121318","12",10825317,10826358,1041
"5140","ENSG00000121335","12",11391540,11501041,109501
"5141","ENSG00000121350","12",21437615,21471250,33635
"5142","ENSG00000121351","12",21354959,21379978,25019
"5143","ENSG00000121361","12",21764955,21775600,10645
"5144","ENSG00000121377","12",10801532,10802627,1095
"5145","ENSG00000121380","12",12049844,12211084,161240
"5146","ENSG00000121381","12",10809094,10810168,1074
"5147","ENSG00000121388","13",19185225,19187349,2124
"5148","ENSG00000121390","13",19674752,19783019,108267
"5149","ENSG00000121406","19",57527325,57557542,30217
"5150","ENSG00000121410","19",58345178,58353499,8321
"5151","ENSG00000121413","19",58083838,58118427,34589
"5152","ENSG00000121417","19",57630395,57644041,13646
"5153","ENSG00000121440","3",73382431,73624941,242510
"5154","ENSG00000121446","1",182409192,182560599,151407
"5155","ENSG00000121454","1",180230264,180278984,48720
"5156","ENSG00000121481","1",185045526,185102603,57077
"5157","ENSG00000121486","1",185118101,185157072,38971
"5158","ENSG00000121542","3",123201927,123274136,72209
"5159","ENSG00000121552","3",122325248,122341969,16721
"5160","ENSG00000121570","3",109326141,109337572,11431
"5161","ENSG00000121577","3",119636457,119665324,28867
"5162","ENSG00000121578","3",119211732,119240946,29214
"5163","ENSG00000121579","3",113716458,113746300,29842
"5164","ENSG00000121594","3",119524293,119559614,35321
"5165","ENSG00000121621","11",28020619,28108156,87537
"5166","ENSG00000121634","1",147907956,147909257,1301
"5167","ENSG00000121644","1",244653103,244709033,55930
"5168","ENSG00000121653","11",45885651,45906465,20814
"5169","ENSG00000121671","11",45847118,45883248,36130
"5170","ENSG00000121680","11",45909663,45918812,9149
"5171","ENSG00000121690","11",33015876,33033582,17706
"5172","ENSG00000121691","11",34438934,34472060,33126
"5173","ENSG00000121716","7",100352176,100367733,15557
"5174","ENSG00000121741","13",19958670,20091829,133159
"5175","ENSG00000121742","13",20221962,20232365,10403
"5176","ENSG00000121743","13",20138255,20161052,22797
"5177","ENSG00000121749","12",71839707,71927248,87541
"5178","ENSG00000121753","1",31727117,31764893,37776
"5179","ENSG00000121764","1",31617686,31632518,14832
"5180","ENSG00000121766","1",31296982,31364953,67971
"5181","ENSG00000121769","1",31365625,31376850,11225
"5182","ENSG00000121774","1",32013868,32060850,46982
"5183","ENSG00000121775","1",32072031,32102866,30835
"5184","ENSG00000121797","3",46407166,46412997,5831
"5185","ENSG00000121807","3",46353734,46360928,7194
"5186","ENSG00000121851","1",145964690,145978848,14158
"5187","ENSG00000121853","3",172445133,172448456,3323
"5188","ENSG00000121858","3",172505508,172523475,17967
"5189","ENSG00000121864","3",179323031,179338583,15552
"5190","ENSG00000121871","3",165186720,165197109,10389
"5191","ENSG00000121879","3",179148114,179240093,91979
"5192","ENSG00000121892","4",39822863,39977956,155093
"5193","ENSG00000121895","4",38966744,39032922,66178
"5194","ENSG00000121897","4",39458587,39485109,26522
"5195","ENSG00000121898","10",123706207,123940267,234060
"5196","ENSG00000121900","1",32894594,32901438,6844
"5197","ENSG00000121903","1",33472645,33496507,23862
"5198","ENSG00000121904","1",33513999,34165842,651843
"5199","ENSG00000121905","1",32885994,32898441,12447
"5200","ENSG00000121931","1",110947190,110963965,16775
"5201","ENSG00000121933","1",111483348,111563962,80614
"5202","ENSG00000121940","1",108929508,108963457,33949
"5203","ENSG00000121957","1",108875350,108934545,59195
"5204","ENSG00000121964","2",143938068,144332568,394500
"5205","ENSG00000121966","2",136114349,136118165,3816
"5206","ENSG00000121988","2",135136916,135531218,394302
"5207","ENSG00000121989","2",147844517,147930826,86309
"5208","ENSG00000122008","5",75511756,75601144,89388
"5209","ENSG00000122012","5",76083383,76353939,270556
"5210","ENSG00000122025","13",28003274,28100592,97318
"5211","ENSG00000122026","13",27251309,27256691,5382
"5212","ENSG00000122033","13",27435643,27450591,14948
"5213","ENSG00000122034","13",27424619,27435823,11204
"5214","ENSG00000122035","13",27270327,27273690,3363
"5215","ENSG00000122042","13",29764371,29850684,86313
"5216","ENSG00000122043","13",29935771,29950488,14717
"5217","ENSG00000122068","3",197737179,197787596,50417
"5218","ENSG00000122085","2",241072169,241102332,30163
"5219","ENSG00000122121","X",129738974,129769536,30562
"5220","ENSG00000122122","X",129779949,129795201,15252
"5221","ENSG00000122126","X",129539849,129592561,52712
"5222","ENSG00000122133","9",135561756,135566955,5199
"5223","ENSG00000122136","9",135546139,135549969,3830
"5224","ENSG00000122140","9",135499984,135504673,4689
"5225","ENSG00000122145","X",80014753,80031774,17021
"5226","ENSG00000122176","1",203340628,203351758,11130
"5227","ENSG00000122180","1",203083129,203086012,2883
"5228","ENSG00000122188","1",203765176,203776233,11057
"5229","ENSG00000122194","6",160702238,160753315,51077
"5230","ENSG00000122203","5",176346062,176361807,15745
"5231","ENSG00000122218","1",160288594,160343273,54679
"5232","ENSG00000122223","1",160830160,160862887,32727
"5233","ENSG00000122224","1",160796074,160828261,32187
"5234","ENSG00000122254","16",22814162,22916338,102176
"5235","ENSG00000122257","16",24537693,24572863,35170
"5236","ENSG00000122299","16",11750586,11797258,46672
"5237","ENSG00000122304","16",11275639,11276480,841
"5238","ENSG00000122335","6",158109519,158168280,58761
"5239","ENSG00000122359","10",80150889,80205572,54683
"5240","ENSG00000122367","10",86668449,86736068,67619
"5241","ENSG00000122375","10",86654547,86666848,12301
"5242","ENSG00000122376","10",87094161,87191468,97307
"5243","ENSG00000122378","10",80407829,80437115,29286
"5244","ENSG00000122386","16",3112560,3120517,7957
"5245","ENSG00000122390","16",3443649,3486953,43304
"5246","ENSG00000122406","1",92832013,92841924,9911
"5247","ENSG00000122417","1",86346824,86396342,49518
"5248","ENSG00000122420","1",78303884,78540701,236817
"5249","ENSG00000122432","1",84506300,84566194,59894
"5250","ENSG00000122435","1",100133150,100150498,17348
"5251","ENSG00000122477","1",100148449,100178273,29824
"5252","ENSG00000122481","1",95234210,95247225,13015
"5253","ENSG00000122482","1",90915298,91022272,106974
"5254","ENSG00000122483","1",93179919,93278730,98811
"5255","ENSG00000122484","1",92299059,92402056,102997
"5256","ENSG00000122490","18",79902420,79951657,49237
"5257","ENSG00000122507","7",33129244,33606068,476824
"5258","ENSG00000122512","7",5970925,6009106,38181
"5259","ENSG00000122515","7",44748581,44769881,21300
"5260","ENSG00000122543","7",5879827,5886362,6535
"5261","ENSG00000122545","7",35800932,35907105,106173
"5262","ENSG00000122547","7",36153254,36301538,148284
"5263","ENSG00000122548","7",26533121,26538788,5667
"5264","ENSG00000122550","7",23105758,23177914,72156
"5265","ENSG00000122557","7",35632659,35695571,62912
"5266","ENSG00000122565","7",26201162,26213607,12445
"5267","ENSG00000122566","7",26173057,26201529,28472
"5268","ENSG00000122574","7",29806486,29917066,110580
"5269","ENSG00000122584","7",8433609,8752961,319352
"5270","ENSG00000122585","7",24284188,24291862,7674
"5271","ENSG00000122591","7",22889371,23014130,124759
"5272","ENSG00000122592","7",27153716,27157936,4220
"5273","ENSG00000122641","7",41667168,41705834,38666
"5274","ENSG00000122642","7",32957404,33006930,49526
"5275","ENSG00000122643","7",33014114,33062797,48683
"5276","ENSG00000122644","7",12686856,12690958,4102
"5277","ENSG00000122674","7",5898725,5926550,27825
"5278","ENSG00000122678","7",44072062,44082530,10468
"5279","ENSG00000122679","7",45157791,45186302,28511
"5280","ENSG00000122687","7",2234231,2242198,7967
"5281","ENSG00000122691","7",19020991,19117636,96645
"5282","ENSG00000122692","9",33041765,33076674,34909
"5283","ENSG00000122694","9",36136536,36163913,27377
"5284","ENSG00000122696","9",37879400,37904353,24953
"5285","ENSG00000122705","9",36190856,36304781,113925
"5286","ENSG00000122707","9",36036913,36124455,87542
"5287","ENSG00000122711","9",33218365,33248567,30202
"5288","ENSG00000122728","9",32629454,32635669,6215
"5289","ENSG00000122729","9",32384603,32454769,70166
"5290","ENSG00000122733","9",34957608,34982544,24936
"5291","ENSG00000122735","9",34457414,34520988,63574
"5292","ENSG00000122741","9",37800554,37867666,67112
"5293","ENSG00000122756","9",34551432,34590140,38708
"5294","ENSG00000122778","7",138831381,138981318,149937
"5295","ENSG00000122779","7",138460259,138589996,129737
"5296","ENSG00000122783","7",135092363,135170795,78432
"5297","ENSG00000122786","7",134744252,134970729,226477
"5298","ENSG00000122787","7",138002324,138118305,115981
"5299","ENSG00000122824","X",51332231,51337525,5294
"5300","ENSG00000122852","10",79610939,79615455,4516
"5301","ENSG00000122859","10",69571698,69573238,1540
"5302","ENSG00000122861","10",73909177,73917496,8319
"5303","ENSG00000122862","10",69088103,69104805,16702
"5304","ENSG00000122863","10",71964395,72013558,49163
"5305","ENSG00000122870","10",58513140,58831437,318297
"5306","ENSG00000122872","10",60684505,60685209,704
"5307","ENSG00000122873","10",58269162,58289586,20424
"5308","ENSG00000122877","10",62811996,62919900,107904
"5309","ENSG00000122882","10",73130155,73169055,38900
"5310","ENSG00000122884","10",73007217,73096974,89757
"5311","ENSG00000122912","10",68477998,68527523,49525
"5312","ENSG00000122952","10",56357227,56361273,4046
"5313","ENSG00000122958","10",69123512,69174412,50900
"5314","ENSG00000122965","12",113816738,113966325,149587
"5315","ENSG00000122966","12",119685791,119877320,191529
"5316","ENSG00000122970","12",110124335,110218793,94458
"5317","ENSG00000122971","12",120725774,120740008,14234
"5318","ENSG00000122986","12",110627841,110704950,77109
"5319","ENSG00000123009","12",120282303,120282716,413
"5320","ENSG00000123064","12",113157174,113185479,28305
"5321","ENSG00000123066","12",115953872,116277719,323847
"5322","ENSG00000123080","1",50960745,50974634,13889
"5323","ENSG00000123091","1",51236273,51273447,37174
"5324","ENSG00000123094","12",25959029,26079892,120863
"5325","ENSG00000123095","12",26120030,26125037,5007
"5326","ENSG00000123096","12",26121991,26299290,177299
"5327","ENSG00000123104","12",26335352,26833194,497842
"5328","ENSG00000123106","12",28133249,28581511,448262
"5329","ENSG00000123119","8",90791741,90959393,167652
"5330","ENSG00000123124","8",86342738,86478420,135682
"5331","ENSG00000123130","X",23701055,23766475,65420
"5332","ENSG00000123131","X",23664262,23686397,22135
"5333","ENSG00000123136","19",14408819,14419383,10564
"5334","ENSG00000123143","19",14433053,14471867,38814
"5335","ENSG00000123144","19",12730640,12734684,4044
"5336","ENSG00000123146","19",14380501,14408725,28224
"5337","ENSG00000123154","19",12666802,12675832,9030
"5338","ENSG00000123159","19",14477760,14496149,18389
"5339","ENSG00000123165","X",128050962,128052398,1436
"5340","ENSG00000123171","13",51861981,51866232,4251
"5341","ENSG00000123178","13",49912702,49936490,23788
"5342","ENSG00000123179","13",49660674,49691486,30812
"5343","ENSG00000123191","13",51930436,52012125,81689
"5344","ENSG00000123200","13",45954465,46052759,98294
"5345","ENSG00000123201","13",50994511,51080862,86351
"5346","ENSG00000123213","5",65722205,65871725,149520
"5347","ENSG00000123219","5",65517766,65563168,45402
"5348","ENSG00000123240","10",13099449,13138308,38859
"5349","ENSG00000123243","10",7559270,7666998,107728
"5350","ENSG00000123268","12",50763710,50821162,57452
"5351","ENSG00000123297","12",57782761,57808071,25310
"5352","ENSG00000123307","12",55019974,55030017,10043
"5353","ENSG00000123329","12",57472264,57488814,16550
"5354","ENSG00000123338","12",54497752,54548243,50491
"5355","ENSG00000123342","12",55835433,55842966,7533
"5356","ENSG00000123349","12",53295291,53299450,4159
"5357","ENSG00000123352","12",49366584,49527424,160840
"5358","ENSG00000123353","12",55818041,55821879,3838
"5359","ENSG00000123358","12",52022832,52059507,36675
"5360","ENSG00000123360","12",54549601,54579239,29638
"5361","ENSG00000123364","12",53938831,53946544,7713
"5362","ENSG00000123374","12",55966781,55972789,6008
"5363","ENSG00000123384","12",57128493,57213351,84858
"5364","ENSG00000123388","12",53973126,53977643,4517
"5365","ENSG00000123395","12",52069246,52077494,8248
"5366","ENSG00000123405","12",54292111,54301015,8904
"5367","ENSG00000123407","12",53954903,53958956,4053
"5368","ENSG00000123411","12",56007659,56038435,30776
"5369","ENSG00000123415","12",54121277,54189008,67731
"5370","ENSG00000123416","12",49127782,49131397,3615
"5371","ENSG00000123427","12",57771492,57782541,11049
"5372","ENSG00000123444","11",47572197,47578976,6779
"5373","ENSG00000123447","11",49405091,49415789,10698
"5374","ENSG00000123453","9",133663560,133739955,76395
"5375","ENSG00000123454","9",133635348,133659344,23996
"5376","ENSG00000123472","1",46632737,46673867,41130
"5377","ENSG00000123473","1",47250139,47314147,64008
"5378","ENSG00000123485","2",233833416,233854566,21150
"5379","ENSG00000123496","X",115003975,115019977,16002
"5380","ENSG00000123500","6",116118909,116158747,39838
"5381","ENSG00000123505","6",110874770,110895713,20943
"5382","ENSG00000123545","6",96889315,96897891,8576
"5383","ENSG00000123552","6",99432379,99521728,89349
"5384","ENSG00000123560","X",103773718,103792619,18901
"5385","ENSG00000123561","X",106032435,106038727,6292
"5386","ENSG00000123562","X",103675496,103688158,12662
"5387","ENSG00000123569","X",104011147,104013687,2540
"5388","ENSG00000123570","X",103822327,103832257,9930
"5389","ENSG00000123572","X",105822539,105958610,136071
"5390","ENSG00000123575","X",104166453,104195902,29449
"5391","ENSG00000123576","X",104250038,104254933,4895
"5392","ENSG00000123584","X",149781930,149787737,5807
"5393","ENSG00000123594","X",13318236,13320399,2163
"5394","ENSG00000123595","X",13689125,13710506,21381
"5395","ENSG00000123600","2",171317405,171434802,117397
"5396","ENSG00000123607","2",165857475,165953816,96341
"5397","ENSG00000123609","2",151270465,151290057,19592
"5398","ENSG00000123610","2",151357592,151380046,22454
"5399","ENSG00000123612","2",157526767,157628864,102097
"5400","ENSG00000123636","2",159318979,159616569,297590
"5401","ENSG00000123643","5",151437046,151492379,55333
"5402","ENSG00000123684","1",211743457,211830763,87306
"5403","ENSG00000123685","1",212686417,212699840,13423
"5404","ENSG00000123689","1",209675412,209676390,978
"5405","ENSG00000123700","17",70168673,70180048,11375
"5406","ENSG00000123728","X",132203024,132219480,16456
"5407","ENSG00000123737","4",121801317,121817021,15704
"5408","ENSG00000123739","4",109709989,109730070,20081
"5409","ENSG00000123810","19",41354417,41364165,9748
"5410","ENSG00000123815","19",40691530,40718207,26677
"5411","ENSG00000123836","1",207034366,207081024,46658
"5412","ENSG00000123838","1",207104233,207144972,40739
"5413","ENSG00000123843","1",207088860,207099993,11133
"5414","ENSG00000123870","19",52588505,52597345,8840
"5415","ENSG00000123892","11",88113251,88175443,62192
"5416","ENSG00000123901","11",94377316,94401419,24103
"5417","ENSG00000123908","8",140520156,140635633,115477
"5418","ENSG00000123933","4",2247432,2262109,14677
"5419","ENSG00000123965","7",74894116,74897835,3719
"5420","ENSG00000123975","9",89311195,89316703,5508
"5421","ENSG00000123977","2",227871054,227924344,53290
"5422","ENSG00000123983","2",222860942,222944639,83697
"5423","ENSG00000123989","2",219538948,219543809,4861
"5424","ENSG00000123992","2",219373527,219400022,26495
"5425","ENSG00000123999","2",219569162,219575711,6549
"5426","ENSG00000124003","2",222671786,222709930,38144
"5427","ENSG00000124006","2",219550728,219571859,21131
"5428","ENSG00000124019","2",224378698,224402107,23409
"5429","ENSG00000124067","16",67943474,67969601,26127
"5430","ENSG00000124074","16",67662945,67667265,4320
"5431","ENSG00000124091","20",56491492,56525925,34433
"5432","ENSG00000124092","20",57495966,57525652,29686
"5433","ENSG00000124097","20",57488392,57489027,635
"5434","ENSG00000124098","20",56358974,56368663,9689
"5435","ENSG00000124102","20",45174902,45176544,1642
"5436","ENSG00000124103","20",56517187,56526152,8965
"5437","ENSG00000124104","20",45833799,45843276,9477
"5438","ENSG00000124107","20",45252239,45254564,2325
"5439","ENSG00000124116","20",45747944,45791932,43988
"5440","ENSG00000124120","20",44475874,44494603,18729
"5441","ENSG00000124126","20",48624252,48827999,203747
"5442","ENSG00000124134","20",45091214,45101127,9913
"5443","ENSG00000124140","20",46021690,46060152,38462
"5444","ENSG00000124143","20",38601934,38651035,49101
"5445","ENSG00000124145","20",45325288,45348424,23136
"5446","ENSG00000124151","20",47501887,47656877,154990
"5447","ENSG00000124155","20",45416084,45456934,40850
"5448","ENSG00000124157","20",45221300,45224458,3158
"5449","ENSG00000124159","20",45293445,45308529,15084
"5450","ENSG00000124160","20",46060991,46089962,28971
"5451","ENSG00000124164","20",58389122,58451101,61979
"5452","ENSG00000124171","20",50731580,50756795,25215
"5453","ENSG00000124172","20",59025475,59032345,6870
"5454","ENSG00000124177","20",41402083,41618384,216301
"5455","ENSG00000124181","20",41136960,41196801,59841
"5456","ENSG00000124191","20",43914852,44069616,154764
"5457","ENSG00000124193","20",43457893,43466046,8153
"5458","ENSG00000124194","20",44247099,44280917,33818
"5459","ENSG00000124196","20",43726164,43726998,834
"5460","ENSG00000124198","20",48921711,49036693,114982
"5461","ENSG00000124201","20",49237946,49278426,40480
"5462","ENSG00000124203","20",59123381,59259113,135732
"5463","ENSG00000124205","20",59300443,59325992,25549
"5464","ENSG00000124207","20",49046246,49096960,50714
"5465","ENSG00000124208","20",50081124,50153637,72513
"5466","ENSG00000124209","20",58309715,58367507,57792
"5467","ENSG00000124212","20",49503874,49568137,64263
"5468","ENSG00000124214","20",49113339,49188367,75028
"5469","ENSG00000124215","20",59958427,60034011,75584
"5470","ENSG00000124216","20",49982980,49988886,5906
"5471","ENSG00000124217","20",50958826,50963931,5105
"5472","ENSG00000124222","20",58651253,58679526,28273
"5473","ENSG00000124224","20",58228940,58309451,80511
"5474","ENSG00000124225","20",57648392,57711536,63144
"5475","ENSG00000124226","20",49936336,49953885,17549
"5476","ENSG00000124227","20",58218495,58228653,10158
"5477","ENSG00000124228","20",49219295,49244077,24782
"5478","ENSG00000124232","20",45306840,45317824,10984
"5479","ENSG00000124233","20",45207033,45209768,2735
"5480","ENSG00000124237","20",58150904,58161150,10246
"5481","ENSG00000124243","20",50794894,50882676,87782
"5482","ENSG00000124249","20",44745865,44752313,6448
"5483","ENSG00000124251","20",45372557,45407889,35332
"5484","ENSG00000124253","20",57561080,57568121,7041
"5485","ENSG00000124256","20",57603846,57620576,16730
"5486","ENSG00000124257","20",45888625,45891287,2662
"5487","ENSG00000124260","X",152133310,152138578,5268
"5488","ENSG00000124275","5",7851186,7906025,54839
"5489","ENSG00000124279","5",7859159,7869037,9878
"5490","ENSG00000124299","19",33386950,33521791,134841
"5491","ENSG00000124302","19",33621953,33773509,151556
"5492","ENSG00000124313","X",53225828,53321350,95522
"5493","ENSG00000124333","X",155881345,155943769,62424
"5494","ENSG00000124334","X",155997581,156010817,13236
"5495","ENSG00000124343","X",2752048,2816500,64452
"5496","ENSG00000124356","2",73828916,73873659,44743
"5497","ENSG00000124357","2",71064344,71079808,15464
"5498","ENSG00000124370","2",71109684,71130239,20555
"5499","ENSG00000124374","2",71182738,71227103,44365
"5500","ENSG00000124380","2",69893956,69905575,11619
"5501","ENSG00000124383","2",71130632,71150101,19469
"5502","ENSG00000124391","16",88638591,88640473,1882
"5503","ENSG00000124399","4",43898962,43899351,389
"5504","ENSG00000124406","4",42408373,42657105,248732
"5505","ENSG00000124422","17",20999596,21043760,44164
"5506","ENSG00000124429","X",85277396,85379717,102321
"5507","ENSG00000124440","19",46297046,46343433,46387
"5508","ENSG00000124444","19",43596392,43601157,4765
"5509","ENSG00000124449","19",43716076,43720021,3945
"5510","ENSG00000124459","19",43912624,43935282,22658
"5511","ENSG00000124466","19",43460787,43465608,4821
"5512","ENSG00000124467","19",42752686,42855691,103005
"5513","ENSG00000124469","19",42580243,42595055,14812
"5514","ENSG00000124479","X",43948776,43973395,24619
"5515","ENSG00000124486","X",41085445,41236579,151134
"5516","ENSG00000124490","6",49692358,49713590,21232
"5517","ENSG00000124491","6",6144085,6321013,176928
"5518","ENSG00000124493","6",34018645,34155622,136977
"5519","ENSG00000124496","6",42224931,42452051,227120
"5520","ENSG00000124507","6",34466061,34535229,69168
"5521","ENSG00000124508","6",26383096,26394874,11778
"5522","ENSG00000124523","6",13574529,13615158,40629
"5523","ENSG00000124532","6",24402908,24426194,23286
"5524","ENSG00000124535","6",2765414,2786952,21538
"5525","ENSG00000124541","6",43021623,43034156,12533
"5526","ENSG00000124549","6",26421391,26432383,10992
"5527","ENSG00000124557","6",26501221,26510422,9201
"5528","ENSG00000124562","6",34757505,34773857,16352
"5529","ENSG00000124564","6",25833066,25882286,49220
"5530","ENSG00000124568","6",25782897,25832059,49162
"5531","ENSG00000124570","6",2948159,2972165,24006
"5532","ENSG00000124571","6",43522334,43576038,53704
"5533","ENSG00000124574","6",43427366,43450427,23061
"5534","ENSG00000124575","6",26234268,26234933,665
"5535","ENSG00000124587","6",42963865,42979181,15316
"5536","ENSG00000124588","6",2987987,3028869,40882
"5537","ENSG00000124593","6",41780349,41790141,9792
"5538","ENSG00000124596","6",41033627,41097787,64160
"5539","ENSG00000124602","6",41026895,41039221,12326
"5540","ENSG00000124608","6",44298731,44313347,14616
"5541","ENSG00000124610","6",26017085,26017732,647
"5542","ENSG00000124613","6",27374615,27403904,29289
"5543","ENSG00000124614","6",34417454,34426069,8615
"5544","ENSG00000124615","6",39899578,39934551,34973
"5545","ENSG00000124635","6",27125897,27132750,6853
"5546","ENSG00000124641","6",41905354,41921139,15785
"5547","ENSG00000124657","6",27957241,27958182,941
"5548","ENSG00000124659","6",42744481,42746096,1615
"5549","ENSG00000124664","6",34537802,34556333,18531
"5550","ENSG00000124678","6",35118071,35148610,30539
"5551","ENSG00000124688","6",43629540,43640952,11412
"5552","ENSG00000124701","6",41053304,41064511,11207
"5553","ENSG00000124702","6",43014103,43021298,7195
"5554","ENSG00000124713","6",42960754,42963880,3126
"5555","ENSG00000124721","6",38715341,39030529,315188
"5556","ENSG00000124731","6",41267926,41286682,18756
"5557","ENSG00000124733","6",43011143,43016868,5725
"5558","ENSG00000124743","6",53647916,53665756,17840
"5559","ENSG00000124749","6",56056590,56394094,337504
"5560","ENSG00000124762","6",36676460,36687339,10879
"5561","ENSG00000124766","6",21592768,21598619,5851
"5562","ENSG00000124767","6",38675925,38703145,27220
"5563","ENSG00000124772","6",36740775,36839444,98669
"5564","ENSG00000124780","6",39299001,39314461,15460
"5565","ENSG00000124782","6",7107597,7251980,144383
"5566","ENSG00000124783","6",7268306,7347446,79140
"5567","ENSG00000124784","6",7389793,7418037,28244
"5568","ENSG00000124785","6",5997999,6007605,9606
"5569","ENSG00000124786","6",8411463,8435611,24148
"5570","ENSG00000124787","6",4994732,5004063,9331
"5571","ENSG00000124788","6",16299112,16761491,462379
"5572","ENSG00000124789","6",17615035,17706834,91799
"5573","ENSG00000124795","6",18223860,18264548,40688
"5574","ENSG00000124802","6",8073360,8102559,29199
"5575","ENSG00000124812","6",49834257,49877096,42839
"5576","ENSG00000124813","6",45328157,45664349,336192
"5577","ENSG00000124818","6",47781982,47832780,50798
"5578","ENSG00000124827","6",10873223,10881941,8718
"5579","ENSG00000124831","2",237627587,237813682,186095
"5580","ENSG00000124835","2",237048599,237056167,7568
"5581","ENSG00000124839","2",237574322,237601614,27292
"5582","ENSG00000124875","4",73836640,73849064,12424
"5583","ENSG00000124882","4",74365145,74388749,23604
"5584","ENSG00000124900","11",55883297,55891810,8513
"5585","ENSG00000124915","11",61746493,61757655,11162
"5586","ENSG00000124920","11",61752642,61788518,35876
"5587","ENSG00000124935","11",62242239,62244812,2573
"5588","ENSG00000124939","11",62208673,62213943,5270
"5589","ENSG00000124942","11",62433542,62556235,122693
"5590","ENSG00000125037","3",9962537,10011116,48579
"5591","ENSG00000125046","3",8619400,8745040,125640
"5592","ENSG00000125084","12",48978453,48981676,3223
"5593","ENSG00000125089","4",8182072,8241803,59731
"5594","ENSG00000125107","16",58519951,58629885,109934
"5595","ENSG00000125122","16",67207139,67227048,19909
"5596","ENSG00000125124","16",56466836,56520087,53251
"5597","ENSG00000125144","16",56666731,56668065,1334
"5598","ENSG00000125148","16",56608584,56609497,913
"5599","ENSG00000125149","16",67109958,67148539,38581
"5600","ENSG00000125166","16",58707131,58734342,27211
"5601","ENSG00000125170","16",57471922,57487327,15405
"5602","ENSG00000125207","12",130337887,130372637,34750
"5603","ENSG00000125245","13",99254714,99261744,7030
"5604","ENSG00000125246","13",99606669,99897134,290465
"5605","ENSG00000125247","13",100603927,100675093,71166
"5606","ENSG00000125249","13",97434169,97469128,34959
"5607","ENSG00000125255","13",103043998,103066846,22848
"5608","ENSG00000125257","13",95019835,95301475,281640
"5609","ENSG00000125266","13",106489745,106535662,45917
"5610","ENSG00000125285","13",94709622,94712399,2777
"5611","ENSG00000125304","13",99446311,99564006,117695
"5612","ENSG00000125319","17",44141906,44162476,20570
"5613","ENSG00000125337","6",167996241,168045095,48854
"5614","ENSG00000125347","5",132481609,132490777,9168
"5615","ENSG00000125351","X",119805311,119852998,47687
"5616","ENSG00000125352","X",119870475,119871827,1352
"5617","ENSG00000125354","X",119615724,119693370,77646
"5618","ENSG00000125355","X",120258650,120311556,52906
"5619","ENSG00000125356","X",119871832,119876662,4830
"5620","ENSG00000125363","X",11293413,11300761,7348
"5621","ENSG00000125375","14",50312326,50335558,23232
"5622","ENSG00000125378","14",53949736,53958761,9025
"5623","ENSG00000125384","14",52314305,52328598,14293
"5624","ENSG00000125385","9",37046835,37047237,402
"5625","ENSG00000125386","4",2536631,2732565,195934
"5626","ENSG00000125388","4",2963571,3040760,77189
"5627","ENSG00000125398","17",72121020,72126416,5396
"5628","ENSG00000125409","17",15303811,15341632,37821
"5629","ENSG00000125414","17",10521148,10549700,28552
"5630","ENSG00000125430","17",14301081,14349404,48323
"5631","ENSG00000125434","17",8287763,8295400,7637
"5632","ENSG00000125445","17",75261674,75266376,4702
"5633","ENSG00000125447","17",75236599,75262363,25764
"5634","ENSG00000125449","17",75109952,75130272,20320
"5635","ENSG00000125450","17",75205659,75235758,30099
"5636","ENSG00000125454","17",75272981,75289510,16529
"5637","ENSG00000125457","17",75266228,75271227,4999
"5638","ENSG00000125458","17",75130225,75131757,1532
"5639","ENSG00000125459","1",155610205,155614967,4762
"5640","ENSG00000125462","1",156404250,156430701,26451
"5641","ENSG00000125482","9",132375548,132406851,31303
"5642","ENSG00000125484","9",132670035,132694953,24918
"5643","ENSG00000125485","9",132592997,132670401,77404
"5644","ENSG00000125492","9",132582606,132590252,7646
"5645","ENSG00000125498","19",54769793,54784322,14529
"5646","ENSG00000125503","19",55090914,55117637,26723
"5647","ENSG00000125505","19",54173412,54189882,16470
"5648","ENSG00000125508","20",63540810,63547504,6694
"5649","ENSG00000125510","20",64080082,64100643,20561
"5650","ENSG00000125514","20",63034217,63037028,2811
"5651","ENSG00000125520","20",63739776,63744050,4274
"5652","ENSG00000125522","20",64105820,64107171,1351
"5653","ENSG00000125531","20",63547891,63556695,8804
"5654","ENSG00000125533","20",63005927,63007035,1108
"5655","ENSG00000125534","20",63520765,63522206,1441
"5656","ENSG00000125538","2",112829751,112836903,7152
"5657","ENSG00000125551","2",87748087,87758793,10706
"5658","ENSG00000125571","2",112912971,112918882,5911
"5659","ENSG00000125611","2",112584240,112589275,5035
"5660","ENSG00000125618","2",113215997,113278921,62924
"5661","ENSG00000125629","2",118088452,118110997,22545
"5662","ENSG00000125630","2",112541915,112577150,35235
"5663","ENSG00000125631","2",117859427,117934942,75515
"5664","ENSG00000125633","2",117915478,118014133,98655
"5665","ENSG00000125637","2",113157325,113209396,52071
"5666","ENSG00000125648","19",6436079,6465203,29124
"5667","ENSG00000125650","19",6375148,6379058,3910
"5668","ENSG00000125651","19",6379572,6393981,14409
"5669","ENSG00000125652","19",6372794,6375250,2456
"5670","ENSG00000125656","19",6361531,6368906,7375
"5671","ENSG00000125657","19",6531026,6535924,4898
"5672","ENSG00000125675","X",123184153,123490915,306762
"5673","ENSG00000125676","X",123600561,123733056,132495
"5674","ENSG00000125686","17",39404285,39451272,46987
"5675","ENSG00000125691","17",38847860,38853764,5904
"5676","ENSG00000125703","1",62784132,62865516,81384
"5677","ENSG00000125726","19",6583183,6604103,20920
"5678","ENSG00000125730","19",6677704,6730562,52858
"5679","ENSG00000125731","19",6752160,6767463,15303
"5680","ENSG00000125733","19",6737925,6751530,13605
"5681","ENSG00000125734","19",6729914,6737603,7689
"5682","ENSG00000125735","19",6661253,6670588,9335
"5683","ENSG00000125740","19",45467995,45475179,7184
"5684","ENSG00000125741","19",45527427,45602212,74785
"5685","ENSG00000125743","19",45687454,45692569,5115
"5686","ENSG00000125744","19",45485294,45497055,11761
"5687","ENSG00000125746","19",45606994,45645629,38635
"5688","ENSG00000125753","19",45506579,45526983,20404
"5689","ENSG00000125755","19",45815410,45863290,47880
"5690","ENSG00000125772","20",5544404,5611026,66622
"5691","ENSG00000125775","20",1309909,1329139,19230
"5692","ENSG00000125779","20",3888839,3929882,41043
"5693","ENSG00000125780","20",2296001,2341079,45078
"5694","ENSG00000125787","20",3043622,3045747,2125
"5695","ENSG00000125788","20",142590,145751,3161
"5696","ENSG00000125798","20",22581005,22585455,4450
"5697","ENSG00000125804","20",25985210,26086917,101707
"5698","ENSG00000125810","20",23079360,23086324,6964
"5699","ENSG00000125812","20",23362182,23373062,10880
"5700","ENSG00000125813","20",21705659,21718486,12827
"5701","ENSG00000125814","20",23374519,23421519,47000
"5702","ENSG00000125815","20",23491101,23496018,4917
"5703","ENSG00000125816","20",21395365,21397526,2161
"5704","ENSG00000125817","20",3783851,3786740,2889
"5705","ENSG00000125818","20",1113240,1189415,76175
"5706","ENSG00000125820","20",21511010,21514026,3016
"5707","ENSG00000125821","20",18587893,18766644,178751
"5708","ENSG00000125823","20",23439685,23444930,5245
"5709","ENSG00000125826","20",407498,430966,23468
"5710","ENSG00000125827","20",7977346,8019805,42459
"5711","ENSG00000125831","20",23450403,23452876,2473
"5712","ENSG00000125834","20",2101611,2177038,75427
"5713","ENSG00000125835","20",2461634,2470853,9219
"5714","ENSG00000125841","20",346782,359660,12878
"5715","ENSG00000125843","20",3820524,3828838,8314
"5716","ENSG00000125844","20",17613678,17682295,68617
"5717","ENSG00000125845","20",6767686,6780246,12560
"5718","ENSG00000125846","20",18288283,18316996,28713
"5719","ENSG00000125848","20",14322985,14337614,14629
"5720","ENSG00000125850","20",17956979,18059188,102209
"5721","ENSG00000125851","20",17226107,17484578,258471
"5722","ENSG00000125861","20",3659292,3663399,4107
"5723","ENSG00000125863","20",10401009,10434222,33213
"5724","ENSG00000125864","20",17493905,17569220,75315
"5725","ENSG00000125868","20",17570075,17609919,39844
"5726","ENSG00000125869","20",9514358,9530524,16166
"5727","ENSG00000125870","20",16729961,16742564,12603
"5728","ENSG00000125871","20",17969018,17991122,22104
"5729","ENSG00000125872","20",6040778,6054049,13271
"5730","ENSG00000125875","20",435480,462543,27063
"5731","ENSG00000125877","20",3208868,3223870,15002
"5732","ENSG00000125878","20",603797,610398,6601
"5733","ENSG00000125879","20",16748358,16770062,21704
"5734","ENSG00000125885","20",5950652,5998977,48325
"5735","ENSG00000125888","20",17693672,17735871,42199
"5736","ENSG00000125895","20",1180561,1185415,4854
"5737","ENSG00000125898","20",833715,857463,23748
"5738","ENSG00000125899","20",10996293,11029455,33162
"5739","ENSG00000125900","20",1534251,1557705,23454
"5740","ENSG00000125901","20",3046052,3048250,2198
"5741","ENSG00000125903","20",227258,229886,2628
"5742","ENSG00000125910","19",3172346,3180332,7986
"5743","ENSG00000125912","19",3185563,3209575,24012
"5744","ENSG00000125931","X",72301638,72307187,5549
"5745","ENSG00000125944","1",23303771,23344336,40565
"5746","ENSG00000125945","1",23359448,23369836,10388
"5747","ENSG00000125952","14",65006174,65102695,96521
"5748","ENSG00000125954","14",64914485,65061803,147318
"5749","ENSG00000125962","X",102599168,102604159,4991
"5750","ENSG00000125965","20",35433347,35454746,21399
"5751","ENSG00000125966","20",35226690,35276998,50308
"5752","ENSG00000125967","20",33657087,33674463,17376
"5753","ENSG00000125968","20",31605283,31606515,1232
"5754","ENSG00000125970","20",33993646,34108308,114662
"5755","ENSG00000125971","20",34516409,34540958,24549
"5756","ENSG00000125975","20",35523186,35529652,6466
"5757","ENSG00000125977","20",34088309,34112243,23934
"5758","ENSG00000125991","20",35542021,35557634,15613
"5759","ENSG00000125995","20",35699272,35700984,1712
"5760","ENSG00000125997","20",33347720,33354444,6724
"5761","ENSG00000125998","20",35285731,35292425,6694
"5762","ENSG00000125999","20",33273480,33309871,36391
"5763","ENSG00000126001","20",35455164,35519280,64116
"5764","ENSG00000126003","20",32192504,32207743,15239
"5765","ENSG00000126005","20",35201745,35278131,76386
"5766","ENSG00000126010","X",16123556,16153021,29465
"5767","ENSG00000126012","X",53191321,53225422,34101
"5768","ENSG00000126016","X",112774503,112840815,66312
"5769","ENSG00000126062","3",50354750,50359521,4771
"5770","ENSG00000126067","1",35599541,35641526,41985
"5771","ENSG00000126070","1",35930718,36072500,141782
"5772","ENSG00000126088","1",45010950,45015575,4625
"5773","ENSG00000126091","1",43705824,43931165,225341
"5774","ENSG00000126106","1",44635238,44674481,39243
"5775","ENSG00000126107","1",45002540,45011324,8784
"5776","ENSG00000126214","14",103561896,103714249,152353
"5777","ENSG00000126215","14",103697609,103715504,17895
"5778","ENSG00000126216","13",112485011,112588205,103194
"5779","ENSG00000126217","13",112894378,113099742,205364
"5780","ENSG00000126218","13",113122814,113149529,26715
"5781","ENSG00000126226","13",113177539,113208715,31176
"5782","ENSG00000126231","13",113158648,113172386,13738
"5783","ENSG00000126233","8",142740949,142742406,1457
"5784","ENSG00000126243","19",35935358,35945767,10409
"5785","ENSG00000126246","19",35738801,35742453,3652
"5786","ENSG00000126247","19",36139575,36150353,10778
"5787","ENSG00000126249","19",34404399,34426168,21769
"5788","ENSG00000126251","19",35370929,35372962,2033
"5789","ENSG00000126254","19",35629030,35637686,8656
"5790","ENSG00000126259","19",35855861,35867109,11248
"5791","ENSG00000126261","19",34428352,34471251,42899
"5792","ENSG00000126262","19",35443907,35451767,7860
"5793","ENSG00000126264","19",35902480,35904377,1897
"5794","ENSG00000126266","19",35351552,35353862,2310
"5795","ENSG00000126267","19",35648323,35658782,10459
"5796","ENSG00000126337","17",41486136,41492546,6410
"5797","ENSG00000126351","17",40058290,40093867,35577
"5798","ENSG00000126353","17",40553769,40565472,11703
"5799","ENSG00000126368","17",40092793,40100589,7796
"5800","ENSG00000126391","11",65386621,65413525,26904
"5801","ENSG00000126432","11",64318121,64321811,3690
"5802","ENSG00000126453","19",49665142,49673916,8774
"5803","ENSG00000126456","19",49659569,49665875,6306
"5804","ENSG00000126457","19",49675786,49689029,13243
"5805","ENSG00000126458","19",49635292,49640143,4851
"5806","ENSG00000126460","19",49580646,49591004,10358
"5807","ENSG00000126461","19",49642209,49658642,16433
"5808","ENSG00000126464","19",49591182,49626439,35257
"5809","ENSG00000126467","19",49739753,49763306,23553
"5810","ENSG00000126500","11",64103188,64119173,15985
"5811","ENSG00000126522","7",66075798,66093558,17760
"5812","ENSG00000126524","7",66987680,66995587,7907
"5813","ENSG00000126545","4",69931068,69946574,15506
"5814","ENSG00000126549","4",69995930,70002570,6640
"5815","ENSG00000126550","4",70050402,70058845,8443
"5816","ENSG00000126561","17",42287547,42311943,24396
"5817","ENSG00000126562","17",42780610,42797066,16456
"5818","ENSG00000126581","17",42810134,42833350,23216
"5819","ENSG00000126583","19",53879190,53907652,28462
"5820","ENSG00000126602","16",3651639,3717553,65914
"5821","ENSG00000126603","16",4314761,4339597,24836
"5822","ENSG00000126653","17",30115521,30186475,70954
"5823","ENSG00000126698","1",28199456,28233029,33573
"5824","ENSG00000126705","1",27534035,27604431,70396
"5825","ENSG00000126709","1",27666064,27672198,6134
"5826","ENSG00000126733","X",86148451,86832604,684153
"5827","ENSG00000126746","12",6666477,6689572,23095
"5828","ENSG00000126749","12",6970913,6997428,26515
"5829","ENSG00000126752","X",48255317,48267444,12127
"5830","ENSG00000126756","X",47651796,47659180,7384
"5831","ENSG00000126759","X",47623172,47630305,7133
"5832","ENSG00000126767","X",47635521,47650604,15083
"5833","ENSG00000126768","X",48893447,48898143,4696
"5834","ENSG00000126773","14",60091911,60169133,77222
"5835","ENSG00000126775","14",55366392,55411858,45466
"5836","ENSG00000126777","14",55559072,55701526,142454
"5837","ENSG00000126778","14",60643414,60658259,14845
"5838","ENSG00000126785","14",63204114,63293508,89394
"5839","ENSG00000126787","14",55148112,55191608,43496
"5840","ENSG00000126790","14",59460363,59484408,24045
"5841","ENSG00000126803","14",64535905,64546173,10268
"5842","ENSG00000126804","14",64503712,64533690,29978
"5843","ENSG00000126814","14",60971451,60981358,9907
"5844","ENSG00000126821","14",63684216,63728065,43849
"5845","ENSG00000126822","14",64704102,64750249,46147
"5846","ENSG00000126838","12",9148840,9208395,59555
"5847","ENSG00000126856","16",90056566,90092072,35506
"5848","ENSG00000126858","17",32142454,32253374,110920
"5849","ENSG00000126860","17",31317560,31321884,4324
"5850","ENSG00000126861","17",31272013,31297539,25526
"5851","ENSG00000126870","7",158856558,158956747,100189
"5852","ENSG00000126878","9",131096476,131123152,26676
"5853","ENSG00000126882","9",131258076,131276510,18434
"5854","ENSG00000126883","9",131125586,131234663,109077
"5855","ENSG00000126890","X",154651972,154653579,1607
"5856","ENSG00000126895","X",153902531,153907166,4635
"5857","ENSG00000126903","X",154487306,154490690,3384
"5858","ENSG00000126934","19",4090321,4124129,33808
"5859","ENSG00000126945","X",101408222,101414133,5911
"5860","ENSG00000126947","X",101550531,101554700,4169
"5861","ENSG00000126950","X",101078879,101096367,17488
"5862","ENSG00000126952","X",101832112,101857577,25465
"5863","ENSG00000126953","X",101345661,101348742,3081
"5864","ENSG00000126970","X",64915802,65034713,118911
"5865","ENSG00000127022","5",179678628,179731641,53013
"5866","ENSG00000127054","1",1311585,1324691,13106
"5867","ENSG00000127074","1",192636138,192660306,24168
"5868","ENSG00000127080","9",92613183,92670131,56948
"5869","ENSG00000127081","9",92844182,92878038,33856
"5870","ENSG00000127083","9",92414245,92424461,10216
"5871","ENSG00000127084","9",92947523,93036236,88713
"5872","ENSG00000127124","1",41506365,42035925,529560
"5873","ENSG00000127125","1",42456117,42473385,17268
"5874","ENSG00000127129","1",41478775,41484683,5908
"5875","ENSG00000127152","14",99169287,99272197,102910
"5876","ENSG00000127184","5",86617928,86620962,3034
"5877","ENSG00000127191","9",136881912,136926607,44695
"5878","ENSG00000127220","19",17292131,17310236,18105
"5879","ENSG00000127241","3",187217285,187292022,74737
"5880","ENSG00000127249","3",193398967,193593111,194144
"5881","ENSG00000127252","3",193241125,193277738,36613
"5882","ENSG00000127311","12",66302545,66347645,45100
"5883","ENSG00000127314","12",68610855,68671901,61046
"5884","ENSG00000127318","12",68248242,68253604,5362
"5885","ENSG00000127324","12",71125085,71441898,316813
"5886","ENSG00000127325","12",69643360,69699476,56116
"5887","ENSG00000127328","12",69738681,69823204,84523
"5888","ENSG00000127329","12",70515866,70637440,121574
"5889","ENSG00000127334","12",67648338,67665406,17068
"5890","ENSG00000127337","12",69359710,69390870,31160
"5891","ENSG00000127362","7",141764097,141765197,1100
"5892","ENSG00000127364","7",141778442,141780819,2377
"5893","ENSG00000127366","7",141790217,141791367,1150
"5894","ENSG00000127377","7",151428835,151440813,11978
"5895","ENSG00000127399","7",150323263,150338156,14893
"5896","ENSG00000127412","7",142908101,142933808,25707
"5897","ENSG00000127415","4",986997,1004564,17567
"5898","ENSG00000127418","4",1009936,1026898,16962
"5899","ENSG00000127419","4",932387,958656,26269
"5900","ENSG00000127423","1",25831913,25859458,27545
"5901","ENSG00000127445","19",9835257,9849682,14425
"5902","ENSG00000127452","19",9810267,9827816,17549
"5903","ENSG00000127463","1",19215660,19251527,35867
"5904","ENSG00000127472","1",20028179,20091911,63732
"5905","ENSG00000127481","1",19074510,19210266,135756
"5906","ENSG00000127483","1",20742679,20787323,44644
"5907","ENSG00000127507","19",14732392,14778560,46168
"5908","ENSG00000127511","19",16829400,16880353,50953
"5909","ENSG00000127515","19",14840466,14848922,8456
"5910","ENSG00000127526","19",16549831,16572415,22584
"5911","ENSG00000127527","19",16355239,16472085,116846
"5912","ENSG00000127528","19",16324817,16327874,3057
"5913","ENSG00000127530","19",14789260,14835376,46116
"5914","ENSG00000127533","19",16888860,16892606,3746
"5915","ENSG00000127540","19",1597169,1605473,8304
"5916","ENSG00000127554","16",1984193,1987749,3556
"5917","ENSG00000127561","16",1989660,1994275,4615
"5918","ENSG00000127564","16",2968024,2980479,12455
"5919","ENSG00000127578","16",629239,634117,4878
"5920","ENSG00000127580","16",684622,690444,5822
"5921","ENSG00000127585","16",692498,705808,13310
"5922","ENSG00000127586","16",788046,800737,12691
"5923","ENSG00000127588","16",798041,800734,2693
"5924","ENSG00000127589","8",30351873,30353518,1645
"5925","ENSG00000127603","1",39081316,39487177,405861
"5926","ENSG00000127616","19",10960825,11079426,118601
"5927","ENSG00000127663","19",4969113,5153598,184485
"5928","ENSG00000127666","19",4815932,4831704,15772
"5929","ENSG00000127720","12",82358528,82479239,120711
"5930","ENSG00000127743","5",149371324,149404202,32878
"5931","ENSG00000127774","17",3668812,3669668,856
"5932","ENSG00000127780","17",3432870,3433841,971
"5933","ENSG00000127804","17",2405562,2511891,106329
"5934","ENSG00000127824","2",219249710,219278170,28460
"5935","ENSG00000127831","2",218419092,218453295,34203
"5936","ENSG00000127837","2",218264123,218270257,6134
"5937","ENSG00000127838","2",218270392,218346793,76401
"5938","ENSG00000127863","13",23570370,23676104,105734
"5939","ENSG00000127870","13",26132115,26222314,90199
"5940","ENSG00000127884","10",133362485,133373354,10869
"5941","ENSG00000127903","19",56661980,56671783,9803
"5942","ENSG00000127914","7",91940867,92110673,169806
"5943","ENSG00000127920","7",93921699,93928610,6911
"5944","ENSG00000127922","7",96481626,96709891,228265
"5945","ENSG00000127928","7",93591573,93911265,319692
"5946","ENSG00000127946","7",75533298,75738962,205664
"5947","ENSG00000127947","7",77537295,77640069,102774
"5948","ENSG00000127948","7",75899200,75986855,87655
"5949","ENSG00000127951","7",77193369,77199848,6479
"5950","ENSG00000127952","7",75996338,76048004,51666
"5951","ENSG00000127954","7",88270892,88306891,35999
"5952","ENSG00000127955","7",79768028,80226181,458153
"5953","ENSG00000127957","7",75507747,75528148,20401
"5954","ENSG00000127980","7",92487020,92528520,41500
"5955","ENSG00000127989","7",91692008,91880720,188712
"5956","ENSG00000127990","7",94524204,94656572,132368
"5957","ENSG00000127993","7",92528773,92540481,11708
"5958","ENSG00000127995","7",94509219,94557019,47800
"5959","ENSG00000128000","19",40028260,40056231,27971
"5960","ENSG00000128011","19",39306568,39315336,8768
"5961","ENSG00000128016","19",39406813,39409412,2599
"5962","ENSG00000128039","4",55346242,55373100,26858
"5963","ENSG00000128040","4",56809860,56821742,11882
"5964","ENSG00000128045","4",52862317,52866835,4518
"5965","ENSG00000128050","4",56435741,56464579,28838
"5966","ENSG00000128052","4",55078481,55125595,47114
"5967","ENSG00000128059","4",56393362,56435615,42253
"5968","ENSG00000128159","22",50217689,50245023,27334
"5969","ENSG00000128165","22",50481543,50486440,4897
"5970","ENSG00000128185","22",20314276,20320080,5804
"5971","ENSG00000128191","22",20080232,20111877,31645
"5972","ENSG00000128203","22",26429260,26445015,15755
"5973","ENSG00000128218","22",23752743,23754425,1682
"5974","ENSG00000128228","22",21642302,21644299,1997
"5975","ENSG00000128242","22",30554635,30574665,20030
"5976","ENSG00000128245","22",31944522,31957603,13081
"5977","ENSG00000128250","22",29438583,29442455,3872
"5978","ENSG00000128253","22",32190435,32205001,14566
"5979","ENSG00000128254","22",31926214,31945518,19304
"5980","ENSG00000128262","22",24251828,24265525,13697
"5981","ENSG00000128266","22",23070519,23125032,54513
"5982","ENSG00000128268","22",39457012,39492194,35182
"5983","ENSG00000128271","22",24417879,24442357,24478
"5984","ENSG00000128272","22",39519695,39522685,2990
"5985","ENSG00000128274","22",42692121,42721298,29177
"5986","ENSG00000128276","22",32354885,32361161,6276
"5987","ENSG00000128283","22",37560480,37569405,8925
"5988","ENSG00000128284","22",36140330,36166177,25847
"5989","ENSG00000128285","22",40678750,40682814,4064
"5990","ENSG00000128294","22",26521996,26596717,74721
"5991","ENSG00000128298","22",38084900,38110684,25784
"5992","ENSG00000128309","22",37019635,37029822,10187
"5993","ENSG00000128310","22",37823382,37825495,2113
"5994","ENSG00000128311","22",37010859,37020183,9324
"5995","ENSG00000128313","22",35717872,35729483,11611
"5996","ENSG00000128322","22",23573125,23580302,7177
"5997","ENSG00000128335","22",36226209,36239954,13745
"5998","ENSG00000128340","22",37225270,37244448,19178
"5999","ENSG00000128342","22",30240453,30246759,6306
"6000","ENSG00000128346","22",37943050,37953669,10619
"6001","ENSG00000128383","22",38952741,38992778,40037
"6002","ENSG00000128394","22",39040604,39055972,15368
"6003","ENSG00000128408","22",45413691,45432496,18805
"6004","ENSG00000128422","17",41619442,41624842,5400
"6005","ENSG00000128438","17",16922915,16934839,11924
"6006","ENSG00000128463","15",34225013,34230156,5143
"6007","ENSG00000128482","17",19411125,19417276,6151
"6008","ENSG00000128487","17",20009344,20319026,309682
"6009","ENSG00000128510","7",130293134,130324180,31046
"6010","ENSG00000128512","7",111726110,112206411,480301
"6011","ENSG00000128513","7",124822386,124929983,107597
"6012","ENSG00000128524","7",128862856,128865847,2991
"6013","ENSG00000128534","7",118184144,118204035,19891
"6014","ENSG00000128536","7",105876796,106036432,159636
"6015","ENSG00000128563","7",102363872,102426676,62804
"6016","ENSG00000128564","7",101162509,101165569,3060
"6017","ENSG00000128567","7",131500262,131558217,57955
"6018","ENSG00000128573","7",114086327,114693772,607445
"6019","ENSG00000128578","7",129434432,129488399,53967
"6020","ENSG00000128581","7",101310906,101321823,10917
"6021","ENSG00000128585","7",131110096,131496632,386536
"6022","ENSG00000128590","7",108569867,108574850,4983
"6023","ENSG00000128591","7",128830377,128859274,28897
"6024","ENSG00000128594","7",128027071,128032107,5036
"6025","ENSG00000128595","7",128739292,128773400,34108
"6026","ENSG00000128596","7",128790757,128822132,31375
"6027","ENSG00000128602","7",129188633,129213545,24912
"6028","ENSG00000128604","7",128937457,128950038,12581
"6029","ENSG00000128606","7",102913000,102945111,32111
"6030","ENSG00000128607","7",130070534,130135705,65171
"6031","ENSG00000128609","7",123536997,123557904,20907
"6032","ENSG00000128610","7",122301303,122310691,9388
"6033","ENSG00000128617","7",128772491,128775790,3299
"6034","ENSG00000128626","19",38930548,38933162,2614
"6035","ENSG00000128641","2",191245185,191425389,180204
"6036","ENSG00000128645","2",176188668,176190907,2239
"6037","ENSG00000128652","2",176136612,176173102,36490
"6038","ENSG00000128654","2",176269395,176338025,68630
"6039","ENSG00000128655","2",177623244,178072777,449533
"6040","ENSG00000128656","2",174799313,175005381,206068
"6041","ENSG00000128683","2",170813213,170861151,47938
"6042","ENSG00000128692","2",170751805,170752788,983
"6043","ENSG00000128694","2",189746660,189763227,16567
"6044","ENSG00000128699","2",189770267,189784364,14097
"6045","ENSG00000128708","2",171922448,171983686,61238
"6046","ENSG00000128709","2",176122719,176124937,2218
"6047","ENSG00000128710","2",176108790,176119942,11152
"6048","ENSG00000128713","2",176104216,176109754,5538
"6049","ENSG00000128714","2",176092721,176095944,3223
"6050","ENSG00000128731","15",28111040,28322172,211132
"6051","ENSG00000128739","15",24823637,24978723,155086
"6052","ENSG00000128789","18",12658043,12725740,67697
"6053","ENSG00000128791","18",9334767,9402420,67653
"6054","ENSG00000128805","10",48446034,48656265,210231
"6055","ENSG00000128815","10",48684876,48982956,298080
"6056","ENSG00000128829","15",39934115,40035591,101476
"6057","ENSG00000128833","15",52192322,52295804,103482
"6058","ENSG00000128849","15",57375967,57550727,174760
"6059","ENSG00000128872","15",51751597,51816363,64766
"6060","ENSG00000128881","15",42738730,42920809,182079
"6061","ENSG00000128886","15",43772605,43777315,4710
"6062","ENSG00000128891","15",40528683,40565057,36374
"6063","ENSG00000128908","15",40978880,41116280,137400
"6064","ENSG00000128915","15",60419609,60479160,59551
"6065","ENSG00000128917","15",40929340,40939073,9733
"6066","ENSG00000128918","15",57953424,58497866,544442
"6067","ENSG00000128923","15",58771192,58861900,90708
"6068","ENSG00000128928","15",40405485,40435947,30462
"6069","ENSG00000128944","15",40382721,40394246,11525
"6070","ENSG00000128951","15",48331011,48343373,12362
"6071","ENSG00000128965","15",40952962,40956512,3550
"6072","ENSG00000128973","15",68206992,68257211,50219
"6073","ENSG00000128989","15",52547045,52569883,22838
"6074","ENSG00000129003","15",61852389,62060473,208084
"6075","ENSG00000129007","15",68190705,68206110,15405
"6076","ENSG00000129009","15",74173710,74176872,3162
"6077","ENSG00000129028","15",70881342,70892433,11091
"6078","ENSG00000129038","15",73925989,73952137,26148
"6079","ENSG00000129048","3",132597237,132618967,21730
"6080","ENSG00000129055","3",134477706,134486716,9010
"6081","ENSG00000129071","3",129430944,129440179,9235
"6082","ENSG00000129083","11",14443440,14500027,56587
"6083","ENSG00000129084","11",14504874,14643635,138761
"6084","ENSG00000129103","7",56064002,56080670,16668
"6085","ENSG00000129116","4",168497052,168928457,431405
"6086","ENSG00000129128","4",176319966,176332245,12279
"6087","ENSG00000129151","11",27040725,27127809,87084
"6088","ENSG00000129152","11",17719571,17722136,2565
"6089","ENSG00000129158","11",17788048,18013047,224999
"6090","ENSG00000129159","11",17734774,17856804,122030
"6091","ENSG00000129167","11",18017564,18042426,24862
"6092","ENSG00000129170","11",19182037,19210571,28534
"6093","ENSG00000129173","11",19224063,19241620,17557
"6094","ENSG00000129187","4",182890060,182917936,27876
"6095","ENSG00000129194","17",7588178,7590170,1992
"6096","ENSG00000129195","17",6444441,6451469,7028
"6097","ENSG00000129197","17",5419641,5432876,13235
"6098","ENSG00000129204","17",5116438,5175034,58596
"6099","ENSG00000129214","17",7613946,7633382,19436
"6100","ENSG00000129219","17",4807152,4823434,16282
"6101","ENSG00000129221","17",6393693,6435199,41506
"6102","ENSG00000129226","17",7579491,7582111,2620
"6103","ENSG00000129235","17",6640758,6644541,3783
"6104","ENSG00000129244","17",7646627,7657770,11143
"6105","ENSG00000129245","17",7591230,7614871,23641
"6106","ENSG00000129250","17",4997950,5028401,30451
"6107","ENSG00000129255","17",7583529,7592789,9260
"6108","ENSG00000129292","8",132775358,132848807,73449
"6109","ENSG00000129295","8",132570416,132675592,105176
"6110","ENSG00000129315","12",48688458,48716998,28540
"6111","ENSG00000129317","12",43718993,43758817,39824
"6112","ENSG00000129347","19",10553078,10566037,12959
"6113","ENSG00000129351","19",10654261,10692417,38156
"6114","ENSG00000129353","19",10602457,10644557,42100
"6115","ENSG00000129354","19",10572671,10587315,14644
"6116","ENSG00000129355","19",10566462,10569059,2597
"6117","ENSG00000129422","8",17643795,17800917,157122
"6118","ENSG00000129437","19",51077495,51084245,6750
"6119","ENSG00000129450","19",51124908,51136651,11743
"6120","ENSG00000129451","19",51012739,51020175,7436
"6121","ENSG00000129455","19",50996007,51002711,6704
"6122","ENSG00000129460","14",23469689,23509862,40173
"6123","ENSG00000129465","14",24336025,24340022,3997
"6124","ENSG00000129467","14",24318349,24335093,16744
"6125","ENSG00000129472","14",21459020,21476960,17940
"6126","ENSG00000129473","14",23298790,23311759,12969
"6127","ENSG00000129474","14",22971177,22982551,11374
"6128","ENSG00000129480","14",31446036,31457506,11470
"6129","ENSG00000129484","14",20343582,20357905,14323
"6130","ENSG00000129493","14",31291788,31420550,128762
"6131","ENSG00000129514","14",37589552,37596059,6507
"6132","ENSG00000129515","14",34561094,34630183,69089
"6133","ENSG00000129518","14",34515938,34539711,23773
"6134","ENSG00000129521","14",33924231,34462774,538543
"6135","ENSG00000129534","14",45203190,45253540,50350
"6136","ENSG00000129535","14",24080107,24115014,34907
"6137","ENSG00000129538","14",20801228,20802855,1627
"6138","ENSG00000129559","14",24216857,24232367,15510
"6139","ENSG00000129562","14",22564907,22589224,24317
"6140","ENSG00000129566","14",20365667,20413501,47834
"6141","ENSG00000129595","5",112142441,112419313,276872
"6142","ENSG00000129596","5",115804733,115816659,11926
"6143","ENSG00000129625","5",112876385,112922289,45904
"6144","ENSG00000129636","16",47154387,47464149,309762
"6145","ENSG00000129646","17",76274049,76307998,33949
"6146","ENSG00000129654","17",76136333,76141245,4912
"6147","ENSG00000129657","17",77088749,77217101,128352
"6148","ENSG00000129667","17",76470891,76501790,30899
"6149","ENSG00000129673","17",76453351,76470117,16766
"6150","ENSG00000129675","X",136665547,136780932,115385
"6151","ENSG00000129680","X",136213220,136256482,43262
"6152","ENSG00000129682","X",138614727,139222777,608050
"6153","ENSG00000129691","8",38105242,38144076,38834
"6154","ENSG00000129696","8",33473386,33513601,40215
"6155","ENSG00000129744","11",3645128,3664416,19288
"6156","ENSG00000129749","11",3665587,3671384,5797
"6157","ENSG00000129757","11",2883213,2885773,2560
"6158","ENSG00000129810","3",20160593,20186206,25613
"6159","ENSG00000129824","Y",2841602,2932000,90398
"6160","ENSG00000129910","16",89171767,89195492,23725
"6161","ENSG00000129911","19",1852399,1863579,11180
"6162","ENSG00000129925","16",370788,387113,16325
"6163","ENSG00000129932","19",3490822,3500940,10118
"6164","ENSG00000129933","19",19320829,19358754,37925
"6165","ENSG00000129946","19",416583,460996,44413
"6166","ENSG00000129951","19",812488,821977,9489
"6167","ENSG00000129965","11",2132538,2161209,28671
"6168","ENSG00000129968","19",1876810,1885547,8737
"6169","ENSG00000129988","20",38346482,38377013,30531
"6170","ENSG00000129990","19",55171196,55180289,9093
"6171","ENSG00000129991","19",55151767,55157773,6006
"6172","ENSG00000129993","16",88874858,88977204,102346
"6173","ENSG00000130005","19",1397026,1401570,4544
"6174","ENSG00000130021","X",6667865,7148190,480325
"6175","ENSG00000130023","6",169751622,169781600,29978
"6176","ENSG00000130024","6",169703902,169725566,21664
"6177","ENSG00000130032","X",151694658,151705924,11266
"6178","ENSG00000130035","12",4720341,4851927,131586
"6179","ENSG00000130037","12",5043989,5046788,2799
"6180","ENSG00000130038","12",3606633,3764819,158186
"6181","ENSG00000130045","9",88534033,88584274,50241
"6182","ENSG00000130052","X",68647666,68725842,78176
"6183","ENSG00000130054","X",69505241,69532508,27267
"6184","ENSG00000130055","X",70423031,70433390,10359
"6185","ENSG00000130066","X",23783173,23786226,3053
"6186","ENSG00000130119","X",54530211,54567289,37078
"6187","ENSG00000130147","2",234952017,235055714,103697
"6188","ENSG00000130150","X",14873421,14922327,48906
"6189","ENSG00000130158","19",11199295,11262524,63229
"6190","ENSG00000130159","19",11505929,11529172,23243
"6191","ENSG00000130164","19",11089362,11133816,44454
"6192","ENSG00000130165","19",11551147,11559236,8089
"6193","ENSG00000130167","19",11296139,11326996,30857
"6194","ENSG00000130173","19",11237450,11241943,4493
"6195","ENSG00000130175","19",11435288,11450968,15680
"6196","ENSG00000130176","19",11538767,11550323,11556
"6197","ENSG00000130177","13",114234887,114272723,37836
"6198","ENSG00000130182","16",3088890,3099295,10405
"6199","ENSG00000130193","8",142727223,142736927,9704
"6200","ENSG00000130202","19",44846175,44889223,43048
"6201","ENSG00000130203","19",44905791,44909393,3602
"6202","ENSG00000130204","19",44890569,44903689,13120
"6203","ENSG00000130208","19",44914247,44919349,5102
"6204","ENSG00000130222","9",89605012,89606555,1543
"6205","ENSG00000130224","X",115110616,115234096,123480
"6206","ENSG00000130226","7",153887097,154894285,1007188
"6207","ENSG00000130227","8",21919662,22006585,86923
"6208","ENSG00000130234","X",15561033,15602148,41115
"6209","ENSG00000130244","19",38403135,38409088,5953
"6210","ENSG00000130254","19",5586999,5624046,37047
"6211","ENSG00000130255","19",5674947,5691875,16928
"6212","ENSG00000130270","19",1782075,1812276,30201
"6213","ENSG00000130287","19",19211958,19252233,40275
"6214","ENSG00000130294","2",240713761,240821036,107275
"6215","ENSG00000130299","19",17334920,17342731,7811
"6216","ENSG00000130300","19",17351450,17377342,25892
"6217","ENSG00000130303","19",17402939,17405630,2691
"6218","ENSG00000130304","19",17468769,17506168,37399
"6219","ENSG00000130305","7",73302517,73308867,6350
"6220","ENSG00000130307","19",17249176,17282786,33610
"6221","ENSG00000130309","19",17555649,17583162,27513
"6222","ENSG00000130311","19",17309518,17323298,13780
"6223","ENSG00000130312","19",17292609,17306843,14234
"6224","ENSG00000130313","19",17511636,17521288,9652
"6225","ENSG00000130332","19",2321520,2328611,7091
"6226","ENSG00000130338","6",158232236,158511828,279592
"6227","ENSG00000130340","6",157700387,157945077,244690
"6228","ENSG00000130347","6",106571971,106629487,57516
"6229","ENSG00000130348","6",106629578,106668417,38839
"6230","ENSG00000130349","6",107028199,107051586,23387
"6231","ENSG00000130363","6",158972871,159000187,27316
"6232","ENSG00000130368","6",159906690,159916530,9840
"6233","ENSG00000130377","19",6135247,6193094,57847
"6234","ENSG00000130382","19",6210381,6279975,69594
"6235","ENSG00000130383","19",5865826,5870540,4714
"6236","ENSG00000130385","X",50910784,50916607,5823
"6237","ENSG00000130396","6",167826922,167972023,145101
"6238","ENSG00000130402","19",38647649,38731589,83940
"6239","ENSG00000130413","11",8391868,8594289,202421
"6240","ENSG00000130414","2",239892450,240025345,132895
"6241","ENSG00000130427","7",100720468,100723700,3232
"6242","ENSG00000130429","7",99374249,99394816,20567
"6243","ENSG00000130433","19",53992288,54012669,20381
"6244","ENSG00000130449","5",61332258,61546172,213914
"6245","ENSG00000130475","19",17747718,17788568,40850
"6246","ENSG00000130477","19",17601328,17688365,87037
"6247","ENSG00000130479","19",17719242,17734513,15271
"6248","ENSG00000130487","22",50546203,50551023,4820
"6249","ENSG00000130508","2",1631887,1744852,112965
"6250","ENSG00000130511","19",18418864,18434562,15698
"6251","ENSG00000130513","19",18374731,18389176,14445
"6252","ENSG00000130517","19",18340598,18369950,29352
"6253","ENSG00000130518","19",18257097,18274509,17412
"6254","ENSG00000130520","19",18306230,18323274,17044
"6255","ENSG00000130522","19",18279760,18281622,1862
"6256","ENSG00000130528","19",49151198,49155396,4198
"6257","ENSG00000130529","19",49157741,49211836,54095
"6258","ENSG00000130540","22",43824509,43862513,38004
"6259","ENSG00000130544","19",7069703,7087968,18265
"6260","ENSG00000130545","19",6463777,6467221,3444
"6261","ENSG00000130558","9",135075422,135121179,45757
"6262","ENSG00000130559","9",135808487,135907546,99059
"6263","ENSG00000130560","9",135932969,135961380,28411
"6264","ENSG00000130561","2",233307816,233347055,39239
"6265","ENSG00000130584","20",63743666,63832038,88372
"6266","ENSG00000130589","20",63558086,63574239,16153
"6267","ENSG00000130590","20",63974116,63980008,5892
"6268","ENSG00000130592","11",1852970,1892267,39297
"6269","ENSG00000130595","11",1919703,1938706,19003
"6270","ENSG00000130598","11",1838981,1841680,2699
"6271","ENSG00000130600","11",1995176,2001470,6294
"6272","ENSG00000130612","19",40890826,40912357,21531
"6273","ENSG00000130635","9",134641774,134844843,203069
"6274","ENSG00000130638","22",45671798,45845307,173509
"6275","ENSG00000130640","10",133278630,133312337,33707
"6276","ENSG00000130643","10",133324072,133336935,12863
"6277","ENSG00000130649","10",133520406,133561220,40814
"6278","ENSG00000130653","9",137459952,137550402,90450
"6279","ENSG00000130656","16",142728,154503,11775
"6280","ENSG00000130669","19",39125770,39182816,57046
"6281","ENSG00000130675","7",156994051,157010663,16612
"6282","ENSG00000130684","20",25673195,25696853,23658
"6283","ENSG00000130695","1",26234200,26278808,44608
"6284","ENSG00000130699","20",61953469,62065810,112341
"6285","ENSG00000130700","20",62463497,62475995,12498
"6286","ENSG00000130701","20",62410237,62427539,17302
"6287","ENSG00000130702","20",62307955,62367312,59357
"6288","ENSG00000130703","20",62231922,62296213,64291
"6289","ENSG00000130706","20",62302093,62308862,6769
"6290","ENSG00000130707","9",130444929,130501274,56345
"6291","ENSG00000130711","9",130664594,130682981,18387
"6292","ENSG00000130713","9",130693721,130704894,11173
"6293","ENSG00000130714","9",131502902,131523806,20904
"6294","ENSG00000130717","9",131523801,131531264,7463
"6295","ENSG00000130720","9",130902438,130939286,36848
"6296","ENSG00000130723","9",131373636,131500197,126561
"6297","ENSG00000130724","19",58551566,58555124,3558
"6298","ENSG00000130725","19",58555712,58558960,3248
"6299","ENSG00000130726","19",58544064,58550722,6658
"6300","ENSG00000130731","16",634427,636366,1939
"6301","ENSG00000130733","19",10922185,10928681,6496
"6302","ENSG00000130734","19",10543895,10553418,9523
"6303","ENSG00000130741","X",24054946,24078810,23864
"6304","ENSG00000130748","19",47045909,47048624,2715
"6305","ENSG00000130749","19",47064187,47113776,49589
"6306","ENSG00000130751","19",47019820,47045775,25955
"6307","ENSG00000130755","19",39328353,39342372,14019
"6308","ENSG00000130758","19",40191426,40215575,24149
"6309","ENSG00000130762","1",3454665,3481113,26448
"6310","ENSG00000130764","1",3778559,3796498,17939
"6311","ENSG00000130766","1",28259518,28282491,22973
"6312","ENSG00000130768","1",27935000,27959157,24157
"6313","ENSG00000130770","1",28236109,28246906,10797
"6314","ENSG00000130772","1",28329002,28335965,6963
"6315","ENSG00000130775","1",27872543,27886685,14142
"6316","ENSG00000130779","12",122271432,122422632,151200
"6317","ENSG00000130783","12",122774327,122827528,53201
"6318","ENSG00000130787","12",122834453,122862961,28508
"6319","ENSG00000130803","19",9140397,9163424,23027
"6320","ENSG00000130810","19",10106362,10112012,5650
"6321","ENSG00000130811","19",10115014,10119918,4904
"6322","ENSG00000130812","19",10092338,10102796,10458
"6323","ENSG00000130813","19",10086122,10093252,7130
"6324","ENSG00000130816","19",10133345,10231286,97941
"6325","ENSG00000130818","19",9523223,9538645,15422
"6326","ENSG00000130821","X",153687926,153696588,8662
"6327","ENSG00000130822","X",153669730,153689010,19280
"6328","ENSG00000130826","X",154762742,154777689,14947
"6329","ENSG00000130827","X",154458281,154477779,19498
"6330","ENSG00000130829","X",153642492,153651326,8834
"6331","ENSG00000130830","X",154778684,154821007,42323
"6332","ENSG00000130844","19",53519527,53580269,60742
"6333","ENSG00000130856","18",76822607,76970727,148120
"6334","ENSG00000130876","19",33208664,33225850,17186
"6335","ENSG00000130881","19",33177603,33208864,31261
"6336","ENSG00000130921","12",123232916,123257959,25043
"6337","ENSG00000130935","17",67717931,67744531,26600
"6338","ENSG00000130939","1",10032832,10181239,148407
"6339","ENSG00000130940","1",10636604,10796650,160046
"6340","ENSG00000130943","22",46255663,46263355,7692
"6341","ENSG00000130948","9",96235306,96302176,66870
"6342","ENSG00000130950","9",94318196,94328644,10448
"6343","ENSG00000130956","9",96450169,96491336,41167
"6344","ENSG00000130957","9",94558720,94593824,35104
"6345","ENSG00000130958","9",96313444,96383711,70267
"6346","ENSG00000130962","X",37349275,37457295,108020
"6347","ENSG00000130985","X",47190861,47215128,24267
"6348","ENSG00000130988","X",47078355,47093314,14959
"6349","ENSG00000130997","4",2071918,2242121,170203
"6350","ENSG00000131002","Y",19567313,19606274,38961
"6351","ENSG00000131013","6",149504733,149546038,41305
"6352","ENSG00000131015","6",149942014,149949235,7221
"6353","ENSG00000131016","6",151239967,151358559,118592
"6354","ENSG00000131018","6",152121684,152637801,516117
"6355","ENSG00000131019","6",150061053,150069121,8068
"6356","ENSG00000131023","6",149658153,149718105,59952
"6357","ENSG00000131037","19",55072020,55087923,15903
"6358","ENSG00000131042","19",54273821,54281184,7363
"6359","ENSG00000131043","20",36236459,36270918,34459
"6360","ENSG00000131044","20",31870702,31944963,74261
"6361","ENSG00000131050","20",33161768,33181412,19644
"6362","ENSG00000131051","20",35701347,35742312,40965
"6363","ENSG00000131055","20",31637888,31645006,7118
"6364","ENSG00000131059","20",33217310,33227758,10448
"6365","ENSG00000131061","20",33731657,33792269,60612
"6366","ENSG00000131067","20",34844720,34872856,28136
"6367","ENSG00000131068","20",31368618,31373923,5305
"6368","ENSG00000131069","20",34872146,34927962,55816
"6369","ENSG00000131080","X",66595637,66639298,43661
"6370","ENSG00000131089","X",63634967,63809274,174307
"6371","ENSG00000131094","17",44959693,44968303,8610
"6372","ENSG00000131095","17",44903159,44916937,13778
"6373","ENSG00000131096","17",43952738,44004469,51731
"6374","ENSG00000131097","17",44846353,44850476,4123
"6375","ENSG00000131100","22",17592136,17628749,36613
"6376","ENSG00000131115","19",44207547,44237268,29721
"6377","ENSG00000131116","19",43607224,43619629,12405
"6378","ENSG00000131126","19",43401496,43418597,17101
"6379","ENSG00000131127","4",337814,384868,47054
"6380","ENSG00000131142","19",8052767,8062650,9883
"6381","ENSG00000131143","16",85798633,85807044,8411
"6382","ENSG00000131148","16",85771758,85799608,27850
"6383","ENSG00000131149","16",85169525,85676204,506679
"6384","ENSG00000131152","16",87302876,87334273,31397
"6385","ENSG00000131153","16",85676198,85690073,13875
"6386","ENSG00000131165","16",89644435,89657721,13286
"6387","ENSG00000131171","X",81202102,81298547,96445
"6388","ENSG00000131174","X",77899440,77907376,7936
"6389","ENSG00000131183","5",177379235,177398848,19613
"6390","ENSG00000131187","5",177402140,177409576,7436
"6391","ENSG00000131188","5",177446445,177456286,9841
"6392","ENSG00000131196","18",79395856,79529325,133469
"6393","ENSG00000131203","8",39902275,39928790,26515
"6394","ENSG00000131233","1",38874451,38881587,7136
"6395","ENSG00000131236","1",40040233,40072649,32416
"6396","ENSG00000131238","1",40071461,40097727,26266
"6397","ENSG00000131242","17",31391675,31538211,146536
"6398","ENSG00000131263","X",74585217,74614617,29400
"6399","ENSG00000131264","X",73447254,73455245,7991
"6400","ENSG00000131269","X",75051048,75156732,105684
"6401","ENSG00000131323","14",102777476,102911500,134024
"6402","ENSG00000131351","19",17049729,17075625,25896
"6403","ENSG00000131355","19",14619117,14690027,70910
"6404","ENSG00000131368","3",15042460,15065317,22857
"6405","ENSG00000131370","3",15254353,15341368,87015
"6406","ENSG00000131373","3",15560704,15601852,41148
"6407","ENSG00000131374","3",17157162,18444817,1287655
"6408","ENSG00000131375","3",15206152,15252916,46764
"6409","ENSG00000131378","3",16313574,16514026,200452
"6410","ENSG00000131379","3",14675099,14773034,97935
"6411","ENSG00000131381","3",15070073,15099163,29090
"6412","ENSG00000131386","3",16174680,16231992,57312
"6413","ENSG00000131389","3",14402576,14489349,86773
"6414","ENSG00000131398","19",50311937,50333515,21578
"6415","ENSG00000131400","19",50358477,50365830,7353
"6416","ENSG00000131401","19",50333796,50344767,10971
"6417","ENSG00000131408","19",50329653,50383387,53734
"6418","ENSG00000131409","19",50516892,50568435,51543
"6419","ENSG00000131435","5",132257696,132273454,15758
"6420","ENSG00000131437","5",132692628,132737638,45010
"6421","ENSG00000131446","5",180784782,180815652,30870
"6422","ENSG00000131459","5",180300698,180353336,52638
"6423","ENSG00000131462","17",42609683,42615238,5555
"6424","ENSG00000131467","17",42824385,42843758,19373
"6425","ENSG00000131469","17",42998273,43002959,4686
"6426","ENSG00000131470","17",42572315,42577831,5516
"6427","ENSG00000131471","17",42851184,42858130,6946
"6428","ENSG00000131473","17",41866917,41930542,63625
"6429","ENSG00000131475","17",42773449,42779599,6150
"6430","ENSG00000131477","17",42758447,42763041,4594
"6431","ENSG00000131480","17",42844580,42850707,6127
"6432","ENSG00000131482","17",42900797,42913369,12572
"6433","ENSG00000131484","17",45533963,45534710,747
"6434","ENSG00000131495","5",140638740,140647785,9045
"6435","ENSG00000131503","5",140401814,140539856,138042
"6436","ENSG00000131504","5",141515016,141619055,104039
"6437","ENSG00000131507","5",142108779,142154440,45661
"6438","ENSG00000131508","5",139526431,139628434,102003
"6439","ENSG00000131558","7",133253073,134066589,813516
"6440","ENSG00000131584","1",1292390,1309609,17219
"6441","ENSG00000131591","1",1081818,1116361,34543
"6442","ENSG00000131620","11",70078302,70189528,111226
"6443","ENSG00000131626","11",70270700,70385312,114612
"6444","ENSG00000131634","16",1528688,1555580,26892
"6445","ENSG00000131650","16",2964216,2968383,4167
"6446","ENSG00000131652","16",3024027,3027755,3728
"6447","ENSG00000131653","16",2155698,2178129,22431
"6448","ENSG00000131668","9",93951627,93955355,3728
"6449","ENSG00000131669","9",93121496,93134251,12755
"6450","ENSG00000131686","1",8945867,8975092,29225
"6451","ENSG00000131697","1",5862811,5992473,129662
"6452","ENSG00000131711","5",72107234,72209565,102331
"6453","ENSG00000131721","X",120158561,120165630,7069
"6454","ENSG00000131724","X",118727133,118794535,67402
"6455","ENSG00000131725","X",118346073,118449961,103888
"6456","ENSG00000131730","5",81233320,81266398,33078
"6457","ENSG00000131732","5",81301587,81313297,11710
"6458","ENSG00000131737","17",41377650,41382403,4753
"6459","ENSG00000131738","17",41363494,41369800,6306
"6460","ENSG00000131746","17",40475828,40501623,25795
"6461","ENSG00000131747","17",40388525,40417896,29371
"6462","ENSG00000131748","17",39637090,39664201,27111
"6463","ENSG00000131759","17",40309180,40357643,48463
"6464","ENSG00000131771","17",39626740,39636626,9886
"6465","ENSG00000131773","8",135457456,135656722,199266
"6466","ENSG00000131778","1",147242654,147295765,53111
"6467","ENSG00000131779","1",145911350,145918717,7367
"6468","ENSG00000131781","1",147175351,147243050,67699
"6469","ENSG00000131788","1",145848522,145859836,11314
"6470","ENSG00000131791","1",147155106,147172550,17444
"6471","ENSG00000131797","16",31700590,31711986,11396
"6472","ENSG00000131808","11",30231016,30235261,4245
"6473","ENSG00000131828","X",19343893,19361705,17812
"6474","ENSG00000131831","X",17800049,17861337,61288
"6475","ENSG00000131844","5",71587288,71658706,71418
"6476","ENSG00000131845","19",57351307,57359898,8591
"6477","ENSG00000131848","19",56219670,56368383,148713
"6478","ENSG00000131849","19",58432814,58440153,7339
"6479","ENSG00000131864","19",57119138,57131926,12788
"6480","ENSG00000131871","15",101270817,101277500,6683
"6481","ENSG00000131873","15",101175727,101252048,76321
"6482","ENSG00000131876","15",101281510,101295282,13772
"6483","ENSG00000131885","17",16840895,16845881,4986
"6484","ENSG00000131899","17",18225635,18244875,19240
"6485","ENSG00000131910","1",26911489,26913975,2486
"6486","ENSG00000131914","1",26410817,26429728,18911
"6487","ENSG00000131931","8",42836674,42843325,6651
"6488","ENSG00000131941","19",32978592,33064888,86296
"6489","ENSG00000131943","19",29698886,29715789,16903
"6490","ENSG00000131944","19",32972209,32978222,6013
"6491","ENSG00000131951","14",59919713,60063559,143846
"6492","ENSG00000131966","14",58200080,58235636,35556
"6493","ENSG00000131969","14",50872053,50904970,32917
"6494","ENSG00000131979","14",54842008,54902826,60818
"6495","ENSG00000131981","14",55124110,55145423,21313
"6496","ENSG00000131982","12",20449655,20450083,428
"6497","ENSG00000132000","19",13931187,13953392,22205
"6498","ENSG00000132002","19",14514769,14529770,15001
"6499","ENSG00000132003","19",13795460,13832230,36770
"6500","ENSG00000132004","19",12688053,12696631,8578
"6501","ENSG00000132005","19",13961530,14007039,45509
"6502","ENSG00000132010","19",12092843,12140355,47512
"6503","ENSG00000132016","19",13882348,13906452,24104
"6504","ENSG00000132017","19",13952492,13961449,8957
"6505","ENSG00000132024","19",13906201,13930879,24678
"6506","ENSG00000132026","19",12825478,12835428,9950
"6507","ENSG00000132031","2",19992052,20012668,20616
"6508","ENSG00000132109","11",4384897,4393702,8805
"6509","ENSG00000132122","1",48295373,48472208,176835
"6510","ENSG00000132128","1",46261196,46303608,42412
"6511","ENSG00000132141","17",34927859,34981078,53219
"6512","ENSG00000132153","3",47802909,47850195,47286
"6513","ENSG00000132155","3",12583601,12664226,80625
"6514","ENSG00000132164","3",10816201,10940714,124513
"6515","ENSG00000132170","3",12287368,12434356,146988
"6516","ENSG00000132182","3",13316235,13420322,104087
"6517","ENSG00000132185","1",161706972,161714352,7380
"6518","ENSG00000132196","1",162790702,162812817,22115
"6519","ENSG00000132199","18",670318,712662,42344
"6520","ENSG00000132204","18",1254383,1408344,153961
"6521","ENSG00000132205","18",2847006,2916003,68997
"6522","ENSG00000132207","16",30193887,30197561,3674
"6523","ENSG00000132254","11",6474683,6481479,6796
"6524","ENSG00000132256","11",5663557,5938619,275062
"6525","ENSG00000132259","11",6234765,6244429,9664
"6526","ENSG00000132274","11",5689697,5737089,47392
"6527","ENSG00000132275","11",6595072,6603616,8544
"6528","ENSG00000132286","11",6481501,6484681,3180
"6529","ENSG00000132294","8",131904093,132013642,109549
"6530","ENSG00000132297","8",132061486,132111159,49673
"6531","ENSG00000132300","2",86106223,86142157,35934
"6532","ENSG00000132305","2",86143932,86195770,51838
"6533","ENSG00000132313","2",86199355,86213790,14435
"6534","ENSG00000132321","2",236324147,236507535,183388
"6535","ENSG00000132323","2",238170402,238203708,33306
"6536","ENSG00000132326","2",238244044,238290102,46058
"6537","ENSG00000132329","2",237858893,237912106,53213
"6538","ENSG00000132330","2",238060889,238099413,38524
"6539","ENSG00000132334","10",127907061,128085855,178794
"6540","ENSG00000132341","12",130872037,130877678,5641
"6541","ENSG00000132356","5",40759379,40798374,38995
"6542","ENSG00000132357","5",40841308,40860175,18867
"6543","ENSG00000132359","17",2755705,3037741,282036
"6544","ENSG00000132361","17",2689386,2712663,23277
"6545","ENSG00000132376","17",1494577,1516742,22165
"6546","ENSG00000132382","17",4538897,4555631,16734
"6547","ENSG00000132383","17",1829702,1900082,70380
"6548","ENSG00000132386","17",1762029,1777565,15536
"6549","ENSG00000132388","17",4269259,4366628,97369
"6550","ENSG00000132394","3",128153481,128408646,255165
"6551","ENSG00000132405","4",6909242,7033118,123876
"6552","ENSG00000132406","4",4235542,4248223,12681
"6553","ENSG00000132423","6",99369401,99394195,24794
"6554","ENSG00000132424","6",99398050,99425331,27281
"6555","ENSG00000132429","6",105157900,105180014,22114
"6556","ENSG00000132432","7",54752250,54759974,7724
"6557","ENSG00000132434","7",55365448,55433742,68294
"6558","ENSG00000132436","7",50444128,50542535,98407
"6559","ENSG00000132437","7",50458436,50565405,106969
"6560","ENSG00000132446","X",31071233,31072041,808
"6561","ENSG00000132463","4",70815783,70839897,24114
"6562","ENSG00000132464","4",70628744,70646824,18080
"6563","ENSG00000132465","4",70655541,70681817,26276
"6564","ENSG00000132466","4",73073376,73258798,185422
"6565","ENSG00000132467","4",70688532,70690551,2019
"6566","ENSG00000132470","17",75721328,75757818,36490
"6567","ENSG00000132471","17",75845699,75856507,10808
"6568","ENSG00000132475","17",75776434,75785893,9459
"6569","ENSG00000132478","17",75784806,75825799,40993
"6570","ENSG00000132481","17",75874164,75878581,4417
"6571","ENSG00000132485","1",71063291,71081289,17998
"6572","ENSG00000132507","17",7306999,7312463,5464
"6573","ENSG00000132510","17",7839904,7854796,14892
"6574","ENSG00000132514","17",7074537,7080307,5770
"6575","ENSG00000132517","17",5032600,5052009,19409
"6576","ENSG00000132518","17",8002594,8020339,17745
"6577","ENSG00000132522","17",7311324,7315564,4240
"6578","ENSG00000132530","17",6755447,6775647,20200
"6579","ENSG00000132535","17",7187169,7219841,32672
"6580","ENSG00000132541","8",98102344,98117171,14827
"6581","ENSG00000132549","8",99013266,99877580,864314
"6582","ENSG00000132554","8",99960936,100131268,170332
"6583","ENSG00000132561","8",97868840,98036724,167884
"6584","ENSG00000132563","5",138439057,138446969,7912
"6585","ENSG00000132570","5",134904906,135007959,103053
"6586","ENSG00000132581","17",28648356,28662189,13833
"6587","ENSG00000132589","17",28879335,28897733,18398
"6588","ENSG00000132591","17",28855010,28861061,6051
"6589","ENSG00000132600","16",68310974,68358563,47589
"6590","ENSG00000132603","16",69337996,69343106,5110
"6591","ENSG00000132604","16",69355567,69408571,53004
"6592","ENSG00000132612","16",69311350,69326939,15589
"6593","ENSG00000132613","16",70661204,70686053,24849
"6594","ENSG00000132622","20",3732685,3753111,20426
"6595","ENSG00000132623","20",9986126,10058303,72177
"6596","ENSG00000132631","20",18813726,18814392,666
"6597","ENSG00000132635","20",2835314,2841190,5876
"6598","ENSG00000132639","20",10218830,10307418,88588
"6599","ENSG00000132640","20",11890723,11926609,35886
"6600","ENSG00000132646","20",5114953,5126626,11673
"6601","ENSG00000132661","20",23350791,23354771,3980
"6602","ENSG00000132664","20",18467389,18484646,17257
"6603","ENSG00000132669","20",19757606,20002459,244853
"6604","ENSG00000132670","20",2864184,3039076,174892
"6605","ENSG00000132671","20",23035386,23036812,1426
"6606","ENSG00000132676","1",155687960,155739010,51050
"6607","ENSG00000132677","1",156369211,156385219,16008
"6608","ENSG00000132680","1",155913045,155934413,21368
"6609","ENSG00000132681","1",160151570,160186977,35407
"6610","ENSG00000132688","1",156668763,156677407,8644
"6611","ENSG00000132692","1",156641390,156659532,18142
"6612","ENSG00000132693","1",159712289,159714589,2300
"6613","ENSG00000132694","1",156934840,157045370,110530
"6614","ENSG00000132698","1",156061160,156070504,9344
"6615","ENSG00000132702","1",156619331,156625725,6394
"6616","ENSG00000132703","1",159587826,159588865,1039
"6617","ENSG00000132704","1",157745733,157777132,31399
"6618","ENSG00000132716","1",160215715,160262531,46816
"6619","ENSG00000132718","1",155859567,155885199,25632
"6620","ENSG00000132740","11",68903842,68940602,36760
"6621","ENSG00000132744","11",67642555,67650730,8175
"6622","ENSG00000132746","11",67662162,67681200,19038
"6623","ENSG00000132749","11",68707440,68751520,44080
"6624","ENSG00000132763","1",45500300,45513382,13082
"6625","ENSG00000132768","1",43970000,43973369,3369
"6626","ENSG00000132773","1",45340052,45343973,3921
"6627","ENSG00000132780","1",45583846,45618904,35058
"6628","ENSG00000132781","1",45329163,45340470,11307
"6629","ENSG00000132792","20",37693955,37872129,178174
"6630","ENSG00000132793","20",41340920,41360582,19662
"6631","ENSG00000132801","20",45857614,45879122,21508
"6632","ENSG00000132819","20",57391396,57409333,17937
"6633","ENSG00000132821","20",37903111,37945350,42239
"6634","ENSG00000132823","20",44195939,44210771,14832
"6635","ENSG00000132824","20",44496221,44522085,25864
"6636","ENSG00000132825","20",59936663,59940305,3642
"6637","ENSG00000132832","20",44656451,44696096,39645
"6638","ENSG00000132837","5",78997606,79236038,238432
"6639","ENSG00000132840","5",79069767,79090069,20302
"6640","ENSG00000132842","5",78000525,78294755,294230
"6641","ENSG00000132846","5",77072072,77087285,15213
"6642","ENSG00000132849","1",61742406,62178675,436269
"6643","ENSG00000132854","1",62236165,62319434,83269
"6644","ENSG00000132855","1",62597487,62606159,8672
"6645","ENSG00000132872","18",43267892,43277535,9643
"6646","ENSG00000132874","18",45212995,45683686,470691
"6647","ENSG00000132879","1",11654375,11663327,8952
"6648","ENSG00000132881","1",16231692,16237183,5491
"6649","ENSG00000132906","1",15490832,15526534,35702
"6650","ENSG00000132911","5",152391532,152433368,41836
"6651","ENSG00000132912","5",150708440,150759109,50669
"6652","ENSG00000132915","5",149857953,149944793,86840
"6653","ENSG00000132932","13",25371974,26025851,653877
"6654","ENSG00000132938","13",28820348,29505947,685599
"6655","ENSG00000132950","13",19823482,19863649,40167
"6656","ENSG00000132952","13",30617693,30660770,43077
"6657","ENSG00000132953","13",20777329,20903048,125719
"6658","ENSG00000132958","13",19422877,19536762,113885
"6659","ENSG00000132963","13",28659104,28678959,19855
"6660","ENSG00000132964","13",26254104,26405238,151134
"6661","ENSG00000132965","13",30713478,30764426,50948
"6662","ENSG00000132967","3",22381819,22382929,1110
"6663","ENSG00000132970","13",26557703,26688948,131245
"6664","ENSG00000132972","13",24764169,24879921,115752
"6665","ENSG00000132975","13",26755200,26760786,5586
"6666","ENSG00000133019","1",239386565,239915452,528887
"6667","ENSG00000133020","17",10390322,10421950,31628
"6668","ENSG00000133026","17",8474205,8630761,156556
"6669","ENSG00000133027","17",17505563,17591708,86145
"6670","ENSG00000133028","17",10672474,10698375,25901
"6671","ENSG00000133030","17",17042545,17217679,175134
"6672","ENSG00000133048","1",203178931,203186704,7773
"6673","ENSG00000133055","1",203167811,203175826,8015
"6674","ENSG00000133056","1",204422628,204494724,72096
"6675","ENSG00000133059","1",205142505,205211702,69197
"6676","ENSG00000133063","1",203212827,203273641,60814
"6677","ENSG00000133065","1",205789094,205813748,24654
"6678","ENSG00000133067","1",202193901,202319781,125880
"6679","ENSG00000133069","1",205227946,205285632,57686
"6680","ENSG00000133083","13",35768652,36131306,362654
"6681","ENSG00000133101","13",36431520,36442870,11350
"6682","ENSG00000133103","13",39655627,39791665,136038
"6683","ENSG00000133104","13",36301638,36370180,68542
"6684","ENSG00000133105","13",31739526,31803389,63863
"6685","ENSG00000133106","13",42886388,42992271,105883
"6686","ENSG00000133107","13",37636636,37870425,233789
"6687","ENSG00000133110","13",37562583,37598844,36261
"6688","ENSG00000133111","13",36819224,36829104,9880
"6689","ENSG00000133112","13",45333471,45341370,7899
"6690","ENSG00000133114","13",44989529,45037669,48140
"6691","ENSG00000133115","13",38965925,38991066,25141
"6692","ENSG00000133116","13",33016423,33066143,49720
"6693","ENSG00000133119","13",33818069,33966558,148489
"6694","ENSG00000133121","13",33103137,33350630,247493
"6695","ENSG00000133124","X",108732482,108736409,3927
"6696","ENSG00000133131","X",106813871,107000212,186341
"6697","ENSG00000133134","X",103309346,103311046,1700
"6698","ENSG00000133135","X",106693794,106797016,103222
"6699","ENSG00000133136","X",110346703,110346909,206
"6700","ENSG00000133138","X",106802673,106876150,73477
"6701","ENSG00000133142","X",103576231,103587736,11505
"6702","ENSG00000133169","X",103062651,103064171,1520
"6703","ENSG00000133193","17",73207353,73236753,29400
"6704","ENSG00000133195","17",72645949,73092712,446763
"6705","ENSG00000133216","1",22710839,22921500,210661
"6706","ENSG00000133226","1",24631716,24673281,41565
"6707","ENSG00000133243","19",1985438,2034881,49443
"6708","ENSG00000133246","19",8490056,8502640,12584
"6709","ENSG00000133247","19",55339853,55348121,8268
"6710","ENSG00000133250","19",8509678,8514167,4489
"6711","ENSG00000133256","4",625584,670782,45198
"6712","ENSG00000133265","19",55262223,55280381,18158
"6713","ENSG00000133275","19",1941172,1981338,40166
"6714","ENSG00000133302","5",94618669,94739436,120767
"6715","ENSG00000133313","18",74495816,74523454,27638
"6716","ENSG00000133315","11",63998558,64166113,167555
"6717","ENSG00000133316","11",62832342,62841809,9467
"6718","ENSG00000133317","11",63506084,63516774,10690
"6719","ENSG00000133318","11",63681446,63759891,78445
"6720","ENSG00000133321","11",63536808,63546462,9654
"6721","ENSG00000133328","11",63552770,63563379,10609
"6722","ENSG00000133392","16",15703135,15857028,153893
"6723","ENSG00000133393","16",15865719,15888625,22906
"6724","ENSG00000133398","5",6371874,6378571,6697
"6725","ENSG00000133401","5",31639131,32110932,471801
"6726","ENSG00000133422","22",30925130,30968774,43644
"6727","ENSG00000133424","22",33162226,33922841,760615
"6728","ENSG00000133433","22",23957414,23961186,3772
"6729","ENSG00000133454","22",25742144,26031041,288897
"6730","ENSG00000133460","22",23856703,23886309,29606
"6731","ENSG00000133466","22",37180166,37199385,19219
"6732","ENSG00000133475","22",21207973,21227637,19664
"6733","ENSG00000133477","22",39994954,40043534,48580
"6734","ENSG00000133488","22",30488913,30505711,16798
"6735","ENSG00000133519","22",23390606,23402726,12120
"6736","ENSG00000133561","7",150625375,150632648,7273
"6737","ENSG00000133574","7",150567369,150573953,6584
"6738","ENSG00000133597","7",140672945,140696261,23316
"6739","ENSG00000133606","7",140453033,140479536,26503
"6740","ENSG00000133612","7",151085831,151144436,58605
"6741","ENSG00000133619","7",149714781,149734575,19794
"6742","ENSG00000133624","7",149547154,149624752,77598
"6743","ENSG00000133627","7",152759749,152855378,95629
"6744","ENSG00000133636","12",85874295,85882992,8697
"6745","ENSG00000133639","12",92140278,92145846,5568
"6746","ENSG00000133640","12",85036314,85264457,228143
"6747","ENSG00000133641","12",88033846,88050160,16314
"6748","ENSG00000133657","3",194402672,194498364,95692
"6749","ENSG00000133661","10",79937740,79982614,44874
"6750","ENSG00000133665","10",80344745,80368073,23328
"6751","ENSG00000133678","10",80078646,80092557,13911
"6752","ENSG00000133687","12",29500840,29784759,283919
"6753","ENSG00000133703","12",25204789,25250936,46147
"6754","ENSG00000133704","12",30628988,30695869,66881
"6755","ENSG00000133706","5",146113034,146182650,69616
"6756","ENSG00000133710","5",148025683,148137289,111606
"6757","ENSG00000133731","8",81656914,81686331,29417
"6758","ENSG00000133739","8",85107215,85146080,38865
"6759","ENSG00000133740","8",85177154,85217158,40004
"6760","ENSG00000133742","8",85327608,85379014,51406
"6761","ENSG00000133773","12",82223681,82358805,135124
"6762","ENSG00000133789","11",9664077,9752993,88916
"6763","ENSG00000133794","11",13276652,13387266,110614
"6764","ENSG00000133800","11",10556966,10611689,54723
"6765","ENSG00000133805","11",10308313,10507579,199266
"6766","ENSG00000133812","11",9778667,10294207,515540
"6767","ENSG00000133816","11",12094008,12359144,265136
"6768","ENSG00000133818","11",14277922,14364506,86584
"6769","ENSG00000133835","5",119452473,119637199,184726
"6770","ENSG00000133858","12",71609472,71667725,58253
"6771","ENSG00000133863","8",30831544,30913003,81459
"6772","ENSG00000133872","8",30063012,30083208,20196
"6773","ENSG00000133874","8",33547754,33567128,19374
"6774","ENSG00000133878","8",33591330,33600023,8693
"6775","ENSG00000133884","11",65333852,65354262,20410
"6776","ENSG00000133895","11",64803510,64811294,7784
"6777","ENSG00000133935","14",75649791,75661189,11398
"6778","ENSG00000133937","14",94768216,94770230,2014
"6779","ENSG00000133943","14",91060333,91225632,165299
"6780","ENSG00000133958","14",93333219,93707876,374657
"6781","ENSG00000133961","14",73275107,73458617,183510
"6782","ENSG00000133962","14",91580696,91780707,200011
"6783","ENSG00000133980","14",74303069,74360008,56939
"6784","ENSG00000133983","14",70325081,70416984,91903
"6785","ENSG00000133985","14",70641916,70675366,33450
"6786","ENSG00000133997","14",70581257,70600690,19433
"6787","ENSG00000134001","14",67360328,67386516,26188
"6788","ENSG00000134007","14",70522358,70535015,12657
"6789","ENSG00000134013","8",23297189,23425328,128139
"6790","ENSG00000134014","8",28089673,28191156,101483
"6791","ENSG00000134020","8",22713251,23000000,286749
"6792","ENSG00000134028","8",24384285,24406013,21728
"6793","ENSG00000134030","18",48539031,48863217,324186
"6794","ENSG00000134042","18",50795120,50825402,30282
"6795","ENSG00000134046","18",54151606,54224669,73063
"6796","ENSG00000134049","18",47152834,47176364,23530
"6797","ENSG00000134056","5",69217760,69230158,12398
"6798","ENSG00000134057","5",69167135,69178245,11110
"6799","ENSG00000134058","5",69234795,69277430,42635
"6800","ENSG00000134061","5",67179613,67196799,17186
"6801","ENSG00000134070","3",10164919,10243745,78826
"6802","ENSG00000134072","3",9757347,9769992,12645
"6803","ENSG00000134077","3",9362971,9386791,23820
"6804","ENSG00000134086","3",10141008,10152220,11212
"6805","ENSG00000134107","3",4979116,4985323,6207
"6806","ENSG00000134108","3",5122245,5180912,58667
"6807","ENSG00000134109","3",5187646,5219958,32312
"6808","ENSG00000134115","3",1092658,1404217,311559
"6809","ENSG00000134121","3",196763,409417,212654
"6810","ENSG00000134138","15",36889204,37101299,212095
"6811","ENSG00000134146","15",35217345,35546193,328848
"6812","ENSG00000134152","15",34140674,34210096,69422
"6813","ENSG00000134153","15",34084017,34101862,17845
"6814","ENSG00000134160","15",31001061,31161273,160212
"6815","ENSG00000134183","1",109603267,109619929,16662
"6816","ENSG00000134184","1",109687814,109709039,21225
"6817","ENSG00000134186","1",108692310,108702928,10618
"6818","ENSG00000134193","1",119794017,119811580,17563
"6819","ENSG00000134198","1",115048011,115089503,41492
"6820","ENSG00000134200","1",115029824,115034309,4485
"6821","ENSG00000134201","1",109711780,109775428,63648
"6822","ENSG00000134202","1",109733932,109741038,7106
"6823","ENSG00000134207","1",114089291,114153919,64628
"6824","ENSG00000134215","1",107571161,107965180,394019
"6825","ENSG00000134216","1",111290851,111320566,29715
"6826","ENSG00000134222","1",109279556,109283186,3630
"6827","ENSG00000134240","1",119747996,119768905,20909
"6828","ENSG00000134242","1",113813811,113871753,57942
"6829","ENSG00000134243","1",109309568,109397918,88350
"6830","ENSG00000134245","1",112466541,112530165,63624
"6831","ENSG00000134247","1",116909916,116990353,80437
"6832","ENSG00000134248","1",110401249,110407942,6693
"6833","ENSG00000134249","1",119893533,119896495,2962
"6834","ENSG00000134250","1",119911553,120100779,189226
"6835","ENSG00000134253","1",117111060,117122587,11527
"6836","ENSG00000134255","1",111139627,111185104,45477
"6837","ENSG00000134256","1",117001750,117036476,34726
"6838","ENSG00000134258","1",117143587,117210960,67373
"6839","ENSG00000134259","1",115285918,115338236,52318
"6840","ENSG00000134262","1",113894194,113905201,11007
"6841","ENSG00000134265","18",10525905,10552764,26859
"6842","ENSG00000134278","18",12446512,12658134,211622
"6843","ENSG00000134283","12",42238447,42459715,221268
"6844","ENSG00000134285","12",48921518,48926474,4956
"6845","ENSG00000134287","12",48935723,48957487,21764
"6846","ENSG00000134291","12",47963569,47968878,5309
"6847","ENSG00000134294","12",46358188,46372773,14585
"6848","ENSG00000134297","12",45173064,45216041,42977
"6849","ENSG00000134308","2",9583967,9630997,47030
"6850","ENSG00000134313","2",8721081,8837630,116549
"6851","ENSG00000134317","2",9951693,10002277,50584
"6852","ENSG00000134318","2",11179759,11348330,168571
"6853","ENSG00000134321","2",6865806,6898239,32433
"6854","ENSG00000134323","2",15940550,15947007,6457
"6855","ENSG00000134324","2",11677595,11827409,149814
"6856","ENSG00000134326","2",6840570,6866635,26065
"6857","ENSG00000134330","2",9473658,9496543,22885
"6858","ENSG00000134333","11",18394560,18408425,13865
"6859","ENSG00000134339","11",18239223,18248643,9420
"6860","ENSG00000134343","11",26309599,26663289,353690
"6861","ENSG00000134352","5",55935095,55995022,59927
"6862","ENSG00000134363","5",53480626,53487134,6508
"6863","ENSG00000134365","1",196888014,196918713,30699
"6864","ENSG00000134369","1",201622885,201826969,204084
"6865","ENSG00000134371","1",193121958,193254815,132857
"6866","ENSG00000134375","1",201955503,201970664,15161
"6867","ENSG00000134376","1",197268204,197478455,210251
"6868","ENSG00000134389","1",196977556,197009674,32118
"6869","ENSG00000134398","16",23690310,23713226,22916
"6870","ENSG00000134419","16",18781295,18790383,9088
"6871","ENSG00000134438","18",59267035,59274086,7051
"6872","ENSG00000134440","18",57600656,57622213,21557
"6873","ENSG00000134443","18",59220158,59230774,10616
"6874","ENSG00000134444","18",62187255,62310217,122962
"6875","ENSG00000134452","10",5890203,5937594,47391
"6876","ENSG00000134453","10",6089034,6117457,28423
"6877","ENSG00000134460","10",6010689,6062370,51681
"6878","ENSG00000134461","10",5861616,5889906,28290
"6879","ENSG00000134463","10",11742366,11764070,21704
"6880","ENSG00000134470","10",5943639,5978187,34548
"6881","ENSG00000134480","5",87318416,87412930,94514
"6882","ENSG00000134489","18",24460637,24479961,19324
"6883","ENSG00000134490","18",23197144,23437961,240817
"6884","ENSG00000134504","18",26454910,26657401,202491
"6885","ENSG00000134508","18",23134564,23260467,125903
"6886","ENSG00000134516","5",169637268,170083382,446114
"6887","ENSG00000134531","12",13196723,13219941,23218
"6888","ENSG00000134532","12",23529504,24562544,1033040
"6889","ENSG00000134533","12",15107783,15348675,240892
"6890","ENSG00000134538","12",21131202,21239246,108044
"6891","ENSG00000134539","12",10226058,10329608,103550
"6892","ENSG00000134545","12",10442264,10454685,12421
"6893","ENSG00000134548","12",21526296,21541249,14953
"6894","ENSG00000134551","12",10929236,10932341,3105
"6895","ENSG00000134569","11",46856717,46918642,61925
"6896","ENSG00000134571","11",47331406,47352702,21296
"6897","ENSG00000134574","11",47214465,47239240,24775
"6898","ENSG00000134575","11",47239305,47248906,9601
"6899","ENSG00000134588","X",133024631,133097109,72478
"6900","ENSG00000134590","X",135032366,135033546,1180
"6901","ENSG00000134594","X",130171962,130184870,12908
"6902","ENSG00000134595","X",140502985,140505116,2131
"6903","ENSG00000134597","X",130401987,130413656,11669
"6904","ENSG00000134602","X",132023302,132075943,52641
"6905","ENSG00000134612","11",89639237,89698718,59481
"6906","ENSG00000134627","11",94543840,94621421,77581
"6907","ENSG00000134640","11",92969720,92985066,15346
"6908","ENSG00000134644","1",30931506,31065991,134485
"6909","ENSG00000134668","1",31790422,31816051,25629
"6910","ENSG00000134684","1",32775237,32818153,42916
"6911","ENSG00000134686","1",33323623,33431052,107429
"6912","ENSG00000134690","1",37692481,37709719,17238
"6913","ENSG00000134697","1",37566816,37595937,29121
"6914","ENSG00000134698","1",35808016,35857890,49874
"6915","ENSG00000134709","1",59814786,59876370,61584
"6916","ENSG00000134716","1",59893308,59926773,33465
"6917","ENSG00000134717","1",52056199,52090716,34517
"6918","ENSG00000134744","1",52408282,52553487,145205
"6919","ENSG00000134748","1",52404602,52420836,16234
"6920","ENSG00000134755","18",31058840,31102522,43682
"6921","ENSG00000134757","18",31447741,31478702,30961
"6922","ENSG00000134758","18",32091874,32131561,39687
"6923","ENSG00000134759","18",36129444,36180557,51113
"6924","ENSG00000134760","18",31318160,31359246,41086
"6925","ENSG00000134762","18",30989365,31042815,53450
"6926","ENSG00000134765","18",31129236,31162856,33620
"6927","ENSG00000134769","18",34493290,34891844,398554
"6928","ENSG00000134775","18",36297714,36780055,482341
"6929","ENSG00000134779","18",36777647,36829216,51569
"6930","ENSG00000134780","11",61680391,61747001,66610
"6931","ENSG00000134802","11",57406954,57427580,20626
"6932","ENSG00000134809","11",57528464,57530803,2339
"6933","ENSG00000134812","11",59829273,59845499,16226
"6934","ENSG00000134815","19",47349315,47382704,33389
"6935","ENSG00000134817","11",57233577,57237314,3737
"6936","ENSG00000134824","11",61792980,61867354,74374
"6937","ENSG00000134825","11",61768501,61792802,24301
"6938","ENSG00000134827","11",59852800,59866489,13689
"6939","ENSG00000134830","19",47332147,47347327,15180
"6940","ENSG00000134851","4",55395957,55453397,57440
"6941","ENSG00000134852","4",55427903,55546909,119006
"6942","ENSG00000134853","4",54229280,54298245,68965
"6943","ENSG00000134864","13",100530164,100589528,59364
"6944","ENSG00000134871","13",110305812,110513209,207397
"6945","ENSG00000134873","13",95433604,95579759,146155
"6946","ENSG00000134874","13",95578202,95644703,66501
"6947","ENSG00000134882","13",99200774,99386434,185660
"6948","ENSG00000134884","13",106541673,106568137,26464
"6949","ENSG00000134897","13",102799119,102841533,42414
"6950","ENSG00000134899","13",102807146,102876001,68855
"6951","ENSG00000134900","13",102596986,102679958,82972
"6952","ENSG00000134901","13",102784281,102798976,14695
"6953","ENSG00000134905","13",110641412,110713603,72191
"6954","ENSG00000134909","11",128965060,129279324,314264
"6955","ENSG00000134910","11",125591712,125625215,33503
"6956","ENSG00000134917","11",130404923,130428609,23686
"6957","ENSG00000134940","11",125671522,125681123,9601
"6958","ENSG00000134954","11",128458761,128587558,128797
"6959","ENSG00000134955","11",125063067,125090312,27245
"6960","ENSG00000134962","4",39406930,39451533,44603
"6961","ENSG00000134970","5",115613210,115632992,19782
"6962","ENSG00000134982","5",112707498,112846239,138741
"6963","ENSG00000134986","5",111662621,111997464,334843
"6964","ENSG00000134987","5",111091716,111130502,38786
"6965","ENSG00000134996","9",75088543,75147265,58722
"6966","ENSG00000135002","9",76385526,76394517,8991
"6967","ENSG00000135018","9",83659968,83707958,47990
"6968","ENSG00000135040","9",85941146,86022298,81152
"6969","ENSG00000135045","9",74946583,74952912,6329
"6970","ENSG00000135046","9",73151865,73170393,18528
"6971","ENSG00000135047","9",87726109,87731469,5360
"6972","ENSG00000135048","9",71683366,71816690,133324
"6973","ENSG00000135049","9",85546539,85742029,195490
"6974","ENSG00000135052","9",86026146,86100173,74027
"6975","ENSG00000135063","9",69324567,69392558,67991
"6976","ENSG00000135069","9",78297125,78330093,32968
"6977","ENSG00000135070","9",86264546,86283102,18556
"6978","ENSG00000135074","5",157395534,157575775,180241
"6979","ENSG00000135077","5",157085832,157142869,57037
"6980","ENSG00000135083","5",160249106,160345396,96290
"6981","ENSG00000135090","12",118149801,118372907,223106
"6982","ENSG00000135093","12",109023089,109088023,64934
"6983","ENSG00000135094","12",113392445,113426301,33856
"6984","ENSG00000135097","12",120341330,120369164,27834
"6985","ENSG00000135100","12",120978543,121002512,23969
"6986","ENSG00000135108","12",117141988,117190531,48543
"6987","ENSG00000135111","12",114670255,114684175,13920
"6988","ENSG00000135114","12",121019111,121039242,20131
"6989","ENSG00000135116","12",116856144,116881441,25297
"6990","ENSG00000135119","12",116738178,116853631,115453
"6991","ENSG00000135124","12",121209857,121234106,24249
"6992","ENSG00000135127","12",119989869,120094494,104625
"6993","ENSG00000135144","12",113056709,113098028,41319
"6994","ENSG00000135148","12",112125538,112153604,28066
"6995","ENSG00000135164","7",87152361,87196337,43976
"6996","ENSG00000135175","7",97984684,97991169,6485
"6997","ENSG00000135185","7",87196160,87220587,24427
"6998","ENSG00000135205","7",77122434,77329533,207099
"6999","ENSG00000135211","7",77793728,77798434,4706
"7000","ENSG00000135218","7",80369575,80679277,309702
"7001","ENSG00000135220","4",68928463,68951804,23341
"7002","ENSG00000135222","4",69955256,69961007,5751
"7003","ENSG00000135226","4",69280499,69295050,14551
"7004","ENSG00000135241","7",108470417,108569666,99249
"7005","ENSG00000135245","7",128455849,128458418,2569
"7006","ENSG00000135248","7",128709061,128731743,22682
"7007","ENSG00000135249","7",105532169,105567677,35508
"7008","ENSG00000135250","7",105110704,105399308,288604
"7009","ENSG00000135253","7",128862451,128910719,48268
"7010","ENSG00000135269","7",116210506,116258783,48277
"7011","ENSG00000135272","7",114922154,115019202,97048
"7012","ENSG00000135297","6",73461578,73509236,47658
"7013","ENSG00000135298","6",68635282,69389506,754224
"7014","ENSG00000135299","6",89433152,89633834,200682
"7015","ENSG00000135312","6",77461753,77463773,2020
"7016","ENSG00000135314","6",73241314,73310365,69051
"7017","ENSG00000135315","6",84124241,84227643,103402
"7018","ENSG00000135316","6",85607785,85643792,36007
"7019","ENSG00000135317","6",85505496,85594156,88660
"7020","ENSG00000135318","6",85449584,85495791,46207
"7021","ENSG00000135324","6",84033772,84090881,57109
"7022","ENSG00000135333","6",93240020,93419559,179539
"7023","ENSG00000135334","6",87674860,87702233,27373
"7024","ENSG00000135336","6",87590067,87667453,77386
"7025","ENSG00000135338","6",79484991,79537458,52467
"7026","ENSG00000135341","6",90513573,90587072,73499
"7027","ENSG00000135346","6",87085498,87095406,9908
"7028","ENSG00000135362","11",36296288,36465204,168916
"7029","ENSG00000135363","11",33858576,33892076,33500
"7030","ENSG00000135365","11",45929323,46121178,191855
"7031","ENSG00000135372","11",34105617,34147670,42053
"7032","ENSG00000135373","11",34621093,34661057,39964
"7033","ENSG00000135374","11",34478793,34513805,35012
"7034","ENSG00000135378","11",32829927,32858120,28193
"7035","ENSG00000135387","11",34051731,34102610,50879
"7036","ENSG00000135390","12",53632726,53677408,44682
"7037","ENSG00000135392","12",55820960,55830824,9864
"7038","ENSG00000135404","12",55725323,55729707,4384
"7039","ENSG00000135406","12",49293252,49298686,5434
"7040","ENSG00000135407","12",57797376,57818704,21328
"7041","ENSG00000135409","12",53423855,53431672,7817
"7042","ENSG00000135414","12",55743280,55757278,13998
"7043","ENSG00000135423","12",56470944,56488414,17470
"7044","ENSG00000135424","12",55684568,55716043,31475
"7045","ENSG00000135426","12",54948015,54984762,36747
"7046","ENSG00000135436","12",49582885,49605639,22754
"7047","ENSG00000135437","12",55720367,55724705,4338
"7048","ENSG00000135439","12",57723761,57742157,18396
"7049","ENSG00000135441","12",55716037,55720087,4050
"7050","ENSG00000135443","12",52360006,52367481,7475
"7051","ENSG00000135446","12",57747727,57756013,8286
"7052","ENSG00000135447","12",54575387,54588659,13272
"7053","ENSG00000135451","12",49323236,49331731,8495
"7054","ENSG00000135452","12",57738013,57750219,12206
"7055","ENSG00000135454","12",57623409,57633239,9830
"7056","ENSG00000135457","12",51093663,51173134,79471
"7057","ENSG00000135469","12",56266858,56270966,4108
"7058","ENSG00000135472","12",49866896,49904217,37321
"7059","ENSG00000135473","12",56316223,56334053,17830
"7060","ENSG00000135476","12",53268299,53293643,25344
"7061","ENSG00000135477","12",52250466,52258867,8401
"7062","ENSG00000135480","12",52232520,52252186,19666
"7063","ENSG00000135482","12",56118260,56127514,9254
"7064","ENSG00000135486","12",54280193,54287088,6895
"7065","ENSG00000135502","12",57619527,57626151,6624
"7066","ENSG00000135503","12",51951699,51997078,45379
"7067","ENSG00000135506","12",57693955,57721557,27602
"7068","ENSG00000135517","12",56449502,56469166,19664
"7069","ENSG00000135519","12",49539030,49558337,19307
"7070","ENSG00000135521","6",143843338,143863812,20474
"7071","ENSG00000135525","6",136342281,136550819,208538
"7072","ENSG00000135535","6",109366514,109382467,15953
"7073","ENSG00000135537","6",108294894,108526796,231902
"7074","ENSG00000135540","6",138422043,138692571,270528
"7075","ENSG00000135541","6",135283532,135497765,214233
"7076","ENSG00000135547","6",125747664,125761269,13605
"7077","ENSG00000135549","6",122471917,122726373,254456
"7078","ENSG00000135569","6",132588673,132589686,1013
"7079","ENSG00000135577","6",142058330,142088799,30469
"7080","ENSG00000135587","6",109440724,109443919,3195
"7081","ENSG00000135596","6",109444062,109465968,21906
"7082","ENSG00000135597","6",138903493,138988261,84768
"7083","ENSG00000135604","6",144150526,144188370,37844
"7084","ENSG00000135605","4",48135783,48269838,134055
"7085","ENSG00000135617","2",73228010,73233239,5229
"7086","ENSG00000135622","2",74654228,74683853,29625
"7087","ENSG00000135624","2",73233420,73253021,19601
"7088","ENSG00000135625","2",73290929,73293705,2776
"7089","ENSG00000135631","2",73073382,73156721,83339
"7090","ENSG00000135632","2",73214222,73227221,12999
"7091","ENSG00000135636","2",71453722,71686768,233046
"7092","ENSG00000135637","2",74471986,74483408,11422
"7093","ENSG00000135638","2",72916260,72936071,19811
"7094","ENSG00000135643","12",70366290,70434292,68002
"7095","ENSG00000135655","12",62260338,62417431,157093
"7096","ENSG00000135677","12",64713445,64759431,45986
"7097","ENSG00000135678","12",68842197,68971570,129373
"7098","ENSG00000135679","12",68808177,68850686,42509
"7099","ENSG00000135686","16",84648511,84667686,19175
"7100","ENSG00000135697","16",81238689,81291142,52453
"7101","ENSG00000135698","16",82147798,82170224,22426
"7102","ENSG00000135702","16",75528535,75535247,6712
"7103","ENSG00000135709","16",85027751,85094230,66479
"7104","ENSG00000135720","16",66720893,66751609,30716
"7105","ENSG00000135722","16",67159932,67164570,4638
"7106","ENSG00000135723","16",67229387,67247481,18094
"7107","ENSG00000135736","16",57512181,57536571,24390
"7108","ENSG00000135740","16",67237683,67272191,34508
"7109","ENSG00000135744","1",230702523,230714122,11599
"7110","ENSG00000135747","1",246945547,247078811,133264
"7111","ENSG00000135749","1",232983435,233295725,312290
"7112","ENSG00000135750","1",233614004,233672512,58508
"7113","ENSG00000135763","1",229626247,229660200,33953
"7114","ENSG00000135766","1",231363751,231422287,58536
"7115","ENSG00000135773","1",230747384,230802003,54619
"7116","ENSG00000135775","1",230642481,230693982,51501
"7117","ENSG00000135776","1",229516582,229558707,42125
"7118","ENSG00000135778","1",232950605,232983882,33277
"7119","ENSG00000135801","1",229593111,229626047,32936
"7120","ENSG00000135821","1",182381704,182392206,10502
"7121","ENSG00000135823","1",180972712,181023121,50409
"7122","ENSG00000135824","1",182641816,182684576,42760
"7123","ENSG00000135828","1",182573634,182589256,15622
"7124","ENSG00000135829","1",182839347,182887982,48635
"7125","ENSG00000135835","1",180912897,180951614,38717
"7126","ENSG00000135837","1",179954773,180114875,160102
"7127","ENSG00000135838","1",182789293,182830384,41091
"7128","ENSG00000135842","1",184790724,184974508,183784
"7129","ENSG00000135845","1",172370189,172444086,73897
"7130","ENSG00000135862","1",183023420,183145592,122172
"7131","ENSG00000135870","1",173931214,174022297,91083
"7132","ENSG00000135898","2",230907318,230961066,53748
"7133","ENSG00000135899","2",230167293,230225729,58436
"7134","ENSG00000135900","2",223957463,223967714,10251
"7135","ENSG00000135902","2",232525993,232536667,10674
"7136","ENSG00000135903","2",222199888,222298996,99108
"7137","ENSG00000135905","2",224765090,225042445,277355
"7138","ENSG00000135912","2",218710835,218755416,44581
"7139","ENSG00000135913","2",218450251,218568351,118100
"7140","ENSG00000135914","2",231108230,231125042,16812
"7141","ENSG00000135916","2",230864639,230879248,14609
"7142","ENSG00000135917","2",227683763,227718028,34265
"7143","ENSG00000135919","2",223975045,224039318,64273
"7144","ENSG00000135924","2",219279267,219286900,7633
"7145","ENSG00000135925","2",218880852,218899581,18729
"7146","ENSG00000135926","2",218274197,218292586,18389
"7147","ENSG00000135929","2",218781749,218815293,33544
"7148","ENSG00000135930","2",232550674,232583644,32970
"7149","ENSG00000135931","2",231198546,231374837,176291
"7150","ENSG00000135932","2",230712842,230821075,108233
"7151","ENSG00000135940","2",97646040,97648383,2343
"7152","ENSG00000135945","2",99400475,99490035,89560
"7153","ENSG00000135951","2",98997261,99154964,157703
"7154","ENSG00000135953","2",102714630,102736888,22258
"7155","ENSG00000135956","2",96248516,96265994,17478
"7156","ENSG00000135960","2",108894471,108989372,94901
"7157","ENSG00000135966","2",105264391,105329735,65344
"7158","ENSG00000135968","2",108448561,108509415,60854
"7159","ENSG00000135972","2",105038069,105099960,61891
"7160","ENSG00000135973","2",105241743,105243049,1306
"7161","ENSG00000135974","2",105337532,105349211,11679
"7162","ENSG00000135976","2",97113218,97264434,151216
"7163","ENSG00000135999","2",148644440,148787569,143129
"7164","ENSG00000136002","2",130836916,131047263,210347
"7165","ENSG00000136003","12",108562582,108569384,6802
"7166","ENSG00000136010","12",105019784,105107643,87859
"7167","ENSG00000136011","12",103587273,103766719,179446
"7168","ENSG00000136014","12",95516560,95551476,34916
"7169","ENSG00000136021","12",100267140,100341724,74584
"7170","ENSG00000136026","12",106237881,106304279,66398
"7171","ENSG00000136040","12",94148577,94307675,159098
"7172","ENSG00000136044","12",105173297,105236203,62906
"7173","ENSG00000136045","12",107685799,107713162,27363
"7174","ENSG00000136048","12",101877580,102012130,134550
"7175","ENSG00000136051","12",105107324,105169134,61810
"7176","ENSG00000136052","12",104802553,104958744,156191
"7177","ENSG00000136059","3",37988059,38007188,19129
"7178","ENSG00000136068","3",58008400,58172251,163851
"7179","ENSG00000136098","13",52132639,52159861,27222
"7180","ENSG00000136099","13",52842889,52848641,5752
"7181","ENSG00000136100","13",52412602,52450634,38032
"7182","ENSG00000136104","13",50909678,51024120,114442
"7183","ENSG00000136108","13",52455429,52476628,21199
"7184","ENSG00000136110","13",52703264,52739820,36556
"7185","ENSG00000136111","13",75283503,75482114,198611
"7186","ENSG00000136114","13",52377167,52416373,39206
"7187","ENSG00000136122","13",72727749,72756198,28449
"7188","ENSG00000136141","13",46553168,46753040,199872
"7189","ENSG00000136143","13",47745736,48037968,292232
"7190","ENSG00000136144","13",49531946,49585558,53612
"7191","ENSG00000136146","13",48053323,48095131,41808
"7192","ENSG00000136147","13",49495610,49528981,33371
"7193","ENSG00000136149","13",54440704,54441315,611
"7194","ENSG00000136152","13",45464898,45536701,71803
"7195","ENSG00000136153","13",75620434,75859870,239436
"7196","ENSG00000136155","13",77535674,77645263,109589
"7197","ENSG00000136156","13",48232612,48270357,37745
"7198","ENSG00000136158","13",80335976,80341126,5150
"7199","ENSG00000136159","13",48037726,48047221,9495
"7200","ENSG00000136160","13",77895481,77975529,80048
"7201","ENSG00000136161","13",48488959,48533256,44297
"7202","ENSG00000136167","13",46125920,46211871,85951
"7203","ENSG00000136169","13",49444374,49495003,50629
"7204","ENSG00000136193","7",29920104,29990289,70185
"7205","ENSG00000136197","7",42908726,42912305,3579
"7206","ENSG00000136205","7",47275154,47582558,307404
"7207","ENSG00000136206","7",43997897,44010122,12225
"7208","ENSG00000136213","7",2403588,2448484,44896
"7209","ENSG00000136231","7",23310209,23470491,160282
"7210","ENSG00000136235","7",23235967,23275108,39141
"7211","ENSG00000136237","7",22118236,22357154,238918
"7212","ENSG00000136238","7",6374527,6403967,29440
"7213","ENSG00000136240","7",6445953,6484190,38237
"7214","ENSG00000136243","7",23181841,23201011,19170
"7215","ENSG00000136244","7",22725884,22732002,6118
"7216","ENSG00000136247","7",6577434,6589374,11940
"7217","ENSG00000136250","7",36512949,36724549,211600
"7218","ENSG00000136261","7",16646131,16706523,60392
"7219","ENSG00000136267","7",14145049,14974777,829728
"7220","ENSG00000136270","7",45100100,45112047,11947
"7221","ENSG00000136271","7",44565417,44575051,9634
"7222","ENSG00000136273","7",47963288,47979615,16327
"7223","ENSG00000136274","7",45080437,45088969,8532
"7224","ENSG00000136275","7",47795291,47819847,24556
"7225","ENSG00000136279","7",44044640,44069456,24816
"7226","ENSG00000136280","7",44999475,45076469,76994
"7227","ENSG00000136286","7",44962662,44979088,16426
"7228","ENSG00000136295","7",2631986,2664802,32816
"7229","ENSG00000136297","7",4905989,4959213,53224
"7230","ENSG00000136305","14",24305096,24311430,6334
"7231","ENSG00000136315","14",20919361,20920299,938
"7232","ENSG00000136319","14",20256558,20305960,49402
"7233","ENSG00000136327","14",36580579,36582607,2028
"7234","ENSG00000136352","14",36516392,36521149,4757
"7235","ENSG00000136367","14",23520857,23556192,35335
"7236","ENSG00000136371","15",79833585,79897379,63794
"7237","ENSG00000136378","15",78759206,78811464,52258
"7238","ENSG00000136379","15",80679684,80755621,75937
"7239","ENSG00000136381","15",78437431,78501453,64022
"7240","ENSG00000136383","15",84816680,84873482,56802
"7241","ENSG00000136404","15",83107407,83144854,37447
"7242","ENSG00000136425","15",78104606,78131544,26938
"7243","ENSG00000136436","17",48830988,48866522,35534
"7244","ENSG00000136444","17",50478860,50485974,7114
"7245","ENSG00000136448","17",45051610,45109016,57406
"7246","ENSG00000136449","17",50508384,50531501,23117
"7247","ENSG00000136450","17",58000919,58007346,6427
"7248","ENSG00000136451","17",57971547,57988259,16712
"7249","ENSG00000136457","17",50464496,50468906,4410
"7250","ENSG00000136463","17",63600882,63608365,7483
"7251","ENSG00000136478","17",64147227,64263301,116074
"7252","ENSG00000136485","17",63550477,63594279,43802
"7253","ENSG00000136487","17",63880215,63881944,1729
"7254","ENSG00000136488","17",63894909,63896661,1752
"7255","ENSG00000136490","17",63695888,63701172,5284
"7256","ENSG00000136492","17",61681266,61863521,182255
"7257","ENSG00000136504","17",49788681,49835026,46345
"7258","ENSG00000136514","3",187368385,187372076,3691
"7259","ENSG00000136518","3",179562886,179588407,25521
"7260","ENSG00000136521","3",179604690,179627647,22957
"7261","ENSG00000136522","3",179588285,179604654,16369
"7262","ENSG00000136527","3",185914558,185938103,23545
"7263","ENSG00000136531","2",165194993,165392310,197317
"7264","ENSG00000136535","2",161416297,161425870,9573
"7265","ENSG00000136536","2",159712457,159771027,58570
"7266","ENSG00000136541","2",157318625,157327713,9088
"7267","ENSG00000136542","2",157257705,157318491,60786
"7268","ENSG00000136546","2",166403573,166611482,207909
"7269","ENSG00000136560","2",161136908,161236221,99313
"7270","ENSG00000136573","8",11486894,11564599,77705
"7271","ENSG00000136574","8",11676959,11760002,83043
"7272","ENSG00000136603","3",170357678,170396835,39157
"7273","ENSG00000136628","1",219968600,220046530,77930
"7274","ENSG00000136630","1",220879431,220885059,5628
"7275","ENSG00000136631","1",150067279,150145329,78050
"7276","ENSG00000136634","1",206767602,206774541,6939
"7277","ENSG00000136636","1",215567304,215621807,54503
"7278","ENSG00000136643","1",213051233,213274774,223541
"7279","ENSG00000136682","2",113437691,113496189,58498
"7280","ENSG00000136688","2",112973203,112985658,12455
"7281","ENSG00000136689","2",113107214,113134016,26802
"7282","ENSG00000136694","2",113005461,113008044,2583
"7283","ENSG00000136695","2",113058638,113065382,6744
"7284","ENSG00000136698","2",130592168,130599575,7407
"7285","ENSG00000136699","2",130151392,130182750,31358
"7286","ENSG00000136709","2",127701027,127811187,110160
"7287","ENSG00000136710","2",130337933,130342699,4766
"7288","ENSG00000136715","2",127941217,128028120,86903
"7289","ENSG00000136717","2",127048027,127107288,59261
"7290","ENSG00000136718","2",130342225,130347810,5585
"7291","ENSG00000136720","2",128236716,128318868,82152
"7292","ENSG00000136731","2",128091200,128195677,104477
"7293","ENSG00000136732","2",126656133,126696667,40534
"7294","ENSG00000136738","10",17644151,17716824,72673
"7295","ENSG00000136750","10",26216665,26304558,87893
"7296","ENSG00000136754","10",26746593,26861087,114494
"7297","ENSG00000136758","10",27110112,27155266,45154
"7298","ENSG00000136770","10",21756548,22003769,247221
"7299","ENSG00000136783","9",104747683,104760120,12437
"7300","ENSG00000136802","9",128882112,128918039,35927
"7301","ENSG00000136807","9",127785679,127790787,5108
"7302","ENSG00000136810","9",110243810,110256507,12697
"7303","ENSG00000136811","9",128455186,128501292,46106
"7304","ENSG00000136813","9",111360692,111484745,124053
"7305","ENSG00000136816","9",129803157,129811281,8124
"7306","ENSG00000136819","9",129827290,129835863,8573
"7307","ENSG00000136824","9",104094260,104141419,47159
"7308","ENSG00000136826","9",107484852,107490482,5630
"7309","ENSG00000136827","9",129812942,129824244,11302
"7310","ENSG00000136828","9",126914774,127223166,308392
"7311","ENSG00000136830","9",127505339,127578989,73650
"7312","ENSG00000136834","9",122476958,122477926,968
"7313","ENSG00000136839","9",104617248,104618204,956
"7314","ENSG00000136840","9",127907886,127917041,9155
"7315","ENSG00000136842","9",97501180,97601743,100563
"7316","ENSG00000136848","9",121567057,121785530,218473
"7317","ENSG00000136854","9",127579370,127696027,116657
"7318","ENSG00000136856","9",127397138,127408424,11286
"7319","ENSG00000136859","9",127087348,127122635,35287
"7320","ENSG00000136861","9",120388869,120580170,191301
"7321","ENSG00000136866","9",113038380,113056759,18379
"7322","ENSG00000136867","9",113150976,113164140,13164
"7323","ENSG00000136868","9",113221544,113264492,42948
"7324","ENSG00000136869","9",117704175,117724735,20560
"7325","ENSG00000136870","9",101398873,101410660,11787
"7326","ENSG00000136872","9",101420560,101449664,29104
"7327","ENSG00000136874","9",99906654,99974534,67880
"7328","ENSG00000136875","9",113275343,113292905,17562
"7329","ENSG00000136877","9",127794597,127814327,19730
"7330","ENSG00000136878","9",129834698,129881838,47140
"7331","ENSG00000136881","9",101360417,101383519,23102
"7332","ENSG00000136883","9",114086126,114099291,13165
"7333","ENSG00000136888","9",114587769,114598879,11110
"7334","ENSG00000136891","9",100302077,100352942,50865
"7335","ENSG00000136895","9",127224265,127393660,169395
"7336","ENSG00000136897","9",101387633,101398618,10985
"7337","ENSG00000136908","9",127935099,127938484,3385
"7338","ENSG00000136918","9",124853417,124857890,4473
"7339","ENSG00000136925","9",97600080,97633368,33288
"7340","ENSG00000136928","9",98288109,98708935,420826
"7341","ENSG00000136929","9",97926791,97944856,18065
"7342","ENSG00000136930","9",124353465,124415444,61979
"7343","ENSG00000136931","9",124481236,124507420,26184
"7344","ENSG00000136932","9",97904489,97922570,18081
"7345","ENSG00000136933","9",125200542,125234158,33616
"7346","ENSG00000136935","9",124878357,124948492,70135
"7347","ENSG00000136936","9",97674909,97697357,22448
"7348","ENSG00000136937","9",97633668,97673748,40080
"7349","ENSG00000136938","9",97983341,98015943,32602
"7350","ENSG00000136940","9",122798389,122828631,30242
"7351","ENSG00000136942","9",124857880,124861981,4101
"7352","ENSG00000136943","9",97029677,97039643,9966
"7353","ENSG00000136944","9",126614443,126701032,86589
"7354","ENSG00000136950","9",124862130,124877733,15603
"7355","ENSG00000136960","8",119557086,119673453,116367
"7356","ENSG00000136982","8",119833976,119855894,21918
"7357","ENSG00000136986","8",123013170,123042302,29132
"7358","ENSG00000136997","8",127735434,127742951,7517
"7359","ENSG00000136999","8",119416446,119424434,7988
"7360","ENSG00000137033","9",6215786,6257983,42197
"7361","ENSG00000137038","9",7796500,7888380,91880
"7362","ENSG00000137040","9",6011043,6015625,4582
"7363","ENSG00000137054","9",37485948,37503697,17749
"7364","ENSG00000137055","9",26903372,26947242,43870
"7365","ENSG00000137070","9",34650702,34661892,11190
"7366","ENSG00000137073","9",33921693,34048949,127256
"7367","ENSG00000137074","9",32972606,33025168,52562
"7368","ENSG00000137075","9",36336396,36487548,151152
"7369","ENSG00000137076","9",35696948,35732195,35247
"7370","ENSG00000137077","9",34709005,34710136,1131
"7371","ENSG00000137078","9",35649295,35650950,1655
"7372","ENSG00000137080","9",21165637,21166660,1023
"7373","ENSG00000137090","9",841690,969090,127400
"7374","ENSG00000137094","9",34989641,34998900,9259
"7375","ENSG00000137098","9",35808045,35812272,4227
"7376","ENSG00000137100","9",34613545,34620523,6978
"7377","ENSG00000137101","9",35609533,35646810,37277
"7378","ENSG00000137103","9",35814451,35865518,51067
"7379","ENSG00000137106","9",37422666,37436990,14324
"7380","ENSG00000137124","9",38392702,38398661,5959
"7381","ENSG00000137133","9",35812960,35815354,2394
"7382","ENSG00000137135","9",35658875,35675866,16991
"7383","ENSG00000137142","9",38406528,38424454,17926
"7384","ENSG00000137145","9",19230435,19373545,143110
"7385","ENSG00000137154","9",19375715,19380254,4539
"7386","ENSG00000137161","6",42929192,42939287,10095
"7387","ENSG00000137166","6",41546426,41602384,55958
"7388","ENSG00000137168","6",36854827,36874803,19976
"7389","ENSG00000137171","6",43040777,43075095,34318
"7390","ENSG00000137177","6",17759183,17987635,228452
"7391","ENSG00000137185","6",28224886,28233482,8596
"7392","ENSG00000137193","6",37170152,37175428,5276
"7393","ENSG00000137198","6",16238580,16295549,56969
"7394","ENSG00000137200","6",37433219,37482827,49608
"7395","ENSG00000137203","6",10393186,10419659,26473
"7396","ENSG00000137204","6",43295694,43305538,9844
"7397","ENSG00000137207","6",43511832,43516985,5153
"7398","ENSG00000137210","6",10747759,10852753,104994
"7399","ENSG00000137216","6",44126914,44155519,28605
"7400","ENSG00000137218","6",41770176,41786542,16366
"7401","ENSG00000137221","6",43477523,43506556,29033
"7402","ENSG00000137225","6",44158811,44184401,25590
"7403","ENSG00000137251","6",54307859,54390142,82283
"7404","ENSG00000137252","6",55106460,55282620,176160
"7405","ENSG00000137261","6",24544104,24646191,102087
"7406","ENSG00000137265","6",391752,411443,19691
"7407","ENSG00000137266","6",3268962,3457022,188060
"7408","ENSG00000137267","6",3153666,3157544,3878
"7409","ENSG00000137269","6",53794497,53924125,129628
"7410","ENSG00000137270","6",53126961,53148841,21880
"7411","ENSG00000137273","6",1389576,1395603,6027
"7412","ENSG00000137274","6",3118374,3153578,35204
"7413","ENSG00000137275","6",3063991,3115187,51196
"7414","ENSG00000137285","6",3224277,3231730,7453
"7415","ENSG00000137288","6",33694293,33711727,17434
"7416","ENSG00000137309","6",34236873,34246231,9358
"7417","ENSG00000137310","6",31158547,31167159,8612
"7418","ENSG00000137312","6",30727709,30742732,15023
"7419","ENSG00000137331","6",30743199,30744548,1349
"7420","ENSG00000137337","6",30699807,30717447,17640
"7421","ENSG00000137338","6",28281572,28302549,20977
"7422","ENSG00000137343","6",30626842,30646823,19981
"7423","ENSG00000137364","6",18128311,18155077,26766
"7424","ENSG00000137392","6",35794982,35797344,2362
"7425","ENSG00000137393","6",18387350,18468874,81524
"7426","ENSG00000137404","6",30688047,30691420,3373
"7427","ENSG00000137409","6",36968141,36986298,18157
"7428","ENSG00000137411","6",30908242,30926459,18217
"7429","ENSG00000137413","6",42050513,42087461,36948
"7430","ENSG00000137414","6",17600302,17611715,11413
"7431","ENSG00000137434","6",10671418,10694797,23379
"7432","ENSG00000137440","4",15935569,15938740,3171
"7433","ENSG00000137441","4",15960245,15969309,9064
"7434","ENSG00000137449","4",15002674,15070153,67479
"7435","ENSG00000137460","4",152936352,152979696,43344
"7436","ENSG00000137462","4",153684070,153705702,21632
"7437","ENSG00000137463","4",139266165,139280225,14060
"7438","ENSG00000137473","4",146706638,146945882,239244
"7439","ENSG00000137474","11",77128246,77215241,86995
"7440","ENSG00000137478","11",72836745,73142318,305573
"7441","ENSG00000137486","11",75260122,75351705,91583
"7442","ENSG00000137491","11",75100563,75206549,105986
"7443","ENSG00000137492","11",76349956,76381132,31176
"7444","ENSG00000137494","11",83193739,83260694,66955
"7445","ENSG00000137496","11",71998541,72005715,7174
"7446","ENSG00000137497","11",72002864,72080693,77829
"7447","ENSG00000137500","11",83259097,83286407,27310
"7448","ENSG00000137501","11",85694224,85811159,116935
"7449","ENSG00000137502","11",82973133,83071923,98790
"7450","ENSG00000137504","11",85659708,85682908,23200
"7451","ENSG00000137507","11",76657524,76670747,13223
"7452","ENSG00000137509","11",82822936,82970584,147648
"7453","ENSG00000137513","11",78435968,78574874,138906
"7454","ENSG00000137522","11",71929018,71997597,68579
"7455","ENSG00000137547","8",54135210,54147901,12691
"7456","ENSG00000137558","8",74824534,74855029,30495
"7457","ENSG00000137561","8",63048553,63086053,37500
"7458","ENSG00000137563","8",63015079,63038806,23727
"7459","ENSG00000137571","8",69667046,69834978,167932
"7460","ENSG00000137573","8",69466624,69660915,194291
"7461","ENSG00000137574","8",55773142,55825448,52306
"7462","ENSG00000137575","8",58552924,58582859,29935
"7463","ENSG00000137601","4",169392857,169612629,219772
"7464","ENSG00000137628","4",168216294,168318804,102510
"7465","ENSG00000137634","11",114570591,114595762,25171
"7466","ENSG00000137642","11",121452314,121633763,181449
"7467","ENSG00000137648","11",118077012,118121890,44878
"7468","ENSG00000137656","11",116748170,116772987,24817
"7469","ENSG00000137672","11",101451564,101872562,420998
"7470","ENSG00000137673","11",102520508,102530750,10242
"7471","ENSG00000137674","11",102576832,102625332,48500
"7472","ENSG00000137675","11",102691487,102705806,14319
"7473","ENSG00000137691","11",102047437,102084554,37117
"7474","ENSG00000137692","11",103050686,103092194,41508
"7475","ENSG00000137693","11",102110447,102233424,122977
"7476","ENSG00000137699","11",120111286,120185529,74243
"7477","ENSG00000137700","11",119024114,119030906,6792
"7478","ENSG00000137707","11",111467526,111512354,44828
"7479","ENSG00000137709","11",120236640,120319945,83305
"7480","ENSG00000137710","11",109864295,110296712,432417
"7481","ENSG00000137713","11",111726908,111766427,39519
"7482","ENSG00000137714","11",110429948,110464884,34936
"7483","ENSG00000137720","11",111878935,111885975,7040
"7484","ENSG00000137726","11",117836976,117877486,40510
"7485","ENSG00000137727","11",110577042,110713189,136147
"7486","ENSG00000137731","11",117800844,117828698,27854
"7487","ENSG00000137745","11",102942995,102955732,12737
"7488","ENSG00000137747","11",117900641,117929459,28818
"7489","ENSG00000137752","11",105025443,105035250,9807
"7490","ENSG00000137757","11",104994235,105023168,28933
"7491","ENSG00000137760","11",107502726,107565746,63020
"7492","ENSG00000137764","15",67542703,67807117,264414
"7493","ENSG00000137766","15",53978201,54633414,655213
"7494","ENSG00000137767","15",45631148,45691281,60133
"7495","ENSG00000137770","15",44427622,44529038,101416
"7496","ENSG00000137776","15",58879050,58933679,54629
"7497","ENSG00000137801","15",39581079,39599466,18387
"7498","ENSG00000137802","15",41774434,41827855,53421
"7499","ENSG00000137804","15",41320794,41381050,60256
"7500","ENSG00000137806","15",41387353,41402519,15166
"7501","ENSG00000137807","15",69414246,69448427,34181
"7502","ENSG00000137809","15",68296532,68432163,135631
"7503","ENSG00000137812","15",40594020,40664342,70322
"7504","ENSG00000137814","15",42548828,42569994,21166
"7505","ENSG00000137815","15",41408408,41483563,75155
"7506","ENSG00000137817","15",72241181,72272999,31818
"7507","ENSG00000137818","15",69452814,69456205,3391
"7508","ENSG00000137819","15",69298947,69407780,108833
"7509","ENSG00000137821","15",70853239,71053657,200418
"7510","ENSG00000137822","15",43369221,43409771,40550
"7511","ENSG00000137824","15",40735884,40755851,19967
"7512","ENSG00000137825","15",41493393,41503551,10158
"7513","ENSG00000137831","15",70654554,70763558,109004
"7514","ENSG00000137834","15",66702236,66782849,80613
"7515","ENSG00000137841","15",40278176,40307935,29759
"7516","ENSG00000137842","15",43123279,43185144,61865
"7517","ENSG00000137843","15",40217428,40277487,60059
"7518","ENSG00000137845","15",58588809,58749791,160982
"7519","ENSG00000137857","15",45129933,45165576,35643
"7520","ENSG00000137860","15",45252234,45277846,25612
"7521","ENSG00000137868","15",74179466,74212267,32801
"7522","ENSG00000137869","15",51208057,51338610,130553
"7523","ENSG00000137871","15",56630181,56734086,103905
"7524","ENSG00000137872","15",47184101,47774223,590122
"7525","ENSG00000137875","15",52109263,52112775,3512
"7526","ENSG00000137876","15",55180806,55197049,16243
"7527","ENSG00000137877","15",41848146,41894053,45907
"7528","ENSG00000137878","15",57591908,57714745,122837
"7529","ENSG00000137880","15",40764068,40767708,3640
"7530","ENSG00000137936","1",93561741,93847150,285409
"7531","ENSG00000137941","1",83865024,83999150,134126
"7532","ENSG00000137942","1",93448131,93554661,106530
"7533","ENSG00000137944","1",88935773,88992953,57180
"7534","ENSG00000137947","1",88852633,88891944,39311
"7535","ENSG00000137948","1",91949371,92014426,65055
"7536","ENSG00000137955","1",75786197,75795086,8889
"7537","ENSG00000137959","1",78619922,78646145,26223
"7538","ENSG00000137960","1",77979542,78138444,158902
"7539","ENSG00000137962","1",94148988,94275068,126080
"7540","ENSG00000137965","1",78649796,78664078,14282
"7541","ENSG00000137968","1",75202131,75611116,408985
"7542","ENSG00000137970","1",96678874,96679620,746
"7543","ENSG00000137975","1",86424171,86456553,32382
"7544","ENSG00000137976","1",84398532,84415018,16486
"7545","ENSG00000137992","1",100186919,100249834,62915
"7546","ENSG00000137996","1",100266207,100292769,26562
"7547","ENSG00000138002","2",27444377,27489789,45412
"7548","ENSG00000138018","2",26308547,26395891,87344
"7549","ENSG00000138028","2",27098889,27119128,20239
"7550","ENSG00000138029","2",26243170,26290465,47295
"7551","ENSG00000138030","2",27086747,27100762,14015
"7552","ENSG00000138031","2",24819169,24919839,100670
"7553","ENSG00000138032","2",44167969,44244384,76415
"7554","ENSG00000138035","2",55634061,55693863,59802
"7555","ENSG00000138036","2",43774039,43810010,35971
"7556","ENSG00000138039","2",48686774,48755730,68956
"7557","ENSG00000138050","2",39736060,39779267,43207
"7558","ENSG00000138061","2",38066973,38109902,42929
"7559","ENSG00000138068","2",37167820,37196598,28778
"7560","ENSG00000138069","2",65070696,65130331,59635
"7561","ENSG00000138071","2",65227753,65271253,43500
"7562","ENSG00000138073","2",27130756,27134666,3910
"7563","ENSG00000138074","2",27199587,27212958,13371
"7564","ENSG00000138075","2",43812560,43838865,26305
"7565","ENSG00000138078","2",44316281,44361862,45581
"7566","ENSG00000138079","2",44275458,44321494,46036
"7567","ENSG00000138080","2",27078567,27086408,7841
"7568","ENSG00000138081","2",47789316,47905793,116477
"7569","ENSG00000138083","2",44941702,44946071,4369
"7570","ENSG00000138085","2",27212027,27217178,5151
"7571","ENSG00000138092","2",24793136,24822376,29240
"7572","ENSG00000138095","2",43886224,43995989,109765
"7573","ENSG00000138100","2",27282392,27307439,25047
"7574","ENSG00000138101","2",25377198,25673647,296449
"7575","ENSG00000138107","10",102461881,102502712,40831
"7576","ENSG00000138109","10",94938658,94990091,51433
"7577","ENSG00000138111","10",102461395,102477045,15650
"7578","ENSG00000138115","10",95036772,95069497,32725
"7579","ENSG00000138119","10",93306429,93482334,175905
"7580","ENSG00000138131","10",98247690,98268194,20504
"7581","ENSG00000138134","10",88879734,88975153,95419
"7582","ENSG00000138135","10",89205629,89207314,1685
"7583","ENSG00000138136","10",101226195,101229794,3599
"7584","ENSG00000138138","10",87751512,87841343,89831
"7585","ENSG00000138152","10",122271306,122338162,66856
"7586","ENSG00000138160","10",92593130,92655395,62265
"7587","ENSG00000138161","10",122832158,122846175,14017
"7588","ENSG00000138162","10",121989163,122254545,265382
"7589","ENSG00000138166","10",110497907,110511533,13626
"7590","ENSG00000138172","10",103446786,103452402,5616
"7591","ENSG00000138175","10",102673731,102714397,40666
"7592","ENSG00000138180","10",93496632,93529092,32460
"7593","ENSG00000138182","10",89701610,89774939,73329
"7594","ENSG00000138185","10",95711779,95877266,165487
"7595","ENSG00000138190","10",92834713,93059493,224780
"7596","ENSG00000138193","10",94030812,94332823,302011
"7597","ENSG00000138207","10",93591687,93601744,10057
"7598","ENSG00000138231","3",138161012,138174949,13937
"7599","ENSG00000138246","3",132417502,132539032,121530
"7600","ENSG00000138271","3",151294086,151316952,22866
"7601","ENSG00000138279","10",73375101,73414076,38975
"7602","ENSG00000138286","10",73168166,73244504,76338
"7603","ENSG00000138303","10",72096032,72217134,121102
"7604","ENSG00000138308","10",72935170,72954778,19608
"7605","ENSG00000138311","10",62374192,62670301,296109
"7606","ENSG00000138315","10",72893584,72933036,39452
"7607","ENSG00000138316","10",70672506,70762441,89935
"7608","ENSG00000138326","10",78033760,78056813,23053
"7609","ENSG00000138336","10",68560337,68694487,134150
"7610","ENSG00000138346","10",68414064,68472121,58057
"7611","ENSG00000138347","10",68106117,68212017,105900
"7612","ENSG00000138356","2",200586014,200677064,91050
"7613","ENSG00000138363","2",215311956,215349773,37817
"7614","ENSG00000138375","2",216412414,216483053,70639
"7615","ENSG00000138376","2",214725646,214809683,84037
"7616","ENSG00000138378","2",191029576,191151596,122020
"7617","ENSG00000138379","2",190055697,190062729,7032
"7618","ENSG00000138380","2",202912214,202988263,76049
"7619","ENSG00000138381","2",189661385,189670831,9446
"7620","ENSG00000138382","2",169810081,169824931,14850
"7621","ENSG00000138385","2",169791933,169812064,20131
"7622","ENSG00000138386","2",190646746,190692766,46020
"7623","ENSG00000138395","2",201790461,201895550,105089
"7624","ENSG00000138398","2",169584344,169641406,57062
"7625","ENSG00000138399","2",169528508,169573875,45367
"7626","ENSG00000138400","2",206737763,206765328,27565
"7627","ENSG00000138411","2",196189099,196593684,404585
"7628","ENSG00000138413","2",208236227,208266074,29847
"7629","ENSG00000138430","2",174072447,174248599,176152
"7630","ENSG00000138433","2",174348022,174395712,47690
"7631","ENSG00000138434","2",181891730,181930738,39008
"7632","ENSG00000138435","2",174747592,174787935,40343
"7633","ENSG00000138439","2",202634969,202769757,134788
"7634","ENSG00000138442","2",202874782,203014798,140016
"7635","ENSG00000138443","2",203328239,203447728,119489
"7636","ENSG00000138448","2",186590056,186680901,90845
"7637","ENSG00000138449","2",189560579,189583758,23179
"7638","ENSG00000138459","3",112561709,112585579,23870
"7639","ENSG00000138463","3",122795069,122881139,86070
"7640","ENSG00000138468","3",101324205,101513241,189036
"7641","ENSG00000138472","3",108907792,108953879,46087
"7642","ENSG00000138483","3",107377194,107378637,1443
"7643","ENSG00000138495","3",119654513,119677454,22941
"7644","ENSG00000138496","3",122527924,122564577,36653
"7645","ENSG00000138587","15",56421544,56465137,43593
"7646","ENSG00000138592","15",50424380,50514421,90041
"7647","ENSG00000138593","15",48988476,49046447,57971
"7648","ENSG00000138594","15",51829628,51947295,117667
"7649","ENSG00000138600","15",50702266,50765709,63443
"7650","ENSG00000138604","15",69160584,69272217,111633
"7651","ENSG00000138606","15",45167214,45201175,33961
"7652","ENSG00000138613","15",63276018,63309126,33108
"7653","ENSG00000138614","15",65578753,65611289,32536
"7654","ENSG00000138615","15",65194760,65211473,16713
"7655","ENSG00000138617","15",65234460,65300618,66158
"7656","ENSG00000138621","15",75023586,75117462,93876
"7657","ENSG00000138622","15",73319859,73368958,49099
"7658","ENSG00000138623","15",74409289,74433958,24669
"7659","ENSG00000138629","15",74445977,74461182,15205
"7660","ENSG00000138639","4",85475150,86002668,527518
"7661","ENSG00000138640","4",88725955,89111398,385443
"7662","ENSG00000138641","4",88592434,88708541,116107
"7663","ENSG00000138642","4",88378739,88443111,64372
"7664","ENSG00000138646","4",88457119,88506163,49044
"7665","ENSG00000138650","4",133149294,133208606,59312
"7666","ENSG00000138653","4",114827763,115113876,286113
"7667","ENSG00000138658","4",112539333,112636995,97662
"7668","ENSG00000138660","4",112231737,112270047,38310
"7669","ENSG00000138663","4",83034447,83075818,41371
"7670","ENSG00000138668","4",82352498,82374503,22005
"7671","ENSG00000138669","4",81087370,81215117,127747
"7672","ENSG00000138670","4",81426393,82044244,617851
"7673","ENSG00000138674","4",82818509,82901166,82657
"7674","ENSG00000138675","4",80266599,80336680,70081
"7675","ENSG00000138678","4",83535914,83605875,69961
"7676","ENSG00000138684","4",122610108,122621066,10958
"7677","ENSG00000138685","4",122826708,122898236,71528
"7678","ENSG00000138686","4",121824440,121870497,46057
"7679","ENSG00000138688","4",122152333,122362758,210425
"7680","ENSG00000138696","4",94757968,95158448,400480
"7681","ENSG00000138698","4",98261384,98443861,182477
"7682","ENSG00000138709","4",128061286,128222931,161645
"7683","ENSG00000138722","4",89879532,89954629,75097
"7684","ENSG00000138735","4",119494397,119628804,134407
"7685","ENSG00000138738","4",120684919,120922870,237951
"7686","ENSG00000138741","4",121874481,121952060,77579
"7687","ENSG00000138744","4",75913660,75941013,27353
"7688","ENSG00000138750","4",76114659,76148444,33785
"7689","ENSG00000138755","4",76001275,76007488,6213
"7690","ENSG00000138756","4",78776342,78916372,140030
"7691","ENSG00000138757","4",75642782,75724525,81743
"7692","ENSG00000138758","4",76949703,77040384,90681
"7693","ENSG00000138759","4",78057323,78544269,486946
"7694","ENSG00000138760","4",76158737,76234536,75799
"7695","ENSG00000138764","4",77157207,77433388,276181
"7696","ENSG00000138767","4",77713387,77819615,106228
"7697","ENSG00000138768","4",75724593,75814286,89693
"7698","ENSG00000138769","4",75576496,75630716,54220
"7699","ENSG00000138771","4",76435229,76783253,348024
"7700","ENSG00000138772","4",78551747,78610451,58704
"7701","ENSG00000138777","4",105369077,105474067,104990
"7702","ENSG00000138778","4",103105806,103198409,92603
"7703","ENSG00000138780","4",105708778,105847728,138950
"7704","ENSG00000138785","4",105682627,105895986,213359
"7705","ENSG00000138792","4",110365733,110565285,199552
"7706","ENSG00000138794","4",109688622,109703583,14961
"7707","ENSG00000138795","4",108047545,108168956,121411
"7708","ENSG00000138796","4",107989714,108035175,45461
"7709","ENSG00000138798","4",109912884,110013755,100871
"7710","ENSG00000138801","4",107590276,107720234,129958
"7711","ENSG00000138802","4",109433772,109540896,107124
"7712","ENSG00000138813","4",99511012,99542303,31291
"7713","ENSG00000138814","4",101023409,101348278,324869
"7714","ENSG00000138821","4",102251041,102431258,180217
"7715","ENSG00000138823","4",99563761,99623999,60238
"7716","ENSG00000138829","5",128257909,128659185,401276
"7717","ENSG00000138834","16",1706183,1770317,64134
"7718","ENSG00000138835","9",113444731,113597743,153012
"7719","ENSG00000138867","22",24540423,24555935,15512
"7720","ENSG00000138892","22",50015123,50056935,41812
"7721","ENSG00000138942","22",31160182,31207019,46837
"7722","ENSG00000138944","22",44243665,44312951,69286
"7723","ENSG00000138964","22",44172956,44219533,46577
"7724","ENSG00000139044","12",460364,563509,103145
"7725","ENSG00000139053","12",14973042,14981865,8823
"7726","ENSG00000139055","12",14914039,14938537,24498
"7727","ENSG00000139083","12",11649854,11895402,245548
"7728","ENSG00000139112","12",10212458,10223128,10670
"7729","ENSG00000139116","12",39293228,39443390,150162
"7730","ENSG00000139117","12",38646822,38907430,260608
"7731","ENSG00000139131","12",32727490,32755902,28412
"7732","ENSG00000139132","12",32399529,32646050,246521
"7733","ENSG00000139133","12",34022468,34029694,7226
"7734","ENSG00000139144","12",18247614,18648416,400802
"7735","ENSG00000139146","12",31280584,31327058,46474
"7736","ENSG00000139151","12",18683169,18738100,54931
"7737","ENSG00000139154","12",19404045,19720801,316756
"7738","ENSG00000139155","12",20695355,20753386,58031
"7739","ENSG00000139160","12",31647160,31673114,25954
"7740","ENSG00000139163","12",22625075,22690665,65590
"7741","ENSG00000139168","12",42312086,42326118,14032
"7742","ENSG00000139173","12",43835967,44389762,553795
"7743","ENSG00000139174","12",42456757,42590355,133598
"7744","ENSG00000139178","12",7089587,7109238,19651
"7745","ENSG00000139180","12",4649095,4694317,45222
"7746","ENSG00000139182","12",7129698,7158945,29247
"7747","ENSG00000139187","12",8950044,9010760,60716
"7748","ENSG00000139190","12",6462237,6470987,8750
"7749","ENSG00000139192","12",6451690,6466517,14827
"7750","ENSG00000139193","12",6444867,6451718,6851
"7751","ENSG00000139194","12",7115736,7128889,13153
"7752","ENSG00000139197","12",7188685,7218574,29889
"7753","ENSG00000139200","12",6693792,6700800,7008
"7754","ENSG00000139209","12",46764761,46832408,67647
"7755","ENSG00000139211","12",47075707,47079951,4244
"7756","ENSG00000139218","12",45919131,45992120,72989
"7757","ENSG00000139219","12",47972967,48004554,31587
"7758","ENSG00000139220","12",81257975,81759553,501578
"7759","ENSG00000139223","12",48472665,48473624,959
"7760","ENSG00000139233","12",66116555,66130750,14195
"7761","ENSG00000139239","12",62965325,62965969,644
"7762","ENSG00000139263","12",58872149,58920522,48373
"7763","ENSG00000139266","12",57755103,57760411,5308
"7764","ENSG00000139269","12",57452323,57459280,6957
"7765","ENSG00000139278","12",75480753,75503863,23110
"7766","ENSG00000139287","12",71938845,72186618,247773
"7767","ENSG00000139289","12",76025447,76033932,8485
"7768","ENSG00000139291","12",71686087,71705046,18959
"7769","ENSG00000139292","12",71439798,71586310,146512
"7770","ENSG00000139304","12",80402178,80680271,278093
"7771","ENSG00000139318","12",89347235,89352501,5266
"7772","ENSG00000139323","12",89419718,89526047,106329
"7773","ENSG00000139324","12",88142296,88199887,57591
"7774","ENSG00000139329","12",91102629,91111494,8865
"7775","ENSG00000139330","12",91050491,91057983,7492
"7776","ENSG00000139343","12",95858928,95903828,44900
"7777","ENSG00000139344","12",95943331,95968720,25389
"7778","ENSG00000139350","12",96907223,96953777,46554
"7779","ENSG00000139351","12",101728648,101739472,10824
"7780","ENSG00000139352","12",102957674,102960513,2839
"7781","ENSG00000139354","12",100573683,100628288,54605
"7782","ENSG00000139364","12",125186836,125662377,475541
"7783","ENSG00000139370","12",128793194,128823958,30764
"7784","ENSG00000139372","12",103965822,103988874,23052
"7785","ENSG00000139405","12",113185526,113192368,6842
"7786","ENSG00000139410","12",113422380,113438276,15896
"7787","ENSG00000139428","12",109553715,109573580,19865
"7788","ENSG00000139433","12",109850945,109880541,29596
"7789","ENSG00000139436","12",109929802,109996389,66587
"7790","ENSG00000139437","12",109900264,109983841,83577
"7791","ENSG00000139438","12",109714228,109770507,56279
"7792","ENSG00000139445","12",109277978,109309284,31306
"7793","ENSG00000139496","13",25301556,25349800,48244
"7794","ENSG00000139505","13",25246201,25288009,41808
"7795","ENSG00000139508","13",28700064,28718970,18906
"7796","ENSG00000139514","13",29509414,29595688,86274
"7797","ENSG00000139515","13",27920000,27926313,6313
"7798","ENSG00000139517","13",27545913,27620529,74616
"7799","ENSG00000139531","12",55997180,56006641,9461
"7800","ENSG00000139537","12",48904110,48931840,27730
"7801","ENSG00000139540","12",56230049,56237846,7797
"7802","ENSG00000139546","12",53500921,53506431,5510
"7803","ENSG00000139547","12",56951431,56959374,7943
"7804","ENSG00000139549","12",49086656,49094801,8145
"7805","ENSG00000139567","12",51906908,51923361,16453
"7806","ENSG00000139572","12",54362445,54364487,2042
"7807","ENSG00000139579","12",56222015,56229854,7839
"7808","ENSG00000139597","13",32400723,32428311,27588
"7809","ENSG00000139610","12",51328443,51346679,18236
"7810","ENSG00000139613","12",56162359,56189567,27208
"7811","ENSG00000139618","13",32315086,32400266,85180
"7812","ENSG00000139620","12",48653401,48682238,28837
"7813","ENSG00000139624","12",50129306,50167533,38227
"7814","ENSG00000139625","12",53479669,53500063,20394
"7815","ENSG00000139626","12",53191323,53207282,15959
"7816","ENSG00000139629","12",51351247,51392867,41620
"7817","ENSG00000139631","12",53157663,53180909,23246
"7818","ENSG00000139636","12",49096551,49110900,14349
"7819","ENSG00000139637","12",53299695,53307177,7482
"7820","ENSG00000139641","12",56118250,56144671,26421
"7821","ENSG00000139644","12",49707725,49764934,57209
"7822","ENSG00000139645","12",56237807,56258384,20577
"7823","ENSG00000139648","12",52543909,52553147,9238
"7824","ENSG00000139651","12",53180704,53195142,14438
"7825","ENSG00000139656","13",44143543,44161257,17714
"7826","ENSG00000139668","13",51584455,51767709,183254
"7827","ENSG00000139675","13",52642425,52643796,1371
"7828","ENSG00000139679","13",48389567,48444704,55137
"7829","ENSG00000139684","13",46771256,46797161,25905
"7830","ENSG00000139687","13",48303726,48599436,295710
"7831","ENSG00000139697","12",123289109,123364847,75738
"7832","ENSG00000139714","12",121648742,121672631,23889
"7833","ENSG00000139718","12",121804180,121832584,28404
"7834","ENSG00000139719","12",122229564,122266521,36957
"7835","ENSG00000139722","12",122865330,122896127,30797
"7836","ENSG00000139725","12",121777754,121803403,25649
"7837","ENSG00000139726","12",122752824,122771064,18240
"7838","ENSG00000139734","13",59665583,60163987,498404
"7839","ENSG00000139737","13",77697687,77764242,66555
"7840","ENSG00000139746","13",79311824,79406477,94653
"7841","ENSG00000139767","12",118981541,119163051,181510
"7842","ENSG00000139780","13",102685744,102694504,8760
"7843","ENSG00000139793","13",97221434,97394120,172686
"7844","ENSG00000139797","13",98175785,98177265,1480
"7845","ENSG00000139800","13",99962964,99971909,8945
"7846","ENSG00000139826","13",108218392,108234243,15851
"7847","ENSG00000139832","13",110523066,110561722,38656
"7848","ENSG00000139835","13",113324164,113364148,39984
"7849","ENSG00000139842","13",113208193,113267108,58915
"7850","ENSG00000139865","14",37595847,38041442,445595
"7851","ENSG00000139874","14",38207904,38213067,5163
"7852","ENSG00000139880","14",23047062,23057538,10476
"7853","ENSG00000139890","14",22883222,22887678,4456
"7854","ENSG00000139899","14",24426532,24430954,4422
"7855","ENSG00000139908","14",24205697,24208362,2665
"7856","ENSG00000139910","14",26443090,26598033,154943
"7857","ENSG00000139914","14",24131275,24132849,1574
"7858","ENSG00000139915","14",46840092,47675605,835513
"7859","ENSG00000139921","14",51240162,51257655,17493
"7860","ENSG00000139926","14",51489100,51730727,241627
"7861","ENSG00000139946","14",56117814,56301524,183710
"7862","ENSG00000139970","14",59595976,59870776,274800
"7863","ENSG00000139971","14",57999735,58298139,298404
"7864","ENSG00000139973","14",61811974,62112550,300576
"7865","ENSG00000139974","14",60981114,61083733,102619
"7866","ENSG00000139977","14",57390544,57415906,25362
"7867","ENSG00000139985","14",70452157,70459899,7742
"7868","ENSG00000139988","14",67701886,67734452,32566
"7869","ENSG00000139990","14",69050881,69153150,102269
"7870","ENSG00000139998","14",64945814,64973226,27412
"7871","ENSG00000140006","14",63597039,63641861,44822
"7872","ENSG00000140009","14",64084232,64338112,253880
"7873","ENSG00000140015","14",62699464,63102037,402573
"7874","ENSG00000140022","14",81260656,81436465,175809
"7875","ENSG00000140025","14",89794669,89954777,160108
"7876","ENSG00000140030","14",88005135,88014811,9676
"7877","ENSG00000140043","14",73851844,73886827,34983
"7878","ENSG00000140044","14",75427716,75474111,46395
"7879","ENSG00000140057","14",96392128,96489427,97299
"7880","ENSG00000140067","14",93918894,93929608,10714
"7881","ENSG00000140090","14",92322581,92501483,178902
"7882","ENSG00000140092","14",91869412,91947987,78575
"7883","ENSG00000140093","14",94280460,94293268,12808
"7884","ENSG00000140104","14",104985775,105010482,24707
"7885","ENSG00000140105","14",100333790,100376805,43015
"7886","ENSG00000140107","14",100323337,100330372,7035
"7887","ENSG00000140153","14",102139503,102224847,85344
"7888","ENSG00000140157","15",22838641,22868384,29743
"7889","ENSG00000140199","15",34229996,34338060,108064
"7890","ENSG00000140254","15",45117367,45129938,12571
"7891","ENSG00000140259","15",43804492,43824690,20198
"7892","ENSG00000140262","15",56918623,57299281,380658
"7893","ENSG00000140263","15",45023181,45077185,54004
"7894","ENSG00000140264","15",43777087,43802589,25502
"7895","ENSG00000140265","15",43358172,43371025,12853
"7896","ENSG00000140274","15",45114321,45118421,4100
"7897","ENSG00000140279","15",45092650,45114344,21694
"7898","ENSG00000140280","15",51723011,51751585,28574
"7899","ENSG00000140284","15",50182196,50236385,54189
"7900","ENSG00000140285","15",49423178,49488775,65597
"7901","ENSG00000140287","15",50241947,50265965,24018
"7902","ENSG00000140297","15",59594875,59640239,45364
"7903","ENSG00000140299","15",59659146,59689534,30388
"7904","ENSG00000140307","15",59638062,59657541,19479
"7905","ENSG00000140319","15",40035739,40039188,3449
"7906","ENSG00000140320","15",40439721,40468236,28515
"7907","ENSG00000140323","15",40358219,40378621,20402
"7908","ENSG00000140326","15",42723544,42737128,13584
"7909","ENSG00000140332","15",70047790,70098176,50386
"7910","ENSG00000140350","15",68778535,68820897,42362
"7911","ENSG00000140365","15",75335891,75343224,7333
"7912","ENSG00000140367","15",75843285,75901078,57793
"7913","ENSG00000140368","15",76993359,77037332,43973
"7914","ENSG00000140374","15",76215353,76311472,96119
"7915","ENSG00000140379","15",79960892,79971196,10304
"7916","ENSG00000140382","15",77420412,77485607,65195
"7917","ENSG00000140386","15",76347904,76905444,557540
"7918","ENSG00000140391","15",77041404,77083984,42580
"7919","ENSG00000140395","15",78277835,78299703,21868
"7920","ENSG00000140396","8",70109782,70403808,294026
"7921","ENSG00000140398","15",75346955,75357114,10159
"7922","ENSG00000140400","15",75355207,75368612,13405
"7923","ENSG00000140403","15",78264086,78282196,18110
"7924","ENSG00000140406","15",81000944,81005788,4844
"7925","ENSG00000140416","15",63042632,63071915,29283
"7926","ENSG00000140443","15",98648539,98964530,315991
"7927","ENSG00000140450","15",97960703,97973833,13130
"7928","ENSG00000140451","15",64815632,64825668,10036
"7929","ENSG00000140455","15",63504511,63594640,90129
"7930","ENSG00000140459","15",74337759,74367646,29887
"7931","ENSG00000140463","15",72686179,72738475,52296
"7932","ENSG00000140464","15",73994673,74047812,53139
"7933","ENSG00000140465","15",74719542,74725536,5994
"7934","ENSG00000140470","15",99971437,100342005,370568
"7935","ENSG00000140471","15",100559369,100603230,43861
"7936","ENSG00000140474","15",74836118,74843346,7228
"7937","ENSG00000140478","15",75282835,75295807,12972
"7938","ENSG00000140479","15",101297142,101525202,228060
"7939","ENSG00000140481","15",74202705,74336472,133767
"7940","ENSG00000140488","15",72284727,72320157,35430
"7941","ENSG00000140497","15",74843730,74873365,29635
"7942","ENSG00000140505","15",74748845,74756607,7762
"7943","ENSG00000140506","15",74812716,74825758,13042
"7944","ENSG00000140511","15",88877288,88895626,18338
"7945","ENSG00000140519","15",89471398,89496589,25191
"7946","ENSG00000140521","15",89305198,89334861,29663
"7947","ENSG00000140522","15",89209869,89221614,11745
"7948","ENSG00000140525","15",89243949,89317261,73312
"7949","ENSG00000140526","15",89087459,89202355,114896
"7950","ENSG00000140527","15",89690811,89743638,52827
"7951","ENSG00000140534","15",89575482,89631056,55574
"7952","ENSG00000140538","15",87859751,88256768,397017
"7953","ENSG00000140543","15",88494440,88546675,52235
"7954","ENSG00000140545","15",88898683,88913381,14698
"7955","ENSG00000140548","15",90001324,90082206,80882
"7956","ENSG00000140553","15",90930180,90954093,23913
"7957","ENSG00000140557","15",92393881,92468728,74847
"7958","ENSG00000140563","15",94231538,94483952,252414
"7959","ENSG00000140564","15",90868588,90883458,14870
"7960","ENSG00000140575","15",90388242,90502239,113997
"7961","ENSG00000140577","15",90529923,90645345,115422
"7962","ENSG00000140598","15",82130233,82262734,132501
"7963","ENSG00000140600","15",83447228,83618743,171515
"7964","ENSG00000140612","15",84669538,84716460,46922
"7965","ENSG00000140623","16",4777669,4788521,10852
"7966","ENSG00000140632","16",4803203,4847288,44085
"7967","ENSG00000140650","16",8788823,8849325,60502
"7968","ENSG00000140675","16",31483002,31490860,7858
"7969","ENSG00000140678","16",31355134,31382997,27863
"7970","ENSG00000140682","16",31471585,31477960,6375
"7971","ENSG00000140688","16",31489471,31509309,19838
"7972","ENSG00000140691","16",31458080,31467166,9086
"7973","ENSG00000140694","16",14435700,14632728,197028
"7974","ENSG00000140718","16",53701692,54158512,456820
"7975","ENSG00000140740","16",21952660,21983660,31000
"7976","ENSG00000140743","16",22345936,22437165,91229
"7977","ENSG00000140749","16",21639550,21652608,13058
"7978","ENSG00000140750","16",24919389,25015666,96277
"7979","ENSG00000140795","16",46702282,46790407,88125
"7980","ENSG00000140798","16",48081006,48156018,75012
"7981","ENSG00000140807","16",50548396,50649249,100853
"7982","ENSG00000140829","16",72093613,72112912,19299
"7983","ENSG00000140830","16",72044289,72094431,50142
"7984","ENSG00000140832","16",71626161,71642114,15953
"7985","ENSG00000140835","16",71525233,71538746,13513
"7986","ENSG00000140836","16",72782885,73891871,1108986
"7987","ENSG00000140839","16",74408270,74421953,13683
"7988","ENSG00000140848","16",57092583,57148369,55786
"7989","ENSG00000140853","16",56989485,57083531,94046
"7990","ENSG00000140854","16",57735739,57757244,21505
"7991","ENSG00000140859","16",57758217,57863053,104836
"7992","ENSG00000140873","16",77247813,77435034,187221
"7993","ENSG00000140876","16",77722492,77742260,19768
"7994","ENSG00000140905","16",81081938,81096425,14487
"7995","ENSG00000140931","16",66603874,66613892,10018
"7996","ENSG00000140932","16",66579448,66588275,8827
"7997","ENSG00000140937","16",64943753,65126112,182359
"7998","ENSG00000140939","16",67170154,67175735,5581
"7999","ENSG00000140941","16",87383953,87404779,20826
"8000","ENSG00000140943","16",84053761,84116942,63181
"8001","ENSG00000140945","16",82626965,83800640,1173675
"8002","ENSG00000140948","16",87406246,87493024,86778
"8003","ENSG00000140950","16",84476355,84554033,77678
"8004","ENSG00000140955","16",84191138,84197168,6030
"8005","ENSG00000140961","16",83948282,83966332,18050
"8006","ENSG00000140968","16",85899162,85922606,23444
"8007","ENSG00000140983","16",668105,674174,6069
"8008","ENSG00000140986","16",1943974,1957606,13632
"8009","ENSG00000140987","16",3382081,3401065,18984
"8010","ENSG00000140988","16",1962058,1964841,2783
"8011","ENSG00000140990","16",1959538,1961975,2437
"8012","ENSG00000140992","16",2537979,2603188,65209
"8013","ENSG00000140993","16",3298808,3305729,6921
"8014","ENSG00000140995","16",89947925,89968060,20135
"8015","ENSG00000141002","16",89873570,89913627,40057
"8016","ENSG00000141012","16",88813734,88856970,43236
"8017","ENSG00000141013","16",90019629,90044975,25346
"8018","ENSG00000141026","17",17476994,17493221,16227
"8019","ENSG00000141027","17",16029157,16218185,189028
"8020","ENSG00000141028","17",14024514,14025488,974
"8021","ENSG00000141030","17",17246616,17281273,34657
"8022","ENSG00000141034","17",18039292,18068404,29112
"8023","ENSG00000141040","17",16546954,16569204,22250
"8024","ENSG00000141052","17",12665890,12768949,103059
"8025","ENSG00000141068","17",27456470,27626438,169968
"8026","ENSG00000141076","16",69131291,69231130,99839
"8027","ENSG00000141084","16",67723070,67806652,83582
"8028","ENSG00000141086","16",67927640,67932365,4725
"8029","ENSG00000141096","16",67975663,67980508,4845
"8030","ENSG00000141098","16",67674531,67719339,44808
"8031","ENSG00000141101","16",69741871,69754926,13055
"8032","ENSG00000141127","17",18840085,18931287,91202
"8033","ENSG00000141161","17",35147817,35189345,41528
"8034","ENSG00000141179","17",55750979,55842830,91851
"8035","ENSG00000141194","17",58148449,58159555,11106
"8036","ENSG00000141198","17",54899387,54961956,62569
"8037","ENSG00000141200","17",53822901,53825213,2312
"8038","ENSG00000141219","17",73232233,73248947,16714
"8039","ENSG00000141232","17",50862223,50867978,5755
"8040","ENSG00000141252","17",508668,721717,213049
"8041","ENSG00000141255","17",3440019,3513852,73833
"8042","ENSG00000141258","17",2337498,2381058,43560
"8043","ENSG00000141279","17",47522942,47623276,100334
"8044","ENSG00000141293","17",48133442,48430275,296833
"8045","ENSG00000141294","17",47831634,47837719,6085
"8046","ENSG00000141295","17",47837692,47841289,3597
"8047","ENSG00000141298","17",29625938,29930276,304338
"8048","ENSG00000141314","17",32265832,32324659,58827
"8049","ENSG00000141316","17",32970376,32997877,27501
"8050","ENSG00000141337","17",68259182,68422731,163549
"8051","ENSG00000141338","17",68867289,68955392,88103
"8052","ENSG00000141349","17",44070735,44076344,5609
"8053","ENSG00000141367","17",59619689,59696956,77267
"8054","ENSG00000141371","17",60392429,60431426,38997
"8055","ENSG00000141376","17",60677453,61392838,715385
"8056","ENSG00000141378","17",59674636,59707626,32990
"8057","ENSG00000141380","18",26016253,26091217,74964
"8058","ENSG00000141384","18",26225936,26391685,165749
"8059","ENSG00000141385","18",12328944,12377314,48370
"8060","ENSG00000141391","18",12407896,12432238,24342
"8061","ENSG00000141401","18",11981025,12030877,49852
"8062","ENSG00000141404","18",11689264,11885685,196421
"8063","ENSG00000141424","18",36108531,36129385,20854
"8064","ENSG00000141425","18",35984387,36067576,83189
"8065","ENSG00000141428","18",35972625,35979286,6661
"8066","ENSG00000141429","18",35581117,35711834,130717
"8067","ENSG00000141431","18",33578219,33751195,172976
"8068","ENSG00000141433","18",904871,912172,7301
"8069","ENSG00000141434","18",32185069,32220404,35335
"8070","ENSG00000141437","18",31759562,31760880,1318
"8071","ENSG00000141441","18",32124877,32470882,346005
"8072","ENSG00000141446","18",21529284,21600884,71600
"8073","ENSG00000141447","18",24162045,24397880,235835
"8074","ENSG00000141448","18",22169392,22202528,33136
"8075","ENSG00000141449","18",21242242,21525417,283175
"8076","ENSG00000141452","18",23503470,23531807,28337
"8077","ENSG00000141456","17",4669774,4704337,34563
"8078","ENSG00000141458","18",23506184,23586506,80322
"8079","ENSG00000141469","18",45687025,45752520,65495
"8080","ENSG00000141480","17",4710596,4721499,10903
"8081","ENSG00000141485","17",6684713,6713567,28854
"8082","ENSG00000141497","17",4739833,4746119,6286
"8083","ENSG00000141499","17",7686071,7703502,17431
"8084","ENSG00000141503","17",4833340,4898061,64721
"8085","ENSG00000141504","17",7626234,7627876,1642
"8086","ENSG00000141505","17",7173431,7179564,6133
"8087","ENSG00000141506","17",8878911,8965712,86801
"8088","ENSG00000141510","17",7661779,7687550,25771
"8089","ENSG00000141519","17",80036632,80100613,63981
"8090","ENSG00000141522","17",81867721,81871378,3657
"8091","ENSG00000141524","17",78110458,78132407,21949
"8092","ENSG00000141526","17",82228397,82261129,32732
"8093","ENSG00000141527","17",80169992,80209331,39339
"8094","ENSG00000141540","17",74213571,74262020,48449
"8095","ENSG00000141542","17",82654973,82698698,43725
"8096","ENSG00000141543","17",80134369,80147151,12782
"8097","ENSG00000141551","17",82239023,82273731,34708
"8098","ENSG00000141552","17",81890790,81900991,10201
"8099","ENSG00000141556","17",82752065,82945914,193849
"8100","ENSG00000141560","17",82716706,82730328,13622
"8101","ENSG00000141562","17",82458180,82490537,32357
"8102","ENSG00000141564","17",80544819,80966371,421552
"8103","ENSG00000141568","17",82519713,82644662,124949
"8104","ENSG00000141569","17",75880335,75896951,16616
"8105","ENSG00000141570","17",79792132,79801683,9551
"8106","ENSG00000141574","17",82321024,82334074,13050
"8107","ENSG00000141576","17",76142465,76240493,98028
"8108","ENSG00000141577","17",81189593,81222999,33406
"8109","ENSG00000141579","17",82829434,82840022,10588
"8110","ENSG00000141580","17",82614562,82648553,33991
"8111","ENSG00000141582","17",79833156,79839440,6284
"8112","ENSG00000141622","18",46326809,46463140,136331
"8113","ENSG00000141627","18",49041474,49461347,419873
"8114","ENSG00000141639","18",50560087,50731826,171739
"8115","ENSG00000141642","18",50967991,50988121,20130
"8116","ENSG00000141644","18",50266882,50281774,14892
"8117","ENSG00000141646","18",51028394,51085045,56651
"8118","ENSG00000141655","18",62325287,62391288,66001
"8119","ENSG00000141664","18",62523007,62587709,64702
"8120","ENSG00000141665","18",74073353,74147865,74512
"8121","ENSG00000141668","18",72536680,72638521,101841
"8122","ENSG00000141682","18",59899948,59904306,4358
"8123","ENSG00000141696","17",41801947,41812604,10657
"8124","ENSG00000141698","17",41825181,41836263,11082
"8125","ENSG00000141699","17",42579513,42610623,31110
"8126","ENSG00000141736","17",39687914,39730426,42512
"8127","ENSG00000141738","17",39737927,39747291,9364
"8128","ENSG00000141741","17",39728496,39730532,2036
"8129","ENSG00000141744","17",39667981,39670475,2494
"8130","ENSG00000141748","17",39156894,39167484,10590
"8131","ENSG00000141750","17",39210541,39225945,15404
"8132","ENSG00000141753","17",40443450,40457725,14275
"8133","ENSG00000141756","17",41812680,41823217,10537
"8134","ENSG00000141759","18",79970813,80033949,63136
"8135","ENSG00000141837","19",13206442,13633025,426583
"8136","ENSG00000141854","19",14072536,14075062,2526
"8137","ENSG00000141858","19",14087840,14091036,3196
"8138","ENSG00000141867","19",15235519,15332545,97026
"8139","ENSG00000141873","19",2732204,2740028,7824
"8140","ENSG00000141905","19",3314403,3469217,154814
"8141","ENSG00000141933","19",507497,519654,12157
"8142","ENSG00000141934","19",281040,291403,10363
"8143","ENSG00000141946","19",57134096,57145202,11106
"8144","ENSG00000141956","21",41798225,41879482,81257
"8145","ENSG00000141959","21",44300051,44327376,27325
"8146","ENSG00000141965","19",4791681,4801273,9592
"8147","ENSG00000141968","19",6772708,6857366,84658
"8148","ENSG00000141971","19",17405722,17433724,28002
"8149","ENSG00000141977","19",16161368,16173525,12157
"8150","ENSG00000141979","19",16479067,16628204,149137
"8151","ENSG00000141985","19",4360370,4400547,40177
"8152","ENSG00000141994","19",5784832,5791225,6393
"8153","ENSG00000142002","19",4675224,4724673,49449
"8154","ENSG00000142025","19",41844743,41852333,7590
"8155","ENSG00000142039","19",41310172,41324873,14701
"8156","ENSG00000142046","19",41350911,41384083,33172
"8157","ENSG00000142065","19",36334453,36379201,44748
"8158","ENSG00000142082","11",215030,236931,21901
"8159","ENSG00000142089","11",319676,327537,7861
"8160","ENSG00000142102","11",289135,296107,6972
"8161","ENSG00000142149","21",31873020,32044633,171613
"8162","ENSG00000142156","21",45981737,46005050,23313
"8163","ENSG00000142163","17",3116427,3117374,947
"8164","ENSG00000142166","21",33324429,33359864,35435
"8165","ENSG00000142168","21",31659622,31668931,9309
"8166","ENSG00000142173","21",46098097,46132849,34752
"8167","ENSG00000142178","21",43414483,43427189,12706
"8168","ENSG00000142182","21",44246339,44262216,15877
"8169","ENSG00000142185","21",44350163,44443081,92918
"8170","ENSG00000142186","11",65525077,65538704,13627
"8171","ENSG00000142188","21",33432485,33479974,47489
"8172","ENSG00000142192","21",25880550,26171128,290578
"8173","ENSG00000142197","21",36156782,36294274,137492
"8174","ENSG00000142207","21",32311018,32393012,81994
"8175","ENSG00000142208","14",104769349,104795751,26402
"8176","ENSG00000142224","1",206770764,206842981,72217
"8177","ENSG00000142227","19",48321509,48330553,9044
"8178","ENSG00000142230","19",47113274,47210636,97362
"8179","ENSG00000142233","19",48661407,48673081,11674
"8180","ENSG00000142235","19",48485271,48513935,28664
"8181","ENSG00000142252","19",45079195,45091524,12329
"8182","ENSG00000142273","19",44777869,44800652,22783
"8183","ENSG00000142279","19",34481638,34512304,30666
"8184","ENSG00000142303","19",8580240,8610735,30495
"8185","ENSG00000142319","5",1392794,1445440,52646
"8186","ENSG00000142327","2",240565804,240581372,15568
"8187","ENSG00000142330","2",240586734,240617705,30971
"8188","ENSG00000142347","19",8520797,8577577,56780
"8189","ENSG00000142396","19",58305319,58315663,10344
"8190","ENSG00000142405","19",53793603,53824394,30791
"8191","ENSG00000142408","19",53963040,53990215,27175
"8192","ENSG00000142409","19",56087366,56121295,33929
"8193","ENSG00000142444","19",10928811,10933535,4724
"8194","ENSG00000142449","19",8065402,8149592,84190
"8195","ENSG00000142453","19",10871513,10923070,51557
"8196","ENSG00000142459","19",7830233,7864976,34743
"8197","ENSG00000142484","17",4771884,4783213,11329
"8198","ENSG00000142494","17",19495385,19579034,83649
"8199","ENSG00000142507","17",4796144,4798502,2358
"8200","ENSG00000142511","19",50770464,50771732,1268
"8201","ENSG00000142512","19",51410020,51417803,7783
"8202","ENSG00000142513","19",50790415,50795224,4809
"8203","ENSG00000142515","19",50854915,50860764,5849
"8204","ENSG00000142528","19",50025714,50053414,27700
"8205","ENSG00000142530","19",50466785,50476753,9968
"8206","ENSG00000142534","19",49496365,49499708,3343
"8207","ENSG00000142541","19",49487554,49492308,4754
"8208","ENSG00000142544","19",51097606,51108409,10803
"8209","ENSG00000142546","19",49555711,49590262,34551
"8210","ENSG00000142549","19",51311848,51330354,18506
"8211","ENSG00000142552","19",49528003,49546962,18959
"8212","ENSG00000142556","19",52012765,52030240,17475
"8213","ENSG00000142583","1",9035107,9088478,53371
"8214","ENSG00000142599","1",8352397,8848921,496524
"8215","ENSG00000142606","1",2590639,2633016,42377
"8216","ENSG00000142609","1",1921951,2003837,81886
"8217","ENSG00000142611","1",3069168,3438621,369453
"8218","ENSG00000142615","1",15456728,15472091,15363
"8219","ENSG00000142619","1",17249098,17284233,35135
"8220","ENSG00000142621","1",15247272,15400283,153011
"8221","ENSG00000142623","1",17205128,17246007,40879
"8222","ENSG00000142627","1",16124337,16156069,31732
"8223","ENSG00000142632","1",16197854,16212652,14798
"8224","ENSG00000142634","1",15409888,15430339,20451
"8225","ENSG00000142655","1",10472288,10630758,158470
"8226","ENSG00000142657","1",10398592,10420511,21919
"8227","ENSG00000142661","1",24056035,24112135,56100
"8228","ENSG00000142669","1",26280086,26281522,1436
"8229","ENSG00000142675","1",26177484,26189884,12400
"8230","ENSG00000142676","1",23691742,23696835,5093
"8231","ENSG00000142677","1",24119771,24143140,23369
"8232","ENSG00000142684","1",26169908,26170873,965
"8233","ENSG00000142686","1",35713877,35718894,5017
"8234","ENSG00000142687","1",35433492,35557950,124458
"8235","ENSG00000142694","1",36322031,36324154,2123
"8236","ENSG00000142698","1",34166883,34219131,52248
"8237","ENSG00000142700","1",50417550,50423443,5893
"8238","ENSG00000142731","4",127880893,127899224,18331
"8239","ENSG00000142733","1",27354067,27366961,12894
"8240","ENSG00000142748","1",27369112,27374824,5712
"8241","ENSG00000142751","1",26876132,26890283,14151
"8242","ENSG00000142765","1",27342020,27353937,11917
"8243","ENSG00000142784","1",27234632,27308636,74004
"8244","ENSG00000142789","1",22001656,22012539,10883
"8245","ENSG00000142794","1",21440128,21485005,44877
"8246","ENSG00000142798","1",21822244,21937310,115066
"8247","ENSG00000142856","1",63440770,63593721,152951
"8248","ENSG00000142864","1",67407810,67430415,22605
"8249","ENSG00000142867","1",85265776,85276632,10856
"8250","ENSG00000142871","1",85580761,85583950,3189
"8251","ENSG00000142875","1",84078062,84238498,160436
"8252","ENSG00000142892","1",77088989,77219430,130441
"8253","ENSG00000142910","1",31576485,31587686,11201
"8254","ENSG00000142920","1",33081104,33123492,42388
"8255","ENSG00000142937","1",44775251,44778779,3528
"8256","ENSG00000142945","1",44739818,44767767,27949
"8257","ENSG00000142949","1",43525187,43623666,98479
"8258","ENSG00000142959","1",44783585,44788170,4585
"8259","ENSG00000142961","1",46607715,46616891,9176
"8260","ENSG00000142973","1",46757838,46819413,61575
"8261","ENSG00000143001","1",54980628,54992288,11660
"8262","ENSG00000143006","1",53459399,53467488,8089
"8263","ENSG00000143013","1",87328880,87348923,20043
"8264","ENSG00000143028","1",109466546,109482134,15588
"8265","ENSG00000143032","1",90711539,90717302,5763
"8266","ENSG00000143033","1",93079235,93139079,59844
"8267","ENSG00000143036","1",94820342,94895246,74904
"8268","ENSG00000143061","1",116574399,116667755,93356
"8269","ENSG00000143067","1",119619377,119648266,28889
"8270","ENSG00000143079","1",112396214,112463456,67242
"8271","ENSG00000143093","1",110031577,110074641,43064
"8272","ENSG00000143105","1",110517217,110519175,1958
"8273","ENSG00000143106","1",109399042,109426448,27406
"8274","ENSG00000143107","1",108712908,108742742,29834
"8275","ENSG00000143110","1",111473792,111478512,4720
"8276","ENSG00000143119","1",110871188,110899922,28734
"8277","ENSG00000143125","1",110451149,110457358,6209
"8278","ENSG00000143126","1",109249539,109275751,26212
"8279","ENSG00000143127","1",145891208,145910111,18903
"8280","ENSG00000143147","1",168079543,168137667,58124
"8281","ENSG00000143149","1",165662216,165698863,36647
"8282","ENSG00000143153","1",169105697,169132722,27025
"8283","ENSG00000143155","1",168178962,168202109,23147
"8284","ENSG00000143156","1",169132531,169367948,235417
"8285","ENSG00000143157","1",166839447,166856344,16897
"8286","ENSG00000143158","1",167916675,167937072,20397
"8287","ENSG00000143162","1",167529117,167553805,24688
"8288","ENSG00000143164","1",167935783,168075843,140060
"8289","ENSG00000143167","1",167052836,167166479,113643
"8290","ENSG00000143171","1",165400922,165445355,44433
"8291","ENSG00000143178","1",168280877,168314426,33549
"8292","ENSG00000143179","1",165827614,165911618,84004
"8293","ENSG00000143183","1",165724293,165827755,103462
"8294","ENSG00000143184","1",168576605,168582069,5464
"8295","ENSG00000143185","1",168540768,168543997,3229
"8296","ENSG00000143190","1",167220876,167427345,206469
"8297","ENSG00000143194","1",166975582,167022214,46632
"8298","ENSG00000143195","1",166895711,166975540,79829
"8299","ENSG00000143196","1",168695468,168729206,33738
"8300","ENSG00000143198","1",165631213,165661796,30583
"8301","ENSG00000143199","1",167809388,167914215,104827
"8302","ENSG00000143207","1",175944831,176207286,262455
"8303","ENSG00000143217","1",161070998,161089558,18560
"8304","ENSG00000143222","1",161152776,161158856,6080
"8305","ENSG00000143224","1",161166056,161178013,11957
"8306","ENSG00000143226","1",161505430,161524013,18583
"8307","ENSG00000143228","1",163266576,163355764,89188
"8308","ENSG00000143248","1",163111121,163321791,210670
"8309","ENSG00000143252","1",161314257,161375340,61083
"8310","ENSG00000143256","1",161100556,161118055,17499
"8311","ENSG00000143257","1",161229666,161238302,8636
"8312","ENSG00000143258","1",161159450,161165723,6273
"8313","ENSG00000143278","1",197038741,197067267,28526
"8314","ENSG00000143294","1",156750610,156800815,50205
"8315","ENSG00000143297","1",157513377,157552515,39138
"8316","ENSG00000143303","1",156728442,156736960,8518
"8317","ENSG00000143314","1",156737303,156741590,4287
"8318","ENSG00000143315","1",160024953,160031991,7038
"8319","ENSG00000143318","1",160190575,160201886,11311
"8320","ENSG00000143319","1",156721891,156728799,6908
"8321","ENSG00000143320","1",156699606,156705816,6210
"8322","ENSG00000143321","1",156742109,156766925,24816
"8323","ENSG00000143322","1",179099330,179229684,130354
"8324","ENSG00000143324","1",180632004,180890251,258247
"8325","ENSG00000143333","1",182598623,182604389,5766
"8326","ENSG00000143337","1",179882042,179925000,42958
"8327","ENSG00000143340","1",179743163,179816198,73035
"8328","ENSG00000143341","1",185734391,186190949,456558
"8329","ENSG00000143344","1",183636085,183928531,292446
"8330","ENSG00000143353","1",219173869,219212865,38996
"8331","ENSG00000143355","1",197911902,197935478,23576
"8332","ENSG00000143363","1",151008420,151035713,27293
"8333","ENSG00000143365","1",151806071,151831845,25774
"8334","ENSG00000143367","1",151540305,151583583,43278
"8335","ENSG00000143368","1",149923317,149927803,4486
"8336","ENSG00000143369","1",150508062,150513789,5727
"8337","ENSG00000143373","1",151281618,151292176,10558
"8338","ENSG00000143374","1",150487364,150507609,20245
"8339","ENSG00000143375","1",151510510,151538692,28182
"8340","ENSG00000143376","1",151612006,151699091,87085
"8341","ENSG00000143379","1",150926263,150964744,38481
"8342","ENSG00000143382","1",150549369,150560937,11568
"8343","ENSG00000143384","1",150574551,150579738,5187
"8344","ENSG00000143387","1",150796208,150808260,12052
"8345","ENSG00000143390","1",151340640,151347357,6717
"8346","ENSG00000143393","1",151291797,151327715,35918
"8347","ENSG00000143398","1",151197949,151249536,51587
"8348","ENSG00000143401","1",150218417,150236156,17739
"8349","ENSG00000143409","1",150996086,151008375,12289
"8350","ENSG00000143412","1",150982249,150995634,13385
"8351","ENSG00000143416","1",151364304,151372707,8403
"8352","ENSG00000143418","1",150960583,150975004,14421
"8353","ENSG00000143420","1",150600851,150629612,28761
"8354","ENSG00000143429","2",91617160,91659972,42812
"8355","ENSG00000143434","1",151131685,151146664,14979
"8356","ENSG00000143436","1",151759647,151763496,3849
"8357","ENSG00000143437","1",150809713,150876708,66995
"8358","ENSG00000143442","1",151402724,151459494,56770
"8359","ENSG00000143443","1",151047740,151051986,4246
"8360","ENSG00000143450","1",151762899,151771334,8435
"8361","ENSG00000143452","1",150698060,150720895,22835
"8362","ENSG00000143457","1",150646230,150697154,50924
"8363","ENSG00000143458","1",151070578,151125542,54964
"8364","ENSG00000143469","1",209900923,210171389,270466
"8365","ENSG00000143473","1",210676823,211134165,457342
"8366","ENSG00000143476","1",212035553,212107400,71847
"8367","ENSG00000143479","1",206635536,206684419,48883
"8368","ENSG00000143486","1",206571292,206612465,41173
"8369","ENSG00000143493","1",211940399,212035557,95158
"8370","ENSG00000143494","1",212950520,212992037,41517
"8371","ENSG00000143498","1",222557902,222589933,32031
"8372","ENSG00000143499","1",214281102,214337131,56029
"8373","ENSG00000143502","1",223220819,223364178,143359
"8374","ENSG00000143507","1",221701424,221742089,40665
"8375","ENSG00000143512","1",222522258,222548104,25846
"8376","ENSG00000143514","1",223779893,223845954,66061
"8377","ENSG00000143515","1",154325553,154351304,25751
"8378","ENSG00000143520","1",152348735,152360006,11271
"8379","ENSG00000143536","1",152409243,152414263,5020
"8380","ENSG00000143537","1",155050566,155062775,12209
"8381","ENSG00000143543","1",153974269,153977674,3405
"8382","ENSG00000143545","1",153981617,153986358,4741
"8383","ENSG00000143546","1",153390032,153391073,1041
"8384","ENSG00000143549","1",154155304,154194648,39344
"8385","ENSG00000143552","1",153992685,154155116,162431
"8386","ENSG00000143553","1",153658654,153661830,3176
"8387","ENSG00000143554","1",153774354,153780157,5803
"8388","ENSG00000143556","1",153457744,153460651,2907
"8389","ENSG00000143569","1",154220179,154271510,51331
"8390","ENSG00000143570","1",153959099,153968184,9085
"8391","ENSG00000143575","1",154272511,154275875,3364
"8392","ENSG00000143578","1",153967534,153974361,6827
"8393","ENSG00000143590","1",155078837,155087538,8701
"8394","ENSG00000143595","1",154321090,154325325,4235
"8395","ENSG00000143603","1",154697455,154870281,172826
"8396","ENSG00000143612","1",154206696,154220637,13941
"8397","ENSG00000143614","1",153789030,153923360,134330
"8398","ENSG00000143621","1",153661788,153671028,9240
"8399","ENSG00000143622","1",155897808,155911404,13596
"8400","ENSG00000143624","1",153728050,153774808,46758
"8401","ENSG00000143627","1",155289293,155301438,12145
"8402","ENSG00000143630","1",155277463,155289848,12385
"8403","ENSG00000143631","1",152302175,152325203,23028
"8404","ENSG00000143632","1",229431245,229434098,2853
"8405","ENSG00000143633","1",231223763,231241187,17424
"8406","ENSG00000143641","1",230057990,230282122,224132
"8407","ENSG00000143643","1",230906243,230978875,72632
"8408","ENSG00000143653","1",246724409,246768137,43728
"8409","ENSG00000143669","1",235661041,235883640,222599
"8410","ENSG00000143674","1",233327724,233385148,57424
"8411","ENSG00000143702","1",243124428,243255348,130920
"8412","ENSG00000143727","2",264140,278283,14143
"8413","ENSG00000143740","1",227728539,227781231,52692
"8414","ENSG00000143742","1",225777813,225790468,12655
"8415","ENSG00000143748","1",224227334,224330189,102855
"8416","ENSG00000143751","1",225982702,225999343,16641
"8417","ENSG00000143753","1",224175756,224193441,17685
"8418","ENSG00000143756","1",224114111,224162047,47936
"8419","ENSG00000143761","1",228082660,228099212,16552
"8420","ENSG00000143768","1",225936598,225941383,4785
"8421","ENSG00000143771","1",224356858,224379459,22601
"8422","ENSG00000143772","1",226631690,226739323,107633
"8423","ENSG00000143774","1",228139962,228148984,9022
"8424","ENSG00000143776","1",226989865,227318474,328609
"8425","ENSG00000143786","1",224434660,224740554,305894
"8426","ENSG00000143793","1",228100726,228105411,4685
"8427","ENSG00000143797","2",8852690,9003709,151019
"8428","ENSG00000143799","1",226360691,226408093,47402
"8429","ENSG00000143801","1",226870184,226896105,25921
"8430","ENSG00000143811","1",225919877,225924340,4463
"8431","ENSG00000143815","1",225401502,225428925,27423
"8432","ENSG00000143816","1",227918656,227947932,29276
"8433","ENSG00000143819","1",225810092,225845563,35471
"8434","ENSG00000143839","1",204154819,204190324,35505
"8435","ENSG00000143842","1",204073115,204127743,54628
"8436","ENSG00000143845","1",204131062,204152044,20982
"8437","ENSG00000143847","1",203026498,203078740,52242
"8438","ENSG00000143850","1",204218853,204377665,158812
"8439","ENSG00000143851","1",202147013,202161588,14575
"8440","ENSG00000143858","1",202590596,202710454,119858
"8441","ENSG00000143862","1",202133404,202144743,11339
"8442","ENSG00000143867","2",19351485,19358623,7138
"8443","ENSG00000143869","2",20667144,20679243,12099
"8444","ENSG00000143870","2",10783391,10837977,54586
"8445","ENSG00000143878","2",20447074,20449445,2371
"8446","ENSG00000143882","2",10721100,10785110,64010
"8447","ENSG00000143889","2",38561969,38603586,41617
"8448","ENSG00000143891","2",38666081,38741237,75156
"8449","ENSG00000143919","2",44361947,44772592,410645
"8450","ENSG00000143921","2",43831942,43882988,51046
"8451","ENSG00000143924","2",42169353,42332548,163195
"8452","ENSG00000143933","2",47160083,47176921,16838
"8453","ENSG00000143942","2",53767804,53775196,7392
"8454","ENSG00000143947","2",55231903,55235853,3950
"8455","ENSG00000143951","2",63119559,63827843,708284
"8456","ENSG00000143952","2",63892146,64019428,127282
"8457","ENSG00000143954","2",79025686,79028505,2819
"8458","ENSG00000143970","2",25733753,25878516,144763
"8459","ENSG00000143971","2",67397319,67412089,14770
"8460","ENSG00000143977","2",70281362,70293740,12378
"8461","ENSG00000143994","2",27123789,27130812,7023
"8462","ENSG00000143995","2",66433452,66573869,140417
"8463","ENSG00000144015","2",95592018,95599778,7760
"8464","ENSG00000144021","2",96266132,96273349,7217
"8465","ENSG00000144026","2",95145000,95165413,20413
"8466","ENSG00000144028","2",96274338,96321271,46933
"8467","ENSG00000144029","2",95085369,95149434,64065
"8468","ENSG00000144031","2",70978380,70985499,7119
"8469","ENSG00000144034","2",73729104,73737400,8296
"8470","ENSG00000144035","2",73640832,73642393,1561
"8471","ENSG00000144036","2",72175984,72826041,650057
"8472","ENSG00000144040","2",72942036,73075619,133583
"8473","ENSG00000144043","2",70985942,70994873,8931
"8474","ENSG00000144045","2",74518131,74526281,8150
"8475","ENSG00000144048","2",73762184,73780157,17973
"8476","ENSG00000144057","2",106801600,106887108,85508
"8477","ENSG00000144061","2",110122311,110205066,82755
"8478","ENSG00000144063","2",110083870,110116566,32696
"8479","ENSG00000144115","2",88170295,88186636,16341
"8480","ENSG00000144118","2",120240064,120294710,54646
"8481","ENSG00000144119","2",119156243,119158751,2508
"8482","ENSG00000144120","2",119679167,119686507,7340
"8483","ENSG00000144130","2",112721486,112742879,21393
"8484","ENSG00000144134","2",113627229,113643396,16167
"8485","ENSG00000144136","2",112645939,112663825,17886
"8486","ENSG00000144152","2",112138385,112188218,49833
"8487","ENSG00000144158","2",113657908,113658675,767
"8488","ENSG00000144161","2",112211529,112255136,43607
"8489","ENSG00000144182","2",99154955,99163157,8202
"8490","ENSG00000144188","2",97025981,97031636,5655
"8491","ENSG00000144191","2",98346155,98398601,52446
"8492","ENSG00000144199","2",97083583,97094882,11299
"8493","ENSG00000144214","2",99284238,99304742,20504
"8494","ENSG00000144218","2",99545419,100142739,597320
"8495","ENSG00000144224","2",135741734,135785056,43322
"8496","ENSG00000144227","2",138669157,138780390,111233
"8497","ENSG00000144228","2",138501801,138573547,71746
"8498","ENSG00000144229","2",136765545,137677718,912173
"8499","ENSG00000144230","2",127645864,127652639,6775
"8500","ENSG00000144231","2",127843553,127858155,14602
"8501","ENSG00000144233","2",127861630,127885922,24292
"8502","ENSG00000144278","2",153871922,154453979,582057
"8503","ENSG00000144283","2",158456964,158682879,225915
"8504","ENSG00000144285","2",165984641,166149214,164573
"8505","ENSG00000144290","2",161424332,161985282,560950
"8506","ENSG00000144306","2",174395730,174429575,33845
"8507","ENSG00000144320","2",175923882,176002839,78957
"8508","ENSG00000144331","2",179441982,179861612,419630
"8509","ENSG00000144339","2",191949043,192194933,245890
"8510","ENSG00000144354","2",173354820,173368997,14177
"8511","ENSG00000144355","2",172084740,172089677,4937
"8512","ENSG00000144357","2",169827458,170084131,256673
"8513","ENSG00000144362","2",169694454,169701708,7254
"8514","ENSG00000144366","2",188291669,188595931,304262
"8515","ENSG00000144369","2",186694060,186765959,71899
"8516","ENSG00000144381","2",197486584,197516737,30153
"8517","ENSG00000144395","2",196639554,196763490,123936
"8518","ENSG00000144401","2",207580631,207625928,45297
"8519","ENSG00000144406","2",209771993,209999300,227307
"8520","ENSG00000144407","2",208359714,208854503,494789
"8521","ENSG00000144410","2",206939554,206969474,29920
"8522","ENSG00000144426","2",203014879,203226378,211499
"8523","ENSG00000144445","2",210021421,210171409,149988
"8524","ENSG00000144451","2",213284379,214410501,1126122
"8525","ENSG00000144452","2",214931542,215138626,207084
"8526","ENSG00000144455","3",3700814,4467273,766459
"8527","ENSG00000144460","2",225399710,225654018,254308
"8528","ENSG00000144468","2",226835581,226999215,163634
"8529","ENSG00000144476","2",236567787,236582354,14567
"8530","ENSG00000144481","2",233917373,234019522,102149
"8531","ENSG00000144485","2",238238267,238240662,2395
"8532","ENSG00000144488","2",238100340,238133287,32947
"8533","ENSG00000144504","2",240479422,240569209,89787
"8534","ENSG00000144524","2",231781671,231809254,27583
"8535","ENSG00000144535","2",231961245,232344350,383105
"8536","ENSG00000144550","3",9703826,9729908,26082
"8537","ENSG00000144554","3",10026414,10101930,75516
"8538","ENSG00000144559","3",11790442,11846919,56477
"8539","ENSG00000144560","3",11556069,11771350,215281
"8540","ENSG00000144566","3",19947097,19985175,38078
"8541","ENSG00000144567","2",219176225,219185475,9250
"8542","ENSG00000144579","2",218398256,218405941,7685
"8543","ENSG00000144580","2",218568580,218597080,28500
"8544","ENSG00000144583","2",216257865,216372483,114618
"8545","ENSG00000144589","2",219597857,219616451,18594
"8546","ENSG00000144591","2",219498867,219506989,8122
"8547","ENSG00000144596","3",14489107,14556075,66968
"8548","ENSG00000144597","3",15427598,15450635,23037
"8549","ENSG00000144619","3",2098813,3057959,959146
"8550","ENSG00000144635","3",32525974,32570858,44884
"8551","ENSG00000144642","3",28574791,30010391,1435600
"8552","ENSG00000144644","3",30726200,30894765,168565
"8553","ENSG00000144645","3",31657890,32077580,419690
"8554","ENSG00000144647","3",43079232,43106079,26847
"8555","ENSG00000144648","3",42804752,42887974,83222
"8556","ENSG00000144649","3",42979267,43060211,80944
"8557","ENSG00000144655","3",39141855,39154562,12707
"8558","ENSG00000144659","3",39383370,39397351,13981
"8559","ENSG00000144668","3",37452115,37823507,371392
"8560","ENSG00000144671","3",38282294,38318575,36281
"8561","ENSG00000144674","3",37243177,37366751,123574
"8562","ENSG00000144677","3",37861880,37984469,122589
"8563","ENSG00000144681","3",36380344,36548007,167663
"8564","ENSG00000144711","3",12897043,13283281,386238
"8565","ENSG00000144712","3",12796472,12871916,75444
"8566","ENSG00000144713","3",12834485,12841588,7103
"8567","ENSG00000144724","3",61561569,62297609,736040
"8568","ENSG00000144730","3",57089982,57170306,80324
"8569","ENSG00000144736","3",72749277,72861914,112637
"8570","ENSG00000144741","3",66133610,66388116,254506
"8571","ENSG00000144744","3",69054730,69080408,25678
"8572","ENSG00000144746","3",69084937,69106092,21155
"8573","ENSG00000144747","3",69019827,69052339,32512
"8574","ENSG00000144749","3",66378797,66501263,122466
"8575","ENSG00000144771","3",54918231,54967088,48857
"8576","ENSG00000144785","12",56285916,56316059,30143
"8577","ENSG00000144791","3",45555394,45686341,130947
"8578","ENSG00000144792","3",44578223,44599694,21471
"8579","ENSG00000144802","3",101827991,101861022,33031
"8580","ENSG00000144810","3",99638475,99799226,160751
"8581","ENSG00000144815","3",101779202,101828231,49029
"8582","ENSG00000144820","3",100609601,100695479,85878
"8583","ENSG00000144821","3",108380369,108529322,148953
"8584","ENSG00000144824","3",111732497,111976517,244020
"8585","ENSG00000144827","3",111979010,111993368,14358
"8586","ENSG00000144834","3",111998739,112013887,15148
"8587","ENSG00000144837","3",119597875,119629811,31936
"8588","ENSG00000144840","3",120686681,120742993,56312
"8589","ENSG00000144843","3",119579268,119589945,10677
"8590","ENSG00000144847","3",118900557,119146068,245511
"8591","ENSG00000144848","3",112532509,112562046,29537
"8592","ENSG00000144852","3",119780484,119818485,38001
"8593","ENSG00000144857","3",113211003,113287459,76456
"8594","ENSG00000144867","3",133784033,133825772,41739
"8595","ENSG00000144868","3",133038391,133397792,359401
"8596","ENSG00000144891","3",148697784,148743008,45224
"8597","ENSG00000144893","3",151085697,151437072,351375
"8598","ENSG00000144895","3",150546678,150586016,39338
"8599","ENSG00000144908","3",126103562,126197994,94432
"8600","ENSG00000144909","3",125528858,125595497,66639
"8601","ENSG00000144935","3",142724034,142807888,83854
"8602","ENSG00000144959","3",172630249,172711218,80969
"8603","ENSG00000144962","3",172889357,173141235,251878
"8604","ENSG00000145002","8",12425614,12436343,10729
"8605","ENSG00000145012","3",188153284,188890671,737387
"8606","ENSG00000145014","3",194587673,194633689,46016
"8607","ENSG00000145016","3",197668867,197749727,80860
"8608","ENSG00000145020","3",49416775,49422753,5978
"8609","ENSG00000145022","3",49412206,49416475,4269
"8610","ENSG00000145029","3",49422946,49429326,6380
"8611","ENSG00000145040","3",48561718,48563781,2063
"8612","ENSG00000145041","3",51395867,51500002,104135
"8613","ENSG00000145050","3",51385047,51389397,4350
"8614","ENSG00000145063","2",11105317,11132821,27504
"8615","ENSG00000145075","3",180614008,180870933,256925
"8616","ENSG00000145087","3",120908072,121424761,516689
"8617","ENSG00000145088","3",121835183,121886526,51343
"8618","ENSG00000145103","3",121987323,122022247,34924
"8619","ENSG00000145107","3",196319342,196338503,19161
"8620","ENSG00000145113","3",195746765,195811973,65208
"8621","ENSG00000145147","4",20251905,20620561,368656
"8622","ENSG00000145191","3",184135038,184146127,11089
"8623","ENSG00000145192","3",186613060,186621318,8258
"8624","ENSG00000145194","3",184276011,184293031,17020
"8625","ENSG00000145198","3",184230429,184242329,11900
"8626","ENSG00000145214","4",958887,986895,28008
"8627","ENSG00000145216","4",53377641,53460862,83221
"8628","ENSG00000145217","4",979073,993440,14367
"8629","ENSG00000145220","4",4267701,4290154,22453
"8630","ENSG00000145241","4",67468762,67545503,76741
"8631","ENSG00000145242","4",65319563,65670495,350932
"8632","ENSG00000145244","4",47593999,47838106,244107
"8633","ENSG00000145246","4",47485288,47593486,108198
"8634","ENSG00000145247","4",48885019,48906937,21918
"8635","ENSG00000145248","4",48483343,48489526,6183
"8636","ENSG00000145283","4",86823468,86849263,25795
"8637","ENSG00000145284","4",82629539,82798796,169257
"8638","ENSG00000145287","4",83090048,83137075,47027
"8639","ENSG00000145293","4",82430590,82461177,30587
"8640","ENSG00000145309","4",70334981,70337116,2135
"8641","ENSG00000145321","4",71741696,71804041,62345
"8642","ENSG00000145331","4",99546709,99564039,17330
"8643","ENSG00000145332","4",87160103,87240314,80211
"8644","ENSG00000145335","4",89724099,89838315,114216
"8645","ENSG00000145337","4",88520998,88523776,2778
"8646","ENSG00000145348","4",106041599,106321495,279896
"8647","ENSG00000145349","4",113451032,113761927,310895
"8648","ENSG00000145354","4",102868974,102892807,23833
"8649","ENSG00000145358","4",100185870,100190782,4912
"8650","ENSG00000145362","4",112818109,113383740,565631
"8651","ENSG00000145365","4",112274537,112285904,11367
"8652","ENSG00000145375","4",122923078,123319433,396355
"8653","ENSG00000145384","4",119317250,119322390,5140
"8654","ENSG00000145386","4",121816444,121823933,7489
"8655","ENSG00000145388","4",118685392,118715433,30041
"8656","ENSG00000145390","4",119212587,119295517,82930
"8657","ENSG00000145391","4",139495941,139606699,110758
"8658","ENSG00000145414","4",163110073,163166890,56817
"8659","ENSG00000145416","4",163524298,164384050,859752
"8660","ENSG00000145423","4",153780591,153789083,8492
"8661","ENSG00000145425","4",151099624,151104642,5018
"8662","ENSG00000145428","4",153710125,153760235,50110
"8663","ENSG00000145431","4",156760454,156971799,211345
"8664","ENSG00000145439","4",168863770,169010275,146505
"8665","ENSG00000145451","4",174636920,174829247,192327
"8666","ENSG00000145476","4",186191567,186213463,21896
"8667","ENSG00000145491","5",10441524,10472029,30505
"8668","ENSG00000145494","5",1801400,1816605,15205
"8669","ENSG00000145495","5",10353695,10440388,86693
"8670","ENSG00000145506","5",1008829,1038943,30114
"8671","ENSG00000145526","5",19471296,20575873,1104577
"8672","ENSG00000145536","5",5140330,5320304,179974
"8673","ENSG00000145545","5",6633427,6674386,40959
"8674","ENSG00000145555","5",16661907,16936288,274381
"8675","ENSG00000145569","5",14581792,14616180,34388
"8676","ENSG00000145592","5",40825262,40835222,9960
"8677","ENSG00000145604","5",36151989,36184319,32330
"8678","ENSG00000145623","5",38845858,38945596,99738
"8679","ENSG00000145626","5",35951010,36001028,50018
"8680","ENSG00000145632","5",58453982,58460139,6157
"8681","ENSG00000145642","5",64690442,64718190,27748
"8682","ENSG00000145649","5",55102646,55110252,7606
"8683","ENSG00000145675","5",68215756,68301821,86065
"8684","ENSG00000145681","5",83637805,83721613,83808
"8685","ENSG00000145685","5",78485215,78770021,284806
"8686","ENSG00000145687","5",81413021,81751797,338776
"8687","ENSG00000145692","5",79111809,79132288,20479
"8688","ENSG00000145700","5",75068275,75236878,168603
"8689","ENSG00000145703","5",76403285,76708132,304847
"8690","ENSG00000145708","5",76953045,76981158,28113
"8691","ENSG00000145715","5",87267888,87391931,124043
"8692","ENSG00000145721","5",97091867,97142753,50886
"8693","ENSG00000145723","5",103086000,103120138,34138
"8694","ENSG00000145725","5",103120149,103212799,92650
"8695","ENSG00000145730","5",102753981,103031105,277124
"8696","ENSG00000145734","5",71455651,71567820,112169
"8697","ENSG00000145736","5",71032670,71067689,35019
"8698","ENSG00000145740","5",69093949,69131069,37120
"8699","ENSG00000145741","5",73498408,73505635,7227
"8700","ENSG00000145743","5",107859035,108382098,523063
"8701","ENSG00000145757","5",95652181,95698711,46530
"8702","ENSG00000145777","5",111070062,111078026,7964
"8703","ENSG00000145779","5",119268692,119399688,130996
"8704","ENSG00000145780","5",115520908,115544775,23867
"8705","ENSG00000145781","5",116085016,116412762,327746
"8706","ENSG00000145782","5",115828200,115841837,13637
"8707","ENSG00000145794","5",127290796,127465737,174941
"8708","ENSG00000145808","5",129460281,129738683,278402
"8709","ENSG00000145817","5",144158162,144170714,12552
"8710","ENSG00000145819","5",142770377,143229011,458634
"8711","ENSG00000145824","5",135570679,135579279,8600
"8712","ENSG00000145826","5",135922279,135954983,32704
"8713","ENSG00000145832","5",135579202,135889770,310568
"8714","ENSG00000145833","5",134758771,134855133,96362
"8715","ENSG00000145839","5",135892246,135895827,3581
"8716","ENSG00000145850","5",156919292,156963226,43934
"8717","ENSG00000145860","5",159157409,159210053,52644
"8718","ENSG00000145861","5",160347751,160370641,22890
"8719","ENSG00000145863","5",161547063,161702593,155530
"8720","ENSG00000145864","5",161288429,161549044,260615
"8721","ENSG00000145868","5",148383935,148442836,58901
"8722","ENSG00000145879","5",148312419,148315922,3503
"8723","ENSG00000145882","5",149358037,149369653,11616
"8724","ENSG00000145888","5",151822513,151924842,102329
"8725","ENSG00000145901","5",151029945,151093577,63632
"8726","ENSG00000145907","5",151771045,151812785,41740
"8727","ENSG00000145908","5",150894392,150904983,10591
"8728","ENSG00000145911","5",178113532,178126081,12549
"8729","ENSG00000145912","5",178149460,178153967,4507
"8730","ENSG00000145916","5",178130996,178150568,19572
"8731","ENSG00000145919","5",173607514,173616660,9146
"8732","ENSG00000145920","5",175796310,175884021,87711
"8733","ENSG00000145934","5",167284799,168264157,979358
"8734","ENSG00000145936","5",170374671,170389634,14963
"8735","ENSG00000145945","6",3849373,3851320,1947
"8736","ENSG00000145949","6",2663629,2750966,87337
"8737","ENSG00000145975","6",4049434,4087344,37910
"8738","ENSG00000145979","6",13266542,13328583,62041
"8739","ENSG00000145982","6",5261044,5829192,568148
"8740","ENSG00000145990","6",13357830,13487662,129832
"8741","ENSG00000145996","6",20534457,21232404,697947
"8742","ENSG00000146001","5",141234333,141237529,3196
"8743","ENSG00000146005","5",139795808,139844466,48658
"8744","ENSG00000146006","5",138868921,138875368,6447
"8745","ENSG00000146007","5",140698680,140706676,7996
"8746","ENSG00000146013","5",138252380,138274621,22241
"8747","ENSG00000146021","5",137617500,137736089,118589
"8748","ENSG00000146038","6",24171755,24358059,186304
"8749","ENSG00000146039","6",25754699,25781191,26492
"8750","ENSG00000146047","6",25726777,25727292,515
"8751","ENSG00000146049","6",24356903,24358284,1381
"8752","ENSG00000146054","5",181193924,181205293,11369
"8753","ENSG00000146063","5",181222499,181235808,13309
"8754","ENSG00000146066","5",176388751,176389761,1010
"8755","ENSG00000146067","5",177519789,177554563,34774
"8756","ENSG00000146070","6",46704201,46735693,31492
"8757","ENSG00000146072","6",47231532,47309905,78373
"8758","ENSG00000146083","5",176526712,176538025,11313
"8759","ENSG00000146085","6",49430360,49463253,32893
"8760","ENSG00000146090","5",180100795,180209211,108416
"8761","ENSG00000146094","5",177501907,177511274,9367
"8762","ENSG00000146109","6",26596953,26600739,3786
"8763","ENSG00000146112","6",30676389,30687895,11506
"8764","ENSG00000146122","6",39792298,39904877,112579
"8765","ENSG00000146143","6",57314805,57646850,332045
"8766","ENSG00000146147","6",53929982,54266280,336298
"8767","ENSG00000146151","6",55434369,55579214,144845
"8768","ENSG00000146166","6",63275951,63319977,44026
"8769","ENSG00000146192","6",37005646,37029069,23423
"8770","ENSG00000146197","6",35213956,35253079,39123
"8771","ENSG00000146205","2",241188509,241225377,36868
"8772","ENSG00000146215","6",43299710,43308797,9087
"8773","ENSG00000146216","6",43243481,43288258,44777
"8774","ENSG00000146221","6",44278734,44297698,18964
"8775","ENSG00000146223","6",42879618,42889925,10307
"8776","ENSG00000146232","6",44258166,44265788,7622
"8777","ENSG00000146233","6",46549580,46652830,103250
"8778","ENSG00000146242","6",82363206,82370828,7622
"8779","ENSG00000146243","6",78867551,78946440,78889
"8780","ENSG00000146247","6",78934419,79078254,143835
"8781","ENSG00000146250","6",83512534,83525704,13170
"8782","ENSG00000146263","6",97142161,97283217,141056
"8783","ENSG00000146267","6",99271168,99350062,78894
"8784","ENSG00000146276","6",89177501,89231278,53777
"8785","ENSG00000146278","6",89080751,89085160,4409
"8786","ENSG00000146281","6",89146055,89165565,19510
"8787","ENSG00000146282","6",87513938,87589987,76049
"8788","ENSG00000146285","6",107702154,107824317,122163
"8789","ENSG00000146350","6",121079494,121334745,255251
"8790","ENSG00000146352","6",122996235,123072925,76690
"8791","ENSG00000146360","6",109978256,109980718,2462
"8792","ENSG00000146373","6",124962545,125092633,130088
"8793","ENSG00000146374","6",127118671,127199481,80810
"8794","ENSG00000146376","6",129576132,129710177,134045
"8795","ENSG00000146383","6",132570322,132571359,1037
"8796","ENSG00000146385","6",132552693,132553721,1028
"8797","ENSG00000146386","6",139028745,139043302,14557
"8798","ENSG00000146399","6",132644984,132646003,1019
"8799","ENSG00000146409","6",132769370,132813339,43969
"8800","ENSG00000146410","6",136231024,136250335,19311
"8801","ENSG00000146411","6",133988697,134052636,63939
"8802","ENSG00000146414","6",145864245,145964423,100178
"8803","ENSG00000146416","6",143060496,143340304,279808
"8804","ENSG00000146425","6",158636474,158644743,8269
"8805","ENSG00000146426","6",154832697,155257723,425026
"8806","ENSG00000146433","6",158536436,158635428,98992
"8807","ENSG00000146453","6",159800249,159820704,20455
"8808","ENSG00000146457","6",159725585,159756319,30734
"8809","ENSG00000146463","1",35268967,35422058,153091
"8810","ENSG00000146469","6",152750797,152759765,8968
"8811","ENSG00000146476","6",151452258,151470101,17843
"8812","ENSG00000146477","6",160348378,160452577,104199
"8813","ENSG00000146521","6",167784537,167796872,12335
"8814","ENSG00000146530","7",12330885,12403941,73056
"8815","ENSG00000146535","7",2728105,2844308,116203
"8816","ENSG00000146540","7",996986,1138260,141274
"8817","ENSG00000146555","7",3301252,4269000,967748
"8818","ENSG00000146556","2",113588550,113599043,10493
"8819","ENSG00000146574","7",6794134,6826770,32636
"8820","ENSG00000146576","7",6590021,6608726,18705
"8821","ENSG00000146587","7",5045821,5069487,23666
"8822","ENSG00000146592","7",28299321,28825894,526573
"8823","ENSG00000146618","7",19144782,19145421,639
"8824","ENSG00000146648","7",55019017,55211628,192611
"8825","ENSG00000146666","7",47761476,47766772,5296
"8826","ENSG00000146670","11",65066300,65084164,17864
"8827","ENSG00000146674","7",45912245,45921874,9629
"8828","ENSG00000146676","7",44876293,44885481,9188
"8829","ENSG00000146677","7",44467897,44468304,407
"8830","ENSG00000146678","7",45888360,45893660,5300
"8831","ENSG00000146700","7",76389334,76409697,20363
"8832","ENSG00000146701","7",76048051,76067508,19457
"8833","ENSG00000146707","7",76609986,76627261,17275
"8834","ENSG00000146722","7",75391955,75395434,3479
"8835","ENSG00000146729","7",55951793,56000181,48388
"8836","ENSG00000146731","7",56051685,56063989,12304
"8837","ENSG00000146733","7",56011051,56051604,40553
"8838","ENSG00000146755","7",73312539,73328082,15543
"8839","ENSG00000146757","7",65373799,65401135,27336
"8840","ENSG00000146776","7",105605067,105876604,271537
"8841","ENSG00000146802","7",112762382,112790592,28210
"8842","ENSG00000146809","7",123567010,123639481,72471
"8843","ENSG00000146826","7",100154420,100158723,4303
"8844","ENSG00000146828","7",100826820,100867010,40190
"8845","ENSG00000146830","7",100679507,100694037,14530
"8846","ENSG00000146833","7",99876958,99919600,42642
"8847","ENSG00000146834","7",100428790,100434118,5328
"8848","ENSG00000146839","7",100733626,100797797,64171
"8849","ENSG00000146842","7",130164713,130207770,43057
"8850","ENSG00000146856","7",134986508,135147963,161455
"8851","ENSG00000146857","7",135231979,135258492,26513
"8852","ENSG00000146858","7",139025706,139036042,10336
"8853","ENSG00000146859","7",135148072,135166215,18143
"8854","ENSG00000146872","17",62458658,62615481,156823
"8855","ENSG00000146904","7",143390289,143408856,18567
"8856","ENSG00000146909","7",156949712,156973176,23464
"8857","ENSG00000146910","7",155474206,155555450,81244
"8858","ENSG00000146918","7",158631311,158704829,73518
"8859","ENSG00000146926","7",151175698,151187832,12134
"8860","ENSG00000146938","X",5840637,6228867,388230
"8861","ENSG00000146950","X",9786429,9949443,163014
"8862","ENSG00000146955","7",140404043,140426250,22207
"8863","ENSG00000146963","7",139340359,139423457,83098
"8864","ENSG00000146966","7",140518420,140673993,155573
"8865","ENSG00000147003","X",15627318,15675012,47694
"8866","ENSG00000147010","X",19533977,19887600,353623
"8867","ENSG00000147027","X",34627075,34657285,30210
"8868","ENSG00000147036","X",37571569,37684463,112894
"8869","ENSG00000147041","X",38006553,38128819,122266
"8870","ENSG00000147044","X",41514934,41923645,408711
"8871","ENSG00000147050","X",44873177,45112602,239425
"8872","ENSG00000147059","X",57134530,57137625,3095
"8873","ENSG00000147065","X",65588377,65741931,153554
"8874","ENSG00000147081","X",50190777,50201007,10230
"8875","ENSG00000147082","X",50202713,50351910,149197
"8876","ENSG00000147099","X",72329516,72573101,243585
"8877","ENSG00000147100","X",74421493,74533917,112424
"8878","ENSG00000147113","X",45148373,45200901,52528
"8879","ENSG00000147117","X",47370583,47414305,43722
"8880","ENSG00000147118","X",47974851,48003978,29127
"8881","ENSG00000147119","X",46573784,46598408,24624
"8882","ENSG00000147121","X",46447292,46497422,50130
"8883","ENSG00000147123","X",47142216,47145504,3288
"8884","ENSG00000147124","X",47445879,47482946,37067
"8885","ENSG00000147127","X",70282093,70285002,2909
"8886","ENSG00000147130","X",71239624,71255146,15522
"8887","ENSG00000147133","X",71366239,71532374,166135
"8888","ENSG00000147138","X",79144663,79175315,30652
"8889","ENSG00000147140","X",71283192,71301168,17976
"8890","ENSG00000147144","X",49053572,49069857,16285
"8891","ENSG00000147145","X",78747709,78757094,9385
"8892","ENSG00000147155","X",48521799,48528716,6917
"8893","ENSG00000147160","X",70040542,70049938,9396
"8894","ENSG00000147162","X",71533104,71575892,42788
"8895","ENSG00000147164","X",71056332,71073426,17094
"8896","ENSG00000147166","X",71301750,71305371,3621
"8897","ENSG00000147168","X",71107404,71112108,4704
"8898","ENSG00000147174","X",71578411,71613583,35172
"8899","ENSG00000147180","X",85244032,85273362,29330
"8900","ENSG00000147183","X",88747225,88754785,7560
"8901","ENSG00000147202","X",96684663,97604997,920334
"8902","ENSG00000147206","X",103075810,103093143,17333
"8903","ENSG00000147223","X",106900063,106903341,3278
"8904","ENSG00000147224","X",107628424,107651026,22602
"8905","ENSG00000147231","X",106611930,106679439,67509
"8906","ENSG00000147234","X",107522450,107605251,82801
"8907","ENSG00000147246","X",114584078,114910061,325983
"8908","ENSG00000147251","X",118495898,118686163,190265
"8909","ENSG00000147255","X",131273506,131578899,305393
"8910","ENSG00000147256","X",131058346,131089885,31539
"8911","ENSG00000147257","X",133535745,133985895,450150
"8912","ENSG00000147262","X",130384345,130385660,1315
"8913","ENSG00000147274","X",136848004,136880764,32760
"8914","ENSG00000147316","8",6406596,6648508,241912
"8915","ENSG00000147324","8",8783354,8893630,110276
"8916","ENSG00000147364","8",406428,477967,71539
"8917","ENSG00000147378","X",151716035,151723194,7159
"8918","ENSG00000147381","X",151912509,151925170,12661
"8919","ENSG00000147383","X",152830967,152869729,38762
"8920","ENSG00000147394","X",152914442,152973480,59038
"8921","ENSG00000147400","X",152826973,152830777,3804
"8922","ENSG00000147403","X",154389955,154409168,19213
"8923","ENSG00000147408","8",19404161,19758029,353868
"8924","ENSG00000147416","8",20197381,20226819,29438
"8925","ENSG00000147419","8",27733316,27772653,39337
"8926","ENSG00000147421","8",28890395,29064764,174369
"8927","ENSG00000147432","8",42697376,42737407,40031
"8928","ENSG00000147434","8",42752620,42796392,43772
"8929","ENSG00000147437","8",25419258,25424654,5396
"8930","ENSG00000147439","8",22620418,22669148,48730
"8931","ENSG00000147443","8",21908873,21913690,4817
"8932","ENSG00000147454","8",23528956,23575463,46507
"8933","ENSG00000147457","8",23243637,23262000,18363
"8934","ENSG00000147459","8",25184689,25418082,233393
"8935","ENSG00000147465","8",38143649,38151265,7616
"8936","ENSG00000147471","8",37762595,37779768,17173
"8937","ENSG00000147475","8",37736601,37757801,21200
"8938","ENSG00000147481","8",49909789,50796692,886903
"8939","ENSG00000147485","8",51319577,51809445,489868
"8940","ENSG00000147488","8",52110839,52460959,350120
"8941","ENSG00000147509","8",53851795,53959303,107508
"8942","ENSG00000147526","8",38728186,38853028,124842
"8943","ENSG00000147533","8",41490396,41510980,20584
"8944","ENSG00000147535","8",38263130,38269243,6113
"8945","ENSG00000147536","8",41529218,41545030,15812
"8946","ENSG00000147548","8",38269704,38382272,112568
"8947","ENSG00000147570","8",66021560,66100526,78966
"8948","ENSG00000147571","8",66176376,66178464,2088
"8949","ENSG00000147573","8",66126896,66175485,48589
"8950","ENSG00000147576","8",66432492,66468907,36415
"8951","ENSG00000147586","8",79918717,80030289,111572
"8952","ENSG00000147588","8",81440326,81447439,7113
"8953","ENSG00000147592","8",70635318,70669185,33867
"8954","ENSG00000147596","8",70051651,70071693,20042
"8955","ENSG00000147601","8",73008864,73048123,39259
"8956","ENSG00000147604","8",73290242,73295789,5547
"8957","ENSG00000147606","8",91209494,91398155,188661
"8958","ENSG00000147613","8",86048373,86088621,40248
"8959","ENSG00000147614","8",85987323,86154225,166902
"8960","ENSG00000147642","8",109573978,109691791,117813
"8961","ENSG00000147647","8",104330324,104467055,136731
"8962","ENSG00000147649","8",97644184,97730260,86076
"8963","ENSG00000147650","8",104489231,104589024,99793
"8964","ENSG00000147654","8",109539711,109565996,26285
"8965","ENSG00000147655","8",107899316,108083642,184326
"8966","ENSG00000147669","8",100150623,100154003,3380
"8967","ENSG00000147676","8",119165034,119245673,80639
"8968","ENSG00000147677","8",116642130,116766925,124795
"8969","ENSG00000147679","8",116766505,116849463,82958
"8970","ENSG00000147684","8",124539101,124580648,41547
"8971","ENSG00000147687","8",124488485,124539458,50973
"8972","ENSG00000147689","8",123178960,123210079,31119
"8973","ENSG00000147697","8",129748196,129786624,38428
"8974","ENSG00000147724","8",138130023,138497261,367238
"8975","ENSG00000147789","8",144827464,144847509,20045
"8976","ENSG00000147799","8",144529179,144605816,76637
"8977","ENSG00000147804","8",144409742,144416895,7153
"8978","ENSG00000147813","8",143574785,143578649,3864
"8979","ENSG00000147852","9",2621787,2660056,38269
"8980","ENSG00000147853","9",4709556,4742043,32487
"8981","ENSG00000147854","9",6413151,6507054,93903
"8982","ENSG00000147862","9",14081843,14398983,317140
"8983","ENSG00000147869","9",14719724,14722717,2993
"8984","ENSG00000147872","9",19108375,19149290,40915
"8985","ENSG00000147873","9",21304326,21305312,986
"8986","ENSG00000147874","9",19053141,19102904,49763
"8987","ENSG00000147883","9",22002903,22009305,6402
"8988","ENSG00000147885","9",21216373,21217311,938
"8989","ENSG00000147889","9",21967753,21995301,27548
"8990","ENSG00000147894","9",27546545,27573866,27321
"8991","ENSG00000147896","9",27524314,27526498,2184
"8992","ENSG00000147905","9",37120539,37358149,237610
"8993","ENSG00000147912","9",37510892,37576380,65488
"8994","ENSG00000147955","9",34634722,34637809,3087
"8995","ENSG00000147996","9",65668805,65734041,65236
"8996","ENSG00000148019","9",78236062,78279690,43628
"8997","ENSG00000148053","9",84668551,85027070,358519
"8998","ENSG00000148057","9",83623049,83644130,21081
"8999","ENSG00000148082","9",89005771,89178818,173047
"9000","ENSG00000148090","9",91213815,91361913,148098
"9001","ENSG00000148110","9",94374551,94461042,86491
"9002","ENSG00000148120","9",94726701,95087218,360517
"9003","ENSG00000148123","9",101028727,101325135,296408
"9004","ENSG00000148136","9",104526253,104527209,956
"9005","ENSG00000148143","9",106863166,107013634,150468
"9006","ENSG00000148153","9",112683926,112718149,34223
"9007","ENSG00000148154","9",111896814,111935369,38555
"9008","ENSG00000148156","9",108854589,108856967,2378
"9009","ENSG00000148158","9",112750760,112881671,130911
"9010","ENSG00000148175","9",121338988,121370304,31316
"9011","ENSG00000148180","9",121207794,121332843,125049
"9012","ENSG00000148187","9",122264603,122331337,66734
"9013","ENSG00000148200","9",124517275,124771311,254036
"9014","ENSG00000148204","9",123356170,123380324,24154
"9015","ENSG00000148215","9",122788933,122789895,962
"9016","ENSG00000148218","9",113386312,113401290,14978
"9017","ENSG00000148219","9",116425225,117415070,989845
"9018","ENSG00000148225","9",113313222,113340298,27076
"9019","ENSG00000148229","9",113407235,113410675,3440
"9020","ENSG00000148248","9",133361450,133376166,14716
"9021","ENSG00000148288","9",133152948,133163933,10985
"9022","ENSG00000148290","9",133351758,133356676,4918
"9023","ENSG00000148291","9",133356550,133361158,4608
"9024","ENSG00000148296","9",133328776,133336188,7412
"9025","ENSG00000148297","9",133338323,133348131,9808
"9026","ENSG00000148300","9",133406059,133418096,12037
"9027","ENSG00000148303","9",133348218,133351426,3208
"9028","ENSG00000148308","9",133030675,133058503,27828
"9029","ENSG00000148331","9",129634604,129642169,7565
"9030","ENSG00000148334","9",128120693,128128462,7769
"9031","ENSG00000148335","9",129608884,129636131,27247
"9032","ENSG00000148337","9",128161251,128204383,43132
"9033","ENSG00000148339","9",128068201,128109245,41044
"9034","ENSG00000148341","9",129007036,129028303,21267
"9035","ENSG00000148343","9",129036621,129072082,35461
"9036","ENSG00000148344","9",129738331,129753042,14711
"9037","ENSG00000148346","9",128149071,128153453,4382
"9038","ENSG00000148356","9",127451486,127503501,52015
"9039","ENSG00000148357","9",130265882,130434123,168241
"9040","ENSG00000148358","9",130053426,130140169,86743
"9041","ENSG00000148362","9",136992422,136993984,1562
"9042","ENSG00000148377","10",1018910,1025859,6949
"9043","ENSG00000148384","9",136428619,136439845,11226
"9044","ENSG00000148386","9",135663322,135666422,3100
"9045","ENSG00000148396","9",136440096,136483759,43663
"9046","ENSG00000148399","9",137554444,137578925,24481
"9047","ENSG00000148400","9",136494433,136546048,51615
"9048","ENSG00000148408","9",137877782,138124624,246842
"9049","ENSG00000148411","9",136006537,136095289,88752
"9050","ENSG00000148426","10",11823339,11872277,48938
"9051","ENSG00000148429","10",11453946,11611754,157808
"9052","ENSG00000148444","10",22316386,22320306,3920
"9053","ENSG00000148450","10",23095579,23122013,26434
"9054","ENSG00000148459","10",26697701,26746798,49097
"9055","ENSG00000148468","10",15211643,15371289,159646
"9056","ENSG00000148481","10",15778170,15860507,82337
"9057","ENSG00000148482","10",17951839,18043292,91453
"9058","ENSG00000148483","10",17752201,17800868,48667
"9059","ENSG00000148484","10",16590611,16817463,226852
"9060","ENSG00000148488","10",17315421,17454595,139174
"9061","ENSG00000148498","10",34109560,34815325,705765
"9062","ENSG00000148513","10",37125788,37384111,258323
"9063","ENSG00000148516","10",31318495,31529814,211319
"9064","ENSG00000148541","10",59246129,59363181,117052
"9065","ENSG00000148572","10",63133247,63155031,21784
"9066","ENSG00000148584","10",50799409,50885675,86266
"9067","ENSG00000148600","10",84194537,84219621,25084
"9068","ENSG00000148602","10",84231593,84241461,9868
"9069","ENSG00000148604","10",84230666,84259960,29294
"9070","ENSG00000148606","10",77969251,78029515,60264
"9071","ENSG00000148634","10",67921899,68075348,153449
"9072","ENSG00000148655","10",75431624,76560168,1128544
"9073","ENSG00000148660","10",73812501,73874591,62090
"9074","ENSG00000148671","10",86968192,86983934,15742
"9075","ENSG00000148672","10",87050202,87094843,44641
"9076","ENSG00000148677","10",90912096,90921276,9180
"9077","ENSG00000148680","10",90740823,90858039,117216
"9078","ENSG00000148688","10",90871716,90908553,36837
"9079","ENSG00000148690","10",93667883,93702592,34709
"9080","ENSG00000148700","10",109996368,110135565,139197
"9081","ENSG00000148702","10",113550837,113589602,38765
"9082","ENSG00000148704","10",117128521,117138301,9780
"9083","ENSG00000148719","10",72332830,72355149,22319
"9084","ENSG00000148730","10",70404145,70428618,24473
"9085","ENSG00000148734","10",70247329,70283676,36347
"9086","ENSG00000148735","10",113751262,113783429,32167
"9087","ENSG00000148737","10",112950247,113167678,217431
"9088","ENSG00000148773","10",128096659,128126423,29764
"9089","ENSG00000148795","10",102830531,102837472,6941
"9090","ENSG00000148798","10",103277138,103290346,13208
"9091","ENSG00000148803","10",133355158,133358025,2867
"9092","ENSG00000148814","10",132332154,132381508,49354
"9093","ENSG00000148824","10",133394094,133422520,28426
"9094","ENSG00000148826","10",132783179,132786147,2968
"9095","ENSG00000148832","10",133379261,133391694,12433
"9096","ENSG00000148834","10",104235356,104267459,32103
"9097","ENSG00000148835","10",103367976,103389065,21089
"9098","ENSG00000148840","10",102132994,102150333,17339
"9099","ENSG00000148841","10",104309698,104338465,28767
"9100","ENSG00000148842","10",102918294,103090222,171928
"9101","ENSG00000148843","10",103396626,103446294,49668
"9102","ENSG00000148848","10",126012381,126388455,376074
"9103","ENSG00000148908","10",119499817,119542719,42902
"9104","ENSG00000148925","11",13388001,13463297,75296
"9105","ENSG00000148926","11",10305073,10307397,2324
"9106","ENSG00000148935","11",22625509,22813055,187546
"9107","ENSG00000148942","11",26667020,26723427,56407
"9108","ENSG00000148943","11",27494418,27506769,12351
"9109","ENSG00000148948","11",40114203,41459773,1345570
"9110","ENSG00000148950","11",31432401,31509645,77244
"9111","ENSG00000148965","11",18231355,18236802,5447
"9112","ENSG00000148985","11",3797724,3826371,28647
"9113","ENSG00000149016","11",62575045,62592177,17132
"9114","ENSG00000149021","11",62405103,62423195,18092
"9115","ENSG00000149043","11",1828307,1837521,9214
"9116","ENSG00000149050","11",6997085,7020346,23261
"9117","ENSG00000149054","11",6926404,7001004,74600
"9118","ENSG00000149084","11",43680680,43856617,175937
"9119","ENSG00000149089","11",34853094,34916379,63285
"9120","ENSG00000149090","11",35431823,35530300,98477
"9121","ENSG00000149091","11",46332905,46380554,47649
"9122","ENSG00000149100","11",32583798,32606264,22466
"9123","ENSG00000149115","11",57299638,57324952,25314
"9124","ENSG00000149124","11",58640426,58731974,91548
"9125","ENSG00000149131","11",57597387,57614853,17466
"9126","ENSG00000149136","11",57325986,57335892,9906
"9127","ENSG00000149150","11",57484534,57515780,31246
"9128","ENSG00000149177","11",47980558,48170841,190283
"9129","ENSG00000149179","11",46936689,47164385,227696
"9130","ENSG00000149182","11",47164299,47177125,12826
"9131","ENSG00000149187","11",47465933,47565569,99636
"9132","ENSG00000149196","11",86302211,86345943,43732
"9133","ENSG00000149201","11",86374736,86423109,48373
"9134","ENSG00000149212","11",95165513,95232541,67028
"9135","ENSG00000149218","11",95089846,95132645,42799
"9136","ENSG00000149231","11",96352769,96389956,37187
"9137","ENSG00000149243","11",75422394,75430629,8235
"9138","ENSG00000149256","11",78652831,79440948,788117
"9139","ENSG00000149257","11",75562056,75572783,10727
"9140","ENSG00000149260","11",77066961,77126155,59194
"9141","ENSG00000149262","11",77878720,77994671,115951
"9142","ENSG00000149269","11",77321707,77474635,152928
"9143","ENSG00000149273","11",75399515,75422280,22765
"9144","ENSG00000149289","11",110093392,110171841,78449
"9145","ENSG00000149292","11",113314529,113383544,69015
"9146","ENSG00000149294","11",112961247,113278436,317189
"9147","ENSG00000149295","11",113409605,113475691,66086
"9148","ENSG00000149300","11",111918032,111926871,8839
"9149","ENSG00000149305","11",113904677,113949078,44401
"9150","ENSG00000149308","11",108157215,108222638,65423
"9151","ENSG00000149311","11",108222484,108369102,146618
"9152","ENSG00000149313","11",106075501,106098699,23198
"9153","ENSG00000149328","11",134331874,134378341,46467
"9154","ENSG00000149346","20",10435305,10636829,201524
"9155","ENSG00000149357","11",72085895,72103297,17402
"9156","ENSG00000149380","11",74235801,74311640,75839
"9157","ENSG00000149403","11",120511700,120988904,477204
"9158","ENSG00000149418","11",130159782,130210362,50580
"9159","ENSG00000149428","11",119044188,119057227,13039
"9160","ENSG00000149435","20",23985050,23988779,3729
"9161","ENSG00000149443","20",18809728,18830153,20425
"9162","ENSG00000149451","20",3667965,3682246,14281
"9163","ENSG00000149452","11",62989154,63015841,26687
"9164","ENSG00000149474","20",18138118,18188387,50269
"9165","ENSG00000149476","11",61333210,61353295,20085
"9166","ENSG00000149480","11",62593214,62601865,8651
"9167","ENSG00000149483","11",61362344,61369509,7165
"9168","ENSG00000149485","11",61799625,61829318,29693
"9169","ENSG00000149488","20",2536607,2641784,105177
"9170","ENSG00000149489","11",62611722,62615120,3398
"9171","ENSG00000149499","11",62602218,62612765,10547
"9172","ENSG00000149503","11",62123998,62153169,29171
"9173","ENSG00000149506","11",60867562,60875693,8131
"9174","ENSG00000149507","11",60040409,60048044,7635
"9175","ENSG00000149516","11",60056587,60071115,14528
"9176","ENSG00000149527","1",2425980,2505532,79552
"9177","ENSG00000149531","20",30377372,30399257,21885
"9178","ENSG00000149532","11",61402641,61430031,27390
"9179","ENSG00000149534","11",60088261,60098467,10206
"9180","ENSG00000149541","11",62615296,62622154,6858
"9181","ENSG00000149547","11",125569280,125584684,15404
"9182","ENSG00000149548","11",124954121,125041489,87368
"9183","ENSG00000149554","11",125625665,125676255,50590
"9184","ENSG00000149557","11",125442881,125592568,149687
"9185","ENSG00000149564","11",124752583,124762290,9707
"9186","ENSG00000149571","11",126423358,127003460,580102
"9187","ENSG00000149573","11",118253416,118264536,11120
"9188","ENSG00000149575","11",118157849,118176639,18790
"9189","ENSG00000149577","11",117178733,117197445,18712
"9190","ENSG00000149582","11",118531041,118547280,16239
"9191","ENSG00000149591","11",117199321,117204782,5461
"9192","ENSG00000149596","20",44111695,44187578,75883
"9193","ENSG00000149599","20",31847637,31870747,23110
"9194","ENSG00000149600","20",32702691,32743997,41306
"9195","ENSG00000149609","20",33662327,33665619,3292
"9196","ENSG00000149633","20",38210503,38260772,50269
"9197","ENSG00000149634","20",45886489,45887635,1146
"9198","ENSG00000149635","20",46540946,46550574,9628
"9199","ENSG00000149636","20",36751791,36773818,22027
"9200","ENSG00000149639","20",36777447,36863538,86091
"9201","ENSG00000149646","20",35954564,36030700,76136
"9202","ENSG00000149651","20",45722351,45725830,3479
"9203","ENSG00000149654","20",46173733,46308498,134765
"9204","ENSG00000149656","20",64290385,64313132,22747
"9205","ENSG00000149657","20",62122461,62135374,12913
"9206","ENSG00000149658","20",63195429,63216139,20710
"9207","ENSG00000149679","20",62388632,62407285,18653
"9208","ENSG00000149716","11",69653076,69675416,22340
"9209","ENSG00000149735","11",64934471,64935893,1422
"9210","ENSG00000149742","11",63369789,63410294,40505
"9211","ENSG00000149743","11",64223799,64226254,2455
"9212","ENSG00000149761","11",64225941,64230686,4745
"9213","ENSG00000149781","11",64206678,64223886,17208
"9214","ENSG00000149782","11",64251523,64269150,17627
"9215","ENSG00000149792","11",65122183,65127371,5188
"9216","ENSG00000149798","11",65314866,65322417,7551
"9217","ENSG00000149806","11",65120630,65122177,1547
"9218","ENSG00000149809","11",65111845,65116384,4539
"9219","ENSG00000149823","11",65089324,65111862,22538
"9220","ENSG00000149922","16",30085793,30091887,6094
"9221","ENSG00000149923","16",30075978,30085376,9398
"9222","ENSG00000149925","16",30064164,30070457,6293
"9223","ENSG00000149926","16",30024427,30052978,28551
"9224","ENSG00000149927","16",30005514,30023270,17756
"9225","ENSG00000149929","16",29992321,29996436,4115
"9226","ENSG00000149930","16",29973868,29992261,18393
"9227","ENSG00000149932","16",29940885,29973050,32165
"9228","ENSG00000149948","12",65824131,65966295,142164
"9229","ENSG00000149968","11",102835801,102843609,7808
"9230","ENSG00000149970","X",21372801,21654695,281894
"9231","ENSG00000149972","11",99020949,100358885,1337936
"9232","ENSG00000150045","12",9827481,9845007,17526
"9233","ENSG00000150048","12",10069554,10111627,42073
"9234","ENSG00000150051","10",27672874,27746060,73186
"9235","ENSG00000150054","10",28050993,28334486,283493
"9236","ENSG00000150093","10",32900318,33005792,105474
"9237","ENSG00000150175","10",46870858,46894562,23704
"9238","ENSG00000150201","10",43371636,43376335,4699
"9239","ENSG00000150275","10",53802771,55627942,1825171
"9240","ENSG00000150276","13",52820497,52821018,521
"9241","ENSG00000150281","16",30896607,30903560,6953
"9242","ENSG00000150316","11",94962620,94973586,10966
"9243","ENSG00000150337","1",149782671,149792518,9847
"9244","ENSG00000150347","10",61901684,62096944,195260
"9245","ENSG00000150361","13",69700594,70108493,407899
"9246","ENSG00000150394","16",61647242,62037035,389793
"9247","ENSG00000150401","13",113455819,113490951,35132
"9248","ENSG00000150403","13",113491021,113554590,63569
"9249","ENSG00000150433","11",125096545,125111763,15218
"9250","ENSG00000150455","11",126283065,126298845,15780
"9251","ENSG00000150456","13",20728731,20773958,45227
"9252","ENSG00000150457","13",20973036,21061586,88550
"9253","ENSG00000150459","13",21140514,21149084,8570
"9254","ENSG00000150471","4",61201258,62078335,877077
"9255","ENSG00000150477","18",36829106,37232172,403066
"9256","ENSG00000150510","13",51222334,51284241,61907
"9257","ENSG00000150527","14",39230231,39388513,158282
"9258","ENSG00000150540","2",137964020,138016364,52344
"9259","ENSG00000150551","2",132644853,132671579,26726
"9260","ENSG00000150556","2",149038107,149215262,177155
"9261","ENSG00000150593","10",110871795,110900006,28211
"9262","ENSG00000150594","10",111077163,111080907,3744
"9263","ENSG00000150625","4",175632934,176002664,369730
"9264","ENSG00000150627","4",176065834,176182818,116984
"9265","ENSG00000150628","4",176184638,176195671,11033
"9266","ENSG00000150630","4",176683538,176792922,109384
"9267","ENSG00000150636","18",68715209,69055189,339980
"9268","ENSG00000150637","18",69831158,69961803,130645
"9269","ENSG00000150656","18",74534500,74587212,52712
"9270","ENSG00000150667","15",39588357,39782841,194484
"9271","ENSG00000150672","11",83455012,85627922,2172910
"9272","ENSG00000150676","11",85855101,85920021,64920
"9273","ENSG00000150681","1",192158462,192185815,27353
"9274","ENSG00000150687","11",86791059,86952910,161851
"9275","ENSG00000150712","5",32226994,32312987,85993
"9276","ENSG00000150722","2",181954241,182131398,177157
"9277","ENSG00000150750","11",111245726,111286401,40675
"9278","ENSG00000150753","5",10249929,10266389,16460
"9279","ENSG00000150756","5",10225507,10249897,24390
"9280","ENSG00000150760","10",126905409,127452517,547108
"9281","ENSG00000150764","11",111927144,112022584,95440
"9282","ENSG00000150768","11",112024814,112064390,39576
"9283","ENSG00000150773","11",112064010,112074274,10264
"9284","ENSG00000150776","11",112074086,112085150,11064
"9285","ENSG00000150779","11",112084800,112086798,1998
"9286","ENSG00000150782","11",112143253,112164096,20843
"9287","ENSG00000150783","11",112167372,112172559,5187
"9288","ENSG00000150787","11",112226367,112269955,43588
"9289","ENSG00000150867","10",22534854,22714578,179724
"9290","ENSG00000150873","2",11133053,11146790,13737
"9291","ENSG00000150893","13",38687077,38887131,200054
"9292","ENSG00000150907","13",40469953,40666641,196688
"9293","ENSG00000150938","2",36355778,36551135,195357
"9294","ENSG00000150961","4",118722823,118838683,115860
"9295","ENSG00000150967","12",122920951,122981649,60698
"9296","ENSG00000150977","12",123410683,123436717,26034
"9297","ENSG00000150990","12",124946825,124989131,42306
"9298","ENSG00000150991","12",124911604,124917368,5764
"9299","ENSG00000150995","3",4493345,4847840,354495
"9300","ENSG00000151005","4",163471093,163473746,2653
"9301","ENSG00000151006","16",31083425,31089628,6203
"9302","ENSG00000151012","4",138164097,138242349,78252
"9303","ENSG00000151014","4",139015781,139045939,30158
"9304","ENSG00000151023","10",24981979,25062279,80300
"9305","ENSG00000151025","10",25174802,25602229,427427
"9306","ENSG00000151033","10",30611779,30629762,17983
"9307","ENSG00000151062","12",1791963,1918666,126703
"9308","ENSG00000151065","12",1946053,2004535,58482
"9309","ENSG00000151067","12",1970786,2697950,727164
"9310","ENSG00000151090","3",24117153,24495756,378603
"9311","ENSG00000151092","3",25718944,25790039,71095
"9312","ENSG00000151093","3",25782917,25794534,11617
"9313","ENSG00000151116","11",18529609,18588747,59138
"9314","ENSG00000151117","11",18693122,18704785,11663
"9315","ENSG00000151131","12",104986316,105074197,87881
"9316","ENSG00000151135","12",106955719,106978778,23059
"9317","ENSG00000151136","12",107318421,107659642,341221
"9318","ENSG00000151148","12",109477402,109536705,59303
"9319","ENSG00000151150","10",60026298,60733490,707192
"9320","ENSG00000151151","10",58191517,58267894,76377
"9321","ENSG00000151164","12",110501655,110532086,30431
"9322","ENSG00000151176","12",113358566,113391629,33063
"9323","ENSG00000151208","10",77790791,77926755,135964
"9324","ENSG00000151224","10",80271820,80289658,17838
"9325","ENSG00000151229","12",39755025,40106089,351064
"9326","ENSG00000151233","12",42081845,42144874,63029
"9327","ENSG00000151239","12",43793723,43806375,12652
"9328","ENSG00000151240","10",274190,689668,415478
"9329","ENSG00000151247","4",98871684,98930637,58953
"9330","ENSG00000151276","3",65353525,66038834,685309
"9331","ENSG00000151287","13",102765888,102773811,7923
"9332","ENSG00000151292","5",123512099,123617045,104946
"9333","ENSG00000151303","10",86992406,87010203,17797
"9334","ENSG00000151304","5",121961961,122075570,113609
"9335","ENSG00000151320","14",32329298,32837684,508386
"9336","ENSG00000151322","14",32934933,33804176,869243
"9337","ENSG00000151327","14",35044907,35113130,68223
"9338","ENSG00000151332","14",36298564,36320637,22073
"9339","ENSG00000151338","14",37197913,37552361,354448
"9340","ENSG00000151348","11",44095673,44251981,156308
"9341","ENSG00000151353","2",663877,677406,13529
"9342","ENSG00000151360","2",3658200,3702671,44471
"9343","ENSG00000151364","11",78015715,78046191,30476
"9344","ENSG00000151365","11",78063861,78068351,4490
"9345","ENSG00000151366","11",78068297,78079862,11565
"9346","ENSG00000151376","11",86441108,86672636,231528
"9347","ENSG00000151379","2",17816496,17817101,605
"9348","ENSG00000151388","5",33523535,33892019,368484
"9349","ENSG00000151413","14",31489956,31861224,371268
"9350","ENSG00000151414","1",198156994,198322420,165426
"9351","ENSG00000151418","1",198523222,198540945,17723
"9352","ENSG00000151422","5",108747841,109196841,449000
"9353","ENSG00000151445","14",77426675,77457952,31277
"9354","ENSG00000151458","4",124664048,124712732,48684
"9355","ENSG00000151461","10",11920022,12043170,123148
"9356","ENSG00000151465","10",12195965,12250589,54624
"9357","ENSG00000151466","4",128864921,129093600,228679
"9358","ENSG00000151468","10",12896625,13099652,203027
"9359","ENSG00000151470","4",129093317,129116640,23323
"9360","ENSG00000151474","10",13643706,14462142,818436
"9361","ENSG00000151475","4",127730400,127774292,43892
"9362","ENSG00000151490","12",15322508,15598331,275823
"9363","ENSG00000151491","12",15620134,15882329,262195
"9364","ENSG00000151498","11",134253495,134265855,12360
"9365","ENSG00000151500","11",134248279,134253370,5091
"9366","ENSG00000151502","11",134224671,134247788,23117
"9367","ENSG00000151503","11",134150119,134225454,75335
"9368","ENSG00000151532","10",112446998,112818744,371746
"9369","ENSG00000151552","4",17460261,17512206,51945
"9370","ENSG00000151553","10",114821744,114899832,78088
"9371","ENSG00000151572","12",100717526,101128641,411115
"9372","ENSG00000151575","15",56244009,56445997,201988
"9373","ENSG00000151576","3",114005833,114088422,82589
"9374","ENSG00000151577","3",114128652,114199407,70755
"9375","ENSG00000151611","4",145599042,145660033,60991
"9376","ENSG00000151612","4",145757627,145938823,181196
"9377","ENSG00000151615","4",146638893,146642474,3581
"9378","ENSG00000151617","4",147480917,147544954,64037
"9379","ENSG00000151623","4",148078762,148444698,365936
"9380","ENSG00000151631","10",4871901,4891975,20074
"9381","ENSG00000151632","10",4987400,5018031,30631
"9382","ENSG00000151640","10",132186948,132205759,18811
"9383","ENSG00000151650","10",133237855,133241928,4073
"9384","ENSG00000151651","10",133262420,133276868,14448
"9385","ENSG00000151655","10",7703316,7749520,46204
"9386","ENSG00000151657","10",7750962,7787993,37031
"9387","ENSG00000151665","2",46580937,46617119,36182
"9388","ENSG00000151687","2",189674290,189761193,86903
"9389","ENSG00000151689","2",190343570,190371665,28095
"9390","ENSG00000151690","2",190408355,190509205,100850
"9391","ENSG00000151692","2",6917412,7068286,150874
"9392","ENSG00000151693","2",9206765,9405683,198918
"9393","ENSG00000151694","2",9488486,9556732,68246
"9394","ENSG00000151702","11",128686535,128813267,126732
"9395","ENSG00000151704","11",128836315,128867373,31058
"9396","ENSG00000151715","11",129815819,129860003,44184
"9397","ENSG00000151718","4",183099257,183320777,221520
"9398","ENSG00000151725","4",184694085,184734130,40045
"9399","ENSG00000151726","4",184755595,184826818,71223
"9400","ENSG00000151729","4",185143266,185150382,7116
"9401","ENSG00000151743","12",31671142,31729121,57979
"9402","ENSG00000151746","12",32106835,32383633,276798
"9403","ENSG00000151748","14",50632058,50668331,36273
"9404","ENSG00000151773","13",43823909,43879740,55831
"9405","ENSG00000151778","13",44373665,44397714,24049
"9406","ENSG00000151779","2",15166914,15561334,394420
"9407","ENSG00000151789","3",21412218,22373321,961103
"9408","ENSG00000151790","4",155854738,155920406,65668
"9409","ENSG00000151806","4",44678420,44700928,22508
"9410","ENSG00000151812","14",57563922,57982194,418272
"9411","ENSG00000151834","4",46248427,46475230,226803
"9412","ENSG00000151835","13",23328826,23433740,104914
"9413","ENSG00000151838","14",59504539,59576812,72273
"9414","ENSG00000151846","13",25095868,25099254,3386
"9415","ENSG00000151849","13",24882279,24922889,40610
"9416","ENSG00000151876","5",41925254,41941743,16489
"9417","ENSG00000151881","5",43444252,43483893,39641
"9418","ENSG00000151882","5",43376645,43412391,35746
"9419","ENSG00000151883","5",50665899,50846519,180620
"9420","ENSG00000151892","10",116056925,116273467,216542
"9421","ENSG00000151893","10",118674167,118755249,81082
"9422","ENSG00000151914","6",56457987,56954649,496662
"9423","ENSG00000151917","6",56955107,57027346,72239
"9424","ENSG00000151923","10",119571802,119597029,25227
"9425","ENSG00000151929","10",119651370,119677819,26449
"9426","ENSG00000151948","12",128853427,128984968,131541
"9427","ENSG00000151952","12",129071725,129904025,832300
"9428","ENSG00000151962","4",154781213,154828813,47600
"9429","ENSG00000151963","10",37883594,37884109,515
"9430","ENSG00000151967","3",159839861,159897360,57499
"9431","ENSG00000152034","6",99919910,99994247,74337
"9432","ENSG00000152049","2",223051814,223198399,146585
"9433","ENSG00000152056","2",223751686,223838027,86341
"9434","ENSG00000152061","1",174159410,174995308,835898
"9435","ENSG00000152076","2",130139287,130145134,5847
"9436","ENSG00000152078","1",95117355,95197607,80252
"9437","ENSG00000152082","2",130181737,130190729,8992
"9438","ENSG00000152086","2",130191745,130198439,6694
"9439","ENSG00000152092","1",176857302,177164973,307671
"9440","ENSG00000152093","2",130521197,130528604,7407
"9441","ENSG00000152102","2",131047876,131093460,45584
"9442","ENSG00000152104","1",214348700,214552449,203749
"9443","ENSG00000152117","2",131492813,131521573,28760
"9444","ENSG00000152127","2",134119983,134454621,334638
"9445","ENSG00000152128","2",134455759,134719000,263241
"9446","ENSG00000152133","2",37084451,37099244,14793
"9447","ENSG00000152137","12",119178642,119221131,42489
"9448","ENSG00000152147","2",38751534,38785002,33468
"9449","ENSG00000152154","2",39664982,39717963,52981
"9450","ENSG00000152192","13",78598362,78603552,5190
"9451","ENSG00000152193","13",78614289,78659155,44866
"9452","ENSG00000152207","13",48653711,48711226,57515
"9453","ENSG00000152208","4",92303966,93810157,1506191
"9454","ENSG00000152213","13",49628299,49633872,5573
"9455","ENSG00000152214","18",42743227,43115691,372464
"9456","ENSG00000152217","18",44680173,45068510,388337
"9457","ENSG00000152219","11",30323104,30338223,15119
"9458","ENSG00000152223","18",45847609,45967329,119720
"9459","ENSG00000152229","18",45983536,46072272,88736
"9460","ENSG00000152234","18",46080248,46104334,24086
"9461","ENSG00000152240","18",46104378,46128333,23955
"9462","ENSG00000152242","18",46173553,46266992,93439
"9463","ENSG00000152253","2",168834132,168913371,79239
"9464","ENSG00000152254","2",168901240,168910000,8760
"9465","ENSG00000152256","2",172555373,172608669,53296
"9466","ENSG00000152266","11",13492054,13496181,4127
"9467","ENSG00000152270","11",14643804,14872044,228240
"9468","ENSG00000152284","2",85133392,85310387,176995
"9469","ENSG00000152291","2",85318020,85328296,10276
"9470","ENSG00000152292","2",85418931,85437029,18098
"9471","ENSG00000152315","14",90061994,90185853,123859
"9472","ENSG00000152332","1",162497251,162529631,32380
"9473","ENSG00000152348","5",81972023,82276857,304834
"9474","ENSG00000152359","5",75674124,75717481,43357
"9475","ENSG00000152377","5",136975298,137598379,623081
"9476","ENSG00000152380","5",80487969,80542563,54594
"9477","ENSG00000152382","1",166856510,166876264,19754
"9478","ENSG00000152402","11",106674012,107018524,344512
"9479","ENSG00000152404","11",107326345,107457844,131499
"9480","ENSG00000152409","5",79236131,79327211,91080
"9481","ENSG00000152413","5",79372636,79514217,141581
"9482","ENSG00000152422","5",83077498,83353787,276289
"9483","ENSG00000152430","2",197726879,197786762,59883
"9484","ENSG00000152433","19",57363477,57379565,16088
"9485","ENSG00000152439","19",57499915,57518404,18489
"9486","ENSG00000152443","19",57746815,57758148,11333
"9487","ENSG00000152454","19",57940833,57947706,6873
"9488","ENSG00000152455","10",14878820,14904315,25495
"9489","ENSG00000152457","10",14897359,14954432,57073
"9490","ENSG00000152463","10",15032227,15073852,41625
"9491","ENSG00000152464","10",15097180,15139818,42638
"9492","ENSG00000152465","10",15102584,15168693,66109
"9493","ENSG00000152467","19",58034032,58054631,20599
"9494","ENSG00000152475","19",58367618,58381030,13412
"9495","ENSG00000152484","13",27066156,27171811,105655
"9496","ENSG00000152492","3",191329085,191398659,69574
"9497","ENSG00000152495","5",111223653,111494886,271233
"9498","ENSG00000152503","5",115124762,115180546,55784
"9499","ENSG00000152518","2",43222402,43226606,4204
"9500","ENSG00000152520","13",28138506,28295335,156829
"9501","ENSG00000152527","2",43637260,43767987,130727
"9502","ENSG00000152556","12",48105139,48146404,41265
"9503","ENSG00000152558","11",102396332,102470384,74052
"9504","ENSG00000152578","11",105609994,105982092,372098
"9505","ENSG00000152580","3",151425384,151458709,33325
"9506","ENSG00000152582","5",35617844,35814611,196767
"9507","ENSG00000152583","4",87473335,87531061,57726
"9508","ENSG00000152591","4",87608529,87616873,8344
"9509","ENSG00000152592","4",87650307,87664361,14054
"9510","ENSG00000152595","4",87821411,87846817,25406
"9511","ENSG00000152601","3",152243828,152465780,221952
"9512","ENSG00000152611","5",35904288,35938779,34491
"9513","ENSG00000152620","5",36192589,36242279,49690
"9514","ENSG00000152642","3",32105689,32168713,63024
"9515","ENSG00000152661","6",121435595,121449727,14132
"9516","ENSG00000152669","5",55231152,55233608,2456
"9517","ENSG00000152670","5",55738017,55817157,79140
"9518","ENSG00000152672","2",70808643,70820599,11956
"9519","ENSG00000152683","2",32165841,32224379,58538
"9520","ENSG00000152684","5",52787916,52804044,16128
"9521","ENSG00000152689","2",33436324,33564750,128426
"9522","ENSG00000152700","5",134601149,134649271,48122
"9523","ENSG00000152705","5",134967907,135011696,43789
"9524","ENSG00000152749","13",94601857,94634661,32804
"9525","ENSG00000152760","1",66752459,66779047,26588
"9526","ENSG00000152763","1",66812885,66924856,111971
"9527","ENSG00000152766","10",88819896,88851844,31948
"9528","ENSG00000152767","13",98142562,98455176,312614
"9529","ENSG00000152778","10",89414568,89420997,6429
"9530","ENSG00000152779","10",89430299,89556641,126342
"9531","ENSG00000152782","10",89579497,89645572,66075
"9532","ENSG00000152784","4",80183879,80204329,20450
"9533","ENSG00000152785","4",81030708,81057632,26924
"9534","ENSG00000152795","4",82422564,82430408,7844
"9535","ENSG00000152804","10",92689955,92695647,5692
"9536","ENSG00000152818","6",144285701,144853034,567333
"9537","ENSG00000152822","6",146027646,146437601,409955
"9538","ENSG00000152894","6",127968779,128520674,551895
"9539","ENSG00000152904","1",235327350,235344532,17182
"9540","ENSG00000152910","16",76277278,76560757,283479
"9541","ENSG00000152926","7",64971776,65006684,34908
"9542","ENSG00000152931","5",60487713,60548813,61100
"9543","ENSG00000152932","5",58582221,58859394,277173
"9544","ENSG00000152936","12",25409307,25648579,239272
"9545","ENSG00000152939","5",69415065,69444330,29265
"9546","ENSG00000152942","5",69369293,69414801,45508
"9547","ENSG00000152944","12",27022546,27066343,43797
"9548","ENSG00000152952","3",146069440,146163653,94213
"9549","ENSG00000152953","4",5051480,5500994,449514
"9550","ENSG00000152954","6",24126186,24154900,28714
"9551","ENSG00000152969","4",6026203,6200591,174388
"9552","ENSG00000152977","3",147393422,147510293,116871
"9553","ENSG00000152990","4",22345071,22516066,170995
"9554","ENSG00000153002","3",148791102,148860187,69085
"9555","ENSG00000153006","5",64718148,64768691,50543
"9556","ENSG00000153012","4",24998847,25030946,32099
"9557","ENSG00000153015","5",64768930,65018750,249820
"9558","ENSG00000153029","1",181033425,181061938,28513
"9559","ENSG00000153037","5",112861188,112898371,37183
"9560","ENSG00000153044","5",69189574,69210357,20783
"9561","ENSG00000153046","6",4706159,4955551,249392
"9562","ENSG00000153048","16",8852942,8869012,16070
"9563","ENSG00000153060","16",10627501,10694945,67444
"9564","ENSG00000153064","4",101411286,102074812,663526
"9565","ENSG00000153066","16",11679080,11742878,63798
"9566","ENSG00000153071","5",39371675,39462300,90625
"9567","ENSG00000153086","2",134838616,134902034,63418
"9568","ENSG00000153093","2",110732573,111118222,385649
"9569","ENSG00000153094","2",111119378,111168445,49067
"9570","ENSG00000153107","2",111611639,111884690,273051
"9571","ENSG00000153113","5",96525267,96779595,254328
"9572","ENSG00000153130","4",140257286,140385726,128440
"9573","ENSG00000153132","4",140388453,140427661,39208
"9574","ENSG00000153140","5",90392261,90409786,17525
"9575","ENSG00000153147","4",143513702,143557486,43784
"9576","ENSG00000153157","6",10886831,10979320,92489
"9577","ENSG00000153162","6",7726099,7881728,155629
"9578","ENSG00000153165","2",106391290,106468376,77086
"9579","ENSG00000153179","12",64507001,64697564,190563
"9580","ENSG00000153187","1",244840638,244864560,23922
"9581","ENSG00000153201","2",108719482,108785809,66327
"9582","ENSG00000153207","1",246839098,246931967,92869
"9583","ENSG00000153208","2",111898479,112029561,131082
"9584","ENSG00000153214","2",112055269,112119318,64049
"9585","ENSG00000153230","1",247738615,247739559,944
"9586","ENSG00000153233","12",70638073,70920738,282665
"9587","ENSG00000153234","2",156324437,156342348,17911
"9588","ENSG00000153237","2",158171081,158456753,285672
"9589","ENSG00000153246","2",159932006,160062615,130609
"9590","ENSG00000153250","2",160272151,160493807,221656
"9591","ENSG00000153253","2",165087522,165204067,116545
"9592","ENSG00000153266","3",62369681,62374324,4643
"9593","ENSG00000153283","3",111292719,111665750,373031
"9594","ENSG00000153291","6",46652915,46678190,25275
"9595","ENSG00000153292","6",46997708,47042350,44642
"9596","ENSG00000153294","6",47685864,47722021,36157
"9597","ENSG00000153303","6",168053166,168101511,48345
"9598","ENSG00000153310","8",129839593,130017129,177536
"9599","ENSG00000153317","8",130052104,130443674,391570
"9600","ENSG00000153339","18",31829180,31953136,123956
"9601","ENSG00000153347","5",95391344,95450454,59110
"9602","ENSG00000153363","1",211382736,211435570,52834
"9603","ENSG00000153391","18",35452230,35497991,45761
"9604","ENSG00000153395","5",1456480,1523962,67482
"9605","ENSG00000153404","5",92151,189972,97821
"9606","ENSG00000153406","16",4461680,4495763,34083
"9607","ENSG00000153443","16",4608883,4615027,6144
"9608","ENSG00000153446","16",5044122,5066110,21988
"9609","ENSG00000153485","14",93184951,93187089,2138
"9610","ENSG00000153487","13",110712736,110723339,10603
"9611","ENSG00000153495","13",111316184,111344249,28065
"9612","ENSG00000153498","13",112376355,112434689,58334
"9613","ENSG00000153531","13",113399610,113453524,53914
"9614","ENSG00000153551","3",32391671,32483067,91396
"9615","ENSG00000153558","3",33277025,33403662,126637
"9616","ENSG00000153560","3",33388336,33441371,53035
"9617","ENSG00000153561","2",86720291,86778041,57750
"9618","ENSG00000153563","2",86784610,86808396,23786
"9619","ENSG00000153574","2",88691673,88750929,59256
"9620","ENSG00000153684","15",28378621,28392018,13397
"9621","ENSG00000153707","9",8314246,10612723,2298477
"9622","ENSG00000153714","9",12775020,12823060,48040
"9623","ENSG00000153721","6",154387515,154510685,123170
"9624","ENSG00000153767","3",120742637,120783069,40432
"9625","ENSG00000153774","16",75293698,75433503,139805
"9626","ENSG00000153779","X",89921882,89922883,1001
"9627","ENSG00000153786","16",84974181,85011535,37354
"9628","ENSG00000153789","16",85098358,85112472,14114
"9629","ENSG00000153790","7",25134692,25180356,45664
"9630","ENSG00000153802","4",67820876,67884032,63156
"9631","ENSG00000153814","7",27830573,28180795,350222
"9632","ENSG00000153815","16",81445170,81711762,266592
"9633","ENSG00000153820","2",227979955,228181687,201732
"9634","ENSG00000153822","17",70053429,70135608,82179
"9635","ENSG00000153823","2",228850526,229271285,420759
"9636","ENSG00000153827","2",229763838,229923239,159401
"9637","ENSG00000153832","2",229922302,230013119,90817
"9638","ENSG00000153879","19",33373685,33382686,9001
"9639","ENSG00000153885","19",33795933,33815763,19830
"9640","ENSG00000153896","19",34758073,34773229,15156
"9641","ENSG00000153898","1",84925583,84997113,71530
"9642","ENSG00000153902","19",35124513,35142451,17938
"9643","ENSG00000153904","1",85318481,85578363,259882
"9644","ENSG00000153914","5",66139971,66183615,43644
"9645","ENSG00000153922","5",98853985,98928957,74972
"9646","ENSG00000153923","1",86634273,86655376,21103
"9647","ENSG00000153930","17",55882301,56511659,629358
"9648","ENSG00000153933","17",56834107,56869567,35460
"9649","ENSG00000153936","1",86914635,87109982,195347
"9650","ENSG00000153944","17",57255851,57684689,428838
"9651","ENSG00000153956","7",81946444,82443777,497333
"9652","ENSG00000153975","6",116635618,116668794,33176
"9653","ENSG00000153976","17",13494032,13601929,107897
"9654","ENSG00000153982","17",59220467,59275970,55503
"9655","ENSG00000153989","6",117675469,117710727,35258
"9656","ENSG00000153993","7",84995553,85186855,191302
"9657","ENSG00000154001","14",63371364,63543377,172013
"9658","ENSG00000154007","1",75918873,75932431,13558
"9659","ENSG00000154016","17",19020673,19047637,26964
"9660","ENSG00000154025","17",18950345,19022595,72250
"9661","ENSG00000154027","1",77282019,77559966,277947
"9662","ENSG00000154040","18",24138956,24161603,22647
"9663","ENSG00000154059","18",24426634,24453531,26897
"9664","ENSG00000154065","18",23598926,23662911,63985
"9665","ENSG00000154079","6",70566917,70589569,22652
"9666","ENSG00000154080","18",26906481,27185308,278827
"9667","ENSG00000154096","11",119417378,119424985,7607
"9668","ENSG00000154099","16",84145287,84178767,33480
"9669","ENSG00000154102","16",85690084,85751129,61045
"9670","ENSG00000154114","11",121024072,121090775,66703
"9671","ENSG00000154118","16",87601835,87698156,96321
"9672","ENSG00000154122","5",14704800,14871778,166978
"9673","ENSG00000154124","5",14664664,14699711,35047
"9674","ENSG00000154127","11",122655722,122814473,158751
"9675","ENSG00000154133","11",124883691,124898500,14809
"9676","ENSG00000154134","11",124865432,124881471,16039
"9677","ENSG00000154143","11",124611490,124620356,8866
"9678","ENSG00000154144","11",124622836,124635926,13090
"9679","ENSG00000154146","11",124739942,124747210,7268
"9680","ENSG00000154153","5",16473038,16617058,144020
"9681","ENSG00000154162","5",21750673,22853622,1102949
"9682","ENSG00000154165","3",98531978,98534681,2703
"9683","ENSG00000154174","3",100363431,100401398,37967
"9684","ENSG00000154175","3",100749156,100993515,244359
"9685","ENSG00000154188","8",107249482,107498055,248573
"9686","ENSG00000154198","1",46843095,46900437,57342
"9687","ENSG00000154217","17",67377281,67697261,319980
"9688","ENSG00000154222","1",52345723,52366193,20470
"9689","ENSG00000154227","15",100400395,100544995,144600
"9690","ENSG00000154229","17",66302613,66810743,508130
"9691","ENSG00000154237","15",100919327,101078257,158930
"9692","ENSG00000154240","17",65635537,66192133,556596
"9693","ENSG00000154252","2",241776825,241804208,27383
"9694","ENSG00000154258","17",68974488,69060949,86461
"9695","ENSG00000154262","17",69078702,69141895,63193
"9696","ENSG00000154263","17",69147214,69244846,97632
"9697","ENSG00000154265","17",69244311,69327244,82933
"9698","ENSG00000154269","6",131628442,131747418,118976
"9699","ENSG00000154274","4",37453925,37623495,169570
"9700","ENSG00000154277","4",41256413,41268455,12042
"9701","ENSG00000154305","1",222618097,222668007,49910
"9702","ENSG00000154309","1",222872271,223005995,133724
"9703","ENSG00000154310","3",171058414,171460408,401994
"9704","ENSG00000154316","8",11339637,11368452,28815
"9705","ENSG00000154319","8",11421476,11475908,54432
"9706","ENSG00000154328","8",11769639,11787345,17706
"9707","ENSG00000154330","9",68328308,68531061,202753
"9708","ENSG00000154342","1",228006998,228061271,54273
"9709","ENSG00000154358","1",228208063,228378876,170813
"9710","ENSG00000154359","8",12721906,12756073,34167
"9711","ENSG00000154370","1",228393673,228406835,13162
"9712","ENSG00000154380","1",225486835,225653142,166307
"9713","ENSG00000154415","7",113876777,114075920,199143
"9714","ENSG00000154429","1",229321011,229343294,22283
"9715","ENSG00000154438","7",117363222,117428123,64901
"9716","ENSG00000154447","4",169094259,169270956,176697
"9717","ENSG00000154451","1",89258950,89272804,13854
"9718","ENSG00000154473","10",123154402,123170467,16065
"9719","ENSG00000154478","10",123666355,123694607,28252
"9720","ENSG00000154479","2",169645425,169694405,48980
"9721","ENSG00000154485","10",125753580,125775821,22241
"9722","ENSG00000154493","10",126424997,126798708,373711
"9723","ENSG00000154511","1",92832737,92961522,128785
"9724","ENSG00000154518","2",175176258,175184607,8349
"9725","ENSG00000154529","9",41890314,42129510,239196
"9726","ENSG00000154545","X",52184823,52192268,7445
"9727","ENSG00000154548","6",89095959,89118071,22112
"9728","ENSG00000154553","4",185500660,185535612,34952
"9729","ENSG00000154556","4",185585444,185956652,371208
"9730","ENSG00000154582","8",73939169,73972287,33118
"9731","ENSG00000154589","8",73991352,74029087,37735
"9732","ENSG00000154608","4",118467590,118554100,86510
"9733","ENSG00000154611","18",26133852,26193355,59503
"9734","ENSG00000154620","Y",13703899,13706024,2125
"9735","ENSG00000154639","21",17513043,17593579,80536
"9736","ENSG00000154640","21",17593653,17612947,19294
"9737","ENSG00000154642","21",17788974,17819386,30412
"9738","ENSG00000154645","21",17901263,18267373,366110
"9739","ENSG00000154646","21",18269116,18485879,216763
"9740","ENSG00000154654","21",20998409,21543329,544920
"9741","ENSG00000154655","18",5954706,6415237,460531
"9742","ENSG00000154678","7",31751179,32299329,548150
"9743","ENSG00000154710","7",66682164,66811464,129300
"9744","ENSG00000154719","21",25585656,25607517,21861
"9745","ENSG00000154721","21",25639258,25717562,78304
"9746","ENSG00000154723","21",25716503,25735673,19170
"9747","ENSG00000154727","21",25734570,25772460,37890
"9748","ENSG00000154734","21",26835755,26845409,9654
"9749","ENSG00000154736","21",26917922,26967088,49166
"9750","ENSG00000154743","3",12484432,12539623,55191
"9751","ENSG00000154760","17",35435096,35448837,13741
"9752","ENSG00000154764","3",13816258,13880121,63863
"9753","ENSG00000154767","3",14145147,14178783,33636
"9754","ENSG00000154781","3",14651746,14672659,20913
"9755","ENSG00000154783","3",14810853,14934565,123712
"9756","ENSG00000154803","17",17212212,17237188,24976
"9757","ENSG00000154813","3",16257061,16264969,7908
"9758","ENSG00000154814","3",16265160,16350299,85139
"9759","ENSG00000154822","3",16802651,17090604,287953
"9760","ENSG00000154832","18",50282343,50288304,5961
"9761","ENSG00000154839","18",50375040,50394168,19128
"9762","ENSG00000154845","18",9546791,9615240,68449
"9763","ENSG00000154856","18",10454635,10489949,35314
"9764","ENSG00000154864","18",10666483,11148762,482279
"9765","ENSG00000154874","17",18537800,18625617,87817
"9766","ENSG00000154889","18",11882622,11909223,26601
"9767","ENSG00000154898","17",20321164,20403557,82393
"9768","ENSG00000154914","17",9644698,9729687,84989
"9769","ENSG00000154917","3",133824235,133895882,71647
"9770","ENSG00000154920","17",50373220,50381483,8263
"9771","ENSG00000154928","3",134597801,135260467,662666
"9772","ENSG00000154930","20",25006230,25058980,52750
"9773","ENSG00000154945","17",50693198,50707914,14716
"9774","ENSG00000154957","17",11977439,11997475,20036
"9775","ENSG00000154975","17",51630313,52160017,529704
"9776","ENSG00000154978","7",55436056,55572988,136932
"9777","ENSG00000154997","7",55793540,55862755,69215
"9778","ENSG00000155008","X",85003877,85093316,89439
"9779","ENSG00000155011","4",106921802,107283806,362004
"9780","ENSG00000155016","4",107931549,107953461,21912
"9781","ENSG00000155026","7",5925550,5970683,45133
"9782","ENSG00000155034","7",5431335,5513809,82474
"9783","ENSG00000155052","2",124025287,124915287,890000
"9784","ENSG00000155066","2",95274449,95291308,16859
"9785","ENSG00000155070","7",6855485,6859830,4345
"9786","ENSG00000155085","6",109492856,109691217,198361
"9787","ENSG00000155087","8",102551589,102561018,9429
"9788","ENSG00000155090","8",102648784,102655725,6941
"9789","ENSG00000155093","7",157539056,158587823,1048767
"9790","ENSG00000155096","8",102826308,102893864,67556
"9791","ENSG00000155097","8",103021063,103073051,51988
"9792","ENSG00000155099","8",90993802,91040872,47070
"9793","ENSG00000155100","8",91070196,91087095,16899
"9794","ENSG00000155111","6",110609978,110815958,205980
"9795","ENSG00000155115","6",110958706,110967890,9184
"9796","ENSG00000155158","9",15163622,15307360,143738
"9797","ENSG00000155189","8",6708642,6761503,52861
"9798","ENSG00000155229","10",97458324,97498794,40470
"9799","ENSG00000155249","14",19930917,19936757,5840
"9800","ENSG00000155252","10",97640686,97676434,35748
"9801","ENSG00000155254","10",97713173,97718150,4977
"9802","ENSG00000155256","10",97737121,97760907,23786
"9803","ENSG00000155265","10",97849843,97871580,21737
"9804","ENSG00000155269","4",8558725,8619761,61036
"9805","ENSG00000155275","4",8436140,8493531,57391
"9806","ENSG00000155287","10",99610522,99620609,10087
"9807","ENSG00000155304","21",14371115,14383484,12369
"9808","ENSG00000155307","21",14485228,14658821,173593
"9809","ENSG00000155313","21",15730025,15880069,150044
"9810","ENSG00000155324","5",126360132,126496494,136362
"9811","ENSG00000155329","5",132996985,133026604,29619
"9812","ENSG00000155330","16",46796603,46831180,34577
"9813","ENSG00000155363","1",112673141,112700746,27605
"9814","ENSG00000155366","1",112701106,112707434,6328
"9815","ENSG00000155367","1",112709994,112715477,5483
"9816","ENSG00000155368","2",119366921,119372560,5639
"9817","ENSG00000155380","1",112911847,112957013,45166
"9818","ENSG00000155393","16",50065970,50107272,41302
"9819","ENSG00000155428","7",72959485,72969466,9981
"9820","ENSG00000155438","2",121726945,121736911,9966
"9821","ENSG00000155463","14",22766522,22773041,6519
"9822","ENSG00000155465","14",22773222,22829820,56598
"9823","ENSG00000155495","X",141903894,141909374,5480
"9824","ENSG00000155506","5",154712843,154817605,104762
"9825","ENSG00000155508","5",154857553,154876793,19240
"9826","ENSG00000155511","5",153489615,153813869,324254
"9827","ENSG00000155530","7",134127299,134264591,137292
"9828","ENSG00000155542","5",56909260,56925532,16272
"9829","ENSG00000155545","5",56919602,56971675,52073
"9830","ENSG00000155561","7",135557917,135648757,90840
"9831","ENSG00000155592","16",25236001,25257845,21844
"9832","ENSG00000155621","9",71911510,71986054,74544
"9833","ENSG00000155622","X",52369021,52375680,6659
"9834","ENSG00000155629","10",96593315,96720514,127199
"9835","ENSG00000155636","2",178112424,178139011,26587
"9836","ENSG00000155657","2",178525989,178830802,304813
"9837","ENSG00000155659","X",66021738,66040125,18387
"9838","ENSG00000155660","7",149003062,149028662,25600
"9839","ENSG00000155666","16",27203495,27221768,18273
"9840","ENSG00000155714","16",21983865,22001110,17245
"9841","ENSG00000155719","16",21663971,21761935,97964
"9842","ENSG00000155729","2",200488958,200519784,30826
"9843","ENSG00000155744","2",200973718,201071671,97953
"9844","ENSG00000155749","2",201288271,201357398,69127
"9845","ENSG00000155754","2",201487421,201619178,131757
"9846","ENSG00000155755","2",201620184,201643570,23386
"9847","ENSG00000155760","2",202034587,202038445,3858
"9848","ENSG00000155761","1",117953861,118185223,231362
"9849","ENSG00000155792","8",119873717,120050918,177201
"9850","ENSG00000155816","1",240014348,240475187,460839
"9851","ENSG00000155827","9",101533853,101563344,29491
"9852","ENSG00000155833","9",102995311,103018488,23177
"9853","ENSG00000155846","5",149730298,149855022,124724
"9854","ENSG00000155849","7",36854361,37449249,594888
"9855","ENSG00000155850","5",149960737,149993455,32718
"9856","ENSG00000155858","5",157743712,157760709,16997
"9857","ENSG00000155868","5",157137424,157159019,21595
"9858","ENSG00000155875","9",18858906,19049358,190452
"9859","ENSG00000155876","9",19049395,19050983,1588
"9860","ENSG00000155886","9",19507452,19786928,279476
"9861","ENSG00000155890","3",140678064,140701150,23086
"9862","ENSG00000155893","3",141228726,141367753,139027
"9863","ENSG00000155897","8",130780301,131040909,260608
"9864","ENSG00000155903","3",141487047,141615342,128295
"9865","ENSG00000155906","6",151404762,151452158,47396
"9866","ENSG00000155918","6",150018334,150025532,7198
"9867","ENSG00000155926","8",133036728,133102912,66184
"9868","ENSG00000155957","12",66135846,66170072,34226
"9869","ENSG00000155959","X",155197007,155239817,42810
"9870","ENSG00000155961","X",155258235,155264491,6256
"9871","ENSG00000155962","X",155276211,155334657,58446
"9872","ENSG00000155966","X",148500619,149000663,500044
"9873","ENSG00000155970","8",17027238,17122642,95404
"9874","ENSG00000155974","12",66347431,67069162,721731
"9875","ENSG00000155975","8",17246931,17302427,55496
"9876","ENSG00000155980","12",57550044,57586633,36589
"9877","ENSG00000156006","8",18391282,18401218,9936
"9878","ENSG00000156009","X",149881141,149885835,4694
"9879","ENSG00000156011","8",18527303,19084730,557427
"9880","ENSG00000156017","9",74980790,75028423,47633
"9881","ENSG00000156026","10",72692131,72887694,195563
"9882","ENSG00000156030","14",73715122,73790285,75163
"9883","ENSG00000156042","10",73253759,73358859,105100
"9884","ENSG00000156049","9",77423079,77648322,225243
"9885","ENSG00000156050","14",73931501,73950414,18913
"9886","ENSG00000156052","9",77716087,78031458,315371
"9887","ENSG00000156076","12",65050626,65121305,70679
"9888","ENSG00000156096","4",69480165,69526014,45849
"9889","ENSG00000156097","1",109539872,109548406,8534
"9890","ENSG00000156103","8",88032011,88328025,296014
"9891","ENSG00000156110","10",74151185,74709303,558118
"9892","ENSG00000156113","10",76869601,77638369,768768
"9893","ENSG00000156127","14",75522425,75547015,24590
"9894","ENSG00000156136","4",70992538,71030914,38376
"9895","ENSG00000156140","4",72280969,72569221,288252
"9896","ENSG00000156150","1",110059870,110070672,10802
"9897","ENSG00000156162","8",94719703,94793836,74133
"9898","ENSG00000156170","8",94895767,95116455,220688
"9899","ENSG00000156171","1",111117333,111140216,22883
"9900","ENSG00000156172","8",95244913,95269201,24288
"9901","ENSG00000156194","4",75859864,75902571,42707
"9902","ENSG00000156206","15",81007033,81149179,142146
"9903","ENSG00000156218","15",83654088,84039842,385754
"9904","ENSG00000156219","4",76011184,76112802,101618
"9905","ENSG00000156222","15",84884654,84945798,61144
"9906","ENSG00000156232","15",82809628,82836108,26480
"9907","ENSG00000156234","4",77511753,77611834,100081
"9908","ENSG00000156239","21",28872191,28885371,13180
"9909","ENSG00000156253","21",29004384,29019360,14976
"9910","ENSG00000156256","21",29024629,29054488,29859
"9911","ENSG00000156261","21",29055805,29073797,17992
"9912","ENSG00000156265","21",29077471,29175889,98418
"9913","ENSG00000156269","4",79225694,79326050,100356
"9914","ENSG00000156273","21",29194071,29630751,436680
"9915","ENSG00000156282","21",30165564,30166756,1192
"9916","ENSG00000156284","21",30214006,30216073,2067
"9917","ENSG00000156298","X",38561370,38688920,127550
"9918","ENSG00000156299","21",31118416,31559977,441561
"9919","ENSG00000156304","21",31671033,31732075,61042
"9920","ENSG00000156313","X",38269170,38327544,58374
"9921","ENSG00000156345","9",87966441,87974753,8312
"9922","ENSG00000156374","10",103302796,103351144,48348
"9923","ENSG00000156381","14",102501767,102509799,8032
"9924","ENSG00000156384","10",104122058,104126385,4327
"9925","ENSG00000156395","10",104641290,105265242,623952
"9926","ENSG00000156398","10",102714538,102743492,28954
"9927","ENSG00000156411","14",103912288,103928269,15981
"9928","ENSG00000156413","19",5830610,5839731,9121
"9929","ENSG00000156414","14",103928456,104052667,124211
"9930","ENSG00000156427","5",171419647,171457626,37979
"9931","ENSG00000156453","5",141853111,141879246,26135
"9932","ENSG00000156463","5",145936578,146081791,145213
"9933","ENSG00000156466","8",96142333,96160806,18473
"9934","ENSG00000156467","8",96225920,96235634,9714
"9935","ENSG00000156469","8",96239398,96261610,22212
"9936","ENSG00000156471","8",96261715,96336995,75280
"9937","ENSG00000156475","5",146581146,147084784,503638
"9938","ENSG00000156482","8",98024851,98046469,21618
"9939","ENSG00000156486","8",98427022,98432848,5826
"9940","ENSG00000156500","X",134796395,134854835,58440
"9941","ENSG00000156502","10",69180234,69209099,28865
"9942","ENSG00000156504","X",134769566,134797232,27666
"9943","ENSG00000156508","6",73515750,73523797,8047
"9944","ENSG00000156509","8",100133351,100145817,12466
"9945","ENSG00000156510","10",69220332,69267552,47220
"9946","ENSG00000156515","10",69269984,69401884,131900
"9947","ENSG00000156521","10",70137981,70146700,8719
"9948","ENSG00000156531","X",134373253,134428791,55538
"9949","ENSG00000156535","6",73695785,73828316,132531
"9950","ENSG00000156564","6",40391586,40587465,195879
"9951","ENSG00000156574","10",70432315,70447951,15636
"9952","ENSG00000156575","11",57376769,57381150,4381
"9953","ENSG00000156587","11",57551656,57568284,16628
"9954","ENSG00000156599","11",57667747,57701182,33435
"9955","ENSG00000156603","11",57703714,57712323,8609
"9956","ENSG00000156639","6",37819727,38154624,334897
"9957","ENSG00000156642","15",73560014,73634134,74120
"9958","ENSG00000156650","10",74824927,75032624,207697
"9959","ENSG00000156671","10",75099586,75182123,82537
"9960","ENSG00000156675","8",37858618,37899467,40849
"9961","ENSG00000156687","8",35235475,35796550,561075
"9962","ENSG00000156689","11",58834065,58904215,70150
"9963","ENSG00000156697","X",129906121,129929761,23640
"9964","ENSG00000156709","X",130129362,130165887,36525
"9965","ENSG00000156711","6",36127809,36144524,16715
"9966","ENSG00000156735","8",38176533,38213301,36768
"9967","ENSG00000156738","11",60455752,60470760,15008
"9968","ENSG00000156755","9",64765054,64765535,481
"9969","ENSG00000156787","8",123041968,123152153,110185
"9970","ENSG00000156795","8",123416725,123470028,53303
"9971","ENSG00000156802","8",123319850,123416350,96500
"9972","ENSG00000156804","8",123497889,123541206,43317
"9973","ENSG00000156831","8",125091679,125367120,275441
"9974","ENSG00000156853","16",30602558,30624012,21454
"9975","ENSG00000156858","16",30650717,30656440,5723
"9976","ENSG00000156860","16",30658431,30670814,12383
"9977","ENSG00000156869","1",99708632,99766631,57999
"9978","ENSG00000156873","16",30748293,30761176,12883
"9979","ENSG00000156875","1",100038095,100083377,45282
"9980","ENSG00000156876","1",100083563,100132955,49392
"9981","ENSG00000156885","16",31427731,31428360,629
"9982","ENSG00000156886","16",31393312,31426505,33193
"9983","ENSG00000156920","X",136300963,136416888,115925
"9984","ENSG00000156925","X",137566127,137577691,11564
"9985","ENSG00000156928","7",23298739,23311729,12990
"9986","ENSG00000156931","3",184812143,185052614,240471
"9987","ENSG00000156958","15",49155656,49367869,212213
"9988","ENSG00000156959","3",9498361,9553822,55461
"9989","ENSG00000156966","2",231395710,231401164,5454
"9990","ENSG00000156968","16",15395754,15413271,17517
"9991","ENSG00000156970","15",40161023,40221136,60113
"9992","ENSG00000156973","2",231732433,231786272,53839
"9993","ENSG00000156976","3",186783205,186789897,6692
"9994","ENSG00000156983","3",9731729,9748018,16289
"9995","ENSG00000156990","3",9837849,9844602,6753
"9996","ENSG00000157005","3",187668912,187670394,1482
"9997","ENSG00000157014","3",10248023,10281218,33195
"9998","ENSG00000157017","3",10285675,10292947,7272
"9999","ENSG00000157020","3",10293131,10321112,27981
"10000","ENSG00000157021","15",41163162,41164374,1212
"10001","ENSG00000157036","3",38496127,38542161,46034
"10002","ENSG00000157045","16",15037854,15056079,18225
"10003","ENSG00000157060","1",182899865,182953525,53660
"10004","ENSG00000157064","1",183248237,183418380,170143
"10005","ENSG00000157077","1",52142094,52346686,204592
"10006","ENSG00000157087","3",10324023,10708007,383984
"10007","ENSG00000157093","3",42397083,42410610,13527
"10008","ENSG00000157103","3",10992186,11039247,47061
"10009","ENSG00000157106","16",18804853,18926454,121601
"10010","ENSG00000157107","5",72956041,73090522,134481
"10011","ENSG00000157110","8",30384511,30572256,187745
"10012","ENSG00000157111","5",73120569,73131809,11240
"10013","ENSG00000157119","3",42685519,42692544,7025
"10014","ENSG00000157131","1",56854806,56918221,63415
"10015","ENSG00000157150","3",12153068,12158912,5844
"10016","ENSG00000157152","3",12004388,12192032,187644
"10017","ENSG00000157168","8",31639222,32855666,1216444
"10018","ENSG00000157181","1",186375838,186421378,45540
"10019","ENSG00000157184","1",53196792,53214197,17405
"10020","ENSG00000157191","1",16440721,16460078,19357
"10021","ENSG00000157193","1",53242356,53328469,86113
"10022","ENSG00000157211","1",54132968,54153770,20802
"10023","ENSG00000157212","7",154943687,155003084,59397
"10024","ENSG00000157214","7",90167590,90238137,70547
"10025","ENSG00000157216","1",54225432,54413479,188047
"10026","ENSG00000157219","7",155070324,155087392,17068
"10027","ENSG00000157224","7",90383721,90513402,129681
"10028","ENSG00000157227","14",22836560,22849027,12467
"10029","ENSG00000157240","7",91264364,91271326,6962
"10030","ENSG00000157259","7",92447482,92460075,12593
"10031","ENSG00000157303","9",93058688,93085133,26445
"10032","ENSG00000157306","14",23511760,23560778,49018
"10033","ENSG00000157315","16",69343250,69351786,8536
"10034","ENSG00000157322","16",69950705,69964452,13747
"10035","ENSG00000157326","14",23953734,23969279,15545
"10036","ENSG00000157330","1",12746200,12763699,17499
"10037","ENSG00000157335","16",70173322,70187361,14039
"10038","ENSG00000157343","6",35737032,35749079,12047
"10039","ENSG00000157349","16",70289663,70335283,45620
"10040","ENSG00000157350","16",70375977,70439237,63260
"10041","ENSG00000157353","16",70454595,70480274,25679
"10042","ENSG00000157368","16",70579895,70660682,80787
"10043","ENSG00000157379","14",24290598,24299780,9182
"10044","ENSG00000157388","3",53328963,53813733,484770
"10045","ENSG00000157399","X",2934632,2968310,33678
"10046","ENSG00000157404","4",54657918,54740715,82797
"10047","ENSG00000157423","16",70802084,71230722,428638
"10048","ENSG00000157426","4",56338287,56387508,49221
"10049","ENSG00000157429","16",71464555,71565089,100534
"10050","ENSG00000157445","3",54122547,55074557,952010
"10051","ENSG00000157450","15",58865175,59097419,232244
"10052","ENSG00000157456","15",59105126,59125045,19919
"10053","ENSG00000157470","15",59372693,59523555,150862
"10054","ENSG00000157483","15",59132434,59372900,240466
"10055","ENSG00000157500","3",57227726,57278105,50379
"10056","ENSG00000157502","X",106168305,106208956,40651
"10057","ENSG00000157510","5",149271859,149343637,71778
"10058","ENSG00000157514","X",107713221,107777342,64121
"10059","ENSG00000157538","21",37223420,37267919,44499
"10060","ENSG00000157540","21",37365573,37526358,160785
"10061","ENSG00000157542","21",37607373,38121345,513972
"10062","ENSG00000157551","21",38155549,38307357,151808
"10063","ENSG00000157554","21",38380027,38661780,281753
"10064","ENSG00000157557","21",38805183,38824955,19772
"10065","ENSG00000157570","11",44726465,44932421,205956
"10066","ENSG00000157578","21",39405844,39445805,39961
"10067","ENSG00000157593","6",44254096,44257890,3794
"10068","ENSG00000157600","X",110002631,110182734,180103
"10069","ENSG00000157601","21",41420304,41459214,38910
"10070","ENSG00000157613","11",46277661,46321422,43761
"10071","ENSG00000157617","21",41885112,41954018,68906
"10072","ENSG00000157625","X",30827442,30975084,147642
"10073","ENSG00000157637","17",81244811,81295547,50736
"10074","ENSG00000157653","9",113410054,113429684,19630
"10075","ENSG00000157654","9",109780309,110172512,392203
"10076","ENSG00000157657","9",113876282,114056591,180309
"10077","ENSG00000157680","7",137381037,137847092,466055
"10078","ENSG00000157693","9",114611206,114646422,35216
"10079","ENSG00000157703","7",138594285,138701352,107067
"10080","ENSG00000157734","15",64151715,64157481,5766
"10081","ENSG00000157741","7",139230356,139308236,77880
"10082","ENSG00000157764","7",140719327,140924928,205601
"10083","ENSG00000157765","4",25648011,25678748,30737
"10084","ENSG00000157766","15",88803442,88875354,71912
"10085","ENSG00000157778","7",1567330,1571005,3675
"10086","ENSG00000157782","12",120640552,120667324,26772
"10087","ENSG00000157796","4",39182504,39285810,103306
"10088","ENSG00000157800","7",140293693,140404433,110740
"10089","ENSG00000157823","15",89830599,89894638,64039
"10090","ENSG00000157827","2",152335174,152649826,314652
"10091","ENSG00000157833","2",26173088,26189663,16575
"10092","ENSG00000157837","12",120762510,120904358,141848
"10093","ENSG00000157851","2",26847747,26950351,102604
"10094","ENSG00000157856","2",26401920,26456711,54791
"10095","ENSG00000157869","4",13361354,13484365,123011
"10096","ENSG00000157870","1",2586491,2591469,4978
"10097","ENSG00000157873","1",2555639,2565382,9743
"10098","ENSG00000157881","1",2508531,2526628,18097
"10099","ENSG00000157884","2",26581205,26641366,60161
"10100","ENSG00000157890","15",65895079,66253747,358668
"10101","ENSG00000157895","12",121000486,121016502,16016
"10102","ENSG00000157911","1",2403964,2413797,9833
"10103","ENSG00000157916","1",2391775,2405442,13667
"10104","ENSG00000157927","7",4797055,4883719,86664
"10105","ENSG00000157933","1",2228319,2310213,81894
"10106","ENSG00000157954","7",5190196,5233840,43644
"10107","ENSG00000157965","X",52624998,52632895,7897
"10108","ENSG00000157978","1",25543580,25568886,25306
"10109","ENSG00000157985","2",235494043,236131800,637757
"10110","ENSG00000157992","2",27442366,27446481,4115
"10111","ENSG00000157999","7",6031376,6036386,5010
"10112","ENSG00000158006","1",25959767,25998117,38350
"10113","ENSG00000158008","1",26019884,26036464,16580
"10114","ENSG00000158014","1",26037252,26046133,8881
"10115","ENSG00000158019","2",27889941,28338901,448960
"10116","ENSG00000158022","1",26051304,26068436,17132
"10117","ENSG00000158023","12",121918592,122003927,85335
"10118","ENSG00000158042","11",6680782,6683401,2619
"10119","ENSG00000158050","2",96143169,96145440,2271
"10120","ENSG00000158055","1",24319322,24364482,45160
"10121","ENSG00000158062","1",26281328,26318363,37035
"10122","ENSG00000158077","11",7020446,7071308,50862
"10123","ENSG00000158079","9",94030794,94109856,79062
"10124","ENSG00000158089","2",30910467,31155202,244735
"10125","ENSG00000158092","3",136862208,136951606,89398
"10126","ENSG00000158104","12",121839527,121863596,24069
"10127","ENSG00000158106","8",143368876,143384221,15345
"10128","ENSG00000158109","1",3625015,3630127,5112
"10129","ENSG00000158113","12",122167738,122203471,35733
"10130","ENSG00000158122","9",96639577,96655317,15740
"10131","ENSG00000158125","2",31334321,31414742,80421
"10132","ENSG00000158156","1",27959462,27968096,8634
"10133","ENSG00000158158","2",96760902,96811874,50972
"10134","ENSG00000158161","1",27970344,28088637,118293
"10135","ENSG00000158163","3",138061990,138115818,53828
"10136","ENSG00000158164","X",102513682,102516739,3057
"10137","ENSG00000158169","9",95099054,95426796,327742
"10138","ENSG00000158186","3",138347648,138405534,57886
"10139","ENSG00000158195","1",27404230,27490167,85937
"10140","ENSG00000158201","18",21650901,21704780,53879
"10141","ENSG00000158220","3",138434586,138481686,47100
"10142","ENSG00000158234","3",138608606,138633376,24770
"10143","ENSG00000158246","1",27005020,27012850,7830
"10144","ENSG00000158258","3",139935185,140577397,642212
"10145","ENSG00000158270","18",316737,500722,183985
"10146","ENSG00000158286","1",6205475,6221299,15824
"10147","ENSG00000158290","X",120524609,120575794,51185
"10148","ENSG00000158292","1",6247353,6261098,13745
"10149","ENSG00000158296","20",46557823,46684467,126644
"10150","ENSG00000158301","X",102712176,102717733,5557
"10151","ENSG00000158315","1",38885807,38941830,56023
"10152","ENSG00000158321","7",69598296,70793495,1195199
"10153","ENSG00000158352","X",50591647,50814302,222655
"10154","ENSG00000158373","6",26158146,26171349,13203
"10155","ENSG00000158402","5",138285265,138338355,53090
"10156","ENSG00000158406","6",26277609,26285638,8029
"10157","ENSG00000158411","2",99161427,99181058,19631
"10158","ENSG00000158417","2",99337371,99401326,63955
"10159","ENSG00000158423","X",53422690,53431120,8430
"10160","ENSG00000158427","X",103918896,103966712,47816
"10161","ENSG00000158428","2",218356857,218368099,11242
"10162","ENSG00000158435","2",101252886,101270316,17430
"10163","ENSG00000158445","20",49293394,49484297,190903
"10164","ENSG00000158457","7",129144707,129169699,24992
"10165","ENSG00000158458","5",139846779,140043299,196520
"10166","ENSG00000158467","7",129225023,129430211,205188
"10167","ENSG00000158470","20",49632945,49713878,80933
"10168","ENSG00000158473","1",158179947,158184896,4949
"10169","ENSG00000158477","1",158254424,158258269,3845
"10170","ENSG00000158480","20",49903391,49915529,12138
"10171","ENSG00000158481","1",158289923,158294774,4851
"10172","ENSG00000158482","16",21376648,21386064,9416
"10173","ENSG00000158483","11",71787510,71801237,13727
"10174","ENSG00000158485","1",158327951,158331531,3580
"10175","ENSG00000158486","16",20933111,21159441,226330
"10176","ENSG00000158488","1",158353696,158357553,3857
"10177","ENSG00000158497","5",143812161,143820719,8558
"10178","ENSG00000158516","7",130266863,130289798,22935
"10179","ENSG00000158517","7",74773962,74789375,15413
"10180","ENSG00000158525","7",130344816,130368730,23914
"10181","ENSG00000158526","X",54440404,54448032,7628
"10182","ENSG00000158528","7",94907202,95296415,389213
"10183","ENSG00000158545","16",88570381,88631966,61585
"10184","ENSG00000158552","2",219195237,219209651,14414
"10185","ENSG00000158553","6",27285903,27312170,26267
"10186","ENSG00000158555","11",75434640,75525941,91301
"10187","ENSG00000158560","7",95772506,96110322,337816
"10188","ENSG00000158571","X",54932961,54998534,65573
"10189","ENSG00000158578","X",55009055,55030977,21922
"10190","ENSG00000158604","7",44577894,44582287,4393
"10191","ENSG00000158615","1",204403381,204411817,8436
"10192","ENSG00000158623","7",130506238,130668748,162510
"10193","ENSG00000158636","11",76444923,76553025,108102
"10194","ENSG00000158639","X",55220355,55224108,3753
"10195","ENSG00000158669","8",41577187,41625001,47814
"10196","ENSG00000158683","7",47740202,47948491,208289
"10197","ENSG00000158691","6",28378955,28399734,20779
"10198","ENSG00000158710","1",159918107,159925732,7625
"10199","ENSG00000158711","1",205597556,205631962,34406
"10200","ENSG00000158714","1",159826811,159837492,10681
"10201","ENSG00000158715","1",205657851,205680509,22658
"10202","ENSG00000158716","1",159780932,159782543,1611
"10203","ENSG00000158717","16",88696495,88706421,9926
"10204","ENSG00000158731","1",159598298,159599227,929
"10205","ENSG00000158747","1",19596979,19658456,61477
"10206","ENSG00000158748","1",19664875,19680966,16091
"10207","ENSG00000158764","1",160945025,160954809,9784
"10208","ENSG00000158769","1",160995211,161021343,26132
"10209","ENSG00000158773","1",161039251,161045977,6726
"10210","ENSG00000158786","1",20139326,20150386,11060
"10211","ENSG00000158792","16",89696357,89701705,5348
"10212","ENSG00000158793","1",161118086,161125445,7359
"10213","ENSG00000158796","1",161120974,161132688,11714
"10214","ENSG00000158805","16",89720400,89740925,20525
"10215","ENSG00000158806","8",22024125,22036897,12772
"10216","ENSG00000158813","X",69616067,70039472,423405
"10217","ENSG00000158815","8",22042398,22048809,6411
"10218","ENSG00000158816","1",20290919,20354894,63975
"10219","ENSG00000158825","1",20589086,20618903,29817
"10220","ENSG00000158828","1",20633458,20651511,18053
"10221","ENSG00000158850","1",161171310,161177968,6658
"10222","ENSG00000158856","8",22048995,22082527,33532
"10223","ENSG00000158859","1",161184302,161199054,14752
"10224","ENSG00000158863","8",22089150,22104911,15761
"10225","ENSG00000158864","1",161197104,161214395,17291
"10226","ENSG00000158865","16",24845841,24911628,65787
"10227","ENSG00000158869","1",161215234,161220699,5465
"10228","ENSG00000158874","1",161222292,161223631,1339
"10229","ENSG00000158882","1",161225939,161230746,4807
"10230","ENSG00000158887","1",161304735,161309968,5233
"10231","ENSG00000158901","20",45551153,45579326,28173
"10232","ENSG00000158941","8",22604632,22621514,16882
"10233","ENSG00000158955","17",46833201,46886730,53529
"10234","ENSG00000158966","1",64470129,64693058,222929
"10235","ENSG00000158985","5",131245493,131398447,152954
"10236","ENSG00000158987","5",131423921,131635236,211315
"10237","ENSG00000159023","1",28887091,29120046,232955
"10238","ENSG00000159055","21",32268228,32279049,10821
"10239","ENSG00000159063","11",78100936,78139653,38717
"10240","ENSG00000159069","9",136940435,136944738,4303
"10241","ENSG00000159079","21",32592079,32612603,20524
"10242","ENSG00000159082","21",32628759,32728048,99289
"10243","ENSG00000159086","21",32733899,32771792,37893
"10244","ENSG00000159110","21",33229901,33265675,35774
"10245","ENSG00000159111","17",47823272,47831541,8269
"10246","ENSG00000159128","21",33402896,33479348,76452
"10247","ENSG00000159131","21",33503931,33543491,39560
"10248","ENSG00000159140","21",33543038,33577514,34476
"10249","ENSG00000159147","21",33559542,33588706,29164
"10250","ENSG00000159164","1",149903318,149917844,14526
"10251","ENSG00000159166","1",201380838,201399915,19077
"10252","ENSG00000159167","8",23841929,23854806,12877
"10253","ENSG00000159173","1",201403768,201429866,26098
"10254","ENSG00000159176","1",201483530,201509456,25926
"10255","ENSG00000159182","17",48721719,48722518,799
"10256","ENSG00000159184","17",48724763,48729178,4415
"10257","ENSG00000159186","2",206236236,206236871,635
"10258","ENSG00000159189","1",22643633,22648110,4477
"10259","ENSG00000159197","21",34364024,34371389,7365
"10260","ENSG00000159199","17",48892765,48895871,3106
"10261","ENSG00000159200","21",34513142,34615113,101971
"10262","ENSG00000159202","17",48908407,48929056,20649
"10263","ENSG00000159208","1",150282543,150287093,4550
"10264","ENSG00000159210","17",48929316,48945117,15801
"10265","ENSG00000159212","21",34669389,34718227,48838
"10266","ENSG00000159214","1",43991359,43996528,5169
"10267","ENSG00000159216","21",34787801,36004667,1216866
"10268","ENSG00000159217","17",48997385,49056145,58760
"10269","ENSG00000159224","17",48958554,48968596,10042
"10270","ENSG00000159228","21",36069941,36073166,3225
"10271","ENSG00000159231","21",36135079,36146562,11483
"10272","ENSG00000159239","2",74393836,74421662,27826
"10273","ENSG00000159247","9",138150075,138177433,27358
"10274","ENSG00000159248","15",34751032,34754998,3966
"10275","ENSG00000159251","15",34788095,34795726,7631
"10276","ENSG00000159256","21",36320189,36386148,65959
"10277","ENSG00000159259","21",36385392,36419015,33623
"10278","ENSG00000159261","21",36460621,36576569,115948
"10279","ENSG00000159263","21",36699133,36749917,50784
"10280","ENSG00000159267","21",36750888,36990236,239348
"10281","ENSG00000159289","15",74069857,74082550,12693
"10282","ENSG00000159307","22",43197280,43343372,146092
"10283","ENSG00000159314","17",45393902,45434421,40519
"10284","ENSG00000159322","15",72751369,72785846,34477
"10285","ENSG00000159335","12",6765516,6770952,5436
"10286","ENSG00000159337","15",42067009,42094554,27545
"10287","ENSG00000159339","1",17308195,17364004,55809
"10288","ENSG00000159346","1",202940826,202958572,17746
"10289","ENSG00000159348","1",202961873,202967275,5402
"10290","ENSG00000159352","1",151254703,151267479,12776
"10291","ENSG00000159363","1",16985958,17011928,25970
"10292","ENSG00000159374","2",74557883,74648338,90455
"10293","ENSG00000159377","1",151399560,151401937,2377
"10294","ENSG00000159387","16",55323760,55330760,7000
"10295","ENSG00000159388","1",203305491,203309602,4111
"10296","ENSG00000159398","16",55846154,55956031,109877
"10297","ENSG00000159399","2",74833981,74893359,59378
"10298","ENSG00000159403","12",7080214,7092540,12326
"10299","ENSG00000159409","1",151702404,151716814,14410
"10300","ENSG00000159423","1",18871430,18902724,31294
"10301","ENSG00000159433","15",42575606,42720998,145392
"10302","ENSG00000159445","1",151870866,151909637,38771
"10303","ENSG00000159450","1",152106317,152115454,9137
"10304","ENSG00000159455","1",152686123,152687401,1278
"10305","ENSG00000159459","15",42942897,43106113,163216
"10306","ENSG00000159461","16",56361452,56425545,64093
"10307","ENSG00000159479","1",43383917,43389808,5891
"10308","ENSG00000159495","15",43276280,43302255,25975
"10309","ENSG00000159496","22",23688136,23699176,11040
"10310","ENSG00000159516","1",153149582,153150890,1308
"10311","ENSG00000159527","1",153297862,153310718,12856
"10312","ENSG00000159556","15",76336773,76342475,5702
"10313","ENSG00000159579","16",57186137,57240469,54332
"10314","ENSG00000159588","1",45620044,45624057,4013
"10315","ENSG00000159592","1",45627304,45688113,60809
"10316","ENSG00000159593","16",66802875,66873256,70381
"10317","ENSG00000159596","1",45688181,45694436,6255
"10318","ENSG00000159618","16",57542643,57591681,49038
"10319","ENSG00000159625","16",57694793,57731805,37012
"10320","ENSG00000159640","17",63477061,63498380,21319
"10321","ENSG00000159648","16",57976435,57988116,11681
"10322","ENSG00000159650","3",126481166,126517773,36607
"10323","ENSG00000159658","1",46675159,46719114,43955
"10324","ENSG00000159674","4",1166932,1208962,42030
"10325","ENSG00000159685","3",126704220,126960406,256186
"10326","ENSG00000159692","4",1211448,1249953,38505
"10327","ENSG00000159708","16",67326798,67385204,58406
"10328","ENSG00000159712","9",97156570,97221235,64665
"10329","ENSG00000159713","16",67389809,67393518,3709
"10330","ENSG00000159714","16",67394152,67416833,22681
"10331","ENSG00000159720","16",67438014,67481181,43167
"10332","ENSG00000159723","16",67482571,67483813,1242
"10333","ENSG00000159733","4",2269582,2418663,149081
"10334","ENSG00000159753","16",67644988,67657569,12581
"10335","ENSG00000159761","16",67666814,67668757,1943
"10336","ENSG00000159763","7",143132077,143139739,7662
"10337","ENSG00000159784","7",143353400,143362770,9370
"10338","ENSG00000159788","4",3293028,3439913,146885
"10339","ENSG00000159792","16",67893254,67929676,36422
"10340","ENSG00000159840","7",143381295,143391111,9816
"10341","ENSG00000159842","17",1003518,1229738,226220
"10342","ENSG00000159860","7",143800732,143817973,17241
"10343","ENSG00000159871","19",43785874,43827206,41332
"10344","ENSG00000159873","22",28772674,28789301,16627
"10345","ENSG00000159882","19",44002957,44013924,10967
"10346","ENSG00000159884","9",35658290,35661511,3221
"10347","ENSG00000159885","19",44025342,44033110,7768
"10348","ENSG00000159899","9",35792154,35809732,17578
"10349","ENSG00000159904","7",5121239,5144546,23307
"10350","ENSG00000159905","19",43951223,43967709,16486
"10351","ENSG00000159915","19",44259880,44275317,15437
"10352","ENSG00000159917","19",44228729,44305046,76317
"10353","ENSG00000159921","9",36214441,36277056,62615
"10354","ENSG00000159958","22",41922023,41926818,4795
"10355","ENSG00000159961","17",3411370,3424070,12700
"10356","ENSG00000160007","19",46918676,47005077,86401
"10357","ENSG00000160013","19",46620468,46625089,4621
"10358","ENSG00000160014","19",46601074,46610782,9708
"10359","ENSG00000160049","1",10456522,10472529,16007
"10360","ENSG00000160050","1",32200386,32205387,5001
"10361","ENSG00000160051","1",32205661,32208687,3026
"10362","ENSG00000160055","1",32214472,32222359,7887
"10363","ENSG00000160058","1",32365103,32394731,29628
"10364","ENSG00000160062","1",32539427,32605941,66514
"10365","ENSG00000160072","1",1471769,1497848,26079
"10366","ENSG00000160075","1",1541673,1574863,33190
"10367","ENSG00000160087","1",1253909,1273885,19976
"10368","ENSG00000160094","1",33256492,33300719,44227
"10369","ENSG00000160097","1",32862268,32872482,10214
"10370","ENSG00000160111","19",16892947,17026815,133868
"10371","ENSG00000160113","19",17231883,17245940,14057
"10372","ENSG00000160117","19",17281645,17287646,6001
"10373","ENSG00000160124","3",122359591,122383231,23640
"10374","ENSG00000160131","X",151396515,151409364,12849
"10375","ENSG00000160145","3",124080023,124726325,646302
"10376","ENSG00000160161","19",19538248,19546659,8411
"10377","ENSG00000160172","11",67791648,67805336,13688
"10378","ENSG00000160179","21",42199689,42297244,97555
"10379","ENSG00000160180","21",42311667,42315651,3984
"10380","ENSG00000160181","21",42346357,42350997,4640
"10381","ENSG00000160182","21",42362282,42366535,4253
"10382","ENSG00000160183","21",42371837,42396091,24254
"10383","ENSG00000160185","21",42403447,42447684,44237
"10384","ENSG00000160188","21",42472486,42496246,23760
"10385","ENSG00000160190","21",42496008,42581440,85432
"10386","ENSG00000160191","21",42653621,42775509,121888
"10387","ENSG00000160193","21",42843094,42879568,36474
"10388","ENSG00000160194","21",42879644,42913304,33660
"10389","ENSG00000160199","21",42974510,43033931,59421
"10390","ENSG00000160200","21",43053191,43076943,23752
"10391","ENSG00000160201","21",43092956,43107587,14631
"10392","ENSG00000160202","21",43169008,43172805,3797
"10393","ENSG00000160207","21",43529186,43659488,130302
"10394","ENSG00000160208","21",43659560,43696079,36519
"10395","ENSG00000160209","21",43719094,43762307,43213
"10396","ENSG00000160211","X",154531391,154547572,16181
"10397","ENSG00000160213","21",43772511,43776445,3934
"10398","ENSG00000160214","21",43789513,43805293,15780
"10399","ENSG00000160216","21",43865223,43987592,122369
"10400","ENSG00000160218","21",44012309,44106552,94243
"10401","ENSG00000160219","X",154675249,154751583,76334
"10402","ENSG00000160221","21",44133610,44210114,76504
"10403","ENSG00000160223","21",44217014,44240966,23952
"10404","ENSG00000160224","21",44285838,44298648,12810
"10405","ENSG00000160226","21",44328944,44339402,10458
"10406","ENSG00000160229","19",20776304,20807322,31018
"10407","ENSG00000160233","21",44455510,44462196,6686
"10408","ENSG00000160255","21",44885953,44931989,46036
"10409","ENSG00000160256","21",44940012,44976989,36977
"10410","ENSG00000160271","9",133097720,133149334,51614
"10411","ENSG00000160282","21",46136262,46155579,19317
"10412","ENSG00000160284","21",46161148,46184476,23328
"10413","ENSG00000160285","21",46188141,46228824,40683
"10414","ENSG00000160293","9",133761894,133992604,230710
"10415","ENSG00000160294","21",46235133,46286297,51164
"10416","ENSG00000160298","21",46300181,46323875,23694
"10417","ENSG00000160299","21",46324141,46445769,121628
"10418","ENSG00000160305","21",46458891,46570015,111124
"10419","ENSG00000160307","21",46598604,46605208,6604
"10420","ENSG00000160310","21",46635595,46665124,29529
"10421","ENSG00000160318","19",51367098,51369003,1905
"10422","ENSG00000160321","19",21932958,22010949,77991
"10423","ENSG00000160323","9",133414358,133459402,45044
"10424","ENSG00000160325","9",133459965,133470848,10883
"10425","ENSG00000160326","9",133471094,133479127,8033
"10426","ENSG00000160336","19",53445001,53458261,13260
"10427","ENSG00000160339","9",134880810,134887523,6713
"10428","ENSG00000160345","9",135495181,135501734,6553
"10429","ENSG00000160349","9",135521438,135526532,5094
"10430","ENSG00000160352","19",21082159,21125270,43111
"10431","ENSG00000160360","9",136327476,136359605,32129
"10432","ENSG00000160392","19",40319536,40348527,28991
"10433","ENSG00000160396","19",40379271,40390187,10916
"10434","ENSG00000160401","9",127706988,127716002,9014
"10435","ENSG00000160404","9",127731524,127735313,3789
"10436","ENSG00000160408","9",127885321,127905408,20087
"10437","ENSG00000160410","19",40576853,40591399,14546
"10438","ENSG00000160439","19",55039108,55071291,32183
"10439","ENSG00000160445","9",128729786,128772414,42628
"10440","ENSG00000160446","9",128720870,128724127,3257
"10441","ENSG00000160447","9",128702503,128720916,18413
"10442","ENSG00000160460","19",40466241,40576464,110223
"10443","ENSG00000160469","19",55282072,55312533,30461
"10444","ENSG00000160471","19",55349306,55354719,5413
"10445","ENSG00000160472","19",55376826,55378246,1420
"10446","ENSG00000160505","19",55836578,55881854,45276
"10447","ENSG00000160539","9",131289459,131359022,69563
"10448","ENSG00000160551","17",29390464,29551904,161440
"10449","ENSG00000160563","9",131852928,132079867,226939
"10450","ENSG00000160570","19",42198598,42220140,21542
"10451","ENSG00000160584","11",116843402,117098437,255035
"10452","ENSG00000160588","11",118226690,118252365,25675
"10453","ENSG00000160593","11",118193740,118225094,31354
"10454","ENSG00000160602","17",28725897,28743455,17558
"10455","ENSG00000160606","17",28724348,28727935,3587
"10456","ENSG00000160613","11",117204337,117232525,28188
"10457","ENSG00000160633","19",5623035,5668478,45443
"10458","ENSG00000160654","11",118344344,118355161,10817
"10459","ENSG00000160678","1",153627926,153632039,4113
"10460","ENSG00000160679","1",153633982,153646306,12324
"10461","ENSG00000160683","11",118883766,118897799,14033
"10462","ENSG00000160685","1",155002630,155018522,15892
"10463","ENSG00000160688","1",154983338,154993111,9773
"10464","ENSG00000160691","1",154962298,154974395,12097
"10465","ENSG00000160695","11",119067692,119081978,14286
"10466","ENSG00000160703","11",119166568,119184016,17448
"10467","ENSG00000160710","1",154582057,154628013,45956
"10468","ENSG00000160712","1",154405193,154469450,64257
"10469","ENSG00000160714","1",154548577,154559028,10451
"10470","ENSG00000160716","1",154567781,154580026,12245
"10471","ENSG00000160741","1",153947669,153958615,10946
"10472","ENSG00000160746","3",43354859,43691594,336735
"10473","ENSG00000160752","1",155308748,155320666,11918
"10474","ENSG00000160753","1",155320894,155331114,10220
"10475","ENSG00000160766","1",155213821,155227422,13601
"10476","ENSG00000160767","1",155247205,155255483,8278
"10477","ENSG00000160781","1",156243320,156248117,4797
"10478","ENSG00000160783","1",156212993,156240042,27049
"10479","ENSG00000160785","1",156193932,156212796,18864
"10480","ENSG00000160789","1",156082573,156140089,57516
"10481","ENSG00000160791","3",46370854,46376206,5352
"10482","ENSG00000160796","3",46979683,47009704,30021
"10483","ENSG00000160799","3",46921726,46982010,60284
"10484","ENSG00000160801","3",46877721,46903799,26078
"10485","ENSG00000160803","1",156035299,156053798,18499
"10486","ENSG00000160808","3",46835111,46882172,47061
"10487","ENSG00000160813","7",100435282,100436497,1215
"10488","ENSG00000160818","1",156594487,156601496,7009
"10489","ENSG00000160838","1",156920632,156933094,12462
"10490","ENSG00000160856","1",157674321,157700769,26448
"10491","ENSG00000160862","7",99966720,99976042,9322
"10492","ENSG00000160867","5",177086905,177098144,11239
"10493","ENSG00000160868","7",99756960,99784248,27288
"10494","ENSG00000160870","7",99684957,99735196,50239
"10495","ENSG00000160877","19",13116862,13141147,24285
"10496","ENSG00000160882","8",142872356,142879846,7490
"10497","ENSG00000160883","5",176880869,176899346,18477
"10498","ENSG00000160886","8",142700111,142705127,5016
"10499","ENSG00000160888","19",13150411,13154911,4500
"10500","ENSG00000160908","7",99473877,99504857,30980
"10501","ENSG00000160917","7",99438922,99457373,18451
"10502","ENSG00000160932","8",143017982,143023832,5850
"10503","ENSG00000160948","8",144423601,144428563,4962
"10504","ENSG00000160949","8",144428775,144444440,15665
"10505","ENSG00000160951","19",14472466,14475354,2888
"10506","ENSG00000160953","19",1354711,1378431,23720
"10507","ENSG00000160957","8",144511288,144517845,6557
"10508","ENSG00000160959","8",144517992,144525172,7180
"10509","ENSG00000160961","19",14689801,14733746,43945
"10510","ENSG00000160963","7",101362875,101559024,196149
"10511","ENSG00000160972","8",144477969,144502121,24152
"10512","ENSG00000160973","8",144473412,144476335,2923
"10513","ENSG00000160991","7",102433106,102456825,23719
"10514","ENSG00000160993","7",102456238,102464863,8625
"10515","ENSG00000160994","19",15010726,15023276,12550
"10516","ENSG00000160999","7",102285091,102321711,36620
"10517","ENSG00000161010","5",179835133,179862173,27040
"10518","ENSG00000161011","5",179806398,179838078,31680
"10519","ENSG00000161013","5",179797597,179806952,9355
"10520","ENSG00000161016","8",144789765,144792587,2822
"10521","ENSG00000161021","5",179732822,179777283,44461
"10522","ENSG00000161031","19",15468645,15498956,30311
"10523","ENSG00000161036","7",102464956,102473168,8212
"10524","ENSG00000161040","7",102813230,103074843,261613
"10525","ENSG00000161048","7",103099776,103149560,49784
"10526","ENSG00000161055","5",180590105,180591499,1394
"10527","ENSG00000161057","7",103344254,103369395,25141
"10528","ENSG00000161082","19",3224661,3297076,72415
"10529","ENSG00000161091","19",3538261,3574290,36029
"10530","ENSG00000161103","22",18846811,18861049,14238
"10531","ENSG00000161132","22",20299760,20313216,13456
"10532","ENSG00000161133","22",20350578,20390758,40180
"10533","ENSG00000161149","22",21008193,21014292,6099
"10534","ENSG00000161179","22",21628089,21630064,1975
"10535","ENSG00000161180","22",21632716,21637329,4613
"10536","ENSG00000161202","3",184155377,184173614,18237
"10537","ENSG00000161203","3",184174689,184184091,9402
"10538","ENSG00000161204","3",184186023,184194012,7989
"10539","ENSG00000161217","3",196214222,196287957,73735
"10540","ENSG00000161243","19",38990714,39032785,42071
"10541","ENSG00000161249","19",35497220,35513658,16438
"10542","ENSG00000161265","19",35742464,35745445,2981
"10543","ENSG00000161267","3",197509783,197573323,63540
"10544","ENSG00000161270","19",35825964,35869287,43323
"10545","ENSG00000161277","19",36034985,36054762,19777
"10546","ENSG00000161281","19",36150922,36152449,1527
"10547","ENSG00000161298","19",36604817,36634114,29297
"10548","ENSG00000161328","11",537527,554912,17385
"10549","ENSG00000161381","17",39063313,39154394,91081
"10550","ENSG00000161395","17",39671122,39696797,25675
"10551","ENSG00000161405","17",39757718,39864312,106594
"10552","ENSG00000161509","17",74842023,74861504,19481
"10553","ENSG00000161513","17",74862497,74873031,10534
"10554","ENSG00000161526","17",75667251,75708062,40811
"10555","ENSG00000161533","17",75941507,75979177,37670
"10556","ENSG00000161542","17",76309486,76384521,75035
"10557","ENSG00000161544","17",76527356,76551175,23819
"10558","ENSG00000161547","17",76734115,76737374,3259
"10559","ENSG00000161551","19",51804816,51890950,86134
"10560","ENSG00000161558","19",48332356,48364059,31703
"10561","ENSG00000161594","17",41835685,41848384,12699
"10562","ENSG00000161609","19",49388219,49417990,29771
"10563","ENSG00000161610","17",42184060,42185452,1392
"10564","ENSG00000161618","19",49453225,49471050,17825
"10565","ENSG00000161634","12",54644591,54648493,3902
"10566","ENSG00000161638","12",54395261,54419266,24005
"10567","ENSG00000161640","19",49948985,49961172,12187
"10568","ENSG00000161642","12",54369133,54391298,22165
"10569","ENSG00000161643","19",49969673,49975814,6141
"10570","ENSG00000161647","17",43800799,43833170,32371
"10571","ENSG00000161649","17",43847148,43863639,16491
"10572","ENSG00000161652","19",50152548,50163195,10647
"10573","ENSG00000161653","17",44004546,44009063,4517
"10574","ENSG00000161654","17",44034635,44067619,32984
"10575","ENSG00000161664","17",44170447,44179083,8636
"10576","ENSG00000161671","19",50476400,50490870,14470
"10577","ENSG00000161677","19",50505998,50511353,5355
"10578","ENSG00000161681","19",50661827,50719450,57623
"10579","ENSG00000161682","17",44353215,44363875,10660
"10580","ENSG00000161692","17",44708608,44752264,43656
"10581","ENSG00000161714","17",45108959,45133354,24395
"10582","ENSG00000161791","12",49636499,49708165,71666
"10583","ENSG00000161798","12",49961872,49965682,3810
"10584","ENSG00000161800","12",49976923,50033136,56213
"10585","ENSG00000161813","12",50392383,50480004,87621
"10586","ENSG00000161835","12",52006946,52015889,8943
"10587","ENSG00000161847","19",10316212,10333638,17426
"10588","ENSG00000161850","12",52393931,52406355,12424
"10589","ENSG00000161860","19",12898786,12919276,20490
"10590","ENSG00000161888","19",11131520,11155808,24288
"10591","ENSG00000161896","6",33721662,33746905,25243
"10592","ENSG00000161904","6",33771202,33789130,17928
"10593","ENSG00000161905","17",4630902,4642294,11392
"10594","ENSG00000161911","6",41149342,41154337,4995
"10595","ENSG00000161912","6",41101022,41140835,39813
"10596","ENSG00000161914","19",11483427,11505839,22412
"10597","ENSG00000161920","17",4731428,4733607,2179
"10598","ENSG00000161921","17",4733533,4739928,6395
"10599","ENSG00000161929","17",5208920,5234860,25940
"10600","ENSG00000161939","17",7012635,7017520,4885
"10601","ENSG00000161940","17",7023020,7030290,7270
"10602","ENSG00000161944","17",7101322,7115700,14378
"10603","ENSG00000161955","17",7558292,7561608,3316
"10604","ENSG00000161956","17",7561919,7571969,10050
"10605","ENSG00000161958","17",7438273,7444937,6664
"10606","ENSG00000161960","17",7572706,7579006,6300
"10607","ENSG00000161970","17",8377516,8383213,5697
"10608","ENSG00000161973","17",8729935,8745219,15284
"10609","ENSG00000161980","16",46407,53628,7221
"10610","ENSG00000161981","16",53010,57669,4659
"10611","ENSG00000161992","16",560394,565529,5135
"10612","ENSG00000161996","16",649311,667833,18522
"10613","ENSG00000161999","16",681670,684528,2858
"10614","ENSG00000162004","16",722582,726954,4372
"10615","ENSG00000162006","16",769428,783370,13942
"10616","ENSG00000162009","16",1078781,1080142,1361
"10617","ENSG00000162032","16",1776712,1793700,16988
"10618","ENSG00000162039","16",1833987,1884294,50307
"10619","ENSG00000162040","16",1911463,1918440,6977
"10620","ENSG00000162062","16",2460086,2464963,4877
"10621","ENSG00000162063","16",2429394,2458854,29460
"10622","ENSG00000162065","16",2475051,2509560,34509
"10623","ENSG00000162066","16",2520357,2531422,11065
"10624","ENSG00000162068","16",2471499,2474145,2646
"10625","ENSG00000162069","16",3027682,3036926,9244
"10626","ENSG00000162073","16",2969245,2973489,4244
"10627","ENSG00000162076","16",2883213,2899382,16169
"10628","ENSG00000162078","16",2830169,2839585,9416
"10629","ENSG00000162086","16",3305406,3318852,13446
"10630","ENSG00000162104","16",3953387,4116442,163055
"10631","ENSG00000162105","11",70467856,71252577,784721
"10632","ENSG00000162129","11",72285495,72434680,149185
"10633","ENSG00000162139","11",74988279,75018893,30614
"10634","ENSG00000162144","11",61348745,61362299,13554
"10635","ENSG00000162148","11",61481120,61490931,9811
"10636","ENSG00000162174","11",62337448,62393412,55964
"10637","ENSG00000162188","11",62707676,62709201,1525
"10638","ENSG00000162191","11",62676498,62679117,2619
"10639","ENSG00000162194","11",62662817,62672255,9438
"10640","ENSG00000162222","11",62728069,62740293,12224
"10641","ENSG00000162227","11",62771357,62787342,15985
"10642","ENSG00000162231","11",62792123,62806302,14179
"10643","ENSG00000162236","11",62806897,62832088,25191
"10644","ENSG00000162241","11",65375192,65383701,8509
"10645","ENSG00000162244","3",51993522,51995942,2420
"10646","ENSG00000162267","3",52794768,52809009,14241
"10647","ENSG00000162298","11",65121780,65134533,12753
"10648","ENSG00000162300","11",65084210,65088398,4188
"10649","ENSG00000162302","11",64359148,64372215,13067
"10650","ENSG00000162337","11",68312591,68449275,136684
"10651","ENSG00000162341","11",69048932,69136316,87384
"10652","ENSG00000162344","11",69698238,69704022,5784
"10653","ENSG00000162365","1",47137435,47149735,12300
"10654","ENSG00000162366","1",47183582,47191044,7462
"10655","ENSG00000162367","1",47216290,47232220,15930
"10656","ENSG00000162368","1",47333797,47378839,45042
"10657","ENSG00000162373","1",48727519,48776969,49450
"10658","ENSG00000162374","1",50024029,50203786,179757
"10659","ENSG00000162377","1",52684449,52698347,13898
"10660","ENSG00000162378","1",52726453,52827336,100883
"10661","ENSG00000162383","1",53087179,53142632,55453
"10662","ENSG00000162384","1",53214099,53220634,6535
"10663","ENSG00000162385","1",53226900,53238518,11618
"10664","ENSG00000162390","1",54542257,54639192,96935
"10665","ENSG00000162391","1",54609181,54623556,14375
"10666","ENSG00000162396","1",54756898,54764523,7625
"10667","ENSG00000162398","1",54806063,54842252,36189
"10668","ENSG00000162399","1",54998933,55017172,18239
"10669","ENSG00000162402","1",55066359,55215364,149005
"10670","ENSG00000162407","1",56494761,56645301,150540
"10671","ENSG00000162408","1",6521347,6554513,33166
"10672","ENSG00000162409","1",56645314,56715335,70021
"10673","ENSG00000162413","1",6590724,6614607,23883
"10674","ENSG00000162415","1",45016399,45306209,289810
"10675","ENSG00000162419","1",28668732,28719353,50621
"10676","ENSG00000162426","1",8317826,8344167,26341
"10677","ENSG00000162430","1",25800176,25818221,18045
"10678","ENSG00000162433","1",65147549,65232145,84596
"10679","ENSG00000162434","1",64833229,64966549,133320
"10680","ENSG00000162437","1",64745095,64833232,88137
"10681","ENSG00000162438","1",15438439,15449242,10803
"10682","ENSG00000162441","1",9922113,9943407,21294
"10683","ENSG00000162444","1",9997206,10016021,18815
"10684","ENSG00000162456","1",46545644,46551527,5883
"10685","ENSG00000162458","1",15756607,15786594,29987
"10686","ENSG00000162460","1",15742499,15747982,5483
"10687","ENSG00000162461","1",15736258,15741392,5134
"10688","ENSG00000162482","1",19282573,19288770,6197
"10689","ENSG00000162490","1",11691710,11725857,34147
"10690","ENSG00000162493","1",13583465,13617957,34492
"10691","ENSG00000162494","1",13474973,13514003,39030
"10692","ENSG00000162496","1",12567910,12618210,50300
"10693","ENSG00000162510","1",30711277,30723585,12308
"10694","ENSG00000162511","1",30732469,30757774,25305
"10695","ENSG00000162512","1",30869466,30908758,39292
"10696","ENSG00000162517","1",31629866,31644896,15030
"10697","ENSG00000162520","1",32680360,32703596,23236
"10698","ENSG00000162521","1",32651142,32686211,35069
"10699","ENSG00000162522","1",32741830,32774970,33140
"10700","ENSG00000162526","1",32351521,32364312,12791
"10701","ENSG00000162542","1",19682213,19799945,117732
"10702","ENSG00000162543","1",20186096,20196050,9954
"10703","ENSG00000162545","1",20482391,20486210,3819
"10704","ENSG00000162551","1",21509397,21578410,69013
"10705","ENSG00000162552","1",22117313,22143969,26656
"10706","ENSG00000162571","1",1173884,1197935,24051
"10707","ENSG00000162572","1",1280436,1292029,11593
"10708","ENSG00000162576","1",1352689,1361777,9088
"10709","ENSG00000162585","1",2184461,2212720,28259
"10710","ENSG00000162591","1",3487951,3611508,123557
"10711","ENSG00000162592","1",3746460,3771645,25185
"10712","ENSG00000162594","1",67138907,67259979,121072
"10713","ENSG00000162595","1",68045896,68051631,5735
"10714","ENSG00000162598","1",59987269,60073770,86501
"10715","ENSG00000162599","1",60865259,61462788,597529
"10716","ENSG00000162600","1",58415384,58546802,131418
"10717","ENSG00000162601","1",58643440,58700077,56637
"10718","ENSG00000162604","1",61681046,61725423,44377
"10719","ENSG00000162607","1",62436297,62451804,15507
"10720","ENSG00000162613","1",77944055,77979110,35055
"10721","ENSG00000162614","1",77888513,77943895,55382
"10722","ENSG00000162616","1",77979175,78017964,38789
"10723","ENSG00000162618","1",78889764,79282124,392360
"10724","ENSG00000162620","1",74026015,74198187,172172
"10725","ENSG00000162621","1",74469878,74512614,42736
"10726","ENSG00000162623","1",74733152,74766678,33526
"10727","ENSG00000162624","1",75128434,75161533,33099
"10728","ENSG00000162627","1",98661701,98760500,98799
"10729","ENSG00000162630","1",193179045,193186654,7609
"10730","ENSG00000162631","1",107140007,107483458,343451
"10731","ENSG00000162636","1",108560089,108644900,84811
"10732","ENSG00000162639","1",108648290,108661526,13236
"10733","ENSG00000162641","1",108815898,108963484,147586
"10734","ENSG00000162642","1",85249953,85259672,9719
"10735","ENSG00000162643","1",84999147,85133138,133991
"10736","ENSG00000162645","1",89106132,89150456,44324
"10737","ENSG00000162650","1",109483479,109492804,9325
"10738","ENSG00000162654","1",89181144,89198942,17798
"10739","ENSG00000162664","1",89995110,90035533,40423
"10740","ENSG00000162669","1",91260766,91404856,144090
"10741","ENSG00000162670","1",190097658,190478404,380746
"10742","ENSG00000162676","1",92473043,92486925,13882
"10743","ENSG00000162687","1",196225779,196609225,383446
"10744","ENSG00000162688","1",99850361,99924023,73662
"10745","ENSG00000162692","1",100719742,100739045,19303
"10746","ENSG00000162694","1",100872372,100895179,22807
"10747","ENSG00000162695","1",100896076,100981757,85681
"10748","ENSG00000162699","1",101893105,101894047,942
"10749","ENSG00000162702","1",200404940,200410056,5116
"10750","ENSG00000162704","1",183620846,183635783,14937
"10751","ENSG00000162706","1",159171609,159203313,31704
"10752","ENSG00000162711","1",247416156,247449108,32952
"10753","ENSG00000162714","1",247297412,247331846,34434
"10754","ENSG00000162722","1",247857187,247880138,22951
"10755","ENSG00000162723","1",159951492,159954237,2745
"10756","ENSG00000162728","1",160081538,160090563,9025
"10757","ENSG00000162729","1",160091340,160098943,7603
"10758","ENSG00000162733","1",162631373,162787405,156032
"10759","ENSG00000162734","1",160205337,160215376,10039
"10760","ENSG00000162735","1",160276812,160286348,9536
"10761","ENSG00000162736","1",160343316,160358952,15636
"10762","ENSG00000162738","1",160400564,160428670,28106
"10763","ENSG00000162739","1",160485030,160523262,38232
"10764","ENSG00000162745","1",161983192,162023854,40662
"10765","ENSG00000162746","1",161721563,161728143,6580
"10766","ENSG00000162747","1",161623196,161631963,8767
"10767","ENSG00000162753","1",173500460,173603072,102612
"10768","ENSG00000162755","1",161098361,161100346,1985
"10769","ENSG00000162757","1",209779208,209784559,5351
"10770","ENSG00000162761","1",165201867,165356715,154848
"10771","ENSG00000162763","1",165544007,165563961,19954
"10772","ENSG00000162769","1",212858275,212899363,41088
"10773","ENSG00000162771","1",212624474,212626778,2304
"10774","ENSG00000162772","1",212565334,212620777,55443
"10775","ENSG00000162775","1",110338506,110346681,8175
"10776","ENSG00000162777","1",111185969,111204535,18566
"10777","ENSG00000162779","1",179365720,179554735,189015
"10778","ENSG00000162782","1",179591613,179691272,99659
"10779","ENSG00000162783","1",181088712,181092899,4187
"10780","ENSG00000162804","2",240998618,241095568,96950
"10781","ENSG00000162813","1",220057482,220090462,32980
"10782","ENSG00000162814","1",217631324,217871696,240372
"10783","ENSG00000162817","1",220690363,220699153,8790
"10784","ENSG00000162819","1",222712553,222735196,22643
"10785","ENSG00000162825","1",145289900,145405778,115878
"10786","ENSG00000162836","1",147629652,147670524,40872
"10787","ENSG00000162840","4",68376323,68376505,182
"10788","ENSG00000162843","1",241652278,241802133,149855
"10789","ENSG00000162849","1",245154985,245709432,554447
"10790","ENSG00000162851","1",246540561,246566261,25700
"10791","ENSG00000162852","1",246566444,246668595,102151
"10792","ENSG00000162869","2",48440598,48515391,74793
"10793","ENSG00000162873","1",205336065,205357090,21025
"10794","ENSG00000162877","1",205828025,205850132,22107
"10795","ENSG00000162878","2",42048021,42058517,10496
"10796","ENSG00000162881","2",42762481,42764261,1780
"10797","ENSG00000162882","2",42767089,42792593,25504
"10798","ENSG00000162885","1",235447190,235504452,57262
"10799","ENSG00000162888","1",206491116,206497728,6612
"10800","ENSG00000162889","1",206684944,206734283,49339
"10801","ENSG00000162891","1",206865354,206869223,3869
"10802","ENSG00000162892","1",206897443,206904139,6696
"10803","ENSG00000162894","1",206903317,206923247,19930
"10804","ENSG00000162896","1",206928522,206946466,17944
"10805","ENSG00000162897","1",206957965,206970625,12660
"10806","ENSG00000162909","1",223701593,223776018,74425
"10807","ENSG00000162910","1",228106679,228109312,2633
"10808","ENSG00000162913","1",228203503,228213664,10161
"10809","ENSG00000162923","1",224385143,224437033,51890
"10810","ENSG00000162924","2",60881521,60931610,50089
"10811","ENSG00000162927","2",60940222,61018259,78037
"10812","ENSG00000162928","2",61017225,61051990,34765
"10813","ENSG00000162929","2",61065871,61138034,72163
"10814","ENSG00000162931","1",228407935,228416861,8926
"10815","ENSG00000162944","2",197568224,197676045,107821
"10816","ENSG00000162946","1",231626815,232041272,414457
"10817","ENSG00000162947","2",149745648,149859191,113543
"10818","ENSG00000162949","2",30722771,30820542,97771
"10819","ENSG00000162951","2",80288351,80304752,16401
"10820","ENSG00000162959","2",31865060,32011230,146170
"10821","ENSG00000162961","2",31867809,32039805,171996
"10822","ENSG00000162971","2",199928913,199955736,26823
"10823","ENSG00000162972","2",199955317,200008540,53223
"10824","ENSG00000162975","2",10911934,10914225,2291
"10825","ENSG00000162976","2",11155198,11178870,23672
"10826","ENSG00000162980","2",151788984,151828492,39508
"10827","ENSG00000162981","2",14632700,14650814,18114
"10828","ENSG00000162989","2",154697855,154858354,160499
"10829","ENSG00000162992","2",181673088,181680876,7788
"10830","ENSG00000162994","2",55172547,55232563,60016
"10831","ENSG00000162997","2",55282319,55284522,2203
"10832","ENSG00000162998","2",182833275,182866637,33362
"10833","ENSG00000162999","2",183078559,183100005,21446
"10834","ENSG00000163001","2",55519604,55545879,26275
"10835","ENSG00000163002","2",183117513,183161680,44167
"10836","ENSG00000163006","2",108786757,108885477,98720
"10837","ENSG00000163012","2",186827835,186849208,21373
"10838","ENSG00000163013","2",73254682,73284431,29749
"10839","ENSG00000163016","2",73641083,73697509,56426
"10840","ENSG00000163017","2",73892314,73919865,27551
"10841","ENSG00000163026","2",24029347,24049575,20228
"10842","ENSG00000163029","2",17663812,17800242,136430
"10843","ENSG00000163032","2",17539126,17657018,117892
"10844","ENSG00000163040","2",131527675,131533666,5991
"10845","ENSG00000163041","1",226061851,226072007,10156
"10846","ENSG00000163046","2",132147591,132257969,110378
"10847","ENSG00000163050","1",226897536,226987545,90009
"10848","ENSG00000163053","2",230034982,230068993,34011
"10849","ENSG00000163060","2",94871430,94876823,5393
"10850","ENSG00000163064","2",118842171,118847678,5507
"10851","ENSG00000163069","4",52020706,52038482,17776
"10852","ENSG00000163071","4",52051304,52097299,45995
"10853","ENSG00000163072","2",168786539,168865514,78975
"10854","ENSG00000163075","2",119544432,119662251,117819
"10855","ENSG00000163081","2",222298147,222305217,7070
"10856","ENSG00000163082","2",222424543,222562621,138078
"10857","ENSG00000163083","2",120346136,120351803,5667
"10858","ENSG00000163092","2",166888487,167259753,371266
"10859","ENSG00000163093","2",169479480,169506655,27175
"10860","ENSG00000163098","19",53289601,53291622,2021
"10861","ENSG00000163104","4",94207611,94291292,83681
"10862","ENSG00000163106","4",94298535,94342876,44341
"10863","ENSG00000163110","4",94451857,94668227,216370
"10864","ENSG00000163114","4",95840019,95841474,1455
"10865","ENSG00000163116","4",97184093,98143476,959383
"10866","ENSG00000163121","2",96497646,96508109,10463
"10867","ENSG00000163125","1",150363091,150476566,113475
"10868","ENSG00000163126","2",96824526,96857934,33408
"10869","ENSG00000163131","1",150730188,150765792,35604
"10870","ENSG00000163132","4",4859665,4863936,4271
"10871","ENSG00000163138","4",20696282,20752907,56625
"10872","ENSG00000163141","1",151036321,151047720,11399
"10873","ENSG00000163145","4",15339818,15446166,106348
"10874","ENSG00000163154","1",151156649,151159749,3100
"10875","ENSG00000163155","1",151159748,151165948,6200
"10876","ENSG00000163156","1",151156664,151170297,13633
"10877","ENSG00000163159","1",151169987,151195321,25334
"10878","ENSG00000163161","2",127257290,127294176,36886
"10879","ENSG00000163162","2",101271219,101308701,37482
"10880","ENSG00000163166","2",127436207,127526886,90679
"10881","ENSG00000163170","2",74135400,74147912,12512
"10882","ENSG00000163171","2",37641882,37738468,96586
"10883","ENSG00000163191","1",152032506,152047907,15401
"10884","ENSG00000163206","1",152878322,152885047,6725
"10885","ENSG00000163207","1",152908546,152911886,3340
"10886","ENSG00000163209","1",153001747,153003856,2109
"10887","ENSG00000163214","2",38797729,38875934,78205
"10888","ENSG00000163216","1",153039732,153041931,2199
"10889","ENSG00000163217","2",68860909,68871397,10488
"10890","ENSG00000163218","1",153330120,153348841,18721
"10891","ENSG00000163219","2",68679601,68826833,147232
"10892","ENSG00000163220","1",153357854,153361023,3169
"10893","ENSG00000163221","1",153373711,153375621,1910
"10894","ENSG00000163235","2",70447284,70554193,106909
"10895","ENSG00000163239","1",154502219,154548147,45928
"10896","ENSG00000163249","2",207711540,207761839,50299
"10897","ENSG00000163251","2",207762598,207769906,7308
"10898","ENSG00000163254","2",208128137,208129828,1691
"10899","ENSG00000163257","4",17800655,17810758,10103
"10900","ENSG00000163263","1",154199085,154206333,7248
"10901","ENSG00000163273","2",231921809,231926396,4587
"10902","ENSG00000163281","4",44682200,44726595,44395
"10903","ENSG00000163283","2",232378724,232382889,4165
"10904","ENSG00000163285","4",46035769,46124054,88285
"10905","ENSG00000163286","2",232406844,232410714,3870
"10906","ENSG00000163288","4",46993723,47426444,432721
"10907","ENSG00000163291","4",78887127,78939438,52311
"10908","ENSG00000163293","4",47914142,48040173,126031
"10909","ENSG00000163295","2",232456125,232460753,4628
"10910","ENSG00000163297","4",79901146,80125454,224308
"10911","ENSG00000163312","4",83407343,83455855,48512
"10912","ENSG00000163319","4",83455932,83469735,13803
"10913","ENSG00000163320","3",88051944,88149885,97941
"10914","ENSG00000163322","4",83459517,83523348,63831
"10915","ENSG00000163328","2",174431571,174487094,55523
"10916","ENSG00000163331","2",158795317,158862781,67464
"10917","ENSG00000163344","1",154924740,154936719,11979
"10918","ENSG00000163346","1",154944076,154956123,12047
"10919","ENSG00000163347","3",190305707,190322446,16739
"10920","ENSG00000163348","1",154957026,154963853,6827
"10921","ENSG00000163349","1",113929324,113977869,48545
"10922","ENSG00000163352","1",154993586,154994315,729
"10923","ENSG00000163354","1",155018520,155033781,15261
"10924","ENSG00000163357","1",155033824,155050930,17106
"10925","ENSG00000163359","2",237324003,237414375,90372
"10926","ENSG00000163362","1",200891048,200915742,24694
"10927","ENSG00000163364","2",176629572,176637931,8359
"10928","ENSG00000163374","1",155659443,155689000,29557
"10929","ENSG00000163376","3",66998307,67011210,12903
"10930","ENSG00000163377","3",68731766,68953297,221531
"10931","ENSG00000163378","3",68975217,69013684,38467
"10932","ENSG00000163380","3",69106872,69123032,16160
"10933","ENSG00000163382","1",156591762,156594299,2537
"10934","ENSG00000163389","3",119468963,119494708,25745
"10935","ENSG00000163393","1",115976513,116070054,93541
"10936","ENSG00000163394","4",26481400,26490462,9062
"10937","ENSG00000163395","1",201190825,201228952,38127
"10938","ENSG00000163399","1",116372668,116410261,37593
"10939","ENSG00000163406","3",121894401,121944188,49787
"10940","ENSG00000163412","3",71675414,71754773,79359
"10941","ENSG00000163421","3",71771655,71785206,13551
"10942","ENSG00000163424","3",119146151,119160042,13891
"10943","ENSG00000163428","3",120324509,120349354,24845
"10944","ENSG00000163430","3",120392293,120450993,58700
"10945","ENSG00000163431","1",201896456,201946588,50132
"10946","ENSG00000163435","1",202007945,202017183,9238
"10947","ENSG00000163440","4",55556519,55592245,35726
"10948","ENSG00000163444","1",203007374,203024848,17474
"10949","ENSG00000163449","2",216081866,216102783,20917
"10950","ENSG00000163453","4",57030773,57110385,79612
"10951","ENSG00000163462","1",155173787,155184971,11184
"10952","ENSG00000163463","1",155169408,155173475,4067
"10953","ENSG00000163464","2",218162845,218166995,4150
"10954","ENSG00000163466","2",218217141,218254356,37215
"10955","ENSG00000163467","1",156337314,156346995,9681
"10956","ENSG00000163468","1",156308968,156367873,58905
"10957","ENSG00000163472","1",156282935,156293185,10250
"10958","ENSG00000163479","1",156009048,156020951,11903
"10959","ENSG00000163481","2",218663892,218672002,8110
"10960","ENSG00000163482","2",218672069,218702716,30647
"10961","ENSG00000163485","1",203090654,203167405,76751
"10962","ENSG00000163491","3",27110085,27369460,259375
"10963","ENSG00000163492","2",178829757,179050086,220329
"10964","ENSG00000163497","2",218981087,218985657,4570
"10965","ENSG00000163499","2",218990189,218993422,3233
"10966","ENSG00000163501","2",219054424,219060921,6497
"10967","ENSG00000163507","3",108549864,108589644,39780
"10968","ENSG00000163508","3",27715949,27722711,6762
"10969","ENSG00000163510","2",179944876,180007297,62421
"10970","ENSG00000163512","3",28315003,28349050,34047
"10971","ENSG00000163513","3",30606502,30694142,87640
"10972","ENSG00000163515","3",108743424,108757384,13960
"10973","ENSG00000163516","2",219229757,219236669,6912
"10974","ENSG00000163517","3",13479724,13506424,26700
"10975","ENSG00000163518","1",157573747,157598085,24338
"10976","ENSG00000163519","3",108822698,108855005,32307
"10977","ENSG00000163520","3",13549125,13638422,89297
"10978","ENSG00000163521","2",219236598,219245478,8880
"10979","ENSG00000163527","3",31532638,31637622,104984
"10980","ENSG00000163528","3",14112077,14124870,12793
"10981","ENSG00000163530","3",109293788,109316517,22729
"10982","ENSG00000163531","1",204828651,205022822,194171
"10983","ENSG00000163534","1",157794403,157820120,25717
"10984","ENSG00000163535","2",200510008,200584096,74088
"10985","ENSG00000163536","3",167735243,167825568,90325
"10986","ENSG00000163539","3",33496245,33718356,222111
"10987","ENSG00000163541","2",84423528,84460045,36517
"10988","ENSG00000163545","1",205302059,205321791,19732
"10989","ENSG00000163554","1",158610706,158686715,76009
"10990","ENSG00000163558","3",170222424,170305977,83553
"10991","ENSG00000163563","1",158831351,158849506,18155
"10992","ENSG00000163564","1",158930796,158977054,46258
"10993","ENSG00000163565","1",158999968,159055155,55187
"10994","ENSG00000163568","1",159062484,159147096,84612
"10995","ENSG00000163576","3",19879472,19947025,67553
"10996","ENSG00000163577","3",170888418,170908644,20226
"10997","ENSG00000163581","3",170996347,171026743,30396
"10998","ENSG00000163584","3",170864875,170870208,5333
"10999","ENSG00000163586","2",88122982,88128116,5134
"11000","ENSG00000163590","3",160755602,161078902,323300
"11001","ENSG00000163596","2",202773150,202871985,98835
"11002","ENSG00000163597","17",76557764,76565348,7584
"11003","ENSG00000163599","2",203867771,203873965,6194
"11004","ENSG00000163600","2",203936748,203961577,24829
"11005","ENSG00000163602","3",72371825,72446621,74796
"11006","ENSG00000163605","3",72996785,73069199,72414
"11007","ENSG00000163606","3",112921205,112975103,53898
"11008","ENSG00000163607","3",112990918,113015060,24142
"11009","ENSG00000163608","3",113002444,113019861,17417
"11010","ENSG00000163611","3",113442718,113515187,72469
"11011","ENSG00000163612","4",9153296,9165451,12155
"11012","ENSG00000163617","3",113964137,114056594,92457
"11013","ENSG00000163618","3",62398346,62875416,477070
"11014","ENSG00000163623","4",84491987,84498450,6463
"11015","ENSG00000163624","4",84583127,84651334,68207
"11016","ENSG00000163625","4",84669610,84966391,296781
"11017","ENSG00000163626","4",73052362,73069755,17393
"11018","ENSG00000163629","4",86594315,86815171,220856
"11019","ENSG00000163630","3",63228315,63616924,388609
"11020","ENSG00000163631","4",73397114,73421482,24368
"11021","ENSG00000163632","3",63819362,63848636,29274
"11022","ENSG00000163633","4",86876205,86892422,16217
"11023","ENSG00000163634","3",63833870,63863868,29998
"11024","ENSG00000163635","3",63898399,64003453,105054
"11025","ENSG00000163636","3",64010549,64024010,13461
"11026","ENSG00000163637","3",64092236,64445476,353240
"11027","ENSG00000163638","3",64515654,64688000,172346
"11028","ENSG00000163644","4",88257620,88284769,27149
"11029","ENSG00000163645","3",150659885,150703971,44086
"11030","ENSG00000163646","3",150926163,150972999,46836
"11031","ENSG00000163655","3",155870650,155944020,73370
"11032","ENSG00000163659","3",156673235,156706770,33535
"11033","ENSG00000163660","3",157146508,157160760,14252
"11034","ENSG00000163661","3",157436850,157443633,6783
"11035","ENSG00000163666","3",57197838,57227606,29768
"11036","ENSG00000163673","3",36712422,36764349,51927
"11037","ENSG00000163681","3",57755450,57930003,174553
"11038","ENSG00000163682","4",39452521,39458949,6428
"11039","ENSG00000163683","4",39546336,39638902,92566
"11040","ENSG00000163684","3",58306247,58324695,18448
"11041","ENSG00000163686","3",58237506,58295693,58187
"11042","ENSG00000163687","3",58192257,58214697,22440
"11043","ENSG00000163689","3",58717365,59050084,332719
"11044","ENSG00000163694","4",40423267,40630875,207608
"11045","ENSG00000163697","4",40810027,41216714,406687
"11046","ENSG00000163701","3",9902612,9916402,13790
"11047","ENSG00000163702","3",9917074,9933630,16556
"11048","ENSG00000163703","3",9933822,9945413,11591
"11049","ENSG00000163704","3",9945542,9952408,6866
"11050","ENSG00000163705","3",10081317,10108231,26914
"11051","ENSG00000163710","3",142815922,142889206,73284
"11052","ENSG00000163714","3",142964497,143060546,96049
"11053","ENSG00000163719","3",9649433,9702393,52960
"11054","ENSG00000163728","3",180602163,180617828,15665
"11055","ENSG00000163734","4",74036589,74038807,2218
"11056","ENSG00000163735","4",73995642,73998677,3035
"11057","ENSG00000163736","4",73986439,73988190,1751
"11058","ENSG00000163737","4",73981077,73982124,1047
"11059","ENSG00000163738","4",74114174,74303099,188925
"11060","ENSG00000163739","4",73869393,73871242,1849
"11061","ENSG00000163743","4",75479037,75514764,35727
"11062","ENSG00000163746","3",146391421,146495991,104570
"11063","ENSG00000163749","4",76312997,76421868,108871
"11064","ENSG00000163751","3",148865296,148897203,31907
"11065","ENSG00000163754","3",148991341,149027668,36327
"11066","ENSG00000163755","3",149129584,149173732,44148
"11067","ENSG00000163762","3",149318498,149334414,15916
"11068","ENSG00000163781","3",133598175,133662380,64205
"11069","ENSG00000163785","3",134065303,134250744,185441
"11070","ENSG00000163788","3",43286512,43424764,138252
"11071","ENSG00000163792","2",27149004,27156974,7970
"11072","ENSG00000163793","2",27275421,27281499,6078
"11073","ENSG00000163794","2",27307400,27308445,1045
"11074","ENSG00000163795","2",27377235,27380790,3555
"11075","ENSG00000163798","2",27663471,27694976,31505
"11076","ENSG00000163803","2",28457145,28644142,186997
"11077","ENSG00000163806","2",28782517,28850611,68094
"11078","ENSG00000163807","3",44737661,44761619,23958
"11079","ENSG00000163808","3",44761721,44873376,111655
"11080","ENSG00000163810","3",44874608,44914990,40382
"11081","ENSG00000163811","2",28894667,28948219,53552
"11082","ENSG00000163812","3",44915257,44976185,60928
"11083","ENSG00000163814","3",45082277,45146422,64145
"11084","ENSG00000163815","3",45001548,45036071,34523
"11085","ENSG00000163817","3",45755449,45796536,41087
"11086","ENSG00000163818","3",45823316,45916042,92726
"11087","ENSG00000163820","3",45917899,45995824,77925
"11088","ENSG00000163823","3",46201711,46208313,6602
"11089","ENSG00000163825","3",46497976,46500950,2974
"11090","ENSG00000163827","3",46515385,46580099,64714
"11091","ENSG00000163832","3",47495640,47513712,18072
"11092","ENSG00000163833","3",121593379,121630295,36916
"11093","ENSG00000163840","3",122564338,122575203,10865
"11094","ENSG00000163848","3",125225561,125375354,149793
"11095","ENSG00000163864","3",139560180,139678017,117837
"11096","ENSG00000163866","1",34712737,34859755,147018
"11097","ENSG00000163867","1",34986165,35031945,45780
"11098","ENSG00000163870","3",127571266,127598267,27001
"11099","ENSG00000163872","3",183697797,183812624,114827
"11100","ENSG00000163873","1",36795527,37034515,238988
"11101","ENSG00000163874","1",37474580,37484377,9797
"11102","ENSG00000163875","1",37492575,37514774,22199
"11103","ENSG00000163877","1",37534449,37554293,19844
"11104","ENSG00000163879","1",37556919,37566857,9938
"11105","ENSG00000163882","3",184361718,184368596,6878
"11106","ENSG00000163884","3",126342635,126357408,14773
"11107","ENSG00000163885","3",126394909,126436556,41647
"11108","ENSG00000163888","3",184259213,184261553,2340
"11109","ENSG00000163898","3",185506262,185552588,46326
"11110","ENSG00000163900","3",185476496,185499057,22561
"11111","ENSG00000163902","3",128619969,128681075,61106
"11112","ENSG00000163904","3",185582496,185633551,51055
"11113","ENSG00000163909","1",39623435,39639643,16208
"11114","ENSG00000163913","3",129440036,129520507,80471
"11115","ENSG00000163914","3",129528640,129535169,6529
"11116","ENSG00000163915","3",185712528,185729787,17259
"11117","ENSG00000163918","3",186789880,186807058,17178
"11118","ENSG00000163923","3",187120948,187180908,59960
"11119","ENSG00000163930","3",52401008,52410008,9000
"11120","ENSG00000163931","3",53224712,53256052,31340
"11121","ENSG00000163932","3",53156009,53192717,36708
"11122","ENSG00000163933","3",53088483,53130453,41970
"11123","ENSG00000163935","3",52903572,53046750,143178
"11124","ENSG00000163938","3",52681156,52694497,13341
"11125","ENSG00000163939","3",52545352,52685917,140565
"11126","ENSG00000163945","4",1347266,1395992,48726
"11127","ENSG00000163946","3",56620133,56683237,63104
"11128","ENSG00000163947","3",56727418,57079329,351911
"11129","ENSG00000163950","4",1692731,1712344,19613
"11130","ENSG00000163956","4",3503612,3532446,28834
"11131","ENSG00000163958","3",196197452,196211437,13985
"11132","ENSG00000163959","3",196211487,196243178,31691
"11133","ENSG00000163960","3",196347662,196432430,84768
"11134","ENSG00000163961","3",196468783,196503768,34985
"11135","ENSG00000163964","3",196639775,196736007,96232
"11136","ENSG00000163975","3",196988621,197029817,41196
"11137","ENSG00000163993","4",6693878,6697170,3292
"11138","ENSG00000163995","4",7965310,8158832,193522
"11139","ENSG00000164002","1",40508741,40516556,7815
"11140","ENSG00000164007","1",42733093,42740254,7161
"11141","ENSG00000164008","1",42767249,42779491,12242
"11142","ENSG00000164010","1",42817122,42844991,27869
"11143","ENSG00000164011","1",42846573,42852477,5904
"11144","ENSG00000164022","4",106315544,106349226,33682
"11145","ENSG00000164023","4",107824563,107915047,90484
"11146","ENSG00000164024","4",98995659,99062809,67150
"11147","ENSG00000164031","4",99896248,99946618,50370
"11148","ENSG00000164032","4",99948086,99950355,2269
"11149","ENSG00000164035","4",100395341,100880126,484785
"11150","ENSG00000164037","4",102885048,103019739,134691
"11151","ENSG00000164038","4",103019868,103085829,65961
"11152","ENSG00000164039","4",103077592,103099870,22278
"11153","ENSG00000164040","4",128269237,128288829,19592
"11154","ENSG00000164045","3",48157146,48188402,31256
"11155","ENSG00000164047","3",48223347,48225491,2144
"11156","ENSG00000164048","3",48241100,48299253,58153
"11157","ENSG00000164049","3",48372219,48401259,29040
"11158","ENSG00000164050","3",48403854,48430086,26232
"11159","ENSG00000164051","3",48432164,48440456,8292
"11160","ENSG00000164053","3",48446710,48467645,20935
"11161","ENSG00000164054","3",48467798,48504826,37028
"11162","ENSG00000164056","4",123396795,123403760,6965
"11163","ENSG00000164061","3",49554477,49671549,117072
"11164","ENSG00000164062","3",49674014,49683971,9957
"11165","ENSG00000164066","4",127623271,127726737,103466
"11166","ENSG00000164068","3",49689538,49721529,31991
"11167","ENSG00000164070","4",127781821,127840733,58912
"11168","ENSG00000164073","4",127917732,127966034,48302
"11169","ENSG00000164074","4",127965306,128039927,74621
"11170","ENSG00000164076","3",49857988,49869935,11947
"11171","ENSG00000164077","3",49907160,49930173,23013
"11172","ENSG00000164078","3",49887002,49903873,16871
"11173","ENSG00000164080","3",51541144,51668667,127523
"11174","ENSG00000164081","3",51662693,51704323,41630
"11175","ENSG00000164082","3",51707068,51718613,11545
"11176","ENSG00000164086","3",52048919,52056571,7652
"11177","ENSG00000164087","3",52075253,52154690,79437
"11178","ENSG00000164088","3",52245759,52250599,4840
"11179","ENSG00000164089","4",108742048,108763054,21006
"11180","ENSG00000164091","3",52254434,52288020,33586
"11181","ENSG00000164093","4",110617423,110642123,24700
"11182","ENSG00000164096","4",119296419,119304445,8026
"11183","ENSG00000164099","4",118280038,118353003,72965
"11184","ENSG00000164100","4",118033618,118258634,225016
"11185","ENSG00000164104","4",173331695,173335125,3430
"11186","ENSG00000164105","4",173369969,173377532,7563
"11187","ENSG00000164106","4",173384701,173406380,21679
"11188","ENSG00000164107","4",173524969,173530229,5260
"11189","ENSG00000164109","4",120055623,120066858,11235
"11190","ENSG00000164111","4",121667946,121696995,29049
"11191","ENSG00000164112","4",121758930,121765427,6497
"11192","ENSG00000164113","4",122378966,122429802,50836
"11193","ENSG00000164114","4",155342658,155376970,34312
"11194","ENSG00000164116","4",155666711,155732349,65638
"11195","ENSG00000164117","4",174236658,174284264,47606
"11196","ENSG00000164118","4",174283730,174333380,49650
"11197","ENSG00000164120","4",174490175,174523154,32979
"11198","ENSG00000164122","4",176213673,176277571,63898
"11199","ENSG00000164123","4",158893134,159038760,145626
"11200","ENSG00000164124","4",158201604,158255411,53807
"11201","ENSG00000164125","4",158124474,158173318,48844
"11202","ENSG00000164128","4",163323962,163344832,20870
"11203","ENSG00000164129","4",163343892,163351934,8042
"11204","ENSG00000164134","4",139301505,139420033,118528
"11205","ENSG00000164136","4",141636583,141733987,97404
"11206","ENSG00000164142","4",151409176,151670503,261327
"11207","ENSG00000164144","4",152779937,152918463,138526
"11208","ENSG00000164151","5",5420664,5490220,69556
"11209","ENSG00000164161","4",144646156,144745271,99115
"11210","ENSG00000164162","4",144831908,145098541,266633
"11211","ENSG00000164163","4",145098288,145129524,31236
"11212","ENSG00000164164","4",145110838,145180161,69323
"11213","ENSG00000164167","4",146175703,146200000,24297
"11214","ENSG00000164168","4",147617383,147672044,54661
"11215","ENSG00000164169","4",147637785,147684163,46378
"11216","ENSG00000164171","5",52989340,53094779,105439
"11217","ENSG00000164172","5",53095679,53110063,14384
"11218","ENSG00000164175","5",33944623,33984693,40070
"11219","ENSG00000164176","5",83940554,84384880,444326
"11220","ENSG00000164180","5",88189633,88269476,79843
"11221","ENSG00000164181","5",60751791,60844274,92483
"11222","ENSG00000164182","5",60945205,61153026,207821
"11223","ENSG00000164185","5",122129546,122153569,24023
"11224","ENSG00000164187","5",36098407,36151887,53480
"11225","ENSG00000164188","5",36248434,36302114,53680
"11226","ENSG00000164190","5",36876769,37066413,189644
"11227","ENSG00000164197","5",64165843,64372869,207026
"11228","ENSG00000164199","5",90529344,91164437,635093
"11229","ENSG00000164209","5",110738136,110765161,27025
"11230","ENSG00000164211","5",111496033,111512590,16557
"11231","ENSG00000164219","5",115204012,115262877,58865
"11232","ENSG00000164220","5",76615482,76623413,7931
"11233","ENSG00000164221","5",115267190,115296693,29503
"11234","ENSG00000164236","5",10564070,10657816,93746
"11235","ENSG00000164237","5",10275875,10307902,32027
"11236","ENSG00000164241","5",127042558,127073492,30934
"11237","ENSG00000164244","5",127517609,127555089,37480
"11238","ENSG00000164251","5",76818933,76835315,16382
"11239","ENSG00000164252","5",77029251,77065234,35983
"11240","ENSG00000164253","5",77425970,77620611,194641
"11241","ENSG00000164256","5",23443586,23528597,85011
"11242","ENSG00000164258","5",53560633,53683338,122705
"11243","ENSG00000164265","5",147870682,147882191,11509
"11244","ENSG00000164266","5",147824568,147831786,7218
"11245","ENSG00000164270","5",148451032,148677235,226203
"11246","ENSG00000164283","5",54977867,55022671,44804
"11247","ENSG00000164284","5",149345430,149354583,9153
"11248","ENSG00000164287","5",55112995,55173175,60180
"11249","ENSG00000164291","5",95555074,95605064,49990
"11250","ENSG00000164292","5",95713522,95824383,110861
"11251","ENSG00000164294","5",55160167,55167297,7130
"11252","ENSG00000164296","5",149993118,150000654,7536
"11253","ENSG00000164299","5",80319625,80321842,2217
"11254","ENSG00000164300","5",80111651,80256048,144397
"11255","ENSG00000164303","4",184088706,184221230,132524
"11256","ENSG00000164304","6",7326656,7389742,63086
"11257","ENSG00000164305","4",184627696,184649509,21813
"11258","ENSG00000164306","4",184649667,184694963,45296
"11259","ENSG00000164307","5",96760810,96808100,47290
"11260","ENSG00000164308","5",96875939,96919716,43777
"11261","ENSG00000164309","5",79689836,79800240,110404
"11262","ENSG00000164318","5",38258409,38465480,207071
"11263","ENSG00000164323","4",185159665,185209504,49839
"11264","ENSG00000164325","5",73173193,73175143,1950
"11265","ENSG00000164326","5",71719275,71721048,1773
"11266","ENSG00000164327","5",38937920,39074399,136479
"11267","ENSG00000164329","5",79612120,79686648,74528
"11268","ENSG00000164330","5",158695916,159099916,404000
"11269","ENSG00000164331","5",73552190,73565667,13477
"11270","ENSG00000164332","5",159263290,159286036,22746
"11271","ENSG00000164334","5",119629559,119635822,6263
"11272","ENSG00000164338","5",73565443,73583380,17937
"11273","ENSG00000164342","4",186069152,186088069,18917
"11274","ENSG00000164344","4",186208979,186258471,49492
"11275","ENSG00000164346","5",74766991,74780113,13122
"11276","ENSG00000164347","5",74721206,74767147,45941
"11277","ENSG00000164362","5",1253147,1295047,41900
"11278","ENSG00000164363","5",1225381,1246189,20808
"11279","ENSG00000164366","5",196871,218215,21344
"11280","ENSG00000164379","6",1312098,1314758,2660
"11281","ENSG00000164385","6",2621913,2634619,12706
"11282","ENSG00000164393","6",47656436,47697797,41361
"11283","ENSG00000164398","5",131949973,132012243,62270
"11284","ENSG00000164399","5",132060529,132063204,2675
"11285","ENSG00000164400","5",132073789,132076170,2381
"11286","ENSG00000164402","5",132750819,132807241,56422
"11287","ENSG00000164403","5",132822141,132830898,8757
"11288","ENSG00000164404","5",132861181,132866884,5703
"11289","ENSG00000164405","5",132866630,132868847,2217
"11290","ENSG00000164406","5",132872322,132875046,2724
"11291","ENSG00000164411","6",87282978,87329278,46300
"11292","ENSG00000164414","6",87470623,87512336,41713
"11293","ENSG00000164418","6",101181257,102070083,888826
"11294","ENSG00000164430","6",73413515,73452297,38782
"11295","ENSG00000164434","6",122779716,122784074,4358
"11296","ENSG00000164438","5",171309248,171312139,2891
"11297","ENSG00000164440","6",139240061,139291998,51937
"11298","ENSG00000164442","6",139371807,139374648,2841
"11299","ENSG00000164451","6",116529013,116558868,29855
"11300","ENSG00000164458","6",166157656,166168700,11044
"11301","ENSG00000164463","5",173056352,173139284,82932
"11302","ENSG00000164465","6",117453817,117569858,116041
"11303","ENSG00000164466","5",175477062,175529742,52680
"11304","ENSG00000164483","6",130144315,130365425,221110
"11305","ENSG00000164484","6",130365734,130443063,77329
"11306","ENSG00000164485","6",137143820,137173648,29828
"11307","ENSG00000164488","6",168292830,168319777,26947
"11308","ENSG00000164494","6",107152562,107459564,307002
"11309","ENSG00000164500","7",50096036,50159830,63794
"11310","ENSG00000164506","6",147204425,147390476,186051
"11311","ENSG00000164508","6",25726132,25726527,395
"11312","ENSG00000164509","5",55851357,55922854,71497
"11313","ENSG00000164512","5",56099680,56233330,133650
"11314","ENSG00000164520","6",149883375,149898102,14727
"11315","ENSG00000164530","6",36948263,36964837,16574
"11316","ENSG00000164532","7",35202430,35254147,51717
"11317","ENSG00000164535","7",6409126,6484190,75064
"11318","ENSG00000164542","7",36324221,36390125,65904
"11319","ENSG00000164543","7",43582758,43650713,67955
"11320","ENSG00000164548","7",23504780,23532041,27261
"11321","ENSG00000164556","7",38685346,38687037,1691
"11322","ENSG00000164574","5",154190730,154420984,230254
"11323","ENSG00000164576","5",154445997,154461053,15056
"11324","ENSG00000164587","5",150442635,150449739,7104
"11325","ENSG00000164588","5",45254948,45696498,441550
"11326","ENSG00000164591","5",150660874,150679365,18491
"11327","ENSG00000164597","7",107201555,107564514,362959
"11328","ENSG00000164600","7",31337465,31340726,3261
"11329","ENSG00000164603","7",112819147,112939875,120728
"11330","ENSG00000164604","7",113078331,113087778,9447
"11331","ENSG00000164609","5",160401641,160421711,20070
"11332","ENSG00000164610","7",33094797,33109404,14607
"11333","ENSG00000164611","5",160421855,160428739,6884
"11334","ENSG00000164615","5",134738548,134752157,13609
"11335","ENSG00000164616","5",135930317,135951591,21274
"11336","ENSG00000164619","7",33904308,34156427,252119
"11337","ENSG00000164620","5",141636950,141641064,4114
"11338","ENSG00000164621","5",136129507,136134890,5383
"11339","ENSG00000164626","6",39188971,39229475,40504
"11340","ENSG00000164627","6",39329990,39725408,395418
"11341","ENSG00000164631","7",6688433,6706947,18514
"11342","ENSG00000164638","7",5274369,5306870,32501
"11343","ENSG00000164645","7",88794106,88795737,1631
"11344","ENSG00000164647","7",90154456,90164829,10373
"11345","ENSG00000164649","7",21900899,21945903,45004
"11346","ENSG00000164651","7",20782283,20786886,4603
"11347","ENSG00000164654","7",7566875,7608932,42057
"11348","ENSG00000164659","7",86876906,87059654,182748
"11349","ENSG00000164663","6",41789896,41895361,105465
"11350","ENSG00000164669","7",65141032,65234216,93184
"11351","ENSG00000164674","6",158650014,158764876,114862
"11352","ENSG00000164675","7",123452193,123535077,82884
"11353","ENSG00000164683","8",79764010,79767857,3847
"11354","ENSG00000164684","8",80628451,80874781,246330
"11355","ENSG00000164687","8",81280536,81284777,4241
"11356","ENSG00000164690","7",155799980,155812463,12483
"11357","ENSG00000164691","6",159034468,159045152,10684
"11358","ENSG00000164692","7",94394561,94431232,36671
"11359","ENSG00000164694","6",159169400,159272108,102708
"11360","ENSG00000164695","8",81732448,81759515,27067
"11361","ENSG00000164707","7",135681237,135729258,48021
"11362","ENSG00000164713","7",98252379,98310441,58062
"11363","ENSG00000164715","7",98106862,98209638,102776
"11364","ENSG00000164729","17",35192520,35194523,2003
"11365","ENSG00000164733","8",11842524,11869448,26924
"11366","ENSG00000164736","8",54457935,54460892,2957
"11367","ENSG00000164740","7",63495799,63502536,6737
"11368","ENSG00000164741","8",13083361,13604610,521249
"11369","ENSG00000164742","7",45574140,45723116,148976
"11370","ENSG00000164743","8",13566869,13568288,1419
"11371","ENSG00000164744","7",47987148,48029119,41971
"11372","ENSG00000164746","7",48035511,48061304,25793
"11373","ENSG00000164749","8",75407914,75566843,158929
"11374","ENSG00000164751","8",76980258,77001044,20786
"11375","ENSG00000164754","8",116845935,116874866,28931
"11376","ENSG00000164756","8",116950273,117176714,226441
"11377","ENSG00000164758","8",117520713,117540262,19549
"11378","ENSG00000164761","8",118923557,118951885,28328
"11379","ENSG00000164764","8",73064543,73124088,59545
"11380","ENSG00000164776","7",56080283,56092996,12713
"11381","ENSG00000164778","7",155458129,155464831,6702
"11382","ENSG00000164794","8",109963636,109975771,12135
"11383","ENSG00000164796","8",112222928,113436939,1214011
"11384","ENSG00000164808","8",47260575,47736306,475731
"11385","ENSG00000164815","7",104126341,104208047,81706
"11386","ENSG00000164816","8",7055304,7056739,1435
"11387","ENSG00000164818","7",726699,786475,59776
"11388","ENSG00000164821","8",6935822,6938338,2516
"11389","ENSG00000164822","8",6924697,6926076,1379
"11390","ENSG00000164823","8",89901849,89927888,26039
"11391","ENSG00000164825","8",6870592,6877936,7344
"11392","ENSG00000164828","7",816615,896435,79820
"11393","ENSG00000164830","8",106359476,106752694,393218
"11394","ENSG00000164841","8",108606850,108787594,180744
"11395","ENSG00000164845","12",8232512,8242948,10436
"11396","ENSG00000164849","7",1044546,1059261,14715
"11397","ENSG00000164850","7",1082208,1093815,11607
"11398","ENSG00000164853","7",1232872,1237326,4454
"11399","ENSG00000164855","7",1542235,1560821,18586
"11400","ENSG00000164867","7",150991017,151014588,23571
"11401","ENSG00000164871","8",7442684,7463674,20990
"11402","ENSG00000164877","7",1428465,1459470,31005
"11403","ENSG00000164879","8",85373436,85449040,75604
"11404","ENSG00000164880","7",1470277,1504389,34112
"11405","ENSG00000164885","7",151053815,151057897,4082
"11406","ENSG00000164889","7",151057210,151076526,19316
"11407","ENSG00000164893","8",86214063,86321146,107083
"11408","ENSG00000164896","7",151076593,151080866,4273
"11409","ENSG00000164897","7",151081085,151083493,2408
"11410","ENSG00000164898","7",139339457,139346328,6871
"11411","ENSG00000164900","7",151148589,151174745,26156
"11412","ENSG00000164902","5",126600925,126627252,26327
"11413","ENSG00000164904","5",126531200,126595362,64162
"11414","ENSG00000164916","7",4682295,4771442,89147
"11415","ENSG00000164919","8",99873200,99893707,20507
"11416","ENSG00000164920","8",98944403,98952104,7701
"11417","ENSG00000164924","8",100916523,100953388,36865
"11418","ENSG00000164929","8",103140713,103230305,89592
"11419","ENSG00000164930","8",103298433,103332866,34433
"11420","ENSG00000164932","8",103371538,103382989,11451
"11421","ENSG00000164933","8",103398635,103415189,16554
"11422","ENSG00000164934","8",103414714,103443453,28739
"11423","ENSG00000164935","8",104339087,104356689,17602
"11424","ENSG00000164938","8",94925972,94949378,23406
"11425","ENSG00000164941","8",94813311,94881746,68435
"11426","ENSG00000164944","8",94487689,94553529,65840
"11427","ENSG00000164946","9",14734666,14910995,176329
"11428","ENSG00000164949","8",94249253,94262350,13097
"11429","ENSG00000164951","8",93857807,93926068,68261
"11430","ENSG00000164953","8",93754844,93819234,64390
"11431","ENSG00000164961","8",125024260,125091819,67559
"11432","ENSG00000164967","9",34610486,34612104,1618
"11433","ENSG00000164970","9",34398184,34458570,60386
"11434","ENSG00000164972","9",34379019,34397810,18791
"11435","ENSG00000164975","9",15422704,15465953,43249
"11436","ENSG00000164976","9",34366666,34376898,10232
"11437","ENSG00000164978","9",34329506,34343711,14205
"11438","ENSG00000164983","8",124306189,124372692,66503
"11439","ENSG00000164985","9",15464066,15510995,46929
"11440","ENSG00000164989","9",15553043,16061663,508620
"11441","ENSG00000165006","9",34179005,34252523,73518
"11442","ENSG00000165023","9",90609832,90642862,33030
"11443","ENSG00000165025","9",90801787,90898549,96762
"11444","ENSG00000165028","9",104764129,104777764,13635
"11445","ENSG00000165029","9",104781006,104928155,147149
"11446","ENSG00000165030","9",91409045,91423832,14787
"11447","ENSG00000165046","8",38386207,38409527,23320
"11448","ENSG00000165055","7",128476729,128506602,29873
"11449","ENSG00000165059","9",69012529,69014113,1584
"11450","ENSG00000165060","9",69035563,69100178,64615
"11451","ENSG00000165061","8",40530590,40897833,367243
"11452","ENSG00000165066","8",41645178,41650669,5491
"11453","ENSG00000165071","8",132685007,132760712,75705
"11454","ENSG00000165072","9",70043848,70226972,183124
"11455","ENSG00000165076","7",141836286,141841487,5201
"11456","ENSG00000165078","8",67422038,67746385,324347
"11457","ENSG00000165084","8",68330955,68819023,488068
"11458","ENSG00000165091","9",72521608,72838291,316683
"11459","ENSG00000165092","9",72900671,73080442,179771
"11460","ENSG00000165097","6",18155329,18223861,68532
"11461","ENSG00000165102","8",43140464,43202855,62391
"11462","ENSG00000165105","9",82979590,83063177,83587
"11463","ENSG00000165113","9",83739425,83829516,90091
"11464","ENSG00000165115","9",83834099,83921465,87366
"11465","ENSG00000165118","9",83938311,83956986,18675
"11466","ENSG00000165119","9",83968083,83980616,12533
"11467","ENSG00000165120","7",130206344,130216844,10500
"11468","ENSG00000165121","9",85805359,85849542,44183
"11469","ENSG00000165124","9",110365248,110579880,214632
"11470","ENSG00000165125","7",142871208,142885745,14537
"11471","ENSG00000165131","7",142939343,142940865,1522
"11472","ENSG00000165138","9",98731329,98796965,65636
"11473","ENSG00000165140","9",94603133,94640249,37116
"11474","ENSG00000165152","9",101473170,101533537,60367
"11475","ENSG00000165156","8",123248451,123275541,27090
"11476","ENSG00000165164","X",35919734,36385317,465583
"11477","ENSG00000165168","X",37780011,37813461,33450
"11478","ENSG00000165169","X",37836757,37847571,10814
"11479","ENSG00000165171","7",73834590,73842516,7926
"11480","ENSG00000165175","X",38801432,38806537,5105
"11481","ENSG00000165178","7",75156639,75172044,15405
"11482","ENSG00000165181","9",111686173,111795008,108835
"11483","ENSG00000165182","X",23907801,23939509,31708
"11484","ENSG00000165185","9",112486847,112669397,182550
"11485","ENSG00000165186","X",23334849,23404374,69525
"11486","ENSG00000165188","9",113297093,113303376,6283
"11487","ENSG00000165192","X",15281697,15315656,33959
"11488","ENSG00000165194","X",100291644,100410273,118629
"11489","ENSG00000165195","X",15319451,15335580,16129
"11490","ENSG00000165197","X",15345596,15384413,38817
"11491","ENSG00000165202","9",122614738,122615682,944
"11492","ENSG00000165204","9",122800123,122801073,950
"11493","ENSG00000165209","9",123109500,123268576,159076
"11494","ENSG00000165215","7",73768997,73770270,1273
"11495","ENSG00000165219","9",125261794,125367207,105413
"11496","ENSG00000165233","9",93096217,93113283,17066
"11497","ENSG00000165238","9",93184916,93320572,135656
"11498","ENSG00000165240","X",77910656,78050395,139739
"11499","ENSG00000165244","9",96385941,96418370,32429
"11500","ENSG00000165246","Y",14522573,14845650,323077
"11501","ENSG00000165259","X",84317874,84502479,184605
"11502","ENSG00000165264","9",32553001,32573184,20183
"11503","ENSG00000165269","9",33383179,33402682,19503
"11504","ENSG00000165271","9",33461353,33473930,12577
"11505","ENSG00000165272","9",33441156,33447596,6440
"11506","ENSG00000165275","9",37753803,37778972,25169
"11507","ENSG00000165280","9",35056064,35072627,16563
"11508","ENSG00000165282","9",35088688,35096601,7913
"11509","ENSG00000165283","9",35099776,35103195,3419
"11510","ENSG00000165288","X",80670854,80809688,138834
"11511","ENSG00000165300","13",87672615,87696272,23657
"11512","ENSG00000165304","9",36572862,36677683,104821
"11513","ENSG00000165309","10",22928024,23038523,110499
"11514","ENSG00000165312","10",23439458,23442390,2932
"11515","ENSG00000165322","10",31805404,31928876,123472
"11516","ENSG00000165323","11",92352096,92896470,544374
"11517","ENSG00000165325","11",93329971,93438487,108516
"11518","ENSG00000165338","10",91409280,91514829,105549
"11519","ENSG00000165349","X",70925579,70931125,5546
"11520","ENSG00000165355","14",39397669,39432500,34831
"11521","ENSG00000165359","X",135520643,135582510,61867
"11522","ENSG00000165370","X",137027447,137033847,6400
"11523","ENSG00000165376","X",106900164,106930861,30697
"11524","ENSG00000165379","14",41607570,41904549,296979
"11525","ENSG00000165383","10",48909483,48914232,4749
"11526","ENSG00000165389","14",34432788,34462240,29452
"11527","ENSG00000165392","8",31033788,31175916,142128
"11528","ENSG00000165406","10",45454585,45594906,140321
"11529","ENSG00000165409","14",80954989,81146302,191313
"11530","ENSG00000165410","14",34706769,34714823,8054
"11531","ENSG00000165416","13",52652709,52700909,48200
"11532","ENSG00000165417","14",81175452,81221377,45925
"11533","ENSG00000165424","10",79382325,79445627,63302
"11534","ENSG00000165434","11",74330316,74398433,68117
"11535","ENSG00000165443","10",59176643,59247774,71131
"11536","ENSG00000165449","10",59650761,59736002,85241
"11537","ENSG00000165457","11",72216601,72221950,5349
"11538","ENSG00000165458","11",72223701,72239147,15446
"11539","ENSG00000165462","11",72239077,72245664,6587
"11540","ENSG00000165471","10",52765380,52771700,6320
"11541","ENSG00000165474","13",20187463,20192938,5475
"11542","ENSG00000165475","13",20403666,20525873,122207
"11543","ENSG00000165476","10",63521401,63625128,103727
"11544","ENSG00000165478","11",124919205,124936412,17207
"11545","ENSG00000165480","13",21153595,21176552,22957
"11546","ENSG00000165487","13",21492691,21604181,111490
"11547","ENSG00000165490","11",82899975,82958277,58302
"11548","ENSG00000165494","11",83156988,83187451,30463
"11549","ENSG00000165495","11",125164687,125433389,268702
"11550","ENSG00000165496","14",46651010,46651821,811
"11551","ENSG00000165501","14",49598761,49614672,15911
"11552","ENSG00000165502","14",49618519,49620685,2166
"11553","ENSG00000165506","14",49625174,49635230,10056
"11554","ENSG00000165507","10",44970981,44978810,7829
"11555","ENSG00000165509","X",141838316,141897832,59516
"11556","ENSG00000165511","10",44997698,45000888,3190
"11557","ENSG00000165512","10",45000923,45005326,4403
"11558","ENSG00000165516","14",49768130,49786385,18255
"11559","ENSG00000165521","14",88612431,88792752,180321
"11560","ENSG00000165525","14",49782083,49852821,70738
"11561","ENSG00000165526","11",126202096,126211692,9596
"11562","ENSG00000165527","14",49893082,49897054,3972
"11563","ENSG00000165533","14",88824153,88881078,56925
"11564","ENSG00000165548","14",77116568,77259495,142927
"11565","ENSG00000165553","14",77265483,77271312,5829
"11566","ENSG00000165555","14",77394021,77423517,29496
"11567","ENSG00000165556","13",27962137,27971139,9002
"11568","ENSG00000165566","13",25161684,25172288,10604
"11569","ENSG00000165568","10",4786629,4848062,61433
"11570","ENSG00000165572","13",41127569,41132746,5177
"11571","ENSG00000165583","X",48186220,48196763,10543
"11572","ENSG00000165584","X",48346428,48356707,10279
"11573","ENSG00000165588","14",56799905,56810479,10574
"11574","ENSG00000165591","X",57286706,57489196,202490
"11575","ENSG00000165606","10",49364181,49396016,31835
"11576","ENSG00000165609","10",12165330,12196144,30814
"11577","ENSG00000165617","14",58633967,58648321,14354
"11578","ENSG00000165621","13",96985719,96994730,9011
"11579","ENSG00000165623","10",13221766,13234374,12608
"11580","ENSG00000165626","10",13438484,13528974,90490
"11581","ENSG00000165629","10",7788147,7807815,19668
"11582","ENSG00000165630","10",13586939,13630859,43920
"11583","ENSG00000165632","10",7818505,8016631,198126
"11584","ENSG00000165633","10",49014236,49115522,101286
"11585","ENSG00000165637","10",75210154,75231448,21294
"11586","ENSG00000165643","9",135693407,135699528,6121
"11587","ENSG00000165644","10",75233969,75236030,2061
"11588","ENSG00000165646","10",117241093,117279430,38337
"11589","ENSG00000165650","10",117277274,117375440,98166
"11590","ENSG00000165655","10",75397830,75401764,3934
"11591","ENSG00000165660","10",124801819,124836667,34848
"11592","ENSG00000165661","9",136206333,136245841,39508
"11593","ENSG00000165669","10",118297925,118342328,44403
"11594","ENSG00000165671","5",177133025,177300215,167190
"11595","ENSG00000165672","10",119167720,119178812,11092
"11596","ENSG00000165675","X",130623369,130903317,279948
"11597","ENSG00000165678","10",84139509,84153568,14059
"11598","ENSG00000165682","12",9985642,10013424,27782
"11599","ENSG00000165684","9",136375577,136400168,24591
"11600","ENSG00000165685","12",10170542,10191801,21259
"11601","ENSG00000165688","9",136410641,136423761,13120
"11602","ENSG00000165689","9",136401922,136410614,8692
"11603","ENSG00000165694","X",132076993,132128020,51027
"11604","ENSG00000165695","9",132725578,132878777,153199
"11605","ENSG00000165698","9",132878027,132890201,12174
"11606","ENSG00000165699","9",132891348,132946874,55526
"11607","ENSG00000165702","9",132944000,132991687,47687
"11608","ENSG00000165704","X",134460165,134520513,60348
"11609","ENSG00000165714","12",12357078,12471233,114155
"11610","ENSG00000165716","9",136712572,136724742,12170
"11611","ENSG00000165724","9",137582081,137590512,8431
"11612","ENSG00000165730","10",68827531,68895432,67901
"11613","ENSG00000165731","10",43077069,43130351,53282
"11614","ENSG00000165732","10",68956170,68985068,28898
"11615","ENSG00000165733","10",42782795,42834937,52142
"11616","ENSG00000165752","10",132207492,132331847,124355
"11617","ENSG00000165757","10",30012803,30115494,102691
"11618","ENSG00000165762","14",19875142,19883932,8790
"11619","ENSG00000165775","X",155025980,155060304,34324
"11620","ENSG00000165782","14",20457719,20461612,3893
"11621","ENSG00000165792","14",20989770,20997035,7265
"11622","ENSG00000165794","14",20999255,21001871,2616
"11623","ENSG00000165795","14",21016763,21070872,54109
"11624","ENSG00000165799","14",21042316,21044234,1918
"11625","ENSG00000165801","14",21070273,21090248,19975
"11626","ENSG00000165802","9",137447573,137459334,11761
"11627","ENSG00000165804","14",21090077,21104722,14645
"11628","ENSG00000165805","12",87980035,88034037,54002
"11629","ENSG00000165806","10",113679162,113730907,51745
"11630","ENSG00000165807","14",64549920,64589381,39461
"11631","ENSG00000165810","5",181040225,181061521,21296
"11632","ENSG00000165813","10",114120862,114174232,53370
"11633","ENSG00000165816","10",114239254,114294489,55235
"11634","ENSG00000165819","14",21498133,21511342,13209
"11635","ENSG00000165821","14",21521080,21537216,16136
"11636","ENSG00000165828","10",133347368,133352683,5315
"11637","ENSG00000165832","10",114938195,114977676,39481
"11638","ENSG00000165837","13",45534522,45615739,81217
"11639","ENSG00000165841","10",94762681,94855547,92866
"11640","ENSG00000165861","14",72969451,73027131,57680
"11641","ENSG00000165863","10",116663696,116670264,6568
"11642","ENSG00000165868","10",116671192,116850236,179044
"11643","ENSG00000165874","10",46610474,46652025,41551
"11644","ENSG00000165879","10",97319267,97321915,2648
"11645","ENSG00000165886","10",97498924,97571206,72282
"11646","ENSG00000165887","10",97572499,97583884,11385
"11647","ENSG00000165891","12",77021248,77065569,44321
"11648","ENSG00000165895","11",100687288,100993941,306653
"11649","ENSG00000165898","14",74493720,74497106,3386
"11650","ENSG00000165899","12",80099537,80380879,281342
"11651","ENSG00000165905","11",45921621,45929096,7475
"11652","ENSG00000165912","11",47177522,47186443,8921
"11653","ENSG00000165914","14",90524564,90816479,291915
"11654","ENSG00000165915","11",47407132,47416496,9364
"11655","ENSG00000165916","11",47418769,47426473,7704
"11656","ENSG00000165917","11",47437764,47449143,11379
"11657","ENSG00000165923","11",47659591,47715389,55798
"11658","ENSG00000165929","14",91779746,91867536,87790
"11659","ENSG00000165934","14",92121937,92172145,50208
"11660","ENSG00000165935","12",27466810,27502185,35375
"11661","ENSG00000165943","14",93182199,93184923,2724
"11662","ENSG00000165948","14",94081301,94103846,22545
"11663","ENSG00000165949","14",94104836,94116698,11862
"11664","ENSG00000165953","14",94487274,94517844,30570
"11665","ENSG00000165959","14",95181940,95319908,137968
"11666","ENSG00000165966","12",41188448,41574724,386276
"11667","ENSG00000165970","11",20599400,20659285,59885
"11668","ENSG00000165972","12",95867048,95942635,75587
"11669","ENSG00000165973","11",20669551,21575681,906130
"11670","ENSG00000165983","10",16436943,16513745,76802
"11671","ENSG00000165985","10",16513734,16521879,8145
"11672","ENSG00000165995","10",18140677,18543557,402880
"11673","ENSG00000165996","10",17589032,17617374,28342
"11674","ENSG00000165997","10",18659431,18681639,22208
"11675","ENSG00000166002","11",93478472,93543391,64919
"11676","ENSG00000166004","11",93661682,93730358,68676
"11677","ENSG00000166006","12",75040077,75209868,169791
"11678","ENSG00000166012","11",93729948,93784391,54443
"11679","ENSG00000166013","11",89841997,89850970,8973
"11680","ENSG00000166016","11",34150987,34358010,207023
"11681","ENSG00000166024","10",98134624,98244897,110273
"11682","ENSG00000166025","11",94706431,94876748,170317
"11683","ENSG00000166033","10",122458551,122514907,56356
"11684","ENSG00000166035","15",58410569,58569844,159275
"11685","ENSG00000166037","11",95789965,95832693,42728
"11686","ENSG00000166046","12",106301929,106347003,45074
"11687","ENSG00000166049","X",151563675,151676739,113064
"11688","ENSG00000166068","15",38252836,38357249,104413
"11689","ENSG00000166069","15",37921939,37967724,45785
"11690","ENSG00000166073","15",39799032,39920892,121860
"11691","ENSG00000166086","11",134068925,134152001,83076
"11692","ENSG00000166090","14",23372809,23376403,3594
"11693","ENSG00000166091","14",23376773,23379772,2999
"11694","ENSG00000166104","15",62227896,62253235,25339
"11695","ENSG00000166105","11",134274245,134319564,45319
"11696","ENSG00000166106","11",130448974,130476641,27667
"11697","ENSG00000166111","12",108907741,109021240,113499
"11698","ENSG00000166118","11",133840631,133845538,4907
"11699","ENSG00000166123","16",46884362,46931289,46927
"11700","ENSG00000166126","14",102922656,102933596,10940
"11701","ENSG00000166128","15",63189560,63267776,78216
"11702","ENSG00000166130","12",98613405,98645113,31708
"11703","ENSG00000166133","15",40569299,40574949,5650
"11704","ENSG00000166135","10",100529072,100559998,30926
"11705","ENSG00000166136","10",100523740,100530000,6260
"11706","ENSG00000166140","15",40807086,40815084,7998
"11707","ENSG00000166143","15",40815445,40828709,13264
"11708","ENSG00000166145","15",40844018,40858207,14189
"11709","ENSG00000166147","15",48408306,48645849,237543
"11710","ENSG00000166148","12",63142759,63150942,8183
"11711","ENSG00000166152","16",49373823,49399431,25608
"11712","ENSG00000166153","12",100203669,100267079,63410
"11713","ENSG00000166159","12",1820267,1836753,16486
"11714","ENSG00000166164","16",50313487,50368934,55447
"11715","ENSG00000166165","14",103519667,103522833,3166
"11716","ENSG00000166166","14",103529196,103537073,7877
"11717","ENSG00000166167","10",101354033,101557321,203288
"11718","ENSG00000166169","10",101578882,101588270,9388
"11719","ENSG00000166170","14",103556544,103562831,6287
"11720","ENSG00000166171","10",101570560,101609662,39102
"11721","ENSG00000166173","15",70829130,70854159,25029
"11722","ENSG00000166181","11",43311963,43344529,32566
"11723","ENSG00000166183","14",104085686,104115582,29896
"11724","ENSG00000166188","16",57994668,58000453,5785
"11725","ENSG00000166189","10",102065390,102068038,2648
"11726","ENSG00000166192","15",72114258,72143692,29434
"11727","ENSG00000166197","10",102152176,102163871,11695
"11728","ENSG00000166199","11",43880811,43920274,39463
"11729","ENSG00000166200","15",49106068,49155661,49593
"11730","ENSG00000166206","15",26543546,26939539,395993
"11731","ENSG00000166211","12",101475421,101486997,11576
"11732","ENSG00000166220","10",70771239,70785401,14162
"11733","ENSG00000166224","10",70815961,70881173,65212
"11734","ENSG00000166225","12",69470349,69579789,109440
"11735","ENSG00000166226","12",69585426,69601570,16144
"11736","ENSG00000166228","10",70882280,70888565,6285
"11737","ENSG00000166233","15",72474330,72602987,128657
"11738","ENSG00000166246","16",4734344,4749396,15052
"11739","ENSG00000166250","11",123069872,123195248,125376
"11740","ENSG00000166257","11",123629187,123655244,26057
"11741","ENSG00000166260","17",54951902,54968785,16883
"11742","ENSG00000166261","11",123723914,123741675,17761
"11743","ENSG00000166262","15",49326962,49620931,293969
"11744","ENSG00000166263","17",54968727,55173632,204905
"11745","ENSG00000166265","21",26466209,26573255,107046
"11746","ENSG00000166266","11",108008898,108107761,98863
"11747","ENSG00000166268","12",69825304,69959097,133793
"11748","ENSG00000166272","10",102743948,102834516,90568
"11749","ENSG00000166275","10",102854223,102864961,10738
"11750","ENSG00000166278","6",31897785,31945672,47887
"11751","ENSG00000166289","19",29665459,29675477,10018
"11752","ENSG00000166292","17",55719627,55732121,12494
"11753","ENSG00000166295","10",72216000,72235860,19860
"11754","ENSG00000166311","11",6390440,6394998,4558
"11755","ENSG00000166313","11",6395124,6419414,24290
"11756","ENSG00000166317","10",73644881,73663803,18922
"11757","ENSG00000166321","10",73110375,73131828,21453
"11758","ENSG00000166323","11",108308519,108467531,159012
"11759","ENSG00000166326","11",35662775,35818007,155232
"11760","ENSG00000166329","17",57744481,57745312,831
"11761","ENSG00000166333","11",6603708,6610874,7166
"11762","ENSG00000166337","11",6606294,6612539,6245
"11763","ENSG00000166340","11",6612768,6619448,6680
"11764","ENSG00000166341","11",6621330,6655809,34479
"11765","ENSG00000166342","18",72742314,72868146,125832
"11766","ENSG00000166343","10",73423579,73433561,9982
"11767","ENSG00000166347","18",74250846,74291973,41127
"11768","ENSG00000166348","10",73497538,73625953,128415
"11769","ENSG00000166349","11",36510709,36593156,82447
"11770","ENSG00000166352","11",36594493,36659290,64797
"11771","ENSG00000166359","19",33132090,33175795,43705
"11772","ENSG00000166368","11",6891490,6892599,1109
"11773","ENSG00000166377","18",79069285,79378287,309002
"11774","ENSG00000166387","11",7513298,7657127,143829
"11775","ENSG00000166391","11",75717838,75732958,15120
"11776","ENSG00000166394","11",7665100,7677222,12122
"11777","ENSG00000166396","18",63752935,63805376,52441
"11778","ENSG00000166398","19",34254537,34355586,101049
"11779","ENSG00000166401","18",63969925,64019779,49854
"11780","ENSG00000166402","11",8019244,8106112,86868
"11781","ENSG00000166405","11",8106056,8169055,62999
"11782","ENSG00000166407","11",8224309,8268716,44407
"11783","ENSG00000166408","11",7772890,7773814,924
"11784","ENSG00000166411","15",78131498,78171945,40447
"11785","ENSG00000166415","15",53513741,53762878,249137
"11786","ENSG00000166426","15",78340353,78348225,7872
"11787","ENSG00000166428","14",104924713,104937790,13077
"11788","ENSG00000166432","X",101882288,101932079,49791
"11789","ENSG00000166435","11",74807739,74949200,141461
"11790","ENSG00000166436","11",8612037,8682694,70657
"11791","ENSG00000166439","11",74748849,74842413,93564
"11792","ENSG00000166441","11",8682788,8714759,31971
"11793","ENSG00000166444","11",8693351,8910951,217600
"11794","ENSG00000166446","16",80597907,80804598,206691
"11795","ENSG00000166448","7",98846488,98870771,24283
"11796","ENSG00000166450","15",55611544,55743152,131608
"11797","ENSG00000166451","16",81006498,81033114,26616
"11798","ENSG00000166452","11",8911139,8920084,8945
"11799","ENSG00000166454","16",81035842,81047350,11508
"11800","ENSG00000166455","16",81053497,81077267,23770
"11801","ENSG00000166471","11",9280654,9314636,33982
"11802","ENSG00000166473","16",81100875,81220370,119495
"11803","ENSG00000166477","15",51938025,51971778,33753
"11804","ENSG00000166478","11",9460319,9528524,68205
"11805","ENSG00000166479","18",68673688,68715108,41420
"11806","ENSG00000166482","17",19383442,19387240,3798
"11807","ENSG00000166483","11",9573670,9593457,19787
"11808","ENSG00000166484","17",19377721,19383544,5823
"11809","ENSG00000166492","11",3410352,3422496,12144
"11810","ENSG00000166501","16",23835983,24220611,384628
"11811","ENSG00000166503","15",83112738,83207823,95085
"11812","ENSG00000166507","10",73801911,73811798,9887
"11813","ENSG00000166508","7",100092728,100101940,9212
"11814","ENSG00000166509","16",78022515,78066761,44246
"11815","ENSG00000166510","18",54901509,54959461,57952
"11816","ENSG00000166523","12",8533305,8540963,7658
"11817","ENSG00000166526","7",100064033,100082548,18515
"11818","ENSG00000166527","12",8509475,8522366,12891
"11819","ENSG00000166529","7",100049774,100065038,15264
"11820","ENSG00000166530","4",110251871,110252099,228
"11821","ENSG00000166532","12",8681600,8783095,101495
"11822","ENSG00000166535","12",8822621,8887001,64380
"11823","ENSG00000166546","16",66427295,66493529,66234
"11824","ENSG00000166548","16",66508003,66552544,44541
"11825","ENSG00000166557","15",79311112,79427432,116320
"11826","ENSG00000166558","16",84009667,84042636,32969
"11827","ENSG00000166562","18",59139866,59158832,18966
"11828","ENSG00000166569","18",59275156,59318649,43493
"11829","ENSG00000166573","18",77250549,77277896,27347
"11830","ENSG00000166575","11",87037844,87328824,290980
"11831","ENSG00000166578","12",113195441,113221094,25653
"11832","ENSG00000166579","17",8413131,8490411,77280
"11833","ENSG00000166582","17",16342534,16353656,11122
"11834","ENSG00000166589","16",66908122,66918917,10795
"11835","ENSG00000166592","16",66921679,66925536,3857
"11836","ENSG00000166595","16",66932065,66934423,2358
"11837","ENSG00000166596","17",9576627,9643447,66820
"11838","ENSG00000166598","12",103930107,103953645,23538
"11839","ENSG00000166603","18",60371062,60372775,1713
"11840","ENSG00000166619","20",37492472,37527931,35459
"11841","ENSG00000166634","18",63556160,63567011,10851
"11842","ENSG00000166664","15",30357766,30393849,36083
"11843","ENSG00000166669","16",10326434,10483638,157204
"11844","ENSG00000166670","11",102770502,102780628,10126
"11845","ENSG00000166676","16",10760919,10818794,57875
"11846","ENSG00000166681","X",103376340,103378077,1737
"11847","ENSG00000166682","11",113687547,113706373,18826
"11848","ENSG00000166685","17",73192632,73208507,15875
"11849","ENSG00000166689","11",16777297,17014414,237117
"11850","ENSG00000166704","19",57977053,58003349,26296
"11851","ENSG00000166707","X",104112131,104115846,3715
"11852","ENSG00000166710","15",44711487,44718877,7390
"11853","ENSG00000166716","15",84748592,84806445,57853
"11854","ENSG00000166734","15",44288719,44415758,127039
"11855","ENSG00000166736","11",113974881,113990313,15432
"11856","ENSG00000166741","11",114257787,114313285,55498
"11857","ENSG00000166743","16",20623237,20698890,75653
"11858","ENSG00000166747","16",71729000,71809201,80201
"11859","ENSG00000166750","17",35243071,35273655,30584
"11860","ENSG00000166762","15",43628503,43668118,39615
"11861","ENSG00000166763","15",43699488,43718184,18696
"11862","ENSG00000166770","19",56477250,56504362,27112
"11863","ENSG00000166780","16",15434475,15625028,190553
"11864","ENSG00000166783","16",15594387,15643154,48767
"11865","ENSG00000166787","11",18112472,18116132,3660
"11866","ENSG00000166788","11",18069935,18106087,36152
"11867","ENSG00000166793","11",57645087,57649944,4857
"11868","ENSG00000166794","15",64155812,64163205,7393
"11869","ENSG00000166796","11",18412318,18452063,39745
"11870","ENSG00000166797","15",64072565,64093857,21292
"11871","ENSG00000166800","11",18455824,18479600,23776
"11872","ENSG00000166801","11",59142748,59155039,12291
"11873","ENSG00000166803","15",64364304,64387687,23383
"11874","ENSG00000166813","15",89608789,89655467,46678
"11875","ENSG00000166816","16",75111860,75116771,4911
"11876","ENSG00000166819","15",89664367,89679427,15060
"11877","ENSG00000166821","15",89677764,89690783,13019
"11878","ENSG00000166822","16",75443054,75465497,22443
"11879","ENSG00000166823","15",89748661,89751310,2649
"11880","ENSG00000166825","15",89784895,89815401,30506
"11881","ENSG00000166828","16",23182745,23216883,34138
"11882","ENSG00000166831","15",64739891,64775589,35698
"11883","ENSG00000166833","11",19350724,20121601,770877
"11884","ENSG00000166839","15",64911902,64958691,46789
"11885","ENSG00000166840","11",58905398,59043527,138129
"11886","ENSG00000166845","18",54357906,54385218,27312
"11887","ENSG00000166847","16",23641466,23677472,36006
"11888","ENSG00000166848","16",75647773,75761872,114099
"11889","ENSG00000166851","16",23677656,23690367,12711
"11890","ENSG00000166855","15",65148219,65185342,37123
"11891","ENSG00000166856","12",56994492,56998447,3955
"11892","ENSG00000166860","12",56998836,57006546,7710
"11893","ENSG00000166862","22",36563921,36703558,139637
"11894","ENSG00000166863","12",57010000,57028883,18883
"11895","ENSG00000166866","12",57028517,57051198,22681
"11896","ENSG00000166869","16",23755026,23758935,3909
"11897","ENSG00000166881","12",57055643,57088063,32420
"11898","ENSG00000166884","11",59456938,59457991,1053
"11899","ENSG00000166886","12",57089043,57095476,6433
"11900","ENSG00000166887","15",42158701,42208316,49615
"11901","ENSG00000166888","12",57095408,57132139,36731
"11902","ENSG00000166889","11",59636716,59669037,32321
"11903","ENSG00000166896","12",57906039,57959148,53109
"11904","ENSG00000166897","22",37367960,37427479,59519
"11905","ENSG00000166900","11",59713456,59805882,92426
"11906","ENSG00000166902","11",59806140,59810778,4638
"11907","ENSG00000166908","12",57591174,57603418,12244
"11908","ENSG00000166912","15",30938941,30991628,52687
"11909","ENSG00000166913","20",44885702,44908532,22830
"11910","ENSG00000166917","10",133246478,133247891,1413
"11911","ENSG00000166920","15",45430529,45448761,18232
"11912","ENSG00000166922","15",32641676,32697098,55422
"11913","ENSG00000166923","15",32718004,32745106,27102
"11914","ENSG00000166924","7",100483927,100494802,10875
"11915","ENSG00000166925","7",100463359,100479232,15873
"11916","ENSG00000166926","11",60334831,60396596,61765
"11917","ENSG00000166927","11",60378485,60395951,17466
"11918","ENSG00000166928","11",60378530,60417756,39226
"11919","ENSG00000166930","11",60429572,60455214,25642
"11920","ENSG00000166938","15",66293217,66333898,40681
"11921","ENSG00000166946","15",43185118,43197177,12059
"11922","ENSG00000166947","15",43197227,43221125,23898
"11923","ENSG00000166948","20",2380908,2432753,51845
"11924","ENSG00000166949","15",67063763,67195169,131406
"11925","ENSG00000166959","11",60699585,60715807,16222
"11926","ENSG00000166960","18",32937402,33441101,503699
"11927","ENSG00000166961","11",60756953,60776732,19779
"11928","ENSG00000166963","15",43510958,43531620,20662
"11929","ENSG00000166965","15",90954870,90963125,8255
"11930","ENSG00000166971","16",53491040,53504411,13371
"11931","ENSG00000166974","18",34976928,35143470,166542
"11932","ENSG00000166979","21",32412006,32515397,103391
"11933","ENSG00000166984","6",167146414,167196913,50499
"11934","ENSG00000166986","12",57475445,57517569,42124
"11935","ENSG00000166987","12",57520710,57530148,9438
"11936","ENSG00000166997","7",100119634,100125508,5874
"11937","ENSG00000167004","15",43746410,43773278,26868
"11938","ENSG00000167005","16",56429133,56452199,23066
"11939","ENSG00000167011","7",101170496,101180293,9797
"11940","ENSG00000167014","15",44956687,44979229,22542
"11941","ENSG00000167034","8",23678697,23682938,4241
"11942","ENSG00000167037","22",24806169,24927578,121409
"11943","ENSG00000167046","20",62640719,62643304,2585
"11944","ENSG00000167065","22",30652051,30667890,15839
"11945","ENSG00000167074","22",41367333,41399326,31993
"11946","ENSG00000167077","22",41699503,41799456,99953
"11947","ENSG00000167080","17",49132460,49176840,44380
"11948","ENSG00000167081","9",125747345,125967377,220032
"11949","ENSG00000167083","17",49202791,49210574,7783
"11950","ENSG00000167085","17",49404049,49414905,10856
"11951","ENSG00000167088","18",21612314,21633524,21210
"11952","ENSG00000167094","9",127716079,127731590,15511
"11953","ENSG00000167098","20",32983773,33004433,20660
"11954","ENSG00000167100","17",50110040,50129882,19842
"11955","ENSG00000167103","9",127920881,127930785,9904
"11956","ENSG00000167104","20",33031648,33044047,12399
"11957","ENSG00000167105","17",50271406,50281485,10079
"11958","ENSG00000167106","9",127940582,127980989,40407
"11959","ENSG00000167107","17",50426158,50474845,48687
"11960","ENSG00000167110","9",128255829,128275995,20166
"11961","ENSG00000167112","9",128305159,128322447,17288
"11962","ENSG00000167113","9",128322544,128334072,11528
"11963","ENSG00000167114","9",128340527,128361470,20943
"11964","ENSG00000167117","17",50761029,50767557,6528
"11965","ENSG00000167118","9",128371319,128392016,20697
"11966","ENSG00000167123","9",128411751,128437351,25600
"11967","ENSG00000167130","9",129081111,129090438,9327
"11968","ENSG00000167131","17",44899142,44905390,6248
"11969","ENSG00000167136","9",128818500,128822676,4176
"11970","ENSG00000167139","15",73873564,73889214,15650
"11971","ENSG00000167157","9",129665647,129722674,57027
"11972","ENSG00000167165","2",233691607,233773300,81693
"11973","ENSG00000167173","15",75195643,75212169,16526
"11974","ENSG00000167178","15",74100311,74138540,38229
"11975","ENSG00000167182","17",47896150,47928957,32807
"11976","ENSG00000167183","17",47951967,47957883,5916
"11977","ENSG00000167186","16",19067614,19080095,12481
"11978","ENSG00000167191","16",19856691,19886167,29476
"11979","ENSG00000167193","17",1420689,1463162,42473
"11980","ENSG00000167194","16",30023334,30027736,4402
"11981","ENSG00000167195","15",75258599,75270199,11600
"11982","ENSG00000167196","15",75903876,75942511,38635
"11983","ENSG00000167202","15",77984036,78077724,93688
"11984","ENSG00000167207","16",50693588,50734041,40453
"11985","ENSG00000167208","16",50666300,50681353,15053
"11986","ENSG00000167210","18",46476972,46657220,180248
"11987","ENSG00000167216","18",46917492,47102243,184751
"11988","ENSG00000167220","18",47107408,47150500,43092
"11989","ENSG00000167232","19",23304991,23395471,90480
"11990","ENSG00000167244","11",2129112,2141238,12126
"11991","ENSG00000167257","11",117232625,117286454,53829
"11992","ENSG00000167258","17",39461486,39564907,103421
"11993","ENSG00000167261","16",67987394,68000586,13192
"11994","ENSG00000167264","16",67987746,68079320,91574
"11995","ENSG00000167272","12",120578764,120581398,2634
"11996","ENSG00000167280","17",79074939,79088599,13660
"11997","ENSG00000167281","17",79089345,79516148,426803
"11998","ENSG00000167283","11",118401606,118431496,29890
"11999","ENSG00000167286","11",118338954,118342744,3790
"12000","ENSG00000167291","17",79932343,80035872,103529
"12001","ENSG00000167302","17",81228277,81239091,10814
"12002","ENSG00000167306","18",49822789,50195147,372358
"12003","ENSG00000167311","11",3638503,3642316,3813
"12004","ENSG00000167315","18",49782164,49813953,31789
"12005","ENSG00000167323","11",3854527,4093210,238683
"12006","ENSG00000167325","11",4094707,4138932,44225
"12007","ENSG00000167332","11",4680171,4697854,17683
"12008","ENSG00000167333","11",4598672,4608231,9559
"12009","ENSG00000167346","11",4704927,4992429,287502
"12010","ENSG00000167355","11",5303444,5505652,202208
"12011","ENSG00000167359","11",5440570,5441514,944
"12012","ENSG00000167360","11",5422111,5423206,1095
"12013","ENSG00000167363","17",82735615,82751196,15581
"12014","ENSG00000167371","16",29811382,29815892,4510
"12015","ENSG00000167377","16",71447597,71463095,15498
"12016","ENSG00000167378","19",43584369,43596135,11766
"12017","ENSG00000167380","19",44165073,44178381,13308
"12018","ENSG00000167384","19",44474428,44500524,26096
"12019","ENSG00000167390","20",23989292,23990454,1162
"12020","ENSG00000167393","X",333963,386955,52992
"12021","ENSG00000167394","16",31060843,31074240,13397
"12022","ENSG00000167395","16",31074422,31084196,9774
"12023","ENSG00000167397","16",31090842,31095980,5138
"12024","ENSG00000167414","19",46634076,46634685,609
"12025","ENSG00000167419","17",58218548,58268518,49970
"12026","ENSG00000167434","17",60149942,60170899,20957
"12027","ENSG00000167447","17",59209400,59215247,5847
"12028","ENSG00000167459","19",16031170,16042142,10972
"12029","ENSG00000167460","19",16067021,16103002,35981
"12030","ENSG00000167461","19",16111889,16134234,22345
"12031","ENSG00000167468","19",1103926,1106791,2865
"12032","ENSG00000167470","19",1248553,1259140,10587
"12033","ENSG00000167476","19",2252252,2269759,17507
"12034","ENSG00000167483","19",17523301,17553839,30538
"12035","ENSG00000167487","19",18637025,18671721,34696
"12036","ENSG00000167491","19",19385826,19508931,123105
"12037","ENSG00000167494","17",18497095,18506313,9218
"12038","ENSG00000167508","16",88651935,88663161,11226
"12039","ENSG00000167513","16",88803789,88809258,5469
"12040","ENSG00000167515","16",88856220,88862686,6466
"12041","ENSG00000167522","16",89267630,89490561,222931
"12042","ENSG00000167523","16",89657802,89671272,13470
"12043","ENSG00000167524","17",28607964,28614200,6236
"12044","ENSG00000167525","17",28703197,28711854,8657
"12045","ENSG00000167526","16",89560657,89566828,6171
"12046","ENSG00000167528","12",48337180,48351414,14234
"12047","ENSG00000167531","12",48567684,48570066,2382
"12048","ENSG00000167535","12",48813794,48828941,15147
"12049","ENSG00000167536","17",28897781,28903079,5298
"12050","ENSG00000167543","17",29566052,29573157,7105
"12051","ENSG00000167548","12",49018975,49059774,40799
"12052","ENSG00000167549","17",29614756,29622907,8151
"12053","ENSG00000167550","12",49064676,49070025,5349
"12054","ENSG00000167552","12",49184795,49189080,4285
"12055","ENSG00000167553","12",49188736,49274603,85867
"12056","ENSG00000167554","19",52336243,52367778,31535
"12057","ENSG00000167555","19",52397849,52418412,20563
"12058","ENSG00000167562","19",52555457,52587174,31717
"12059","ENSG00000167565","19",40440844,40444335,3491
"12060","ENSG00000167566","12",49791146,49828750,37604
"12061","ENSG00000167578","19",40778216,40796942,18726
"12062","ENSG00000167580","12",49950741,49958881,8140
"12063","ENSG00000167588","12",50103982,50111313,7331
"12064","ENSG00000167595","19",35758143,35771028,12885
"12065","ENSG00000167600","19",41193210,41207539,14329
"12066","ENSG00000167601","19",41219223,41261766,42543
"12067","ENSG00000167604","19",35887653,35902303,14650
"12068","ENSG00000167608","19",54160108,54173250,13142
"12069","ENSG00000167612","12",51888009,51891727,3718
"12070","ENSG00000167613","19",54351384,54370558,19174
"12071","ENSG00000167614","19",54415219,54436900,21681
"12072","ENSG00000167615","19",54448887,54462037,13150
"12073","ENSG00000167617","19",54465026,54473296,8270
"12074","ENSG00000167618","19",54497879,54510687,12808
"12075","ENSG00000167619","19",42313309,42325064,11755
"12076","ENSG00000167625","19",42220271,42228201,7930
"12077","ENSG00000167632","8",139727725,140458579,730854
"12078","ENSG00000167633","19",54816468,54830778,14310
"12079","ENSG00000167634","19",54923509,54966312,42803
"12080","ENSG00000167635","19",36214602,36238774,24172
"12081","ENSG00000167637","19",43827321,43852017,24696
"12082","ENSG00000167641","19",38251237,38256532,5295
"12083","ENSG00000167642","19",38244035,38292615,48580
"12084","ENSG00000167644","19",38304164,38305006,842
"12085","ENSG00000167645","19",38303558,38317273,13715
"12086","ENSG00000167646","19",55158661,55166722,8061
"12087","ENSG00000167653","8",142670308,142682725,12417
"12088","ENSG00000167654","19",3879864,3928082,48218
"12089","ENSG00000167656","8",142784882,142786539,1657
"12090","ENSG00000167657","19",3958453,3971123,12670
"12091","ENSG00000167658","19",3976056,3985463,9407
"12092","ENSG00000167664","19",4292232,4302431,10199
"12093","ENSG00000167670","19",4402640,4445018,42378
"12094","ENSG00000167671","19",4444999,4457794,12795
"12095","ENSG00000167674","19",4472297,4502208,29911
"12096","ENSG00000167676","19",4502180,4518465,16285
"12097","ENSG00000167680","19",4542593,4559684,17091
"12098","ENSG00000167685","19",56132599,56160893,28294
"12099","ENSG00000167693","17",799310,979776,180466
"12100","ENSG00000167695","17",732412,742968,10556
"12101","ENSG00000167699","17",757097,783390,26293
"12102","ENSG00000167700","8",144509070,144511213,2143
"12103","ENSG00000167701","8",144502973,144507174,4201
"12104","ENSG00000167702","8",144466043,144474202,8159
"12105","ENSG00000167703","17",1569267,1628886,59619
"12106","ENSG00000167705","17",1646145,1649866,3721
"12107","ENSG00000167711","17",1742836,1755268,12432
"12108","ENSG00000167716","17",1716523,1738599,22076
"12109","ENSG00000167720","17",2303383,2325260,21877
"12110","ENSG00000167721","17",2322503,2337507,15004
"12111","ENSG00000167723","17",3510502,3557995,47493
"12112","ENSG00000167733","19",5680604,5688523,7919
"12113","ENSG00000167740","17",4143168,4187310,44142
"12114","ENSG00000167741","17",4556927,4560818,3891
"12115","ENSG00000167747","19",50797704,50804929,7225
"12116","ENSG00000167748","19",50819146,50823787,4641
"12117","ENSG00000167749","19",50906352,50910738,4386
"12118","ENSG00000167751","19",50861568,50880567,18999
"12119","ENSG00000167754","19",50943303,50953093,9790
"12120","ENSG00000167755","19",50958631,50969673,11042
"12121","ENSG00000167757","19",51022216,51028039,5823
"12122","ENSG00000167759","19",51055626,51065114,9488
"12123","ENSG00000167766","19",52594060,52690496,96436
"12124","ENSG00000167767","12",52168996,52192014,23018
"12125","ENSG00000167768","12",52674736,52680407,5671
"12126","ENSG00000167769","19",6306142,6333629,27487
"12127","ENSG00000167770","11",63985853,64001811,15958
"12128","ENSG00000167771","11",63911230,63917164,5934
"12129","ENSG00000167772","19",8363289,8374370,11081
"12130","ENSG00000167774","19",8308283,8321379,13096
"12131","ENSG00000167775","19",8302127,8308358,6231
"12132","ENSG00000167778","12",53064316,53079404,15088
"12133","ENSG00000167779","12",53097436,53102345,4909
"12134","ENSG00000167780","12",53103486,53124535,21049
"12135","ENSG00000167785","19",8806170,8832314,26144
"12136","ENSG00000167792","11",67605653,67612554,6901
"12137","ENSG00000167797","11",67506497,67508649,2152
"12138","ENSG00000167798","19",10037803,10074135,36332
"12139","ENSG00000167799","11",67627938,67629937,1999
"12140","ENSG00000167800","11",67631303,67639560,8257
"12141","ENSG00000167807","19",10305427,10316009,10582
"12142","ENSG00000167815","19",12796820,12801800,4980
"12143","ENSG00000167822","11",56134721,56140201,5480
"12144","ENSG00000167840","17",5105541,5123116,17575
"12145","ENSG00000167842","17",5486285,5490814,4529
"12146","ENSG00000167850","17",74541108,74546143,5035
"12147","ENSG00000167851","17",74466399,74484796,18397
"12148","ENSG00000167858","17",6789133,6831761,42628
"12149","ENSG00000167861","17",74950742,74973166,22424
"12150","ENSG00000167862","17",75012670,75021261,8591
"12151","ENSG00000167863","17",75038863,75046985,8122
"12152","ENSG00000167874","17",7855065,7856099,1034
"12153","ENSG00000167880","17",76004502,76027452,22950
"12154","ENSG00000167881","17",76038775,76072517,33742
"12155","ENSG00000167889","17",76868456,76950393,81937
"12156","ENSG00000167895","17",78130770,78142968,12198
"12157","ENSG00000167900","17",78174091,78187233,13142
"12158","ENSG00000167904","8",55696424,55773407,76983
"12159","ENSG00000167910","8",58490178,58500163,9985
"12160","ENSG00000167912","8",59119040,59123478,4438
"12161","ENSG00000167914","17",39953263,39977766,24503
"12162","ENSG00000167916","17",40697991,40703752,5761
"12163","ENSG00000167920","17",40819106,40836274,17168
"12164","ENSG00000167925","17",42188799,42194532,5733
"12165","ENSG00000167930","16",234521,272183,37662
"12166","ENSG00000167941","17",43753738,43758791,5053
"12167","ENSG00000167962","16",1997654,2009821,12167
"12168","ENSG00000167964","16",2140803,2154165,13362
"12169","ENSG00000167965","16",2204248,2209453,5205
"12170","ENSG00000167967","16",2223580,2235742,12162
"12171","ENSG00000167968","16",2235816,2238711,2895
"12172","ENSG00000167969","16",2239402,2252300,12898
"12173","ENSG00000167971","16",2177180,2196525,19345
"12174","ENSG00000167972","16",2275881,2340746,64865
"12175","ENSG00000167977","16",2682523,2709030,26507
"12176","ENSG00000167978","16",2752626,2772538,19912
"12177","ENSG00000167981","16",3432414,3443504,11090
"12178","ENSG00000167984","16",3539033,3577403,38370
"12179","ENSG00000167985","11",61430042,61447529,17487
"12180","ENSG00000167986","11",61299451,61342596,43145
"12181","ENSG00000167987","11",61130257,61161615,31358
"12182","ENSG00000167992","11",61258286,61295316,37030
"12183","ENSG00000167994","11",61897301,61920269,22968
"12184","ENSG00000167995","11",61950063,61965515,15452
"12185","ENSG00000167996","11",61959718,61967634,7916
"12186","ENSG00000168000","11",62690275,62709845,19570
"12187","ENSG00000168002","11",62761565,62766710,5145
"12188","ENSG00000168003","11",62856102,62888875,32773
"12189","ENSG00000168004","11",63461404,63491194,29790
"12190","ENSG00000168005","11",63813456,63827716,14260
"12191","ENSG00000168010","11",72814406,72843674,29268
"12192","ENSG00000168014","11",74012714,74171210,158496
"12193","ENSG00000168016","3",36826820,36945098,118278
"12194","ENSG00000168026","3",39107704,39138903,31199
"12195","ENSG00000168028","3",39406716,39412542,5826
"12196","ENSG00000168032","3",40387156,40428744,41588
"12197","ENSG00000168036","3",41194741,41260096,65355
"12198","ENSG00000168038","3",41246599,41962130,715531
"12199","ENSG00000168040","11",70203163,70207390,4227
"12200","ENSG00000168056","11",65538805,65558930,20125
"12201","ENSG00000168060","11",65044818,65058553,13735
"12202","ENSG00000168061","11",65040901,65044828,3927
"12203","ENSG00000168062","11",64987945,64997018,9073
"12204","ENSG00000168065","11",64555626,64572875,17249
"12205","ENSG00000168066","11",64764606,64778786,14180
"12206","ENSG00000168067","11",64784918,64803241,18323
"12207","ENSG00000168070","11",64937517,64972108,34591
"12208","ENSG00000168071","11",64340204,64357534,17330
"12209","ENSG00000168077","8",27633868,27676776,42908
"12210","ENSG00000168078","8",27809624,27838082,28458
"12211","ENSG00000168079","8",27869883,27992673,122790
"12212","ENSG00000168081","8",28316986,28343355,26369
"12213","ENSG00000168090","7",100088969,100092187,3218
"12214","ENSG00000168092","11",117144284,117176894,32610
"12215","ENSG00000168096","16",4696510,4734378,37868
"12216","ENSG00000168101","16",4693694,4695859,2165
"12217","ENSG00000168116","6",57046532,57055239,8707
"12218","ENSG00000168118","1",229271062,229305894,34832
"12219","ENSG00000168122","21",13095305,13113790,18485
"12220","ENSG00000168124","16",3204247,3205188,941
"12221","ENSG00000168126","6",27937465,27938403,938
"12222","ENSG00000168129","2",82856826,82857384,558
"12223","ENSG00000168131","6",27911185,27912396,1211
"12224","ENSG00000168135","22",38426327,38455199,28872
"12225","ENSG00000168137","3",9397615,9479240,81625
"12226","ENSG00000168140","16",4371848,4383538,11690
"12227","ENSG00000168143","6",54846771,54945099,98328
"12228","ENSG00000168148","1",228424845,228425325,480
"12229","ENSG00000168152","4",82900684,82919969,19285
"12230","ENSG00000168158","16",3355889,3357294,1405
"12231","ENSG00000168159","1",228487382,228496188,8806
"12232","ENSG00000168172","8",42896946,43030535,133589
"12233","ENSG00000168175","14",55051647,55070194,18547
"12234","ENSG00000168209","10",72273924,72276036,2112
"12235","ENSG00000168214","4",26163455,26435131,271676
"12236","ENSG00000168216","6",69672757,69867236,194479
"12237","ENSG00000168228","4",25312774,25370383,57609
"12238","ENSG00000168229","14",52267713,52276724,9011
"12239","ENSG00000168234","18",23992773,24135610,142837
"12240","ENSG00000168237","3",52287089,52295257,8168
"12241","ENSG00000168243","1",235547685,235650754,103069
"12242","ENSG00000168246","5",172209646,172283764,74118
"12243","ENSG00000168255","7",102537918,102572653,34735
"12244","ENSG00000168256","17",42011382,42025644,14262
"12245","ENSG00000168259","17",41976435,42021376,44941
"12246","ENSG00000168263","9",2717510,2730037,12527
"12247","ENSG00000168264","1",234604269,234609525,5256
"12248","ENSG00000168267","10",23192327,23194252,1925
"12249","ENSG00000168268","3",52524385,52535054,10669
"12250","ENSG00000168269","5",170105897,170109734,3837
"12251","ENSG00000168273","3",52534013,52579237,45224
"12252","ENSG00000168275","1",234373456,234385068,11612
"12253","ENSG00000168280","2",148875227,149026759,151532
"12254","ENSG00000168282","14",49620795,49623481,2686
"12255","ENSG00000168283","10",22321099,22331484,10385
"12256","ENSG00000168286","16",67842082,67844195,2113
"12257","ENSG00000168288","2",149569637,149587778,18141
"12258","ENSG00000168291","3",58427630,58433857,6227
"12259","ENSG00000168297","3",58332880,58426126,93246
"12260","ENSG00000168298","6",26156354,26157107,753
"12261","ENSG00000168300","8",51817575,51899186,81611
"12262","ENSG00000168301","3",58492096,58502360,10264
"12263","ENSG00000168303","7",40126023,40134652,8629
"12264","ENSG00000168306","3",58505136,58537283,32147
"12265","ENSG00000168309","3",58564117,58627610,63493
"12266","ENSG00000168310","4",184387729,184474550,86821
"12267","ENSG00000168314","3",39467198,39529479,62281
"12268","ENSG00000168329","3",39263494,39281735,18241
"12269","ENSG00000168333","8",49054311,49076090,21779
"12270","ENSG00000168334","3",39183210,39192596,9386
"12271","ENSG00000168348","14",35534164,35537054,2890
"12272","ENSG00000168350","14",100143957,100159645,15688
"12273","ENSG00000168356","3",38845767,39051941,206174
"12274","ENSG00000168367","16",86331632,86349688,18056
"12275","ENSG00000168374","3",57571363,57598220,26857
"12276","ENSG00000168385","2",241315100,241354027,38927
"12277","ENSG00000168386","3",99830141,100114513,284372
"12278","ENSG00000168389","1",39955112,39969968,14856
"12279","ENSG00000168393","2",241675747,241686944,11197
"12280","ENSG00000168394","6",32845209,32853978,8769
"12281","ENSG00000168395","2",241687085,241729478,42393
"12282","ENSG00000168397","2",241637213,241673857,36644
"12283","ENSG00000168398","14",96204679,96244166,39487
"12284","ENSG00000168404","16",74671855,74700960,29105
"12285","ENSG00000168405","6",25061626,25452263,390637
"12286","ENSG00000168411","16",74621399,74666877,45478
"12287","ENSG00000168412","4",186533655,186555567,21912
"12288","ENSG00000168418","16",84218667,84239750,21083
"12289","ENSG00000168421","4",40191053,40246967,55914
"12290","ENSG00000168427","2",238138668,238152947,14279
"12291","ENSG00000168434","16",23388493,23453189,64696
"12292","ENSG00000168438","6",110180141,110254275,74134
"12293","ENSG00000168439","11",64185272,64204543,19271
"12294","ENSG00000168447","16",23278231,23381294,103063
"12295","ENSG00000168453","8",22114419,22133384,18965
"12296","ENSG00000168454","18",9885726,9889275,3549
"12297","ENSG00000168461","18",9708275,9862551,154276
"12298","ENSG00000168476","8",22138020,22141951,3931
"12299","ENSG00000168477","6",32041153,32115334,74181
"12300","ENSG00000168481","8",22146830,22157084,10254
"12301","ENSG00000168484","8",22156913,22164479,7566
"12302","ENSG00000168487","8",22165140,22212326,47186
"12303","ENSG00000168488","16",28823035,28837237,14202
"12304","ENSG00000168490","8",22219703,22232101,12398
"12305","ENSG00000168491","4",185445182,185471752,26570
"12306","ENSG00000168495","8",22245133,22254601,9468
"12307","ENSG00000168496","11",61792911,61797238,4327
"12308","ENSG00000168497","2",191834310,191847088,12778
"12309","ENSG00000168502","18",8705661,8832778,127117
"12310","ENSG00000168505","2",236165236,236168386,3150
"12311","ENSG00000168509","1",146017468,146036746,19278
"12312","ENSG00000168515","11",62190216,62193539,3323
"12313","ENSG00000168517","17",45160700,45170040,9340
"12314","ENSG00000168522","8",43034194,43085788,51594
"12315","ENSG00000168528","1",31409565,31434680,25115
"12316","ENSG00000168530","2",210290150,210315174,25024
"12317","ENSG00000168538","4",183659267,183713594,54327
"12318","ENSG00000168539","11",62908679,62921807,13128
"12319","ENSG00000168542","2",188974320,189012746,38426
"12320","ENSG00000168546","8",21690398,21812357,121959
"12321","ENSG00000168556","4",183505058,183512429,7371
"12322","ENSG00000168564","4",183444635,183449064,4429
"12323","ENSG00000168566","6",7590198,7611967,21769
"12324","ENSG00000168569","11",62771629,62792021,20392
"12325","ENSG00000168575","8",42416475,42541926,125451
"12326","ENSG00000168582","2",208160740,208163576,2836
"12327","ENSG00000168589","16",80540734,80550811,10077
"12328","ENSG00000168591","17",44186970,44191929,4959
"12329","ENSG00000168594","4",174829668,174978180,148512
"12330","ENSG00000168610","17",42313324,42388568,75244
"12331","ENSG00000168612","20",45881227,45885266,4039
"12332","ENSG00000168615","8",38996869,39105261,108392
"12333","ENSG00000168619","8",39584489,39730065,145576
"12334","ENSG00000168621","5",37812677,37840041,27364
"12335","ENSG00000168630","20",45749920,45750074,154
"12336","ENSG00000168631","6",30934523,30954221,19698
"12337","ENSG00000168634","20",45702038,45708817,6779
"12338","ENSG00000168646","17",65528563,65561648,33085
"12339","ENSG00000168653","1",39026318,39034636,8318
"12340","ENSG00000168658","2",98087116,98313299,226183
"12341","ENSG00000168661","19",34926903,34945170,18267
"12342","ENSG00000168671","5",36035021,36071358,36337
"12343","ENSG00000168672","8",126552443,126558478,6035
"12344","ENSG00000168675","18",13217498,13652755,435257
"12345","ENSG00000168676","16",67289428,67326760,37332
"12346","ENSG00000168679","1",110362851,110391082,28231
"12347","ENSG00000168685","5",35852695,35879603,26908
"12348","ENSG00000168701","16",67227103,67229278,2175
"12349","ENSG00000168702","2",140231423,142131701,1900278
"12350","ENSG00000168703","20",45123425,45124465,1040
"12351","ENSG00000168710","1",109984765,110023742,38977
"12352","ENSG00000168724","5",34929559,34958964,29405
"12353","ENSG00000168734","20",44531785,44624247,92462
"12354","ENSG00000168743","4",105894775,106004027,109252
"12355","ENSG00000168746","20",44436172,44465349,29177
"12356","ENSG00000168748","16",66844414,66854153,9739
"12357","ENSG00000168754","2",96875882,96986580,110698
"12358","ENSG00000168757","Y",6246223,6249019,2796
"12359","ENSG00000168758","2",96859718,96870757,11039
"12360","ENSG00000168763","2",96816245,96835382,19137
"12361","ENSG00000168765","1",109656099,109674836,18737
"12362","ENSG00000168769","4",105145875,105279816,133941
"12363","ENSG00000168772","4",104468308,104494901,26593
"12364","ENSG00000168778","12",123671113,123708399,37286
"12365","ENSG00000168779","3",158095954,158106503,10549
"12366","ENSG00000168781","15",43533462,43590253,56791
"12367","ENSG00000168785","4",98470367,98658611,188244
"12368","ENSG00000168792","17",29560547,29567037,6490
"12369","ENSG00000168795","9",37438102,37465450,27348
"12370","ENSG00000168802","16",69118010,69132578,14568
"12371","ENSG00000168803","15",43330657,43354555,23898
"12372","ENSG00000168806","15",43323649,43330605,6956
"12373","ENSG00000168807","16",69187129,69309052,121923
"12374","ENSG00000168811","3",159988835,159996019,7184
"12375","ENSG00000168813","19",32345594,32387667,42073
"12376","ENSG00000168818","4",4415742,4542346,126604
"12377","ENSG00000168824","4",4348140,4419058,70918
"12378","ENSG00000168826","4",4290251,4321786,31535
"12379","ENSG00000168827","3",158644278,158692575,48297
"12380","ENSG00000168828","9",35869263,35870601,1338
"12381","ENSG00000168830","6",86937528,87016679,79151
"12382","ENSG00000168843","4",161383897,162164004,780107
"12383","ENSG00000168852","13",40812309,40921749,109440
"12384","ENSG00000168872","16",70346861,70373383,26522
"12385","ENSG00000168874","2",85751344,85791383,40039
"12386","ENSG00000168875","3",137764284,137766338,2054
"12387","ENSG00000168876","11",94493979,94499578,5599
"12388","ENSG00000168878","2",85657314,85668741,11427
"12389","ENSG00000168883","2",85602856,85649283,46427
"12390","ENSG00000168884","4",2741648,2756376,14728
"12391","ENSG00000168887","2",85605254,85612066,6812
"12392","ENSG00000168890","2",85598547,85603196,4649
"12393","ENSG00000168894","2",85595725,85597613,1888
"12394","ENSG00000168899","2",85584431,85593406,8975
"12395","ENSG00000168903","5",180988845,181006727,17882
"12396","ENSG00000168904","15",99251362,99390729,139367
"12397","ENSG00000168906","2",85539168,85545281,6113
"12398","ENSG00000168907","15",42139034,42156636,17602
"12399","ENSG00000168913","9",34521043,34522990,1947
"12400","ENSG00000168916","5",124636913,124748807,111894
"12401","ENSG00000168917","3",136818647,136855888,37241
"12402","ENSG00000168918","2",233059967,233207903,147936
"12403","ENSG00000168924","4",1811479,1856156,44677
"12404","ENSG00000168925","16",75219000,75226338,7338
"12405","ENSG00000168928","16",75204103,75207161,3058
"12406","ENSG00000168930","11",89797655,89808575,10920
"12407","ENSG00000168936","4",1715952,1721358,5406
"12408","ENSG00000168938","5",123023250,123036741,13491
"12409","ENSG00000168939","X",155767812,155782459,14647
"12410","ENSG00000168944","5",123344885,123423592,78707
"12411","ENSG00000168952","14",24809656,25050297,240641
"12412","ENSG00000168955","2",227362156,227381995,19839
"12413","ENSG00000168958","2",227325151,227357836,32685
"12414","ENSG00000168959","11",88504576,89065945,561369
"12415","ENSG00000168961","17",27629798,27649560,19762
"12416","ENSG00000168967","5",22142352,22152356,10004
"12417","ENSG00000168970","15",41828095,41848155,20060
"12418","ENSG00000168992","2",95546531,95547545,1014
"12419","ENSG00000168993","4",784957,826129,41172
"12420","ENSG00000168994","6",3722614,3752026,29412
"12421","ENSG00000168995","19",51142299,51153526,11227
"12422","ENSG00000169006","2",11658178,11670195,12017
"12423","ENSG00000169016","2",11444375,11466177,21802
"12424","ENSG00000169018","15",68277745,68295862,18117
"12425","ENSG00000169019","4",47450787,47463702,12915
"12426","ENSG00000169020","4",672436,674330,1894
"12427","ENSG00000169021","19",29205320,29213151,7831
"12428","ENSG00000169026","4",681829,689441,7612
"12429","ENSG00000169031","2",227164565,227314792,150227
"12430","ENSG00000169032","15",66386817,66492312,105495
"12431","ENSG00000169035","19",50976468,50984099,7631
"12432","ENSG00000169040","5",71375786,71385993,10207
"12433","ENSG00000169045","5",179614178,179634784,20606
"12434","ENSG00000169047","2",226731317,226799759,68442
"12435","ENSG00000169057","X",154021573,154137103,115530
"12436","ENSG00000169059","X",6533618,6535118,1500
"12437","ENSG00000169062","13",114281601,114305817,24216
"12438","ENSG00000169064","3",167240287,167381346,141059
"12439","ENSG00000169067","5",57480018,57482811,2793
"12440","ENSG00000169071","9",91563091,91950228,387137
"12441","ENSG00000169075","6",118501430,118502906,1476
"12442","ENSG00000169083","X",67544021,67730619,186598
"12443","ENSG00000169084","X",2219516,2502805,283289
"12444","ENSG00000169085","8",66493520,66518524,25004
"12445","ENSG00000169087","3",122739999,122793831,53832
"12446","ENSG00000169093","X",1403139,1453762,50623
"12447","ENSG00000169100","X",1386152,1392113,5961
"12448","ENSG00000169105","15",40470998,40474571,3573
"12449","ENSG00000169116","4",74933095,75050115,117020
"12450","ENSG00000169118","15",64165525,64356173,190648
"12451","ENSG00000169122","8",57994509,58204279,209770
"12452","ENSG00000169126","10",27812164,27999048,186884
"12453","ENSG00000169129","10",114294824,114404756,109932
"12454","ENSG00000169131","5",178711512,178730659,19147
"12455","ENSG00000169136","19",49928702,49933935,5233
"12456","ENSG00000169139","8",48008415,48064708,56293
"12457","ENSG00000169154","8",37934281,37940124,5843
"12458","ENSG00000169155","9",126805006,126838210,33204
"12459","ENSG00000169164","X",55654709,55657014,2305
"12460","ENSG00000169169","19",49690898,49713731,22833
"12461","ENSG00000169174","1",55039548,55064852,25304
"12462","ENSG00000169180","16",28097979,28211920,113941
"12463","ENSG00000169181","16",27787528,28063714,276186
"12464","ENSG00000169184","22",27748277,27801756,53479
"12465","ENSG00000169188","X",55000363,55009057,8694
"12466","ENSG00000169189","16",27224994,27268772,43778
"12467","ENSG00000169193","7",23597382,23644708,47326
"12468","ENSG00000169194","5",132656263,132661110,4847
"12469","ENSG00000169203","16",29483642,29505999,22357
"12470","ENSG00000169213","1",51907956,51990700,82744
"12471","ENSG00000169214","1",247711436,247716646,5210
"12472","ENSG00000169217","16",30350773,30355308,4535
"12473","ENSG00000169218","1",37611350,37634892,23542
"12474","ENSG00000169220","5",177357924,177372596,14672
"12475","ENSG00000169221","16",30357102,30370494,13392
"12476","ENSG00000169223","5",177331567,177351668,20101
"12477","ENSG00000169224","1",247507058,247577690,70632
"12478","ENSG00000169228","5",177301198,177303744,2546
"12479","ENSG00000169230","5",177303799,177306949,3150
"12480","ENSG00000169231","1",155195588,155209051,13463
"12481","ENSG00000169239","X",15688830,15788411,99581
"12482","ENSG00000169241","1",155135344,155138857,3513
"12483","ENSG00000169242","1",155127876,155134899,7023
"12484","ENSG00000169245","4",76021118,76023497,2379
"12485","ENSG00000169246","16",21402237,21448567,46330
"12486","ENSG00000169247","5",148923639,149063163,139524
"12487","ENSG00000169248","4",76033682,76041415,7733
"12488","ENSG00000169249","X",15790472,15823260,32788
"12489","ENSG00000169251","3",161104696,161253532,148836
"12490","ENSG00000169252","5",148825245,148828687,3442
"12491","ENSG00000169253","9",108626833,108627150,317
"12492","ENSG00000169255","3",161083883,161105411,21528
"12493","ENSG00000169258","5",176595802,176610156,14354
"12494","ENSG00000169271","5",54455699,54456377,678
"12495","ENSG00000169282","3",156037701,156539138,501437
"12496","ENSG00000169288","4",77862830,77952785,89955
"12497","ENSG00000169291","1",154469772,154502412,32640
"12498","ENSG00000169297","X",30304206,30309598,5392
"12499","ENSG00000169299","4",37826660,37862937,36277
"12500","ENSG00000169302","5",147234963,147387855,152892
"12501","ENSG00000169306","X",28587399,29956723,1369324
"12502","ENSG00000169313","3",151337380,151384812,47432
"12503","ENSG00000169314","22",23763021,23765861,2840
"12504","ENSG00000169325","7",57200825,57203597,2772
"12505","ENSG00000169327","14",21148370,21159060,10690
"12506","ENSG00000169330","15",79432516,79472290,39774
"12507","ENSG00000169340","16",20359170,20404737,45567
"12508","ENSG00000169344","16",20333052,20356301,23249
"12509","ENSG00000169347","16",20309572,20327808,18236
"12510","ENSG00000169359","3",155821024,155854456,33432
"12511","ENSG00000169371","15",75598083,75626469,28386
"12512","ENSG00000169372","12",93677375,93894840,217465
"12513","ENSG00000169375","15",75369379,75455842,86463
"12514","ENSG00000169379","3",93980139,94055668,75529
"12515","ENSG00000169385","14",20955487,20956436,949
"12516","ENSG00000169393","19",47994632,48025154,30522
"12517","ENSG00000169397","14",20891399,20892348,949
"12518","ENSG00000169398","8",140657900,141002216,344316
"12519","ENSG00000169402","7",6754109,6799365,45256
"12520","ENSG00000169403","1",28147166,28193936,46770
"12521","ENSG00000169410","15",75463251,75579289,116038
"12522","ENSG00000169413","14",20781268,20782467,1199
"12523","ENSG00000169418","1",153678688,153693992,15304
"12524","ENSG00000169427","8",139600838,139704109,103271
"12525","ENSG00000169429","4",73740541,73743716,3175
"12526","ENSG00000169432","2",166195185,166376001,180816
"12527","ENSG00000169435","4",73571550,73620631,49081
"12528","ENSG00000169436","8",138588235,138914041,325806
"12529","ENSG00000169439","8",96493813,96611790,117977
"12530","ENSG00000169442","1",26317958,26320523,2565
"12531","ENSG00000169446","X",135962070,135974063,11993
"12532","ENSG00000169469","1",153031203,153032900,1697
"12533","ENSG00000169474","1",152985231,152985500,269
"12534","ENSG00000169488","14",19975444,19976659,1215
"12535","ENSG00000169490","8",38988808,38996824,8016
"12536","ENSG00000169495","8",38974228,38988663,14435
"12537","ENSG00000169499","8",38901235,38973912,72677
"12538","ENSG00000169504","1",24745382,24844321,98939
"12539","ENSG00000169507","2",164896186,164955525,59339
"12540","ENSG00000169508","13",99294539,99307399,12860
"12541","ENSG00000169509","1",152514482,152516008,1526
"12542","ENSG00000169515","19",46410329,46413564,3235
"12543","ENSG00000169519","11",28108248,28527041,418793
"12544","ENSG00000169548","22",22513736,22520270,6534
"12545","ENSG00000169550","11",26559032,26572263,13231
"12546","ENSG00000169551","X",135156536,135171398,14862
"12547","ENSG00000169554","2",144364364,144521057,156693
"12548","ENSG00000169562","X",71215194,71225215,10021
"12549","ENSG00000169564","2",70087454,70089203,1749
"12550","ENSG00000169567","5",131159027,131171735,12708
"12551","ENSG00000169570","5",118836074,118988547,152473
"12552","ENSG00000169575","22",22244675,22245515,840
"12553","ENSG00000169583","9",136994635,136996803,2168
"12554","ENSG00000169592","16",29995715,30005793,10078
"12555","ENSG00000169594","15",83255903,83284714,28811
"12556","ENSG00000169598","1",3857267,3885429,28162
"12557","ENSG00000169599","2",69395750,69437628,41878
"12558","ENSG00000169604","2",69013178,69249327,236149
"12559","ENSG00000169605","2",68974573,68980974,6401
"12560","ENSG00000169607","2",112736349,112764664,28315
"12561","ENSG00000169609","15",82988441,83011641,23200
"12562","ENSG00000169612","15",82986210,82991057,4847
"12563","ENSG00000169618","2",68643589,68658247,14658
"12564","ENSG00000169621","2",68467572,68655862,188290
"12565","ENSG00000169627","16",30192934,30194306,1372
"12566","ENSG00000169629","2",112370092,112434488,64396
"12567","ENSG00000169635","22",21417371,21451463,34092
"12568","ENSG00000169641","1",23084023,23177808,93785
"12569","ENSG00000169660","17",82418318,82442645,24327
"12570","ENSG00000169662","22",21290760,21294586,3826
"12571","ENSG00000169668","22",21103016,21122285,19269
"12572","ENSG00000169676","4",9781680,9784009,2329
"12573","ENSG00000169679","2",110637528,110678063,40535
"12574","ENSG00000169682","16",28974221,28984548,10327
"12575","ENSG00000169683","17",82023305,82031151,7846
"12576","ENSG00000169684","15",78565520,78595269,29749
"12577","ENSG00000169688","16",56651886,56653204,1318
"12578","ENSG00000169689","17",82018702,82024107,5405
"12579","ENSG00000169692","9",136673143,136687457,14314
"12580","ENSG00000169696","17",81976807,82017406,40599
"12581","ENSG00000169704","3",129060767,129062406,1639
"12582","ENSG00000169710","17",82078338,82098294,19956
"12583","ENSG00000169714","3",129169484,129183922,14438
"12584","ENSG00000169715","16",56625475,56627112,1637
"12585","ENSG00000169717","1",3021483,3022903,1420
"12586","ENSG00000169718","17",82057506,82065887,8381
"12587","ENSG00000169727","17",82050691,82057470,6779
"12588","ENSG00000169733","17",82047902,82051831,3929
"12589","ENSG00000169738","17",82035136,82037732,2596
"12590","ENSG00000169740","10",43643860,43648881,5021
"12591","ENSG00000169744","4",16501541,16898678,397137
"12592","ENSG00000169750","17",82031678,82034204,2526
"12593","ENSG00000169752","15",75935969,76059795,123826
"12594","ENSG00000169756","2",108534355,108687246,152891
"12595","ENSG00000169758","15",76059958,76229121,169163
"12596","ENSG00000169760","3",173396284,174286644,890360
"12597","ENSG00000169762","4",16160505,16227410,66905
"12598","ENSG00000169764","2",63840940,63891562,50622
"12599","ENSG00000169777","5",9628997,9712378,83381
"12600","ENSG00000169783","15",77613027,77820900,207873
"12601","ENSG00000169789","Y",22490397,22514637,24240
"12602","ENSG00000169813","10",43385617,43409166,23549
"12603","ENSG00000169814","3",15601341,15647640,46299
"12604","ENSG00000169826","10",43138445,43185302,46857
"12605","ENSG00000169836","4",103586031,103719985,133954
"12606","ENSG00000169840","13",27792643,27794768,2125
"12607","ENSG00000169851","4",30720415,31146805,426390
"12608","ENSG00000169855","3",78597239,79767998,1170759
"12609","ENSG00000169856","15",52756989,52791078,34089
"12610","ENSG00000169857","15",33866227,34039204,172977
"12611","ENSG00000169860","3",152835131,152841439,6308
"12612","ENSG00000169862","5",10971836,11904446,932610
"12613","ENSG00000169871","7",101085481,101097967,12486
"12614","ENSG00000169877","16",31527900,31528803,903
"12615","ENSG00000169884","12",48965340,48971735,6395
"12616","ENSG00000169885","1",1915108,1917296,2188
"12617","ENSG00000169891","X",16946658,17153272,206614
"12618","ENSG00000169894","7",100949534,100968347,18813
"12619","ENSG00000169895","X",16719612,16765340,45728
"12620","ENSG00000169896","16",31259967,31332892,72925
"12621","ENSG00000169900","16",31215962,31217359,1397
"12622","ENSG00000169902","7",66205317,66420543,215226
"12623","ENSG00000169903","3",149473974,149503281,29307
"12624","ENSG00000169905","1",179839967,179877803,37836
"12625","ENSG00000169906","X",16650158,16654670,4512
"12626","ENSG00000169908","3",149369022,149377692,8670
"12627","ENSG00000169914","1",19882395,19912945,30550
"12628","ENSG00000169918","15",31475398,31870789,395391
"12629","ENSG00000169919","7",65960684,65982215,21531
"12630","ENSG00000169925","9",134030305,134068535,38230
"12631","ENSG00000169926","15",31326835,31435665,108830
"12632","ENSG00000169933","X",11822423,12724523,902100
"12633","ENSG00000169946","8",104590733,105804539,1213806
"12634","ENSG00000169951","16",30553764,30558498,4734
"12635","ENSG00000169955","16",30530367,30535347,4980
"12636","ENSG00000169957","16",30524004,30526821,2817
"12637","ENSG00000169962","1",1331280,1335314,4034
"12638","ENSG00000169964","3",44861904,44865670,3766
"12639","ENSG00000169967","2",127298730,127388465,89735
"12640","ENSG00000169972","1",1308597,1311677,3080
"12641","ENSG00000169976","6",144094881,144095573,692
"12642","ENSG00000169981","3",44648732,44660791,12059
"12643","ENSG00000169989","4",152769354,152779764,10410
"12644","ENSG00000169991","1",18904280,18956676,52396
"12645","ENSG00000169992","17",7404874,7419860,14986
"12646","ENSG00000169994","2",127535802,127637729,101927
"12647","ENSG00000170004","17",7884806,7912760,27954
"12648","ENSG00000170006","4",152618628,152680012,61384
"12649","ENSG00000170011","3",39808914,40260321,451407
"12650","ENSG00000170017","3",105366909,105576900,209991
"12651","ENSG00000170027","7",76326799,76358991,32192
"12652","ENSG00000170035","2",180967248,181076585,109337
"12653","ENSG00000170037","17",7932101,7949918,17817
"12654","ENSG00000170043","17",7930345,7932123,1778
"12655","ENSG00000170044","3",102099244,102479841,380597
"12656","ENSG00000170049","17",7921859,7929803,7944
"12657","ENSG00000170054","14",94462717,94479689,16972
"12658","ENSG00000170074","5",177707981,177783398,75417
"12659","ENSG00000170075","1",202122917,202133592,10675
"12660","ENSG00000170085","5",176238367,176345991,107624
"12661","ENSG00000170088","4",165070608,165208549,137941
"12662","ENSG00000170089","5",177809407,177950732,141325
"12663","ENSG00000170091","5",174045706,174243501,197795
"12664","ENSG00000170092","7",75493625,75504304,10679
"12665","ENSG00000170099","14",94304248,94323389,19141
"12666","ENSG00000170100","16",89217703,89237071,19368
"12667","ENSG00000170113","15",22773063,22829789,56726
"12668","ENSG00000170122","9",116231,118204,1973
"12669","ENSG00000170128","1",200872955,200874178,1223
"12670","ENSG00000170142","3",23805903,23891316,85413
"12671","ENSG00000170144","2",177212563,177223958,11395
"12672","ENSG00000170145","11",111602449,111730855,128406
"12673","ENSG00000170152","9",61861848,61862567,719
"12674","ENSG00000170153","4",140859807,141212877,353070
"12675","ENSG00000170160","17",16689537,16777881,88344
"12676","ENSG00000170161","9",62897368,62900104,2736
"12677","ENSG00000170162","6",117265558,117273565,8007
"12678","ENSG00000170166","2",176151550,176153226,1676
"12679","ENSG00000170175","17",7445061,7457710,12649
"12680","ENSG00000170178","2",176099730,176101193,1463
"12681","ENSG00000170180","4",144109303,144140751,31448
"12682","ENSG00000170185","4",143184917,143223830,38913
"12683","ENSG00000170190","17",75087727,75106162,18435
"12684","ENSG00000170191","20",25612935,25624014,11079
"12685","ENSG00000170209","11",113387791,113400418,12627
"12686","ENSG00000170214","5",159865080,159973012,107932
"12687","ENSG00000170222","17",10697594,10711233,13639
"12688","ENSG00000170231","5",160187367,160238735,51368
"12689","ENSG00000170234","5",160061801,160119450,57649
"12690","ENSG00000170236","15",50500562,50546708,46146
"12691","ENSG00000170242","11",11841423,11959323,117900
"12692","ENSG00000170248","3",33798571,33869707,71136
"12693","ENSG00000170260","7",149239651,149255609,15958
"12694","ENSG00000170262","21",32291813,32314784,22971
"12695","ENSG00000170264","2",61824848,61854143,29295
"12696","ENSG00000170265","7",149195546,149226238,30692
"12697","ENSG00000170266","3",32996609,33097202,100593
"12698","ENSG00000170270","14",93202894,93207065,4171
"12699","ENSG00000170271","5",154818492,154859252,40760
"12700","ENSG00000170275","3",33113979,33147773,33794
"12701","ENSG00000170276","11",111912734,111914093,1359
"12702","ENSG00000170279","7",148590766,148615860,25094
"12703","ENSG00000170289","8",86553977,86743675,189698
"12704","ENSG00000170290","11",107707378,107719693,12315
"12705","ENSG00000170291","17",7251416,7259940,8524
"12706","ENSG00000170293","3",32238679,32370321,131642
"12707","ENSG00000170296","17",7240008,7242449,2441
"12708","ENSG00000170298","17",20449395,20467539,18144
"12709","ENSG00000170310","17",9250471,9576591,326120
"12710","ENSG00000170312","10",60778331,60794852,16521
"12711","ENSG00000170315","17",16380798,16382745,1947
"12712","ENSG00000170322","11",129863636,129895590,31954
"12713","ENSG00000170323","8",81478419,81483263,4844
"12714","ENSG00000170324","10",48153088,48274696,121608
"12715","ENSG00000170325","11",129899706,130002835,103129
"12716","ENSG00000170340","2",62196115,62224731,28616
"12717","ENSG00000170345","14",75278826,75282230,3404
"12718","ENSG00000170348","14",75131469,75176612,45143
"12719","ENSG00000170356","7",144250045,144256244,6199
"12720","ENSG00000170364","3",4303304,4317567,14263
"12721","ENSG00000170365","4",145481194,145559176,77982
"12722","ENSG00000170367","20",23875934,23879748,3814
"12723","ENSG00000170369","20",23823769,23826729,2960
"12724","ENSG00000170370","10",117542445,117549546,7101
"12725","ENSG00000170373","20",23747553,23751268,3715
"12726","ENSG00000170374","12",53326575,53345315,18740
"12727","ENSG00000170379","7",143620952,143730409,109457
"12728","ENSG00000170381","7",83363238,83649139,285901
"12729","ENSG00000170382","1",204617170,204685738,68568
"12730","ENSG00000170385","1",211571568,211579161,7593
"12731","ENSG00000170390","4",150078445,150257438,178993
"12732","ENSG00000170396","2",184598529,184939492,340963
"12733","ENSG00000170409","7",102327256,102329530,2274
"12734","ENSG00000170412","17",74424851,74451653,26802
"12735","ENSG00000170417","2",102736905,103019900,282995
"12736","ENSG00000170419","7",54542325,54571080,28755
"12737","ENSG00000170421","12",52897187,52949954,52767
"12738","ENSG00000170423","12",52837804,52849092,11288
"12739","ENSG00000170425","17",15944917,15975746,30829
"12740","ENSG00000170426","12",56923133,56934408,11275
"12741","ENSG00000170430","10",129467190,129770983,303793
"12742","ENSG00000170439","12",55681678,55684611,2933
"12743","ENSG00000170442","12",52249300,52309163,59863
"12744","ENSG00000170445","5",140673904,140691537,17633
"12745","ENSG00000170448","4",47847233,47914667,67434
"12746","ENSG00000170454","12",52424070,52434371,10301
"12747","ENSG00000170456","12",31382226,31591136,208910
"12748","ENSG00000170458","5",140631728,140633701,1973
"12749","ENSG00000170464","5",139408588,139444491,35903
"12750","ENSG00000170465","12",52468516,52473805,5289
"12751","ENSG00000170468","14",73490964,73493392,2428
"12752","ENSG00000170469","5",139396563,139404088,7525
"12753","ENSG00000170471","20",38472816,38578859,106043
"12754","ENSG00000170473","12",55901413,55932618,31205
"12755","ENSG00000170476","5",139387480,139390081,2601
"12756","ENSG00000170477","12",52806549,52814116,7567
"12757","ENSG00000170482","5",139367196,139384553,17357
"12758","ENSG00000170484","12",52565782,52573825,8043
"12759","ENSG00000170485","2",100820139,100996829,176690
"12760","ENSG00000170486","12",52585589,52601538,15949
"12761","ENSG00000170498","1",204190341,204196491,6150
"12762","ENSG00000170500","2",100273291,100322733,49442
"12763","ENSG00000170502","4",87422573,87459455,36882
"12764","ENSG00000170509","4",87303789,87322886,19097
"12765","ENSG00000170515","12",56104537,56113910,9373
"12766","ENSG00000170516","4",46734827,46909245,174418
"12767","ENSG00000170522","4",110045846,110199199,153353
"12768","ENSG00000170523","12",52314301,52321398,7097
"12769","ENSG00000170525","10",6144934,6254644,109710
"12770","ENSG00000170537","16",18983934,19063942,80008
"12771","ENSG00000170540","16",18791669,18801572,9903
"12772","ENSG00000170542","6",2887270,2903309,16039
"12773","ENSG00000170545","12",51244558,51270415,25857
"12774","ENSG00000170549","5",3595832,3601403,5571
"12775","ENSG00000170558","18",27950966,28177130,226164
"12776","ENSG00000170561","5",2745845,2751677,5832
"12777","ENSG00000170571","5",50396192,50443248,47056
"12778","ENSG00000170577","2",45005182,45009452,4270
"12779","ENSG00000170579","18",3496032,4455307,959275
"12780","ENSG00000170581","12",56341597,56360167,18570
"12781","ENSG00000170584","5",163446526,163460102,13576
"12782","ENSG00000170604","19",45883608,45886141,2533
"12783","ENSG00000170606","5",133052013,133106449,54436
"12784","ENSG00000170608","19",45863989,45873797,9808
"12785","ENSG00000170613","5",157161846,157166264,4418
"12786","ENSG00000170615","7",103352730,103446177,93447
"12787","ENSG00000170619","8",144841042,144853736,12694
"12788","ENSG00000170624","5",155870344,156767788,897444
"12789","ENSG00000170627","12",54455950,54473602,17652
"12790","ENSG00000170629","7",103175133,103280410,105277
"12791","ENSG00000170631","8",144930358,144950888,20530
"12792","ENSG00000170632","7",103074881,103099759,24878
"12793","ENSG00000170633","12",121400041,121430623,30582
"12794","ENSG00000170634","2",53970838,54305300,334462
"12795","ENSG00000170638","22",50185915,50199598,13683
"12796","ENSG00000170653","12",53507856,53626410,118554
"12797","ENSG00000170667","7",102482445,102517781,35336
"12798","ENSG00000170677","18",70289045,70330199,41154
"12799","ENSG00000170681","9",100578079,100587906,9827
"12800","ENSG00000170683","11",7937171,7941708,4537
"12801","ENSG00000170684","19",45071500,45076587,5087
"12802","ENSG00000170688","11",7848700,7849626,926
"12803","ENSG00000170689","17",48621156,48626358,5202
"12804","ENSG00000170703","17",48762235,48817214,54979
"12805","ENSG00000170734","6",43576150,43615660,39510
"12806","ENSG00000170743","11",7238778,7469043,230265
"12807","ENSG00000170745","2",17877847,18361616,483769
"12808","ENSG00000170748","11",7089027,7090900,1873
"12809","ENSG00000170759","10",32009015,32056425,47410
"12810","ENSG00000170775","7",124745997,124765627,19630
"12811","ENSG00000170776","15",85380571,85749358,368787
"12812","ENSG00000170777","9",6328375,6331900,3525
"12813","ENSG00000170779","14",105009573,105021148,11575
"12814","ENSG00000170782","11",6876625,6877619,994
"12815","ENSG00000170786","8",56300010,56320776,20766
"12816","ENSG00000170788","10",80336105,80356755,20650
"12817","ENSG00000170790","11",6863057,6874717,11660
"12818","ENSG00000170791","8",56211686,56218798,7112
"12819","ENSG00000170801","4",8269754,8307098,37344
"12820","ENSG00000170802","2",48314637,48379295,64658
"12821","ENSG00000170807","7",123655866,123664290,8424
"12822","ENSG00000170819","3",133399995,133475222,75227
"12823","ENSG00000170820","2",48962157,49154537,192380
"12824","ENSG00000170827","9",133079900,133087355,7455
"12825","ENSG00000170832","17",60177327,60422470,245143
"12826","ENSG00000170835","9",133061978,133071861,9883
"12827","ENSG00000170836","17",60600183,60666280,66097
"12828","ENSG00000170837","3",71754050,71756496,2446
"12829","ENSG00000170846","4",6663396,6676755,13359
"12830","ENSG00000170848","19",42902079,42919563,17484
"12831","ENSG00000170852","7",32868172,32894131,25959
"12832","ENSG00000170854","3",97941818,97972457,30639
"12833","ENSG00000170855","12",120443964,120446384,2420
"12834","ENSG00000170858","19",54707916,54713453,5537
"12835","ENSG00000170860","3",14178817,14201122,22305
"12836","ENSG00000170871","4",6781375,6884170,102795
"12837","ENSG00000170873","8",124550790,124728429,177639
"12838","ENSG00000170876","3",14124940,14143679,18739
"12839","ENSG00000170881","8",124474738,124487914,13176
"12840","ENSG00000170889","19",54200809,54249003,48194
"12841","ENSG00000170890","12",120322115,120327779,5664
"12842","ENSG00000170891","4",5014586,5019458,4872
"12843","ENSG00000170892","19",54189938,54194536,4598
"12844","ENSG00000170893","3",129974688,129977935,3247
"12845","ENSG00000170899","6",52977948,52995304,17356
"12846","ENSG00000170903","11",105995623,106022403,26780
"12847","ENSG00000170906","19",54102728,54109257,6529
"12848","ENSG00000170909","19",54094668,54102692,8024
"12849","ENSG00000170915","6",52361421,52407777,46356
"12850","ENSG00000170917","4",122888697,122922968,34271
"12851","ENSG00000170919","13",45341345,45417975,76630
"12852","ENSG00000170920","19",9126012,9126950,938
"12853","ENSG00000170921","17",63009556,63427699,418143
"12854","ENSG00000170925","X",107980864,107982370,1506
"12855","ENSG00000170927","6",51615300,52087625,472325
"12856","ENSG00000170929","19",9087061,9095669,8608
"12857","ENSG00000170935","X",107774899,107795829,20930
"12858","ENSG00000170946","11",31369840,31432835,62995
"12859","ENSG00000170948","19",8832398,8843340,10942
"12860","ENSG00000170949","19",53066606,53103436,36830
"12861","ENSG00000170950","6",49785651,49787307,1656
"12862","ENSG00000170953","11",124539635,124545333,5698
"12863","ENSG00000170954","19",53107879,53133077,25198
"12864","ENSG00000170955","11",6318946,6320532,1586
"12865","ENSG00000170956","19",41796587,41811554,14967
"12866","ENSG00000170959","11",30830369,31369810,539441
"12867","ENSG00000170961","8",121612116,121641440,29324
"12868","ENSG00000170962","11",103907189,104164379,257190
"12869","ENSG00000170965","X",134565838,134764322,198484
"12870","ENSG00000170967","11",104036580,104039188,2608
"12871","ENSG00000170983","8",11576257,11582817,6560
"12872","ENSG00000170989","1",101236865,101243713,6848
"12873","ENSG00000171004","X",132626016,132961395,335379
"12874","ENSG00000171014","11",123939543,123940637,1094
"12875","ENSG00000171016","15",55538890,55588947,50057
"12876","ENSG00000171017","19",7888505,7902021,13516
"12877","ENSG00000171033","8",78516340,78605267,88927
"12878","ENSG00000171044","8",10896045,11201366,305321
"12879","ENSG00000171045","8",142212080,142403182,191102
"12880","ENSG00000171049","19",51752026,51770531,18505
"12881","ENSG00000171051","19",51745172,51804110,58938
"12882","ENSG00000171053","11",125746293,125749867,3574
"12883","ENSG00000171055","2",36531805,36646087,114282
"12884","ENSG00000171056","8",10723768,10730511,6743
"12885","ENSG00000171060","8",10672628,10700590,27962
"12886","ENSG00000171067","11",68261338,68272001,10663
"12887","ENSG00000171084","3",125916620,125930024,13404
"12888","ENSG00000171094","2",29192774,29921586,728812
"12889","ENSG00000171097","9",128832942,128882494,49552
"12890","ENSG00000171100","X",150568619,150673322,104703
"12891","ENSG00000171101","19",51167328,51173524,6196
"12892","ENSG00000171102","9",133205277,133209250,3973
"12893","ENSG00000171103","2",28849821,28870309,20488
"12894","ENSG00000171105","19",7112255,7294414,182159
"12895","ENSG00000171109","3",179347709,179394936,47227
"12896","ENSG00000171115","7",150450630,150479393,28763
"12897","ENSG00000171116","X",149774068,149776867,2799
"12898","ENSG00000171119","19",5823802,5828324,4522
"12899","ENSG00000171121","3",179236691,179267002,30311
"12900","ENSG00000171124","19",5842888,5851474,8586
"12901","ENSG00000171126","2",42442017,42493982,51965
"12902","ENSG00000171130","7",149872968,149891204,18236
"12903","ENSG00000171132","2",45651345,46187990,536645
"12904","ENSG00000171133","9",111327483,111330183,2700
"12905","ENSG00000171135","3",9890574,9894349,3775
"12906","ENSG00000171136","19",14028148,14031042,2894
"12907","ENSG00000171148","3",9779860,9793011,13151
"12908","ENSG00000171150","2",46698952,46780245,81293
"12909","ENSG00000171155","X",120625674,120630054,4380
"12910","ENSG00000171159","9",128160265,128163924,3659
"12911","ENSG00000171160","10",97614553,97633500,18947
"12912","ENSG00000171161","1",248838210,248849517,11307
"12913","ENSG00000171163","1",248850006,248859144,9138
"12914","ENSG00000171169","9",128061233,128068206,6973
"12915","ENSG00000171174","2",27781379,27890681,109302
"12916","ENSG00000171189","21",29536933,29940033,403100
"12917","ENSG00000171195","4",70430492,70482997,52505
"12918","ENSG00000171199","4",70397931,70410195,12264
"12919","ENSG00000171201","4",70370093,70390244,20151
"12920","ENSG00000171202","11",85647967,85656547,8580
"12921","ENSG00000171204","11",85628573,85636539,7966
"12922","ENSG00000171206","10",102642310,102660680,18370
"12923","ENSG00000171208","16",47077703,47143997,66294
"12924","ENSG00000171209","4",70242588,70251428,8840
"12925","ENSG00000171217","6",155264013,155276548,12535
"12926","ENSG00000171219","11",64823052,64844653,21601
"12927","ENSG00000171222","20",35953617,35959472,5855
"12928","ENSG00000171223","19",12791486,12793315,1829
"12929","ENSG00000171224","10",69630247,69633596,3349
"12930","ENSG00000171227","2",119429901,119438504,8603
"12931","ENSG00000171234","4",69051363,69112987,61624
"12932","ENSG00000171236","19",4536402,4540036,3634
"12933","ENSG00000171241","16",46578591,46621379,42788
"12934","ENSG00000171243","7",16461481,16530580,69099
"12935","ENSG00000171246","17",80466834,80477843,11009
"12936","ENSG00000171262","15",38454127,38487710,33583
"12937","ENSG00000171291","19",11848726,11883750,35024
"12938","ENSG00000171295","19",11814284,11835201,20917
"12939","ENSG00000171298","17",80101556,80119881,18325
"12940","ENSG00000171302","17",78991716,79009867,18151
"12941","ENSG00000171303","2",26692690,26733420,40730
"12942","ENSG00000171307","10",97446170,97457370,11200
"12943","ENSG00000171310","12",104455295,104762014,306719
"12944","ENSG00000171311","10",97436142,97446017,9875
"12945","ENSG00000171314","10",97426191,97433444,7253
"12946","ENSG00000171316","8",60678740,60868028,189288
"12947","ENSG00000171320","8",27771949,27812640,40691
"12948","ENSG00000171345","17",41523617,41528308,4691
"12949","ENSG00000171346","17",41513745,41522529,8784
"12950","ENSG00000171357","1",46203334,46221256,17922
"12951","ENSG00000171360","17",41436446,41440921,4475
"12952","ENSG00000171365","X",49922596,50099235,176639
"12953","ENSG00000171368","5",659862,693352,33490
"12954","ENSG00000171385","1",111770662,111989155,218493
"12955","ENSG00000171388","X",129645259,129654956,9697
"12956","ENSG00000171401","17",41500981,41505705,4724
"12957","ENSG00000171402","X",52862525,52868083,5558
"12958","ENSG00000171403","17",41565836,41572059,6223
"12959","ENSG00000171405","X",52812204,52818301,6097
"12960","ENSG00000171408","6",135851701,136195574,343873
"12961","ENSG00000171421","5",1798385,1801366,2981
"12962","ENSG00000171425","19",55635459,55645623,10164
"12963","ENSG00000171428","8",18170477,18223689,53212
"12964","ENSG00000171431","17",40875941,40885227,9286
"12965","ENSG00000171433","X",48761747,48773648,11901
"12966","ENSG00000171435","12",117453012,117968983,515971
"12967","ENSG00000171443","19",55600022,55603138,3116
"12968","ENSG00000171444","5",113022099,113488823,466724
"12969","ENSG00000171446","17",40776808,40782534,5726
"12970","ENSG00000171448","9",122915566,122931512,15946
"12971","ENSG00000171450","2",218959655,218962162,2507
"12972","ENSG00000171451","18",67506587,67516720,10133
"12973","ENSG00000171453","6",43509702,43562419,52717
"12974","ENSG00000171456","20",32358330,32439319,80989
"12975","ENSG00000171459","9",122742303,122750783,8480
"12976","ENSG00000171462","6",43450352,43456632,6280
"12977","ENSG00000171466","19",9641807,9675100,33293
"12978","ENSG00000171467","6",43307134,43369647,62513
"12979","ENSG00000171469","19",9604680,9621236,16556
"12980","ENSG00000171475","17",40219304,40284136,64832
"12981","ENSG00000171476","4",56647988,56681899,33911
"12982","ENSG00000171478","X",48130657,48132613,1956
"12983","ENSG00000171481","9",122675036,122676153,1117
"12984","ENSG00000171483","X",48107992,48120210,12218
"12985","ENSG00000171487","19",55999726,56061813,62087
"12986","ENSG00000171488","1",89633072,89769903,136831
"12987","ENSG00000171489","X",48004336,48009729,5393
"12988","ENSG00000171490","16",11833850,11851580,17730
"12989","ENSG00000171492","1",89821014,89936611,115597
"12990","ENSG00000171495","5",40998017,41071342,73325
"12991","ENSG00000171496","9",122567117,122583384,16267
"12992","ENSG00000171497","4",158709127,158723396,14269
"12993","ENSG00000171501","9",122553112,122554214,1102
"12994","ENSG00000171502","1",85729233,86156943,427710
"12995","ENSG00000171503","4",158672125,158709623,37498
"12996","ENSG00000171505","9",122526358,122527296,938
"12997","ENSG00000171509","4",158315311,158653372,338061
"12998","ENSG00000171517","1",84811602,84893206,81604
"12999","ENSG00000171522","5",40679915,40693735,13820
"13000","ENSG00000171530","5",77691166,77868780,177614
"13001","ENSG00000171532","17",39603536,39609777,6241
"13002","ENSG00000171533","11",75586918,75669120,82202
"13003","ENSG00000171540","5",77628712,77639688,10976
"13004","ENSG00000171551","2",232479827,232487834,8007
"13005","ENSG00000171552","20",31664452,31723989,59537
"13006","ENSG00000171557","4",154604134,154612967,8833
"13007","ENSG00000171560","4",154583128,154590745,7617
"13008","ENSG00000171561","11",75081753,75096876,15123
"13009","ENSG00000171564","4",154562956,154571086,8130
"13010","ENSG00000171566","4",154535005,154550400,15395
"13011","ENSG00000171570","19",40778242,40808418,30176
"13012","ENSG00000171574","19",58401504,58418327,16823
"13013","ENSG00000171587","21",40010999,40847158,836159
"13014","ENSG00000171595","17",74274234,74314884,40650
"13015","ENSG00000171596","2",231523187,231530445,7258
"13016","ENSG00000171603","1",9729026,9824526,95500
"13017","ENSG00000171604","5",139647299,139683882,36583
"13018","ENSG00000171606","19",58183029,58213562,30533
"13019","ENSG00000171608","1",9651732,9729114,77382
"13020","ENSG00000171611","6",42915989,42925835,9846
"13021","ENSG00000171612","1",9539465,9585173,45708
"13022","ENSG00000171617","5",74627406,74641424,14018
"13023","ENSG00000171621","1",9292894,9369532,76638
"13024","ENSG00000171631","11",73264505,73298617,34112
"13025","ENSG00000171634","17",67825503,67984378,158875
"13026","ENSG00000171643","5",76850001,76921650,71649
"13027","ENSG00000171649","19",57578456,57593890,15434
"13028","ENSG00000171657","X",41724181,41730130,5949
"13029","ENSG00000171658","3",185959943,185980872,20929
"13030","ENSG00000171659","X",41688973,41697275,8302
"13031","ENSG00000171671","11",70862790,70865115,2325
"13032","ENSG00000171680","1",6466092,6520061,53969
"13033","ENSG00000171681","12",14365632,14502935,137303
"13034","ENSG00000171695","20",64083380,64084359,979
"13035","ENSG00000171700","20",64073181,64079988,6807
"13036","ENSG00000171703","20",64049836,64072347,22511
"13037","ENSG00000171711","8",7894629,7896711,2082
"13038","ENSG00000171714","11",21799934,22283357,483423
"13039","ENSG00000171720","5",141620876,141636849,15973
"13040","ENSG00000171722","1",162373203,162376870,3667
"13041","ENSG00000171723","14",66507407,67181803,674396
"13042","ENSG00000171724","16",77788564,77980107,191543
"13043","ENSG00000171729","1",15152532,15220478,67946
"13044","ENSG00000171735","1",6785454,7769706,984252
"13045","ENSG00000171747","19",38801671,38812945,11274
"13046","ENSG00000171757","3",169793428,169812986,19558
"13047","ENSG00000171759","12",102836889,102958410,121521
"13048","ENSG00000171763","15",45402336,45421415,19079
"13049","ENSG00000171766","15",45361124,45402327,41203
"13050","ENSG00000171772","10",133553901,133569835,15934
"13051","ENSG00000171773","19",17455425,17460954,5529
"13052","ENSG00000171777","19",38409051,38426305,17254
"13053","ENSG00000171786","1",160367071,160372846,5775
"13054","ENSG00000171790","1",41015597,41023237,7640
"13055","ENSG00000171791","18",63123346,63320128,196782
"13056","ENSG00000171792","12",2876258,2889524,13266
"13057","ENSG00000171793","1",40979688,41012565,32877
"13058","ENSG00000171794","10",133230217,133231558,1341
"13059","ENSG00000171798","10",133160219,133226412,66193
"13060","ENSG00000171804","19",37884823,37906677,21854
"13061","ENSG00000171806","1",169792529,169794963,2434
"13062","ENSG00000171811","10",132808392,132942823,134431
"13063","ENSG00000171812","1",36095239,36125222,29983
"13064","ENSG00000171813","10",132397168,132417859,20691
"13065","ENSG00000171815","5",141051135,141059344,8209
"13066","ENSG00000171817","19",37551406,37614179,62773
"13067","ENSG00000171819","1",11189355,11195981,6626
"13068","ENSG00000171823","12",1565993,1594581,28588
"13069","ENSG00000171824","1",11066618,11099869,33251
"13070","ENSG00000171827","19",37467585,37488652,21067
"13071","ENSG00000171840","12",564296,663779,99483
"13072","ENSG00000171843","9",20341669,20622518,280849
"13073","ENSG00000171847","12",8221260,8227618,6358
"13074","ENSG00000171848","2",10120698,10211725,91027
"13075","ENSG00000171853","2",3379675,3485094,105419
"13076","ENSG00000171855","9",21077104,21077942,838
"13077","ENSG00000171858","20",62387103,62388520,1417
"13078","ENSG00000171860","12",8058302,8066471,8169
"13079","ENSG00000171861","17",782353,792509,10156
"13080","ENSG00000171862","10",87863625,87971930,108305
"13081","ENSG00000171863","2",3575260,3580920,5660
"13082","ENSG00000171864","20",4721909,4728460,6551
"13083","ENSG00000171865","2",3541430,3558333,16903
"13084","ENSG00000171867","20",4686236,4701590,15354
"13085","ENSG00000171872","1",44118850,44135140,16290
"13086","ENSG00000171873","20",4220631,4249074,28443
"13087","ENSG00000171877","15",43870761,44195271,324510
"13088","ENSG00000171885","18",26852043,26865771,13728
"13089","ENSG00000171889","9",21410969,21559900,148931
"13090","ENSG00000171903","19",15912367,15934867,22500
"13091","ENSG00000171914","15",62390526,62844631,454105
"13092","ENSG00000171916","17",18476737,18494945,18208
"13093","ENSG00000171928","17",18781111,18806714,25603
"13094","ENSG00000171931","17",18744024,18779349,35325
"13095","ENSG00000171936","19",15737985,15742343,4358
"13096","ENSG00000171940","20",53567065,53609907,42842
"13097","ENSG00000171943","1",121184810,121392822,208012
"13098","ENSG00000171944","11",5128776,5138356,9580
"13099","ENSG00000171951","2",223596940,223602361,5421
"13100","ENSG00000171953","17",17977409,18039209,61800
"13101","ENSG00000171954","19",15508525,15552317,43792
"13102","ENSG00000171956","15",60004234,60061730,57496
"13103","ENSG00000171960","1",42658423,42676758,18335
"13104","ENSG00000171962","17",17972813,18016889,44076
"13105","ENSG00000171970","19",2900898,2918473,17575
"13106","ENSG00000171984","20",5750393,5864395,114002
"13107","ENSG00000171987","11",4571423,4577820,6397
"13108","ENSG00000171988","10",63167221,63521850,354629
"13109","ENSG00000171989","15",59206823,59208515,1692
"13110","ENSG00000171992","5",150601080,150659207,58127
"13111","ENSG00000171999","11",4431323,4432277,954
"13112","ENSG00000172000","19",2867335,2883445,16110
"13113","ENSG00000172005","2",95025677,95053992,28315
"13114","ENSG00000172006","19",2819874,2835773,15899
"13115","ENSG00000172007","4",139453232,139476609,23377
"13116","ENSG00000172009","19",2785503,2815807,30304
"13117","ENSG00000172014","9",64369394,64413142,43748
"13118","ENSG00000172016","2",79157003,79159753,2750
"13119","ENSG00000172020","3",115623324,115721490,98166
"13120","ENSG00000172023","2",79085030,79088019,2989
"13121","ENSG00000172031","1",92029985,92063538,33553
"13122","ENSG00000172037","3",49121114,49133118,12004
"13123","ENSG00000172046","3",49108046,49120938,12892
"13124","ENSG00000172053","3",49095932,49105130,9198
"13125","ENSG00000172057","17",39921041,39927601,6560
"13126","ENSG00000172058","5",70900665,70918530,17865
"13127","ENSG00000172059","2",10042849,10054836,11987
"13128","ENSG00000172061","3",194355247,194369743,14496
"13129","ENSG00000172062","5",70925030,70953942,28912
"13130","ENSG00000172071","2",88556740,88627464,70724
"13131","ENSG00000172073","2",88524649,88529585,4936
"13132","ENSG00000172081","19",2071036,2096673,25637
"13133","ENSG00000172086","2",88027205,88055783,28578
"13134","ENSG00000172113","3",48290722,48301685,10963
"13135","ENSG00000172115","7",25120091,25125361,5270
"13136","ENSG00000172116","2",86815339,86861924,46585
"13137","ENSG00000172123","17",35411060,35433283,22223
"13138","ENSG00000172137","16",71358713,71390436,31723
"13139","ENSG00000172139","3",112140898,112294227,153329
"13140","ENSG00000172146","17",3207539,3218896,11357
"13141","ENSG00000172148","19",14863714,14867358,3644
"13142","ENSG00000172156","17",34285668,34288334,2666
"13143","ENSG00000172159","9",83242990,83538546,295556
"13144","ENSG00000172164","8",120535745,120813273,277528
"13145","ENSG00000172167","8",120445400,120542133,96733
"13146","ENSG00000172171","17",30897336,30906238,8902
"13147","ENSG00000172172","8",120380761,120445402,64641
"13148","ENSG00000172175","18",58671465,58754477,83012
"13149","ENSG00000172179","6",22287244,22302826,15582
"13150","ENSG00000172183","15",88636153,88656483,20330
"13151","ENSG00000172186","X",69174124,69174717,593
"13152","ENSG00000172188","11",55602360,55607645,5285
"13153","ENSG00000172197","6",20102145,20212399,110254
"13154","ENSG00000172201","6",19837370,19842197,4827
"13155","ENSG00000172209","7",107470018,107475684,5666
"13156","ENSG00000172215","3",45940933,45948351,7418
"13157","ENSG00000172216","20",50190734,50192689,1955
"13158","ENSG00000172232","19",825097,832018,6921
"13159","ENSG00000172236","16",1240705,1242554,1849
"13160","ENSG00000172238","4",93828753,93830964,2211
"13161","ENSG00000172239","5",43526267,43557758,31491
"13162","ENSG00000172243","12",10116777,10130258,13481
"13163","ENSG00000172244","5",43486709,43515148,28439
"13164","ENSG00000172247","11",47589667,47594411,4744
"13165","ENSG00000172250","22",42500568,42512560,11992
"13166","ENSG00000172260","1",71395943,72282539,886596
"13167","ENSG00000172262","5",43065176,43192021,126845
"13168","ENSG00000172264","20",13995369,16053197,2057828
"13169","ENSG00000172269","11",119096503,119108331,11828
"13170","ENSG00000172270","19",571277,583493,12216
"13171","ENSG00000172273","11",119121587,119136044,14457
"13172","ENSG00000172289","11",59712916,59713845,929
"13173","ENSG00000172292","2",168455862,168775137,319275
"13174","ENSG00000172296","20",13008972,13169103,160131
"13175","ENSG00000172297","Y",25454561,25460572,6011
"13176","ENSG00000172301","17",31851871,31859291,7420
"13177","ENSG00000172315","20",46684365,46689444,5079
"13178","ENSG00000172318","2",167868948,167874041,5093
"13179","ENSG00000172322","12",9951316,9995694,44378
"13180","ENSG00000172331","7",134646811,134679816,33005
"13181","ENSG00000172336","7",100706121,100707486,1365
"13182","ENSG00000172339","1",94974405,95072951,98546
"13183","ENSG00000172340","3",67360460,67654614,294154
"13184","ENSG00000172345","15",81309053,81324183,15130
"13185","ENSG00000172346","22",41561010,41577741,16731
"13186","ENSG00000172348","6",46220736,46491972,271236
"13187","ENSG00000172349","15",81159575,81314058,154483
"13188","ENSG00000172350","11",119149052,119162653,13601
"13189","ENSG00000172354","7",100673567,100679174,5607
"13190","ENSG00000172361","18",50227193,50266495,39302
"13191","ENSG00000172362","11",58439077,58442758,3681
"13192","ENSG00000172365","11",58421264,58428121,6857
"13193","ENSG00000172366","16",636817,648474,11657
"13194","ENSG00000172367","11",119185457,119190223,4766
"13195","ENSG00000172375","11",119102198,119118544,16346
"13196","ENSG00000172379","15",80404350,80597933,193583
"13197","ENSG00000172380","1",67701475,67833467,131992
"13198","ENSG00000172382","16",2712419,2720551,8132
"13199","ENSG00000172399","4",119135784,119187789,52005
"13200","ENSG00000172403","4",118850688,119061247,210559
"13201","ENSG00000172404","22",40859549,40862126,2577
"13202","ENSG00000172409","11",57648992,57661865,12873
"13203","ENSG00000172410","1",66797741,66801256,3515
"13204","ENSG00000172421","17",62343941,62416479,72538
"13205","ENSG00000172425","11",118527472,118531197,3725
"13206","ENSG00000172426","6",43645036,43672600,27564
"13207","ENSG00000172428","2",240126563,240136807,10244
"13208","ENSG00000172432","6",43605316,43629264,23948
"13209","ENSG00000172456","1",59296638,59810647,514009
"13210","ENSG00000172458","13",20702127,20723098,20971
"13211","ENSG00000172460","16",2839568,2842744,3176
"13212","ENSG00000172461","6",96015974,96215612,199638
"13213","ENSG00000172465","X",103628704,103630953,2249
"13214","ENSG00000172466","18",35332227,35345482,13255
"13215","ENSG00000172469","6",95577535,95609452,31917
"13216","ENSG00000172476","X",103499130,103519489,20359
"13217","ENSG00000172478","2",240886048,240896889,10841
"13218","ENSG00000172482","2",240868824,240880502,11678
"13219","ENSG00000172493","4",86935002,87141054,206052
"13220","ENSG00000172497","5",81329996,81394179,64183
"13221","ENSG00000172500","11",65883741,65888539,4798
"13222","ENSG00000172508","11",67414968,67425607,10639
"13223","ENSG00000172530","16",87949244,88077318,128074
"13224","ENSG00000172531","11",67398183,67421183,23000
"13225","ENSG00000172534","X",153947557,153971818,24261
"13226","ENSG00000172538","10",49131154,49134008,2854
"13227","ENSG00000172543","11",65879837,65883741,3904
"13228","ENSG00000172548","5",157460019,157474717,14698
"13229","ENSG00000172551","12",54830518,54896008,65490
"13230","ENSG00000172554","2",950849,1367613,416764
"13231","ENSG00000172568","5",157341598,157345677,4079
"13232","ENSG00000172572","12",20369245,20684381,315136
"13233","ENSG00000172575","15",38488103,38565575,77472
"13234","ENSG00000172578","3",183487551,183555706,68155
"13235","ENSG00000172586","10",73782047,73783652,1605
"13236","ENSG00000172590","14",22829879,22835037,5158
"13237","ENSG00000172594","6",122789049,122809720,20671
"13238","ENSG00000172602","12",48857145,48865870,8725
"13239","ENSG00000172613","11",67317871,67398410,80539
"13240","ENSG00000172638","11",65866441,65873592,7151
"13241","ENSG00000172640","12",48202083,48203387,1304
"13242","ENSG00000172650","10",73674285,73698159,23874
"13243","ENSG00000172661","10",45727200,45792961,65761
"13244","ENSG00000172663","11",67461710,67469272,7562
"13245","ENSG00000172667","3",178960121,179072215,112094
"13246","ENSG00000172671","10",45615501,45672780,57279
"13247","ENSG00000172673","6",127708072,127918631,210559
"13248","ENSG00000172680","8",56112942,56113982,1040
"13249","ENSG00000172687","19",21358930,21379302,20372
"13250","ENSG00000172689","11",60785333,60801305,15972
"13251","ENSG00000172716","17",35350305,35373701,23396
"13252","ENSG00000172717","14",67189393,67228550,39157
"13253","ENSG00000172724","9",34689570,34691276,1706
"13254","ENSG00000172725","11",67435510,67443821,8311
"13255","ENSG00000172728","8",33370824,33473422,102598
"13256","ENSG00000172731","10",70298970,70382650,83680
"13257","ENSG00000172732","11",65857126,65867653,10527
"13258","ENSG00000172733","8",30995802,31033715,37913
"13259","ENSG00000172738","6",37212178,37258155,45977
"13260","ENSG00000172746","1",26980165,26980975,810
"13261","ENSG00000172748","8",232137,264703,32566
"13262","ENSG00000172752","3",130345516,130484844,139328
"13263","ENSG00000172757","11",65823022,65862026,39004
"13264","ENSG00000172765","3",129647792,129893606,245814
"13265","ENSG00000172766","13",41311267,41377030,65763
"13266","ENSG00000172771","3",129401321,129428651,27330
"13267","ENSG00000172772","11",58266792,58268260,1468
"13268","ENSG00000172775","16",57152466,57186116,33650
"13269","ENSG00000172780","3",129087569,129122801,35232
"13270","ENSG00000172782","17",74877299,74893781,16482
"13271","ENSG00000172785","9",121038,179147,58109
"13272","ENSG00000172789","12",54032853,54035358,2505
"13273","ENSG00000172794","17",74670578,74747335,76757
"13274","ENSG00000172795","5",112976702,113022195,45493
"13275","ENSG00000172799","2",231433923,231434426,503
"13276","ENSG00000172803","11",65833834,65856896,23062
"13277","ENSG00000172809","17",74203582,74210655,7073
"13278","ENSG00000172817","8",64587763,64798737,210974
"13279","ENSG00000172818","11",65787063,65797214,10151
"13280","ENSG00000172819","12",53210567,53232980,22413
"13281","ENSG00000172824","16",66988589,67009758,21169
"13282","ENSG00000172828","16",66961245,66975149,13904
"13283","ENSG00000172830","11",67303478,67312607,9129
"13284","ENSG00000172831","16",66934444,66945096,10652
"13285","ENSG00000172840","16",66878589,66895754,17165
"13286","ENSG00000172845","2",173880850,173965702,84852
"13287","ENSG00000172867","12",52644558,52652211,7653
"13288","ENSG00000172869","5",119037772,119249138,211366
"13289","ENSG00000172878","2",171999943,172082430,82487
"13290","ENSG00000172888","3",40524878,40574685,49807
"13291","ENSG00000172889","9",136658856,136672678,13822
"13292","ENSG00000172890","11",71453109,71524107,70998
"13293","ENSG00000172893","11",71428193,71452868,24675
"13294","ENSG00000172900","11",71382601,71423423,40822
"13295","ENSG00000172901","5",115962454,116027619,65165
"13296","ENSG00000172912","22",40569286,40569895,609
"13297","ENSG00000172915","13",34942287,35673022,730735
"13298","ENSG00000172922","11",65714005,65720947,6942
"13299","ENSG00000172927","11",69294151,69367726,73575
"13300","ENSG00000172932","11",67288547,67302485,13938
"13301","ENSG00000172935","11",69004395,69013382,8987
"13302","ENSG00000172936","3",38138478,38143022,4544
"13303","ENSG00000172938","11",68980021,68980986,965
"13304","ENSG00000172939","3",38165089,38255484,90395
"13305","ENSG00000172940","3",38265812,38278757,12945
"13306","ENSG00000172943","X",53936676,54048958,112282
"13307","ENSG00000172954","2",30447226,30644225,196999
"13308","ENSG00000172955","4",99202638,99219537,16899
"13309","ENSG00000172965","2",111036776,111523376,486600
"13310","ENSG00000172967","22",16783412,16821699,38287
"13311","ENSG00000172969","3",75664330,75667220,2890
"13312","ENSG00000172971","3",75619506,75623849,4343
"13313","ENSG00000172974","2",65205108,65205988,880
"13314","ENSG00000172977","11",65711996,65719604,7608
"13315","ENSG00000172985","2",109129348,109504632,375284
"13316","ENSG00000172986","3",72888073,72998138,110065
"13317","ENSG00000172987","10",98457077,99235862,778785
"13318","ENSG00000172992","17",45023340,45061109,37769
"13319","ENSG00000172995","3",35638945,35794496,155551
"13320","ENSG00000173011","4",7041899,7057952,16053
"13321","ENSG00000173013","4",7040849,7042939,2090
"13322","ENSG00000173020","11",67266473,67286556,20083
"13323","ENSG00000173039","11",65653597,65663090,9493
"13324","ENSG00000173040","4",5542772,5709548,166776
"13325","ENSG00000173041","7",64519878,64563075,43197
"13326","ENSG00000173064","12",112160188,112382439,222251
"13327","ENSG00000173065","17",28755978,28855232,99254
"13328","ENSG00000173068","9",16409503,16870843,461340
"13329","ENSG00000173077","9",114850968,115402644,551676
"13330","ENSG00000173080","1",155941710,155942949,1239
"13331","ENSG00000173083","4",83292461,83335153,42692
"13332","ENSG00000173085","4",83261536,83284914,23378
"13333","ENSG00000173093","12",110846769,110907535,60766
"13334","ENSG00000173110","1",161524540,161526894,2354
"13335","ENSG00000173113","11",64316460,64318084,1624
"13336","ENSG00000173114","7",111091006,111125454,34448
"13337","ENSG00000173120","11",67119263,67258082,138819
"13338","ENSG00000173124","10",95194200,95228928,34728
"13339","ENSG00000173137","8",144373101,144393242,20141
"13340","ENSG00000173141","13",21176658,21179084,2426
"13341","ENSG00000173145","10",94333226,94362959,29733
"13342","ENSG00000173153","11",64305524,64316743,11219
"13343","ENSG00000173156","11",67056847,67072017,15170
"13344","ENSG00000173157","12",43353866,43551921,198055
"13345","ENSG00000173163","2",61888724,62147247,258523
"13346","ENSG00000173166","2",203394345,203535335,140990
"13347","ENSG00000173171","1",155208699,155213824,5125
"13348","ENSG00000173175","3",123282296,123449758,167462
"13349","ENSG00000173193","3",122680839,122730840,50001
"13350","ENSG00000173198","X",78271468,78327691,56223
"13351","ENSG00000173200","3",122577628,122639047,61419
"13352","ENSG00000173207","1",154974653,154979251,4598
"13353","ENSG00000173208","12",39550033,39619803,69770
"13354","ENSG00000173209","2",61177418,61191203,13785
"13355","ENSG00000173210","5",149141483,149260542,119059
"13356","ENSG00000173212","1",116111755,116135240,23485
"13357","ENSG00000173213","18",47390,49557,2167
"13358","ENSG00000173214","6",111259348,111271167,11819
"13359","ENSG00000173218","1",115641970,115698224,56254
"13360","ENSG00000173221","5",95751319,95822726,71407
"13361","ENSG00000173226","3",121769761,121835079,65318
"13362","ENSG00000173227","11",67006778,67050863,44085
"13363","ENSG00000173230","3",121663199,121749767,86568
"13364","ENSG00000173231","21",13776086,13777266,1180
"13365","ENSG00000173237","11",66975277,66977004,1727
"13366","ENSG00000173239","10",88802730,88820546,17816
"13367","ENSG00000173250","5",146513103,146516190,3087
"13368","ENSG00000173253","9",1049858,1057552,7694
"13369","ENSG00000173258","9",111525159,111577844,52685
"13370","ENSG00000173261","5",146084313,146105577,21264
"13371","ENSG00000173262","12",7812512,7891148,78636
"13372","ENSG00000173264","11",64270062,64289500,19438
"13373","ENSG00000173267","10",86958599,86963258,4659
"13374","ENSG00000173269","10",86935540,86969481,33941
"13375","ENSG00000173272","2",131464900,131492743,27843
"13376","ENSG00000173273","8",9555912,9782346,226434
"13377","ENSG00000173275","X",135344796,135363152,18356
"13378","ENSG00000173276","21",41986831,42010387,23556
"13379","ENSG00000173281","8",9136255,9151574,15319
"13380","ENSG00000173295","8",8228595,8244865,16270
"13381","ENSG00000173320","4",183797692,184023526,225834
"13382","ENSG00000173327","11",65597756,65615382,17626
"13383","ENSG00000173334","8",125430358,125438403,8045
"13384","ENSG00000173335","20",23602410,23605876,3466
"13385","ENSG00000173338","11",65592855,65595996,3141
"13386","ENSG00000173366","3",52221081,52231190,10109
"13387","ENSG00000173369","1",22652762,22661637,8875
"13388","ENSG00000173372","1",22636628,22639678,3050
"13389","ENSG00000173376","4",121035613,121073021,37408
"13390","ENSG00000173389","3",51894876,51903353,8477
"13391","ENSG00000173391","12",10158301,10172138,13837
"13392","ENSG00000173401","12",75334639,75370560,35921
"13393","ENSG00000173402","3",49468703,49535618,66915
"13394","ENSG00000173404","20",20368104,20370949,2845
"13395","ENSG00000173406","1",56994778,58546734,1551956
"13396","ENSG00000173409","1",230978981,231000733,21752
"13397","ENSG00000173418","20",20017116,20033655,16539
"13398","ENSG00000173421","3",49198428,49258106,59678
"13399","ENSG00000173431","14",21057822,21058455,633
"13400","ENSG00000173432","11",18266260,18269977,3717
"13401","ENSG00000173436","1",19484403,19629821,145418
"13402","ENSG00000173442","11",65576046,65592650,16604
"13403","ENSG00000173451","12",71664301,71680644,16343
"13404","ENSG00000173452","7",19719310,19773598,54288
"13405","ENSG00000173456","11",119334527,119337313,2786
"13406","ENSG00000173457","11",64244479,64246943,2464
"13407","ENSG00000173464","14",20583559,20609884,26325
"13408","ENSG00000173465","11",65570430,65573942,3512
"13409","ENSG00000173467","7",16859412,16881987,22575
"13410","ENSG00000173473","3",47585269,47782106,196837
"13411","ENSG00000173480","19",57900296,57916610,16314
"13412","ENSG00000173482","18",7566782,8406861,840079
"13413","ENSG00000173486","11",64241003,64244134,3131
"13414","ENSG00000173511","11",64234538,64238793,4255
"13415","ENSG00000173517","15",77100656,77420144,319488
"13416","ENSG00000173530","8",23135588,23164027,28439
"13417","ENSG00000173531","3",49683947,49689501,5554
"13418","ENSG00000173535","8",23102590,23117437,14847
"13419","ENSG00000173540","3",49716844,49723951,7107
"13420","ENSG00000173542","4",70902326,71022449,120123
"13421","ENSG00000173545","5",16451519,16465800,14281
"13422","ENSG00000173546","15",75674322,75712848,38526
"13423","ENSG00000173548","15",75647906,75662301,14395
"13424","ENSG00000173557","2",26562585,26579532,16947
"13425","ENSG00000173559","2",191678068,191696659,18591
"13426","ENSG00000173567","2",26308173,26346817,38644
"13427","ENSG00000173572","19",55891699,55932336,40637
"13428","ENSG00000173575","15",92900189,93027996,127807
"13429","ENSG00000173578","3",46017024,46027742,10718
"13430","ENSG00000173581","19",55641062,55653161,12099
"13431","ENSG00000173585","3",45886504,45903175,16671
"13432","ENSG00000173588","12",94306449,94459988,153539
"13433","ENSG00000173597","4",69721167,69787961,66794
"13434","ENSG00000173598","12",93377883,93408146,30263
"13435","ENSG00000173599","11",66848417,66958439,110022
"13436","ENSG00000173610","4",69588417,69653249,64832
"13437","ENSG00000173611","9",124942608,125143506,200898
"13438","ENSG00000173612","6",116792085,116829037,36952
"13439","ENSG00000173614","1",9943428,9985501,42073
"13440","ENSG00000173621","11",66856647,66860475,3828
"13441","ENSG00000173626","6",116494989,116545610,50621
"13442","ENSG00000173627","1",183646275,183653316,7041
"13443","ENSG00000173638","21",45493572,45573365,79793
"13444","ENSG00000173641","1",16014028,16019594,5566
"13445","ENSG00000173653","11",66842835,66846546,3711
"13446","ENSG00000173660","1",46303698,46316776,13078
"13447","ENSG00000173662","1",6555307,6579755,24448
"13448","ENSG00000173673","1",6244192,6245578,1386
"13449","ENSG00000173674","X",20124525,20141838,17313
"13450","ENSG00000173678","7",102650325,102661398,11073
"13451","ENSG00000173679","9",122661566,122662648,1082
"13452","ENSG00000173681","X",19912860,19970298,57438
"13453","ENSG00000173692","2",231056864,231172827,115963
"13454","ENSG00000173698","X",18989307,19122637,133330
"13455","ENSG00000173699","2",230990324,231025055,34731
"13456","ENSG00000173702","3",124905442,124953819,48377
"13457","ENSG00000173705","3",33150043,33218810,68767
"13458","ENSG00000173706","3",124965710,125055997,90287
"13459","ENSG00000173714","17",50834650,50842348,7698
"13460","ENSG00000173715","11",66744451,66843328,98877
"13461","ENSG00000173726","1",235109341,235128837,19496
"13462","ENSG00000173727","11",65455258,65466720,11462
"13463","ENSG00000173728","1",244352635,244389663,37028
"13464","ENSG00000173744","2",227472152,227561214,89062
"13465","ENSG00000173757","17",42199168,42276707,77539
"13466","ENSG00000173762","17",82314868,82317608,2740
"13467","ENSG00000173769","3",44241886,44332098,90212
"13468","ENSG00000173786","17",41966763,41977740,10977
"13469","ENSG00000173801","17",41754604,41786931,32327
"13470","ENSG00000173805","17",41717742,41734644,16902
"13471","ENSG00000173809","19",32719753,32829580,109827
"13472","ENSG00000173810","1",101270875,101271363,488
"13473","ENSG00000173811","3",42732575,42746768,14193
"13474","ENSG00000173812","17",41688885,41692668,3783
"13475","ENSG00000173818","17",80415165,80438086,22921
"13476","ENSG00000173821","17",80260866,80398786,137920
"13477","ENSG00000173825","11",65354751,65357613,2862
"13478","ENSG00000173826","17",63523334,63548977,25643
"13479","ENSG00000173838","17",62701314,62808344,107030
"13480","ENSG00000173846","1",44800377,44805990,5613
"13481","ENSG00000173848","10",5412557,5459056,46499
"13482","ENSG00000173852","7",34928876,35038271,109395
"13483","ENSG00000173862","7",33725981,33728456,2475
"13484","ENSG00000173867","15",88459501,88546585,87084
"13485","ENSG00000173868","17",49223362,49230766,7404
"13486","ENSG00000173875","19",12610918,12633840,22922
"13487","ENSG00000173889","3",170086732,170181749,95017
"13488","ENSG00000173890","3",170037995,170085392,47397
"13489","ENSG00000173894","17",79778148,79787983,9835
"13490","ENSG00000173898","11",66685248,66729226,43978
"13491","ENSG00000173905","3",168008677,168095975,87298
"13492","ENSG00000173908","17",40792203,40799959,7756
"13493","ENSG00000173914","11",66664998,66677887,12889
"13494","ENSG00000173915","10",103389041,103396492,7451
"13495","ENSG00000173917","17",48540894,48544989,4095
"13496","ENSG00000173918","17",79022814,79049788,26974
"13497","ENSG00000173926","5",126867714,127030558,162844
"13498","ENSG00000173928","19",11374685,11376951,2266
"13499","ENSG00000173930","5",102233986,102296284,62298
"13500","ENSG00000173933","11",66638617,66668374,29757
"13501","ENSG00000173947","1",111346600,111353013,6413
"13502","ENSG00000173950","3",195068284,195271159,202875
"13503","ENSG00000173960","2",23927285,24004909,77624
"13504","ENSG00000173966","4",53575713,53576387,674
"13505","ENSG00000173976","19",3769089,3772221,3132
"13506","ENSG00000173988","13",46211943,46277366,65423
"13507","ENSG00000173991","17",39664187,39666555,2368
"13508","ENSG00000173992","11",66593153,66606019,12866
"13509","ENSG00000174004","3",196639694,196662004,22310
"13510","ENSG00000174007","3",196706277,196712250,5973
"13511","ENSG00000174010","X",23983720,24027186,43466
"13512","ENSG00000174013","3",196568611,196589059,20448
"13513","ENSG00000174015","13",45702320,45714559,12239
"13514","ENSG00000174016","X",80335504,80445311,109807
"13515","ENSG00000174021","1",84498325,84506581,8256
"13516","ENSG00000174028","X",23075758,23076767,1009
"13517","ENSG00000174032","13",45393316,45418455,25139
"13518","ENSG00000174038","9",35041095,35045986,4891
"13519","ENSG00000174059","1",207880972,207911402,30430
"13520","ENSG00000174080","11",66563464,66568841,5377
"13521","ENSG00000174099","12",65278643,65491430,212787
"13522","ENSG00000174106","12",65169583,65248355,78772
"13523","ENSG00000174109","16",1419752,1420756,1004
"13524","ENSG00000174123","4",38772238,38782990,10752
"13525","ENSG00000174125","4",38790677,38856817,66140
"13526","ENSG00000174130","4",38823715,38856817,33102
"13527","ENSG00000174132","5",100535374,100586741,51367
"13528","ENSG00000174136","5",98768650,98798643,29993
"13529","ENSG00000174137","4",1617915,1684302,66387
"13530","ENSG00000174145","4",37244743,37449463,204720
"13531","ENSG00000174151","1",109494052,109502932,8880
"13532","ENSG00000174156","6",52896639,52909698,13059
"13533","ENSG00000174165","11",66520637,66546235,25598
"13534","ENSG00000174171","15",41892777,41899528,6751
"13535","ENSG00000174173","3",101561868,101566446,4578
"13536","ENSG00000174175","1",169588849,169630193,41344
"13537","ENSG00000174177","16",88706483,88715396,8913
"13538","ENSG00000174197","15",41621224,41773081,151857
"13539","ENSG00000174206","12",64186316,64222296,35980
"13540","ENSG00000174225","X",100969708,100990829,21121
"13541","ENSG00000174226","8",100572889,100663415,90526
"13542","ENSG00000174227","4",499210,540200,40990
"13543","ENSG00000174231","17",1650629,1684867,34238
"13544","ENSG00000174233","12",48766194,48789037,22843
"13545","ENSG00000174236","12",27696519,27697596,1077
"13546","ENSG00000174238","17",1517718,1562816,45098
"13547","ENSG00000174243","12",48829756,48852842,23086
"13548","ENSG00000174255","3",114234631,114237578,2947
"13549","ENSG00000174276","11",65116403,65117708,1305
"13550","ENSG00000174279","2",176077472,176083913,6441
"13551","ENSG00000174282","17",7459366,7484263,24897
"13552","ENSG00000174292","17",7380534,7389774,9240
"13553","ENSG00000174306","20",41178448,41317672,139224
"13554","ENSG00000174307","1",201464383,201469237,4854
"13555","ENSG00000174325","2",188733738,188790104,56366
"13556","ENSG00000174326","17",7041630,7043923,2293
"13557","ENSG00000174327","17",7036075,7040121,4046
"13558","ENSG00000174332","1",53506237,53738106,231869
"13559","ENSG00000174343","4",40335333,40355217,19884
"13560","ENSG00000174348","1",53062052,53085502,23450
"13561","ENSG00000174353","7",72969696,73005922,36226
"13562","ENSG00000174358","5",1201595,1225111,23516
"13563","ENSG00000174365","20",38446343,38450940,4597
"13564","ENSG00000174370","11",128899565,128906069,6504
"13565","ENSG00000174371","1",241847967,241895148,47181
"13566","ENSG00000174373","14",35538352,35809304,270952
"13567","ENSG00000174384","7",73093657,73105389,11732
"13568","ENSG00000174403","20",62544343,62551526,7183
"13569","ENSG00000174405","13",108207439,108218368,10929
"13570","ENSG00000174407","20",62550453,62570764,20311
"13571","ENSG00000174417","8",109086621,109119584,32963
"13572","ENSG00000174418","13",106425773,106426122,349
"13573","ENSG00000174428","7",75092396,75149817,57421
"13574","ENSG00000174429","8",106759483,106770244,10761
"13575","ENSG00000174437","12",110280756,110351093,70337
"13576","ENSG00000174442","15",66504959,66550130,45171
"13577","ENSG00000174444","15",66498015,66524532,26517
"13578","ENSG00000174446","15",66490135,66497780,7645
"13579","ENSG00000174448","18",54324358,54357964,33606
"13580","ENSG00000174450","15",23439498,23447234,7736
"13581","ENSG00000174453","2",214411065,214578959,167894
"13582","ENSG00000174456","12",110027028,110073634,46606
"13583","ENSG00000174460","X",118823824,118826968,3144
"13584","ENSG00000174469","7",146116002,148420998,2304996
"13585","ENSG00000174473","4",171812254,173041559,1229305
"13586","ENSG00000174482","9",27948078,28670286,722208
"13587","ENSG00000174483","11",66510606,66533613,23007
"13588","ENSG00000174485","15",65658046,65792293,134247
"13589","ENSG00000174495","7",28279211,28279700,489
"13590","ENSG00000174498","15",65327127,65378002,50875
"13591","ENSG00000174500","3",112120839,112133270,12431
"13592","ENSG00000174501","2",95836919,95991831,154912
"13593","ENSG00000174502","1",205913048,205943460,30412
"13594","ENSG00000174514","1",205568885,205602918,34033
"13595","ENSG00000174516","11",66466327,66477337,11010
"13596","ENSG00000174521","19",40216058,40218399,2341
"13597","ENSG00000174527","12",109347903,109455523,107620
"13598","ENSG00000174529","1",205083129,205084460,1331
"13599","ENSG00000174547","11",66435075,66466738,31663
"13600","ENSG00000174562","19",50825289,50837213,11924
"13601","ENSG00000174564","3",136946230,137011085,64855
"13602","ENSG00000174567","1",204198163,204213988,15825
"13603","ENSG00000174572","6",27211244,27211913,669
"13604","ENSG00000174574","1",38991276,39006059,14783
"13605","ENSG00000174576","11",66421004,66426707,5703
"13606","ENSG00000174579","3",136148917,136197241,48324
"13607","ENSG00000174586","19",58354357,58362848,8491
"13608","ENSG00000174599","4",117083554,117085576,2022
"13609","ENSG00000174600","12",108288044,108339317,51273
"13610","ENSG00000174606","1",212992182,213015867,23685
"13611","ENSG00000174607","4",114598770,114678225,79455
"13612","ENSG00000174611","3",134599923,134651636,51713
"13613","ENSG00000174628","16",19716456,19858467,142011
"13614","ENSG00000174640","3",133928145,134052184,124039
"13615","ENSG00000174652","19",9412461,9435571,23110
"13616","ENSG00000174669","11",66362521,66372214,9693
"13617","ENSG00000174672","11",1389899,1462689,72790
"13618","ENSG00000174677","19",53315137,53316043,906
"13619","ENSG00000174678","X",37541077,37545262,4185
"13620","ENSG00000174680","21",29748175,29764002,15827
"13621","ENSG00000174684","11",66345374,66347629,2255
"13622","ENSG00000174695","5",83052846,83077863,25017
"13623","ENSG00000174697","7",128241278,128257629,16351
"13624","ENSG00000174705","5",172325000,172454525,129525
"13625","ENSG00000174715","3",138643874,138644694,820
"13626","ENSG00000174718","12",31959370,31993107,33737
"13627","ENSG00000174720","4",112637107,112657592,20485
"13628","ENSG00000174721","10",91906589,91909483,2894
"13629","ENSG00000174738","3",23945286,23980617,35331
"13630","ENSG00000174740","X",91434595,91438584,3989
"13631","ENSG00000174744","11",66337333,66345125,7792
"13632","ENSG00000174748","3",23916545,23924374,7829
"13633","ENSG00000174749","4",112145454,112195256,49802
"13634","ENSG00000174775","11",532242,537287,5045
"13635","ENSG00000174776","3",167478684,167653983,175299
"13636","ENSG00000174780","4",56467617,56503681,36064
"13637","ENSG00000174788","19",7631611,7633719,2108
"13638","ENSG00000174791","11",66330241,66336840,6599
"13639","ENSG00000174792","4",75556048,75565885,9837
"13640","ENSG00000174796","4",75513946,75550473,36527
"13641","ENSG00000174799","4",55948871,56033363,84492
"13642","ENSG00000174804","11",86945679,86955395,9716
"13643","ENSG00000174807","11",66314494,66317044,2550
"13644","ENSG00000174808","4",74744759,74794523,49764
"13645","ENSG00000174827","1",145670852,145708148,37296
"13646","ENSG00000174837","19",6887566,6940459,52893
"13647","ENSG00000174839","3",57625454,57693077,67623
"13648","ENSG00000174840","3",57556274,57566848,10574
"13649","ENSG00000174842","1",92246402,92298987,52585
"13650","ENSG00000174844","3",57293699,57544344,250645
"13651","ENSG00000174851","11",66284580,66289145,4565
"13652","ENSG00000174871","11",66278175,66285301,7126
"13653","ENSG00000174876","1",103687415,103696680,9265
"13654","ENSG00000174885","11",278365,285359,6994
"13655","ENSG00000174886","19",5891276,5904006,12730
"13656","ENSG00000174891","3",158105855,158545730,439875
"13657","ENSG00000174898","19",5720637,5778734,58097
"13658","ENSG00000174899","3",157543246,157677749,134503
"13659","ENSG00000174903","11",66268590,66277492,8902
"13660","ENSG00000174912","3",156713884,156714928,1044
"13661","ENSG00000174914","11",56699095,56703884,4789
"13662","ENSG00000174915","11",448268,491399,43131
"13663","ENSG00000174917","19",5678421,5680896,2475
"13664","ENSG00000174928","3",155762617,155806278,43661
"13665","ENSG00000174937","11",56469274,56473352,4078
"13666","ENSG00000174938","16",29871159,29899547,28388
"13667","ENSG00000174939","16",29900375,29919864,19489
"13668","ENSG00000174943","16",29905012,29926236,21224
"13669","ENSG00000174944","3",151212117,151278542,66425
"13670","ENSG00000174945","7",2679522,2775500,95978
"13671","ENSG00000174946","3",151197832,151203201,5369
"13672","ENSG00000174948","3",154334943,154430190,95247
"13673","ENSG00000174950","1",27379176,27383333,4157
"13674","ENSG00000174951","19",48748011,48755390,7379
"13675","ENSG00000174953","3",154272546,154324487,51941
"13676","ENSG00000174963","3",147386046,147406860,20814
"13677","ENSG00000174970","11",55965755,55969945,4190
"13678","ENSG00000174977","17",18650195,18651542,1347
"13679","ENSG00000174989","12",116910950,117031148,120198
"13680","ENSG00000174990","16",87881546,87936580,55034
"13681","ENSG00000174992","16",29778240,29782973,4733
"13682","ENSG00000174996","11",66257294,66267860,10566
"13683","ENSG00000175003","6",160121815,160158718,36903
"13684","ENSG00000175018","10",125576522,125683144,106622
"13685","ENSG00000175029","10",124984317,125161170,176853
"13686","ENSG00000175040","3",143119771,143124014,4243
"13687","ENSG00000175048","6",157381133,157678157,297024
"13688","ENSG00000175054","3",142449007,142578733,129726
"13689","ENSG00000175061","17",16438767,16478678,39911
"13690","ENSG00000175063","20",45812576,45816957,4381
"13691","ENSG00000175065","18",31376777,31414912,38135
"13692","ENSG00000175066","3",142157527,142225592,68065
"13693","ENSG00000175073","8",66628487,66667231,38744
"13694","ENSG00000175077","3",187197486,187201465,3979
"13695","ENSG00000175084","2",219418377,219426739,8362
"13696","ENSG00000175087","1",26111165,26125555,14390
"13697","ENSG00000175093","3",141051347,141148611,97264
"13698","ENSG00000175097","11",36575574,36598279,22705
"13699","ENSG00000175104","11",36483769,36510272,26503
"13700","ENSG00000175105","3",88059255,88144664,85409
"13701","ENSG00000175106","17",15502264,15563595,61331
"13702","ENSG00000175110","3",139005806,139357223,351417
"13703","ENSG00000175115","11",66070272,66244744,174472
"13704","ENSG00000175121","20",45109452,45115172,5720
"13705","ENSG00000175130","1",32333839,32336233,2394
"13706","ENSG00000175137","1",248810446,248825915,15469
"13707","ENSG00000175147","1",15111815,15153618,41803
"13708","ENSG00000175155","17",59331655,59401729,70074
"13709","ENSG00000175161","3",84958981,86074429,1115448
"13710","ENSG00000175164","9",133250401,133276024,25623
"13711","ENSG00000175166","3",184299198,184309050,9852
"13712","ENSG00000175170","20",25762384,25868225,105841
"13713","ENSG00000175175","17",58755854,58985179,229325
"13714","ENSG00000175182","3",184335926,184348421,12495
"13715","ENSG00000175183","12",76858709,76879023,20314
"13716","ENSG00000175189","12",57434784,57452062,17278
"13717","ENSG00000175193","3",183829271,183884933,55662
"13718","ENSG00000175197","12",57516588,57521737,5149
"13719","ENSG00000175198","13",100089015,100530437,441422
"13720","ENSG00000175202","15",72675782,72686149,10367
"13721","ENSG00000175203","12",57530102,57547331,17229
"13722","ENSG00000175206","1",11845709,11848345,2636
"13723","ENSG00000175213","11",46700818,46705912,5094
"13724","ENSG00000175215","12",57819927,57846729,26802
"13725","ENSG00000175216","11",46743048,46846308,103260
"13726","ENSG00000175220","11",46677080,46700619,23539
"13727","ENSG00000175221","19",867630,893218,25588
"13728","ENSG00000175224","11",46617527,46674818,57291
"13729","ENSG00000175229","11",66040765,66049161,8396
"13730","ENSG00000175262","1",10946471,10982037,35566
"13731","ENSG00000175264","11",45647689,45665622,17933
"13732","ENSG00000175265","15",34379068,34437466,58398
"13733","ENSG00000175267","16",22092538,22156964,64426
"13734","ENSG00000175274","11",44885903,44951306,65403
"13735","ENSG00000175279","1",10430433,10442808,12375
"13736","ENSG00000175283","9",128945530,128947619,2089
"13737","ENSG00000175287","9",128920966,128942041,21075
"13738","ENSG00000175294","11",66016752,66026517,9765
"13739","ENSG00000175302","21",13384249,13427773,43524
"13740","ENSG00000175305","8",94879770,94896678,16908
"13741","ENSG00000175309","5",178208471,178232802,24331
"13742","ENSG00000175311","16",21233699,21253850,20151
"13743","ENSG00000175315","11",66012008,66013505,1497
"13744","ENSG00000175318","15",72159806,72197787,37981
"13745","ENSG00000175322","18",14057457,14132490,75033
"13746","ENSG00000175324","8",38163335,38176730,13395
"13747","ENSG00000175325","5",177992235,177996242,4007
"13748","ENSG00000175329","22",35066136,35087387,21251
"13749","ENSG00000175334","11",66002228,66004149,1921
"13750","ENSG00000175336","12",56360568,56362857,2289
"13751","ENSG00000175344","15",31923438,32173018,249580
"13752","ENSG00000175348","11",8947202,8965011,17809
"13753","ENSG00000175352","11",8980576,9004049,23473
"13754","ENSG00000175354","18",12785478,12929643,144165
"13755","ENSG00000175356","11",9019498,9138114,118616
"13756","ENSG00000175376","11",65996545,66002176,5631
"13757","ENSG00000175387","18",47808957,47931146,122189
"13758","ENSG00000175390","11",7970251,8001862,31611
"13759","ENSG00000175395","10",37949573,37976647,27074
"13760","ENSG00000175398","12",55636860,55637854,994
"13761","ENSG00000175414","5",176365487,176401865,36378
"13762","ENSG00000175416","5",176392455,176416569,24114
"13763","ENSG00000175426","5",96390333,96434143,43810
"13764","ENSG00000175445","8",19901717,19967259,65542
"13765","ENSG00000175449","5",95646754,95684773,38019
"13766","ENSG00000175455","3",123897305,123961408,64103
"13767","ENSG00000175463","11",67403915,67410089,6174
"13768","ENSG00000175467","11",65961728,65980137,18409
"13769","ENSG00000175470","10",131901008,131959834,58826
"13770","ENSG00000175471","5",94703741,95284575,580834
"13771","ENSG00000175482","11",67350772,67356972,6200
"13772","ENSG00000175485","11",6199146,6200259,1113
"13773","ENSG00000175489","19",18391137,18397622,6485
"13774","ENSG00000175497","2",114442299,115845752,1403453
"13775","ENSG00000175505","11",67364168,67374177,10009
"13776","ENSG00000175509","2",113667478,113668621,1143
"13777","ENSG00000175513","11",65945445,65959963,14518
"13778","ENSG00000175514","11",67451301,67452729,1428
"13779","ENSG00000175518","11",5514393,5516705,2312
"13780","ENSG00000175520","11",5507300,5509958,2658
"13781","ENSG00000175535","10",116545931,116567855,21924
"13782","ENSG00000175536","11",74490519,74493724,3205
"13783","ENSG00000175538","11",74454841,74467729,12888
"13784","ENSG00000175544","11",67452406,67460313,7907
"13785","ENSG00000175548","12",38316762,38329721,12959
"13786","ENSG00000175550","11",65919274,65921563,2289
"13787","ENSG00000175556","X",118974614,119018355,43741
"13788","ENSG00000175564","11",74000277,74009085,8808
"13789","ENSG00000175567","11",73974672,73983246,8574
"13790","ENSG00000175573","11",65916810,65919062,2252
"13791","ENSG00000175575","11",73876699,73931124,54425
"13792","ENSG00000175581","11",73787316,73865133,77817
"13793","ENSG00000175582","11",73675638,73761137,85499
"13794","ENSG00000175591","11",73218298,73236352,18054
"13795","ENSG00000175592","11",65892049,65900573,8524
"13796","ENSG00000175595","16",13920157,13952345,32188
"13797","ENSG00000175600","7",40134977,40860763,725786
"13798","ENSG00000175602","11",65890112,65891635,1523
"13799","ENSG00000175604","16",12086746,12090302,3556
"13800","ENSG00000175606","8",73972437,73982783,10346
"13801","ENSG00000175611","9",95759231,95876049,116818
"13802","ENSG00000175634","11",67428460,67435401,6941
"13803","ENSG00000175643","16",11249619,11381662,132043
"13804","ENSG00000175646","16",11280841,11281330,489
"13805","ENSG00000175658","1",144274892,144277993,3101
"13806","ENSG00000175662","17",17843511,17972422,128911
"13807","ENSG00000175664","13",30932656,30975500,42844
"13808","ENSG00000175676","15",23157366,23170711,13345
"13809","ENSG00000175691","19",2933218,2944971,11753
"13810","ENSG00000175697","3",120164645,120285094,120449
"13811","ENSG00000175699","14",93987225,94008863,21638
"13812","ENSG00000175701","2",110211529,110245420,33891
"13813","ENSG00000175707","1",26949562,26960468,10906
"13814","ENSG00000175711","17",82942155,83051810,109655
"13815","ENSG00000175718","X",115189427,115192868,3441
"13816","ENSG00000175727","12",122078756,122147344,68588
"13817","ENSG00000175728","11",130672956,130717352,44396
"13818","ENSG00000175730","20",32690180,32690815,635
"13819","ENSG00000175741","7",39854494,39855056,562
"13820","ENSG00000175745","5",93583222,93594611,11389
"13821","ENSG00000175746","15",39250684,39254845,4161
"13822","ENSG00000175749","5",103032376,103033031,655
"13823","ENSG00000175756","1",1373730,1375495,1765
"13824","ENSG00000175764","9",121821928,122093606,271678
"13825","ENSG00000175766","5",176630618,176646644,16026
"13826","ENSG00000175768","9",37582646,37592604,9958
"13827","ENSG00000175772","2",110375138,110384442,9304
"13828","ENSG00000175773","11",130314993,130403657,88664
"13829","ENSG00000175779","15",38628005,39180499,552494
"13830","ENSG00000175782","12",68746176,68793964,47788
"13831","ENSG00000175785","14",93718298,93788485,70187
"13832","ENSG00000175787","9",94259311,94301454,42143
"13833","ENSG00000175792","3",128064778,128153914,89136
"13834","ENSG00000175793","1",26863149,26864456,1307
"13835","ENSG00000175800","11",4378282,4379209,927
"13836","ENSG00000175806","8",10054292,10428891,374599
"13837","ENSG00000175809","X",22272943,22274461,1518
"13838","ENSG00000175820","13",102729369,102759070,29701
"13839","ENSG00000175826","17",7243591,7252491,8900
"13840","ENSG00000175832","17",43527844,43579620,51776
"13841","ENSG00000175841","3",101521891,101522979,1088
"13842","ENSG00000175854","9",128275379,128316123,40744
"13843","ENSG00000175857","5",58491435,58497090,5655
"13844","ENSG00000175866","17",81035122,81117432,82310
"13845","ENSG00000175868","11",14904997,15082342,177345
"13846","ENSG00000175874","2",101345550,101387503,41953
"13847","ENSG00000175877","7",73861159,73865890,4731
"13848","ENSG00000175879","2",176129694,176132695,3001
"13849","ENSG00000175886","18",39334872,39335672,800
"13850","ENSG00000175893","9",14611071,14693471,82400
"13851","ENSG00000175894","21",44497893,44711572,213679
"13852","ENSG00000175895","8",95133785,95156685,22900
"13853","ENSG00000175899","12",9067664,9116229,48565
"13854","ENSG00000175906","17",43398993,43401137,2144
"13855","ENSG00000175920","4",3463306,3501473,38167
"13856","ENSG00000175928","3",3799437,3847703,48266
"13857","ENSG00000175931","17",76389456,76453152,63696
"13858","ENSG00000175938","16",30949068,30956461,7393
"13859","ENSG00000175946","8",123645527,123652950,7423
"13860","ENSG00000175967","6",113904132,113921642,17510
"13861","ENSG00000175970","12",120710458,120723640,13182
"13862","ENSG00000175984","1",114582848,114670422,87574
"13863","ENSG00000175985","14",69484692,69531551,46859
"13864","ENSG00000176007","9",38527097,38527912,815
"13865","ENSG00000176009","11",8937579,8938211,632
"13866","ENSG00000176014","18",12307669,12344320,36651
"13867","ENSG00000176018","5",90515611,90529584,13973
"13868","ENSG00000176020","3",49716834,49719695,2861
"13869","ENSG00000176022","1",1232237,1235041,2804
"13870","ENSG00000176024","19",51927147,51948759,21612
"13871","ENSG00000176029","11",8920076,8933006,12930
"13872","ENSG00000176040","3",112034843,112081269,46426
"13873","ENSG00000176043","14",72929612,72929930,318
"13874","ENSG00000176046","16",28532708,28539174,6466
"13875","ENSG00000176049","5",147585438,147782775,197337
"13876","ENSG00000176054","21",28997613,28998033,420
"13877","ENSG00000176055","5",90458209,90474771,16562
"13878","ENSG00000176058","9",137191617,137204193,12576
"13879","ENSG00000176076","X",109623700,109625172,1472
"13880","ENSG00000176083","1",26361634,26374522,12888
"13881","ENSG00000176087","5",140564828,140569100,4272
"13882","ENSG00000176092","1",26321698,26360080,38382
"13883","ENSG00000176095","3",49724294,49786542,62248
"13884","ENSG00000176101","9",137188660,137190370,1710
"13885","ENSG00000176102","11",33077188,33162371,85183
"13886","ENSG00000176105","18",721588,812546,90958
"13887","ENSG00000176108","17",80991598,81009517,17919
"13888","ENSG00000176115","9",63127359,63143401,16042
"13889","ENSG00000176124","13",50082169,50906856,824687
"13890","ENSG00000176125","7",100888721,100889715,994
"13891","ENSG00000176134","9",64637845,64652556,14711
"13892","ENSG00000176136","18",13824149,13827323,3174
"13893","ENSG00000176142","3",119428949,119468830,39881
"13894","ENSG00000176148","11",33039417,33105943,66526
"13895","ENSG00000176153","14",64939152,64942905,3753
"13896","ENSG00000176155","17",82101460,82212830,111370
"13897","ENSG00000176160","17",58420167,58488384,68217
"13898","ENSG00000176165","14",28760330,28770277,9947
"13899","ENSG00000176170","17",76376584,76387860,11276
"13900","ENSG00000176171","10",131966455,131982013,15558
"13901","ENSG00000176177","22",39743044,39893864,150820
"13902","ENSG00000176182","19",45890023,45902613,12590
"13903","ENSG00000176183","5",98338744,98339832,1088
"13904","ENSG00000176194","18",12254319,12277595,23276
"13905","ENSG00000176198","14",20239286,20244349,5063
"13906","ENSG00000176200","11",59503576,59504511,935
"13907","ENSG00000176204","2",76747719,77593319,845600
"13908","ENSG00000176208","17",30831966,30895869,63903
"13909","ENSG00000176209","8",42541155,42555193,14038
"13910","ENSG00000176222","19",43872363,43901385,29022
"13911","ENSG00000176225","18",70003031,70205945,202914
"13912","ENSG00000176232","7",63980385,63981477,1092
"13913","ENSG00000176236","10",15095385,15097319,1934
"13914","ENSG00000176239","11",5351508,5352446,938
"13915","ENSG00000176243","3",96776945,96777683,738
"13916","ENSG00000176244","10",15075475,15088776,13301
"13917","ENSG00000176248","9",137174784,137188560,13776
"13918","ENSG00000176256","1",33860475,33864791,4316
"13919","ENSG00000176261","1",32600172,32650903,50731
"13920","ENSG00000176268","13",40863599,40863902,303
"13921","ENSG00000176269","8",166049,167043,994
"13922","ENSG00000176273","10",93893973,93956062,62089
"13923","ENSG00000176289","X",149525001,149526043,1042
"13924","ENSG00000176293","19",58059239,58086310,27071
"13925","ENSG00000176294","14",19719015,19830253,111238
"13926","ENSG00000176299","14",19773504,19783696,10192
"13927","ENSG00000176302","11",118971707,118981291,9584
"13928","ENSG00000176318","X",102546734,102548213,1479
"13929","ENSG00000176320","1",158197922,158203877,5955
"13930","ENSG00000176340","11",63974620,63976543,1923
"13931","ENSG00000176343","11",111889199,111889474,275
"13932","ENSG00000176349","7",1838586,1849931,11345
"13933","ENSG00000176358","17",49838309,49848017,9708
"13934","ENSG00000176371","15",84600986,84627796,26810
"13935","ENSG00000176378","1",21459756,21460082,326
"13936","ENSG00000176381","6",166305300,166308448,3148
"13937","ENSG00000176383","12",122203681,122208952,5271
"13938","ENSG00000176386","9",113255835,113275572,19737
"13939","ENSG00000176387","16",67430652,67437553,6901
"13940","ENSG00000176390","17",30769388,30824692,55304
"13941","ENSG00000176393","1",201982372,202006147,23775
"13942","ENSG00000176396","19",39538705,39540333,1628
"13943","ENSG00000176399","9",22446824,22455740,8916
"13944","ENSG00000176401","19",39530990,39532854,1864
"13945","ENSG00000176402","7",99923269,99929620,6351
"13946","ENSG00000176406","8",103500696,104256094,755398
"13947","ENSG00000176407","2",84971093,85059472,88379
"13948","ENSG00000176410","7",73680969,73683453,2484
"13949","ENSG00000176422","12",56468578,56479708,11130
"13950","ENSG00000176428","7",73667831,73672112,4281
"13951","ENSG00000176435","14",38254103,38256369,2266
"13952","ENSG00000176438","14",95407266,95475836,68570
"13953","ENSG00000176444","1",155262868,155278491,15623
"13954","ENSG00000176454","15",34358633,34367196,8563
"13955","ENSG00000176463","15",91853708,92172435,318727
"13956","ENSG00000176472","19",43525497,43536130,10633
"13957","ENSG00000176473","14",100376418,100530303,153885
"13958","ENSG00000176476","16",28553915,28591790,37875
"13959","ENSG00000176485","11",63573195,63616883,43688
"13960","ENSG00000176490","19",2714567,2721372,6805
"13961","ENSG00000176510","7",143509256,143519469,10213
"13962","ENSG00000176515","6",1079929,1104946,25017
"13963","ENSG00000176531","19",43474954,43504935,29981
"13964","ENSG00000176532","7",29563835,29567293,3458
"13965","ENSG00000176533","19",2511219,2702694,191475
"13966","ENSG00000176542","3",113648385,113696646,48261
"13967","ENSG00000176547","11",48324920,48328471,3551
"13968","ENSG00000176563","17",42798792,42811587,12795
"13969","ENSG00000176566","8",87870747,87874015,3268
"13970","ENSG00000176571","8",86866442,87615219,748777
"13971","ENSG00000176584","10",122729429,122826868,97439
"13972","ENSG00000176593","19",58002061,58011232,9171
"13973","ENSG00000176595","8",1973677,2006936,33259
"13974","ENSG00000176597","3",183253253,183298504,45251
"13975","ENSG00000176601","2",134964485,135047468,82983
"13976","ENSG00000176619","19",2427638,2456959,29321
"13977","ENSG00000176623","8",86468257,86514357,46100
"13978","ENSG00000176624","18",51174550,51218304,43754
"13979","ENSG00000176635","22",30080174,30177075,96901
"13980","ENSG00000176641","18",61808067,61894247,86180
"13981","ENSG00000176654","12",7890801,7900140,9339
"13982","ENSG00000176658","17",32492522,32877177,384655
"13983","ENSG00000176659","20",60055853,60072956,17103
"13984","ENSG00000176678","16",86576368,86582160,5792
"13985","ENSG00000176679","Y",3579041,3580041,1000
"13986","ENSG00000176681","17",46292733,46337794,45061
"13987","ENSG00000176692","16",86566829,86569728,2899
"13988","ENSG00000176697","11",27654893,27722058,67165
"13989","ENSG00000176700","15",84631451,84647478,16027
"13990","ENSG00000176714","2",27625639,27629012,3373
"13991","ENSG00000176715","16",89088375,89164121,75746
"13992","ENSG00000176716","11",7726436,7729684,3248
"13993","ENSG00000176720","2",241551424,241574131,22707
"13994","ENSG00000176723","16",31432593,31443160,10567
"13995","ENSG00000176728","Y",18772706,19077563,304857
"13996","ENSG00000176731","8",85214048,85220421,6373
"13997","ENSG00000176732","2",24115371,24123477,8106
"13998","ENSG00000176746","X",26192440,26195646,3206
"13999","ENSG00000176749","17",32486993,32491253,4260
"14000","ENSG00000176752","11",5170351,5171296,945
"14001","ENSG00000176753","15",40250664,40252969,2305
"14002","ENSG00000176754","1",204032447,204041265,8818
"14003","ENSG00000176761","19",44467641,44473227,5586
"14004","ENSG00000176769","10",131092391,131311721,219330
"14005","ENSG00000176771","2",132671788,133568463,896675
"14006","ENSG00000176774","X",26138343,26140735,2392
"14007","ENSG00000176782","8",7836471,7841242,4771
"14008","ENSG00000176783","5",179550554,179610012,59458
"14009","ENSG00000176787","11",5058650,5059627,977
"14010","ENSG00000176788","5",17065598,17276843,211245
"14011","ENSG00000176809","17",64854312,64919480,65168
"14012","ENSG00000176812","X",25194381,25195207,826
"14013","ENSG00000176826","7",55681074,55713252,32178
"14014","ENSG00000176834","12",118063593,118136026,72433
"14015","ENSG00000176840","19",4769031,4785077,16046
"14016","ENSG00000176842","16",54930862,54934485,3623
"14017","ENSG00000176845","17",83079609,83095122,15513
"14018","ENSG00000176853","8",123768439,123815452,47013
"14019","ENSG00000176855","1",182959074,182960405,1331
"14020","ENSG00000176857","5",109051315,109052457,1142
"14021","ENSG00000176871","12",118032694,118062430,29736
"14022","ENSG00000176882","13",49620314,49620646,332
"14023","ENSG00000176884","9",137139154,137168756,29602
"14024","ENSG00000176887","2",5692384,5701385,9001
"14025","ENSG00000176890","18",657653,673578,15925
"14026","ENSG00000176894","12",132687587,132704985,17398
"14027","ENSG00000176895","11",4903783,4909462,5679
"14028","ENSG00000176896","X",13653189,13681964,28775
"14029","ENSG00000176903","14",73711783,73714372,2589
"14030","ENSG00000176904","11",4859610,4863652,4042
"14031","ENSG00000176907","8",40153455,40155308,1853
"14032","ENSG00000176909","19",48712725,48719725,7000
"14033","ENSG00000176912","18",623743,658340,34597
"14034","ENSG00000176915","12",132725503,132761832,36329
"14035","ENSG00000176919","9",136945185,136946975,1790
"14036","ENSG00000176920","19",48695971,48705950,9979
"14037","ENSG00000176923","19",14927052,14928060,1008
"14038","ENSG00000176927","17",29929200,30108452,179252
"14039","ENSG00000176928","5",75025346,75052770,27424
"14040","ENSG00000176933","6",28217643,28218634,991
"14041","ENSG00000176945","3",195720884,195741123,20239
"14042","ENSG00000176946","2",241584405,241637158,52753
"14043","ENSG00000176953","16",28950807,28967097,16290
"14044","ENSG00000176956","8",143157914,143160711,2797
"14045","ENSG00000176970","X",148464708,148465428,720
"14046","ENSG00000176971","11",26994184,26996121,1937
"14047","ENSG00000176973","11",65572349,65574198,1849
"14048","ENSG00000176974","17",18327860,18363563,35703
"14049","ENSG00000176978","9",137110546,137115177,4631
"14050","ENSG00000176979","4",165016458,165041749,25291
"14051","ENSG00000176984","11",120168977,120171679,2702
"14052","ENSG00000176986","10",73744372,73772161,27789
"14053","ENSG00000176988","X",147981337,148026665,45328
"14054","ENSG00000176994","17",18315293,18328056,12763
"14055","ENSG00000176998","6",29791753,29792750,997
"14056","ENSG00000177000","1",11785723,11806920,21197
"14057","ENSG00000177023","8",7470308,7475082,4774
"14058","ENSG00000177025","19",57958437,57974534,16097
"14059","ENSG00000177030","11",644233,706715,62482
"14060","ENSG00000177034","5",79976731,79991265,14534
"14061","ENSG00000177042","11",695428,705028,9600
"14062","ENSG00000177045","19",45764785,45769252,4467
"14063","ENSG00000177047","9",21140214,21142145,1931
"14064","ENSG00000177051","19",45710629,45730896,20267
"14065","ENSG00000177054","11",19117099,19176422,59323
"14066","ENSG00000177058","5",55625845,55773194,147349
"14067","ENSG00000177076","9",19409009,19452505,43496
"14068","ENSG00000177082","15",84639281,84654343,15062
"14069","ENSG00000177084","12",132623753,132687365,63612
"14070","ENSG00000177096","22",42074248,42079438,5190
"14071","ENSG00000177098","11",118133377,118152888,19511
"14072","ENSG00000177103","11",117427773,117817525,389752
"14073","ENSG00000177105","11",3826978,3840959,13981
"14074","ENSG00000177106","11",694438,727727,33289
"14075","ENSG00000177108","14",77131270,77142734,11464
"14076","ENSG00000177112","11",10541258,10599936,58678
"14077","ENSG00000177119","12",45215987,45440404,224417
"14078","ENSG00000177125","9",126860665,126885878,25213
"14079","ENSG00000177133","1",3059615,3068437,8822
"14080","ENSG00000177138","X",9024232,9295682,271450
"14081","ENSG00000177143","18",580357,582114,1757
"14082","ENSG00000177150","18",13663347,13726663,63316
"14083","ENSG00000177156","11",747415,765012,17597
"14084","ENSG00000177169","12",131894622,131923150,28528
"14085","ENSG00000177173","1",116532936,116534092,1156
"14086","ENSG00000177181","1",42380792,42424232,43440
"14087","ENSG00000177182","8",61057158,61501645,444487
"14088","ENSG00000177189","X",20149911,20267519,117608
"14089","ENSG00000177191","19",41425359,41428730,3371
"14090","ENSG00000177192","12",131929200,131945896,16696
"14091","ENSG00000177197","13",48328084,48328564,480
"14092","ENSG00000177200","16",53055033,53329150,274117
"14093","ENSG00000177202","19",48606742,48607714,972
"14094","ENSG00000177212","1",248269917,248277976,8059
"14095","ENSG00000177225","11",767220,777488,10268
"14096","ENSG00000177233","1",248121932,248122882,950
"14097","ENSG00000177234","10",120597949,120600124,2175
"14098","ENSG00000177238","16",31214091,31231537,17446
"14099","ENSG00000177239","9",137086985,137109183,22198
"14100","ENSG00000177261","2",214697727,214698059,332
"14101","ENSG00000177272","1",110672465,110674940,2475
"14102","ENSG00000177275","1",247924889,247935339,10450
"14103","ENSG00000177283","10",35638249,35642278,4029
"14104","ENSG00000177291","10",35605410,35608935,3525
"14105","ENSG00000177294","17",6776215,6797101,20886
"14106","ENSG00000177301","1",110519837,110631474,111637
"14107","ENSG00000177302","17",18271428,18315007,43579
"14108","ENSG00000177303","17",75500261,75515537,15276
"14109","ENSG00000177306","8",7246726,7247571,845
"14110","ENSG00000177311","3",141324213,141449792,125579
"14111","ENSG00000177324","X",18162931,18220883,57952
"14112","ENSG00000177335","8",143039209,143060684,21475
"14113","ENSG00000177337","18",3593732,3598363,4631
"14114","ENSG00000177338","17",73749270,73828520,79250
"14115","ENSG00000177340","12",31324316,31325829,1513
"14116","ENSG00000177350","14",55766177,55767717,1540
"14117","ENSG00000177352","3",49162535,49166331,3796
"14118","ENSG00000177354","10",49299170,49327492,28322
"14119","ENSG00000177359","12",31111652,31201235,89583
"14120","ENSG00000177363","11",62686406,62689530,3124
"14121","ENSG00000177369","17",49230853,49318011,87158
"14122","ENSG00000177370","17",997129,1003671,6542
"14123","ENSG00000177374","17",2054154,2063241,9087
"14124","ENSG00000177380","19",49119544,49151026,31482
"14125","ENSG00000177383","3",184710367,184712002,1635
"14126","ENSG00000177398","21",42062959,42143453,80494
"14127","ENSG00000177406","12",630858,664196,33338
"14128","ENSG00000177409","7",93130056,93148385,18329
"14129","ENSG00000177410","20",49278178,49299600,21422
"14130","ENSG00000177414","1",64203627,64267368,63741
"14131","ENSG00000177418","7",66556889,66557362,473
"14132","ENSG00000177425","12",79574979,79690964,115985
"14133","ENSG00000177426","18",3411608,3459978,48370
"14134","ENSG00000177427","17",18260597,18266552,5955
"14135","ENSG00000177432","4",88695915,88697829,1914
"14136","ENSG00000177447","11",27806443,27806996,553
"14137","ENSG00000177452","1",63788721,63789304,583
"14138","ENSG00000177453","5",43192071,43280850,88779
"14139","ENSG00000177455","16",28931939,28939347,7408
"14140","ENSG00000177459","8",98064522,98093610,29088
"14141","ENSG00000177462","1",247920252,247921956,1704
"14142","ENSG00000177463","3",14947584,15053600,106016
"14143","ENSG00000177464","19",45589764,45602212,12448
"14144","ENSG00000177465","14",73591706,73596496,4790
"14145","ENSG00000177469","17",42402449,42423256,20807
"14146","ENSG00000177476","1",247605586,247606515,929
"14147","ENSG00000177479","3",48918821,48986382,67561
"14148","ENSG00000177483","2",237798389,237842808,44419
"14149","ENSG00000177485","X",120250752,120258398,7646
"14150","ENSG00000177494","3",111592900,111595346,2446
"14151","ENSG00000177504","X",8169944,8171267,1323
"14152","ENSG00000177508","16",54283304,54286787,3483
"14153","ENSG00000177511","18",57352557,57371731,19174
"14154","ENSG00000177519","2",153477338,153478762,1424
"14155","ENSG00000177535","1",247449118,247458105,8987
"14156","ENSG00000177542","11",790475,798281,7806
"14157","ENSG00000177548","16",28904421,28936526,32105
"14158","ENSG00000177551","1",115836377,115843917,7540
"14159","ENSG00000177553","1",11777077,11779619,2542
"14160","ENSG00000177556","5",151742316,151772532,30216
"14161","ENSG00000177558","19",35224800,35228729,3929
"14162","ENSG00000177565","3",177019340,177228000,208660
"14163","ENSG00000177570","8",118189455,118622112,432657
"14164","ENSG00000177575","12",7470813,7503893,33080
"14165","ENSG00000177576","18",49477250,49487252,10002
"14166","ENSG00000177590","7",150746893,150747728,835
"14167","ENSG00000177595","11",799179,809753,10574
"14168","ENSG00000177596","13",74412957,74419115,6158
"14169","ENSG00000177599","19",11797667,11809622,11955
"14170","ENSG00000177600","11",809965,812880,2915
"14171","ENSG00000177602","17",3723903,3726699,2796
"14172","ENSG00000177606","1",58780788,58784327,3539
"14173","ENSG00000177613","10",51695487,51699591,4104
"14174","ENSG00000177614","1",230314490,230426332,111842
"14175","ENSG00000177627","12",48482498,48496386,13888
"14176","ENSG00000177628","1",155234452,155244699,10247
"14177","ENSG00000177640","10",118046279,118210158,163879
"14178","ENSG00000177646","3",128879596,128916067,36471
"14179","ENSG00000177663","22",17084954,17115694,30740
"14180","ENSG00000177666","11",818914,825573,6659
"14181","ENSG00000177669","8",30131824,30144686,12862
"14182","ENSG00000177673","2",231592901,231594283,1382
"14183","ENSG00000177674","1",11736084,11754802,18718
"14184","ENSG00000177675","12",7346685,7479897,133212
"14185","ENSG00000177679","7",76201896,76287288,85392
"14186","ENSG00000177683","7",108554543,108569750,15207
"14187","ENSG00000177684","6",49960249,49964105,3856
"14188","ENSG00000177685","11",826144,831991,5847
"14189","ENSG00000177688","6",149400227,149401292,1065
"14190","ENSG00000177689","X",27807990,27823014,15024
"14191","ENSG00000177692","21",33485530,33491720,6190
"14192","ENSG00000177694","3",174438573,175810548,1371975
"14193","ENSG00000177697","11",832887,839831,6944
"14194","ENSG00000177699","15",78978889,78985926,7037
"14195","ENSG00000177700","11",837356,842529,5173
"14196","ENSG00000177706","7",192571,260772,68201
"14197","ENSG00000177707","3",111070071,111275563,205492
"14198","ENSG00000177710","8",11330888,11332208,1320
"14199","ENSG00000177721","5",43039081,43043170,4089
"14200","ENSG00000177725","8",22169338,22171710,2372
"14201","ENSG00000177728","17",75441159,75500452,59293
"14202","ENSG00000177731","17",18244815,18258738,13923
"14203","ENSG00000177732","20",325595,330224,4629
"14204","ENSG00000177733","5",137745651,137754376,8725
"14205","ENSG00000177736","9",124968294,124968840,546
"14206","ENSG00000177738","5",43013060,43067452,54392
"14207","ENSG00000177752","4",44622065,44678556,56491
"14208","ENSG00000177757","1",817371,819837,2466
"14209","ENSG00000177776","14",74377818,74378418,600
"14210","ENSG00000177788","1",229256892,229271242,14350
"14211","ENSG00000177791","10",73631654,73641757,10103
"14212","ENSG00000177800","1",229249636,229251810,2174
"14213","ENSG00000177807","1",159998651,160070160,71509
"14214","ENSG00000177822","4",181874438,182145249,270811
"14215","ENSG00000177830","11",867860,915058,47198
"14216","ENSG00000177839","5",141187127,141191541,4414
"14217","ENSG00000177842","3",40477131,40518736,41605
"14218","ENSG00000177853","10",96129715,96205288,75573
"14219","ENSG00000177854","X",153972754,153983194,10440
"14220","ENSG00000177855","2",183607442,183608119,677
"14221","ENSG00000177868","1",42807052,42817397,10345
"14222","ENSG00000177873","3",40477113,40490236,13123
"14223","ENSG00000177875","12",48183584,48185926,2342
"14224","ENSG00000177879","5",115841592,115914081,72489
"14225","ENSG00000177885","17",75318076,75405709,87633
"14226","ENSG00000177888","1",197153680,197200542,46862
"14227","ENSG00000177889","12",93405673,93441947,36274
"14228","ENSG00000177910","9",88129458,88138446,8988
"14229","ENSG00000177917","2",152717893,152761253,43360
"14230","ENSG00000177932","5",179060415,179083537,23122
"14231","ENSG00000177938","12",18738101,18739187,1086
"14232","ENSG00000177943","9",136850943,136860799,9856
"14233","ENSG00000177946","16",89969773,89972832,3059
"14234","ENSG00000177947","11",196738,200261,3523
"14235","ENSG00000177951","11",167784,207428,39644
"14236","ENSG00000177954","1",153990762,153992155,1393
"14237","ENSG00000177963","11",207511,215113,7602
"14238","ENSG00000177971","15",75639085,75648706,9621
"14239","ENSG00000177981","12",48147789,48181213,33424
"14240","ENSG00000177984","9",136759634,136766255,6621
"14241","ENSG00000177989","22",50529710,50532580,2870
"14242","ENSG00000177990","12",63558913,63668939,110026
"14243","ENSG00000177992","9",87882826,87888899,6073
"14244","ENSG00000177994","2",54330034,54383742,53708
"14245","ENSG00000178015","5",95620087,95622142,2055
"14246","ENSG00000178021","2",54253178,54256229,3051
"14247","ENSG00000178026","22",24585620,24593208,7588
"14248","ENSG00000178028","1",44213455,44220681,7226
"14249","ENSG00000178031","9",17906563,18910950,1004387
"14250","ENSG00000178033","6",116511639,116524788,13149
"14251","ENSG00000178035","3",49024325,49029408,5083
"14252","ENSG00000178038","3",46668995,46693704,24709
"14253","ENSG00000178053","3",158571163,158607252,36089
"14254","ENSG00000178055","3",46829542,46834095,4553
"14255","ENSG00000178057","3",49020459,49023495,3036
"14256","ENSG00000178074","2",199911293,199955935,44642
"14257","ENSG00000178075","3",113828182,113947174,118992
"14258","ENSG00000178078","19",4324043,4342786,18743
"14259","ENSG00000178081","15",30103720,30131757,28037
"14260","ENSG00000178082","17",29203426,29204474,1048
"14261","ENSG00000178084","3",184053047,184060671,7624
"14262","ENSG00000178093","19",19512418,19515685,3267
"14263","ENSG00000178096","1",149887890,149900798,12908
"14264","ENSG00000178104","1",148808181,149048286,240105
"14265","ENSG00000178105","11",108665069,108940927,275858
"14266","ENSG00000178107","14",21108043,21116703,8660
"14267","ENSG00000178115","15",30552078,30562501,10423
"14268","ENSG00000178125","8",66964099,67056604,92505
"14269","ENSG00000178127","18",9102630,9134345,31715
"14270","ENSG00000178146","X",101778969,101780538,1569
"14271","ENSG00000178149","3",49015488,49022293,6805
"14272","ENSG00000178150","19",48270081,48287608,17527
"14273","ENSG00000178162","2",130416755,130431363,14608
"14274","ENSG00000178163","4",10439880,10457426,17546
"14275","ENSG00000178171","2",130755435,130768134,12699
"14276","ENSG00000178172","5",148202794,148215137,12343
"14277","ENSG00000178175","5",72439903,72507410,67507
"14278","ENSG00000178177","4",17841199,18021876,180677
"14279","ENSG00000178184","18",80157232,80247514,90282
"14280","ENSG00000178187","5",178941191,178966433,25242
"14281","ENSG00000178188","16",28846600,28874212,27612
"14282","ENSG00000178199","6",149446795,149485061,38266
"14283","ENSG00000178201","19",57454790,57457142,2352
"14284","ENSG00000178202","11",108472112,108498384,26272
"14285","ENSG00000178209","8",143915147,143976734,61587
"14286","ENSG00000178217","10",80537902,80646560,108658
"14287","ENSG00000178222","4",1056250,1113564,57314
"14288","ENSG00000178226","16",31138925,31150094,11169
"14289","ENSG00000178229","19",57320472,57330770,10298
"14290","ENSG00000178233","6",44270466,44307506,37040
"14291","ENSG00000178234","7",152025674,152122340,96666
"14292","ENSG00000178235","13",83877205,83882393,5188
"14293","ENSG00000178243","9",135343249,135346562,3313
"14294","ENSG00000178248","22",23462086,23486980,24894
"14295","ENSG00000178252","3",49007062,49015953,8891
"14296","ENSG00000178257","16",11273218,11273641,423
"14297","ENSG00000178279","16",11267748,11269533,1785
"14298","ENSG00000178287","8",7847876,7868867,20991
"14299","ENSG00000178295","2",17753858,17788946,35088
"14300","ENSG00000178297","19",2360238,2426239,66001
"14301","ENSG00000178301","11",77589391,77610355,20964
"14302","ENSG00000178307","17",21197280,21214624,17344
"14303","ENSG00000178338","5",178859953,178888122,28169
"14304","ENSG00000178342","18",79863668,79900184,36516
"14305","ENSG00000178343","4",42397488,42402487,4999
"14306","ENSG00000178358","11",6920974,6922043,1069
"14307","ENSG00000178363","10",5524009,5526771,2762
"14308","ENSG00000178372","10",5498697,5499555,858
"14309","ENSG00000178381","7",1152071,1160759,8688
"14310","ENSG00000178385","2",207821288,208025527,204239
"14311","ENSG00000178386","19",44051367,44067999,16632
"14312","ENSG00000178394","5",63960356,63962507,2151
"14313","ENSG00000178395","1",223393417,223395470,2053
"14314","ENSG00000178397","7",6329411,6348981,19570
"14315","ENSG00000178401","12",49346888,49357546,10658
"14316","ENSG00000178403","4",112513516,112516180,2664
"14317","ENSG00000178404","17",78870910,78903217,32307
"14318","ENSG00000178409","6",107065182,107115269,50087
"14319","ENSG00000178412","18",79638928,79679745,40817
"14320","ENSG00000178425","6",116100851,116249497,148646
"14321","ENSG00000178429","10",84560443,84561263,820
"14322","ENSG00000178440","10",49942056,50011654,69598
"14323","ENSG00000178445","9",6532464,6645783,113319
"14324","ENSG00000178449","12",50112082,50120457,8375
"14325","ENSG00000178457","21",28013363,28023233,9870
"14326","ENSG00000178458","4",139698144,139698554,410
"14327","ENSG00000178460","8",66870749,66922048,51299
"14328","ENSG00000178462","10",5393101,5404828,11727
"14329","ENSG00000178464","19",12643275,12643919,644
"14330","ENSG00000178467","3",48989889,49007153,17264
"14331","ENSG00000178473","10",5364966,5374692,9726
"14332","ENSG00000178498","12",57604622,57609804,5182
"14333","ENSG00000178502","17",41848518,41865423,16905
"14334","ENSG00000178522","4",70592256,70607288,15032
"14335","ENSG00000178531","19",7924491,7926135,1644
"14336","ENSG00000178537","3",48856926,48898904,41978
"14337","ENSG00000178538","8",60185412,60281400,95988
"14338","ENSG00000178562","2",203706475,203738912,32437
"14339","ENSG00000178567","3",36985043,36993168,8125
"14340","ENSG00000178568","2",211375717,212538841,1163124
"14341","ENSG00000178573","16",79585843,79600737,14894
"14342","ENSG00000178585","1",9848276,9910336,62060
"14343","ENSG00000178586","2",240045077,240047027,1950
"14344","ENSG00000178591","20",87250,97094,9844
"14345","ENSG00000178596","1",94302038,94303022,984
"14346","ENSG00000178597","4",7430285,7434930,4645
"14347","ENSG00000178602","2",240139026,240144562,5536
"14348","ENSG00000178605","X",304529,318819,14290
"14349","ENSG00000178607","17",64039142,64130819,91677
"14350","ENSG00000178623","2",240605430,240631259,25829
"14351","ENSG00000178631","3",139493809,139494937,1128
"14352","ENSG00000178636","4",119192773,119212644,19871
"14353","ENSG00000178645","10",49679651,49710261,30610
"14354","ENSG00000178654","9",7597823,7598377,554
"14355","ENSG00000178660","3",94506766,94507620,854
"14356","ENSG00000178662","2",165469647,165689407,219760
"14357","ENSG00000178665","7",55887456,55942530,55074
"14358","ENSG00000178685","8",143977153,144012772,35619
"14359","ENSG00000178690","18",54587757,54599493,11736
"14360","ENSG00000178691","17",31937007,32001038,64031
"14361","ENSG00000178694","3",94062980,94131832,68852
"14362","ENSG00000178695","13",76880166,76886390,6224
"14363","ENSG00000178700","3",94047836,94063389,15553
"14364","ENSG00000178715","1",15828232,15828669,437
"14365","ENSG00000178718","15",74954416,74957464,3048
"14366","ENSG00000178719","8",143990056,143993415,3359
"14367","ENSG00000178722","5",61610424,61793401,182977
"14368","ENSG00000178723","9",34917175,34918296,1121
"14369","ENSG00000178726","20",23045633,23049741,4108
"14370","ENSG00000178732","3",194394821,194398354,3533
"14371","ENSG00000178734","13",75871038,75883811,12773
"14372","ENSG00000178741","15",74919791,74938083,18292
"14373","ENSG00000178750","3",94014365,94028597,14232
"14374","ENSG00000178752","2",238158970,238168900,9930
"14375","ENSG00000178761","15",74899992,74906883,6891
"14376","ENSG00000178762","6",25731782,25732091,309
"14377","ENSG00000178764","8",122781655,122974510,192855
"14378","ENSG00000178772","3",194339768,194351328,11560
"14379","ENSG00000178773","16",89575758,89597246,21488
"14380","ENSG00000178776","5",147880726,147906538,25812
"14381","ENSG00000178789","17",74521174,74531475,10301
"14382","ENSG00000178795","11",77216558,77301687,85129
"14383","ENSG00000178796","1",151710433,151729805,19372
"14384","ENSG00000178802","15",74890005,74902219,12214
"14385","ENSG00000178803","22",24429206,24495074,65868
"14386","ENSG00000178804","3",129543214,129551467,8253
"14387","ENSG00000178809","7",75395063,75410996,15933
"14388","ENSG00000178814","8",144051266,144063965,12699
"14389","ENSG00000178821","1",1917590,1919279,1689
"14390","ENSG00000178826","7",143279957,143288048,8091
"14391","ENSG00000178828","1",19814029,19815283,1254
"14392","ENSG00000178836","2",233754305,233755345,1040
"14393","ENSG00000178852","17",47323290,47441312,118022
"14394","ENSG00000178860","8",71841549,71844468,2919
"14395","ENSG00000178878","12",12725917,12829975,104058
"14396","ENSG00000178882","12",123973241,124316024,342783
"14397","ENSG00000178896","8",144078648,144080648,2000
"14398","ENSG00000178904","19",32405543,32485895,80352
"14399","ENSG00000178913","5",141260225,141320821,60596
"14400","ENSG00000178917","3",44494847,44510636,15789
"14401","ENSG00000178919","9",97853254,97856715,3461
"14402","ENSG00000178921","17",8247618,8270491,22873
"14403","ENSG00000178922","1",43451003,43453989,2986
"14404","ENSG00000178927","17",82442586,82450829,8243
"14405","ENSG00000178928","19",47801243,47819051,17808
"14406","ENSG00000178934","19",38789211,38791749,2538
"14407","ENSG00000178935","19",57803841,57814913,11072
"14408","ENSG00000178947","X",135421944,135428075,6131
"14409","ENSG00000178950","4",849276,932373,83097
"14410","ENSG00000178951","19",4043303,4066899,23596
"14411","ENSG00000178952","16",28842411,28846348,3937
"14412","ENSG00000178965","1",74568117,74673792,105675
"14413","ENSG00000178966","9",83980711,84004074,23363
"14414","ENSG00000178971","17",8224815,8248056,23241
"14415","ENSG00000178974","14",55271421,55361918,90497
"14416","ENSG00000178977","17",8220642,8224043,3401
"14417","ENSG00000178980","19",47778585,47784686,6101
"14418","ENSG00000178982","19",38619082,38636955,17873
"14419","ENSG00000178988","4",6707701,6709865,2164
"14420","ENSG00000178996","5",54517759,54546586,28827
"14421","ENSG00000178997","15",41182725,41230743,48018
"14422","ENSG00000178999","17",8204733,8210600,5867
"14423","ENSG00000179002","1",18839599,18859682,20083
"14424","ENSG00000179008","14",60396469,60515543,119074
"14425","ENSG00000179010","4",6640091,6642745,2654
"14426","ENSG00000179021","3",88149959,88168729,18770
"14427","ENSG00000179023","1",18480982,18486126,5144
"14428","ENSG00000179029","17",8173237,8176399,3162
"14429","ENSG00000179031","X",100910712,100911489,777
"14430","ENSG00000179038","11",67195569,67197167,1598
"14431","ENSG00000179041","8",66429014,66430733,1719
"14432","ENSG00000179044","16",67184379,67190185,5806
"14433","ENSG00000179046","4",188091273,188109603,18330
"14434","ENSG00000179051","1",17406760,17439677,32917
"14435","ENSG00000179055","9",104694379,104695485,1106
"14436","ENSG00000179057","11",18704305,18726230,21925
"14437","ENSG00000179058","9",129612225,129620776,8551
"14438","ENSG00000179059","4",187995771,188005046,9275
"14439","ENSG00000179066","19",35090930,35113664,22734
"14440","ENSG00000179071","11",85683848,85686195,2347
"14441","ENSG00000179073","6",132608225,132609302,1077
"14442","ENSG00000179082","9",129321016,129324905,3889
"14443","ENSG00000179083","X",93674013,93712274,38261
"14444","ENSG00000179085","1",155139891,155140595,704
"14445","ENSG00000179088","12",103237591,103496010,258419
"14446","ENSG00000179091","8",144095039,144097525,2486
"14447","ENSG00000179094","17",8140472,8156506,16034
"14448","ENSG00000179097","3",87990696,87993835,3139
"14449","ENSG00000179101","X",123514473,123514872,399
"14450","ENSG00000179104","12",82686880,83134870,447990
"14451","ENSG00000179111","17",8120592,8124106,3514
"14452","ENSG00000179115","19",12922479,12934037,11558
"14453","ENSG00000179119","11",18606403,18634791,28388
"14454","ENSG00000179131","7",66914581,66914943,362
"14455","ENSG00000179133","10",23201916,23344845,142929
"14456","ENSG00000179134","19",39342396,39385710,43314
"14457","ENSG00000179136","17",12549764,12642854,93090
"14458","ENSG00000179141","13",29476515,29490105,13590
"14459","ENSG00000179142","8",142910559,142917843,7284
"14460","ENSG00000179144","7",150514872,150521073,6201
"14461","ENSG00000179148","17",8095900,8119047,23147
"14462","ENSG00000179151","15",74630558,74696292,65734
"14463","ENSG00000179152","3",44338119,44409451,71332
"14464","ENSG00000179163","1",23845077,23868294,23217
"14465","ENSG00000179165","6",36390551,36442854,52303
"14466","ENSG00000179168","19",38384265,38388082,3817
"14467","ENSG00000179172","1",12847408,12848725,1317
"14468","ENSG00000179178","1",43269983,43274002,4019
"14469","ENSG00000179195","12",123971845,124015439,43594
"14470","ENSG00000179213","19",51246348,51269330,22982
"14471","ENSG00000179218","19",12938578,12944489,5911
"14472","ENSG00000179219","16",85282958,85285963,3005
"14473","ENSG00000179222","X",51803007,51902357,99350
"14474","ENSG00000179240","11",76381303,76414619,33316
"14475","ENSG00000179241","11",35943981,36232136,288155
"14476","ENSG00000179242","20",61252261,61940617,688356
"14477","ENSG00000179253","20",61717506,61719748,2242
"14478","ENSG00000179256","12",14804650,14814182,9532
"14479","ENSG00000179262","19",12945855,12953642,7787
"14480","ENSG00000179270","2",29060976,29074523,13547
"14481","ENSG00000179271","19",12953119,12957223,4104
"14482","ENSG00000179277","17",15786618,15787575,957
"14483","ENSG00000179284","19",12965159,12974762,9603
"14484","ENSG00000179292","11",66291894,66296664,4770
"14485","ENSG00000179295","12",112418351,112509913,91562
"14486","ENSG00000179299","4",40749925,40811184,61259
"14487","ENSG00000179300","X",78656069,78659328,3259
"14488","ENSG00000179304","X",52891306,52908560,17254
"14489","ENSG00000179314","17",6057807,6124427,66620
"14490","ENSG00000179331","11",107928448,107963482,35034
"14491","ENSG00000179335","15",74598500,74645414,46914
"14492","ENSG00000179342","7",66505155,66506223,1068
"14493","ENSG00000179344","6",32659467,32668383,8916
"14494","ENSG00000179348","3",128479427,128493185,13758
"14495","ENSG00000179361","15",74541177,74598131,56954
"14496","ENSG00000179362","15",45511136,45586290,75154
"14497","ENSG00000179363","X",103710909,103714032,3123
"14498","ENSG00000179364","14",105300563,105398147,97584
"14499","ENSG00000179387","4",140524168,140553770,29602
"14500","ENSG00000179388","8",22687659,22693480,5821
"14501","ENSG00000179397","1",244454377,244641177,186800
"14502","ENSG00000179399","13",91398621,92873682,1475061
"14503","ENSG00000179403","1",1434861,1442882,8021
"14504","ENSG00000179406","7",66376044,66493566,117522
"14505","ENSG00000179407","3",128462439,128467248,4809
"14506","ENSG00000179409","17",744421,753999,9578
"14507","ENSG00000179428","7",22725395,22727620,2225
"14508","ENSG00000179431","11",35618419,35620868,2449
"14509","ENSG00000179443","9",35991336,35992285,949
"14510","ENSG00000179447","20",19242302,19284596,42294
"14511","ENSG00000179452","1",181236388,181238604,2216
"14512","ENSG00000179454","14",44924319,45042322,118003
"14513","ENSG00000179455","15",23565674,23630075,64401
"14514","ENSG00000179456","1",244048939,244057476,8537
"14515","ENSG00000179460","7",20582072,20583206,1134
"14516","ENSG00000179468","7",143026158,143027195,1037
"14517","ENSG00000179476","14",44897275,44907257,9982
"14518","ENSG00000179477","17",8072636,8087716,15080
"14519","ENSG00000179520","12",100357079,100422059,64980
"14520","ENSG00000179523","15",44527257,44537046,9789
"14521","ENSG00000179526","8",144098633,144108124,9491
"14522","ENSG00000179528","2",74497517,74503316,5799
"14523","ENSG00000179532","11",6497260,6593758,96498
"14524","ENSG00000179542","X",143622790,143636101,13311
"14525","ENSG00000179546","1",23191895,23194729,2834
"14526","ENSG00000179562","7",127580628,127593611,12983
"14527","ENSG00000179564","3",50279087,50288114,9027
"14528","ENSG00000179571","1",143595216,143635641,40425
"14529","ENSG00000179577","8",104419512,104421500,1988
"14530","ENSG00000179580","16",1966823,1968975,2152
"14531","ENSG00000179583","16",10866222,10943021,76799
"14532","ENSG00000179588","16",88453280,88537031,83751
"14533","ENSG00000179593","17",8039034,8049134,10100
"14534","ENSG00000179598","17",17200995,17206333,5338
"14535","ENSG00000179600","14",63312835,63318879,6044
"14536","ENSG00000179603","7",126438598,127253294,814696
"14537","ENSG00000179604","17",73283624,73312005,28381
"14538","ENSG00000179611","13",43968424,43971199,2775
"14539","ENSG00000179615","12",55572468,55575612,3144
"14540","ENSG00000179627","14",104800596,104804712,4116
"14541","ENSG00000179630","13",43879284,43893932,14648
"14542","ENSG00000179632","8",144104461,144107611,3150
"14543","ENSG00000179636","14",21024109,21036276,12167
"14544","ENSG00000179639","1",159289714,159308224,18510
"14545","ENSG00000179673","17",46978156,46979253,1097
"14546","ENSG00000179674","3",160677159,160678452,1293
"14547","ENSG00000179676","18",64079989,64149088,69099
"14548","ENSG00000179695","12",55444069,55453347,9278
"14549","ENSG00000179698","8",144107726,144118315,10589
"14550","ENSG00000179709","19",55947832,55988629,40797
"14551","ENSG00000179715","12",47079603,47236662,157059
"14552","ENSG00000179743","1",15834474,15848147,13673
"14553","ENSG00000179750","22",38982347,38992804,10457
"14554","ENSG00000179751","19",39202831,39204266,1435
"14555","ENSG00000179755","16",35021749,35024229,2480
"14556","ENSG00000179761","17",28950513,29057216,106703
"14557","ENSG00000179766","9",35406755,35483035,76280
"14558","ENSG00000179772","20",31844301,31845619,1318
"14559","ENSG00000179774","10",68230624,68232103,1479
"14560","ENSG00000179776","16",66366622,66404784,38162
"14561","ENSG00000179796","3",26622806,26717537,94731
"14562","ENSG00000179799","3",75356437,75362268,5831
"14563","ENSG00000179813","13",42781550,42791549,9999
"14564","ENSG00000179817","11",18172837,18174280,1443
"14565","ENSG00000179818","2",69962263,70103220,140957
"14566","ENSG00000179820","19",53864763,53876435,11672
"14567","ENSG00000179826","11",18120955,18138480,17525
"14568","ENSG00000179832","8",144148016,144261940,113924
"14569","ENSG00000179833","2",64631621,64751005,119384
"14570","ENSG00000179840","1",9652610,9654586,1976
"14571","ENSG00000179841","14",64465499,64474503,9004
"14572","ENSG00000179846","19",45149750,45158737,8987
"14573","ENSG00000179855","19",3585478,3593541,8063
"14574","ENSG00000179859","17",7913324,7916276,2952
"14575","ENSG00000179862","1",40861051,40862366,1315
"14576","ENSG00000179869","7",48171458,48647497,476039
"14577","ENSG00000179873","19",55785397,55836800,51403
"14578","ENSG00000179886","8",143597835,143603224,5389
"14579","ENSG00000179889","16",14974591,15139339,164748
"14580","ENSG00000179899","12",55411727,55414787,3060
"14581","ENSG00000179902","1",109105951,109113857,7906
"14582","ENSG00000179909","19",57697367,57709194,11827
"14583","ENSG00000179912","12",57253762,57431005,177243
"14584","ENSG00000179913","19",17794828,17813082,18254
"14585","ENSG00000179914","1",160876540,160885180,8640
"14586","ENSG00000179915","2",49918503,51225575,1307072
"14587","ENSG00000179918","16",30443631,30446181,2550
"14588","ENSG00000179921","2",218259496,218263861,4365
"14589","ENSG00000179922","19",55620742,55624601,3859
"14590","ENSG00000179930","1",182054570,182061712,7142
"14591","ENSG00000179933","14",23095505,23100456,4951
"14592","ENSG00000179934","3",39329706,39333511,3805
"14593","ENSG00000179935","20",18786065,18794579,8514
"14594","ENSG00000179938","15",30083053,30093499,10446
"14595","ENSG00000179941","12",76344474,76348415,3941
"14596","ENSG00000179943","19",55591376,55601970,10594
"14597","ENSG00000179950","8",143816344,143829859,13515
"14598","ENSG00000179954","19",55488404,55519099,30695
"14599","ENSG00000179958","16",30423619,30430075,6456
"14600","ENSG00000179965","16",30407297,30431108,23811
"14601","ENSG00000179967","4",139114930,139115374,444
"14602","ENSG00000179978","5",70094659,70128434,33775
"14603","ENSG00000179981","18",75210755,75289950,79195
"14604","ENSG00000179988","10",122954381,122997513,43132
"14605","ENSG00000179994","7",72862757,72871581,8824
"14606","ENSG00000179997","2",174501952,174502312,360
"14607","ENSG00000180008","14",55027230,55049489,22259
"14608","ENSG00000180011","18",75195113,75209139,14026
"14609","ENSG00000180015","4",188738373,188739494,1121
"14610","ENSG00000180016","17",3397104,3398410,1306
"14611","ENSG00000180019","7",112446164,112446375,211
"14612","ENSG00000180035","16",30378106,30400108,22002
"14613","ENSG00000180042","17",3385930,3386874,944
"14614","ENSG00000180043","19",55354908,55363260,8352
"14615","ENSG00000180044","3",160225496,160228213,2717
"14616","ENSG00000180061","19",55312801,55334048,21247
"14617","ENSG00000180066","10",132444327,132449408,5081
"14618","ENSG00000180071","9",38571358,38620596,49238
"14619","ENSG00000180083","20",45648563,45670270,21707
"14620","ENSG00000180089","19",55226639,55229264,2625
"14621","ENSG00000180090","17",3291017,3298360,7343
"14622","ENSG00000180096","16",30378133,30395991,17858
"14623","ENSG00000180098","1",28553085,28578545,25460
"14624","ENSG00000180104","5",443175,471937,28762
"14625","ENSG00000180105","2",206410087,206410909,822
"14626","ENSG00000180113","6",46687875,46704319,16444
"14627","ENSG00000180116","12",39626167,39908300,282133
"14628","ENSG00000180138","13",37103259,37105664,2405
"14629","ENSG00000180139","10",88932390,88940820,8430
"14630","ENSG00000180152","2",112853328,112854122,794
"14631","ENSG00000180155","8",142771197,142777810,6613
"14632","ENSG00000180172","13",21094315,21094714,399
"14633","ENSG00000180176","11",2163929,2171877,7948
"14634","ENSG00000180178","2",130012065,130040560,28495
"14635","ENSG00000180182","X",40648305,40735858,87553
"14636","ENSG00000180185","16",1826941,1840207,13266
"14637","ENSG00000180189","14",58284773,58285363,590
"14638","ENSG00000180190","8",489792,545781,55989
"14639","ENSG00000180198","1",28505943,28539300,33357
"14640","ENSG00000180205","20",45607939,45631268,23329
"14641","ENSG00000180209","16",30370934,30377991,7057
"14642","ENSG00000180210","11",46719180,46739506,20326
"14643","ENSG00000180211","6",39958414,39958833,419
"14644","ENSG00000180219","12",99647753,99650114,2361
"14645","ENSG00000180221","10",58212541,58213036,495
"14646","ENSG00000180228","2",178431414,178451512,20098
"14647","ENSG00000180229","15",20379495,20506180,126685
"14648","ENSG00000180230","10",119997086,119997709,623
"14649","ENSG00000180233","7",30284597,30367689,83092
"14650","ENSG00000180245","4",109827994,109849123,21129
"14651","ENSG00000180251","2",102473303,102533972,60669
"14652","ENSG00000180257","19",52949379,52962911,13532
"14653","ENSG00000180259","20",4731279,4740668,9389
"14654","ENSG00000180263","12",95076749,95217482,140733
"14655","ENSG00000180264","9",124451425,124478589,27164
"14656","ENSG00000180269","16",20031485,20073917,42432
"14657","ENSG00000180279","19",50808874,50818880,10006
"14658","ENSG00000180284","X",103651735,103652106,371
"14659","ENSG00000180287","1",242082986,242524696,441710
"14660","ENSG00000180304","15",64687573,64703281,15708
"14661","ENSG00000180305","20",45629739,45631196,1457
"14662","ENSG00000180316","6",36243203,36312229,69026
"14663","ENSG00000180318","12",85280220,85301784,21564
"14664","ENSG00000180329","17",44673069,44689779,16710
"14665","ENSG00000180332","13",45192853,45194717,1864
"14666","ENSG00000180336","17",44656404,44690308,33904
"14667","ENSG00000180340","17",44557459,44559570,2111
"14668","ENSG00000180346","4",89111500,89114899,3399
"14669","ENSG00000180347","7",31514071,31658720,144649
"14670","ENSG00000180353","3",121631399,121660927,29528
"14671","ENSG00000180354","7",30134986,30162762,27776
"14672","ENSG00000180357","15",64460742,64686068,225326
"14673","ENSG00000180370","3",196739857,196832647,92790
"14674","ENSG00000180376","3",56557161,56621818,64657
"14675","ENSG00000180383","20",31465506,31476757,11251
"14676","ENSG00000180385","3",9986893,10006990,20097
"14677","ENSG00000180386","17",41275659,41276697,1038
"14678","ENSG00000180389","13",27945260,27945415,155
"14679","ENSG00000180398","2",46901870,46941855,39985
"14680","ENSG00000180422","16",89159146,89164245,5099
"14681","ENSG00000180423","11",46602861,46617909,15048
"14682","ENSG00000180424","20",31440632,31450257,9625
"14683","ENSG00000180425","11",114391443,114400511,9068
"14684","ENSG00000180432","3",42856005,42876165,20160
"14685","ENSG00000180438","3",13937273,14082811,145538
"14686","ENSG00000180440","13",36674020,36697839,23819
"14687","ENSG00000180447","9",86944362,86947506,3144
"14688","ENSG00000180448","19",1065923,1086628,20705
"14689","ENSG00000180458","19",37545470,37549171,3701
"14690","ENSG00000180475","11",58227882,58228918,1036
"14691","ENSG00000180479","19",37554782,37594790,40008
"14692","ENSG00000180481","12",75391089,75432688,41599
"14693","ENSG00000180483","20",31377164,31390590,13426
"14694","ENSG00000180488","1",77779624,77879539,99915
"14695","ENSG00000180509","21",34446688,34512210,65522
"14696","ENSG00000180525","10",649948,669581,19633
"14697","ENSG00000180530","21",14961235,15065936,104701
"14698","ENSG00000180532","19",57668935,57679152,10217
"14699","ENSG00000180535","7",98211427,98212979,1552
"14700","ENSG00000180537","6",13924446,13980310,55864
"14701","ENSG00000180539","9",137027464,137037957,10493
"14702","ENSG00000180543","8",97273474,97277964,4490
"14703","ENSG00000180549","9",137030174,137033010,2836
"14704","ENSG00000180573","6",26124145,26139116,14971
"14705","ENSG00000180574","12",10505602,10523135,17533
"14706","ENSG00000180581","10",91807179,91807439,260
"14707","ENSG00000180592","10",21513478,21526368,12890
"14708","ENSG00000180596","6",26114873,26123926,9053
"14709","ENSG00000180610","4",39770081,39771371,1290
"14710","ENSG00000180611","3",192796815,192917856,121041
"14711","ENSG00000180613","4",54099523,54102498,2975
"14712","ENSG00000180616","17",73165010,73176633,11623
"14713","ENSG00000180626","17",5179535,5191868,12333
"14714","ENSG00000180628","10",91163012,91284337,121325
"14715","ENSG00000180638","17",19678288,19718979,40691
"14716","ENSG00000180644","10",70597348,70602759,5411
"14717","ENSG00000180660","13",35474182,35477209,3027
"14718","ENSG00000180662","14",65467807,65468341,534
"14719","ENSG00000180663","16",31807926,31808844,918
"14720","ENSG00000180667","1",207043849,207052980,9131
"14721","ENSG00000180673","4",62816826,62818794,1968
"14722","ENSG00000180694","8",90621995,90791632,169637
"14723","ENSG00000180697","3",126526999,126558965,31966
"14724","ENSG00000180712","4",184334292,184353977,19685
"14725","ENSG00000180714","11",57917297,57918239,942
"14726","ENSG00000180720","11",46385098,46386608,1510
"14727","ENSG00000180723","11",4660853,4661763,910
"14728","ENSG00000180730","13",26044597,26051031,6434
"14729","ENSG00000180739","19",10512742,10517931,5189
"14730","ENSG00000180745","10",127877841,127892941,15100
"14731","ENSG00000180747","16",21446683,21520444,73761
"14732","ENSG00000180758","1",9100305,9129102,28797
"14733","ENSG00000180764","10",93958191,93961540,3349
"14734","ENSG00000180767","3",126524283,126543291,19008
"14735","ENSG00000180769","4",84965534,85011277,45743
"14736","ENSG00000180770","3",130021553,130022520,967
"14737","ENSG00000180772","X",116170744,116174974,4230
"14738","ENSG00000180773","11",93144174,93197991,53817
"14739","ENSG00000180776","13",21372573,21459370,86797
"14740","ENSG00000180777","18",14728272,14854038,125766
"14741","ENSG00000180785","11",4643420,4655488,12068
"14742","ENSG00000180787","17",5078467,5096374,17907
"14743","ENSG00000180801","4",113900284,113979727,79443
"14744","ENSG00000180803","13",25863250,25863667,417
"14745","ENSG00000180806","12",53994895,54003337,8442
"14746","ENSG00000180815","X",19360056,19515261,155205
"14747","ENSG00000180817","10",70202835,70233911,31076
"14748","ENSG00000180818","12",53985065,53990279,5214
"14749","ENSG00000180822","6",3231403,3303373,71970
"14750","ENSG00000180828","8",64580367,64583628,3261
"14751","ENSG00000180834","3",183815876,183825594,9718
"14752","ENSG00000180846","19",1952531,1954586,2055
"14753","ENSG00000180855","19",12429706,12441021,11315
"14754","ENSG00000180861","12",13371089,13387167,16078
"14755","ENSG00000180867","1",147172744,147179622,6878
"14756","ENSG00000180869","1",84628230,84635020,6790
"14757","ENSG00000180871","2",218125289,218137251,11962
"14758","ENSG00000180872","6",50042144,50049874,7730
"14759","ENSG00000180875","1",240489573,240612155,122582
"14760","ENSG00000180878","11",6205566,6211132,5566
"14761","ENSG00000180879","X",153793516,153798505,4989
"14762","ENSG00000180881","12",75275979,75390928,114949
"14763","ENSG00000180884","19",34956354,34964229,7875
"14764","ENSG00000180891","17",57861243,57955412,94169
"14765","ENSG00000180900","8",143790920,143815773,24853
"14766","ENSG00000180901","17",75032575,75065889,33314
"14767","ENSG00000180902","2",241734602,241768816,34214
"14768","ENSG00000180909","11",6151641,6152549,908
"14769","ENSG00000180914","3",8750408,8769628,19220
"14770","ENSG00000180917","16",71281389,71289715,8326
"14771","ENSG00000180919","11",6107684,6108835,1151
"14772","ENSG00000180921","8",143723933,143738234,14301
"14773","ENSG00000180926","19",9261015,9261716,701
"14774","ENSG00000180929","3",51955381,51957499,2118
"14775","ENSG00000180934","11",6019336,6034338,15002
"14776","ENSG00000180938","8",124973295,124979389,6094
"14777","ENSG00000180953","15",79898840,79923702,24862
"14778","ENSG00000180957","22",27851669,27920134,68465
"14779","ENSG00000180964","X",103252995,103255192,2197
"14780","ENSG00000180974","11",5880629,5887079,6450
"14781","ENSG00000180979","15",42537820,42548802,10982
"14782","ENSG00000180988","11",5820314,5821348,1034
"14783","ENSG00000180992","6",44113451,44127452,14001
"14784","ENSG00000180998","14",52552836,52637713,84877
"14785","ENSG00000180999","1",172420685,172468831,48146
"14786","ENSG00000181001","11",5786471,5791265,4794
"14787","ENSG00000181004","4",122732702,122744942,12240
"14788","ENSG00000181007","19",36383120,36418656,35536
"14789","ENSG00000181009","11",5776165,5783355,7190
"14790","ENSG00000181013","17",58541587,58544368,2781
"14791","ENSG00000181016","7",112480853,112491062,10209
"14792","ENSG00000181017","11",5761153,5767465,6312
"14793","ENSG00000181019","16",69706996,69726668,19672
"14794","ENSG00000181023","11",5736448,5738522,2074
"14795","ENSG00000181026","15",88621337,88632281,10944
"14796","ENSG00000181027","19",46746046,46776988,30942
"14797","ENSG00000181029","19",7680833,7687703,6870
"14798","ENSG00000181031","17",212389,386254,173865
"14799","ENSG00000181035","19",19063999,19112888,48889
"14800","ENSG00000181036","1",159800511,159816257,15746
"14801","ENSG00000181038","17",76726830,76733936,7106
"14802","ENSG00000181045","17",80219699,80253500,33801
"14803","ENSG00000181061","3",42784298,42804531,20233
"14804","ENSG00000181072","7",136868669,137020255,151586
"14805","ENSG00000181074","11",5754243,5755905,1662
"14806","ENSG00000181085","8",143716340,143722458,6118
"14807","ENSG00000181090","9",137618992,137870016,251024
"14808","ENSG00000181092","3",186842704,186858463,15759
"14809","ENSG00000181097","8",143696154,143698413,2259
"14810","ENSG00000181101","1",175044626,175045648,1022
"14811","ENSG00000181104","5",76716126,76735770,19644
"14812","ENSG00000181109","11",5726502,5727464,962
"14813","ENSG00000181123","22",30475364,30492804,17440
"14814","ENSG00000181126","6",29790954,29797811,6857
"14815","ENSG00000181135","8",143684452,143713898,29446
"14816","ENSG00000181143","19",8848844,8981342,132498
"14817","ENSG00000181163","5",171387116,171411137,24021
"14818","ENSG00000181171","8",123984138,124040782,56644
"14819","ENSG00000181191","X",69160851,69165793,4942
"14820","ENSG00000181192","10",12068954,12123221,54267
"14821","ENSG00000181195","8",56436674,56446671,9997
"14822","ENSG00000181211","7",43117896,43163187,45291
"14823","ENSG00000181215","4",5897373,6200555,303182
"14824","ENSG00000181218","1",228456979,228457873,894
"14825","ENSG00000181220","7",149472696,149497817,25121
"14826","ENSG00000181222","17",7484366,7514618,30252
"14827","ENSG00000181227","1",75743423,75744776,1353
"14828","ENSG00000181234","12",128267403,128707915,440512
"14829","ENSG00000181240","19",6426037,6433779,7742
"14830","ENSG00000181260","3",179464346,179465328,982
"14831","ENSG00000181264","11",120325129,120333682,8553
"14832","ENSG00000181274","10",97332497,97334709,2212
"14833","ENSG00000181284","17",7435443,7437679,2236
"14834","ENSG00000181291","17",34579487,34639318,59831
"14835","ENSG00000181296","11",56775261,56776206,945
"14836","ENSG00000181315","6",26634383,26659752,25369
"14837","ENSG00000181322","3",138261437,138329886,68449
"14838","ENSG00000181323","17",7420324,7421632,1308
"14839","ENSG00000181333","11",94021361,94113751,92390
"14840","ENSG00000181350","17",16441577,16492153,50576
"14841","ENSG00000181355","6",9596110,10211608,615498
"14842","ENSG00000181358","13",49890591,49892998,2407
"14843","ENSG00000181359","4",170581470,170605450,23980
"14844","ENSG00000181374","17",34356480,34358610,2130
"14845","ENSG00000181378","2",219002846,219041527,38681
"14846","ENSG00000181381","4",168356735,168537786,181051
"14847","ENSG00000181392","19",36003307,36008813,5506
"14848","ENSG00000181396","17",82389210,82418637,29427
"14849","ENSG00000181404","9",14475,73865,59390
"14850","ENSG00000181408","17",82374230,82375586,1356
"14851","ENSG00000181409","17",81117295,81166221,48926
"14852","ENSG00000181418","12",48995149,48999375,4226
"14853","ENSG00000181433","X",135889205,135913061,23856
"14854","ENSG00000181444","7",149764182,149773588,9406
"14855","ENSG00000181449","3",181711925,181714436,2511
"14856","ENSG00000181450","1",227563543,227677443,113900
"14857","ENSG00000181458","3",100492619,100577444,84825
"14858","ENSG00000181467","3",153162270,153170620,8350
"14859","ENSG00000181472","6",151364115,151391559,27444
"14860","ENSG00000181481","17",30970984,30999911,28927
"14861","ENSG00000181499","11",123942785,123943873,1088
"14862","ENSG00000181513","17",45132600,45144181,11581
"14863","ENSG00000181514","6",72598451,72599634,1183
"14864","ENSG00000181523","17",80206716,80220923,14207
"14865","ENSG00000181524","6",42956345,42956765,420
"14866","ENSG00000181541","4",150581922,150584693,2771
"14867","ENSG00000181544","X",14835961,14873069,37108
"14868","ENSG00000181552","14",20768427,20770948,2521
"14869","ENSG00000181555","3",47016429,47163967,147538
"14870","ENSG00000181562","14",20745892,20748380,2488
"14871","ENSG00000181577","6",44000580,44007612,7032
"14872","ENSG00000181585","3",46694528,46710886,16358
"14873","ENSG00000181588","19",1554669,1568058,13389
"14874","ENSG00000181609","11",5488685,5489749,1064
"14875","ENSG00000181610","17",57834781,57850056,15275
"14876","ENSG00000181616","11",5544489,5548533,4044
"14877","ENSG00000181617","4",70226071,70235252,9181
"14878","ENSG00000181619","14",59429022,59465342,36320
"14879","ENSG00000181625","16",29454501,29458219,3718
"14880","ENSG00000181626","18",12093853,12129749,35896
"14881","ENSG00000181631","3",151326312,151329549,3237
"14882","ENSG00000181634","9",114784652,114806039,21387
"14883","ENSG00000181638","8",143246821,143262705,15884
"14884","ENSG00000181649","11",2928273,2929420,1147
"14885","ENSG00000181652","7",151012209,151024499,12290
"14886","ENSG00000181656","1",100538139,100542021,3882
"14887","ENSG00000181666","19",37312837,37369365,56528
"14888","ENSG00000181690","8",56160909,56211324,50415
"14889","ENSG00000181698","11",56274154,56276819,2665
"14890","ENSG00000181704","X",68498562,68537282,38720
"14891","ENSG00000181722","3",114314501,115147271,832770
"14892","ENSG00000181741","20",34475924,34476474,550
"14893","ENSG00000181744","3",143971798,144048719,76921
"14894","ENSG00000181751","5",103258763,103278660,19897
"14895","ENSG00000181754","1",109504178,109509738,5560
"14896","ENSG00000181773","1",27392622,27395814,3192
"14897","ENSG00000181778","9",68536580,68540867,4287
"14898","ENSG00000181780","11",56071111,56072049,938
"14899","ENSG00000181781","19",463346,474983,11637
"14900","ENSG00000181786","19",8697397,8698822,1425
"14901","ENSG00000181788","3",150741125,150763477,22352
"14902","ENSG00000181789","3",129249606,129277773,28167
"14903","ENSG00000181790","8",142449430,142545009,95579
"14904","ENSG00000181798","2",231508422,231514366,5944
"14905","ENSG00000181800","10",11316834,11319884,3050
"14906","ENSG00000181803","14",20640696,20641691,995
"14907","ENSG00000181804","3",143265222,143848485,583263
"14908","ENSG00000181817","1",36391238,36397908,6670
"14909","ENSG00000181819","X",105405647,105407039,1392
"14910","ENSG00000181826","4",37590800,37686376,95576
"14911","ENSG00000181827","15",56087280,56243266,155986
"14912","ENSG00000181830","11",45804072,45813015,8943
"14913","ENSG00000181847","3",114276913,114310288,33375
"14914","ENSG00000181852","12",56202175,56221933,19758
"14915","ENSG00000181856","17",7281667,7288257,6590
"14916","ENSG00000181867","5",121851882,121852833,951
"14917","ENSG00000181873","1",228165804,228182257,16453
"14918","ENSG00000181885","17",7259903,7263983,4080
"14919","ENSG00000181894","19",58126248,58155110,28862
"14920","ENSG00000181896","19",19668796,19683509,14713
"14921","ENSG00000181904","5",134845680,134859735,14055
"14922","ENSG00000181908","11",64449074,64451657,2583
"14923","ENSG00000181915","10",62804857,62808483,3626
"14924","ENSG00000181924","11",73872667,73876901,4234
"14925","ENSG00000181929","12",49002274,49018825,16551
"14926","ENSG00000181938","16",58295080,58406144,111064
"14927","ENSG00000181950","11",55466771,55467712,941
"14928","ENSG00000181963","11",4449295,4450361,1066
"14929","ENSG00000181965","5",135534282,135535964,1682
"14930","ENSG00000181982","4",24806117,24980204,174087
"14931","ENSG00000181984","15",20562375,20575696,13321
"14932","ENSG00000181991","15",88467453,88480776,13323
"14933","ENSG00000181995","11",60615729,60687267,71538
"14934","ENSG00000181997","9",64621560,64637586,16026
"14935","ENSG00000182000","3",149984395,149984797,402
"14936","ENSG00000182004","1",203861599,203871152,9553
"14937","ENSG00000182010","10",62183035,62268844,85809
"14938","ENSG00000182013","19",46466491,46471563,5072
"14939","ENSG00000182021","9",63111255,63127100,15845
"14940","ENSG00000182022","10",124007668,124093598,85930
"14941","ENSG00000182035","20",38581195,38588463,7268
"14942","ENSG00000182040","17",74916083,74923256,7173
"14943","ENSG00000182048","11",3609901,3637559,27658
"14944","ENSG00000182050","12",85955666,86838904,883238
"14945","ENSG00000182053","11",49027501,49038451,10950
"14946","ENSG00000182054","15",90083045,90102504,19459
"14947","ENSG00000182057","22",42269703,42279534,9831
"14948","ENSG00000182077","10",27397121,27414368,17247
"14949","ENSG00000182083","2",240028965,240030456,1491
"14950","ENSG00000182087","19",1009648,1021179,11531
"14951","ENSG00000182093","21",39377698,39428528,50830
"14952","ENSG00000182095","7",5306790,5425414,118624
"14953","ENSG00000182103","11",82729940,82733864,3924
"14954","ENSG00000182107","14",61277370,61281840,4470
"14955","ENSG00000182108","16",10928891,10942468,13577
"14956","ENSG00000182111","7",57450177,57473546,23369
"14957","ENSG00000182117","15",34341713,34343177,1464
"14958","ENSG00000182118","1",231018958,231040254,21296
"14959","ENSG00000182132","5",170353487,170736632,383145
"14960","ENSG00000182134","1",151770107,151791416,21309
"14961","ENSG00000182141","19",21291160,21329425,38265
"14962","ENSG00000182149","16",71845996,71931199,85203
"14963","ENSG00000182150","9",95871264,96121154,249890
"14964","ENSG00000182154","9",137551879,137552555,676
"14965","ENSG00000182156","17",79730943,79742219,11276
"14966","ENSG00000182158","7",137874979,138002086,127107
"14967","ENSG00000182162","X",1462581,1537185,74604
"14968","ENSG00000182165","7",87322943,87345528,22585
"14969","ENSG00000182168","4",95162504,95549206,386702
"14970","ENSG00000182170","11",3217944,3218813,869
"14971","ENSG00000182173","17",75516060,75524735,8675
"14972","ENSG00000182175","15",93035273,93089204,53931
"14973","ENSG00000182177","2",236194872,236264409,69537
"14974","ENSG00000182179","3",49805209,49813953,8744
"14975","ENSG00000182180","10",73248843,73252693,3850
"14976","ENSG00000182183","1",52633168,52669683,36515
"14977","ENSG00000182185","14",67819779,68730218,910439
"14978","ENSG00000182187","2",208142573,208146158,3585
"14979","ENSG00000182195","X",141111605,141177125,65520
"14980","ENSG00000182196","12",122980060,122982913,2853
"14981","ENSG00000182197","8",117794490,118111853,317363
"14982","ENSG00000182199","12",57229573,57234935,5362
"14983","ENSG00000182208","11",1469457,1501247,31790
"14984","ENSG00000182218","14",99645110,99680569,35459
"14985","ENSG00000182220","X",40579372,40606848,27476
"14986","ENSG00000182223","4",48490252,48494389,4137
"14987","ENSG00000182224","17",7857746,7862282,4536
"14988","ENSG00000182230","5",176060689,176116015,55326
"14989","ENSG00000182240","21",41167801,41282530,114729
"14990","ENSG00000182247","3",23203020,23591794,388774
"14991","ENSG00000182253","15",99098217,99135593,37376
"14992","ENSG00000182255","11",30009730,30017030,7300
"14993","ENSG00000182256","15",26971181,27541984,570803
"14994","ENSG00000182257","22",46049478,46054144,4666
"14995","ENSG00000182261","11",7957537,7965426,7889
"14996","ENSG00000182263","2",163593396,163736012,142616
"14997","ENSG00000182264","19",48740852,48746909,6057
"14998","ENSG00000182271","17",30316333,30334059,17726
"14999","ENSG00000182272","11",369499,382117,12618
"15000","ENSG00000182287","X",15825806,15854931,29125
"15001","ENSG00000182307","8",145052465,145066685,14220
"15002","ENSG00000182308","4",41981756,41986465,4709
"15003","ENSG00000182310","19",51689128,51712387,23259
"15004","ENSG00000182315","19",7056209,7058640,2431
"15005","ENSG00000182318","19",58326994,58342332,15338
"15006","ENSG00000182324","19",48455509,48466980,11471
"15007","ENSG00000182325","8",144355431,144359376,3945
"15008","ENSG00000182326","12",6988259,7071032,82773
"15009","ENSG00000182327","17",4788964,4790589,1625
"15010","ENSG00000182329","2",202073289,202205203,131914
"15011","ENSG00000182333","10",88664441,88678814,14373
"15012","ENSG00000182334","11",7824818,7830840,6022
"15013","ENSG00000182347","9",5084999,5086112,1113
"15014","ENSG00000182348","7",88759368,89337057,577689
"15015","ENSG00000182352","17",74584679,74594209,9530
"15016","ENSG00000182359","11",106051098,106077459,26361
"15017","ENSG00000182362","21",46286342,46297751,11409
"15018","ENSG00000182366","8",375931,384079,8148
"15019","ENSG00000182372","8",1755778,1801711,45933
"15020","ENSG00000182376","16",88742767,88745748,2981
"15021","ENSG00000182378","X",276322,303356,27034
"15022","ENSG00000182379","12",57216794,57226449,9655
"15023","ENSG00000182383","5",74990189,74990637,448
"15024","ENSG00000182389","2",151832768,152099475,266707
"15025","ENSG00000182393","19",39296407,39298673,2266
"15026","ENSG00000182397","15",99790156,99806927,16771
"15027","ENSG00000182400","14",39147811,39170532,22721
"15028","ENSG00000182405","15",34102083,34108686,6603
"15029","ENSG00000182446","17",81556887,81648465,91578
"15030","ENSG00000182447","3",161496808,161503942,7134
"15031","ENSG00000182450","11",64291302,64300031,8729
"15032","ENSG00000182459","17",82359247,82363775,4528
"15033","ENSG00000182463","20",52972358,53495330,522972
"15034","ENSG00000182472","19",38730187,38769904,39717
"15035","ENSG00000182473","17",76081016,76121576,40560
"15036","ENSG00000182477","6",28053228,28054165,937
"15037","ENSG00000182481","17",68035708,68046854,11146
"15038","ENSG00000182484","X",156020826,156025710,4884
"15039","ENSG00000182487","7",73220624,73235945,15321
"15040","ENSG00000182489","X",100913445,100929433,15988
"15041","ENSG00000182492","X",153494980,153509546,14566
"15042","ENSG00000182504","3",101724593,101770562,45969
"15043","ENSG00000182508","X",112630648,112680054,49406
"15044","ENSG00000182511","15",90883695,90895776,12081
"15045","ENSG00000182512","14",95533503,95544724,11221
"15046","ENSG00000182518","X",55143102,55161310,18208
"15047","ENSG00000182521","14",55413541,55456726,43185
"15048","ENSG00000182531","10",15007861,15008884,1023
"15049","ENSG00000182533","3",8733800,8841808,108008
"15050","ENSG00000182534","17",76672551,76711016,38465
"15051","ENSG00000182541","22",31212239,31280080,67841
"15052","ENSG00000182544","12",53251251,53254405,3154
"15053","ENSG00000182545","14",20505537,20511169,5632
"15054","ENSG00000182551","2",3497366,3519531,22165
"15055","ENSG00000182552","4",183639635,183659203,19568
"15056","ENSG00000182557","17",4433940,4488208,54268
"15057","ENSG00000182566","19",7728957,7733906,4949
"15058","ENSG00000182568","3",18345377,18445588,100211
"15059","ENSG00000182574","X",100956593,100957538,945
"15060","ENSG00000182575","17",49575858,49583827,7969
"15061","ENSG00000182578","5",150053291,150113372,60081
"15062","ENSG00000182580","3",184561785,184582408,20623
"15063","ENSG00000182583","X",7842262,7844143,1881
"15064","ENSG00000182584","20",33666943,33668525,1582
"15065","ENSG00000182585","4",74308473,74315307,6834
"15066","ENSG00000182586","21",45234308,45264548,30240
"15067","ENSG00000182591","21",30880644,30881555,911
"15068","ENSG00000182600","2",232857270,232878708,21438
"15069","ENSG00000182601","16",25691959,26137685,445726
"15070","ENSG00000182606","3",42013802,42225890,212088
"15071","ENSG00000182612","17",81637171,81648749,11578
"15072","ENSG00000182613","5",181147586,181159285,11699
"15073","ENSG00000182621","20",8077251,8968360,891109
"15074","ENSG00000182625","15",58686411,58686617,206
"15075","ENSG00000182628","17",59109857,59155260,45403
"15076","ENSG00000182632","10",42408168,42475349,67181
"15077","ENSG00000182636","15",23685679,23687305,1626
"15078","ENSG00000182645","10",116324448,116380029,55581
"15079","ENSG00000182648","7",156388922,156640654,251732
"15080","ENSG00000182652","14",19743571,19749469,5898
"15081","ENSG00000182667","11",131370478,132336822,966344
"15082","ENSG00000182670","21",37073226,37203112,129886
"15083","ENSG00000182674","8",72537225,72938349,401124
"15084","ENSG00000182676","17",81833492,81835050,1558
"15085","ENSG00000182685","16",2209253,2211950,2697
"15086","ENSG00000182687","17",76074781,76077537,2756
"15087","ENSG00000182698","2",219327409,219333177,5768
"15088","ENSG00000182700","5",140125935,140129392,3457
"15089","ENSG00000182704","11",76782251,76798153,15902
"15090","ENSG00000182712","X",155061622,155071136,9514
"15091","ENSG00000182718","15",60347134,60402883,55749
"15092","ENSG00000182722","7",64852397,64853354,957
"15093","ENSG00000182732","14",71932429,72566530,634101
"15094","ENSG00000182742","17",48575507,48578350,2843
"15095","ENSG00000182747","6",136922301,136925660,3359
"15096","ENSG00000182749","1",25861210,25871253,10043
"15097","ENSG00000182752","9",116153791,116402321,248530
"15098","ENSG00000182759","8",143419182,143430406,11224
"15099","ENSG00000182768","15",90265659,90278141,12482
"15100","ENSG00000182771","10",85599552,86366795,767243
"15101","ENSG00000182774","15",82536750,82540459,3709
"15102","ENSG00000182782","12",122701293,122703343,2050
"15103","ENSG00000182791","11",66590176,66593063,2887
"15104","ENSG00000182793","6",52831655,52846095,14440
"15105","ENSG00000182795","1",207018522,207032756,14234
"15106","ENSG00000182796","12",55829608,55836246,6638
"15107","ENSG00000182798","X",16167481,16171464,3983
"15108","ENSG00000182809","14",105472962,105480170,7208
"15109","ENSG00000182810","16",68021274,68023442,2168
"15110","ENSG00000182814","2",84290683,84292202,1519
"15111","ENSG00000182824","22",18733914,18757906,23992
"15112","ENSG00000182827","1",226144679,226186741,42062
"15113","ENSG00000182831","16",9091644,9121635,29991
"15114","ENSG00000182836","5",41306952,41510628,203676
"15115","ENSG00000182841","22",42555223,42582038,26815
"15116","ENSG00000182853","17",4785285,4786433,1148
"15117","ENSG00000182858","22",49900229,49918438,18209
"15118","ENSG00000182866","1",32251239,32286165,34926
"15119","ENSG00000182870","12",132196372,132329589,133217
"15120","ENSG00000182871","21",45405165,45513720,108555
"15121","ENSG00000182872","X",47145221,47186813,41592
"15122","ENSG00000182873","1",2181794,2184389,2595
"15123","ENSG00000182885","16",57668277,57689378,21101
"15124","ENSG00000182888","X",3717149,3717600,451
"15125","ENSG00000182890","X",121047588,121050080,2492
"15126","ENSG00000182896","17",7355123,7357219,2096
"15127","ENSG00000182899","3",197950190,197956610,6420
"15128","ENSG00000182901","1",240775515,241357230,581715
"15129","ENSG00000182902","22",17563450,17590995,27545
"15130","ENSG00000182903","4",425815,499156,73341
"15131","ENSG00000182912","21",44517216,44525952,8736
"15132","ENSG00000182916","X",103330229,103332326,2097
"15133","ENSG00000182919","11",93741591,93764749,23158
"15134","ENSG00000182921","3",73182501,73183291,790
"15135","ENSG00000182923","3",134485721,134575017,89296
"15136","ENSG00000182931","20",45684653,45705019,20366
"15137","ENSG00000182934","11",126262938,126269144,6206
"15138","ENSG00000182944","22",29268009,29300525,32516
"15139","ENSG00000182950","15",75724041,75727688,3647
"15140","ENSG00000182952","6",26538366,26546933,8567
"15141","ENSG00000182957","13",23979805,24307074,327269
"15142","ENSG00000182963","17",44798448,44830816,32368
"15143","ENSG00000182965","7",112520488,112521670,1182
"15144","ENSG00000182968","13",112067647,112070488,2841
"15145","ENSG00000182973","3",32685145,32773875,88730
"15146","ENSG00000182974","15",21637909,21638992,1083
"15147","ENSG00000182979","14",105419820,105470729,50909
"15148","ENSG00000182983","3",42905731,42917641,11910
"15149","ENSG00000182985","11",115169218,115504957,335739
"15150","ENSG00000182986","19",52863790,52897693,33903
"15151","ENSG00000182993","12",14803572,14906586,103014
"15152","ENSG00000183010","17",81932384,81942412,10028
"15153","ENSG00000183011","17",7856685,7885238,28553
"15154","ENSG00000183018","17",4498881,4539035,40154
"15155","ENSG00000183019","19",7676628,7679826,3198
"15156","ENSG00000183020","11",924894,1012245,87351
"15157","ENSG00000183022","2",230573167,230573809,642
"15158","ENSG00000183023","2",40097270,40611053,513783
"15159","ENSG00000183024","17",3126584,3127581,997
"15160","ENSG00000183032","14",36678431,37172866,494435
"15161","ENSG00000183034","17",74924275,74933912,9637
"15162","ENSG00000183035","X",83861126,83886699,25573
"15163","ENSG00000183036","21",39867438,39929397,61959
"15164","ENSG00000183044","16",8674596,8784575,109979
"15165","ENSG00000183048","17",81712236,81721016,8780
"15166","ENSG00000183049","10",12349482,12835545,486063
"15167","ENSG00000183054","2",110513812,110577185,63373
"15168","ENSG00000183055","10",58715554,58716257,703
"15169","ENSG00000183060","15",99715697,99733561,17864
"15170","ENSG00000183066","22",41998725,42058456,59731
"15171","ENSG00000183067","21",39745407,39802096,56689
"15172","ENSG00000183072","5",173232109,173235311,3202
"15173","ENSG00000183077","17",78187317,78207701,20384
"15174","ENSG00000183087","13",113820549,113864076,43527
"15175","ENSG00000183090","4",143577302,143700675,123373
"15176","ENSG00000183091","2",151485336,151734487,249151
"15177","ENSG00000183092","14",100537147,100587413,50266
"15178","ENSG00000183098","13",93226807,94408020,1181213
"15179","ENSG00000183111","5",149551947,149634968,83021
"15180","ENSG00000183114","1",20552573,20555020,2447
"15181","ENSG00000183117","8",2935353,4994972,2059619
"15182","ENSG00000183122","7",144153486,144158905,5419
"15183","ENSG00000183128","10",103472804,103479240,6436
"15184","ENSG00000183134","11",60850933,60855950,5017
"15185","ENSG00000183137","6",109095110,109163932,68822
"15186","ENSG00000183145","21",37006150,37019662,13512
"15187","ENSG00000183146","Y",21382954,21386360,3406
"15188","ENSG00000183148","9",40223285,40266392,43107
"15189","ENSG00000183150","12",12660890,12696207,35317
"15190","ENSG00000183153","17",40362931,40363815,884
"15191","ENSG00000183154","8",37734761,37737426,2665
"15192","ENSG00000183155","1",202878957,202889135,10178
"15193","ENSG00000183160","12",108589851,108598320,8469
"15194","ENSG00000183161","11",22622890,22625841,2951
"15195","ENSG00000183166","7",71779491,72447151,667660
"15196","ENSG00000183169","22",22639177,22644473,5296
"15197","ENSG00000183171","X",150114378,150116520,2142
"15198","ENSG00000183172","22",42079691,42084284,4593
"15199","ENSG00000183185","3",97986673,98035304,48631
"15200","ENSG00000183186","19",405445,409147,3702
"15201","ENSG00000183196","16",75472052,75495445,23393
"15202","ENSG00000183199","4",87891843,87894015,2172
"15203","ENSG00000183206","18",14507339,14543585,36246
"15204","ENSG00000183207","19",48993562,49015970,22408
"15205","ENSG00000183208","15",90233808,90245811,12003
"15206","ENSG00000183230","10",65912523,67696195,1783672
"15207","ENSG00000183239","6",44089242,44089696,454
"15208","ENSG00000183242","11",32435518,32458769,23251
"15209","ENSG00000183246","22",21545357,21551461,6104
"15210","ENSG00000183248","19",7868719,7874390,5671
"15211","ENSG00000183250","21",44932814,44939937,7123
"15212","ENSG00000183251","11",5301014,5301946,932
"15213","ENSG00000183255","21",44849585,44873903,24318
"15214","ENSG00000183258","5",177511577,177516961,5384
"15215","ENSG00000183273","12",119334712,119541040,206328
"15216","ENSG00000183281","2",87002559,87021852,19293
"15217","ENSG00000183283","12",51238724,51271362,32638
"15218","ENSG00000183287","18",59430939,59697662,266723
"15219","ENSG00000183291","1",86862445,86914424,51979
"15220","ENSG00000183292","2",130570829,130584161,13332
"15221","ENSG00000183298","1",101786340,101787219,879
"15222","ENSG00000183303","11",7795905,7796973,1068
"15223","ENSG00000183304","X",8790795,8801383,10588
"15224","ENSG00000183307","22",17116299,17121367,5068
"15225","ENSG00000183308","2",200963263,201009102,45839
"15226","ENSG00000183309","8",143636013,143656418,20405
"15227","ENSG00000183310","1",248573801,248574757,956
"15228","ENSG00000183313","11",5985892,5986985,1093
"15229","ENSG00000183317","1",37713880,37765133,51253
"15230","ENSG00000183318","17",8753106,8758559,5453
"15231","ENSG00000183323","5",69280175,69332809,52634
"15232","ENSG00000183324","15",73443164,73560013,116849
"15233","ENSG00000183337","X",40049815,40177329,127514
"15234","ENSG00000183340","11",96389989,96507574,117585
"15235","ENSG00000183346","10",61662961,61766766,103805
"15236","ENSG00000183347","1",89364058,89386461,22403
"15237","ENSG00000183354","9",5881596,6008482,126886
"15238","ENSG00000183378","11",7689438,7706421,16983
"15239","ENSG00000183379","14",74405894,74426210,20316
"15240","ENSG00000183386","1",37996770,38005606,8836
"15241","ENSG00000183395","12",102196459,102197833,1374
"15242","ENSG00000183396","3",48620759,48621855,1096
"15243","ENSG00000183397","19",3539154,3544030,4876
"15244","ENSG00000183401","19",11344684,11354944,10260
"15245","ENSG00000183421","21",41739369,41767089,27720
"15246","ENSG00000183423","4",109848202,109872315,24113
"15247","ENSG00000183426","16",14922802,14952060,29258
"15248","ENSG00000183431","1",37956975,37990075,33100
"15249","ENSG00000183432","4",150720981,150721478,497
"15250","ENSG00000183434","X",133216669,133218348,1679
"15251","ENSG00000183439","4",164954446,164977668,23222
"15252","ENSG00000183444","7",97966090,97967074,984
"15253","ENSG00000183454","16",9753404,10182754,429350
"15254","ENSG00000183458","16",14911551,14935708,24157
"15255","ENSG00000183463","13",27977714,27988654,10940
"15256","ENSG00000183470","7",132648794,132728769,79975
"15257","ENSG00000183474","5",69560208,69594723,34515
"15258","ENSG00000183475","15",100602534,100651705,49171
"15259","ENSG00000183476","15",78077808,78104909,27101
"15260","ENSG00000183479","X",153444720,153470587,25867
"15261","ENSG00000183484","14",105049395,105065445,16050
"15262","ENSG00000183486","21",41361999,41409393,47394
"15263","ENSG00000183495","12",131949920,132081102,131182
"15264","ENSG00000183496","15",82041778,82046119,4341
"15265","ENSG00000183506","22",21473000,21517533,44533
"15266","ENSG00000183508","1",117606048,117628389,22341
"15267","ENSG00000183513","2",98599314,98608515,9201
"15268","ENSG00000183514","2",227870083,227870644,561
"15269","ENSG00000183520","1",38009258,38024820,15562
"15270","ENSG00000183527","21",39174769,39183851,9082
"15271","ENSG00000183530","22",31676256,31750140,73884
"15272","ENSG00000183535","21",45419716,45425070,5354
"15273","ENSG00000183542","12",10407382,10409757,2375
"15274","ENSG00000183549","16",20409534,20441336,31802
"15275","ENSG00000183559","10",122697709,122699822,2113
"15276","ENSG00000183560","11",94305592,94307721,2129
"15277","ENSG00000183562","11",2989863,2991344,1481
"15278","ENSG00000183566","20",33193585,33210462,16877
"15279","ENSG00000183569","22",42553617,42574382,20765
"15280","ENSG00000183570","21",45643694,45942454,298760
"15281","ENSG00000183571","15",98968229,99007792,39563
"15282","ENSG00000183576","14",99397748,99480889,83141
"15283","ENSG00000183578","15",51056598,51105276,48678
"15284","ENSG00000183579","22",28883592,29057487,173895
"15285","ENSG00000183580","5",15500180,15939795,439615
"15286","ENSG00000183586","1",152399577,152399769,192
"15287","ENSG00000183597","22",20017014,20065926,48912
"15288","ENSG00000183598","1",149813271,149813681,410
"15289","ENSG00000183604","16",30267553,30335374,67821
"15290","ENSG00000183605","10",119140767,119165667,24900
"15291","ENSG00000183607","2",68945232,68952893,7661
"15292","ENSG00000183615","1",32247222,32248856,1634
"15293","ENSG00000183617","19",3762682,3768575,5893
"15294","ENSG00000183621","10",30820207,31031937,211730
"15295","ENSG00000183624","3",129278828,129306186,27358
"15296","ENSG00000183625","3",46163604,46266706,103102
"15297","ENSG00000183628","22",18906028,18914238,8210
"15298","ENSG00000183629","15",28519611,28533014,13403
"15299","ENSG00000183631","X",126819729,126821786,2057
"15300","ENSG00000183632","16",32673528,32676732,3204
"15301","ENSG00000183638","8",10606349,10712187,105838
"15302","ENSG00000183640","21",30812697,30813252,555
"15303","ENSG00000183643","15",92471654,92501117,29463
"15304","ENSG00000183644","11",111514785,111537031,22246
"15305","ENSG00000183647","19",57599885,57612722,12837
"15306","ENSG00000183648","14",92116122,92121917,5795
"15307","ENSG00000183654","5",16067139,16180762,113623
"15308","ENSG00000183655","15",85759326,85794925,35599
"15309","ENSG00000183662","3",68004247,68545621,541374
"15310","ENSG00000183665","8",124450820,124462150,11330
"15311","ENSG00000183666","5",21341833,21589372,247539
"15312","ENSG00000183668","19",43211791,43269530,57739
"15313","ENSG00000183671","2",206175316,206218047,42731
"15314","ENSG00000183674","6",10429255,10435015,5760
"15315","ENSG00000183682","1",39491636,39529869,38233
"15316","ENSG00000183684","17",81887844,81891586,3742
"15317","ENSG00000183688","17",439978,445939,5961
"15318","ENSG00000183690","X",44147872,44343672,195800
"15319","ENSG00000183691","17",56593699,56595590,1891
"15320","ENSG00000183695","11",19054455,19060681,6226
"15321","ENSG00000183696","7",48088628,48108736,20108
"15322","ENSG00000183709","19",39268514,39270092,1578
"15323","ENSG00000183715","11",132414977,133532519,1117542
"15324","ENSG00000183718","5",181254417,181261139,6722
"15325","ENSG00000183722","13",39209116,39603528,394412
"15326","ENSG00000183723","16",66614750,66696707,81957
"15327","ENSG00000183726","1",25338317,25362361,24044
"15328","ENSG00000183729","8",52938431,52941117,2686
"15329","ENSG00000183733","2",70777310,70790643,13333
"15330","ENSG00000183734","11",2268495,2270952,2457
"15331","ENSG00000183735","12",64452092,64502114,50022
"15332","ENSG00000183741","22",38861450,38872314,10864
"15333","ENSG00000183742","7",20134655,20217404,82749
"15334","ENSG00000183747","16",20451461,20487669,36208
"15335","ENSG00000183751","16",1972037,1982933,10896
"15336","ENSG00000183760","19",39083913,39111493,27580
"15337","ENSG00000183763","3",49828601,49856574,27973
"15338","ENSG00000183765","22",28687743,28742422,54679
"15339","ENSG00000183770","3",138944224,138947137,2913
"15340","ENSG00000183773","22",20965108,20981360,16252
"15341","ENSG00000183775","5",144170873,144485686,314813
"15342","ENSG00000183778","21",39556442,39673137,116695
"15343","ENSG00000183779","8",37695782,37700019,4237
"15344","ENSG00000183780","1",233904676,234324511,419835
"15345","ENSG00000183783","4",44173903,44448809,274906
"15346","ENSG00000183784","9",212824,215893,3069
"15347","ENSG00000183785","22",18110331,18146554,36223
"15348","ENSG00000183791","18",46962768,46964644,1876
"15349","ENSG00000183793","16",15363624,15381047,17423
"15350","ENSG00000183798","20",41359962,41366818,6856
"15351","ENSG00000183801","11",7485388,7511377,25989
"15352","ENSG00000183807","6",116752197,116765719,13522
"15353","ENSG00000183808","8",93729356,93741017,11661
"15354","ENSG00000183813","3",32951574,32956349,4775
"15355","ENSG00000183814","1",226231149,226309869,78720
"15356","ENSG00000183822","22",36847372,36870441,23069
"15357","ENSG00000183826","6",38168451,38640148,471697
"15358","ENSG00000183828","14",105172938,105181323,8385
"15359","ENSG00000183831","1",173609561,173669862,60301
"15360","ENSG00000183833","3",119703022,119767102,64080
"15361","ENSG00000183837","X",153056409,153060467,4058
"15362","ENSG00000183840","2",132416805,132646582,229777
"15363","ENSG00000183844","21",41304212,41357431,53219
"15364","ENSG00000183850","19",23075210,23147221,72011
"15365","ENSG00000183853","1",157993273,158100262,106989
"15366","ENSG00000183856","1",156525405,156572604,47199
"15367","ENSG00000183862","X",151738451,151745304,6853
"15368","ENSG00000183864","22",41433494,41446801,13307
"15369","ENSG00000183873","3",38548057,38649673,101616
"15370","ENSG00000183876","5",150296343,150339307,42964
"15371","ENSG00000183878","Y",13248379,13480673,232294
"15372","ENSG00000183888","1",16004236,16008807,4571
"15373","ENSG00000183889","16",16317444,16350590,33146
"15374","ENSG00000183891","2",19896631,19901983,5352
"15375","ENSG00000183908","11",57181747,57191717,9970
"15376","ENSG00000183909","15",101926164,101933350,7186
"15377","ENSG00000183911","X",101339917,101340934,1017
"15378","ENSG00000183914","17",7717354,7833744,116390
"15379","ENSG00000183918","X",124227868,124373197,145329
"15380","ENSG00000183921","16",22165583,22191754,26171
"15381","ENSG00000183929","1",228650241,228651379,1138
"15382","ENSG00000183935","12",13000420,13004830,4410
"15383","ENSG00000183938","9",33629121,33629586,465
"15384","ENSG00000183943","X",3604370,3713608,109238
"15385","ENSG00000183955","12",123383773,123409353,25580
"15386","ENSG00000183960","3",19148510,19535642,387132
"15387","ENSG00000183963","22",31064105,31104757,40652
"15388","ENSG00000183971","16",2009926,2020755,10829
"15389","ENSG00000183977","3",19979961,20012330,32369
"15390","ENSG00000183978","17",42795147,42798704,3557
"15391","ENSG00000183979","17",81900745,81902905,2160
"15392","ENSG00000184005","1",76074746,76634603,559857
"15393","ENSG00000184007","1",31906421,31944856,38435
"15394","ENSG00000184009","17",81509971,81523847,13876
"15395","ENSG00000184012","21",41464305,41531116,66811
"15396","ENSG00000184014","11",9138825,9265350,126525
"15397","ENSG00000184022","1",248590487,248597700,7213
"15398","ENSG00000184029","21",37951425,38121360,169935
"15399","ENSG00000184033","X",154617609,154619282,1673
"15400","ENSG00000184047","12",122207668,122227456,19788
"15401","ENSG00000184055","11",71593454,71594382,928
"15402","ENSG00000184056","15",90998416,91022603,24187
"15403","ENSG00000184058","22",19756703,19783593,26890
"15404","ENSG00000184060","17",30906344,30959322,52978
"15405","ENSG00000184068","22",41831215,41834665,3450
"15406","ENSG00000184076","22",29767369,29770413,3044
"15407","ENSG00000184083","X",54068324,54183281,114957
"15408","ENSG00000184084","5",73803296,73803599,303
"15409","ENSG00000184100","3",160100850,160102793,1943
"15410","ENSG00000184106","6",41208713,41217947,9234
"15411","ENSG00000184108","4",188139419,188147743,8324
"15412","ENSG00000184110","16",28688558,28735730,47172
"15413","ENSG00000184111","10",92596852,92597287,435
"15414","ENSG00000184113","22",19523024,19527545,4521
"15415","ENSG00000184115","2",110397406,110435166,37760
"15416","ENSG00000184117","22",29554808,29581337,26529
"15417","ENSG00000184139","4",131857343,131857913,570
"15418","ENSG00000184144","1",205042937,205078289,35352
"15419","ENSG00000184148","1",152970648,152972574,1926
"15420","ENSG00000184154","11",72080331,72110782,30451
"15421","ENSG00000184155","1",159535078,159536007,929
"15422","ENSG00000184156","8",132120859,132481095,360236
"15423","ENSG00000184160","4",3766348,3768526,2178
"15424","ENSG00000184162","19",19201416,19203424,2008
"15425","ENSG00000184163","1",1242446,1246722,4276
"15426","ENSG00000184164","22",49918167,49927540,9373
"15427","ENSG00000184166","17",3088484,3104422,15938
"15428","ENSG00000184178","4",52872982,53366066,493084
"15429","ENSG00000184182","2",237966827,238042782,75955
"15430","ENSG00000184185","17",21376357,21419870,43513
"15431","ENSG00000184188","5",80299678,80302847,3169
"15432","ENSG00000184194","X",53049091,53080615,31524
"15433","ENSG00000184203","3",195514428,195543386,28958
"15434","ENSG00000184205","X",53082367,53088540,6173
"15435","ENSG00000184206","15",84235773,84245368,9595
"15436","ENSG00000184207","16",2211997,2214807,2810
"15437","ENSG00000184208","22",41688877,41698136,9259
"15438","ENSG00000184209","12",123457641,123473154,15513
"15439","ENSG00000184210","X",70177483,70205545,28062
"15440","ENSG00000184216","X",154010506,154019902,9396
"15441","ENSG00000184220","3",99817837,100181732,363895
"15442","ENSG00000184221","21",33070141,33072413,2272
"15443","ENSG00000184224","11",67602880,67606706,3826
"15444","ENSG00000184226","13",66302834,67230445,927611
"15445","ENSG00000184227","14",73537143,73543796,6653
"15446","ENSG00000184232","11",120211032,120230334,19302
"15447","ENSG00000184254","15",100877714,100916626,38912
"15448","ENSG00000184258","X",140783578,140784366,788
"15449","ENSG00000184260","1",149886975,149887364,389
"15450","ENSG00000184261","2",47516581,47570939,54358
"15451","ENSG00000184270","1",149887484,149888013,529
"15452","ENSG00000184271","12",51186936,51217708,30772
"15453","ENSG00000184274","21",45300245,45305257,5012
"15454","ENSG00000184276","11",71833200,71837710,4510
"15455","ENSG00000184277","15",101621444,101652391,30947
"15456","ENSG00000184281","11",2400488,2403878,3390
"15457","ENSG00000184292","1",58575423,58577773,2350
"15458","ENSG00000184293","12",9715860,9733299,17439
"15459","ENSG00000184302","14",60508951,60512850,3899
"15460","ENSG00000184303","2",91684447,91685884,1437
"15461","ENSG00000184304","14",29576479,30191898,615419
"15462","ENSG00000184305","4",90127535,91601913,1474378
"15463","ENSG00000184307","3",113947901,113965401,17500
"15464","ENSG00000184313","1",54641754,54710266,68512
"15465","ENSG00000184319","22",50756948,50801309,44361
"15466","ENSG00000184321","11",5402597,5403547,950
"15467","ENSG00000184330","1",153416520,153423222,6702
"15468","ENSG00000184343","X",153776412,153785732,9320
"15469","ENSG00000184344","12",7689784,7695775,5991
"15470","ENSG00000184345","3",51861629,51863424,1795
"15471","ENSG00000184347","5",168661733,169301129,639396
"15472","ENSG00000184349","5",107376889,107670937,294048
"15473","ENSG00000184350","11",3225035,3232386,7351
"15474","ENSG00000184357","6",27866849,27867529,680
"15475","ENSG00000184361","17",45254393,45262094,7701
"15476","ENSG00000184363","11",392614,404908,12294
"15477","ENSG00000184368","X",20006713,20116907,110194
"15478","ENSG00000184371","1",109910242,109930992,20750
"15479","ENSG00000184374","8",118995452,119108455,113003
"15480","ENSG00000184378","3",169766921,169769561,2640
"15481","ENSG00000184381","22",38111495,38214778,103283
"15482","ENSG00000184384","11",95976598,96343195,366597
"15483","ENSG00000184385","21",42102134,42108534,6400
"15484","ENSG00000184388","X",73003517,73005713,2196
"15485","ENSG00000184389","1",33306766,33321098,14332
"15486","ENSG00000184402","20",62143769,62182514,38745
"15487","ENSG00000184408","7",120273175,120750337,477162
"15488","ENSG00000184414","7",100570131,100571136,1005
"15489","ENSG00000184423","3",1595777,1596245,468
"15490","ENSG00000184428","8",143304384,143359979,55595
"15491","ENSG00000184432","3",139355600,139389680,34080
"15492","ENSG00000184434","9",26993136,27005693,12557
"15493","ENSG00000184436","22",20999104,21002196,3092
"15494","ENSG00000184441","21",44331234,44335851,4617
"15495","ENSG00000184445","12",122527246,122626396,99150
"15496","ENSG00000184451","17",42678889,42683917,5028
"15497","ENSG00000184454","1",24556087,24609328,53241
"15498","ENSG00000184459","22",32413847,32464484,50637
"15499","ENSG00000184465","6",169457212,169702067,244855
"15500","ENSG00000184470","22",19875517,19941820,66303
"15501","ENSG00000184471","16",1090005,1096244,6239
"15502","ENSG00000184478","11",5938751,5951347,12596
"15503","ENSG00000184481","X",71096197,71103535,7338
"15504","ENSG00000184486","6",98834592,98839470,4878
"15505","ENSG00000184489","8",141391993,141432454,40461
"15506","ENSG00000184492","2",113498665,113501155,2490
"15507","ENSG00000184497","13",113759240,113816995,57755
"15508","ENSG00000184500","3",93873033,93980003,106970
"15509","ENSG00000184502","17",41712331,41715969,3638
"15510","ENSG00000184507","15",34343315,34357737,14422
"15511","ENSG00000184508","15",90929964,90935196,5232
"15512","ENSG00000184515","X",102153708,102155977,2269
"15513","ENSG00000184517","16",75148494,75172236,23742
"15514","ENSG00000184523","9",62838824,62844276,5452
"15515","ENSG00000184524","11",787115,790113,2998
"15516","ENSG00000184530","6",127519455,127591820,72365
"15517","ENSG00000184544","17",9771434,9791297,19863
"15518","ENSG00000184545","11",1554051,1572271,18220
"15519","ENSG00000184557","17",78356778,78360077,3299
"15520","ENSG00000184560","17",7425616,7427568,1952
"15521","ENSG00000184564","13",85792790,85806683,13893
"15522","ENSG00000184566","11",33880643,33881800,1157
"15523","ENSG00000184571","22",24719034,24774720,55686
"15524","ENSG00000184574","12",6618835,6635960,17125
"15525","ENSG00000184575","12",64404392,64451125,46733
"15526","ENSG00000184584","5",139475533,139482935,7402
"15527","ENSG00000184588","1",65792514,66374579,582065
"15528","ENSG00000184599","1",112720419,112727235,6816
"15529","ENSG00000184601","14",104579684,104590515,10831
"15530","ENSG00000184602","16",11668455,11679152,10697
"15531","ENSG00000184608","8",11368402,11438658,70256
"15532","ENSG00000184611","2",162371407,162838730,467323
"15533","ENSG00000184612","6",17530899,17531652,753
"15534","ENSG00000184613","12",44508275,44921848,413573
"15535","ENSG00000184616","7",74906673,74913310,6637
"15536","ENSG00000184617","20",46484461,46492640,8179
"15537","ENSG00000184619","17",8356902,8376711,19809
"15538","ENSG00000184634","X",71118556,71142454,23898
"15539","ENSG00000184635","19",19900913,19963464,62551
"15540","ENSG00000184640","17",77280569,77500596,220027
"15541","ENSG00000184647","8",10525532,10554166,28634
"15542","ENSG00000184650","17",8339864,8346048,6184
"15543","ENSG00000184659","9",65736555,65738784,2229
"15544","ENSG00000184661","8",25459199,25507911,48712
"15545","ENSG00000184669","11",17013998,17053024,39026
"15546","ENSG00000184672","8",84182787,84921844,739057
"15547","ENSG00000184675","X",64185117,64205708,20591
"15548","ENSG00000184677","1",22428838,22531157,102319
"15549","ENSG00000184678","1",149884459,149886652,2193
"15550","ENSG00000184697","16",3014712,3020071,5359
"15551","ENSG00000184698","11",5383812,5393263,9451
"15552","ENSG00000184702","22",19714503,19724224,9721
"15553","ENSG00000184708","22",31436977,31496108,59131
"15554","ENSG00000184709","9",137168758,137170051,1293
"15555","ENSG00000184716","15",43794162,43800221,6059
"15556","ENSG00000184719","10",88273864,88584530,310666
"15557","ENSG00000184730","16",28494643,28498970,4327
"15558","ENSG00000184731","2",38814,46870,8056
"15559","ENSG00000184735","X",22999961,23003589,3628
"15560","ENSG00000184743","11",63624087,63671921,47834
"15561","ENSG00000184752","12",94897055,95003748,106693
"15562","ENSG00000184774","1",202820266,202827225,6959
"15563","ENSG00000184785","X",134990991,134992473,1482
"15564","ENSG00000184786","6",169740109,169751587,11478
"15565","ENSG00000184787","21",44768580,44801826,33246
"15566","ENSG00000184788","X",85092287,85243961,151674
"15567","ENSG00000184792","22",30693782,30907824,214042
"15568","ENSG00000184809","21",39597147,39612910,15763
"15569","ENSG00000184811","17",1279662,1300978,21316
"15570","ENSG00000184814","3",139019031,139020926,1895
"15571","ENSG00000184828","18",48026672,48410752,384080
"15572","ENSG00000184831","X",23833353,23907934,74581
"15573","ENSG00000184838","5",120464300,120687332,223032
"15574","ENSG00000184840","5",177592158,177596124,3966
"15575","ENSG00000184844","X",153841251,153841565,314
"15576","ENSG00000184845","5",175440036,175444182,4146
"15577","ENSG00000184856","21",22098616,22116605,17989
"15578","ENSG00000184857","16",8780384,8797642,17258
"15579","ENSG00000184860","16",81988855,82011481,22626
"15580","ENSG00000184863","7",155644451,155781485,137034
"15581","ENSG00000184867","X",101655281,101659850,4569
"15582","ENSG00000184887","14",105248490,105251093,2603
"15583","ENSG00000184895","Y",2786855,2787699,844
"15584","ENSG00000184897","3",129314771,129316286,1515
"15585","ENSG00000184898","2",151247940,151261863,13923
"15586","ENSG00000184900","21",44805617,44818779,13162
"15587","ENSG00000184903","7",110663051,111562517,899466
"15588","ENSG00000184905","X",102125679,102140426,14747
"15589","ENSG00000184906","9",40497850,40566779,68929
"15590","ENSG00000184908","1",16043736,16057308,13572
"15591","ENSG00000184911","X",72777009,72848802,71793
"15592","ENSG00000184916","14",105140982,105168824,27842
"15593","ENSG00000184922","17",45221444,45247319,25875
"15594","ENSG00000184923","10",87225448,87236908,11460
"15595","ENSG00000184924","2",24789734,24793382,3648
"15596","ENSG00000184925","9",136949551,136955497,5946
"15597","ENSG00000184933","11",6791736,6799689,7953
"15598","ENSG00000184937","11",32387775,32435885,48110
"15599","ENSG00000184939","16",68530090,68576072,45982
"15600","ENSG00000184949","22",38578120,38656629,78509
"15601","ENSG00000184956","11",1012823,1036718,23895
"15602","ENSG00000184961","9",39983821,39984401,580
"15603","ENSG00000184967","12",132144457,132152473,8016
"15604","ENSG00000184979","22",18149899,18177397,27498
"15605","ENSG00000184983","22",42085525,42090955,5430
"15606","ENSG00000184984","15",33968720,34067457,98737
"15607","ENSG00000184985","4",7192538,7742836,550298
"15608","ENSG00000184986","14",105526583,105530202,3619
"15609","ENSG00000184988","17",43211835,43220041,8206
"15610","ENSG00000184990","14",104753147,104768494,15347
"15611","ENSG00000184991","Y",21565092,21605081,39989
"15612","ENSG00000184992","12",124993645,125031231,37586
"15613","ENSG00000184995","9",21480839,21482313,1474
"15614","ENSG00000184999","11",63137867,63369718,231851
"15615","ENSG00000185000","8",144314584,144326910,12326
"15616","ENSG00000185002","6",116877212,116932161,54949
"15617","ENSG00000185008","3",75906695,77649964,1743269
"15618","ENSG00000185009","10",74120255,74151063,30808
"15619","ENSG00000185010","X",154835788,155026940,191152
"15620","ENSG00000185013","2",18562872,18589572,26700
"15621","ENSG00000185015","8",85220587,85284073,63486
"15622","ENSG00000185019","20",3107573,3160196,52623
"15623","ENSG00000185022","22",38200767,38216507,15740
"15624","ENSG00000185024","14",105209286,105315589,106303
"15625","ENSG00000185028","5",191495,196334,4839
"15626","ENSG00000185031","1",64984608,64986087,1479
"15627","ENSG00000185033","15",90160604,90229679,69075
"15628","ENSG00000185037","7",63291518,63304056,12538
"15629","ENSG00000185038","2",233775679,233833423,57744
"15630","ENSG00000185040","7",76531319,76541459,10140
"15631","ENSG00000185043","15",90229975,90234047,4072
"15632","ENSG00000185046","12",98726457,99984654,1258197
"15633","ENSG00000185049","4",1982714,2041903,59189
"15634","ENSG00000185052","20",19212646,19722937,510291
"15635","ENSG00000185053","8",14084845,15238431,1153586
"15636","ENSG00000185055","7",105565120,105600875,35755
"15637","ENSG00000185056","5",173973779,174006140,32361
"15638","ENSG00000185065","22",19447893,19450105,2212
"15639","ENSG00000185070","14",85530144,85654428,124284
"15640","ENSG00000185074","9",90216039,90216924,885
"15641","ENSG00000185078","2",208031383,208031953,570
"15642","ENSG00000185085","11",62646848,62653302,6454
"15643","ENSG00000185088","15",63125872,63158021,32149
"15644","ENSG00000185090","1",37793802,37801137,7335
"15645","ENSG00000185100","14",104724186,104747325,23139
"15646","ENSG00000185101","11",417933,442011,24078
"15647","ENSG00000185104","1",50437028,50960267,523239
"15648","ENSG00000185105","17",81939645,81947233,7588
"15649","ENSG00000185112","3",194686544,194689037,2493
"15650","ENSG00000185115","15",29264992,29269829,4837
"15651","ENSG00000185122","8",144291591,144314720,23129
"15652","ENSG00000185127","6",169702190,169704856,2666
"15653","ENSG00000185129","5",140107777,140125619,17842
"15654","ENSG00000185130","6",27807444,27807931,487
"15655","ENSG00000185133","22",31122731,31134697,11966
"15656","ENSG00000185149","4",155208636,155217078,8442
"15657","ENSG00000185155","1",226223618,226227054,3436
"15658","ENSG00000185156","17",8797162,8799349,2187
"15659","ENSG00000185158","17",32007872,32053504,45632
"15660","ENSG00000185163","12",132136594,132144319,7725
"15661","ENSG00000185164","16",18417325,18562211,144886
"15662","ENSG00000185168","17",81303771,81309248,5477
"15663","ENSG00000185176","2",240676418,240682906,6488
"15664","ENSG00000185177","7",57119614,57139864,20250
"15665","ENSG00000185182","15",22427039,22437902,10863
"15666","ENSG00000185186","21",43461960,43479534,17574
"15667","ENSG00000185187","11",405716,417455,11739
"15668","ENSG00000185189","8",143833583,143840973,7390
"15669","ENSG00000185198","19",685546,695498,9952
"15670","ENSG00000185201","11",307631,315272,7641
"15671","ENSG00000185203","X",156014623,156016837,2214
"15672","ENSG00000185215","14",103123442,103137439,13997
"15673","ENSG00000185219","3",44431705,44477670,45965
"15674","ENSG00000185220","1",248906196,248919946,13750
"15675","ENSG00000185221","1",214870734,214871716,982
"15676","ENSG00000185222","X",103356489,103358462,1973
"15677","ENSG00000185231","18",13882044,13915707,33663
"15678","ENSG00000185236","19",8389981,8404434,14453
"15679","ENSG00000185238","11",20387558,20509338,121780
"15680","ENSG00000185245","17",4932277,4935023,2746
"15681","ENSG00000185246","14",45084099,45116282,32183
"15682","ENSG00000185247","X",149688228,149717268,29040
"15683","ENSG00000185250","6",109390215,109441171,50956
"15684","ENSG00000185252","22",20394115,20408461,14346
"15685","ENSG00000185261","5",94152966,94618597,465631
"15686","ENSG00000185262","17",76265348,76271298,5950
"15687","ENSG00000185264","22",36991120,37007851,16731
"15688","ENSG00000185267","10",14819245,14838575,19330
"15689","ENSG00000185269","17",81952507,81961840,9333
"15690","ENSG00000185271","14",20425852,20436158,10306
"15691","ENSG00000185272","21",14216130,14228372,12242
"15692","ENSG00000185274","7",71132144,71713600,581456
"15693","ENSG00000185275","Y",18992467,18992709,242
"15694","ENSG00000185278","1",173868082,173903549,35467
"15695","ENSG00000185290","7",56114681,56116417,1736
"15696","ENSG00000185291","X",1336616,1382689,46073
"15697","ENSG00000185294","17",45844835,45847072,2237
"15698","ENSG00000185296","5",17306381,17306960,579
"15699","ENSG00000185298","17",81666737,81673904,7167
"15700","ENSG00000185303","10",79555852,79560402,4550
"15701","ENSG00000185304","2",87755960,87825952,69992
"15702","ENSG00000185305","5",53883942,54310582,426640
"15703","ENSG00000185306","12",64264762,64391192,126430
"15704","ENSG00000185313","3",38696802,38816286,119484
"15705","ENSG00000185324","16",89680737,89696354,15617
"15706","ENSG00000185332","17",81311270,81330674,19404
"15707","ENSG00000185338","16",11254405,11256200,1795
"15708","ENSG00000185339","22",30606838,30627278,20440
"15709","ENSG00000185340","22",29306582,29312785,6203
"15710","ENSG00000185344","12",123712353,123761755,49402
"15711","ENSG00000185345","6",161347417,162727771,1380354
"15712","ENSG00000185347","14",105489855,105499575,9720
"15713","ENSG00000185352","13",96090839,96839562,748723
"15714","ENSG00000185359","17",81683326,81703138,19812
"15715","ENSG00000185361","19",4639516,4655568,16052
"15716","ENSG00000185372","5",181123122,181131169,8047
"15717","ENSG00000185379","17",35092208,35121522,29314
"15718","ENSG00000185385","19",14878203,14886132,7929
"15719","ENSG00000185386","22",50263713,50270767,7054
"15720","ENSG00000185390","21",13349265,13350648,1383
"15721","ENSG00000185404","2",230327184,230403732,76548
"15722","ENSG00000185414","2",99181152,99199561,18409
"15723","ENSG00000185418","15",101653596,101724473,70877
"15724","ENSG00000185420","1",245749342,246507312,757970
"15725","ENSG00000185432","12",50923472,50932510,9038
"15726","ENSG00000185433","21",25385388,25431701,46313
"15727","ENSG00000185436","1",24154168,24187959,33791
"15728","ENSG00000185437","21",39445855,39515506,69651
"15729","ENSG00000185442","15",92617448,92809884,192436
"15730","ENSG00000185448","X",34129756,34132314,2558
"15731","ENSG00000185453","19",48170680,48197620,26940
"15732","ENSG00000185467","7",99173574,99207506,33932
"15733","ENSG00000185475","11",62787402,62790400,2998
"15734","ENSG00000185477","4",89236383,89307800,71417
"15735","ENSG00000185479","12",52446651,52452146,5495
"15736","ENSG00000185480","12",102120185,102197520,77335
"15737","ENSG00000185482","12",57243453,57251188,7735
"15738","ENSG00000185483","1",63774017,64181498,407481
"15739","ENSG00000185485","3",195959748,195990318,30570
"15740","ENSG00000185495","1",223992743,224010612,17869
"15741","ENSG00000185499","1",155185824,155192916,7092
"15742","ENSG00000185504","17",81539885,81553961,14076
"15743","ENSG00000185507","11",612553,615983,3430
"15744","ENSG00000185513","20",43489442,43550950,61508
"15745","ENSG00000185515","X",155071420,155123074,51654
"15746","ENSG00000185518","15",91099950,91301309,201359
"15747","ENSG00000185519","1",16057769,16073651,15882
"15748","ENSG00000185522","11",554850,560738,5888
"15749","ENSG00000185523","1",212830141,212847649,17508
"15750","ENSG00000185527","17",81650459,81663112,12653
"15751","ENSG00000185532","10",50990888,52298350,1307462
"15752","ENSG00000185551","15",96325938,96340263,14325
"15753","ENSG00000185559","14",100725705,100738224,12519
"15754","ENSG00000185561","17",1702816,1710377,7561
"15755","ENSG00000185565","3",115802363,117139389,1337026
"15756","ENSG00000185567","14",104937244,104978374,41130
"15757","ENSG00000185585","9",124777133,124814885,37752
"15758","ENSG00000185591","12",53380176,53416446,36270
"15759","ENSG00000185594","15",96783389,96785615,2226
"15760","ENSG00000185596","15",101961603,101976543,14940
"15761","ENSG00000185607","15",43989061,43990184,1123
"15762","ENSG00000185608","22",19431902,19436075,4173
"15763","ENSG00000185610","12",45014672,45051099,36427
"15764","ENSG00000185614","3",49803254,49805030,1776
"15765","ENSG00000185615","16",283152,287215,4063
"15766","ENSG00000185619","4",705748,770640,64892
"15767","ENSG00000185621","3",197960200,198043720,83520
"15768","ENSG00000185624","17",81843161,81860624,17463
"15769","ENSG00000185627","11",236966,252984,16018
"15770","ENSG00000185630","1",164555584,164899296,343712
"15771","ENSG00000185631","2",128203361,128203775,414
"15772","ENSG00000185633","12",57234903,57240715,5812
"15773","ENSG00000185634","15",48823741,48963919,140178
"15774","ENSG00000185640","12",52821410,52834295,12885
"15775","ENSG00000185641","5",116051917,116052289,372
"15776","ENSG00000185650","14",68787660,68796253,8593
"15777","ENSG00000185651","22",21549447,21624034,74587
"15778","ENSG00000185652","12",5432108,5521536,89428
"15779","ENSG00000185658","21",39184176,39321559,137383
"15780","ENSG00000185662","5",171782432,171796126,13694
"15781","ENSG00000185664","12",55954105,55973317,19212
"15782","ENSG00000185666","22",32512552,33058372,545820
"15783","ENSG00000185668","1",38044611,38046794,2183
"15784","ENSG00000185669","16",88677688,88686507,8819
"15785","ENSG00000185670","11",62748319,62754160,5841
"15786","ENSG00000185674","2",99242246,99255282,13036
"15787","ENSG00000185681","9",122159908,122200088,40180
"15788","ENSG00000185684","12",132084283,132131639,47356
"15789","ENSG00000185686","22",22547701,22559361,11660
"15790","ENSG00000185689","6",4079206,4130951,51745
"15791","ENSG00000185697","8",66562175,66614247,52072
"15792","ENSG00000185710","16",21879338,21919156,39818
"15793","ENSG00000185716","16",22007638,22087534,79896
"15794","ENSG00000185721","22",31399523,31530634,131111
"15795","ENSG00000185722","17",4163821,4263995,100174
"15796","ENSG00000185728","8",63168553,63212786,44233
"15797","ENSG00000185730","8",143289676,143298061,8385
"15798","ENSG00000185736","10",1177313,1737525,560212
"15799","ENSG00000185737","10",81875194,82987179,1111985
"15800","ENSG00000185739","16",4189374,4242080,52706
"15801","ENSG00000185742","11",109422120,109429114,6994
"15802","ENSG00000185745","10",89392546,89406487,13941
"15803","ENSG00000185753","X",40626921,40647561,20640
"15804","ENSG00000185758","4",183321764,183322426,662
"15805","ENSG00000185760","6",72621792,73198851,577059
"15806","ENSG00000185761","19",1505022,1513604,8582
"15807","ENSG00000185774","4",20728606,21948772,1220166
"15808","ENSG00000185775","9",42183659,42189882,6223
"15809","ENSG00000185787","15",78810487,78898133,87646
"15810","ENSG00000185792","19",55708432,55738402,29970
"15811","ENSG00000185798","3",196554177,196568674,14497
"15812","ENSG00000185800","19",45782947,45792845,9898
"15813","ENSG00000185803","8",144354135,144361272,7137
"15814","ENSG00000185808","21",37059170,37073170,14000
"15815","ENSG00000185811","7",50304068,50405101,101033
"15816","ENSG00000185813","17",81900965,81911464,10499
"15817","ENSG00000185818","4",2059512,2069089,9577
"15818","ENSG00000185821","12",55426254,55427192,938
"15819","ENSG00000185823","15",24675868,24683393,7525
"15820","ENSG00000185825","X",153700492,153724746,24254
"15821","ENSG00000185829","17",46516702,46579682,62980
"15822","ENSG00000185834","20",55074644,55075140,496
"15823","ENSG00000185837","22",17159384,17165445,6061
"15824","ENSG00000185838","22",19783223,19854939,71716
"15825","ENSG00000185839","1",58630841,58631530,689
"15826","ENSG00000185842","1",224896262,225399292,503030
"15827","ENSG00000185847","12",110934590,110959093,24503
"15828","ENSG00000185860","1",162824458,162868815,44357
"15829","ENSG00000185862","17",31303770,31314105,10335
"15830","ENSG00000185863","9",137170858,137172409,1551
"15831","ENSG00000185864","16",21834569,21880827,46258
"15832","ENSG00000185869","19",36888124,36916291,28167
"15833","ENSG00000185873","4",68226653,68245720,19067
"15834","ENSG00000185875","10",25016612,25026664,10052
"15835","ENSG00000185880","15",44728988,44767829,38841
"15836","ENSG00000185883","16",2513952,2520218,6266
"15837","ENSG00000185885","11",313506,315272,1766
"15838","ENSG00000185888","1",227815693,227846470,30777
"15839","ENSG00000185896","13",113297239,113323672,26433
"15840","ENSG00000185897","19",35358460,35360485,2025
"15841","ENSG00000185899","7",143443453,143444409,956
"15842","ENSG00000185900","8",43093506,43123434,29928
"15843","ENSG00000185904","10",42475480,42495337,19857
"15844","ENSG00000185905","16",29742463,29745990,3527
"15845","ENSG00000185909","3",49171598,49176486,4888
"15846","ENSG00000185915","X",21654690,21658330,3640
"15847","ENSG00000185917","21",36034541,36079389,44848
"15848","ENSG00000185920","9",95442980,95517057,74077
"15849","ENSG00000185924","17",1934677,2025334,90657
"15850","ENSG00000185933","10",103453387,103458888,5501
"15851","ENSG00000185942","8",62248591,62999652,751061
"15852","ENSG00000185946","1",103525691,103555239,29548
"15853","ENSG00000185947","16",31873807,31917357,43550
"15854","ENSG00000185950","13",109752695,109786583,33888
"15855","ENSG00000185955","7",100456620,100464260,7640
"15856","ENSG00000185958","12",50326230,50396622,70392
"15857","ENSG00000185960","X",624344,659411,35067
"15858","ENSG00000185962","1",152622834,152623103,269
"15859","ENSG00000185963","9",92711363,92764833,53470
"15860","ENSG00000185972","9",36169394,36171334,1940
"15861","ENSG00000185973","X",155489011,155669944,180933
"15862","ENSG00000185974","13",113667219,113737736,70517
"15863","ENSG00000185982","20",187853,189681,1828
"15864","ENSG00000185985","X",145817832,145829856,12024
"15865","ENSG00000185986","5",1567495,1594620,27125
"15866","ENSG00000185988","19",1524074,1536046,11972
"15867","ENSG00000185989","13",113977783,114132623,154840
"15868","ENSG00000186001","3",197791226,197888436,97210
"15869","ENSG00000186007","1",205381378,205455954,74576
"15870","ENSG00000186009","13",113648804,113658186,9382
"15871","ENSG00000186010","19",19515736,19529054,13318
"15872","ENSG00000186017","19",36445119,36489902,44783
"15873","ENSG00000186019","19",44103007,44113183,10176
"15874","ENSG00000186020","19",36534774,36605276,70502
"15875","ENSG00000186026","19",44072159,44089613,17454
"15876","ENSG00000186038","3",184097064,184106995,9931
"15877","ENSG00000186047","13",50519364,50843939,324575
"15878","ENSG00000186049","12",52607570,52618559,10989
"15879","ENSG00000186051","9",105662457,105663112,655
"15880","ENSG00000186056","1",30718504,30726827,8323
"15881","ENSG00000186063","1",222668013,222713210,45197
"15882","ENSG00000186073","15",36579626,36810248,230622
"15883","ENSG00000186074","17",74694311,74712978,18667
"15884","ENSG00000186075","17",39868164,39877896,9732
"15885","ENSG00000186076","12",93640822,93641586,764
"15886","ENSG00000186081","12",52514575,52520530,5955
"15887","ENSG00000186086","1",108450282,108471002,20720
"15888","ENSG00000186088","7",77310751,77416349,105598
"15889","ENSG00000186090","3",184031544,184039369,7825
"15890","ENSG00000186094","1",48532854,50023954,1491100
"15891","ENSG00000186103","3",121567917,121590622,22705
"15892","ENSG00000186104","11",14877440,14892252,14812
"15893","ENSG00000186105","5",62578819,62581446,2627
"15894","ENSG00000186106","8",100509752,100559784,50032
"15895","ENSG00000186111","19",3630183,3700479,70296
"15896","ENSG00000186115","19",15878023,15898077,20054
"15897","ENSG00000186118","1",46668855,46673594,4739
"15898","ENSG00000186119","11",55819607,55820597,990
"15899","ENSG00000186130","9",122908056,122913323,5267
"15900","ENSG00000186132","2",119302225,119366834,64609
"15901","ENSG00000186136","12",11185993,11186937,944
"15902","ENSG00000186141","1",145824088,145844402,20314
"15903","ENSG00000186143","2",27136848,27139410,2562
"15904","ENSG00000186146","4",9444534,9450514,5980
"15905","ENSG00000186148","2",109933161,109974085,40924
"15906","ENSG00000186150","1",110112468,110113945,1477
"15907","ENSG00000186152","19",54696604,54700905,4301
"15908","ENSG00000186153","16",78099430,79212667,1113237
"15909","ENSG00000186160","1",47067231,47118318,51087
"15910","ENSG00000186162","3",10014238,10026365,12127
"15911","ENSG00000186163","7",142265833,142272235,6402
"15912","ENSG00000186166","11",118998138,119015793,17655
"15913","ENSG00000186174","11",118893875,118925608,31733
"15914","ENSG00000186184","13",27620742,27744237,123495
"15915","ENSG00000186185","17",44924709,44947711,23002
"15916","ENSG00000186187","16",74999030,75110994,111964
"15917","ENSG00000186188","10",93566665,93604480,37815
"15918","ENSG00000186190","20",33055424,33073628,18204
"15919","ENSG00000186191","20",33079644,33111751,32107
"15920","ENSG00000186193","9",137062127,137070557,8430
"15921","ENSG00000186197","1",236348257,236502915,154658
"15922","ENSG00000186198","15",65045387,65053397,8010
"15923","ENSG00000186204","19",15672757,15697174,24417
"15924","ENSG00000186205","1",220786913,220819659,32746
"15925","ENSG00000186207","1",152510803,152512177,1374
"15926","ENSG00000186212","4",76894928,76898147,3219
"15927","ENSG00000186222","4",6716055,6717671,1616
"15928","ENSG00000186226","1",152786214,152788426,2212
"15929","ENSG00000186230","19",57435325,57447101,11776
"15930","ENSG00000186231","6",96924620,97140754,216134
"15931","ENSG00000186234","4",9692495,9702954,10459
"15932","ENSG00000186235","2",238224552,238231699,7147
"15933","ENSG00000186260","16",14071321,14266773,195452
"15934","ENSG00000186265","3",112463966,112499472,35506
"15935","ENSG00000186268","11",124093582,124094532,950
"15936","ENSG00000186272","19",57411163,57421939,10776
"15937","ENSG00000186280","11",94973709,94999519,25810
"15938","ENSG00000186281","2",96021946,96039451,17505
"15939","ENSG00000186283","1",179082070,179098023,15953
"15940","ENSG00000186288","X",73077276,73079512,2236
"15941","ENSG00000186297","15",26866911,26949208,82297
"15942","ENSG00000186298","12",110719680,110742939,23259
"15943","ENSG00000186300","19",2841437,2860471,19034
"15944","ENSG00000186301","1",16645622,16650289,4667
"15945","ENSG00000186306","1",158398522,158399466,944
"15946","ENSG00000186310","X",93670930,93673568,2638
"15947","ENSG00000186312","X",15674932,15703724,28792
"15948","ENSG00000186314","5",145471799,145835369,363570
"15949","ENSG00000186318","11",117285207,117316259,31052
"15950","ENSG00000186326","19",32675407,32678300,2893
"15951","ENSG00000186329","3",171843349,171938715,95366
"15952","ENSG00000186334","5",151276762,151303766,27004
"15953","ENSG00000186335","5",151314972,151347590,32618
"15954","ENSG00000186340","6",169215780,169254044,38264
"15955","ENSG00000186350","9",134317098,134440585,123487
"15956","ENSG00000186352","4",185396021,185400628,4607
"15957","ENSG00000186364","1",145845630,145848954,3324
"15958","ENSG00000186367","5",129748079,129766732,18653
"15959","ENSG00000186369","14",62114353,62130962,16609
"15960","ENSG00000186376","X",135248920,135344109,95189
"15961","ENSG00000186377","1",47023669,47050751,27082
"15962","ENSG00000186393","17",40766238,40772162,5924
"15963","ENSG00000186395","17",40818117,40822614,4497
"15964","ENSG00000186399","15",30403740,30414162,10422
"15965","ENSG00000186407","17",74609885,74623738,13853
"15966","ENSG00000186409","1",42463221,42657190,193969
"15967","ENSG00000186416","X",119588337,119606443,18106
"15968","ENSG00000186417","15",51341655,51408005,66350
"15969","ENSG00000186431","19",54874235,54891420,17185
"15970","ENSG00000186432","3",160495007,160565571,70564
"15971","ENSG00000186439","6",123216339,123637093,420754
"15972","ENSG00000186440","1",158560606,158570580,9974
"15973","ENSG00000186442","12",52789685,52796117,6432
"15974","ENSG00000186446","3",44729596,44737083,7487
"15975","ENSG00000186448","3",44584888,44648471,63583
"15976","ENSG00000186451","3",57060664,57075432,14768
"15977","ENSG00000186452","12",50842920,50887884,44964
"15978","ENSG00000186453","2",24175053,24200849,25796
"15979","ENSG00000186458","20",257724,261096,3372
"15980","ENSG00000186462","X",73212299,73214848,2549
"15981","ENSG00000186466","9",63317067,63333091,16024
"15982","ENSG00000186468","5",82273320,82278396,5076
"15983","ENSG00000186469","14",51826195,51979342,153147
"15984","ENSG00000186470","6",26365159,26378320,13161
"15985","ENSG00000186471","X",119895837,119920716,24879
"15986","ENSG00000186472","7",82754012,83162930,408918
"15987","ENSG00000186474","19",51029092,51035230,6138
"15988","ENSG00000186479","5",64506257,64612312,106055
"15989","ENSG00000186480","7",155297776,155310235,12459
"15990","ENSG00000186481","18",14179097,14252140,73043
"15991","ENSG00000186487","2",1789113,2331664,542551
"15992","ENSG00000186493","5",2752131,2755397,3266
"15993","ENSG00000186496","18",35366694,35377337,10643
"15994","ENSG00000186501","1",27322145,27336400,14255
"15995","ENSG00000186509","11",58023881,58181616,157735
"15996","ENSG00000186510","1",16018875,16034050,15175
"15997","ENSG00000186517","1",161046946,161069970,23024
"15998","ENSG00000186522","2",109542799,109614143,71344
"15999","ENSG00000186523","8",12182096,12194133,12037
"16000","ENSG00000186526","19",15615218,15630638,15420
"16001","ENSG00000186529","19",15640897,15662825,21928
"16002","ENSG00000186532","17",1779485,1830634,51149
"16003","ENSG00000186543","1",21434318,21437558,3240
"16004","ENSG00000186562","8",7821966,7823889,1923
"16005","ENSG00000186564","1",47436017,47440691,4674
"16006","ENSG00000186566","17",44395281,44503430,108149
"16007","ENSG00000186567","19",44662278,44684359,22081
"16008","ENSG00000186572","8",7811720,7815716,3996
"16009","ENSG00000186575","22",29603556,29698598,95042
"16010","ENSG00000186577","6",34246381,34249108,2727
"16011","ENSG00000186579","8",7825172,7829053,3881
"16012","ENSG00000186583","8",144012414,144047085,34671
"16013","ENSG00000186591","7",129830732,129952949,122217
"16014","ENSG00000186594","17",1711493,1717174,5681
"16015","ENSG00000186599","8",7487669,7489593,1924
"16016","ENSG00000186603","1",45326905,45328533,1628
"16017","ENSG00000186615","14",55496786,55580888,84102
"16018","ENSG00000186625","6",149594873,149648972,54099
"16019","ENSG00000186628","15",82755362,82806070,50708
"16020","ENSG00000186635","11",72685069,72793599,108530
"16021","ENSG00000186638","9",34252381,34311371,58990
"16022","ENSG00000186642","11",72576141,72674591,98450
"16023","ENSG00000186645","7",77024691,77030572,5881
"16024","ENSG00000186648","14",24052009,24069729,17720
"16025","ENSG00000186652","11",57386780,57390650,3870
"16026","ENSG00000186654","22",44668547,44737681,69134
"16027","ENSG00000186660","11",58579063,58621550,42487
"16028","ENSG00000186665","17",67991101,67996431,5330
"16029","ENSG00000186666","12",49836043,49843106,7063
"16030","ENSG00000186675","X",75782988,75785236,2248
"16031","ENSG00000186676","7",125033453,125035301,1848
"16032","ENSG00000186684","2",127184120,127220313,36193
"16033","ENSG00000186687","5",131170944,131205428,34484
"16034","ENSG00000186704","7",76978617,77004308,25691
"16035","ENSG00000186710","12",113149858,113159276,9418
"16036","ENSG00000186714","11",32602246,32794658,192412
"16037","ENSG00000186715","1",16754910,16770237,15327
"16038","ENSG00000186716","22",23179704,23318037,138333
"16039","ENSG00000186723","19",15804549,15815664,11115
"16040","ENSG00000186732","22",43411196,43507848,96652
"16041","ENSG00000186743","6",116038756,116039495,739
"16042","ENSG00000186765","17",81528396,81537130,8734
"16043","ENSG00000186766","10",127737235,127741186,3951
"16044","ENSG00000186767","X",63347228,63351344,4116
"16045","ENSG00000186777","4",270675,305321,34646
"16046","ENSG00000186787","X",57118551,57121546,2995
"16047","ENSG00000186788","9",81943586,81950038,6452
"16048","ENSG00000186790","1",47416285,47418052,1767
"16049","ENSG00000186792","3",50292831,50299405,6574
"16050","ENSG00000186795","10",117197489,117210299,12810
"16051","ENSG00000186806","19",51331536,51342124,10588
"16052","ENSG00000186810","X",71615916,71618511,2595
"16053","ENSG00000186812","18",35241030,35267133,26103
"16054","ENSG00000186814","18",35251058,35290245,39187
"16055","ENSG00000186815","12",113221050,113298585,77535
"16056","ENSG00000186818","19",54643889,54670359,26470
"16057","ENSG00000186825","2",131794961,131801661,6700
"16058","ENSG00000186827","1",1211340,1214153,2813
"16059","ENSG00000186831","17",18426861,18431848,4987
"16060","ENSG00000186832","17",41609778,41615899,6121
"16061","ENSG00000186834","17",45148502,45152101,3599
"16062","ENSG00000186838","19",39515113,39520686,5573
"16063","ENSG00000186842","21",32572238,32575881,3643
"16064","ENSG00000186844","1",152827473,152827894,421
"16065","ENSG00000186847","17",41582279,41586895,4616
"16066","ENSG00000186854","2",84821650,84907008,85358
"16067","ENSG00000186862","10",101007679,101032295,24616
"16068","ENSG00000186866","21",45263928,45287898,23970
"16069","ENSG00000186867","4",121329312,121381059,51747
"16070","ENSG00000186868","17",45894382,46028334,133952
"16071","ENSG00000186871","X",72204657,72239027,34370
"16072","ENSG00000186881","9",104504263,104505222,959
"16073","ENSG00000186889","2",62500218,62511894,11676
"16074","ENSG00000186891","1",1203508,1206592,3084
"16075","ENSG00000186897","12",49332409,49337188,4779
"16076","ENSG00000186907","11",57460528,57477534,17006
"16077","ENSG00000186908","12",76763588,76853696,90108
"16078","ENSG00000186910","14",94442464,94452800,10336
"16079","ENSG00000186912","X",70258170,70259764,1594
"16080","ENSG00000186918","8",28345590,28402701,57111
"16081","ENSG00000186919","17",76071961,76083666,11705
"16082","ENSG00000186930","21",30598590,30598902,312
"16083","ENSG00000186940","9",79391304,79391759,455
"16084","ENSG00000186951","22",46150521,46243756,93235
"16085","ENSG00000186952","5",110289233,110738956,449723
"16086","ENSG00000186960","14",28771676,28823817,52141
"16087","ENSG00000186971","21",30430230,30431026,796
"16088","ENSG00000186973","1",43145153,43156396,11243
"16089","ENSG00000186976","22",43528744,43812337,283593
"16090","ENSG00000186994","19",8322584,8343262,20678
"16091","ENSG00000186998","22",29205896,29259597,53701
"16092","ENSG00000187003","9",108862266,108863759,1493
"16093","ENSG00000187010","1",25272393,25330445,58052
"16094","ENSG00000187012","22",44569295,44572453,3158
"16095","ENSG00000187013","17",61411751,61413280,1529
"16096","ENSG00000187017","1",6424776,6461367,36591
"16097","ENSG00000187021","10",116590385,116609175,18790
"16098","ENSG00000187024","9",127690348,127724873,34525
"16099","ENSG00000187026","21",30746794,30747233,439
"16100","ENSG00000187033","3",169911572,169939175,27603
"16101","ENSG00000187037","7",37683796,37833788,149992
"16102","ENSG00000187045","22",37065436,37109713,44277
"16103","ENSG00000187048","1",46929177,46941484,12307
"16104","ENSG00000187049","11",61391687,61398863,7176
"16105","ENSG00000187051","22",39529093,39532761,3668
"16106","ENSG00000187054","4",67909385,67964140,54755
"16107","ENSG00000187066","11",65084979,65089375,4396
"16108","ENSG00000187068","3",185076838,185153060,76222
"16109","ENSG00000187079","11",12674421,12944737,270316
"16110","ENSG00000187080","1",247965233,247966386,1153
"16111","ENSG00000187082","8",7482504,7486400,3896
"16112","ENSG00000187091","3",38007496,38029762,22266
"16113","ENSG00000187094","3",42257825,42266207,8382
"16114","ENSG00000187097","14",73958010,74019399,61389
"16115","ENSG00000187098","3",69739435,69968337,228902
"16116","ENSG00000187103","6",146171315,146171847,532
"16117","ENSG00000187105","14",73478484,73558947,80463
"16118","ENSG00000187109","12",76036585,76084958,48373
"16119","ENSG00000187116","19",54307070,54313139,6069
"16120","ENSG00000187118","3",28241584,28325142,83558
"16121","ENSG00000187122","10",96998038,97185959,187921
"16122","ENSG00000187123","2",149329985,149474138,144153
"16123","ENSG00000187134","10",4963253,4983283,20030
"16124","ENSG00000187135","19",29526499,29564479,37980
"16125","ENSG00000187140","1",63323041,63325126,2085
"16126","ENSG00000187144","1",16387117,16437424,50307
"16127","ENSG00000187147","1",44405194,44651724,246530
"16128","ENSG00000187151","11",101890674,101916522,25848
"16129","ENSG00000187164","10",116881477,117126586,245109
"16130","ENSG00000187166","12",48328980,48330279,1299
"16131","ENSG00000187172","21",10413477,10516431,102954
"16132","ENSG00000187173","1",152698345,152699442,1097
"16133","ENSG00000187175","21",44681576,44682163,587
"16134","ENSG00000187180","1",152675295,152676574,1279
"16135","ENSG00000187185","16",57798186,57816946,18760
"16136","ENSG00000187186","9",34664163,34666112,1949
"16137","ENSG00000187187","19",39984134,40021038,36904
"16138","ENSG00000187189","6",116249961,116254140,4179
"16139","ENSG00000187191","Y",24763069,24813492,50423
"16140","ENSG00000187193","16",56682470,56684196,1726
"16141","ENSG00000187210","9",76419850,76651203,231353
"16142","ENSG00000187223","1",152663396,152664659,1263
"16143","ENSG00000187229","8",18720905,18734405,13500
"16144","ENSG00000187231","2",179101678,179264832,163154
"16145","ENSG00000187239","9",129887187,130043194,156007
"16146","ENSG00000187240","11",103109410,103479863,370453
"16147","ENSG00000187242","17",40861303,40867223,5920
"16148","ENSG00000187243","X",52061827,52069248,7421
"16149","ENSG00000187244","19",44809059,44821421,12362
"16150","ENSG00000187257","7",77696459,77783022,86563
"16151","ENSG00000187258","7",34658239,34878332,220093
"16152","ENSG00000187260","7",151375909,151410727,34818
"16153","ENSG00000187266","19",11377207,11384342,7135
"16154","ENSG00000187268","X",13035617,13044682,9065
"16155","ENSG00000187288","3",9866711,9880254,13543
"16156","ENSG00000187323","18",52340197,53535903,1195706
"16157","ENSG00000187325","X",78129748,78139650,9902
"16158","ENSG00000187372","5",141213919,141218979,5060
"16159","ENSG00000187391","7",78017055,79453667,1436612
"16160","ENSG00000187398","11",24496970,25082638,585668
"16161","ENSG00000187416","7",104328700,104907232,578532
"16162","ENSG00000187446","15",41230839,41281887,51048
"16163","ENSG00000187472","6",98780257,98780505,248
"16164","ENSG00000187474","19",51795157,51826190,31033
"16165","ENSG00000187475","6",26107419,26108136,717
"16166","ENSG00000187479","11",43925342,43943883,18541
"16167","ENSG00000187481","1",119467221,119473803,6582
"16168","ENSG00000187486","11",17385859,17389331,3472
"16169","ENSG00000187492","3",49790732,49799873,9141
"16170","ENSG00000187498","13",110148963,110307157,158194
"16171","ENSG00000187504","17",51502488,51503233,745
"16172","ENSG00000187510","12",92702843,92772455,69612
"16173","ENSG00000187513","1",34792999,34795747,2748
"16174","ENSG00000187514","2",231706895,231713541,6646
"16175","ENSG00000187516","X",37990817,37991317,500
"16176","ENSG00000187522","10",14838306,14871741,33435
"16177","ENSG00000187527","3",193274790,193378843,104053
"16178","ENSG00000187531","17",81911939,81921323,9384
"16179","ENSG00000187533","4",70133616,70176799,43183
"16180","ENSG00000187534","19",39943239,39943680,441
"16181","ENSG00000187535","16",1510427,1612072,101645
"16182","ENSG00000187536","2",25809925,25810656,731
"16183","ENSG00000187537","14",19402486,19434341,31855
"16184","ENSG00000187546","7",15200317,15562015,361698
"16185","ENSG00000187550","19",55529733,55537089,7356
"16186","ENSG00000187553","10",93060798,93069540,8742
"16187","ENSG00000187554","1",223109404,223143248,33844
"16188","ENSG00000187555","16",8892097,8964514,72417
"16189","ENSG00000187556","19",13862063,13880757,18694
"16190","ENSG00000187559","9",68302867,68304905,2038
"16191","ENSG00000187566","6",18120440,18122687,2247
"16192","ENSG00000187569","12",7711433,7717559,6126
"16193","ENSG00000187581","14",93347191,93348356,1165
"16194","ENSG00000187583","1",966497,975865,9368
"16195","ENSG00000187589","18",14377546,14378757,1211
"16196","ENSG00000187595","17",42025576,42098479,72903
"16197","ENSG00000187600","2",46429190,46441833,12643
"16198","ENSG00000187601","X",55452105,55453566,1461
"16199","ENSG00000187605","2",73986404,74108176,121772
"16200","ENSG00000187607","17",15699577,15720787,21210
"16201","ENSG00000187608","1",1001138,1014540,13402
"16202","ENSG00000187609","9",137306896,137423211,116315
"16203","ENSG00000187616","9",133514586,133528612,14026
"16204","ENSG00000187621","14",95650498,95679833,29335
"16205","ENSG00000187624","17",410325,431062,20737
"16206","ENSG00000187626","6",28241697,28252269,10572
"16207","ENSG00000187627","2",86907953,87013976,106023
"16208","ENSG00000187630","14",23969874,24006408,36534
"16209","ENSG00000187634","1",923928,944581,20653
"16210","ENSG00000187642","1",975204,982093,6889
"16211","ENSG00000187650","19",5904858,5910853,5995
"16212","ENSG00000187653","4",90838903,90839037,134
"16213","ENSG00000187657","Y",9905595,9908139,2544
"16214","ENSG00000187658","5",157671533,157680158,8625
"16215","ENSG00000187672","3",55508311,56468467,960156
"16216","ENSG00000187676","13",31199975,31332276,132301
"16217","ENSG00000187678","5",142310427,142326455,16028
"16218","ENSG00000187682","X",48826513,48830138,3625
"16219","ENSG00000187686","11",125113161,125126781,13620
"16220","ENSG00000187688","17",16415571,16437003,21432
"16221","ENSG00000187689","4",70518569,70532743,14174
"16222","ENSG00000187690","X",51406948,51408843,1895
"16223","ENSG00000187699","2",189879609,190203484,323875
"16224","ENSG00000187713","9",137204082,137205648,1566
"16225","ENSG00000187714","10",49610310,49612720,2410
"16226","ENSG00000187715","3",127915232,127987671,72439
"16227","ENSG00000187720","15",71096952,71783383,686431
"16228","ENSG00000187721","13",19026001,19032626,6625
"16229","ENSG00000187726","11",73950319,73970366,20047
"16230","ENSG00000187730","1",2019329,2030758,11429
"16231","ENSG00000187735","8",53966552,54022456,55904
"16232","ENSG00000187736","2",219075317,219160865,85548
"16233","ENSG00000187741","16",89737549,89816657,79108
"16234","ENSG00000187742","9",89318506,89359662,41156
"16235","ENSG00000187747","11",5580877,5581884,1007
"16236","ENSG00000187753","9",86220265,86259657,39392
"16237","ENSG00000187758","4",99276369,99291003,14634
"16238","ENSG00000187762","6",35023522,35023831,309
"16239","ENSG00000187763","6",28046434,28047367,933
"16240","ENSG00000187764","9",89360787,89498130,137343
"16241","ENSG00000187772","6",104936616,105083332,146716
"16242","ENSG00000187773","18",74434099,74457944,23845
"16243","ENSG00000187775","17",78423697,78577394,153697
"16244","ENSG00000187778","12",49556544,49568145,11601
"16245","ENSG00000187783","10",44911316,44937010,25694
"16246","ENSG00000187790","14",45135930,45200890,64960
"16247","ENSG00000187791","9",34889066,34895764,6698
"16248","ENSG00000187792","22",23738682,23751112,12430
"16249","ENSG00000187796","9",136361903,136373681,11778
"16250","ENSG00000187800","1",156893698,156916434,22736
"16251","ENSG00000187801","1",40450102,40463718,13616
"16252","ENSG00000187806","15",72398273,72408029,9756
"16253","ENSG00000187808","X",119758588,119760202,1614
"16254","ENSG00000187812","15",75775553,75786898,11345
"16255","ENSG00000187815","1",40477290,40496343,19053
"16256","ENSG00000187821","4",185018841,185020804,1963
"16257","ENSG00000187823","X",112454500,112457112,2612
"16258","ENSG00000187824","17",10699015,10730316,31301
"16259","ENSG00000187833","2",73784189,73817147,32958
"16260","ENSG00000187837","6",26055787,26056428,641
"16261","ENSG00000187838","17",7389727,7394842,5115
"16262","ENSG00000187840","8",38030534,38060365,29831
"16263","ENSG00000187848","12",132618776,132622386,3610
"16264","ENSG00000187855","12",107774385,107776644,2259
"16265","ENSG00000187860","22",30356635,30378658,22023
"16266","ENSG00000187862","1",156579727,156586770,7043
"16267","ENSG00000187866","9",68780034,68784608,4574
"16268","ENSG00000187867","19",14053363,14062076,8713
"16269","ENSG00000187870","17",20743333,20754501,11168
"16270","ENSG00000187871","6",55327469,55402493,75024
"16271","ENSG00000187889","1",56718789,56819696,100907
"16272","ENSG00000187893","X",47707191,47753456,46265
"16273","ENSG00000187900","3",98238352,98239281,929
"16274","ENSG00000187902","19",55428740,55442863,14123
"16275","ENSG00000187904","4",6995341,6998958,3617
"16276","ENSG00000187905","22",21045960,21064168,18208
"16277","ENSG00000187908","10",122560665,122643740,83075
"16278","ENSG00000187912","19",14583084,14611157,28073
"16279","ENSG00000187918","11",5449323,5456518,7195
"16280","ENSG00000187922","9",136738167,136743356,5189
"16281","ENSG00000187942","1",21812265,21825221,12956
"16282","ENSG00000187944","2",196805002,196810276,5274
"16283","ENSG00000187950","12",29412474,29497686,85212
"16284","ENSG00000187951","15",30658717,30772993,114276
"16285","ENSG00000187952","1",21428303,21429536,1233
"16286","ENSG00000187953","7",6710128,6753862,43734
"16287","ENSG00000187954","8",144449582,144465677,16095
"16288","ENSG00000187955","8",120059780,120373573,313793
"16289","ENSG00000187957","2",229357629,229714555,356926
"16290","ENSG00000187959","17",73248449,73262352,13903
"16291","ENSG00000187961","1",960584,965719,5135
"16292","ENSG00000187969","X",74304190,74305031,841
"16293","ENSG00000187979","22",18178038,18205915,27877
"16294","ENSG00000187980","1",20161253,20177424,16171
"16295","ENSG00000187984","9",92809388,92888693,79305
"16296","ENSG00000187987","6",28431930,28443502,11572
"16297","ENSG00000187988","9",37477149,37478317,1168
"16298","ENSG00000187994","19",38867830,38878275,10445
"16299","ENSG00000187997","17",78146353,78166177,19824
"16300","ENSG00000187999","2",33636502,33637425,923
"16301","ENSG00000188000","19",9178979,9188817,9838
"16302","ENSG00000188001","3",188947214,189325304,378090
"16303","ENSG00000188002","5",1598920,1634005,35085
"16304","ENSG00000188004","1",159834495,159855237,20742
"16305","ENSG00000188010","2",38875962,38929072,53110
"16306","ENSG00000188011","2",241869600,241873823,4223
"16307","ENSG00000188013","17",20589293,20590367,1074
"16308","ENSG00000188015","1",153547329,153549258,1929
"16309","ENSG00000188021","X",56563639,56567868,4229
"16310","ENSG00000188026","12",123470054,123533719,63665
"16311","ENSG00000188029","9",87772453,87786884,14431
"16312","ENSG00000188032","19",14081619,14085875,4256
"16313","ENSG00000188033","19",12576100,12640098,63998
"16314","ENSG00000188037","7",143316126,143352083,35957
"16315","ENSG00000188038","16",67884885,67888855,3970
"16316","ENSG00000188039","19",16719976,16817963,97987
"16317","ENSG00000188042","2",234493041,234497081,4040
"16318","ENSG00000188050","7",122697712,122699156,1444
"16319","ENSG00000188051","19",17435509,17448668,13159
"16320","ENSG00000188056","6",41228324,41238882,10558
"16321","ENSG00000188060","1",28592200,28595443,3243
"16322","ENSG00000188064","22",45920366,45977162,56796
"16323","ENSG00000188070","11",63759892,63768775,8883
"16324","ENSG00000188076","11",193080,194573,1493
"16325","ENSG00000188078","22",36536656,36537604,948
"16326","ENSG00000188086","3",46742350,46750745,8395
"16327","ENSG00000188089","15",41981582,42051190,69608
"16328","ENSG00000188092","1",147928393,147993521,65128
"16329","ENSG00000188095","15",89760591,89778754,18163
"16330","ENSG00000188101","9",92913156,92921560,8404
"16331","ENSG00000188107","6",63719980,65707225,1987245
"16332","ENSG00000188112","6",42101119,42142620,41501
"16333","ENSG00000188120","Y",23129355,23199094,69739
"16334","ENSG00000188124","11",6765626,6771976,6350
"16335","ENSG00000188130","22",50245450,50261716,16266
"16336","ENSG00000188133","9",32783540,32789201,5661
"16337","ENSG00000188152","9",96928310,96940253,11943
"16338","ENSG00000188153","X",108439844,108697545,257701
"16339","ENSG00000188157","1",1020120,1056118,35998
"16340","ENSG00000188158","X",17375420,17735994,360574
"16341","ENSG00000188162","11",17547373,17647150,99777
"16342","ENSG00000188163","9",137243584,137247770,4186
"16343","ENSG00000188167","3",33090421,33097146,6725
"16344","ENSG00000188171","19",20619939,20661596,41657
"16345","ENSG00000188175","7",93188586,93226524,37938
"16346","ENSG00000188176","17",4583999,4608319,24320
"16347","ENSG00000188177","2",112275597,112340063,64466
"16348","ENSG00000188185","7",39733430,39793092,59662
"16349","ENSG00000188186","7",100148907,100155944,7037
"16350","ENSG00000188191","7",549197,727650,178453
"16351","ENSG00000188199","10",79703227,79714681,11454
"16352","ENSG00000188211","11",17351726,17377341,25615
"16353","ENSG00000188215","16",20854925,20900358,45433
"16354","ENSG00000188219","2",131218067,131265278,47211
"16355","ENSG00000188223","19",35745678,35754519,8841
"16356","ENSG00000188227","19",37506939,37548762,41823
"16357","ENSG00000188229","9",137241287,137243707,2420
"16358","ENSG00000188234","10",45825594,45853875,28281
"16359","ENSG00000188242","5",466124,473098,6974
"16360","ENSG00000188243","13",75525219,75549439,24220
"16361","ENSG00000188257","1",19975431,19980416,4985
"16362","ENSG00000188263","22",49994513,50012659,18146
"16363","ENSG00000188266","15",78507564,78537372,29808
"16364","ENSG00000188269","19",14824251,14835285,11034
"16365","ENSG00000188277","15",40770080,40772449,2369
"16366","ENSG00000188280","22",20338805,20354372,15567
"16367","ENSG00000188282","2",218034960,218090581,55621
"16368","ENSG00000188283","19",37217926,37248738,30812
"16369","ENSG00000188290","1",998962,1000172,1210
"16370","ENSG00000188293","19",46229742,46231243,1501
"16371","ENSG00000188295","1",247099962,247104372,4410
"16372","ENSG00000188305","19",2274631,2282175,7544
"16373","ENSG00000188306","3",169821922,169837775,15853
"16374","ENSG00000188312","9",92325953,92620529,294576
"16375","ENSG00000188313","3",146515180,146544856,29676
"16376","ENSG00000188315","3",49268596,49277232,8636
"16377","ENSG00000188316","10",116849512,116911788,62276
"16378","ENSG00000188321","19",9323772,9351162,27390
"16379","ENSG00000188322","16",28259228,28323849,64621
"16380","ENSG00000188334","19",47968046,47992170,24124
"16381","ENSG00000188338","3",50205246,50221486,16240
"16382","ENSG00000188342","13",45120510,45284893,164383
"16383","ENSG00000188343","8",93698561,93731527,32966
"16384","ENSG00000188352","9",20658309,20995955,337646
"16385","ENSG00000188365","7",5419846,5423122,3276
"16386","ENSG00000188368","19",42302098,42310821,8723
"16387","ENSG00000188372","7",76397518,76442071,44553
"16388","ENSG00000188373","10",84173801,84185294,11493
"16389","ENSG00000188375","12",31791185,31792298,1113
"16390","ENSG00000188379","9",21384254,21385388,1134
"16391","ENSG00000188383","2",97081098,97083249,2151
"16392","ENSG00000188385","10",132036336,132184858,148522
"16393","ENSG00000188386","9",101591604,101595021,3417
"16394","ENSG00000188388","15",85240472,85247170,6698
"16395","ENSG00000188389","2",241849884,241858894,9010
"16396","ENSG00000188393","12",9898673,9932381,33708
"16397","ENSG00000188394","9",123034527,123035696,1169
"16398","ENSG00000188396","1",44805913,44806675,762
"16399","ENSG00000188403","15",19964666,19965101,435
"16400","ENSG00000188404","1",169690665,169711702,21037
"16401","ENSG00000188408","X",26216169,26218270,2101
"16402","ENSG00000188419","X",85861180,86047561,186381
"16403","ENSG00000188425","19",45913214,45914870,1656
"16404","ENSG00000188428","6",8013567,8064396,50829
"16405","ENSG00000188451","6",158237336,158242797,5461
"16406","ENSG00000188452","2",181536672,181680665,143993
"16407","ENSG00000188459","X",47803296,47804789,1493
"16408","ENSG00000188460","1",223863726,223864851,1125
"16409","ENSG00000188467","15",48120972,48142672,21700
"16410","ENSG00000188483","9",129175552,129178262,2710
"16411","ENSG00000188486","11",119093854,119095467,1613
"16412","ENSG00000188487","11",15112424,15247208,134784
"16413","ENSG00000188488","14",94561442,94593118,31676
"16414","ENSG00000188493","19",40740856,40751553,10697
"16415","ENSG00000188501","15",66547179,66565979,18800
"16416","ENSG00000188505","19",39196964,39201884,4920
"16417","ENSG00000188508","19",35487324,35495558,8234
"16418","ENSG00000188511","22",49414524,49657542,243018
"16419","ENSG00000188512","8",33969567,33969879,312
"16420","ENSG00000188517","4",108808725,109302752,494027
"16421","ENSG00000188522","17",18968789,19004764,35975
"16422","ENSG00000188523","9",132410043,132573317,163274
"16423","ENSG00000188525","2",10003158,10006030,2872
"16424","ENSG00000188529","1",23964804,23980927,16123
"16425","ENSG00000188536","16",172876,173710,834
"16426","ENSG00000188542","2",240560054,240564014,3960
"16427","ENSG00000188549","15",40331452,40340967,9515
"16428","ENSG00000188554","17",43170481,43211689,41208
"16429","ENSG00000188559","20",20389530,20712644,323114
"16430","ENSG00000188566","9",137205685,137217009,11324
"16431","ENSG00000188573","5",168529116,168530634,1518
"16432","ENSG00000188580","6",123804141,124825657,1021516
"16433","ENSG00000188582","3",142949164,142963682,14518
"16434","ENSG00000188585","1",178479247,178499634,20387
"16435","ENSG00000188596","12",96489571,96875555,385984
"16436","ENSG00000188599","16",15104312,15123498,19186
"16437","ENSG00000188603","16",28474111,28495575,21464
"16438","ENSG00000188610","1",121167646,121185539,17893
"16439","ENSG00000188611","10",50182778,50279720,96942
"16440","ENSG00000188612","17",75165586,75182959,17373
"16441","ENSG00000188613","10",119029714,119033730,4016
"16442","ENSG00000188620","10",123135962,123139423,3461
"16443","ENSG00000188624","19",46120067,46124688,4621
"16444","ENSG00000188626","15",28701954,28738384,36430
"16445","ENSG00000188629","19",9363020,9382617,19597
"16446","ENSG00000188636","22",44492583,44498233,5650
"16447","ENSG00000188641","1",97077743,97995000,917257
"16448","ENSG00000188643","1",153606886,153613145,6259
"16449","ENSG00000188647","9",69709522,69760011,50489
"16450","ENSG00000188649","10",95907603,96032684,125081
"16451","ENSG00000188655","14",20556093,20560931,4838
"16452","ENSG00000188659","15",82262810,82284930,22120
"16453","ENSG00000188660","21",43446601,43453902,7301
"16454","ENSG00000188662","17",50171428,50181178,9750
"16455","ENSG00000188668","2",158874642,158875670,1028
"16456","ENSG00000188672","1",25362249,25430192,67943
"16457","ENSG00000188674","2",208165343,208190030,24687
"16458","ENSG00000188676","8",39934614,40016391,81777
"16459","ENSG00000188677","22",43999211,44172949,173738
"16460","ENSG00000188681","21",9068361,9129752,61391
"16461","ENSG00000188687","2",74216242,74343414,127172
"16462","ENSG00000188690","10",125784980,125823258,38278
"16463","ENSG00000188693","7",92134604,92180725,46121
"16464","ENSG00000188706","X",129803288,129843909,40621
"16465","ENSG00000188707","7",150322639,150332721,10082
"16466","ENSG00000188710","9",130892702,130896812,4110
"16467","ENSG00000188712","9",104722335,104723271,936
"16468","ENSG00000188716","10",75037836,75058514,20678
"16469","ENSG00000188725","5",61157704,61162468,4764
"16470","ENSG00000188729","3",191199241,191265615,66374
"16471","ENSG00000188730","7",49773638,49921950,148312
"16472","ENSG00000188732","7",23680130,23703249,23119
"16473","ENSG00000188735","12",121712752,121783001,70249
"16474","ENSG00000188738","2",185738804,185833290,94486
"16475","ENSG00000188739","1",235131183,235161283,30100
"16476","ENSG00000188747","9",137423350,137434406,11056
"16477","ENSG00000188755","17",62264705,62275655,10950
"16478","ENSG00000188760","2",219543663,219550595,6932
"16479","ENSG00000188761","1",113876816,113887581,10765
"16480","ENSG00000188763","7",73433783,73436120,2337
"16481","ENSG00000188765","2",3617548,3617757,209
"16482","ENSG00000188766","19",38388421,38399587,11166
"16483","ENSG00000188770","1",203494143,203508864,14721
"16484","ENSG00000188771","11",112248479,112260860,12381
"16485","ENSG00000188778","8",37962990,37966599,3609
"16486","ENSG00000188779","15",67819704,67834555,14851
"16487","ENSG00000188782","1",26190561,26202968,12407
"16488","ENSG00000188783","1",203475806,203491352,15546
"16489","ENSG00000188784","1",19920009,19923617,3608
"16490","ENSG00000188785","19",57389850,57402992,13142
"16491","ENSG00000188786","1",37809574,37859592,50018
"16492","ENSG00000188800","1",40245947,40251684,5737
"16493","ENSG00000188803","17",11241263,11564063,322800
"16494","ENSG00000188807","1",9588911,9614877,25966
"16495","ENSG00000188811","13",39038306,39050109,11803
"16496","ENSG00000188816","10",123148122,123150672,2550
"16497","ENSG00000188817","3",63652668,63679020,26352
"16498","ENSG00000188818","5",795606,850986,55380
"16499","ENSG00000188820","6",116461370,116463771,2401
"16500","ENSG00000188822","1",23870515,23913362,42847
"16501","ENSG00000188825","17",43338741,43389199,50458
"16502","ENSG00000188827","16",3581181,3611606,30425
"16503","ENSG00000188828","X",103707224,103728655,21431
"16504","ENSG00000188831","14",36371165,36372383,1218
"16505","ENSG00000188833","9",137434364,137441816,7452
"16506","ENSG00000188846","3",40457292,40468587,11295
"16507","ENSG00000188848","4",42110853,42152878,42025
"16508","ENSG00000188850","5",43336164,43348716,12552
"16509","ENSG00000188856","8",80558870,80559757,887
"16510","ENSG00000188859","1",166057426,166166969,109543
"16511","ENSG00000188868","19",12317477,12333720,16243
"16512","ENSG00000188869","15",81331088,81374213,43125
"16513","ENSG00000188873","8",47157118,47157771,653
"16514","ENSG00000188877","8",43292483,43363518,71035
"16515","ENSG00000188878","17",75909574,75941140,31566
"16516","ENSG00000188883","7",139452690,139483712,31022
"16517","ENSG00000188886","2",96123850,96138436,14586
"16518","ENSG00000188895","17",40122298,40136916,14618
"16519","ENSG00000188897","16",11359845,11527245,167400
"16520","ENSG00000188906","12",40196744,40369285,172541
"16521","ENSG00000188909","11",122977570,122981720,4150
"16522","ENSG00000188910","1",34781214,34786369,5155
"16523","ENSG00000188916","10",127135426,127196591,61165
"16524","ENSG00000188917","X",101009346,101052116,42770
"16525","ENSG00000188921","9",20999509,21031640,32131
"16526","ENSG00000188933","17",16786489,16804455,17966
"16527","ENSG00000188937","X",41447434,41475710,28276
"16528","ENSG00000188938","9",93431441,93453581,22140
"16529","ENSG00000188958","3",191267168,191330536,63368
"16530","ENSG00000188959","9",110190048,110208189,18141
"16531","ENSG00000188976","1",944203,959309,15106
"16532","ENSG00000188981","4",3244369,3271738,27369
"16533","ENSG00000188984","1",12716110,12728760,12650
"16534","ENSG00000188985","18",26170726,26171284,558
"16535","ENSG00000188986","9",137255327,137273542,18215
"16536","ENSG00000188991","12",16188485,16277685,89200
"16537","ENSG00000188992","21",14108813,14210891,102078
"16538","ENSG00000188993","4",51993702,52017620,23918
"16539","ENSG00000188994","6",87152833,87265943,113110
"16540","ENSG00000188996","6",655939,656963,1024
"16541","ENSG00000188997","11",78171249,78188626,17377
"16542","ENSG00000189001","19",35523367,35528351,4984
"16543","ENSG00000189002","3",90202316,90257415,55099
"16544","ENSG00000189007","6",143422832,143450695,27863
"16545","ENSG00000189013","19",54803535,54814517,10982
"16546","ENSG00000189014","10",47689707,47730436,40729
"16547","ENSG00000189023","X",35798342,35803735,5393
"16548","ENSG00000189030","1",156298624,156299299,675
"16549","ENSG00000189037","X",44844004,44844888,884
"16550","ENSG00000189042","19",36687612,36727701,40089
"16551","ENSG00000189043","7",10931943,10940153,8210
"16552","ENSG00000189045","5",75611459,75671846,60387
"16553","ENSG00000189046","12",109088188,109093631,5443
"16554","ENSG00000189050","17",59952240,59964761,12521
"16555","ENSG00000189051","17",8390704,8397826,7122
"16556","ENSG00000189056","7",103471784,103989658,517874
"16557","ENSG00000189057","11",59107185,59127412,20227
"16558","ENSG00000189058","3",195568705,195584033,15328
"16559","ENSG00000189060","22",37805093,37807436,2343
"16560","ENSG00000189064","X",49589529,49596827,7298
"16561","ENSG00000189067","16",11547722,11636381,88659
"16562","ENSG00000189068","19",54040825,54063953,23128
"16563","ENSG00000189077","7",75986831,75994656,7825
"16564","ENSG00000189079","12",45729706,45908040,178334
"16565","ENSG00000189089","21",36050214,36051377,1163
"16566","ENSG00000189090","10",47487219,47491693,4474
"16567","ENSG00000189091","16",70523791,70577670,53879
"16568","ENSG00000189099","4",151277171,151291453,14282
"16569","ENSG00000189108","X",104566315,105767829,1201514
"16570","ENSG00000189114","19",45178745,45216933,38188
"16571","ENSG00000189120","17",47844908,47855874,10966
"16572","ENSG00000189127","5",80556755,80570280,13525
"16573","ENSG00000189129","10",80131682,80145359,13677
"16574","ENSG00000189132","X",34942796,34944915,2119
"16575","ENSG00000189134","6",28259320,28260958,1638
"16576","ENSG00000189136","15",84526781,84571216,44435
"16577","ENSG00000189139","14",44504342,44507279,2937
"16578","ENSG00000189143","7",73799542,73832693,33151
"16579","ENSG00000189144","19",37735833,37817300,81467
"16580","ENSG00000189149","16",21300849,21339037,38188
"16581","ENSG00000189152","17",19127469,19159176,31707
"16582","ENSG00000189157","4",76214040,76283783,69743
"16583","ENSG00000189159","17",75135248,75168281,33033
"16584","ENSG00000189164","19",37371061,37393066,22005
"16585","ENSG00000189166","7",56991888,57009149,17261
"16586","ENSG00000189167","13",32303700,32315344,11644
"16587","ENSG00000189171","1",153618787,153631360,12573
"16588","ENSG00000189180","10",38010650,38065088,54438
"16589","ENSG00000189181","1",248681322,248682328,1006
"16590","ENSG00000189182","12",52689626,52703463,13837
"16591","ENSG00000189184","4",137518918,137532494,13576
"16592","ENSG00000189186","X",27590382,27748821,158439
"16593","ENSG00000189190","19",52749942,52786807,36865
"16594","ENSG00000189195","1",92080305,92184725,104420
"16595","ENSG00000189196","3",64078361,64087363,9002
"16596","ENSG00000189212","7",35079989,35186041,106052
"16597","ENSG00000189221","X",43654907,43746824,91917
"16598","ENSG00000189223","2",113211421,113276581,65160
"16599","ENSG00000189227","15",67521131,67530146,9015
"16600","ENSG00000189229","3",6490460,6736750,246290
"16601","ENSG00000189233","8",28021964,28083936,61972
"16602","ENSG00000189238","12",126723412,126749027,25615
"16603","ENSG00000189241","6",116267760,116279903,12143
"16604","ENSG00000189252","X",143508735,143517475,8740
"16605","ENSG00000189253","11",89869282,89876017,6735
"16606","ENSG00000189266","1",23956839,23963462,6623
"16607","ENSG00000189269","22",23608452,23632321,23869
"16608","ENSG00000189275","10",131772398,131790199,17801
"16609","ENSG00000189280","1",34755047,34758512,3465
"16610","ENSG00000189283","3",59747277,61251459,1504182
"16611","ENSG00000189292","2",279558,288851,9293
"16612","ENSG00000189295","22",16654066,16675540,21474
"16613","ENSG00000189298","6",28349947,28369172,19225
"16614","ENSG00000189299","X",55623400,55625325,1925
"16615","ENSG00000189306","22",42508344,42519796,11452
"16616","ENSG00000189308","4",82909973,83012926,102953
"16617","ENSG00000189316","7",64888527,64890100,1573
"16618","ENSG00000189319","10",124619292,124744378,125086
"16619","ENSG00000189320","7",135728348,135748813,20465
"16620","ENSG00000189325","6",36315761,36336888,21127
"16621","ENSG00000189326","X",143025918,143034702,8784
"16622","ENSG00000189332","11",18209138,18214562,5424
"16623","ENSG00000189334","1",153614255,153616986,2731
"16624","ENSG00000189337","1",13892792,15118043,1225251
"16625","ENSG00000189339","1",1659529,1692728,33199
"16626","ENSG00000189343","17",19445970,19446852,882
"16627","ENSG00000189348","19",53281559,53284944,3385
"16628","ENSG00000189350","2",28956611,29061373,104762
"16629","ENSG00000189357","9",81928514,81934948,6434
"16630","ENSG00000189362","2",190504338,190534722,30384
"16631","ENSG00000189366","3",125929275,125937039,7764
"16632","ENSG00000189367","6",127438406,127459389,20983
"16633","ENSG00000189369","X",51743431,51746232,2801
"16634","ENSG00000189372","X",108383398,108383993,595
"16635","ENSG00000189375","17",18635006,18644427,9421
"16636","ENSG00000189376","8",123219967,123241377,21410
"16637","ENSG00000189377","19",42428288,42443048,14760
"16638","ENSG00000189398","11",3390780,3391752,972
"16639","ENSG00000189401","X",70062491,70064179,1688
"16640","ENSG00000189403","13",30456704,30617597,160893
"16641","ENSG00000189409","1",1632095,1635263,3168
"16642","ENSG00000189410","1",20719731,20732837,13106
"16643","ENSG00000189419","15",100344047,100350725,6678
"16644","ENSG00000189420","X",153418322,153426481,8159
"16645","ENSG00000189423","17",20408311,20434286,25975
"16646","ENSG00000189430","19",54906150,54916140,9990
"16647","ENSG00000189431","11",13009577,13012106,2529
"16648","ENSG00000189433","1",34759740,34762327,2587
"16649","ENSG00000194297","1",119331397,119331525,128
"16650","ENSG00000195401","10",68735720,68735823,103
"16651","ENSG00000196071","1",248095184,248101103,5919
"16652","ENSG00000196072","10",100273280,100286680,13400
"16653","ENSG00000196074","20",59863564,59933655,70091
"16654","ENSG00000196081","19",23221599,23250390,28791
"16655","ENSG00000196083","3",190514051,190659750,145699
"16656","ENSG00000196090","20",42072752,43189970,1117218
"16657","ENSG00000196091","12",101568353,101686018,117665
"16658","ENSG00000196092","9",36833269,37034268,200999
"16659","ENSG00000196096","2",213276552,213284205,7653
"16660","ENSG00000196099","11",123805335,123806387,1052
"16661","ENSG00000196104","4",166733384,167234796,501412
"16662","ENSG00000196109","19",22179091,22215801,36710
"16663","ENSG00000196110","19",9294275,9309838,15563
"16664","ENSG00000196114","6",34576258,34576656,398
"16665","ENSG00000196115","8",39314591,39417378,102787
"16666","ENSG00000196116","9",97412096,97496125,84029
"16667","ENSG00000196118","16",30757423,30762221,4798
"16668","ENSG00000196119","11",124566660,124582942,16282
"16669","ENSG00000196123","16",67175599,67184040,8441
"16670","ENSG00000196126","6",32578769,32589848,11079
"16671","ENSG00000196131","19",53258292,53261837,3545
"16672","ENSG00000196132","20",64102394,64242253,139859
"16673","ENSG00000196136","14",94612377,94624055,11678
"16674","ENSG00000196139","10",5035354,5107686,72332
"16675","ENSG00000196141","2",200305881,200482264,176383
"16676","ENSG00000196150","8",144876497,144902168,25671
"16677","ENSG00000196151","2",159235793,159286799,51006
"16678","ENSG00000196152","9",127424374,127445372,20998
"16679","ENSG00000196154","1",153543613,153550136,6523
"16680","ENSG00000196155","16",67277510,67289499,11989
"16681","ENSG00000196159","4",125316399,125492932,176533
"16682","ENSG00000196166","8",38510834,38560939,50105
"16683","ENSG00000196167","11",111290787,111305498,14711
"16684","ENSG00000196169","17",74326210,74355820,29610
"16685","ENSG00000196172","19",23739195,23758891,19696
"16686","ENSG00000196177","10",123008979,123058311,49332
"16687","ENSG00000196182","1",36339624,36385896,46272
"16688","ENSG00000196183","14",104835997,104836852,855
"16689","ENSG00000196184","1",159437845,159443078,5233
"16690","ENSG00000196187","1",225845536,225882380,36844
"16691","ENSG00000196188","1",206009264,206023895,14631
"16692","ENSG00000196189","1",156147366,156177752,30386
"16693","ENSG00000196196","9",35906202,35907136,934
"16694","ENSG00000196199","13",19633659,19673441,39782
"16695","ENSG00000196204","7",4973988,5040675,66687
"16696","ENSG00000196205","9",133019486,133020874,1388
"16697","ENSG00000196208","2",11482341,11642788,160447
"16698","ENSG00000196209","20",1470741,1491587,20846
"16699","ENSG00000196214","19",52269587,52296046,26459
"16700","ENSG00000196218","19",38433699,38587564,153865
"16701","ENSG00000196220","3",8980591,9363053,382462
"16702","ENSG00000196224","11",1607565,1608463,898
"16703","ENSG00000196227","20",59933764,59948680,14916
"16704","ENSG00000196228","2",108247195,108265351,18156
"16705","ENSG00000196230","6",30720352,30725426,5074
"16706","ENSG00000196233","10",96832282,96995959,163677
"16707","ENSG00000196235","19",39436156,39476670,40514
"16708","ENSG00000196236","22",40857077,40932815,75738
"16709","ENSG00000196242","1",247524677,247536440,11763
"16710","ENSG00000196243","12",90918023,90948669,30646
"16711","ENSG00000196247","7",64666083,64711582,45499
"16712","ENSG00000196248","11",123976661,123977781,1120
"16713","ENSG00000196260","6",30931353,30955636,24283
"16714","ENSG00000196262","7",44796680,44824564,27884
"16715","ENSG00000196263","19",56507850,56530221,22371
"16716","ENSG00000196267","19",52153864,52171643,17779
"16717","ENSG00000196268","19",21397119,21427573,30454
"16718","ENSG00000196273","14",100657250,100676069,18819
"16719","ENSG00000196274","15",76230048,76230390,342
"16720","ENSG00000196275","7",74796144,74851551,55407
"16721","ENSG00000196277","3",6770001,7741533,971532
"16722","ENSG00000196284","6",44809317,45377953,568636
"16723","ENSG00000196289","1",241957767,241959062,1295
"16724","ENSG00000196290","2",200889327,200903938,14611
"16725","ENSG00000196295","7",30516309,30595286,78977
"16726","ENSG00000196296","16",28878405,28904509,26104
"16727","ENSG00000196301","6",32459821,32473500,13679
"16728","ENSG00000196302","5",70516387,70555266,38879
"16729","ENSG00000196305","9",92210207,92293756,83549
"16730","ENSG00000196312","9",96887373,97013708,126335
"16731","ENSG00000196313","7",72879365,72951440,72075
"16732","ENSG00000196323","11",130226677,130314917,88240
"16733","ENSG00000196329","7",150722253,150750033,27780
"16734","ENSG00000196335","7",23710203,23832513,122310
"16735","ENSG00000196337","19",49054275,49058860,4585
"16736","ENSG00000196338","X",71144831,71171201,26370
"16737","ENSG00000196341","11",124302831,124315099,12268
"16738","ENSG00000196344","4",99412261,99435737,23476
"16739","ENSG00000196345","3",44555193,44594173,38980
"16740","ENSG00000196350","19",22286408,22317176,30768
"16741","ENSG00000196352","1",207321376,207386804,65428
"16742","ENSG00000196353","3",131533555,132285410,751855
"16743","ENSG00000196357","19",36182060,36246257,64197
"16744","ENSG00000196358","9",132161676,132244526,82850
"16745","ENSG00000196361","19",11451326,11481046,29720
"16746","ENSG00000196363","9",134135365,134159968,24603
"16747","ENSG00000196365","19",5691834,5720572,28738
"16748","ENSG00000196366","9",136483495,136486067,2572
"16749","ENSG00000196367","7",98877933,99050831,172898
"16750","ENSG00000196368","X",51490011,51496592,6581
"16751","ENSG00000196369","1",144887265,145095528,208263
"16752","ENSG00000196371","11",94543840,94549898,6058
"16753","ENSG00000196372","10",5638867,5666595,27728
"16754","ENSG00000196376","6",117907264,118317676,410412
"16755","ENSG00000196378","8",144773114,144787345,14231
"16756","ENSG00000196381","19",37667751,37692315,24564
"16757","ENSG00000196387","12",133079838,133107544,27706
"16758","ENSG00000196388","17",4988130,4997610,9480
"16759","ENSG00000196390","5",74929880,74930566,686
"16760","ENSG00000196391","15",90352245,90369146,16901
"16761","ENSG00000196396","20",50510321,50585241,74920
"16762","ENSG00000196403","11",124158421,124159356,935
"16763","ENSG00000196405","14",99971449,100144236,172787
"16764","ENSG00000196406","X",141697411,141698739,1328
"16765","ENSG00000196407","1",151847101,151853712,6611
"16766","ENSG00000196411","7",100802565,100827523,24958
"16767","ENSG00000196415","19",840999,848175,7176
"16768","ENSG00000196417","19",53389793,53430413,40620
"16769","ENSG00000196418","1",247121975,247172016,50041
"16770","ENSG00000196419","22",41621119,41664048,42929
"16771","ENSG00000196420","1",153537147,153541765,4618
"16772","ENSG00000196421","20",64034344,64039962,5618
"16773","ENSG00000196422","9",135479079,135488893,9814
"16774","ENSG00000196427","1",108223341,108244081,20740
"16775","ENSG00000196428","3",150408335,150466431,58096
"16776","ENSG00000196431","22",26621963,26630669,8706
"16777","ENSG00000196433","X",1615059,1643081,28022
"16778","ENSG00000196436","16",74377878,74392080,14202
"16779","ENSG00000196437","19",37411155,37469275,58120
"16780","ENSG00000196440","X",101418287,101533459,115172
"16781","ENSG00000196449","1",37802945,37808208,5263
"16782","ENSG00000196453","7",149431363,149461062,29699
"16783","ENSG00000196455","3",130678934,130746829,67895
"16784","ENSG00000196456","7",150368790,150398630,29840
"16785","ENSG00000196458","12",132918306,132956306,38000
"16786","ENSG00000196459","X",13712244,13734635,22391
"16787","ENSG00000196460","2",101397359,101475112,77753
"16788","ENSG00000196465","12",56152256,56159647,7391
"16789","ENSG00000196466","19",12390016,12401271,11255
"16790","ENSG00000196468","X",77447405,77457278,9873
"16791","ENSG00000196470","16",48356364,48448402,92038
"16792","ENSG00000196475","4",79406352,79408293,1941
"16793","ENSG00000196476","20",270863,290778,19915
"16794","ENSG00000196482","1",216503246,217137755,634509
"16795","ENSG00000196497","14",24180219,24188869,8650
"16796","ENSG00000196498","12",124324415,124567589,243174
"16797","ENSG00000196502","16",28605196,28623625,18429
"16798","ENSG00000196503","4",56505209,56525481,20272
"16799","ENSG00000196504","2",152651593,152717997,66404
"16800","ENSG00000196505","1",117863485,117929621,66136
"16801","ENSG00000196507","X",103607451,103629690,22239
"16802","ENSG00000196510","12",110372900,110403730,30830
"16803","ENSG00000196511","7",144451941,144836395,384454
"16804","ENSG00000196517","1",43991500,44031467,39967
"16805","ENSG00000196526","4",7758714,7939926,181212
"16806","ENSG00000196531","12",56712428,56731628,19200
"16807","ENSG00000196535","17",29071124,29180412,109288
"16808","ENSG00000196542","3",161344792,161372880,28088
"16809","ENSG00000196544","17",8188333,8190907,2574
"16810","ENSG00000196547","15",90902218,90922584,20366
"16811","ENSG00000196549","3",155024124,155183729,159605
"16812","ENSG00000196550","1",206186179,206204414,18235
"16813","ENSG00000196553","14",66411704,66498677,86973
"16814","ENSG00000196557","16",1153106,1221771,68665
"16815","ENSG00000196562","20",47656348,47786616,130268
"16816","ENSG00000196564","X",18838709,18839452,743
"16817","ENSG00000196565","11",5253188,5505605,252417
"16818","ENSG00000196566","10",87610163,87660003,49840
"16819","ENSG00000196569","6",128883141,129516569,633428
"16820","ENSG00000196570","5",177400109,177400661,552
"16821","ENSG00000196576","22",50274979,50307646,32667
"16822","ENSG00000196581","1",4654732,4792534,137802
"16823","ENSG00000196584","7",152644776,152676141,31365
"16824","ENSG00000196586","6",75749192,75919537,170345
"16825","ENSG00000196588","22",40410281,40636719,226438
"16826","ENSG00000196589","19",7018969,7021450,2481
"16827","ENSG00000196591","6",113933028,114011308,78280
"16828","ENSG00000196593","13",23939557,23946782,7225
"16829","ENSG00000196597","9",96816472,96875623,59151
"16830","ENSG00000196600","11",63163776,63229652,65876
"16831","ENSG00000196604","2",130074030,130129222,55192
"16832","ENSG00000196605","19",9751993,9793180,41187
"16833","ENSG00000196611","11",102789919,102798160,8241
"16834","ENSG00000196616","4",99304971,99352760,47789
"16835","ENSG00000196620","4",68646597,68670652,24055
"16836","ENSG00000196628","18",55222331,55664787,442456
"16837","ENSG00000196632","X",54192823,54358642,165819
"16838","ENSG00000196634","6",147158925,147180992,22067
"16839","ENSG00000196636","7",97116590,97181763,65173
"16840","ENSG00000196639","3",11137093,11263557,126464
"16841","ENSG00000196642","9",136807943,136841187,33244
"16842","ENSG00000196646","19",12163064,12189871,26807
"16843","ENSG00000196652","7",99504651,99534700,30049
"16844","ENSG00000196653","3",44712643,44723831,11188
"16845","ENSG00000196655","11",119018432,119025454,7022
"16846","ENSG00000196656","4",113214046,113217170,3124
"16847","ENSG00000196659","2",177548998,177553014,4016
"16848","ENSG00000196660","1",219685427,219958647,273220
"16849","ENSG00000196663","14",102362941,102502477,139536
"16850","ENSG00000196664","X",12867072,12890361,23289
"16851","ENSG00000196666","11",47586693,47589194,2501
"16852","ENSG00000196668","12",116533422,116536518,3096
"16853","ENSG00000196670","5",180847611,180861285,13674
"16854","ENSG00000196678","16",20780193,20900349,120156
"16855","ENSG00000196683","7",22812628,22822852,10224
"16856","ENSG00000196684","19",16134028,16158575,24547
"16857","ENSG00000196689","17",3565444,3609411,43967
"16858","ENSG00000196693","10",42574185,42638570,64385
"16859","ENSG00000196696","16",69976297,70065948,89651
"16860","ENSG00000196700","20",63956704,63969930,13226
"16861","ENSG00000196704","17",68247930,68257164,9234
"16862","ENSG00000196705","19",21142024,21196053,54029
"16863","ENSG00000196711","8",52534037,52565430,31393
"16864","ENSG00000196712","17",31094927,31382116,287189
"16865","ENSG00000196715","7",65873074,65959563,86489
"16866","ENSG00000196724","19",57921884,57935393,13509
"16867","ENSG00000196730","9",87497228,87708634,211406
"16868","ENSG00000196734","1",152811971,152813109,1138
"16869","ENSG00000196735","6",32628179,32647062,18883
"16870","ENSG00000196739","9",114155537,114312511,156974
"16871","ENSG00000196741","X",47483571,47484823,1252
"16872","ENSG00000196743","5",151212150,151270440,58290
"16873","ENSG00000196747","6",27808199,27808701,502
"16874","ENSG00000196748","6",35776594,35779552,2958
"16875","ENSG00000196754","1",153561108,153567890,6782
"16876","ENSG00000196756","20",38419638,38435409,15771
"16877","ENSG00000196757","19",11925068,11950773,25705
"16878","ENSG00000196758","2",239578301,239586094,7793
"16879","ENSG00000196767","X",83508290,83512127,3837
"16880","ENSG00000196772","1",247814660,247824119,9459
"16881","ENSG00000196776","3",108043091,108091862,48771
"16882","ENSG00000196781","9",81583683,81689547,105864
"16883","ENSG00000196782","4",139716753,140154184,437431
"16884","ENSG00000196787","6",27133042,27135291,2249
"16885","ENSG00000196792","14",30893799,31026401,132602
"16886","ENSG00000196793","10",43556344,43574618,18274
"16887","ENSG00000196796","16",29038655,29052726,14071
"16888","ENSG00000196805","1",153070224,153070840,616
"16889","ENSG00000196810","4",1249300,1288291,38991
"16890","ENSG00000196811","2",232539692,232548115,8423
"16891","ENSG00000196812","6",28124609,28130082,5473
"16892","ENSG00000196814","9",126326829,126507041,180212
"16893","ENSG00000196821","6",34587288,34696859,109571
"16894","ENSG00000196834","2",130459455,130509707,50252
"16895","ENSG00000196839","20",44619522,44652233,32711
"16896","ENSG00000196843","2",96536743,96552634,15891
"16897","ENSG00000196844","11",125776113,125778819,2706
"16898","ENSG00000196850","12",110533245,110583318,50073
"16899","ENSG00000196859","17",40958417,40966892,8475
"16900","ENSG00000196860","14",58395928,58408702,12774
"16901","ENSG00000196862","2",107826937,107890841,63904
"16902","ENSG00000196865","10",113854661,113917194,62533
"16903","ENSG00000196866","6",26198851,26199243,392
"16904","ENSG00000196867","19",56538948,56556810,17862
"16905","ENSG00000196872","2",98793846,98936259,142413
"16906","ENSG00000196873","9",68232003,68300015,68012
"16907","ENSG00000196876","12",51590266,51812864,222598
"16908","ENSG00000196878","1",209614870,209652425,37555
"16909","ENSG00000196890","1",228458107,228460470,2363
"16910","ENSG00000196893","17",18951625,18954149,2524
"16911","ENSG00000196900","5",126631705,126636284,4579
"16912","ENSG00000196911","6",116681187,116741866,60679
"16913","ENSG00000196912","2",97492663,97589965,97302
"16914","ENSG00000196914","11",120336413,120489937,153524
"16915","ENSG00000196917","12",122726076,122730843,4767
"16916","ENSG00000196922","8",144973589,145002895,29306
"16917","ENSG00000196923","5",177483394,177497606,14212
"16918","ENSG00000196924","X",154348524,154374638,26114
"16919","ENSG00000196932","10",61406643,61453450,46807
"16920","ENSG00000196933","X",72044545,72044892,347
"16921","ENSG00000196935","12",63844700,64162217,317517
"16922","ENSG00000196937","7",121348878,121396364,47486
"16923","ENSG00000196943","14",24299850,24309124,9274
"16924","ENSG00000196944","1",248361581,248362627,1046
"16925","ENSG00000196946","12",8157034,8188537,31503
"16926","ENSG00000196950","2",195575977,195737702,161725
"16927","ENSG00000196951","4",140283724,140373403,89679
"16928","ENSG00000196954","11",104942866,104969366,26500
"16929","ENSG00000196961","19",49766968,49807113,40145
"16930","ENSG00000196967","19",37106734,37172741,66007
"16931","ENSG00000196968","10",73772276,73780251,7975
"16932","ENSG00000196970","X",102549965,102571695,21730
"16933","ENSG00000196972","X",135094985,135098712,3727
"16934","ENSG00000196975","2",69644425,69827112,182687
"16935","ENSG00000196976","X",154477769,154479257,1488
"16936","ENSG00000196979","9",130140610,130144219,3609
"16937","ENSG00000196981","3",122412332,122416051,3719
"16938","ENSG00000196990","9",133578415,133586197,7782
"16939","ENSG00000196993","16",28751787,28772807,21020
"16940","ENSG00000196998","X",49074433,49101170,26737
"16941","ENSG00000197006","16",21597218,21657473,60255
"16942","ENSG00000197008","7",64794388,64833681,39293
"16943","ENSG00000197013","19",21496682,21556270,59588
"16944","ENSG00000197016","19",56567468,56588911,21443
"16945","ENSG00000197019","19",40421589,40425992,4403
"16946","ENSG00000197020","19",21722771,21767579,44808
"16947","ENSG00000197021","X",149929527,149938700,9173
"16948","ENSG00000197023","11",4889593,4890596,1003
"16949","ENSG00000197024","7",149126416,149182802,56386
"16950","ENSG00000197037","7",99616946,99632408,15462
"16951","ENSG00000197038","Y",9311130,9322869,11739
"16952","ENSG00000197043","5",151100706,151157785,57079
"16953","ENSG00000197044","19",11767000,11784078,17078
"16954","ENSG00000197045","14",54474484,54489026,14542
"16955","ENSG00000197046","18",45825512,45844080,18568
"16956","ENSG00000197050","19",37007857,37130368,122511
"16957","ENSG00000197054","19",11965037,11980381,15344
"16958","ENSG00000197056","1",35032172,35115859,83687
"16959","ENSG00000197057","4",36281622,36345756,64134
"16960","ENSG00000197061","6",26103876,26104310,434
"16961","ENSG00000197062","6",28267010,28278224,11214
"16962","ENSG00000197063","17",81918270,81927735,9465
"16963","ENSG00000197067","1",248083522,248087522,4000
"16964","ENSG00000197070","9",137605685,137615360,9675
"16965","ENSG00000197077","22",24952730,25197448,244718
"16966","ENSG00000197079","17",41476689,41481140,4451
"16967","ENSG00000197081","6",159969099,160113507,144408
"16968","ENSG00000197083","5",150930645,150946289,15644
"16969","ENSG00000197084","1",152804835,152806628,1793
"16970","ENSG00000197085","7",34346512,34871582,525070
"16971","ENSG00000197093","7",100159244,100168617,9373
"16972","ENSG00000197099","3",186579476,186772986,193510
"16973","ENSG00000197102","14",101964573,102056443,91870
"16974","ENSG00000197106","1",110150494,110202202,51708
"16975","ENSG00000197110","19",39243553,39245129,1576
"16976","ENSG00000197111","12",53452102,53481162,29060
"16977","ENSG00000197114","20",63707465,63736142,28677
"16978","ENSG00000197119","14",100291116,100306547,15431
"16979","ENSG00000197121","2",196833004,196927796,94792
"16980","ENSG00000197122","20",37344685,37406050,61365
"16981","ENSG00000197123","7",64228474,64266931,38457
"16982","ENSG00000197124","19",19997058,20039505,42447
"16983","ENSG00000197125","11",124437445,124445696,8251
"16984","ENSG00000197128","19",57466663,57477570,10907
"16985","ENSG00000197134","19",22052430,22091480,39050
"16986","ENSG00000197136","11",65615773,65637439,21666
"16987","ENSG00000197140","8",39106990,39284917,177927
"16988","ENSG00000197142","10",112374018,112428380,54362
"16989","ENSG00000197147","1",89524836,89597864,73028
"16990","ENSG00000197149","11",17228279,17229151,872
"16991","ENSG00000197150","7",151028422,151047782,19360
"16992","ENSG00000197153","6",27890382,27893106,2724
"16993","ENSG00000197157","7",127652194,128092609,440415
"16994","ENSG00000197162","16",30573740,30585771,12031
"16995","ENSG00000197165","16",28591943,28597050,5107
"16996","ENSG00000197168","13",52033611,52129092,95481
"16997","ENSG00000197170","17",67337916,67366605,28689
"16998","ENSG00000197171","6",29223973,29292963,68990
"16999","ENSG00000197172","X",152766136,152769747,3611
"17000","ENSG00000197176","14",97632647,97686658,54011
"17001","ENSG00000197177","10",133070929,133131675,60746
"17002","ENSG00000197180","X",154424380,154428479,4099
"17003","ENSG00000197181","8",22275316,22357568,82252
"17004","ENSG00000197182","22",46053869,46113928,60059
"17005","ENSG00000197183","20",32443059,32585074,142015
"17006","ENSG00000197185","X",52606535,52611758,5223
"17007","ENSG00000197191","9",137224635,137226320,1685
"17008","ENSG00000197208","5",132294394,132344190,49796
"17009","ENSG00000197210","22",21114607,21124451,9844
"17010","ENSG00000197213","19",56189570,56197920,8350
"17011","ENSG00000197214","9",97067749,97068628,879
"17012","ENSG00000197217","8",23385783,23457695,71912
"17013","ENSG00000197223","2",68041130,68110948,69818
"17014","ENSG00000197226","5",179862066,179907859,45793
"17015","ENSG00000197233","9",122510802,122511743,941
"17016","ENSG00000197238","6",27824108,27824480,372
"17017","ENSG00000197241","1",9003300,9026345,23045
"17018","ENSG00000197245","1",26159079,26163962,4883
"17019","ENSG00000197249","14",94376747,94390693,13946
"17020","ENSG00000197251","6",33586106,33593338,7232
"17021","ENSG00000197253","16",1227272,1230184,2912
"17022","ENSG00000197254","11",58685086,58691861,6775
"17023","ENSG00000197256","19",11164267,11197791,33524
"17024","ENSG00000197258","7",104667749,104669576,1827
"17025","ENSG00000197261","6",49550646,49561907,11261
"17026","ENSG00000197265","8",30578318,30658236,79918
"17027","ENSG00000197272","16",28499362,28512051,12689
"17028","ENSG00000197273","1",42162690,42164745,2055
"17029","ENSG00000197275","8",94371960,94475115,103155
"17030","ENSG00000197279","6",28080568,28089563,8995
"17031","ENSG00000197283","6",33419661,33457541,37880
"17032","ENSG00000197291","17",42753914,42761257,7343
"17033","ENSG00000197296","20",44302840,44311202,8362
"17034","ENSG00000197299","15",90717346,90816166,98820
"17035","ENSG00000197301","12",65851340,65882167,30827
"17036","ENSG00000197302","16",31713229,31794869,81640
"17037","ENSG00000197308","10",8050450,8053484,3034
"17038","ENSG00000197309","11",124183345,124188780,5435
"17039","ENSG00000197312","1",15617458,15669044,51586
"17040","ENSG00000197320","7",9726241,9728272,2031
"17041","ENSG00000197321","10",29457338,29736781,279443
"17042","ENSG00000197322","17",34574123,34579369,5246
"17043","ENSG00000197323","1",114392790,114511203,118413
"17044","ENSG00000197324","14",22871740,22881713,9973
"17045","ENSG00000197329","2",64092652,64144420,51768
"17046","ENSG00000197332","19",11639754,11686569,46815
"17047","ENSG00000197334","8",9091240,9091508,268
"17048","ENSG00000197343","7",99558406,99576453,18047
"17049","ENSG00000197345","11",68891276,68903835,12559
"17050","ENSG00000197353","8",142750150,142752534,2384
"17051","ENSG00000197355","9",137077517,137084539,7022
"17052","ENSG00000197358","14",28264390,28265974,1584
"17053","ENSG00000197360","19",22391019,22532485,141466
"17054","ENSG00000197361","15",63597353,63602428,5075
"17055","ENSG00000197362","7",149069643,149090782,21139
"17056","ENSG00000197363","8",144798876,144811169,12293
"17057","ENSG00000197372","19",23525631,23687220,161589
"17058","ENSG00000197375","5",132369752,132395614,25862
"17059","ENSG00000197376","12",48507354,48529897,22543
"17060","ENSG00000197380","19",46647551,46661182,13631
"17061","ENSG00000197381","21",45073853,45226560,152707
"17062","ENSG00000197385","3",31981771,31991628,9857
"17063","ENSG00000197386","4",3041422,3243960,202538
"17064","ENSG00000197405","19",47290023,47322066,32043
"17065","ENSG00000197406","14",101561351,101563452,2101
"17066","ENSG00000197408","19",40991282,41018398,27116
"17067","ENSG00000197409","6",26196840,26197250,410
"17068","ENSG00000197410","4",154231742,154495570,263828
"17069","ENSG00000197415","3",157259742,157533619,273877
"17070","ENSG00000197416","8",81524981,81531378,6397
"17071","ENSG00000197417","17",3608262,3636322,28060
"17072","ENSG00000197421","22",18773665,18843399,69734
"17073","ENSG00000197429","1",45694324,45750650,56326
"17074","ENSG00000197430","10",96343221,96359365,16144
"17075","ENSG00000197437","1",247670812,247679739,8927
"17076","ENSG00000197442","6",136557046,136792477,235431
"17077","ENSG00000197444","10",49734641,49762379,27738
"17078","ENSG00000197446","19",41114432,41128381,13949
"17079","ENSG00000197448","7",143244093,143270854,26761
"17080","ENSG00000197451","5",178204533,178211163,6630
"17081","ENSG00000197457","20",63639705,63657682,17977
"17082","ENSG00000197461","7",497258,520296,23038
"17083","ENSG00000197462","7",125917871,125933832,15961
"17084","ENSG00000197465","4",143870864,143905563,34699
"17085","ENSG00000197467","10",69801867,69964275,162408
"17086","ENSG00000197471","16",29662979,29670876,7897
"17087","ENSG00000197472","1",246945547,247008093,62546
"17088","ENSG00000197475","8",39451045,39522852,71807
"17089","ENSG00000197479","5",141199582,141203779,4197
"17090","ENSG00000197483","19",55476617,55484487,7870
"17091","ENSG00000197487","19",56176020,56185775,9755
"17092","ENSG00000197496","20",46709649,46736347,26698
"17093","ENSG00000197497","19",53159213,53193386,34173
"17094","ENSG00000197498","6",110982015,111028263,46248
"17095","ENSG00000197503","12",24566964,24584168,17204
"17096","ENSG00000197506","9",84275457,84340683,65226
"17097","ENSG00000197520","1",222737207,222750805,13598
"17098","ENSG00000197530","1",1615415,1630610,15195
"17099","ENSG00000197535","15",52307283,52529050,221767
"17100","ENSG00000197536","5",132410636,132488702,78066
"17101","ENSG00000197540","19",544034,549924,5890
"17102","ENSG00000197548","3",11272309,11557665,285356
"17103","ENSG00000197549","22",21991099,22043934,52835
"17104","ENSG00000197550","9",64817870,64836341,18471
"17105","ENSG00000197555","14",71320449,71741229,420780
"17106","ENSG00000197557","2",177612999,177618742,5743
"17107","ENSG00000197558","7",149776042,149833979,57937
"17108","ENSG00000197561","19",851014,856247,5233
"17109","ENSG00000197562","16",589357,629272,39915
"17110","ENSG00000197563","18",61905255,62187118,281863
"17111","ENSG00000197565","X",108155607,108439497,283890
"17112","ENSG00000197566","17",16620734,16653856,33122
"17113","ENSG00000197568","1",70354805,70385339,30534
"17114","ENSG00000197575","5",116716243,116716650,407
"17115","ENSG00000197576","7",27128507,27130799,2292
"17116","ENSG00000197579","9",32540544,32552586,12042
"17117","ENSG00000197580","11",112175467,112224699,49232
"17118","ENSG00000197582","X",13378735,13379340,605
"17119","ENSG00000197584","3",178272932,178844429,571497
"17120","ENSG00000197585","2",214241676,214684246,442570
"17121","ENSG00000197586","20",25195693,25226729,31036
"17122","ENSG00000197587","1",46506996,46514226,7230
"17123","ENSG00000197588","19",50882096,50896398,14302
"17124","ENSG00000197591","1",247840928,247841896,968
"17125","ENSG00000197594","6",131808016,131895155,87139
"17126","ENSG00000197595","13",112647044,112684497,37453
"17127","ENSG00000197599","16",1434383,1444556,10173
"17128","ENSG00000197601","11",13668668,13732346,63678
"17129","ENSG00000197603","5",37106228,37249428,143200
"17130","ENSG00000197608","19",52064466,52095765,31299
"17131","ENSG00000197614","12",8637346,8662888,25542
"17132","ENSG00000197616","14",23381982,23408273,26291
"17133","ENSG00000197617","1",247255972,247257210,1238
"17134","ENSG00000197619","19",51991332,52008230,16898
"17135","ENSG00000197620","X",149540355,149550510,10155
"17136","ENSG00000197622","1",151050971,151070325,19354
"17137","ENSG00000197629","11",59208510,59212951,4441
"17138","ENSG00000197632","18",63871692,63903888,32196
"17139","ENSG00000197635","2",161992245,162074215,81970
"17140","ENSG00000197641","18",63586989,63604639,17650
"17141","ENSG00000197644","2",29899597,29907199,7602
"17142","ENSG00000197646","9",5510570,5571254,60684
"17143","ENSG00000197647","19",12014732,12035741,21009
"17144","ENSG00000197651","12",90905622,90955176,49554
"17145","ENSG00000197653","12",123762188,123936206,174018
"17146","ENSG00000197658","11",63079940,63144221,64281
"17147","ENSG00000197670","20",53552770,53575863,23093
"17148","ENSG00000197674","11",4690423,4697831,7408
"17149","ENSG00000197692","11",89293745,89294246,501
"17150","ENSG00000197694","9",128552558,128633662,81104
"17151","ENSG00000197696","15",84655129,84658563,3434
"17152","ENSG00000197702","11",12377563,12530801,153238
"17153","ENSG00000197705","18",32672671,32773062,100391
"17154","ENSG00000197712","4",38867677,38945739,78062
"17155","ENSG00000197713","2",210002565,210022260,19695
"17156","ENSG00000197714","19",57280051,57294069,14018
"17157","ENSG00000197721","1",207645113,207738416,93303
"17158","ENSG00000197724","9",93576584,93679587,103003
"17159","ENSG00000197728","12",56041351,56044697,3346
"17160","ENSG00000197734","14",77760830,77769742,8912
"17161","ENSG00000197744","5",118973796,118974122,326
"17162","ENSG00000197745","11",62296277,62299064,2787
"17163","ENSG00000197746","10",71816298,71851325,35027
"17164","ENSG00000197747","1",151982915,151993859,10944
"17165","ENSG00000197748","10",104129888,104232362,102474
"17166","ENSG00000197753","6",35797206,35845397,48191
"17167","ENSG00000197756","2",216498189,216579180,80991
"17168","ENSG00000197757","12",53990624,54030823,40199
"17169","ENSG00000197763","3",126571779,126655124,83345
"17170","ENSG00000197766","19",859643,863630,3987
"17171","ENSG00000197768","9",137251261,137253483,2222
"17172","ENSG00000197769","1",241995490,241999073,3583
"17173","ENSG00000197771","10",119829404,119892556,63152
"17174","ENSG00000197774","16",1773207,1781708,8501
"17175","ENSG00000197776","14",49693105,49753150,60045
"17176","ENSG00000197779","X",47836902,48002561,165659
"17177","ENSG00000197780","1",109062486,109076002,13516
"17178","ENSG00000197782","19",40069152,40090938,21786
"17179","ENSG00000197785","1",1512151,1534687,22536
"17180","ENSG00000197794","2",88915081,88915378,297
"17181","ENSG00000197798","11",126211724,126262984,51260
"17182","ENSG00000197808","19",36636618,36666853,30235
"17183","ENSG00000197813","19",49331525,49340303,8778
"17184","ENSG00000197815","17",17858227,17860041,1814
"17185","ENSG00000197816","9",97307304,97378524,71220
"17186","ENSG00000197818","20",49812713,49892242,79529
"17187","ENSG00000197822","5",69492292,69558104,65812
"17188","ENSG00000197826","4",80335720,80963756,628036
"17189","ENSG00000197837","12",14767999,14771131,3132
"17190","ENSG00000197838","19",41088472,41096195,7723
"17191","ENSG00000197841","19",34734155,34745378,11223
"17192","ENSG00000197847","11",65213840,65242757,28917
"17193","ENSG00000197849","11",124241095,124254364,13269
"17194","ENSG00000197852","1",111680630,111755824,75194
"17195","ENSG00000197857","19",12224686,12294887,70201
"17196","ENSG00000197858","8",144082590,144086216,3626
"17197","ENSG00000197859","9",133532164,133575519,43355
"17198","ENSG00000197860","5",65665928,65723035,57107
"17199","ENSG00000197863","19",36817428,36850787,33359
"17200","ENSG00000197870","12",11265924,11269805,3881
"17201","ENSG00000197872","2",16549459,16666331,116872
"17202","ENSG00000197879","17",1464186,1492686,28500
"17203","ENSG00000197880","1",23581495,23640568,59073
"17204","ENSG00000197882","11",86832540,86833449,909
"17205","ENSG00000197885","3",23891660,23946591,54931
"17206","ENSG00000197887","11",58203202,58204181,979
"17207","ENSG00000197888","4",68537184,68568527,31343
"17208","ENSG00000197889","10",14959388,14988050,28662
"17209","ENSG00000197891","11",64590641,64602353,11712
"17210","ENSG00000197892","8",29067278,29263124,195846
"17211","ENSG00000197893","10",113588716,113664127,75411
"17212","ENSG00000197894","4",99070978,99088801,17823
"17213","ENSG00000197901","11",62936385,62984983,48598
"17214","ENSG00000197903","6",27146418,27146798,380
"17215","ENSG00000197905","12",2959330,3040676,81346
"17216","ENSG00000197912","16",89490719,89557768,67049
"17217","ENSG00000197915","1",152212076,152224193,12117
"17218","ENSG00000197919","9",21440454,21441316,862
"17219","ENSG00000197921","1",2528745,2530263,1518
"17220","ENSG00000197927","2",131722417,131751669,29252
"17221","ENSG00000197928","19",53235381,53254898,19517
"17222","ENSG00000197930","14",52639915,52695900,55985
"17223","ENSG00000197933","19",11721265,11739009,17744
"17224","ENSG00000197934","21",26393635,26569252,175617
"17225","ENSG00000197935","6",28994785,29005316,10531
"17226","ENSG00000197937","19",53124072,53159075,35003
"17227","ENSG00000197938","3",98282888,98283832,944
"17228","ENSG00000197943","16",81739097,81962685,223588
"17229","ENSG00000197948","5",141639302,141651418,12116
"17230","ENSG00000197951","19",56595264,56626481,31217
"17231","ENSG00000197953","3",151733916,151761339,27423
"17232","ENSG00000197956","1",153534599,153536244,1645
"17233","ENSG00000197958","9",127447674,127451406,3732
"17234","ENSG00000197959","1",171841498,172418466,576968
"17235","ENSG00000197961","19",9560353,9584533,24180
"17236","ENSG00000197965","1",167721192,167791919,70727
"17237","ENSG00000197969","9",77177445,77421537,244092
"17238","ENSG00000197971","18",76978827,77133683,154856
"17239","ENSG00000197976","X",1591604,1602520,10916
"17240","ENSG00000197977","6",10980759,11044305,63546
"17241","ENSG00000197978","15",82430018,82439153,9135
"17242","ENSG00000197980","3",156825481,157046129,220648
"17243","ENSG00000197982","1",37806979,37809454,2475
"17244","ENSG00000197984","11",4830175,4833072,2897
"17245","ENSG00000197989","1",28578538,28583132,4594
"17246","ENSG00000197990","7",63449819,63456687,6868
"17247","ENSG00000197991","13",61409858,61427849,17991
"17248","ENSG00000197992","12",10030678,10066031,35353
"17249","ENSG00000197993","7",142941114,142962363,21249
"17250","ENSG00000198000","9",92297358,92325636,28278
"17251","ENSG00000198001","12",43758944,43789543,30599
"17252","ENSG00000198003","19",11420604,11435782,15178
"17253","ENSG00000198010","8",737596,1708474,970878
"17254","ENSG00000198015","12",93467488,93516214,48726
"17255","ENSG00000198018","10",99659509,99711241,51732
"17256","ENSG00000198019","1",121087345,121096310,8965
"17257","ENSG00000198021","X",141583674,141585011,1337
"17258","ENSG00000198022","X",135673591,135686151,12560
"17259","ENSG00000198026","20",45948660,45972203,23543
"17260","ENSG00000198028","19",9466507,9498607,32100
"17261","ENSG00000198033","13",19173772,19181824,8052
"17262","ENSG00000198034","X",72255679,72277248,21569
"17263","ENSG00000198039","7",64870172,64930966,60794
"17264","ENSG00000198040","12",133037292,133063304,26012
"17265","ENSG00000198042","8",33485182,33501262,16080
"17266","ENSG00000198046","19",56439325,56478065,38740
"17267","ENSG00000198049","1",206106936,206117699,10763
"17268","ENSG00000198053","20",1894167,1940592,46425
"17269","ENSG00000198054","21",38121451,38156511,35060
"17270","ENSG00000198055","5",177403204,177442901,39697
"17271","ENSG00000198056","12",56731580,56752373,20793
"17272","ENSG00000198060","10",92291167,92353964,62797
"17273","ENSG00000198062","22",15690026,15721631,31605
"17274","ENSG00000198064","16",30222937,30254510,31573
"17275","ENSG00000198074","7",134527567,134541412,13845
"17276","ENSG00000198075","2",108377911,108388989,11078
"17277","ENSG00000198077","19",40875439,40882752,7313
"17278","ENSG00000198081","18",5289019,5297053,8034
"17279","ENSG00000198087","6",47477789,47627263,149474
"17280","ENSG00000198088","X",107123427,107206433,83006
"17281","ENSG00000198089","22",31488688,31618586,129898
"17282","ENSG00000198090","17",41139433,41140487,1054
"17283","ENSG00000198092","4",68053198,68129880,76682
"17284","ENSG00000198093","19",51889235,51905040,15805
"17285","ENSG00000198099","4",99123657,99157792,34135
"17286","ENSG00000198104","1",248375746,248391811,16065
"17287","ENSG00000198105","10",37776526,37858106,81580
"17288","ENSG00000198106","16",29291220,29372110,80890
"17289","ENSG00000198108","5",129904465,130186634,282169
"17290","ENSG00000198113","9",137277726,137282641,4915
"17291","ENSG00000198121","9",110873263,111038458,165195
"17292","ENSG00000198125","22",35606764,35637951,31187
"17293","ENSG00000198128","1",248046836,248063407,16571
"17294","ENSG00000198130","2",190189735,190344193,154458
"17295","ENSG00000198131","19",58228594,58277495,48901
"17296","ENSG00000198133","14",67447084,67533739,86655
"17297","ENSG00000198134","12",12111163,12111489,326
"17298","ENSG00000198142","2",109614364,109618990,4626
"17299","ENSG00000198146","15",34978341,34988287,9946
"17300","ENSG00000198153","19",22685167,22686732,1565
"17301","ENSG00000198155","4",212610,255985,43375
"17302","ENSG00000198156","16",28342555,28363508,20953
"17303","ENSG00000198157","X",81113701,81201942,88241
"17304","ENSG00000198160","1",66924895,66988619,63724
"17305","ENSG00000198162","1",117367449,117528872,161423
"17306","ENSG00000198168","11",22813799,22830299,16500
"17307","ENSG00000198169","8",144720907,144756417,35510
"17308","ENSG00000198171","20",3190350,3204685,14335
"17309","ENSG00000198173","X",37008397,37011666,3269
"17310","ENSG00000198176","13",113584721,113641473,56752
"17311","ENSG00000198178","12",7729415,7751605,22190
"17312","ENSG00000198182","19",37696371,37719761,23390
"17313","ENSG00000198183","20",33235995,33243311,7316
"17314","ENSG00000198185","20",46499630,46513559,13929
"17315","ENSG00000198189","4",87336515,87391188,54673
"17316","ENSG00000198198","1",43389882,43454247,64365
"17317","ENSG00000198203","2",108288639,108309915,21276
"17318","ENSG00000198205","X",57906708,57910820,4112
"17319","ENSG00000198208","14",74903954,74923396,19442
"17320","ENSG00000198211","16",89919165,89936092,16927
"17321","ENSG00000198216","1",181317690,181808084,490394
"17322","ENSG00000198217","11",4871717,4878117,6400
"17323","ENSG00000198218","3",49029707,49094363,64656
"17324","ENSG00000198221","6",167822103,167826812,4709
"17325","ENSG00000198223","X",1268800,1310381,41581
"17326","ENSG00000198225","6",63211446,63213024,1578
"17327","ENSG00000198231","17",63773603,63819317,45714
"17328","ENSG00000198237","5",69875271,69920867,45596
"17329","ENSG00000198242","17",28719985,28724359,4374
"17330","ENSG00000198246","10",71319259,71381423,62164
"17331","ENSG00000198251","19",40908480,40910685,2205
"17332","ENSG00000198252","14",52730166,52774989,44823
"17333","ENSG00000198258","19",9827892,9830115,2223
"17334","ENSG00000198265","17",67070444,67245989,175545
"17335","ENSG00000198270","12",111931282,112013185,81903
"17336","ENSG00000198276","20",63939829,63956416,16587
"17337","ENSG00000198277","4",68914928,68924741,9813
"17338","ENSG00000198283","11",58507175,58508105,930
"17339","ENSG00000198284","3",126660609,126671939,11330
"17340","ENSG00000198286","7",2906141,3043945,137804
"17341","ENSG00000198298","10",43606419,43617904,11485
"17342","ENSG00000198300","19",56810077,56840728,30651
"17343","ENSG00000198301","4",75940950,75990962,50012
"17344","ENSG00000198312","9",63055641,63059217,3576
"17345","ENSG00000198315","6",28141883,28159460,17577
"17346","ENSG00000198324","12",111360651,111369121,8470
"17347","ENSG00000198326","20",2816302,2820284,3982
"17348","ENSG00000198331","11",125883614,125900648,17034
"17349","ENSG00000198336","17",47200446,47223679,23233
"17350","ENSG00000198342","19",12345944,12365905,19961
"17351","ENSG00000198346","19",53467733,53496255,28522
"17352","ENSG00000198353","12",54016931,54056030,39099
"17353","ENSG00000198354","X",126163499,126166289,2790
"17354","ENSG00000198355","22",49960768,49964072,3304
"17355","ENSG00000198356","19",12737139,12748323,11184
"17356","ENSG00000198358","1",160932465,160949922,17457
"17357","ENSG00000198363","8",61500556,61714640,214084
"17358","ENSG00000198369","2",65310851,65432637,121786
"17359","ENSG00000198373","16",69762306,69941741,179435
"17360","ENSG00000198380","2",69319769,69387254,67485
"17361","ENSG00000198382","11",75815210,76144232,329022
"17362","ENSG00000198390","21",30396074,30396822,748
"17363","ENSG00000198393","12",132986365,133032952,46587
"17364","ENSG00000198398","3",190428655,190449876,21221
"17365","ENSG00000198399","2",24202864,24360714,157850
"17366","ENSG00000198400","1",156815640,156881850,66210
"17367","ENSG00000198406","3",116645902,116646727,825
"17368","ENSG00000198408","10",101784443,101818465,34022
"17369","ENSG00000198414","X",44283916,44286246,2330
"17370","ENSG00000198416","9",39443815,39508885,65070
"17371","ENSG00000198417","16",56657731,56660698,2967
"17372","ENSG00000198420","7",143851375,143902198,50823
"17373","ENSG00000198429","19",11887784,11914329,26545
"17374","ENSG00000198431","12",104215779,104350307,134528
"17375","ENSG00000198435","9",137299631,137302271,2640
"17376","ENSG00000198440","19",56397966,56436035,38069
"17377","ENSG00000198443","17",41184102,41185342,1240
"17378","ENSG00000198445","22",16590751,16592810,2059
"17379","ENSG00000198452","1",247617143,247622372,5229
"17380","ENSG00000198453","19",36916329,36998700,82371
"17381","ENSG00000198454","9",136969243,136971990,2747
"17382","ENSG00000198455","X",57591652,57597545,5893
"17383","ENSG00000198464","19",52297169,52325922,28753
"17384","ENSG00000198466","19",57849859,57865117,15258
"17385","ENSG00000198467","9",35681992,35690056,8064
"17386","ENSG00000198468","1",212852105,212858126,6021
"17387","ENSG00000198471","3",187698259,187702557,4298
"17388","ENSG00000198478","6",79631329,79703655,72326
"17389","ENSG00000198482","19",52527652,52564464,36812
"17390","ENSG00000198483","1",145866560,145885866,19306
"17391","ENSG00000198488","11",77034398,77041973,7575
"17392","ENSG00000198491","3",187197090,187207629,10539
"17393","ENSG00000198492","1",28736621,28769775,33154
"17394","ENSG00000198496","17",43125551,43153671,28120
"17395","ENSG00000198498","4",163494442,163520539,26097
"17396","ENSG00000198502","6",32517353,32530287,12934
"17397","ENSG00000198513","14",50532509,50633068,100559
"17398","ENSG00000198515","4",47935977,48016672,80695
"17399","ENSG00000198517","7",1530702,1543043,12341
"17400","ENSG00000198520","1",44674692,44725591,50899
"17401","ENSG00000198521","19",21804949,21852125,47176
"17402","ENSG00000198522","2",27628247,27651508,23261
"17403","ENSG00000198523","6",118548296,118561716,13420
"17404","ENSG00000198526","2",146587506,146589310,1804
"17405","ENSG00000198535","15",62066977,62070917,3940
"17406","ENSG00000198538","19",52797408,52857600,60192
"17407","ENSG00000198542","13",101452593,101720856,268263
"17408","ENSG00000198546","10",133308914,133313162,4248
"17409","ENSG00000198547","20",32631652,32673941,42289
"17410","ENSG00000198551","19",11559374,11619161,59787
"17411","ENSG00000198553","13",50015254,50020922,5668
"17412","ENSG00000198554","14",54938949,55027105,88156
"17413","ENSG00000198555","16",33976039,33987630,11591
"17414","ENSG00000198556","7",99472890,99503650,30760
"17415","ENSG00000198561","11",57753243,57819546,66303
"17416","ENSG00000198563","6",31530219,31542448,12229
"17417","ENSG00000198569","9",137230757,137236554,5797
"17418","ENSG00000198570","1",211476522,211492917,16395
"17419","ENSG00000198573","X",141241463,141242496,1033
"17420","ENSG00000198574","1",162395268,162412138,16870
"17421","ENSG00000198576","8",142611049,142614479,3430
"17422","ENSG00000198580","7",6673494,6676366,2872
"17423","ENSG00000198585","3",131381671,131388830,7159
"17424","ENSG00000198586","2",170990823,171231314,240491
"17425","ENSG00000198589","4",150264435,151015727,751292
"17426","ENSG00000198590","3",37381062,37440186,59124
"17427","ENSG00000198597","19",30228290,30713538,485248
"17428","ENSG00000198598","12",131828393,131851783,23390
"17429","ENSG00000198604","14",34752731,34875647,122916
"17430","ENSG00000198610","10",5195462,5218949,23487
"17431","ENSG00000198612","2",237085882,237100474,14592
"17432","ENSG00000198618","21",18857779,18858276,497
"17433","ENSG00000198624","5",151181052,151224093,43041
"17434","ENSG00000198625","1",204516379,204558120,41741
"17435","ENSG00000198626","1",237042184,237833988,791804
"17436","ENSG00000198633","19",52429187,52452315,23128
"17437","ENSG00000198642","9",21329671,21335380,5709
"17438","ENSG00000198643","3",58633946,58666834,32888
"17439","ENSG00000198646","20",34689097,34825651,136554
"17440","ENSG00000198648","2",167954020,168247595,293575
"17441","ENSG00000198650","16",71565660,71577092,11432
"17442","ENSG00000198658","1",148146395,148149566,3171
"17443","ENSG00000198663","6",36871870,36928964,57094
"17444","ENSG00000198668","14",90396502,90408268,11766
"17445","ENSG00000198670","6",160531483,160664259,132776
"17446","ENSG00000198671","12",65017468,65054124,36656
"17447","ENSG00000198673","12",61708259,62279150,570891
"17448","ENSG00000198674","11",123994163,123995161,998
"17449","ENSG00000198677","5",95461755,95555007,93252
"17450","ENSG00000198680","9",25676389,25678440,2051
"17451","ENSG00000198681","X",153179284,153183880,4596
"17452","ENSG00000198682","10",87659613,87747705,88092
"17453","ENSG00000198685","3",128572000,128576086,4086
"17454","ENSG00000198689","X",135973841,136047269,73428
"17455","ENSG00000198690","15",30890559,30943108,52549
"17456","ENSG00000198691","1",93992834,94121148,128314
"17457","ENSG00000198692","Y",20575776,20593154,17378
"17458","ENSG00000198695","MT",14149,14673,524
"17459","ENSG00000198700","1",201829149,201884291,55142
"17460","ENSG00000198704","6",28503296,28528215,24919
"17461","ENSG00000198707","12",88049014,88142088,93074
"17462","ENSG00000198711","1",54236440,54239063,2623
"17463","ENSG00000198712","MT",7586,8269,683
"17464","ENSG00000198715","1",156290089,156295689,5600
"17465","ENSG00000198718","14",44962190,45074431,112241
"17466","ENSG00000198719","6",170282206,170306565,24359
"17467","ENSG00000198720","17",29589769,29614761,24992
"17468","ENSG00000198721","6",4115689,4135597,19908
"17469","ENSG00000198722","9",35161992,35405338,243346
"17470","ENSG00000198723","19",7492976,7508450,15474
"17471","ENSG00000198727","MT",14747,15887,1140
"17472","ENSG00000198728","10",102107560,102120453,12893
"17473","ENSG00000198729","6",150143044,150250392,107348
"17474","ENSG00000198730","11",10751246,10801625,50379
"17475","ENSG00000198732","14",69854131,70032366,178235
"17476","ENSG00000198734","1",169511953,169586588,74635
"17477","ENSG00000198736","16",1938210,1943326,5116
"17478","ENSG00000198738","6",85735744,85735921,177
"17479","ENSG00000198739","10",66926036,67101551,175515
"17480","ENSG00000198740","17",49289206,49362473,73267
"17481","ENSG00000198742","7",99027438,99144100,116662
"17482","ENSG00000198743","21",34073578,34106260,32682
"17483","ENSG00000198744","1",634376,634922,546
"17484","ENSG00000198746","1",26890488,26900467,9979
"17485","ENSG00000198752","14",102932380,103057549,125169
"17486","ENSG00000198753","X",153764196,153779346,15150
"17487","ENSG00000198754","1",39769523,39771348,1825
"17488","ENSG00000198755","6",35468401,35470785,2384
"17489","ENSG00000198756","1",183929854,184037729,107875
"17490","ENSG00000198758","1",109750080,109764027,13947
"17491","ENSG00000198759","X",13569601,13633575,63974
"17492","ENSG00000198763","MT",4470,5511,1041
"17493","ENSG00000198765","1",114854863,114995370,140507
"17494","ENSG00000198768","20",58459101,58515131,56030
"17495","ENSG00000198771","1",167630093,167708696,78603
"17496","ENSG00000198774","12",85800703,85836409,35706
"17497","ENSG00000198780","5",74777574,74866966,89392
"17498","ENSG00000198783","17",34961540,34963777,2237
"17499","ENSG00000198785","9",101569352,101738580,169228
"17500","ENSG00000198786","MT",12337,14148,1811
"17501","ENSG00000198788","11",1074875,1110511,35636
"17502","ENSG00000198791","8",17224966,17246878,21912
"17503","ENSG00000198792","22",38219291,38273010,53719
"17504","ENSG00000198793","1",11106535,11262507,155972
"17505","ENSG00000198794","15",74957219,75021495,64276
"17506","ENSG00000198795","18",25061924,25352190,290266
"17507","ENSG00000198796","18",58481247,58629091,147844
"17508","ENSG00000198797","1",177170958,177282422,111464
"17509","ENSG00000198798","X",30230436,30237492,7056
"17510","ENSG00000198799","1",113073198,113132260,59062
"17511","ENSG00000198804","MT",5904,7445,1541
"17512","ENSG00000198805","14",20468954,20477094,8140
"17513","ENSG00000198807","14",36657568,36679715,22147
"17514","ENSG00000198812","12",69608564,69611162,2598
"17515","ENSG00000198814","X",30653359,30731456,78097
"17516","ENSG00000198815","1",42176539,42335877,159338
"17517","ENSG00000198816","19",7515292,7521025,5733
"17518","ENSG00000198818","6",166319728,166342576,22848
"17519","ENSG00000198821","1",167430640,167518610,87970
"17520","ENSG00000198822","7",86643914,86864884,220970
"17521","ENSG00000198824","13",114314482,114337626,23144
"17522","ENSG00000198825","10",119726042,119829147,103105
"17523","ENSG00000198826","15",32615144,32639941,24797
"17524","ENSG00000198829","3",151873643,151884619,10976
"17525","ENSG00000198830","1",26472440,26476642,4202
"17526","ENSG00000198832","22",31104772,31120069,15297
"17527","ENSG00000198833","6",89326625,89352722,26097
"17528","ENSG00000198835","1",228149930,228159826,9896
"17529","ENSG00000198836","3",193593144,193697811,104667
"17530","ENSG00000198837","1",153929501,153946718,17217
"17531","ENSG00000198838","15",33310945,33866121,555176
"17532","ENSG00000198839","7",112206588,112343096,136508
"17533","ENSG00000198840","MT",10059,10404,345
"17534","ENSG00000198841","1",52032103,52033816,1713
"17535","ENSG00000198842","1",167094045,167129165,35120
"17536","ENSG00000198843","3",150602875,150630445,27570
"17537","ENSG00000198844","17",8310241,8322514,12273
"17538","ENSG00000198846","8",58805412,59119147,313735
"17539","ENSG00000198848","16",55802851,55833337,30486
"17540","ENSG00000198851","11",118304545,118316175,11630
"17541","ENSG00000198853","9",35490111,35561898,71787
"17542","ENSG00000198854","1",152719522,152720470,948
"17543","ENSG00000198855","12",108515277,108525837,10560
"17544","ENSG00000198856","4",108650585,108667820,17235
"17545","ENSG00000198857","1",119601340,119609250,7910
"17546","ENSG00000198858","19",896503,913245,16742
"17547","ENSG00000198860","1",184051651,184123978,72327
"17548","ENSG00000198862","21",28928144,28992956,64812
"17549","ENSG00000198863","17",42980565,42993690,13125
"17550","ENSG00000198865","5",42756818,42802439,45621
"17551","ENSG00000198868","5",134928030,134928326,296
"17552","ENSG00000198870","9",133376367,133406096,29729
"17553","ENSG00000198873","10",119207589,119459742,252153
"17554","ENSG00000198874","7",66995173,67239519,244346
"17555","ENSG00000198876","9",34086387,34127399,41012
"17556","ENSG00000198879","10",7158624,7411486,252862
"17557","ENSG00000198881","X",64224194,64230607,6413
"17558","ENSG00000198883","X",152988824,152994116,5292
"17559","ENSG00000198885","2",96325331,96330517,5186
"17560","ENSG00000198886","MT",10760,12137,1377
"17561","ENSG00000198887","9",70258978,70354873,95895
"17562","ENSG00000198888","MT",3307,4262,955
"17563","ENSG00000198889","X",126549383,126552814,3431
"17564","ENSG00000198890","1",107056679,107067636,10957
"17565","ENSG00000198892","1",201888680,201892306,3626
"17566","ENSG00000198894","14",77098126,77117287,19161
"17567","ENSG00000198898","7",116811070,116922049,110979
"17568","ENSG00000198899","MT",8527,9207,680
"17569","ENSG00000198900","20",41028822,41124487,95665
"17570","ENSG00000198901","15",90966040,90995629,29589
"17571","ENSG00000198908","X",102720688,102753540,32852
"17572","ENSG00000198909","17",63622415,63696303,73888
"17573","ENSG00000198910","X",153861514,153886174,24660
"17574","ENSG00000198911","22",41833079,41907307,74228
"17575","ENSG00000198912","1",3889125,3900293,11168
"17576","ENSG00000198914","2",104855511,104858574,3063
"17577","ENSG00000198915","10",43194535,43266919,72384
"17578","ENSG00000198917","9",128819651,128829794,10143
"17579","ENSG00000198918","X",119786504,119791630,5126
"17580","ENSG00000198919","3",108589705,108694840,105135
"17581","ENSG00000198920","17",6578147,6640711,62564
"17582","ENSG00000198923","12",75964799,75964995,196
"17583","ENSG00000198924","10",113834725,113854383,19658
"17584","ENSG00000198925","2",219219380,219229717,10337
"17585","ENSG00000198929","1",162069691,162370475,300784
"17586","ENSG00000198930","X",152727484,152733735,6251
"17587","ENSG00000198931","16",88809339,88811944,2605
"17588","ENSG00000198932","X",102651092,102659083,7991
"17589","ENSG00000198933","17",47694081,47712050,17969
"17590","ENSG00000198934","X",76427724,76431353,3629
"17591","ENSG00000198937","6",37482938,37499893,16955
"17592","ENSG00000198938","MT",9207,9990,783
"17593","ENSG00000198939","5",178895898,178933212,37314
"17594","ENSG00000198944","5",132813587,132816797,3210
"17595","ENSG00000198945","6",130013699,130141451,127752
"17596","ENSG00000198947","X",31097677,33339441,2241764
"17597","ENSG00000198948","4",169986597,170033031,46434
"17598","ENSG00000198951","22",42058354,42070842,12488
"17599","ENSG00000198952","1",156249224,156282825,33601
"17600","ENSG00000198954","10",68988721,69043544,54823
"17601","ENSG00000198959","20",38127385,38166578,39193
"17602","ENSG00000198960","X",101615118,101618001,2883
"17603","ENSG00000198961","5",109334713,109409974,75261
"17604","ENSG00000198963","9",74497335,74693177,195842
"17605","ENSG00000198964","10",50305586,50625163,319577
"17606","ENSG00000198974","1",40754355,40754446,91
"17607","ENSG00000198975","11",122146522,122146593,71
"17608","ENSG00000198976","1",1169005,1169087,82
"17609","ENSG00000198984","14",100307859,100307956,97
"17610","ENSG00000198995","5",180015303,180015397,94
"17611","ENSG00000199005","14",100911139,100911213,74
"17612","ENSG00000199012","14",101065447,101065537,90
"17613","ENSG00000199015","14",101062050,101062118,68
"17614","ENSG00000199020","14",101045920,101045994,74
"17615","ENSG00000199023","7",1022933,1023026,93
"17616","ENSG00000199024","20",3917494,3917571,77
"17617","ENSG00000199035","5",168560896,168560973,77
"17618","ENSG00000199036","6",33207835,33207944,109
"17619","ENSG00000199038","11",568089,568198,109
"17620","ENSG00000199047","5",149732825,149732890,65
"17621","ENSG00000199051","X",85903636,85903707,71
"17622","ENSG00000199053","17",7223297,7223379,82
"17623","ENSG00000199059","1",205448302,205448398,96
"17624","ENSG00000199065","9",4850297,4850375,78
"17625","ENSG00000199072","9",94176347,94176433,86
"17626","ENSG00000199075","3",37969404,37969480,76
"17627","ENSG00000199080","6",52148923,52149041,118
"17628","ENSG00000199082","14",100109655,100109753,98
"17629","ENSG00000199085","7",25949919,25949986,67
"17630","ENSG00000199088","14",101022066,101022132,66
"17631","ENSG00000199090","11",75335092,75335186,94
"17632","ENSG00000199092","14",101065912,101065991,79
"17633","ENSG00000199094","6",71376960,71377031,71
"17634","ENSG00000199102","4",112648363,112648430,67
"17635","ENSG00000199107","14",101065300,101065378,78
"17636","ENSG00000199121","2",218402646,218402722,76
"17637","ENSG00000199122","12",54337216,54337314,98
"17638","ENSG00000199130","16",14309285,14309371,86
"17639","ENSG00000199132","X",134540341,134540431,90
"17640","ENSG00000199133","9",94178834,94178920,86
"17641","ENSG00000199135","1",65058434,65058508,74
"17642","ENSG00000199143","19",53788705,53788773,68
"17643","ENSG00000199145","4",112648004,112648071,67
"17644","ENSG00000199150","3",52268278,52268361,83
"17645","ENSG00000199156","15",63870930,63871019,89
"17646","ENSG00000199157","14",23388596,23388666,70
"17647","ENSG00000199161","9",136670602,136670686,84
"17648","ENSG00000199165","9",94175957,94176036,79
"17649","ENSG00000199168","X",74287286,74287357,71
"17650","ENSG00000199172","12",95308420,95308513,93
"17651","ENSG00000199179","12",62603686,62603769,83
"17652","ENSG00000199197","18",1323794,1324085,291
"17653","ENSG00000199201","10",73192223,73192325,102
"17654","ENSG00000199202","9",95905005,95905141,136
"17655","ENSG00000199217","11",119656311,119656416,105
"17656","ENSG00000199218","20",53097652,53097984,332
"17657","ENSG00000199222","10",21481716,21481817,101
"17658","ENSG00000199226","X",46517766,46517868,102
"17659","ENSG00000199237","12",49593104,49593213,109
"17660","ENSG00000199245","12",88430442,88430550,108
"17661","ENSG00000199260","11",129202966,129203070,104
"17662","ENSG00000199263","16",68474553,68474664,111
"17663","ENSG00000199266","20",38449370,38449503,133
"17664","ENSG00000199279","5",62443176,62443282,106
"17665","ENSG00000199283","7",140241870,140242032,162
"17666","ENSG00000199289","6",26519351,26519458,107
"17667","ENSG00000199290","6",29750371,29750472,101
"17668","ENSG00000199301","16",71666091,71666197,106
"17669","ENSG00000199306","3",197894507,197894613,106
"17670","ENSG00000199308","19",54868939,54869045,106
"17671","ENSG00000199313","9",124887410,124887549,139
"17672","ENSG00000199318","1",87453240,87453373,133
"17673","ENSG00000199322","5",55777469,55777587,118
"17674","ENSG00000199325","11",66614964,66615090,126
"17675","ENSG00000199327","3",125119097,125119200,103
"17676","ENSG00000199331","9",109042386,109042487,101
"17677","ENSG00000199332","6",31402152,31402250,98
"17678","ENSG00000199335","4",3044101,3044207,106
"17679","ENSG00000199347","1",11908152,11908271,119
"17680","ENSG00000199348","2",168606390,168606496,106
"17681","ENSG00000199349","1",206747980,206748092,112
"17682","ENSG00000199357","18",23456371,23456467,96
"17683","ENSG00000199360","6",110856417,110856522,105
"17684","ENSG00000199362","11",75837544,75837645,101
"17685","ENSG00000199366","18",23582016,23582121,105
"17686","ENSG00000199370","7",148389645,148389859,214
"17687","ENSG00000199373","18",32176050,32176168,118
"17688","ENSG00000199377","1",44721786,44721902,116
"17689","ENSG00000199381","13",72881108,72881214,106
"17690","ENSG00000199390","14",100963054,100963130,76
"17691","ENSG00000199394","12",48892130,48892228,98
"17692","ENSG00000199398","5",160008445,160008546,101
"17693","ENSG00000199400","2",230058229,230058324,95
"17694","ENSG00000199405","8",55902723,55902855,132
"17695","ENSG00000199407","10",13727796,13727916,120
"17696","ENSG00000199409","5",150098406,150098506,100
"17697","ENSG00000199411","9",137094345,137094430,85
"17698","ENSG00000199415","12",104125236,104125356,120
"17699","ENSG00000199420","4",15093767,15094094,327
"17700","ENSG00000199424","X",136571705,136571815,110
"17701","ENSG00000199436","14",21392150,21392253,103
"17702","ENSG00000199444","19",12088245,12088346,101
"17703","ENSG00000199455","5",130114409,130114510,101
"17704","ENSG00000199458","6",121453981,121454121,140
"17705","ENSG00000199459","1",85435175,85435284,109
"17706","ENSG00000199460","2",69182877,69182983,106
"17707","ENSG00000199466","10",124766196,124766297,101
"17708","ENSG00000199468","5",156814130,156814234,104
"17709","ENSG00000199470","7",12700758,12700889,131
"17710","ENSG00000199471","1",202914880,202914980,100
"17711","ENSG00000199472","14",73906316,73906427,111
"17712","ENSG00000199473","7",17373201,17373326,125
"17713","ENSG00000199476","3",48288587,48288694,107
"17714","ENSG00000199477","13",45337480,45337609,129
"17715","ENSG00000199487","5",41963868,41963969,101
"17716","ENSG00000199488","3",170994870,170995033,163
"17717","ENSG00000199490","20",49920597,49920694,97
"17718","ENSG00000199492","17",49966075,49966176,101
"17719","ENSG00000199497","20",31901254,31901426,172
"17720","ENSG00000199506","12",95792529,95792635,106
"17721","ENSG00000199508","2",164858432,164858546,114
"17722","ENSG00000199509","20",21138956,21139074,118
"17723","ENSG00000199512","15",59341314,59341417,103
"17724","ENSG00000199515","22",41065554,41065646,92
"17725","ENSG00000199525","9",112252258,112252378,120
"17726","ENSG00000199530","4",82944738,82944845,107
"17727","ENSG00000199535","10",24640166,24640284,118
"17728","ENSG00000199536","3",170149845,170149951,106
"17729","ENSG00000199545","5",139299852,139299968,116
"17730","ENSG00000199550","11",2372638,2372750,112
"17731","ENSG00000199551","12",12226674,12226777,103
"17732","ENSG00000199556","12",45117771,45117888,117
"17733","ENSG00000199562","1",10298966,10299072,106
"17734","ENSG00000199564","X",41292798,41292916,118
"17735","ENSG00000199567","X",86019608,86019715,107
"17736","ENSG00000199568","15",65296051,65296166,115
"17737","ENSG00000199571","12",39819750,39819883,133
"17738","ENSG00000199572","4",190015138,190015255,117
"17739","ENSG00000199575","14",100949833,100949904,71
"17740","ENSG00000199591","3",47931808,47931914,106
"17741","ENSG00000199592","10",77587049,77587159,110
"17742","ENSG00000199593","14",100972103,100972177,74
"17743","ENSG00000199594","3",37140327,37140430,103
"17744","ENSG00000199598","21",43919795,43919901,106
"17745","ENSG00000199603","2",38147415,38147521,106
"17746","ENSG00000199605","13",52400004,52400099,95
"17747","ENSG00000199622","X",13596236,13596548,312
"17748","ENSG00000199627","7",131054886,131054992,106
"17749","ENSG00000199629","7",53366058,53366209,151
"17750","ENSG00000199630","6",89841329,89841424,95
"17751","ENSG00000199638","10",68461407,68461525,118
"17752","ENSG00000199643","5",91270727,91270867,140
"17753","ENSG00000199646","7",138876359,138876465,106
"17754","ENSG00000199664","10",77776951,77777055,104
"17755","ENSG00000199666","1",90657750,90657964,214
"17756","ENSG00000199667","8",100185138,100185239,101
"17757","ENSG00000199672","1",229535064,229535189,125
"17758","ENSG00000199674","17",16137768,16137872,104
"17759","ENSG00000199676","20",35853252,35853364,112
"17760","ENSG00000199683","20",37975156,37975481,325
"17761","ENSG00000199687","2",85728194,85728337,143
"17762","ENSG00000199691","20",38761528,38761842,314
"17763","ENSG00000199695","22",31222745,31222853,108
"17764","ENSG00000199697","17",62683905,62684010,105
"17765","ENSG00000199698","21",23432181,23432282,101
"17766","ENSG00000199700","7",135960703,135960809,106
"17767","ENSG00000199701","8",94713715,94713812,97
"17768","ENSG00000199704","15",25223246,25223327,81
"17769","ENSG00000199705","X",123857062,123857163,101
"17770","ENSG00000199709","11",122927034,122927173,139
"17771","ENSG00000199712","15",25172635,25172716,81
"17772","ENSG00000199713","18",58818883,58819016,133
"17773","ENSG00000199716","14",22867818,22867917,99
"17774","ENSG00000199719","20",18295143,18295451,308
"17775","ENSG00000199730","15",58703852,58704154,302
"17776","ENSG00000199731","5",32234766,32234875,109
"17777","ENSG00000199733","10",26509589,26509704,115
"17778","ENSG00000199735","17",76656320,76656422,102
"17779","ENSG00000199740","12",50939927,50940026,99
"17780","ENSG00000199751","X",71491066,71491167,101
"17781","ENSG00000199753","17",64146083,64146152,69
"17782","ENSG00000199755","14",67340068,67340176,108
"17783","ENSG00000199762","6",47489067,47489170,103
"17784","ENSG00000199781","2",232828653,232828751,98
"17785","ENSG00000199782","15",25185631,25185712,81
"17786","ENSG00000199784","15",56274530,56274636,106
"17787","ENSG00000199787","16",30419625,30419759,134
"17788","ENSG00000199788","13",49095391,49095492,101
"17789","ENSG00000199790","4",41084607,41084713,106
"17790","ENSG00000199791","2",230587121,230587227,106
"17791","ENSG00000199796","19",46306470,46306577,107
"17792","ENSG00000199797","22",28303754,28303850,96
"17793","ENSG00000199798","14",100955370,100955439,69
"17794","ENSG00000199801","17",69985986,69986094,108
"17795","ENSG00000199804","14",24158603,24158722,119
"17796","ENSG00000199805","20",63908955,63909119,164
"17797","ENSG00000199806","21",36851911,36852028,117
"17798","ENSG00000199824","12",51162901,51163007,106
"17799","ENSG00000199836","14",99945315,99945477,162
"17800","ENSG00000199837","1",182944365,182944490,125
"17801","ENSG00000199845","12",123282916,123283034,118
"17802","ENSG00000199846","7",129484504,129484656,152
"17803","ENSG00000199851","6",28015568,28015777,209
"17804","ENSG00000199855","10",27088321,27088427,106
"17805","ENSG00000199856","18",7995570,7995785,215
"17806","ENSG00000199859","4",157201562,157201668,106
"17807","ENSG00000199865","22",41377177,41377283,106
"17808","ENSG00000199866","2",172558151,172558252,101
"17809","ENSG00000199867","18",62330812,62330913,101
"17810","ENSG00000199872","2",26042675,26042781,106
"17811","ENSG00000199874","18",24170505,24170623,118
"17812","ENSG00000199875","11",93719603,93719715,112
"17813","ENSG00000199879","1",148263476,148263632,156
"17814","ENSG00000199880","5",138123011,138123111,100
"17815","ENSG00000199881","10",92272147,92272250,103
"17816","ENSG00000199883","11",16842253,16842587,334
"17817","ENSG00000199890","1",111446798,111446908,110
"17818","ENSG00000199895","12",92170353,92170453,100
"17819","ENSG00000199899","12",113156763,113156861,98
"17820","ENSG00000199900","19",7886977,7887096,119
"17821","ENSG00000199901","4",52786537,52786638,101
"17822","ENSG00000199903","12",51037499,51037602,103
"17823","ENSG00000199906","3",40498891,40499003,112
"17824","ENSG00000199914","14",100973595,100973664,69
"17825","ENSG00000199924","4",52494849,52494952,103
"17826","ENSG00000199927","3",30304320,30304536,216
"17827","ENSG00000199932","6",122211648,122211811,163
"17828","ENSG00000199933","12",101719808,101719918,110
"17829","ENSG00000199936","2",85460144,85460252,108
"17830","ENSG00000199938","6",38565950,38566055,105
"17831","ENSG00000199940","7",71685452,71685747,295
"17832","ENSG00000199942","14",100976477,100976551,74
"17833","ENSG00000199944","6",109059509,109059614,105
"17834","ENSG00000199959","1",84277321,84277457,136
"17835","ENSG00000199960","15",25194921,25195001,80
"17836","ENSG00000199961","17",76561109,76561192,83
"17837","ENSG00000199962","21",17576798,17576906,108
"17838","ENSG00000199963","1",38926870,38926977,107
"17839","ENSG00000199975","11",73832382,73832690,308
"17840","ENSG00000199977","18",21817624,21817828,204
"17841","ENSG00000199979","16",68885576,68885677,101
"17842","ENSG00000199990","5",140711275,140711373,98
"17843","ENSG00000200003","2",27475494,27475595,101
"17844","ENSG00000200008","15",33722492,33722596,104
"17845","ENSG00000200011","12",93460725,93460826,101
"17846","ENSG00000200013","17",60662333,60662437,104
"17847","ENSG00000200026","9",38147428,38147561,133
"17848","ENSG00000200028","2",76772909,76773045,136
"17849","ENSG00000200029","2",218916184,218916287,103
"17850","ENSG00000200033","1",221837334,221837437,103
"17851","ENSG00000200036","1",167005959,167006077,118
"17852","ENSG00000200040","6",75928513,75928625,112
"17853","ENSG00000200041","9",75181520,75181621,101
"17854","ENSG00000200051","5",140527352,140527428,76
"17855","ENSG00000200058","6",134257035,134257143,108
"17856","ENSG00000200059","16",2131851,2131950,99
"17857","ENSG00000200060","12",108738484,108738604,120
"17858","ENSG00000200063","17",78399935,78400063,128
"17859","ENSG00000200064","13",49908634,49908730,96
"17860","ENSG00000200065","5",32134738,32134834,96
"17861","ENSG00000200070","15",59212648,59212788,140
"17862","ENSG00000200075","8",129868590,129868716,126
"17863","ENSG00000200085","1",248029120,248029221,101
"17864","ENSG00000200086","2",55014418,55014521,103
"17865","ENSG00000200087","1",28508559,28508762,203
"17866","ENSG00000200089","14",100993236,100993310,74
"17867","ENSG00000200090","11",47726894,47726992,98
"17868","ENSG00000200091","6",75654970,75655299,329
"17869","ENSG00000200095","15",100560686,100560792,106
"17870","ENSG00000200097","10",35250959,35251052,93
"17871","ENSG00000200105","12",15671707,15671810,103
"17872","ENSG00000200106","9",109196201,109196309,108
"17873","ENSG00000200113","7",37419628,37419767,139
"17874","ENSG00000200114","3",12511095,12511213,118
"17875","ENSG00000200118","3",170244782,170244881,99
"17876","ENSG00000200120","15",49137762,49137863,101
"17877","ENSG00000200131","9",106679977,106680329,352
"17878","ENSG00000200135","12",112149360,112149472,112
"17879","ENSG00000200138","16",28183318,28183430,112
"17880","ENSG00000200142","15",90977208,90977305,97
"17881","ENSG00000200150","14",100956240,100956312,72
"17882","ENSG00000200152","11",74968189,74968292,103
"17883","ENSG00000200156","15",65304677,65304792,115
"17884","ENSG00000200161","5",149116178,149116480,302
"17885","ENSG00000200164","16",69191123,69191223,100
"17886","ENSG00000200169","1",44731055,44731170,115
"17887","ENSG00000200170","10",72220752,72220852,100
"17888","ENSG00000200175","1",150812591,150812698,107
"17889","ENSG00000200176","10",86889569,86889733,164
"17890","ENSG00000200179","19",36203347,36203459,112
"17891","ENSG00000200183","12",50656973,50657078,105
"17892","ENSG00000200201","11",3665164,3665259,95
"17893","ENSG00000200204","16",3086143,3086300,157
"17894","ENSG00000200209","19",38294544,38294636,92
"17895","ENSG00000200215","14",100939556,100939630,74
"17896","ENSG00000200220","1",154039916,154040022,106
"17897","ENSG00000200225","14",20414987,20415098,111
"17898","ENSG00000200231","20",24237255,24237398,143
"17899","ENSG00000200235","5",140579667,140579792,125
"17900","ENSG00000200237","19",9819954,9820094,140
"17901","ENSG00000200241","2",86159956,86160066,110
"17902","ENSG00000200243","5",6848127,6848462,335
"17903","ENSG00000200246","8",32256496,32256623,127
"17904","ENSG00000200247","12",19445949,19446055,106
"17905","ENSG00000200248","6",117060682,117060799,117
"17906","ENSG00000200250","2",127316873,127316979,106
"17907","ENSG00000200253","10",87041238,87041341,103
"17908","ENSG00000200254","1",42569033,42569139,106
"17909","ENSG00000200256","11",75835215,75835323,108
"17910","ENSG00000200257","17",76752912,76753015,103
"17911","ENSG00000200261","9",112169286,112169397,111
"17912","ENSG00000200269","4",48106081,48106188,107
"17913","ENSG00000200279","14",100967052,100967123,71
"17914","ENSG00000200281","2",228169743,228169849,106
"17915","ENSG00000200291","X",117914244,117914345,101
"17916","ENSG00000200295","6",106607716,106607819,103
"17917","ENSG00000200296","12",62850738,62850901,163
"17918","ENSG00000200298","14",72022407,72022516,109
"17919","ENSG00000200301","20",35195306,35195423,117
"17920","ENSG00000200309","12",49132853,49132947,94
"17921","ENSG00000200312","14",89712511,89712823,312
"17922","ENSG00000200318","15",58760466,58760681,215
"17923","ENSG00000200332","22",41648089,41648190,101
"17924","ENSG00000200336","11",18248389,18248506,117
"17925","ENSG00000200340","6",47823390,47823550,160
"17926","ENSG00000200344","1",7982881,7982983,102
"17927","ENSG00000200345","12",7118785,7118891,106
"17928","ENSG00000200350","4",154543933,154544037,104
"17929","ENSG00000200351","5",98936638,98936747,109
"17930","ENSG00000200354","20",38433865,38433998,133
"17931","ENSG00000200355","3",172771277,172771405,128
"17932","ENSG00000200356","10",73279062,73279168,106
"17933","ENSG00000200360","1",111490317,111490423,106
"17934","ENSG00000200361","3",106688678,106688779,101
"17935","ENSG00000200367","14",100943451,100943524,73
"17936","ENSG00000200372","3",116965112,116965227,115
"17937","ENSG00000200376","11",47576471,47576588,117
"17938","ENSG00000200378","5",139447907,139448017,110
"17939","ENSG00000200385","14",37720425,37720561,136
"17940","ENSG00000200388","12",31396390,31396501,111
"17941","ENSG00000200389","3",141902924,141903030,106
"17942","ENSG00000200391","15",43863893,43864005,112
"17943","ENSG00000200394","17",67740669,67740799,130
"17944","ENSG00000200397","7",87218611,87218712,101
"17945","ENSG00000200403","1",19305076,19305182,106
"17946","ENSG00000200407","15",41448742,41448844,102
"17947","ENSG00000200408","1",204562413,204562521,108
"17948","ENSG00000200419","15",45591984,45592085,101
"17949","ENSG00000200428","12",50743568,50743684,116
"17950","ENSG00000200437","17",15311345,15311451,106
"17951","ENSG00000200448","22",42762860,42762959,99
"17952","ENSG00000200455","4",40077884,40077982,98
"17953","ENSG00000200472","18",31718893,31719208,315
"17954","ENSG00000200473","X",70253042,70253162,120
"17955","ENSG00000200475","12",13683542,13683886,344
"17956","ENSG00000200480","14",100989130,100989201,71
"17957","ENSG00000200483","12",131815263,131815368,105
"17958","ENSG00000200486","15",25189414,25189495,81
"17959","ENSG00000200488","2",76445079,76445410,331
"17960","ENSG00000200495","1",248912690,248912795,105
"17961","ENSG00000200496","11",123301390,123301523,133
"17962","ENSG00000200502","9",37160137,37160237,100
"17963","ENSG00000200506","14",99583017,99583118,101
"17964","ENSG00000200508","1",64066640,64066741,101
"17965","ENSG00000200516","12",131801315,131801434,119
"17966","ENSG00000200520","4",139318378,139318486,108
"17967","ENSG00000200522","6",110722250,110722348,98
"17968","ENSG00000200525","8",95055214,95055320,106
"17969","ENSG00000200534","6",132817219,132817348,129
"17970","ENSG00000200536","1",110272484,110272607,123
"17971","ENSG00000200537","11",117015897,117015992,95
"17972","ENSG00000200544","9",33352788,33352874,86
"17973","ENSG00000200550","2",42712740,42712847,107
"17974","ENSG00000200554","9",125303920,125304026,106
"17975","ENSG00000200555","5",180444509,180444612,103
"17976","ENSG00000200556","16",58496908,58497014,106
"17977","ENSG00000200560","17",63573242,63573345,103
"17978","ENSG00000200563","2",86515204,86515308,104
"17979","ENSG00000200571","3",136430084,136430183,99
"17980","ENSG00000200575","1",61816419,61816522,103
"17981","ENSG00000200579","3",38014568,38014669,101
"17982","ENSG00000200587","X",131938846,131938956,110
"17983","ENSG00000200591","1",32639951,32640052,101
"17984","ENSG00000200594","6",154825176,154825279,103
"17985","ENSG00000200597","6",37915573,37915742,169
"17986","ENSG00000200605","15",50221888,50221996,108
"17987","ENSG00000200608","14",100968111,100968185,74
"17988","ENSG00000200610","3",106515897,106515998,101
"17989","ENSG00000200612","14",100986057,100986128,71
"17990","ENSG00000200620","X",15716208,15716346,138
"17991","ENSG00000200629","7",129164849,129164961,112
"17992","ENSG00000200630","8",13160178,13160279,101
"17993","ENSG00000200632","14",100941126,100941202,76
"17994","ENSG00000200648","5",175703898,175704004,106
"17995","ENSG00000200651","17",77442109,77442213,104
"17996","ENSG00000200652","16",28179098,28179223,125
"17997","ENSG00000200661","15",25074114,25074215,101
"17998","ENSG00000200665","12",116082570,116082676,106
"17999","ENSG00000200674","1",173791548,173791887,339
"18000","ENSG00000200677","15",90755243,90755312,69
"18001","ENSG00000200683","22",40917743,40917846,103
"18002","ENSG00000200685","11",13686550,13686658,108
"18003","ENSG00000200687","11",19401872,19401981,109
"18004","ENSG00000200688","12",112069104,112069209,105
"18005","ENSG00000200693","14",63651296,63651499,203
"18006","ENSG00000200701","2",85204926,85205032,106
"18007","ENSG00000200706","6",38207274,38207345,71
"18008","ENSG00000200708","2",133596091,133596399,308
"18009","ENSG00000200714","8",65592731,65592820,89
"18010","ENSG00000200719","8",29048494,29048604,110
"18011","ENSG00000200728","10",96112747,96112851,104
"18012","ENSG00000200731","8",43073474,43073618,144
"18013","ENSG00000200732","6",119327281,119327385,104
"18014","ENSG00000200737","10",97421195,97421307,112
"18015","ENSG00000200741","4",56097390,56097504,114
"18016","ENSG00000200742","14",55651534,55651634,100
"18017","ENSG00000200745","2",236210373,236210548,175
"18018","ENSG00000200750","18",21724119,21724229,110
"18019","ENSG00000200753","7",20377331,20377401,70
"18020","ENSG00000200754","21",17527140,17527247,107
"18021","ENSG00000200755","1",173969318,173969436,118
"18022","ENSG00000200756","5",139717985,139718090,105
"18023","ENSG00000200759","1",151022746,151022852,106
"18024","ENSG00000200761","4",4920770,4921064,294
"18025","ENSG00000200769","7",92202243,92202334,91
"18026","ENSG00000200783","17",72663823,72664152,329
"18027","ENSG00000200785","14",21397292,21397401,109
"18028","ENSG00000200788","9",127470875,127470987,112
"18029","ENSG00000200792","21",32377187,32377322,135
"18030","ENSG00000200795","12",120293097,120293237,140
"18031","ENSG00000200796","1",38396659,38396765,106
"18032","ENSG00000200799","6",108392073,108392177,104
"18033","ENSG00000200807","2",60384605,60384763,158
"18034","ENSG00000200812","15",25180497,25180578,81
"18035","ENSG00000200814","12",62334091,62334197,106
"18036","ENSG00000200815","7",50435380,50435486,106
"18037","ENSG00000200816","6",31623079,31623210,131
"18038","ENSG00000200823","14",100951856,100951933,77
"18039","ENSG00000200830","12",14553702,14553970,268
"18040","ENSG00000200832","14",100954374,100954448,74
"18041","ENSG00000200834","9",33830978,33831078,100
"18042","ENSG00000200839","1",51973410,51973535,125
"18043","ENSG00000200840","13",28232501,28232607,106
"18044","ENSG00000200842","17",62036833,62036945,112
"18045","ENSG00000200847","7",23491792,23491893,101
"18046","ENSG00000200855","11",108084913,108085014,101
"18047","ENSG00000200867","4",7112088,7112399,311
"18048","ENSG00000200869","16",6873899,6874005,106
"18049","ENSG00000200873","15",71858570,71858686,116
"18050","ENSG00000200874","7",75513025,75513126,101
"18051","ENSG00000200879","11",123058077,123058161,84
"18052","ENSG00000200882","3",177126017,177126120,103
"18053","ENSG00000200883","18",9249649,9249746,97
"18054","ENSG00000200885","12",19724435,19724599,164
"18055","ENSG00000200888","17",45071442,45071543,101
"18056","ENSG00000200889","17",59537359,59537499,140
"18057","ENSG00000200893","16",20784509,20784615,106
"18058","ENSG00000200895","6",131820334,131820653,319
"18059","ENSG00000200906","X",77837289,77837395,106
"18060","ENSG00000200913","1",44776490,44776593,103
"18061","ENSG00000200914","17",6600944,6601051,107
"18062","ENSG00000200917","4",105406997,105407092,95
"18063","ENSG00000200922","9",71902455,71902550,95
"18064","ENSG00000200924","2",43892690,43892796,106
"18065","ENSG00000200942","1",201733406,201733505,99
"18066","ENSG00000200953","12",51156868,51156977,109
"18067","ENSG00000200957","6",19642425,19642529,104
"18068","ENSG00000200959","5",139278781,139278978,197
"18069","ENSG00000200966","9",100581079,100581379,300
"18070","ENSG00000200972","1",210374154,210374267,113
"18071","ENSG00000200974","4",165252580,165252661,81
"18072","ENSG00000200985","22",21792434,21792524,90
"18073","ENSG00000200987","15",25225203,25225284,81
"18074","ENSG00000200991","15",84852498,84852615,117
"18075","ENSG00000200997","17",58679527,58679690,163
"18076","ENSG00000200999","4",26702309,26702388,79
"18077","ENSG00000201010","2",48217575,48217899,324
"18078","ENSG00000201012","6",135474504,135474609,105
"18079","ENSG00000201013","2",233379843,233379955,112
"18080","ENSG00000201025","21",16284696,16284768,72
"18081","ENSG00000201027","14",89621918,89622207,289
"18082","ENSG00000201028","1",111650431,111650537,106
"18083","ENSG00000201032","1",200933345,200933447,102
"18084","ENSG00000201033","3",27513871,27514032,161
"18085","ENSG00000201034","16",439297,439397,100
"18086","ENSG00000201035","19",21113128,21113236,108
"18087","ENSG00000201036","14",100979002,100979090,88
"18088","ENSG00000201041","7",128697439,128697556,117
"18089","ENSG00000201044","2",230752141,230752247,106
"18090","ENSG00000201047","10",73082494,73082595,101
"18091","ENSG00000201048","6",10674658,10674768,110
"18092","ENSG00000201050","4",164787290,164787396,106
"18093","ENSG00000201071","15",64111458,64111569,111
"18094","ENSG00000201075","16",14275508,14275600,92
"18095","ENSG00000201076","2",60911303,60911442,139
"18096","ENSG00000201077","15",42427591,42427697,106
"18097","ENSG00000201078","22",37055033,37055347,314
"18098","ENSG00000201086","15",49982443,49982561,118
"18099","ENSG00000201098","7",148987136,148987248,112
"18100","ENSG00000201102","2",177194983,177195095,112
"18101","ENSG00000201109","7",130027277,130027397,120
"18102","ENSG00000201113","2",32214456,32214562,106
"18103","ENSG00000201114","1",114490724,114490832,108
"18104","ENSG00000201118","9",19089593,19089688,95
"18105","ENSG00000201119","6",145463238,145463399,161
"18106","ENSG00000201121","3",101662060,101662164,104
"18107","ENSG00000201129","1",154259727,154259862,135
"18108","ENSG00000201134","1",151841736,151841837,101
"18109","ENSG00000201136","15",43702363,43702470,107
"18110","ENSG00000201140","9",117197118,117197420,302
"18111","ENSG00000201145","4",190017696,190017814,118
"18112","ENSG00000201151","20",35117136,35117207,71
"18113","ENSG00000201155","13",101778884,101779048,164
"18114","ENSG00000201157","8",18979619,18979772,153
"18115","ENSG00000201164","16",68535515,68535658,143
"18116","ENSG00000201170","1",245133927,245134090,163
"18117","ENSG00000201176","4",168885355,168885461,106
"18118","ENSG00000201178","17",32830219,32830329,110
"18119","ENSG00000201179","7",105332790,105332896,106
"18120","ENSG00000201182","3",10037552,10037655,103
"18121","ENSG00000201183","1",148402715,148402875,160
"18122","ENSG00000201184","14",103567405,103567545,140
"18123","ENSG00000201198","12",57415296,57415403,107
"18124","ENSG00000201201","16",67321658,67321987,329
"18125","ENSG00000201207","6",31663288,31663401,113
"18126","ENSG00000201208","12",113178423,113178519,96
"18127","ENSG00000201216","8",102950467,102950564,97
"18128","ENSG00000201217","3",152449272,152449384,112
"18129","ENSG00000201221","20",35887659,35887801,142
"18130","ENSG00000201223","5",36155119,36155222,103
"18131","ENSG00000201228","12",31506303,31506404,101
"18132","ENSG00000201229","3",183451857,183451988,131
"18133","ENSG00000201239","17",82417226,82417321,95
"18134","ENSG00000201240","14",100966029,100966100,71
"18135","ENSG00000201242","13",27402476,27402587,111
"18136","ENSG00000201245","13",99783857,99783983,126
"18137","ENSG00000201247","14",100969879,100969952,73
"18138","ENSG00000201253","13",73191528,73191667,139
"18139","ENSG00000201263","14",100957166,100957237,71
"18140","ENSG00000201264","4",151102057,151102128,71
"18141","ENSG00000201270","1",164980035,164980137,102
"18142","ENSG00000201279","11",3663815,3663911,96
"18143","ENSG00000201289","16",61743154,61743476,322
"18144","ENSG00000201291","6",75473738,75473894,156
"18145","ENSG00000201294","20",3360036,3360142,106
"18146","ENSG00000201297","4",125362819,125362929,110
"18147","ENSG00000201298","5",134701172,134701278,106
"18148","ENSG00000201300","15",25220497,25220578,81
"18149","ENSG00000201302","9",127448501,127448630,129
"18150","ENSG00000201308","2",135656477,135656579,102
"18151","ENSG00000201309","6",134283092,134283193,101
"18152","ENSG00000201311","2",82307067,82307168,101
"18153","ENSG00000201315","3",36685040,36685369,329
"18154","ENSG00000201317","1",92700819,92700934,115
"18155","ENSG00000201318","14",100991919,100991990,71
"18156","ENSG00000201321","1",228628148,228628266,118
"18157","ENSG00000201324","12",108926435,108926541,106
"18158","ENSG00000201339","3",93967926,93968020,94
"18159","ENSG00000201340","17",50696644,50696760,116
"18160","ENSG00000201342","3",170057301,170057429,128
"18161","ENSG00000201343","3",177120691,177120800,109
"18162","ENSG00000201346","20",3384229,3384440,211
"18163","ENSG00000201347","1",178560913,178561029,116
"18164","ENSG00000201348","20",8831186,8831393,207
"18165","ENSG00000201354","7",140609847,140609955,108
"18166","ENSG00000201356","X",28982852,28982970,118
"18167","ENSG00000201358","14",50068568,50068873,305
"18168","ENSG00000201363","20",44344839,44344933,94
"18169","ENSG00000201365","8",66653469,66653576,107
"18170","ENSG00000201367","6",15314920,15315026,106
"18171","ENSG00000201370","5",16623004,16623095,91
"18172","ENSG00000201371","16",27722284,27722392,108
"18173","ENSG00000201372","20",43473013,43473119,106
"18174","ENSG00000201376","14",51244090,51244224,134
"18175","ENSG00000201377","X",70396279,70396375,96
"18176","ENSG00000201379","6",121542486,121542626,140
"18177","ENSG00000201382","12",116782105,116782208,103
"18178","ENSG00000201388","19",32608337,32608469,132
"18179","ENSG00000201390","10",21661635,21661741,106
"18180","ENSG00000201394","3",133710076,133710167,91
"18181","ENSG00000201407","X",24133186,24133317,131
"18182","ENSG00000201412","10",92710499,92710608,109
"18183","ENSG00000201420","X",111669829,111669948,119
"18184","ENSG00000201421","1",185251313,185251411,98
"18185","ENSG00000201423","5",144535354,144535670,316
"18186","ENSG00000201428","12",112267077,112267394,317
"18187","ENSG00000201432","7",36337667,36337778,111
"18188","ENSG00000201433","4",183675603,183675715,112
"18189","ENSG00000201435","12",96303375,96303513,138
"18190","ENSG00000201439","12",25404288,25404428,140
"18191","ENSG00000201440","X",135428168,135428285,117
"18192","ENSG00000201444","9",117707996,117708102,106
"18193","ENSG00000201448","1",36418450,36418578,128
"18194","ENSG00000201451","9",133337728,133337824,96
"18195","ENSG00000201457","1",39567374,39567508,134
"18196","ENSG00000201458","3",172796429,172796558,129
"18197","ENSG00000201466","18",12760717,12760818,101
"18198","ENSG00000201467","X",17044380,17044511,131
"18199","ENSG00000201469","12",132723945,132724057,112
"18200","ENSG00000201470","2",127798903,127798998,95
"18201","ENSG00000201482","15",25201323,25201404,81
"18202","ENSG00000201483","6",7187582,7187686,104
"18203","ENSG00000201492","1",229549905,229550022,117
"18204","ENSG00000201496","4",5458581,5458881,300
"18205","ENSG00000201498","20",34384165,34384265,100
"18206","ENSG00000201499","2",200881715,200881821,106
"18207","ENSG00000201500","14",100977389,100977466,77
"18208","ENSG00000201501","20",50563009,50563110,101
"18209","ENSG00000201510","15",76736641,76736980,339
"18210","ENSG00000201511","3",101647421,101647522,101
"18211","ENSG00000201512","20",38429670,38429803,133
"18212","ENSG00000201518","X",129436530,129436647,117
"18213","ENSG00000201519","6",15324367,15324472,105
"18214","ENSG00000201523","6",19438283,19438418,135
"18215","ENSG00000201524","17",59847438,59847544,106
"18216","ENSG00000201529","14",67617302,67617415,113
"18217","ENSG00000201532","5",139012329,139012441,112
"18218","ENSG00000201533","4",139685127,139685427,300
"18219","ENSG00000201535","11",118836010,118836111,101
"18220","ENSG00000201542","1",35310274,35310425,151
"18221","ENSG00000201544","1",212352816,212352950,134
"18222","ENSG00000201547","17",67408774,67408881,107
"18223","ENSG00000201548","10",88585638,88585733,95
"18224","ENSG00000201550","3",131092821,131092927,106
"18225","ENSG00000201554","3",101458530,101458626,96
"18226","ENSG00000201555","6",31778817,31778905,88
"18227","ENSG00000201557","14",100972670,100972741,71
"18228","ENSG00000201558","1",146052081,146052244,163
"18229","ENSG00000201563","12",32705403,32705506,103
"18230","ENSG00000201564","11",9680924,9681238,314
"18231","ENSG00000201566","7",37435115,37435216,101
"18232","ENSG00000201569","14",100974806,100974880,74
"18233","ENSG00000201570","3",39970125,39970266,141
"18234","ENSG00000201573","14",50468397,50468498,101
"18235","ENSG00000201574","2",231133462,231133630,168
"18236","ENSG00000201579","12",56588518,56588621,103
"18237","ENSG00000201581","10",6149623,6149940,317
"18238","ENSG00000201583","9",105096756,105097061,305
"18239","ENSG00000201586","11",17115652,17115763,111
"18240","ENSG00000201592","X",20136306,20136385,79
"18241","ENSG00000201594","X",146427456,146427572,116
"18242","ENSG00000201595","3",51694465,51694582,117
"18243","ENSG00000201600","3",139584105,139584445,340
"18244","ENSG00000201612","12",27806082,27806390,308
"18245","ENSG00000201616","11",3048359,3048521,162
"18246","ENSG00000201619","1",179201487,179201627,140
"18247","ENSG00000201622","3",197994601,197994709,108
"18248","ENSG00000201641","4",77150328,77150437,109
"18249","ENSG00000201643","7",75943782,75943916,134
"18250","ENSG00000201648","3",175609479,175609613,134
"18251","ENSG00000201654","14",32202045,32202151,106
"18252","ENSG00000201659","X",47132671,47132826,155
"18253","ENSG00000201662","13",48987915,48988017,102
"18254","ENSG00000201663","12",7850717,7850818,101
"18255","ENSG00000201668","18",49871555,49871666,111
"18256","ENSG00000201672","14",100936491,100936565,74
"18257","ENSG00000201680","6",31496689,31496790,101
"18258","ENSG00000201684","11",67362414,67362708,294
"18259","ENSG00000201687","11",113859346,113859449,103
"18260","ENSG00000201689","14",100990091,100990160,69
"18261","ENSG00000201695","11",18266393,18266510,117
"18262","ENSG00000201699","1",149162783,149162944,161
"18263","ENSG00000201700","14",100929919,100929990,71
"18264","ENSG00000201701","3",32037526,32037653,127
"18265","ENSG00000201709","15",65229861,65229967,106
"18266","ENSG00000201710","14",100979992,100980066,74
"18267","ENSG00000201711","9",77635203,77635309,106
"18268","ENSG00000201723","18",78544095,78544188,93
"18269","ENSG00000201724","15",99681786,99681877,91
"18270","ENSG00000201725","1",8883427,8883533,106
"18271","ENSG00000201728","20",23380896,23381012,116
"18272","ENSG00000201733","11",66432763,66432902,139
"18273","ENSG00000201736","4",40990154,40990273,119
"18274","ENSG00000201746","1",10163268,10163374,106
"18275","ENSG00000201747","7",7906519,7906624,105
"18276","ENSG00000201749","9",114615455,114615568,113
"18277","ENSG00000201758","1",244943910,244944216,306
"18278","ENSG00000201761","8",22434391,22434497,106
"18279","ENSG00000201766","10",14663395,14663494,99
"18280","ENSG00000201772","7",45104906,45105042,136
"18281","ENSG00000201782","8",128220504,128220803,299
"18282","ENSG00000201785","6",31536374,31536449,75
"18283","ENSG00000201786","4",153266909,153267010,101
"18284","ENSG00000201791","1",178753654,178753772,118
"18285","ENSG00000201793","13",99205708,99206006,298
"18286","ENSG00000201794","7",2999094,2999394,300
"18287","ENSG00000201800","3",125516979,125517086,107
"18288","ENSG00000201801","1",11909808,11909927,119
"18289","ENSG00000201806","2",97664591,97664731,140
"18290","ENSG00000201807","6",136855698,136855831,133
"18291","ENSG00000201812","21",14070871,14070986,115
"18292","ENSG00000201813","2",195670372,195670474,102
"18293","ENSG00000201816","18",56079394,56079594,200
"18294","ENSG00000201818","4",169005249,169005344,95
"18295","ENSG00000201820","14",51253933,51254023,90
"18296","ENSG00000201821","13",21038529,21038667,138
"18297","ENSG00000201823","6",31835263,31835326,63
"18298","ENSG00000201827","3",133551186,133551315,129
"18299","ENSG00000201830","9",97915690,97915796,106
"18300","ENSG00000201831","15",25170723,25170804,81
"18301","ENSG00000201839","14",100953349,100953423,74
"18302","ENSG00000201846","4",148557947,148558048,101
"18303","ENSG00000201850","16",68089449,68089543,94
"18304","ENSG00000201852","18",22180112,22180218,106
"18305","ENSG00000201861","10",282015,282125,110
"18306","ENSG00000201867","11",34189174,34189275,101
"18307","ENSG00000201868","1",35195969,35196062,93
"18308","ENSG00000201869","5",64573569,64573670,101
"18309","ENSG00000201875","2",205900630,205900958,328
"18310","ENSG00000201882","X",20136066,20136135,69
"18311","ENSG00000201894","19",31787148,31787255,107
"18312","ENSG00000201896","8",119711830,119712145,315
"18313","ENSG00000201898","1",224179641,224179767,126
"18314","ENSG00000201899","14",100984777,100984848,71
"18315","ENSG00000201900","1",114727720,114727824,104
"18316","ENSG00000201913","7",100330777,100330877,100
"18317","ENSG00000201916","22",20481158,20481268,110
"18318","ENSG00000201931","4",177457111,177457228,117
"18319","ENSG00000201933","7",43096732,43096844,112
"18320","ENSG00000201938","9",96103079,96103174,95
"18321","ENSG00000201939","6",153159220,153159345,125
"18322","ENSG00000201942","12",79878305,79878419,114
"18323","ENSG00000201944","1",205731221,205731352,131
"18324","ENSG00000201950","14",100945649,100945720,71
"18325","ENSG00000201957","3",179169083,179169210,127
"18326","ENSG00000201967","19",32862800,32863092,292
"18327","ENSG00000201968","3",126564565,126564678,113
"18328","ENSG00000201969","15",25206262,25206343,81
"18329","ENSG00000201988","6",30736304,30736414,110
"18330","ENSG00000201998","11",9428773,9428954,181
"18331","ENSG00000201999","16",66301809,66301940,131
"18332","ENSG00000202000","4",88000237,88000401,164
"18333","ENSG00000202008","2",201423513,201423604,91
"18334","ENSG00000202014","4",48153434,48153535,101
"18335","ENSG00000202016","2",222498291,222498398,107
"18336","ENSG00000202017","5",60304047,60304151,104
"18337","ENSG00000202019","22",31230071,31230172,101
"18338","ENSG00000202027","1",155120490,155120598,108
"18339","ENSG00000202029","2",159027036,159027142,106
"18340","ENSG00000202034","12",62545582,62545679,97
"18341","ENSG00000202041","1",240154651,240154772,121
"18342","ENSG00000202044","6",152410275,152410394,119
"18343","ENSG00000202047","10",96619376,96619483,107
"18344","ENSG00000202048","14",100981004,100981075,71
"18345","ENSG00000202058","22",42565048,42565330,282
"18346","ENSG00000202059","2",203052285,203052418,133
"18347","ENSG00000202063","1",230820250,230820358,108
"18348","ENSG00000202070","11",70075363,70075469,106
"18349","ENSG00000202071","3",66003839,66003940,101
"18350","ENSG00000202078","1",160326104,160326216,112
"18351","ENSG00000202079","1",247294835,247294941,106
"18352","ENSG00000202081","15",85651522,85651628,106
"18353","ENSG00000202089","11",63882587,63882685,98
"18354","ENSG00000202095","8",96431054,96431160,106
"18355","ENSG00000202099","2",238412642,238412745,103
"18356","ENSG00000202100","17",32463374,32463482,108
"18357","ENSG00000202111","5",140718925,140719013,88
"18358","ENSG00000202119","6",150939222,150939328,106
"18359","ENSG00000202124","16",50098264,50098358,94
"18360","ENSG00000202125","3",142420205,142420369,164
"18361","ENSG00000202141","2",183022859,183022971,112
"18362","ENSG00000202142","14",100975825,100975896,71
"18363","ENSG00000202146","12",54099191,54099302,111
"18364","ENSG00000202150","20",35030317,35030420,103
"18365","ENSG00000202159","18",57755394,57755500,106
"18366","ENSG00000202169","4",61906313,61906408,95
"18367","ENSG00000202172","9",558826,558930,104
"18368","ENSG00000202174","2",132253154,132253305,151
"18369","ENSG00000202175","3",33491983,33492098,115
"18370","ENSG00000202184","1",246189014,246189118,104
"18371","ENSG00000202187","12",28505394,28505528,134
"18372","ENSG00000202188","15",25227109,25227190,81
"18373","ENSG00000202189","9",20786927,20787055,128
"18374","ENSG00000202190","10",60081741,60081854,113
"18375","ENSG00000202191","14",100924824,100924892,68
"18376","ENSG00000202193","16",53337453,53337571,118
"18377","ENSG00000202198","6",52995620,52995950,330
"18378","ENSG00000202205","17",29445300,29445400,100
"18379","ENSG00000202215","4",189709539,189709714,175
"18380","ENSG00000202217","9",74799895,74800222,327
"18381","ENSG00000202222","1",39881566,39881678,112
"18382","ENSG00000202227","2",48501922,48502024,102
"18383","ENSG00000202229","14",23156309,23156414,105
"18384","ENSG00000202237","13",28703702,28703807,105
"18385","ENSG00000202239","21",46525618,46525722,104
"18386","ENSG00000202248","2",11561661,11561779,118
"18387","ENSG00000202255","20",36668559,36668670,111
"18388","ENSG00000202259","1",100000637,100000739,102
"18389","ENSG00000202260","20",17576206,17576510,304
"18390","ENSG00000202265","8",57289552,57289649,97
"18391","ENSG00000202270","14",100968948,100969022,74
"18392","ENSG00000202272","X",23782210,23782310,100
"18393","ENSG00000202273","7",6212638,6212740,102
"18394","ENSG00000202275","14",103797272,103797348,76
"18395","ENSG00000202279","X",136816477,136816574,97
"18396","ENSG00000202285","6",106738948,106739054,106
"18397","ENSG00000202290","13",97362972,97363101,129
"18398","ENSG00000202296","7",56340231,56340337,106
"18399","ENSG00000202297","10",92334463,92334564,101
"18400","ENSG00000202309","2",39128826,39128927,101
"18401","ENSG00000202310","8",100158868,100158975,107
"18402","ENSG00000202314","11",93731502,93731574,72
"18403","ENSG00000202318","12",6234345,6234455,110
"18404","ENSG00000202322","3",50419781,50419899,118
"18405","ENSG00000202337","14",32203163,32203269,106
"18406","ENSG00000202343","6",149594625,149594759,134
"18407","ENSG00000202344","2",55951654,55952014,360
"18408","ENSG00000202347","13",113478915,113479078,163
"18409","ENSG00000202356","8",119891132,119891229,97
"18410","ENSG00000202357","19",11408772,11408880,108
"18411","ENSG00000202358","4",55885595,55885701,106
"18412","ENSG00000202360","8",101137959,101138313,354
"18413","ENSG00000202361","17",61874084,61874182,98
"18414","ENSG00000202368","12",96979528,96979629,101
"18415","ENSG00000202374","4",67747236,67747386,150
"18416","ENSG00000202382","2",85367585,85367686,101
"18417","ENSG00000202392","4",6997012,6997328,316
"18418","ENSG00000202399","8",97772313,97772425,112
"18419","ENSG00000202400","2",231460371,231460440,69
"18420","ENSG00000202402","14",31244761,31244861,100
"18421","ENSG00000202408","1",148334612,148334767,155
"18422","ENSG00000202410","X",94178005,94178106,101
"18423","ENSG00000202411","8",28530411,28530519,108
"18424","ENSG00000202412","3",129818932,129819033,101
"18425","ENSG00000202415","1",9947318,9947636,318
"18426","ENSG00000202417","5",132945342,132945454,112
"18427","ENSG00000202429","2",127472234,127472415,181
"18428","ENSG00000202430","2",24564630,24564738,108
"18429","ENSG00000202431","7",34297496,34297598,102
"18430","ENSG00000202434","2",197404718,197404854,136
"18431","ENSG00000202441","6",33199601,33199696,95
"18432","ENSG00000202445","9",94507738,94507844,106
"18433","ENSG00000202459","14",102695388,102695495,107
"18434","ENSG00000202461","1",12024012,12024124,112
"18435","ENSG00000202469","X",10061222,10061323,101
"18436","ENSG00000202470","12",95275770,95275872,102
"18437","ENSG00000202472","7",140386781,140386907,126
"18438","ENSG00000202474","9",62802320,62802438,118
"18439","ENSG00000202490","14",63618043,63618144,101
"18440","ENSG00000202497","16",69007052,69007155,103
"18441","ENSG00000202502","3",183258300,183258416,116
"18442","ENSG00000202508","10",13511206,13511313,107
"18443","ENSG00000202512","5",109699500,109699834,334
"18444","ENSG00000202513","10",72391964,72392069,105
"18445","ENSG00000202514","8",42949388,42949495,107
"18446","ENSG00000202515","5",140726158,140726246,88
"18447","ENSG00000202517","3",40238608,40238741,133
"18448","ENSG00000202522","11",72766004,72766116,112
"18449","ENSG00000202523","9",83992932,83993033,101
"18450","ENSG00000202533","5",132468147,132468257,110
"18451","ENSG00000202534","12",92952639,92952745,106
"18452","ENSG00000202538","12",120291763,120291903,140
"18453","ENSG00000202542","15",48325558,48325671,113
"18454","ENSG00000202560","14",101047321,101047398,77
"18455","ENSG00000202566","X",74218377,74218461,84
"18456","ENSG00000202569","10",102436512,102436584,72
"18457","ENSG00000202601","5",59703606,59703703,97
"18458","ENSG00000202609","1",177029363,177029445,82
"18459","ENSG00000203258","11",12921186,12922925,1739
"18460","ENSG00000203262","X",96070669,96071778,1109
"18461","ENSG00000203266","20",57110640,57122745,12105
"18462","ENSG00000203279","9",97200475,97238745,38270
"18463","ENSG00000203280","22",25102433,25112692,10259
"18464","ENSG00000203286","9",128745857,128746138,281
"18465","ENSG00000203288","1",151790804,151794402,3598
"18466","ENSG00000203307","1",166081183,166087483,6300
"18467","ENSG00000203321","9",74952968,74996293,43325
"18468","ENSG00000203325","1",32052291,32073474,21183
"18469","ENSG00000203326","19",53365693,53392217,26524
"18470","ENSG00000203327","2",55214387,55216126,1739
"18471","ENSG00000203334","11",108957718,108959797,2079
"18472","ENSG00000203335","7",154055286,154063325,8039
"18473","ENSG00000203356","1",51195095,51235096,40001
"18474","ENSG00000203362","6",43588230,43591362,3132
"18475","ENSG00000203363","2",85686053,85687047,994
"18476","ENSG00000203364","9",93147040,93148556,1516
"18477","ENSG00000203387","2",228352120,228353215,1095
"18478","ENSG00000203392","15",75678548,75680752,2204
"18479","ENSG00000203395","2",68361214,68365584,4370
"18480","ENSG00000203396","9",104328320,104329396,1076
"18481","ENSG00000203397","X",74066083,74066592,509
"18482","ENSG00000203402","X",47297852,47298721,869
"18483","ENSG00000203411","15",75120265,75120562,297
"18484","ENSG00000203413","8",84948585,84949674,1089
"18485","ENSG00000203414","10",13156684,13158136,1452
"18486","ENSG00000203416","22",17213516,17214155,639
"18487","ENSG00000203434","10",108547975,108561815,13840
"18488","ENSG00000203435","2",195994259,195995680,1421
"18489","ENSG00000203436","4",9711953,9712233,280
"18490","ENSG00000203437","12",31465062,31465842,780
"18491","ENSG00000203441","13",99499727,99501052,1325
"18492","ENSG00000203446","7",40538127,40546928,8801
"18493","ENSG00000203462","7",56322804,56323601,797
"18494","ENSG00000203472","16",75475896,75495407,19511
"18495","ENSG00000203485","14",104689606,104722535,32929
"18496","ENSG00000203489","6",75319101,75319980,879
"18497","ENSG00000203496","10",38453181,38466176,12995
"18498","ENSG00000203497","10",110869868,110872233,2365
"18499","ENSG00000203498","6",6993191,6995727,2536
"18500","ENSG00000203499","8",143734140,143790644,56504
"18501","ENSG00000203506","3",29526251,29642809,116558
"18502","ENSG00000203520","11",63616308,63621671,5363
"18503","ENSG00000203523","7",12491095,12492004,909
"18504","ENSG00000203527","22",43275955,43283830,7875
"18505","ENSG00000203531","2",222698623,222699484,861
"18506","ENSG00000203546","14",31334312,31457441,123129
"18507","ENSG00000203565","10",33684755,33709868,25113
"18508","ENSG00000203573","15",40585454,40585751,297
"18509","ENSG00000203581","16",3215611,3216543,932
"18510","ENSG00000203585","12",67443105,67590771,147666
"18511","ENSG00000203588","X",70163842,70165206,1364
"18512","ENSG00000203593","12",2004666,2011392,6726
"18513","ENSG00000203601","1",168903905,169087005,183100
"18514","ENSG00000203605","1",63139250,63163153,23903
"18515","ENSG00000203616","21",13936993,13937325,332
"18516","ENSG00000203620","1",31842019,31855568,13549
"18517","ENSG00000203635","2",1620510,1625419,4909
"18518","ENSG00000203643","2",11721619,11724222,2603
"18519","ENSG00000203644","3",129847048,129847957,909
"18520","ENSG00000203645","3",177294442,177323418,28976
"18521","ENSG00000203647","3",66008770,66009200,430
"18522","ENSG00000203648","12",2659937,2660969,1032
"18523","ENSG00000203650","X",118839539,118919669,80130
"18524","ENSG00000203663","1",248030070,248042305,12235
"18525","ENSG00000203664","1",247488093,247492415,4322
"18526","ENSG00000203666","1",244969705,245127164,157459
"18527","ENSG00000203667","1",244835616,244845057,9441
"18528","ENSG00000203668","1",241628853,241640254,11401
"18529","ENSG00000203684","1",228164086,228165512,1426
"18530","ENSG00000203685","1",226548764,226609230,60466
"18531","ENSG00000203688","6",167679626,167696290,16664
"18532","ENSG00000203690","6",167357031,167384510,27479
"18533","ENSG00000203697","1",223538007,223665734,127727
"18534","ENSG00000203705","1",212791828,212816830,25002
"18535","ENSG00000203706","1",210231456,210234047,2591
"18536","ENSG00000203709","1",207801518,207879115,77597
"18537","ENSG00000203710","1",207496147,207641765,145618
"18538","ENSG00000203711","6",158869848,158919105,49257
"18539","ENSG00000203721","1",200253419,200400705,147286
"18540","ENSG00000203722","6",149916878,149923121,6243
"18541","ENSG00000203724","1",197902630,197907367,4737
"18542","ENSG00000203727","6",147508690,147737547,228857
"18543","ENSG00000203729","1",182407621,182414815,7194
"18544","ENSG00000203730","1",182398117,182400616,2499
"18545","ENSG00000203734","6",138795926,138904070,108144
"18546","ENSG00000203737","1",174448074,174449545,1471
"18547","ENSG00000203739","1",173417793,173489407,71614
"18548","ENSG00000203740","1",170146001,170167790,21789
"18549","ENSG00000203747","1",161541759,161550737,8978
"18550","ENSG00000203756","6",129831244,129861547,30303
"18551","ENSG00000203757","1",158716327,158720720,4393
"18552","ENSG00000203758","1",158445068,158446014,946
"18553","ENSG00000203760","6",126340174,126348875,8701
"18554","ENSG00000203761","1",155745829,155750137,4308
"18555","ENSG00000203772","10",133420666,133424572,3906
"18556","ENSG00000203778","6",112087591,112102790,15199
"18557","ENSG00000203780","10",125896539,126009592,113053
"18558","ENSG00000203782","1",153259687,153262124,2437
"18559","ENSG00000203783","1",153217584,153219310,1726
"18560","ENSG00000203784","1",153203430,153205120,1690
"18561","ENSG00000203785","1",153093135,153106184,13049
"18562","ENSG00000203786","1",152759561,152762052,2491
"18563","ENSG00000203791","10",124748149,124791887,43738
"18564","ENSG00000203795","10",122910701,122913111,2410
"18565","ENSG00000203797","6",110391771,110415575,23804
"18566","ENSG00000203799","6",109165831,109355063,189232
"18567","ENSG00000203801","6",108751654,108769942,18288
"18568","ENSG00000203804","1",150560202,150574552,14350
"18569","ENSG00000203805","10",120456954,120589855,132901
"18570","ENSG00000203808","6",105136308,105169952,33644
"18571","ENSG00000203809","6",104864464,104941447,76983
"18572","ENSG00000203814","1",149782689,149812373,29684
"18573","ENSG00000203825","1",143541768,143572834,31066
"18574","ENSG00000203837","10",116427847,116477957,50110
"18575","ENSG00000203855","1",119564066,119572067,8001
"18576","ENSG00000203857","1",119507198,119515054,7856
"18577","ENSG00000203858","1",119439001,119446086,7085
"18578","ENSG00000203859","1",119414931,119423035,8104
"18579","ENSG00000203865","1",116390575,116418635,28060
"18580","ENSG00000203867","10",110644336,110839468,195132
"18581","ENSG00000203870","X",154823348,154834662,11314
"18582","ENSG00000203872","6",87344813,87365463,20650
"18583","ENSG00000203875","6",85650491,85678932,28441
"18584","ENSG00000203876","10",109940104,110008381,68277
"18585","ENSG00000203877","6",83853266,83857515,4249
"18586","ENSG00000203878","1",111280059,111286116,6057
"18587","ENSG00000203879","X",154436913,154443467,6554
"18588","ENSG00000203880","20",64255695,64287821,32126
"18589","ENSG00000203883","20",64047582,64049639,2057
"18590","ENSG00000203896","20",63736283,63739103,2820
"18591","ENSG00000203897","1",108857217,108858524,1307
"18592","ENSG00000203900","20",63359988,63371177,11189
"18593","ENSG00000203907","6",73368555,73395133,26578
"18594","ENSG00000203908","6",73362658,73364171,1513
"18595","ENSG00000203909","6",73353063,73354276,1213
"18596","ENSG00000203910","1",92217915,92245813,27898
"18597","ENSG00000203914","1",91642516,91644082,1566
"18598","ENSG00000203923","X",145246828,145256112,9284
"18599","ENSG00000203930","X",140709562,140793215,83653
"18600","ENSG00000203933","X",139955725,139965520,9795
"18601","ENSG00000203942","10",97589727,97590934,1207
"18602","ENSG00000203943","1",84298366,84389957,91591
"18603","ENSG00000203950","X",135050932,135052196,1264
"18604","ENSG00000203952","X",134237047,134246207,9160
"18605","ENSG00000203963","1",67092165,67231853,139688
"18606","ENSG00000203965","1",63523372,63572693,49321
"18607","ENSG00000203970","6",50009138,50021981,12843
"18608","ENSG00000203971","20",57957126,57960176,3050
"18609","ENSG00000203972","6",49499923,49528078,28155
"18610","ENSG00000203985","1",54007298,54018186,10888
"18611","ENSG00000203987","9",137867925,137892570,24645
"18612","ENSG00000203989","X",120070672,120077705,7033
"18613","ENSG00000203993","9",137615332,137618906,3574
"18614","ENSG00000203995","1",52842511,52894998,52487
"18615","ENSG00000203999","20",50292709,50315488,22779
"18616","ENSG00000204001","9",136754386,136758543,4157
"18617","ENSG00000204003","9",136738167,136748453,10286
"18618","ENSG00000204006","1",51102221,51148086,45865
"18619","ENSG00000204007","9",135623656,135639540,15884
"18620","ENSG00000204010","10",89378056,89385205,7149
"18621","ENSG00000204011","9",134649385,134652843,3458
"18622","ENSG00000204019","X",116461686,116462976,1290
"18623","ENSG00000204020","10",88761406,88778242,16836
"18624","ENSG00000204022","10",88586753,88606976,20223
"18625","ENSG00000204025","X",111876051,111903990,27939
"18626","ENSG00000204031","9",133317794,133318469,675
"18627","ENSG00000204033","10",84220495,84225589,5094
"18628","ENSG00000204044","20",46013500,46022073,8573
"18629","ENSG00000204049","10",77866875,77869610,2735
"18630","ENSG00000204052","6",43506969,43510686,3717
"18631","ENSG00000204053","X",107272582,107273656,1074
"18632","ENSG00000204054","9",129476946,129513687,36741
"18633","ENSG00000204055","9",129176771,129210548,33777
"18634","ENSG00000204060","1",41361922,41383590,21668
"18635","ENSG00000204065","X",103273691,103276750,3059
"18636","ENSG00000204070","20",45361937,45376798,14861
"18637","ENSG00000204071","X",102140476,102142970,2494
"18638","ENSG00000204084","1",37860697,37947057,86360
"18639","ENSG00000204086","X",96883908,96885467,1559
"18640","ENSG00000204091","6",40334775,40387590,52815
"18641","ENSG00000204092","6",40344344,40346151,1807
"18642","ENSG00000204099","2",241808825,241817413,8588
"18643","ENSG00000204103","20",40685848,40689236,3388
"18644","ENSG00000204104","2",238320441,238400897,80456
"18645","ENSG00000204110","6",37507348,37535616,28268
"18646","ENSG00000204113","X",74185929,74187153,1224
"18647","ENSG00000204116","X",73563200,73687102,123902
"18648","ENSG00000204117","20",37676889,37683234,6345
"18649","ENSG00000204118","X",73126037,73128080,2043
"18650","ENSG00000204120","2",232697299,232860575,163276
"18651","ENSG00000204121","2",232415818,232419816,3998
"18652","ENSG00000204128","2",231037523,231049719,12196
"18653","ENSG00000204130","10",68341107,68407294,66187
"18654","ENSG00000204131","X",71910818,72161750,250932
"18655","ENSG00000204136","9",121444991,121500027,55036
"18656","ENSG00000204138","1",28369582,28500364,130782
"18657","ENSG00000204140","6",35781019,35793675,12656
"18658","ENSG00000204147","10",50739318,50816495,77177
"18659","ENSG00000204148","9",115888169,115925207,37038
"18660","ENSG00000204149","10",49988318,50010499,22181
"18661","ENSG00000204152","10",49942049,49974850,32801
"18662","ENSG00000204160","1",26826688,26857604,30916
"18663","ENSG00000204161","10",49154725,49188585,33860
"18664","ENSG00000204165","X",71103889,71106788,2899
"18665","ENSG00000204172","10",47501854,47523638,21784
"18666","ENSG00000204173","9",111602831,111631289,28458
"18667","ENSG00000204174","10",46461099,46465881,4782
"18668","ENSG00000204175","10",46549044,46555530,6486
"18669","ENSG00000204176","10",46578217,46594173,15956
"18670","ENSG00000204177","10",46786674,46811989,25315
"18671","ENSG00000204178","1",25430858,25500209,69351
"18672","ENSG00000204179","10",46911396,47002488,91092
"18673","ENSG00000204183","20",35433029,35435450,2421
"18674","ENSG00000204186","2",206274663,206314427,39764
"18675","ENSG00000204188","6",33540046,33589026,48980
"18676","ENSG00000204193","9",110303521,110337884,34363
"18677","ENSG00000204194","6",33400059,33400556,497
"18678","ENSG00000204195","X",70234655,70240627,5972
"18679","ENSG00000204209","6",33318558,33323016,4458
"18680","ENSG00000204217","2",202376180,202567751,191571
"18681","ENSG00000204219","1",23381061,23424740,43679
"18682","ENSG00000204220","6",33289302,33298401,9099
"18683","ENSG00000204227","6",33208500,33212722,4222
"18684","ENSG00000204228","6",33204655,33206831,2176
"18685","ENSG00000204231","6",33193588,33200688,7100
"18686","ENSG00000204237","17",81665036,81666635,1599
"18687","ENSG00000204241","11",134032216,134067936,35720
"18688","ENSG00000204246","9",104535749,104536856,1107
"18689","ENSG00000204248","6",33162681,33192499,29818
"18690","ENSG00000204252","6",33004182,33009591,5409
"18691","ENSG00000204253","2",189923336,189924216,880
"18692","ENSG00000204256","6",32968594,32981505,12911
"18693","ENSG00000204257","6",32948613,32969094,20481
"18694","ENSG00000204261","6",32844078,32846500,2422
"18695","ENSG00000204262","2",189031898,189225312,193414
"18696","ENSG00000204264","6",32840717,32844679,3962
"18697","ENSG00000204267","6",32821833,32838770,16937
"18698","ENSG00000204271","X",56818298,56995827,177529
"18699","ENSG00000204272","X",56729241,56818380,89139
"18700","ENSG00000204277","17",78261349,78278492,17143
"18701","ENSG00000204278","17",78231310,78240987,9677
"18702","ENSG00000204279","X",55258412,55264846,6434
"18703","ENSG00000204282","17",78107398,78111799,4401
"18704","ENSG00000204283","17",77877330,77884119,6789
"18705","ENSG00000204287","6",32439878,32445046,5168
"18706","ENSG00000204290","6",32393963,32407128,13165
"18707","ENSG00000204291","9",98943179,99070792,127613
"18708","ENSG00000204296","6",32288526,32371912,83386
"18709","ENSG00000204300","11",123882920,123885670,2750
"18710","ENSG00000204301","6",32194843,32224067,29224
"18711","ENSG00000204304","6",32184733,32190202,5469
"18712","ENSG00000204305","6",32180968,32184322,3354
"18713","ENSG00000204308","6",32178405,32180793,2388
"18714","ENSG00000204310","6",32168212,32178096,9884
"18715","ENSG00000204311","2",178451346,178461409,10063
"18716","ENSG00000204314","6",32148359,32153083,4724
"18717","ENSG00000204315","6",32128707,32130288,1581
"18718","ENSG00000204316","17",75898643,75905413,6770
"18719","ENSG00000204323","17",75633434,75641404,7970
"18720","ENSG00000204334","2",170783786,170798971,15185
"18721","ENSG00000204335","2",170715351,170718078,2727
"18722","ENSG00000204338","6",32005636,32008451,2815
"18723","ENSG00000204344","6",31971091,31982821,11730
"18724","ENSG00000204345","17",74579365,74592283,12918
"18725","ENSG00000204347","17",74356416,74361868,5452
"18726","ENSG00000204348","6",31969810,31972290,2480
"18727","ENSG00000204351","6",31959117,31969751,10634
"18728","ENSG00000204352","9",93318199,93346414,28215
"18729","ENSG00000204356","6",31952087,31959038,6951
"18730","ENSG00000204361","11",114678386,114707069,28683
"18731","ENSG00000204362","1",17189783,17197617,7834
"18732","ENSG00000204363","X",52796144,52798101,1957
"18733","ENSG00000204366","6",31899607,31901992,2385
"18734","ENSG00000204368","X",48212791,48218010,5219
"18735","ENSG00000204370","11",112086824,112120016,33192
"18736","ENSG00000204371","6",31879759,31897687,17928
"18737","ENSG00000204379","X",52495676,52500812,5136
"18738","ENSG00000204380","2",158658337,158735002,76665
"18739","ENSG00000204381","11",111540280,111561745,21465
"18740","ENSG00000204382","X",52512077,52520803,8726
"18741","ENSG00000204385","6",31863192,31879046,15854
"18742","ENSG00000204386","6",31857659,31862906,5247
"18743","ENSG00000204387","6",31834608,31839766,5158
"18744","ENSG00000204388","6",31827738,31830254,2516
"18745","ENSG00000204389","6",31815464,31817946,2482
"18746","ENSG00000204390","6",31809619,31815283,5664
"18747","ENSG00000204392","6",31797396,31806966,9570
"18748","ENSG00000204393","20",32564992,32608893,43901
"18749","ENSG00000204394","6",31777518,31795752,18234
"18750","ENSG00000204396","6",31765590,31777294,11704
"18751","ENSG00000204397","11",105041326,105101431,60105
"18752","ENSG00000204398","13",111588201,111672608,84407
"18753","ENSG00000204403","11",104885718,104898670,12952
"18754","ENSG00000204406","2",148021011,148516971,495960
"18755","ENSG00000204410","6",31739677,31762678,23001
"18756","ENSG00000204420","6",31718594,31726714,8120
"18757","ENSG00000204421","6",31718648,31721746,3098
"18758","ENSG00000204422","6",31686962,31714072,27110
"18759","ENSG00000204424","6",31706885,31710595,3710
"18760","ENSG00000204427","6",31686955,31703356,16401
"18761","ENSG00000204428","6",31676684,31684040,7356
"18762","ENSG00000204429","9",88180673,88181447,774
"18763","ENSG00000204434","2",131591752,131628147,36395
"18764","ENSG00000204435","6",31665236,31670343,5107
"18765","ENSG00000204437","10",79870375,79873903,3528
"18766","ENSG00000204438","6",31661228,31666283,5055
"18767","ENSG00000204439","6",31658298,31660772,2474
"18768","ENSG00000204442","13",107163510,107866735,703225
"18769","ENSG00000204444","6",31652416,31658210,5794
"18770","ENSG00000204446","9",87148644,87159556,10912
"18771","ENSG00000204449","11",90031106,90042025,10919
"18772","ENSG00000204455","11",89854953,89862893,7940
"18773","ENSG00000204456","11",89766440,89768836,2396
"18774","ENSG00000204460","2",129242173,129273848,31675
"18775","ENSG00000204463","6",31639028,31652705,13677
"18776","ENSG00000204464","1",15164344,15171317,6973
"18777","ENSG00000204469","6",31620720,31637771,17051
"18778","ENSG00000204471","17",18393480,18400961,7481
"18779","ENSG00000204472","6",31615217,31617021,1804
"18780","ENSG00000204475","6",31588895,31593006,4111
"18781","ENSG00000204478","1",13410450,13421328,10878
"18782","ENSG00000204479","1",13389632,13392629,2997
"18783","ENSG00000204480","1",13369067,13371900,2833
"18784","ENSG00000204481","1",13342034,13347134,5100
"18785","ENSG00000204482","6",31586124,31588909,2785
"18786","ENSG00000204498","6",31546870,31558829,11959
"18787","ENSG00000204501","1",13315581,13322598,7017
"18788","ENSG00000204511","6",31528962,31530232,1270
"18789","ENSG00000204514","19",57848731,57889074,40343
"18790","ENSG00000204516","6",31494881,31511124,16243
"18791","ENSG00000204518","1",12644547,12667086,22539
"18792","ENSG00000204519","19",57681969,57717301,35332
"18793","ENSG00000204520","6",31399784,31415315,15531
"18794","ENSG00000204524","19",57240632,57262728,22096
"18795","ENSG00000204525","6",31268749,31272130,3381
"18796","ENSG00000204528","6",31173735,31177899,4164
"18797","ENSG00000204529","11",76694041,76719801,25760
"18798","ENSG00000204531","6",31164337,31180731,16394
"18799","ENSG00000204532","19",56202301,56209452,7151
"18800","ENSG00000204536","6",31142439,31158238,15799
"18801","ENSG00000204538","6",31137534,31139066,1532
"18802","ENSG00000204539","6",31115087,31120446,5359
"18803","ENSG00000204540","6",31114750,31140092,25342
"18804","ENSG00000204542","6",31111223,31112559,1336
"18805","ENSG00000204544","6",30983718,30989903,6185
"18806","ENSG00000204547","20",31421436,31429180,7744
"18807","ENSG00000204548","20",31404845,31412838,7993
"18808","ENSG00000204556","20",26018832,26020684,1852
"18809","ENSG00000204560","6",30653119,30673006,19887
"18810","ENSG00000204564","6",30647039,30653210,6171
"18811","ENSG00000204568","6",30617840,30626395,8555
"18812","ENSG00000204569","6",30600413,30618612,18199
"18813","ENSG00000204571","11",71579714,71603353,23639
"18814","ENSG00000204572","11",71565563,71566738,1175
"18815","ENSG00000204574","6",30571393,30597179,25786
"18816","ENSG00000204576","6",30556886,30563723,6837
"18817","ENSG00000204577","19",54216278,54223506,7228
"18818","ENSG00000204580","6",30876421,30900156,23735
"18819","ENSG00000204581","2",111098345,111116407,18062
"18820","ENSG00000204583","12",132603150,132610582,7432
"18821","ENSG00000204584","17",49845910,49848837,2927
"18822","ENSG00000204588","2",109987063,109996140,9077
"18823","ENSG00000204590","6",30541377,30557174,15797
"18824","ENSG00000204592","6",30489509,30494194,4685
"18825","ENSG00000204595","19",53632056,53637009,4953
"18826","ENSG00000204599","6",30326479,30343729,17250
"18827","ENSG00000204603","12",131165011,131232940,67929
"18828","ENSG00000204604","19",52838010,52890375,52365
"18829","ENSG00000204610","6",30163206,30172693,9487
"18830","ENSG00000204611","19",52113091,52139938,26847
"18831","ENSG00000204613","6",30151943,30161211,9268
"18832","ENSG00000204614","6",30136124,30148735,12611
"18833","ENSG00000204616","6",30102897,30113090,10193
"18834","ENSG00000204618","6",30070266,30075887,5621
"18835","ENSG00000204619","6",30066709,30070333,3624
"18836","ENSG00000204620","X",48568014,48574860,6846
"18837","ENSG00000204622","6",30005971,30009956,3985
"18838","ENSG00000204623","6",30001011,30061640,60629
"18839","ENSG00000204624","1",11479155,11537551,58396
"18840","ENSG00000204625","6",29975112,29978410,3298
"18841","ENSG00000204628","5",181236909,181248096,11187
"18842","ENSG00000204632","6",29826967,29831125,4158
"18843","ENSG00000204634","2",101007617,101252866,245249
"18844","ENSG00000204642","6",29722775,29738528,15753
"18845","ENSG00000204644","6",29672392,29681110,8718
"18846","ENSG00000204650","17",45620328,45655156,34828
"18847","ENSG00000204652","17",45608571,45608918,347
"18848","ENSG00000204653","19",50511600,50514690,3090
"18849","ENSG00000204655","6",29657002,29672372,15370
"18850","ENSG00000204657","6",29585121,29590500,5379
"18851","ENSG00000204659","5",179678560,179681034,2474
"18852","ENSG00000204661","5",179641544,179645046,3502
"18853","ENSG00000204662","20",23547764,23550652,2888
"18854","ENSG00000204663","20",23519146,23542018,22872
"18855","ENSG00000204666","19",50050589,50066793,16204
"18856","ENSG00000204669","9",72051376,72072721,21345
"18857","ENSG00000204670","2",97060128,97060415,287
"18858","ENSG00000204671","12",122172030,122174199,2169
"18859","ENSG00000204673","19",49869033,49878459,9426
"18860","ENSG00000204677","5",178006348,178086529,80181
"18861","ENSG00000204681","6",29555629,29633976,78347
"18862","ENSG00000204682","10",21492658,21497284,4626
"18863","ENSG00000204683","10",21125763,21146559,20796
"18864","ENSG00000204684","20",22371216,22471557,100341
"18865","ENSG00000204685","2",96208403,96243353,34950
"18866","ENSG00000204687","6",29486697,29487956,1259
"18867","ENSG00000204688","6",29457181,29464328,7147
"18868","ENSG00000204694","6",29425504,29457071,31567
"18869","ENSG00000204695","6",29301701,29313017,11316
"18870","ENSG00000204697","6",29262703,29264079,1376
"18871","ENSG00000204700","6",29170907,29175811,4904
"18872","ENSG00000204701","6",29108059,29114770,6711
"18873","ENSG00000204704","6",29044213,29045240,1027
"18874","ENSG00000204705","2",95450310,95451500,1190
"18875","ENSG00000204706","9",70033921,70175888,141967
"18876","ENSG00000204709","6",28943877,28944537,660
"18877","ENSG00000204710","11",65170154,65173244,3090
"18878","ENSG00000204711","9",69820817,69906227,85410
"18879","ENSG00000204713","6",28903002,28923988,20986
"18880","ENSG00000204718","13",18726706,18727414,708
"18881","ENSG00000204740","10",19048801,19790401,741600
"18882","ENSG00000204745","2",87125198,87196629,71431
"18883","ENSG00000204754","5",174919082,174995513,76431
"18884","ENSG00000204758","5",172954786,172959392,4606
"18885","ENSG00000204764","5",170861870,171300015,438145
"18886","ENSG00000204767","5",169861303,169980495,119192
"18887","ENSG00000204776","9",65770955,65771434,479
"18888","ENSG00000204778","9",65287914,65323015,35101
"18889","ENSG00000204779","9",65282101,65285209,3108
"18890","ENSG00000204780","9",65250543,65250826,283
"18891","ENSG00000204789","6",27357825,27360221,2396
"18892","ENSG00000204790","9",63974762,64004155,29393
"18893","ENSG00000204791","8",144049079,144051522,2443
"18894","ENSG00000204792","2",74918148,74938418,20270
"18895","ENSG00000204802","9",62374128,62376836,2708
"18896","ENSG00000204805","9",61861625,61863200,1575
"18897","ENSG00000204814","9",61659733,61662690,2957
"18898","ENSG00000204815","17",41930617,41966503,35886
"18899","ENSG00000204818","9",42795392,42800672,5280
"18900","ENSG00000204822","2",74471982,74472687,705
"18901","ENSG00000204832","10",17386919,17445758,58839
"18902","ENSG00000204837","9",39816542,40106661,290119
"18903","ENSG00000204839","8",143566192,143572772,6580
"18904","ENSG00000204842","12",111443485,111599676,156191
"18905","ENSG00000204843","2",74361154,74392087,30933
"18906","ENSG00000204849","9",39355669,39361959,6290
"18907","ENSG00000204850","19",46494508,46496502,1994
"18908","ENSG00000204851","19",46486906,46496498,9592
"18909","ENSG00000204852","12",110614027,110649430,35403
"18910","ENSG00000204856","12",110468415,110490385,21970
"18911","ENSG00000204859","1",6579994,6589280,9286
"18912","ENSG00000204860","9",38620474,38624990,4516
"18913","ENSG00000204866","19",46143106,46161299,18193
"18914","ENSG00000204869","19",46039748,46077118,37370
"18915","ENSG00000204872","2",73700576,73701340,764
"18916","ENSG00000204876","7",155962632,155966343,3711
"18917","ENSG00000204882","8",141356500,141367267,10767
"18918","ENSG00000204889","17",40977716,40987135,9419
"18919","ENSG00000204894","7",152367171,152367260,89
"18920","ENSG00000204897","17",40748021,40755332,7311
"18921","ENSG00000204899","13",72708367,72727629,19262
"18922","ENSG00000204904","X",46887417,46899703,12286
"18923","ENSG00000204909","5",148321203,148339852,18649
"18924","ENSG00000204913","17",39941474,39944734,3260
"18925","ENSG00000204915","X",45730752,45731688,936
"18926","ENSG00000204920","19",43967862,43998326,30464
"18927","ENSG00000204922","11",62670273,62673686,3413
"18928","ENSG00000204923","2",68459422,68467294,7872
"18929","ENSG00000204928","5",145858521,145937126,78605
"18930","ENSG00000204929","2",65436711,66200373,763662
"18931","ENSG00000204930","9",35816391,35828747,12356
"18932","ENSG00000204933","19",43372742,43379123,6381
"18933","ENSG00000204934","7",149867697,149880610,12913
"18934","ENSG00000204936","19",43353686,43363172,9486
"18935","ENSG00000204941","19",43166256,43186536,20280
"18936","ENSG00000204946","7",149262171,149297302,35131
"18937","ENSG00000204947","7",149102784,149126324,23540
"18938","ENSG00000204949","8",123196536,123202743,6207
"18939","ENSG00000204950","11",61508749,61511018,2269
"18940","ENSG00000204952","17",38936432,38967402,30970
"18941","ENSG00000204954","12",103940763,103965708,24945
"18942","ENSG00000204956","5",141330571,141512981,182410
"18943","ENSG00000204959","7",144272445,144286966,14521
"18944","ENSG00000204960","7",155356985,155367934,10949
"18945","ENSG00000204961","5",140847463,141012344,164881
"18946","ENSG00000204962","5",140841187,141012347,171160
"18947","ENSG00000204963","5",140834248,141012347,178099
"18948","ENSG00000204965","5",140821604,141012347,190743
"18949","ENSG00000204967","5",140806929,141012347,205418
"18950","ENSG00000204969","5",140794852,141012347,217495
"18951","ENSG00000204970","5",140786136,141012347,226211
"18952","ENSG00000204971","11",72163322,72209241,45919
"18953","ENSG00000204977","13",49995888,50020481,24593
"18954","ENSG00000204978","19",41443158,41444765,1607
"18955","ENSG00000204979","11",60515413,60542721,27308
"18956","ENSG00000204982","9",33613848,33614009,161
"18957","ENSG00000204983","7",142749468,142753076,3608
"18958","ENSG00000204990","7",141414383,141416390,2007
"18959","ENSG00000204991","16",89818179,89871319,53140
"18960","ENSG00000204993","2",52570648,52572522,1874
"18961","ENSG00000205002","8",116938199,116944487,6288
"18962","ENSG00000205015","16",89166383,89169147,2764
"18963","ENSG00000205018","16",88939789,88951524,11735
"18964","ENSG00000205022","16",88863333,88866660,3327
"18965","ENSG00000205025","11",56801856,56820422,18566
"18966","ENSG00000205035","11",49558546,49810419,251873
"18967","ENSG00000205037","16",88088041,88100985,12944
"18968","ENSG00000205038","8",109362461,109537207,174746
"18969","ENSG00000205041","19",40273489,40275479,1990
"18970","ENSG00000205044","11",49009959,49018589,8630
"18971","ENSG00000205045","17",35464249,35522379,58130
"18972","ENSG00000205054","2",45164816,45323397,158581
"18973","ENSG00000205056","12",92466451,92492091,25640
"18974","ENSG00000205057","12",92420094,92428148,8054
"18975","ENSG00000205060","7",134289332,134316930,27598
"18976","ENSG00000205076","19",38770971,38773492,2521
"18977","ENSG00000205078","16",77199397,77213215,13818
"18978","ENSG00000205084","16",75536741,75556268,19527
"18979","ENSG00000205085","7",128672288,128687872,15584
"18980","ENSG00000205086","2",41935368,41956806,21438
"18981","ENSG00000205089","5",132747445,132754403,6958
"18982","ENSG00000205090","1",1534778,1540624,5846
"18983","ENSG00000205097","4",190024351,190027257,2906
"18984","ENSG00000205100","4",189472965,189475192,2227
"18985","ENSG00000205105","13",46490930,46491121,191
"18986","ENSG00000205106","11",45771432,45772358,926
"18987","ENSG00000205108","9",34723055,34729467,6412
"18988","ENSG00000205111","2",39175646,39229588,53942
"18989","ENSG00000205116","1",1426128,1427787,1659
"18990","ENSG00000205126","11",44047981,44059977,11996
"18991","ENSG00000205129","4",185426249,185449826,23577
"18992","ENSG00000205133","8",92883530,93017673,134143
"18993","ENSG00000205138","19",35995199,35996315,1116
"18994","ENSG00000205143","9",34621379,34628107,6728
"18995","ENSG00000205155","19",35745600,35747519,1919
"18996","ENSG00000205174","7",108883975,108884587,612
"18997","ENSG00000205176","8",85656442,85663497,7055
"18998","ENSG00000205177","11",33698261,33700801,2540
"18999","ENSG00000205181","20",5482736,5526709,43973
"19000","ENSG00000205184","8",81634357,81635662,1305
"19001","ENSG00000205186","8",81458383,81461579,3196
"19002","ENSG00000205189","8",80485619,80526265,40646
"19003","ENSG00000205208","4",158666675,158672255,5580
"19004","ENSG00000205209","19",34593329,34675699,82370
"19005","ENSG00000205212","17",20836447,20896140,59693
"19006","ENSG00000205213","11",27365961,27472790,106829
"19007","ENSG00000205215","17",20519312,20528687,9375
"19008","ENSG00000205220","16",67934506,67936864,2358
"19009","ENSG00000205221","2",36696690,36814792,118102
"19010","ENSG00000205231","1",1173056,1179555,6499
"19011","ENSG00000205236","7",102582523,102642869,60346
"19012","ENSG00000205238","7",102551232,102562308,11076
"19013","ENSG00000205240","13",41431248,41432201,953
"19014","ENSG00000205250","16",67192155,67198918,6763
"19015","ENSG00000205266","17",18415728,18425097,9369
"19016","ENSG00000205267","7",101201809,101203526,1717
"19017","ENSG00000205268","8",65717510,65842322,124812
"19018","ENSG00000205269","6",11537749,11583524,45775
"19019","ENSG00000205274","9",33617762,33618506,744
"19020","ENSG00000205277","7",100969623,101018949,49326
"19021","ENSG00000205279","5",127649044,127658630,9586
"19022","ENSG00000205293","8",57855500,57984126,128626
"19023","ENSG00000205300","20",4070152,4075165,5013
"19024","ENSG00000205301","4",140442262,140498377,56115
"19025","ENSG00000205302","5",122775079,122834543,59464
"19026","ENSG00000205307","7",100572228,100573900,1672
"19027","ENSG00000205309","17",17303335,17347663,44328
"19028","ENSG00000205312","17",16847635,16852777,5142
"19029","ENSG00000205318","6",10633762,10634695,933
"19030","ENSG00000205323","12",55752463,55817724,65261
"19031","ENSG00000205325","17",14767583,14780363,12780
"19032","ENSG00000205327","12",55492378,55493316,938
"19033","ENSG00000205329","12",55330043,55332687,2644
"19034","ENSG00000205333","8",86657388,86660293,2905
"19035","ENSG00000205334","2",27705786,27715732,9946
"19036","ENSG00000205336","16",57610652,57665580,54928
"19037","ENSG00000205339","11",9384652,9448127,63475
"19038","ENSG00000205352","12",53441678,53446645,4967
"19039","ENSG00000205356","7",98214624,98252251,37627
"19040","ENSG00000205358","16",56669814,56671129,1315
"19041","ENSG00000205359","5",102371782,102499016,127234
"19042","ENSG00000205360","16",56648248,56649514,1266
"19043","ENSG00000205361","16",56643705,56644786,1081
"19044","ENSG00000205362","16",56638666,56640087,1421
"19045","ENSG00000205363","15",73735431,73752747,17316
"19046","ENSG00000205364","16",56632659,56633981,1322
"19047","ENSG00000205396","19",16015287,16027462,12175
"19048","ENSG00000205403","4",109740694,109802179,61485
"19049","ENSG00000205409","11",5840928,5841952,1024
"19050","ENSG00000205412","3",148166344,148167298,954
"19051","ENSG00000205413","7",93099513,93118023,18510
"19052","ENSG00000205414","16",50606076,50613684,7608
"19053","ENSG00000205420","12",52487176,52493257,6081
"19054","ENSG00000205423","16",50024410,50037088,12678
"19055","ENSG00000205424","21",45827961,45837987,10026
"19056","ENSG00000205426","12",52285913,52291534,5621
"19057","ENSG00000205436","14",103100144,103110559,10415
"19058","ENSG00000205442","9",24542952,24545946,2994
"19059","ENSG00000205444","6",4610612,4611919,1307
"19060","ENSG00000205445","21",44550357,44551505,1148
"19061","ENSG00000205449","5",86282460,86296463,14003
"19062","ENSG00000205452","16",33964547,33976346,11799
"19063","ENSG00000205456","16",32252719,32255922,3203
"19064","ENSG00000205457","16",33193659,33196858,3199
"19065","ENSG00000205464","5",82279462,82386977,107515
"19066","ENSG00000205476","14",99500190,99604207,104017
"19067","ENSG00000205482","7",77052785,77060512,7727
"19068","ENSG00000205485","7",76549360,76627982,78622
"19069","ENSG00000205488","10",5510036,5526246,16210
"19070","ENSG00000205494","11",5120621,5124513,3892
"19071","ENSG00000205500","2",26984776,27014612,29836
"19072","ENSG00000205502","15",62163535,62165285,1750
"19073","ENSG00000205517","19",11384341,11419342,35001
"19074","ENSG00000205531","11",2944431,2992377,47946
"19075","ENSG00000205534","16",29527568,29594966,67398
"19076","ENSG00000205537","12",47882649,47901525,18876
"19077","ENSG00000205542","X",12975110,12977227,2117
"19078","ENSG00000205544","17",7402975,7404097,1122
"19079","ENSG00000205549","9",16203935,16410990,207055
"19080","ENSG00000205559","22",50583026,50595634,12608
"19081","ENSG00000205560","22",50568861,50578465,9604
"19082","ENSG00000205562","14",85518871,85531585,12714
"19083","ENSG00000205571","5",70049612,70078522,28910
"19084","ENSG00000205572","5",70025247,70043113,17866
"19085","ENSG00000205578","7",73293497,73301161,7664
"19086","ENSG00000205579","14",81246295,81246563,268
"19087","ENSG00000205581","21",39342315,39349647,7332
"19088","ENSG00000205583","7",75359194,75395383,36189
"19089","ENSG00000205584","7",72969814,72971727,1913
"19090","ENSG00000205592","12",40393395,40570832,177437
"19091","ENSG00000205593","22",50309030,50327012,17982
"19092","ENSG00000205596","7",66070904,66071318,414
"19093","ENSG00000205609","16",28379579,28403879,24300
"19094","ENSG00000205611","20",30278906,30289956,11050
"19095","ENSG00000205622","21",38812878,38956467,143589
"19096","ENSG00000205625","6",154706643,154707795,1152
"19097","ENSG00000205628","7",53655508,53811952,156444
"19098","ENSG00000205629","16",25111731,25178231,66500
"19099","ENSG00000205632","22",48866770,48898386,31616
"19100","ENSG00000205634","22",47612231,47631569,19338
"19101","ENSG00000205636","9",13927971,13945610,17639
"19102","ENSG00000205639","2",24010081,24063321,53240
"19103","ENSG00000205642","X",8464830,8466510,1680
"19104","ENSG00000205643","22",46244011,46250311,6300
"19105","ENSG00000205649","4",70028413,70036538,8125
"19106","ENSG00000205653","6",203313,206392,3079
"19107","ENSG00000205659","14",74084796,74201235,116439
"19108","ENSG00000205667","X",3006613,3033571,26958
"19109","ENSG00000205669","14",73610945,73619888,8943
"19110","ENSG00000205670","21",34375480,34416961,41481
"19111","ENSG00000205678","4",64275257,64409468,134211
"19112","ENSG00000205682","4",61420246,61428221,7975
"19113","ENSG00000205683","14",72619296,72894116,274820
"19114","ENSG00000205693","12",27762738,27771276,8538
"19115","ENSG00000205696","10",1526637,1556984,30347
"19116","ENSG00000205702","22",42140203,42149455,9252
"19117","ENSG00000205704","22",41952174,41958933,6759
"19118","ENSG00000205707","12",25195216,25209645,14429
"19119","ENSG00000205710","17",4899418,4902934,3516
"19120","ENSG00000205716","2",102249857,102250255,398
"19121","ENSG00000205726","21",33642400,33899861,257461
"19122","ENSG00000205730","16",19113932,19121629,7697
"19123","ENSG00000205740","10",971146,988341,17195
"19124","ENSG00000205744","19",6467207,6482557,15350
"19125","ENSG00000205745","7",36079084,36085736,6652
"19126","ENSG00000205746","16",18334400,18352476,18076
"19127","ENSG00000205754","12",20962768,21092745,129977
"19128","ENSG00000205755","X",1187549,1212750,25201
"19129","ENSG00000205758","21",33589341,33643926,54585
"19130","ENSG00000205763","7",32916815,32943176,26361
"19131","ENSG00000205765","5",41904188,41921636,17448
"19132","ENSG00000205771","15",43726918,43747094,20176
"19133","ENSG00000205777","X",49589496,49608536,19040
"19134","ENSG00000205784","19",4890437,4902867,12430
"19135","ENSG00000205786","19",35399511,35419385,19874
"19136","ENSG00000205790","19",4679282,4685948,6666
"19137","ENSG00000205791","12",12355406,12357067,1661
"19138","ENSG00000205794","4",40042917,40057199,14282
"19139","ENSG00000205795","2",10056780,10080944,24164
"19140","ENSG00000205808","9",4662315,4665258,2943
"19141","ENSG00000205809","12",10426854,10442300,15446
"19142","ENSG00000205810","12",10412312,10420595,8283
"19143","ENSG00000205822","13",24408157,24597676,189519
"19144","ENSG00000205832","16",4556490,4600714,44224
"19145","ENSG00000205835","3",190852877,190892429,39552
"19146","ENSG00000205837","2",6728177,6770311,42134
"19147","ENSG00000205838","5",34838833,34899456,60623
"19148","ENSG00000205846","12",8455926,8478330,22404
"19149","ENSG00000205847","2",71024127,71029893,5766
"19150","ENSG00000205853","22",32359886,32382106,22220
"19151","ENSG00000205856","22",32149006,32159322,10316
"19152","ENSG00000205857","12",7765216,7774121,8905
"19153","ENSG00000205858","7",16526880,16581568,54688
"19154","ENSG00000205861","13",23888842,23897263,8421
"19155","ENSG00000205863","13",23890525,23902655,12130
"19156","ENSG00000205864","11",1697195,1697755,560
"19157","ENSG00000205865","11",1683269,1685629,2360
"19158","ENSG00000205866","11",1665597,1667856,2259
"19159","ENSG00000205867","11",1597177,1598294,1117
"19160","ENSG00000205869","11",1584342,1585283,941
"19161","ENSG00000205871","15",43115702,43116493,791
"19162","ENSG00000205879","8",12172761,12175771,3010
"19163","ENSG00000205882","8",11993174,11996312,3138
"19164","ENSG00000205883","8",11982321,11984590,2269
"19165","ENSG00000205885","12",7108052,7122501,14449
"19166","ENSG00000205890","16",3032481,3039133,6652
"19167","ENSG00000205898","7",125159974,125160547,573
"19168","ENSG00000205899","17",1270559,1271460,901
"19169","ENSG00000205903","7",6637318,6658279,20961
"19170","ENSG00000205913","16",2737076,2752600,15524
"19171","ENSG00000205918","16",2616121,2643296,27175
"19172","ENSG00000205922","19",1752373,1780988,28615
"19173","ENSG00000205927","21",33025935,33029196,3261
"19174","ENSG00000205929","21",32790673,32813743,23070
"19175","ENSG00000205930","21",32772100,32955437,183337
"19176","ENSG00000205937","16",2253116,2268397,15281
"19177","ENSG00000205940","4",13333414,13338657,5243
"19178","ENSG00000205944","Y",23219434,23291356,71922
"19179","ENSG00000205955","3",184115352,184117898,2546
"19180","ENSG00000205959","4",8482270,8516759,34489
"19181","ENSG00000205971","7",1692810,1694357,1547
"19182","ENSG00000205976","5",7299774,7306592,6818
"19183","ENSG00000205978","14",24399003,24419283,20280
"19184","ENSG00000205981","3",180983709,180989774,6065
"19185","ENSG00000206013","11",298200,299526,1326
"19186","ENSG00000206014","8",11928597,11933203,4606
"19187","ENSG00000206026","18",75409476,75427703,18227
"19188","ENSG00000206028","22",26667693,26672654,4961
"19189","ENSG00000206043","18",74315813,74359187,43374
"19190","ENSG00000206052","18",69400888,69849087,448199
"19191","ENSG00000206053","16",1678256,1702280,24024
"19192","ENSG00000206062","X",91307781,91308878,1097
"19193","ENSG00000206066","22",25318256,25320080,1824
"19194","ENSG00000206069","22",24934954,24946695,11741
"19195","ENSG00000206072","18",63647579,63726432,78853
"19196","ENSG00000206073","18",63637259,63644298,7039
"19197","ENSG00000206075","18",63476958,63505085,28127
"19198","ENSG00000206077","5",710355,784729,74374
"19199","ENSG00000206090","22",23939998,23942798,2800
"19200","ENSG00000206102","21",31038159,31038476,317
"19201","ENSG00000206113","4",2418974,2462942,43968
"19202","ENSG00000206120","3",168249522,168830599,581077
"19203","ENSG00000206127","15",32445106,32455634,10528
"19204","ENSG00000206129","18",56003613,56191262,187649
"19205","ENSG00000206140","22",21466423,21471269,4846
"19206","ENSG00000206142","22",21300990,21325042,24052
"19207","ENSG00000206144","8",53537060,53540300,3240
"19208","ENSG00000206145","22",21035243,21045017,9774
"19209","ENSG00000206147","9",6639139,6639604,465
"19210","ENSG00000206149","15",28589492,28685264,95772
"19211","ENSG00000206150","14",21032818,21034807,1989
"19212","ENSG00000206159","Y",12088010,12421587,333577
"19213","ENSG00000206168","16",231134,231472,338
"19214","ENSG00000206172","16",176680,177522,842
"19215","ENSG00000206177","16",153892,166764,12872
"19216","ENSG00000206178","16",163122,165156,2034
"19217","ENSG00000206181","18",47032572,47035621,3049
"19218","ENSG00000206187","15",25902119,26053123,151004
"19219","ENSG00000206190","15",25677273,25865172,187899
"19220","ENSG00000206192","13",18816718,18871967,55249
"19221","ENSG00000206195","22",15784959,15829984,45025
"19222","ENSG00000206199","3",149761100,149968385,207285
"19223","ENSG00000206228","8",82291624,82292379,755
"19224","ENSG00000206249","20",38288331,38326536,38205
"19225","ENSG00000206260","3",139005468,139006268,800
"19226","ENSG00000206262","3",138947217,138953990,6773
"19227","ENSG00000206337","6",31400700,31478903,78203
"19228","ENSG00000206341","6",29887752,29890482,2730
"19229","ENSG00000206344","6",31197760,31203968,6208
"19230","ENSG00000206356","5",99522311,99525462,3151
"19231","ENSG00000206384","3",130560334,130678155,117821
"19232","ENSG00000206417","3",129315392,129326225,10833
"19233","ENSG00000206418","18",8609437,8639382,29945
"19234","ENSG00000206422","18",7231125,7232047,922
"19235","ENSG00000206432","18",5882072,5895955,13883
"19236","ENSG00000206448","10",15154802,15155320,518
"19237","ENSG00000206503","6",29941260,29945884,4624
"19238","ENSG00000206527","3",123490820,123585053,94233
"19239","ENSG00000206530","3",113286930,113441610,154680
"19240","ENSG00000206531","3",112815709,112846856,31147
"19241","ENSG00000206532","3",110888384,110893476,5092
"19242","ENSG00000206535","3",100401532,100456319,54787
"19243","ENSG00000206538","3",86876388,86991149,114761
"19244","ENSG00000206549","3",46712115,46812574,100459
"19245","ENSG00000206552","3",42934252,42936785,2533
"19246","ENSG00000206557","3",32817997,32897824,79827
"19247","ENSG00000206559","3",28348721,28538122,189401
"19248","ENSG00000206560","3",15667236,15859771,192535
"19249","ENSG00000206561","3",15450133,15521751,71618
"19250","ENSG00000206562","3",15381275,15440566,59291
"19251","ENSG00000206567","3",10004048,10011209,7161
"19252","ENSG00000206573","3",9349689,9398579,48890
"19253","ENSG00000206579","8",55102389,55542054,439665
"19254","ENSG00000206582","20",34526510,34526606,96
"19255","ENSG00000206583","11",85509938,85510044,106
"19256","ENSG00000206585","1",148038753,148038916,163
"19257","ENSG00000206587","11",67895631,67895737,106
"19258","ENSG00000206589","15",43734179,43734285,106
"19259","ENSG00000206592","5",79220942,79221073,131
"19260","ENSG00000206595","1",51382308,51382414,106
"19261","ENSG00000206601","4",108652150,108652256,106
"19262","ENSG00000206603","7",56055365,56055502,137
"19263","ENSG00000206604","3",142145454,142145555,101
"19264","ENSG00000206605","10",26790540,26790646,106
"19265","ENSG00000206612","12",48656648,48656782,134
"19266","ENSG00000206615","22",31388733,31388837,104
"19267","ENSG00000206616","15",23777437,23777543,106
"19268","ENSG00000206621","15",25080142,25080233,91
"19269","ENSG00000206622","X",119787353,119787484,131
"19270","ENSG00000206623","7",28118113,28118219,106
"19271","ENSG00000206627","1",52805108,52805212,104
"19272","ENSG00000206629","4",67429591,67429754,163
"19273","ENSG00000206630","16",2155023,2155105,82
"19274","ENSG00000206633","2",10446714,10446849,135
"19275","ENSG00000206634","7",65755526,65755659,133
"19276","ENSG00000206635","1",151629324,151629430,106
"19277","ENSG00000206638","11",72869544,72869650,106
"19278","ENSG00000206644","3",196393710,196393812,102
"19279","ENSG00000206645","3",37093133,37093234,101
"19280","ENSG00000206646","X",68361075,68361187,112
"19281","ENSG00000206647","2",10155072,10155206,134
"19282","ENSG00000206650","12",68627234,68627375,141
"19283","ENSG00000206651","1",156484098,156484210,112
"19284","ENSG00000206652","1",16514122,16514285,163
"19285","ENSG00000206654","1",39120940,39121043,103
"19286","ENSG00000206656","15",25083588,25083679,91
"19287","ENSG00000206658","9",110369592,110369698,106
"19288","ENSG00000206659","1",175022479,175022580,101
"19289","ENSG00000206660","10",32056746,32056839,93
"19290","ENSG00000206661","8",5128279,5128412,133
"19291","ENSG00000206669","19",36858227,36858329,102
"19292","ENSG00000206674","19",40299478,40299584,106
"19293","ENSG00000206675","4",39297605,39297711,106
"19294","ENSG00000206676","15",37050828,37050930,102
"19295","ENSG00000206679","1",95125511,95125609,98
"19296","ENSG00000206682","5",31505684,31505788,104
"19297","ENSG00000206684","1",172366540,172366646,106
"19298","ENSG00000206685","X",47087506,47087612,106
"19299","ENSG00000206687","18",797989,798135,146
"19300","ENSG00000206688","15",25085385,25085476,91
"19301","ENSG00000206690","11",88099995,88100105,110
"19302","ENSG00000206692","1",171253906,171254022,116
"19303","ENSG00000206695","8",125900951,125901054,103
"19304","ENSG00000206698","5",97175950,97176113,163
"19305","ENSG00000206700","1",48344209,48344315,106
"19306","ENSG00000206703","4",158794590,158794696,106
"19307","ENSG00000206710","20",49972106,49972212,106
"19308","ENSG00000206712","3",98804978,98805084,106
"19309","ENSG00000206715","6",87488445,87488552,107
"19310","ENSG00000206717","6",34821445,34821542,97
"19311","ENSG00000206721","3",120210320,120210421,101
"19312","ENSG00000206723","X",48724455,48724561,106
"19313","ENSG00000206725","2",229973315,229973421,106
"19314","ENSG00000206727","15",25073107,25073201,94
"19315","ENSG00000206728","3",23273807,23273910,103
"19316","ENSG00000206730","17",17578631,17578739,108
"19317","ENSG00000206731","2",27642043,27642169,126
"19318","ENSG00000206732","2",24676309,24676415,106
"19319","ENSG00000206737","1",143729407,143729570,163
"19320","ENSG00000206738","4",2615124,2615224,100
"19321","ENSG00000206739","22",19045256,19045367,111
"19322","ENSG00000206741","5",172779982,172780094,112
"19323","ENSG00000206746","18",62731226,62731332,106
"19324","ENSG00000206751","14",72853224,72853331,107
"19325","ENSG00000206754","6",132815307,132815379,72
"19326","ENSG00000206755","16",30710537,30710665,128
"19327","ENSG00000206756","10",74551392,74551493,101
"19328","ENSG00000206759","3",66293114,66293220,106
"19329","ENSG00000206762","1",205595041,205595147,106
"19330","ENSG00000206763","7",92701708,92701814,106
"19331","ENSG00000206766","18",24218300,24218404,104
"19332","ENSG00000206768","14",69143852,69143953,101
"19333","ENSG00000206769","18",61391595,61391703,108
"19334","ENSG00000206770","5",72768702,72768811,109
"19335","ENSG00000206774","5",80365726,80365832,106
"19336","ENSG00000206775","19",3982507,3982572,65
"19337","ENSG00000206776","8",119388348,119388469,121
"19338","ENSG00000206778","16",15877163,15877266,103
"19339","ENSG00000206779","1",28422555,28422655,100
"19340","ENSG00000206781","15",64445130,64445243,113
"19341","ENSG00000206784","9",37322259,37322371,112
"19342","ENSG00000206785","7",65760052,65760186,134
"19343","ENSG00000206786","5",119138859,119138965,106
"19344","ENSG00000206790","12",100257688,100257790,102
"19345","ENSG00000206791","1",148014417,148014583,166
"19346","ENSG00000206792","X",12054824,12054926,102
"19347","ENSG00000206795","X",12149126,12149238,112
"19348","ENSG00000206797","20",450663,450762,99
"19349","ENSG00000206801","20",43796437,43796543,106
"19350","ENSG00000206803","1",235915415,235915521,106
"19351","ENSG00000206813","22",41747312,41747413,101
"19352","ENSG00000206814","5",17117576,17117686,110
"19353","ENSG00000206815","3",57548838,57548945,107
"19354","ENSG00000206816","11",77691650,77691751,101
"19355","ENSG00000206817","1",91261625,91261724,99
"19356","ENSG00000206819","5",157809098,157809204,106
"19357","ENSG00000206820","4",113420323,113420486,163
"19358","ENSG00000206822","14",63621760,63621871,111
"19359","ENSG00000206824","17",50386145,50386246,101
"19360","ENSG00000206827","18",22647582,22647688,106
"19361","ENSG00000206828","1",149636766,149636929,163
"19362","ENSG00000206832","1",109591534,109591640,106
"19363","ENSG00000206833","16",57830536,57830642,106
"19364","ENSG00000206836","2",197447745,197447851,106
"19365","ENSG00000206838","7",45104349,45104482,133
"19366","ENSG00000206840","10",37994863,37994975,112
"19367","ENSG00000206841","22",50691260,50691363,103
"19368","ENSG00000206844","X",9874601,9874701,100
"19369","ENSG00000206846","15",30673750,30673843,93
"19370","ENSG00000206847","11",129030459,129030572,113
"19371","ENSG00000206848","6",42664162,42664268,106
"19372","ENSG00000206855","10",68911653,68911759,106
"19373","ENSG00000206859","17",17170083,17170189,106
"19374","ENSG00000206862","X",118569405,118569515,110
"19375","ENSG00000206863","18",24124170,24124285,115
"19376","ENSG00000206865","18",56753226,56753326,100
"19377","ENSG00000206869","2",164687643,164687777,134
"19378","ENSG00000206875","6",42018408,42018514,106
"19379","ENSG00000206878","1",228652436,228652560,124
"19380","ENSG00000206881","6",17619533,17619634,101
"19381","ENSG00000206885","2",231455800,231455936,136
"19382","ENSG00000206886","6",81764024,81764156,132
"19383","ENSG00000206888","1",27325219,27325325,106
"19384","ENSG00000206889","3",117544205,117544311,106
"19385","ENSG00000206892","3",196784980,196785086,106
"19386","ENSG00000206895","7",4811188,4811289,101
"19387","ENSG00000206897","12",123616708,123616840,132
"19388","ENSG00000206899","12",97721716,97721822,106
"19389","ENSG00000206903","15",65285461,65285591,130
"19390","ENSG00000206906","14",18343038,18343144,106
"19391","ENSG00000206907","9",111839828,111839934,106
"19392","ENSG00000206911","11",93827622,93827734,112
"19393","ENSG00000206913","11",74252414,74252552,138
"19394","ENSG00000206914","12",122768099,122768200,101
"19395","ENSG00000206915","2",49233794,49233899,105
"19396","ENSG00000206918","3",57512450,57512555,105
"19397","ENSG00000206921","1",161401289,161401395,106
"19398","ENSG00000206922","13",72706017,72706123,106
"19399","ENSG00000206923","9",110903337,110903445,108
"19400","ENSG00000206924","14",75020761,75020867,106
"19401","ENSG00000206925","19",40342329,40342441,112
"19402","ENSG00000206926","3",15433110,15433216,106
"19403","ENSG00000206931","1",150701866,150701972,106
"19404","ENSG00000206932","3",181231737,181231843,106
"19405","ENSG00000206935","1",23162704,23162810,106
"19406","ENSG00000206936","X",49082028,49082165,137
"19407","ENSG00000206937","2",61417244,61417378,134
"19408","ENSG00000206938","7",156872078,156872218,140
"19409","ENSG00000206941","11",75400391,75400538,147
"19410","ENSG00000206944","18",48169784,48169890,106
"19411","ENSG00000206951","2",32945339,32945451,112
"19412","ENSG00000206954","17",48088678,48088784,106
"19413","ENSG00000206957","15",44697333,44697430,97
"19414","ENSG00000206961","2",169727872,169728003,131
"19415","ENSG00000206962","13",41905118,41905224,106
"19416","ENSG00000206963","2",126702839,126702942,103
"19417","ENSG00000206964","2",55286018,55286128,110
"19418","ENSG00000206965","2",174557966,174558072,106
"19419","ENSG00000206967","11",108229503,108229604,101
"19420","ENSG00000206969","14",102865856,102865963,107
"19421","ENSG00000206975","8",56917084,56917190,106
"19422","ENSG00000206976","11",3922567,3922703,136
"19423","ENSG00000206977","6",41832854,41832993,139
"19424","ENSG00000206980","1",151747597,151747700,103
"19425","ENSG00000206985","2",39082589,39082692,103
"19426","ENSG00000206989","5",138561043,138561110,67
"19427","ENSG00000206991","15",43637632,43637738,106
"19428","ENSG00000206992","12",51987657,51987763,106
"19429","ENSG00000206995","15",52162751,52162852,101
"19430","ENSG00000206997","5",96210121,96210227,106
"19431","ENSG00000207000","9",68935873,68935979,106
"19432","ENSG00000207001","15",25054210,25054304,94
"19433","ENSG00000207002","3",123814077,123814207,130
"19434","ENSG00000207003","19",45047458,45047561,103
"19435","ENSG00000207004","14",51724103,51724209,106
"19436","ENSG00000207005","1",16895980,16896143,163
"19437","ENSG00000207008","11",2963771,2963893,122
"19438","ENSG00000207009","4",1683420,1683529,109
"19439","ENSG00000207010","12",12289227,12289329,102
"19440","ENSG00000207014","15",25056860,25056954,94
"19441","ENSG00000207020","5",139554900,139555001,101
"19442","ENSG00000207021","17",81573490,81573602,112
"19443","ENSG00000207022","1",92846059,92846182,123
"19444","ENSG00000207023","6",73464073,73464177,104
"19445","ENSG00000207024","11",64296037,64296138,101
"19446","ENSG00000207029","10",102591524,102591630,106
"19447","ENSG00000207031","12",56645027,56645101,74
"19448","ENSG00000207032","9",34389943,34390051,108
"19449","ENSG00000207034","18",2778941,2779057,116
"19450","ENSG00000207036","8",70357347,70357448,101
"19451","ENSG00000207037","15",84938416,84938522,106
"19452","ENSG00000207039","1",153785720,153785821,101
"19453","ENSG00000207042","16",21642294,21642400,106
"19454","ENSG00000207044","6",112196440,112196546,106
"19455","ENSG00000207046","14",37434469,37434573,104
"19456","ENSG00000207047","2",206161878,206161957,79
"19457","ENSG00000207052","5",32309662,32309768,106
"19458","ENSG00000207053","20",35928570,35928675,105
"19459","ENSG00000207058","4",70703018,70703123,105
"19460","ENSG00000207061","7",156186122,156186223,101
"19461","ENSG00000207062","7",65070538,65070672,134
"19462","ENSG00000207063","15",25051477,25051571,94
"19463","ENSG00000207069","2",25008845,25008946,101
"19464","ENSG00000207072","18",68858934,68859040,106
"19465","ENSG00000207073","19",49566672,49566772,100
"19466","ENSG00000207081","X",134918310,134918416,106
"19467","ENSG00000207082","1",164639565,164639671,106
"19468","ENSG00000207083","16",69175671,69175777,106
"19469","ENSG00000207086","2",9615267,9615373,106
"19470","ENSG00000207087","2",43091388,43091494,106
"19471","ENSG00000207088","3",129397210,129397348,138
"19472","ENSG00000207089","14",68735922,68736028,106
"19473","ENSG00000207090","7",121194948,121195057,109
"19474","ENSG00000207091","15",34314728,34314828,100
"19475","ENSG00000207092","18",9250110,9250211,101
"19476","ENSG00000207093","15",25070432,25070526,94
"19477","ENSG00000207098","21",32841861,32841995,134
"19478","ENSG00000207101","8",41803349,41803450,101
"19479","ENSG00000207105","15",48995912,48996022,110
"19480","ENSG00000207109","3",53333060,53333128,68
"19481","ENSG00000207110","8",127999131,127999294,163
"19482","ENSG00000207116","2",200830009,200830116,107
"19483","ENSG00000207117","2",159536244,159536346,102
"19484","ENSG00000207119","15",69457941,69458149,208
"19485","ENSG00000207124","10",4514952,4515057,105
"19486","ENSG00000207127","17",49416744,49416850,106
"19487","ENSG00000207128","8",10476223,10476329,106
"19488","ENSG00000207129","5",88274258,88274376,118
"19489","ENSG00000207131","6",87826173,87826285,112
"19490","ENSG00000207133","15",25067788,25067882,94
"19491","ENSG00000207134","1",155358712,155358818,106
"19492","ENSG00000207135","10",27335501,27335607,106
"19493","ENSG00000207136","12",50633273,50633376,103
"19494","ENSG00000207137","15",25079058,25079149,91
"19495","ENSG00000207138","8",126504763,126504869,106
"19496","ENSG00000207142","12",42454720,42454821,101
"19497","ENSG00000207144","1",155419397,155419500,103
"19498","ENSG00000207146","X",108676951,108677057,106
"19499","ENSG00000207148","4",121329069,121329170,101
"19500","ENSG00000207151","X",11116092,11116193,101
"19501","ENSG00000207153","11",60985061,60985167,106
"19502","ENSG00000207155","4",140700835,140700942,107
"19503","ENSG00000207160","18",26366301,26366406,105
"19504","ENSG00000207162","15",64671263,64671369,106
"19505","ENSG00000207163","3",14530982,14531088,106
"19506","ENSG00000207168","7",56060470,56060602,132
"19507","ENSG00000207169","17",76337316,76337422,106
"19508","ENSG00000207170","2",18583367,18583468,101
"19509","ENSG00000207171","4",168471409,168471539,130
"19510","ENSG00000207172","14",63630678,63630781,103
"19511","ENSG00000207174","15",25081287,25081378,91
"19512","ENSG00000207175","X",119423742,119423905,163
"19513","ENSG00000207176","12",32396050,32396147,97
"19514","ENSG00000207177","5",110684794,110684927,133
"19515","ENSG00000207180","6",71182612,71182718,106
"19516","ENSG00000207181","1",235127803,235127937,134
"19517","ENSG00000207185","11",118593988,118594093,105
"19518","ENSG00000207186","2",241584968,241585075,107
"19519","ENSG00000207191","15",25062333,25062427,94
"19520","ENSG00000207194","1",50582404,50582511,107
"19521","ENSG00000207195","4",40826655,40826765,110
"19522","ENSG00000207197","15",25077051,25077142,91
"19523","ENSG00000207198","4",41113942,41114045,103
"19524","ENSG00000207199","8",39018615,39018683,68
"19525","ENSG00000207200","11",63970470,63970576,106
"19526","ENSG00000207202","X",10582817,10582919,102
"19527","ENSG00000207205","1",144412576,144412740,164
"19528","ENSG00000207207","2",85434507,85434619,112
"19529","ENSG00000207208","14",101803227,101803331,104
"19530","ENSG00000207215","8",97358265,97358478,213
"19531","ENSG00000207217","7",6016877,6017011,134
"19532","ENSG00000207221","11",83041464,83041598,134
"19533","ENSG00000207223","15",64652888,64652989,101
"19534","ENSG00000207231","4",185415973,185416086,113
"19535","ENSG00000207233","18",54222284,54222412,128
"19536","ENSG00000207234","1",88816779,88816885,106
"19537","ENSG00000207235","17",59260748,59260846,98
"19538","ENSG00000207237","1",25964197,25964300,103
"19539","ENSG00000207242","17",10857899,10858004,105
"19540","ENSG00000207245","15",25106521,25106603,82
"19541","ENSG00000207248","16",21642054,21642160,106
"19542","ENSG00000207249","2",104733234,104733362,128
"19543","ENSG00000207251","3",27265580,27265683,103
"19544","ENSG00000207256","1",42991438,42991544,106
"19545","ENSG00000207258","8",38744020,38744131,111
"19546","ENSG00000207260","4",109992325,109992431,106
"19547","ENSG00000207263","15",25082768,25082859,91
"19548","ENSG00000207264","10",21321961,21322067,106
"19549","ENSG00000207265","19",52259076,52259187,111
"19550","ENSG00000207267","2",11233988,11234094,106
"19551","ENSG00000207270","2",149610668,149610774,106
"19552","ENSG00000207276","9",96256216,96256319,103
"19553","ENSG00000207277","9",63813190,63813307,117
"19554","ENSG00000207278","18",3894699,3894805,106
"19555","ENSG00000207279","15",25094037,25094128,91
"19556","ENSG00000207281","19",40339059,40339164,105
"19557","ENSG00000207291","X",101634006,101634112,106
"19558","ENSG00000207292","6",149631437,149631549,112
"19559","ENSG00000207293","5",57169108,57169209,101
"19560","ENSG00000207295","2",38884560,38884666,106
"19561","ENSG00000207297","17",35573657,35573753,96
"19562","ENSG00000207302","1",25877496,25877605,109
"19563","ENSG00000207303","2",216351403,216351504,101
"19564","ENSG00000207305","20",2453010,2453117,107
"19565","ENSG00000207306","17",48196680,48196786,106
"19566","ENSG00000207308","11",2321718,2321827,109
"19567","ENSG00000207309","6",96649453,96649591,138
"19568","ENSG00000207310","3",119341834,119341940,106
"19569","ENSG00000207312","5",11027200,11027307,107
"19570","ENSG00000207313","12",48667457,48667593,136
"19571","ENSG00000207317","5",140019492,140019592,100
"19572","ENSG00000207320","X",3641443,3641555,112
"19573","ENSG00000207325","13",32763438,32763552,114
"19574","ENSG00000207326","1",246426006,246426119,113
"19575","ENSG00000207327","10",73529051,73529157,106
"19576","ENSG00000207329","9",109324685,109324796,111
"19577","ENSG00000207331","3",98908459,98908564,105
"19578","ENSG00000207333","5",75709495,75709599,104
"19579","ENSG00000207336","5",74725099,74725204,105
"19580","ENSG00000207338","7",123457988,123458094,106
"19581","ENSG00000207340","1",148362370,148362533,163
"19582","ENSG00000207342","14",88840165,88840263,98
"19583","ENSG00000207344","7",65065999,65066132,133
"19584","ENSG00000207347","10",21564471,21564577,106
"19585","ENSG00000207351","3",184086791,184086903,112
"19586","ENSG00000207352","5",65604661,65604761,100
"19587","ENSG00000207355","20",24974171,24974280,109
"19588","ENSG00000207357","19",1021522,1021628,106
"19589","ENSG00000207359","8",89900721,89900824,103
"19590","ENSG00000207360","9",15776181,15776286,105
"19591","ENSG00000207361","8",28416448,28416551,103
"19592","ENSG00000207362","10",100258571,100258677,106
"19593","ENSG00000207363","X",107901145,107901246,101
"19594","ENSG00000207365","12",93021606,93021712,106
"19595","ENSG00000207368","3",195419436,195419546,110
"19596","ENSG00000207369","8",47667771,47667877,106
"19597","ENSG00000207370","3",193624189,193624301,112
"19598","ENSG00000207371","6",41917416,41917526,110
"19599","ENSG00000207378","8",98462944,98463050,106
"19600","ENSG00000207379","1",93385711,93385817,106
"19601","ENSG00000207380","20",5964538,5964650,112
"19602","ENSG00000207382","17",62661621,62661725,104
"19603","ENSG00000207383","2",112579484,112579584,100
"19604","ENSG00000207384","4",139200395,139200513,118
"19605","ENSG00000207385","4",53265461,53265567,106
"19606","ENSG00000207386","2",206025593,206025697,104
"19607","ENSG00000207392","6",159780250,159780381,131
"19608","ENSG00000207393","2",218589214,218589320,106
"19609","ENSG00000207399","8",103384961,103385067,106
"19610","ENSG00000207404","5",108891437,108891546,109
"19611","ENSG00000207410","17",67271469,67271607,138
"19612","ENSG00000207412","14",31686692,31686798,106
"19613","ENSG00000207416","21",36986739,36986851,112
"19614","ENSG00000207417","8",74376687,74376793,106
"19615","ENSG00000207419","6",11709819,11709960,141
"19616","ENSG00000207422","6",151615773,151615879,106
"19617","ENSG00000207425","16",14915457,14915556,99
"19618","ENSG00000207431","6",146639700,146639769,69
"19619","ENSG00000207433","9",15544188,15544294,106
"19620","ENSG00000207438","10",68503152,68503259,107
"19621","ENSG00000207440","14",31142939,31143048,109
"19622","ENSG00000207442","15",25065026,25065121,95
"19623","ENSG00000207444","14",71398337,71398407,70
"19624","ENSG00000207445","11",75404421,75404566,145
"19625","ENSG00000207448","4",70701755,70701858,103
"19626","ENSG00000207449","15",65553081,65553187,106
"19627","ENSG00000207450","8",47805079,47805179,100
"19628","ENSG00000207451","1",11226254,11226360,106
"19629","ENSG00000207452","5",87299687,87299797,110
"19630","ENSG00000207453","10",7486703,7486809,106
"19631","ENSG00000207454","7",101269938,101270041,103
"19632","ENSG00000207455","22",29899587,29899693,106
"19633","ENSG00000207456","2",53570374,53570480,106
"19634","ENSG00000207457","22",41679711,41679817,106
"19635","ENSG00000207458","13",40226827,40226932,105
"19636","ENSG00000207459","5",134634839,134634945,106
"19637","ENSG00000207460","15",25086527,25086618,91
"19638","ENSG00000207466","1",38950825,38950925,100
"19639","ENSG00000207467","12",48809911,48810016,105
"19640","ENSG00000207468","10",119060011,119060138,127
"19641","ENSG00000207475","1",155919909,155920045,136
"19642","ENSG00000207483","10",28667919,28668025,106
"19643","ENSG00000207484","15",51884556,51884653,97
"19644","ENSG00000207493","16",58548499,58548633,134
"19645","ENSG00000207494","10",124814958,124815062,104
"19646","ENSG00000207497","4",185709873,185709967,94
"19647","ENSG00000207503","21",41539206,41539326,120
"19648","ENSG00000207507","19",893484,893590,106
"19649","ENSG00000207508","1",40177843,40177949,106
"19650","ENSG00000207512","3",38505480,38505581,101
"19651","ENSG00000207516","15",45537250,45537377,127
"19652","ENSG00000207518","13",21551304,21551410,106
"19653","ENSG00000207523","1",92840719,92840851,132
"19654","ENSG00000207524","4",88684848,88684954,106
"19655","ENSG00000207525","16",74463888,74463988,100
"19656","ENSG00000207546","12",64622509,64622605,96
"19657","ENSG00000207547","7",100093560,100093643,83
"19658","ENSG00000207550","19",51692612,51692681,69
"19659","ENSG00000207551","10",100974985,100975084,99
"19660","ENSG00000207554","20",63942631,63942726,95
"19661","ENSG00000207559","4",165386242,165386337,95
"19662","ENSG00000207561","17",68424451,68424548,97
"19663","ENSG00000207562","11",111513439,111513515,76
"19664","ENSG00000207563","9",95085208,95085304,96
"19665","ENSG00000207571","12",54033950,54034045,95
"19666","ENSG00000207573","7",32732981,32733077,96
"19667","ENSG00000207574","8",143945191,143945279,88
"19668","ENSG00000207578","5",96079138,96079212,74
"19669","ENSG00000207582","8",134800520,134800607,87
"19670","ENSG00000207583","10",75552458,75552553,95
"19671","ENSG00000207585","19",13874875,13875011,136
"19672","ENSG00000207587","14",101048658,101048748,90
"19673","ENSG00000207588","7",128081861,128081960,99
"19674","ENSG00000207590","1",220117853,220117962,109
"19675","ENSG00000207595","9",124692442,124692551,109
"19676","ENSG00000207600","8",11035206,11035302,96
"19677","ENSG00000207606","1",151545796,151545891,95
"19678","ENSG00000207607","1",1167863,1167952,89
"19679","ENSG00000207609","9",20716105,20716188,83
"19680","ENSG00000207611","2",240456001,240456089,88
"19681","ENSG00000207612","10",29545004,29545097,93
"19682","ENSG00000207614","17",31559996,31560083,87
"19683","ENSG00000207622","12",108836908,108837006,98
"19684","ENSG00000207624","1",220118157,220118241,84
"19685","ENSG00000207626","2",232172653,232172747,94
"19686","ENSG00000207627","5",53951504,53951599,95
"19687","ENSG00000207631","19",40282543,40282641,98
"19688","ENSG00000207633","X",139924148,139924231,83
"19689","ENSG00000207635","20",34990376,34990497,121
"19690","ENSG00000207638","21",16539089,16539169,80
"19691","ENSG00000207642","4",350157,350252,95
"19692","ENSG00000207650","3",195699401,195699497,96
"19693","ENSG00000207651","3",188688781,188688866,85
"19694","ENSG00000207652","13",40810766,40810861,95
"19695","ENSG00000207653","2",32532153,32532246,93
"19696","ENSG00000207654","2",135665397,135665478,81
"19697","ENSG00000207688","17",67471489,67471585,96
"19698","ENSG00000207693","9",137838419,137838516,97
"19699","ENSG00000207696","22",37847678,37847774,96
"19700","ENSG00000207697","4",24520192,24520290,98
"19701","ENSG00000207698","9",109046229,109046298,69
"19702","ENSG00000207701","8",9741672,9741768,96
"19703","ENSG00000207703","15",88611825,88611934,109
"19704","ENSG00000207704","8",123348034,123348130,96
"19705","ENSG00000207711","19",53697533,53697617,84
"19706","ENSG00000207712","15",42199570,42199666,96
"19707","ENSG00000207713","12",6963699,6963766,67
"19708","ENSG00000207719","13",99356131,99356228,97
"19709","ENSG00000207721","1",71067631,71067716,85
"19710","ENSG00000207725","X",45747015,45747124,109
"19711","ENSG00000207730","1",1167104,1167198,94
"19712","ENSG00000207731","X",147230720,147230843,123
"19713","ENSG00000207732","4",20528275,20528384,109
"19714","ENSG00000207736","17",81125276,81125373,97
"19715","ENSG00000207737","9",124693710,124693798,88
"19716","ENSG00000207739","5",168768146,168768255,109
"19717","ENSG00000207741","7",74191198,74191294,96
"19718","ENSG00000207744","2",176150303,176150412,109
"19719","ENSG00000207750","1",100281241,100281308,67
"19720","ENSG00000207752","19",10817426,10817496,70
"19721","ENSG00000207755","X",134540508,134540607,99
"19722","ENSG00000207756","5",36147892,36147988,96
"19723","ENSG00000207757","7",100093768,100093847,79
"19724","ENSG00000207766","15",41691585,41691678,93
"19725","ENSG00000207771","7",30289794,30289890,96
"19726","ENSG00000207773","19",45674928,45675024,96
"19727","ENSG00000207780","22",17980868,17980961,93
"19728","ENSG00000207781","14",65471102,65471186,84
"19729","ENSG00000207782","19",49500785,49500868,83
"19730","ENSG00000207784","X",134541341,134541437,96
"19731","ENSG00000207789","12",57824609,57824692,83
"19732","ENSG00000207797","18",35904818,35904926,108
"19733","ENSG00000207802","20",60308474,60308567,93
"19734","ENSG00000207805","11",2134134,2134209,75
"19735","ENSG00000207808","19",13836440,13836517,77
"19736","ENSG00000207811","11",111512938,111513021,83
"19737","ENSG00000207815","3",15873771,15873849,78
"19738","ENSG00000207816","8",64379149,64379257,108
"19739","ENSG00000207821","19",19435063,19435158,95
"19740","ENSG00000207826","8",1817231,1817307,76
"19741","ENSG00000207837","19",53721076,53721142,66
"19742","ENSG00000207839","17",17813836,17813931,95
"19743","ENSG00000207863","21",16590237,16590325,88
"19744","ENSG00000207864","9",95085445,95085541,96
"19745","ENSG00000207870","X",45746157,45746266,109
"19746","ENSG00000207922","3",50173326,50173419,93
"19747","ENSG00000207923","2",47377675,47377770,95
"19748","ENSG00000207924","12",53991738,53991847,109
"19749","ENSG00000207926","3",52294219,52294308,89
"19750","ENSG00000207930","10",24275685,24275781,96
"19751","ENSG00000207932","22",41900944,41901012,68
"19752","ENSG00000207933","1",156420341,156420429,88
"19753","ENSG00000207938","10",17845107,17845193,86
"19754","ENSG00000207940","3",112112801,112112898,97
"19755","ENSG00000207944","4",38868032,38868127,95
"19756","ENSG00000207948","16",67202321,67202395,74
"19757","ENSG00000207951","2",188297492,188297588,96
"19758","ENSG00000207952","14",31014646,31014742,96
"19759","ENSG00000207954","3",44114212,44114310,98
"19760","ENSG00000207955","9",128392007,128393510,1503
"19761","ENSG00000207956","5",32394378,32394475,97
"19762","ENSG00000207959","14",101066724,101066801,77
"19763","ENSG00000207963","3",171106664,171106759,95
"19764","ENSG00000207965","15",70079372,70079468,96
"19765","ENSG00000207967","12",116148560,116148654,94
"19766","ENSG00000207971","11",122099757,122099844,87
"19767","ENSG00000207972","19",10718404,10718503,99
"19768","ENSG00000207973","7",5495819,5495917,98
"19769","ENSG00000207976","10",96828669,96828764,95
"19770","ENSG00000207978","14",101059755,101059838,83
"19771","ENSG00000207980","19",13836587,13836659,72
"19772","ENSG00000207983","12",12764649,12764743,94
"19773","ENSG00000207988","4",109488698,109488795,97
"19774","ENSG00000207990","7",129770383,129770492,109
"19775","ENSG00000207991","9",123402525,123402603,78
"19776","ENSG00000207996","17",59151136,59151221,85
"19777","ENSG00000207997","20",34466325,34466418,93
"19778","ENSG00000208002","19",52281797,52281893,96
"19779","ENSG00000208003","15",80841978,80842073,95
"19780","ENSG00000208009","11",57641198,57641286,88
"19781","ENSG00000208013","X",110055329,110055426,97
"19782","ENSG00000208017","16",69933081,69933180,99
"19783","ENSG00000208018","20",50585786,50585879,93
"19784","ENSG00000208022","12",80935736,80935833,97
"19785","ENSG00000208024","1",172144535,172144644,109
"19786","ENSG00000208025","7",96219662,96219756,94
"19787","ENSG00000208027","14",101055419,101055491,72
"19788","ENSG00000208028","12",57519163,57519259,96
"19789","ENSG00000208032","8",104484369,104484465,96
"19790","ENSG00000208033","10",104218789,104218883,94
"19791","ENSG00000208036","7",100093993,100094074,81
"19792","ENSG00000208037","8",22244962,22245043,81
"19793","ENSG00000208308","2",135136628,135136755,127
"19794","ENSG00000208772","2",86135870,86136006,136
"19795","ENSG00000208883","X",110224985,110225063,78
"19796","ENSG00000208892","12",132031224,132031359,135
"19797","ENSG00000209042","20",49278940,49279028,88
"19798","ENSG00000209082","MT",3230,3304,74
"19799","ENSG00000209482","22",39315213,39315307,94
"19800","ENSG00000210049","MT",577,647,70
"19801","ENSG00000210077","MT",1602,1670,68
"19802","ENSG00000210082","MT",1671,3229,1558
"19803","ENSG00000210100","MT",4263,4331,68
"19804","ENSG00000210107","MT",4329,4400,71
"19805","ENSG00000210112","MT",4402,4469,67
"19806","ENSG00000210117","MT",5512,5579,67
"19807","ENSG00000210127","MT",5587,5655,68
"19808","ENSG00000210135","MT",5657,5729,72
"19809","ENSG00000210140","MT",5761,5826,65
"19810","ENSG00000210144","MT",5826,5891,65
"19811","ENSG00000210151","MT",7446,7514,68
"19812","ENSG00000210154","MT",7518,7585,67
"19813","ENSG00000210156","MT",8295,8364,69
"19814","ENSG00000210164","MT",9991,10058,67
"19815","ENSG00000210174","MT",10405,10469,64
"19816","ENSG00000210176","MT",12138,12206,68
"19817","ENSG00000210181","3",36968191,36968316,125
"19818","ENSG00000210184","MT",12207,12265,58
"19819","ENSG00000210191","MT",12266,12336,70
"19820","ENSG00000210194","MT",14674,14742,68
"19821","ENSG00000210195","MT",15888,15953,65
"19822","ENSG00000210196","MT",15956,16023,67
"19823","ENSG00000210709","17",46921124,46921249,125
"19824","ENSG00000210741","17",48632490,48632559,69
"19825","ENSG00000210839","4",73026748,73026873,125
"19826","ENSG00000210841","3",57619447,57619572,125
"19827","ENSG00000211137","15",62823957,62824041,84
"19828","ENSG00000211445","5",151020438,151028992,8554
"19829","ENSG00000211448","14",80197527,80387757,190230
"19830","ENSG00000211450","11",57741250,57743554,2304
"19831","ENSG00000211451","1",145919013,145925341,6328
"19832","ENSG00000211452","1",53891239,53911086,19847
"19833","ENSG00000211454","1",19265982,19274194,8212
"19834","ENSG00000211455","12",27243968,27325959,81991
"19835","ENSG00000211456","3",45689056,45745409,56353
"19836","ENSG00000211459","MT",648,1601,953
"19837","ENSG00000211460","2",121737103,121767853,30750
"19838","ENSG00000211491","13",40727828,40727875,47
"19839","ENSG00000211513","19",46709293,46709345,52
"19840","ENSG00000211514","17",59137758,59137872,114
"19841","ENSG00000211563","17",81125877,81125955,78
"19842","ENSG00000211568","11",43559656,43559753,97
"19843","ENSG00000211574","14",100852390,100852487,97
"19844","ENSG00000211575","1",93846832,93846911,79
"19845","ENSG00000211578","X",119646738,119646848,110
"19846","ENSG00000211580","19",46018932,46019049,117
"19847","ENSG00000211581","1",156936131,156936244,113
"19848","ENSG00000211584","12",47753916,47782751,28835
"19849","ENSG00000211592","2",88857161,88857683,522
"19850","ENSG00000211593","2",88860568,88860605,37
"19851","ENSG00000211598","2",88885397,88886153,756
"19852","ENSG00000211599","2",88897232,88897784,552
"19853","ENSG00000211611","2",89159751,89160366,615
"19854","ENSG00000211623","2",89985922,89986702,780
"19855","ENSG00000211625","2",90038848,90039479,631
"19856","ENSG00000211626","2",90069662,90070238,576
"19857","ENSG00000211632","2",90172802,90173414,612
"19858","ENSG00000211633","2",90190193,90190681,488
"19859","ENSG00000211637","22",22030934,22031472,538
"19860","ENSG00000211638","22",22098700,22099212,512
"19861","ENSG00000211639","22",22162199,22162681,482
"19862","ENSG00000211640","22",22195799,22196276,477
"19863","ENSG00000211641","22",22201663,22202161,498
"19864","ENSG00000211642","22",22038643,22215270,176627
"19865","ENSG00000211643","22",22318727,22319226,499
"19866","ENSG00000211644","22",22322472,22322969,497
"19867","ENSG00000211645","22",22327300,22327814,514
"19868","ENSG00000211647","22",22352940,22353433,493
"19869","ENSG00000211648","22",22357739,22358260,521
"19870","ENSG00000211649","22",22369614,22370087,473
"19871","ENSG00000211650","22",22375986,22376505,519
"19872","ENSG00000211651","22",22380766,22381347,581
"19873","ENSG00000211652","22",22395018,22395489,471
"19874","ENSG00000211653","22",22409766,22410282,516
"19875","ENSG00000211654","22",22427540,22428035,495
"19876","ENSG00000211655","22",22431958,22432465,507
"19877","ENSG00000211656","22",22588155,22588688,533
"19878","ENSG00000211657","22",22594528,22595056,528
"19879","ENSG00000211658","22",22668288,22668806,518
"19880","ENSG00000211659","22",22686726,22687271,545
"19881","ENSG00000211660","22",22697789,22698407,618
"19882","ENSG00000211661","22",22704265,22704822,557
"19883","ENSG00000211662","22",22711689,22713203,1514
"19884","ENSG00000211663","22",22720623,22721145,522
"19885","ENSG00000211664","22",22734607,22735089,482
"19886","ENSG00000211665","22",22747383,22747921,538
"19887","ENSG00000211666","22",22758700,22759218,518
"19888","ENSG00000211667","22",22771824,22772582,758
"19889","ENSG00000211668","22",22792491,22793007,516
"19890","ENSG00000211669","22",22811747,22812281,534
"19891","ENSG00000211670","22",22819010,22819756,746
"19892","ENSG00000211672","22",22871507,22872035,528
"19893","ENSG00000211673","22",22880706,22881396,690
"19894","ENSG00000211674","22",22893692,22893818,126
"19895","ENSG00000211676","22",22899481,22899655,174
"19896","ENSG00000211677","22",22900976,22901437,461
"19897","ENSG00000211678","22",22904850,22905025,175
"19898","ENSG00000211679","22",22906342,22906803,461
"19899","ENSG00000211680","22",22910574,22910606,32
"19900","ENSG00000211682","22",22918132,22918201,69
"19901","ENSG00000211683","22",23630618,23638941,8323
"19902","ENSG00000211684","22",22921390,22921435,45
"19903","ENSG00000211685","22",22922594,22923034,440
"19904","ENSG00000211687","7",38253380,38253429,49
"19905","ENSG00000211688","7",38256337,38256396,59
"19906","ENSG00000211689","7",38257879,38265678,7799
"19907","ENSG00000211691","7",38273587,38273647,60
"19908","ENSG00000211692","7",38276259,38276318,59
"19909","ENSG00000211693","7",38291616,38292078,462
"19910","ENSG00000211694","7",38299811,38300322,511
"19911","ENSG00000211695","7",38317017,38318861,1844
"19912","ENSG00000211697","7",38349355,38350022,667
"19913","ENSG00000211698","7",38353715,38354517,802
"19914","ENSG00000211699","7",38358512,38359162,650
"19915","ENSG00000211701","7",38367586,38368169,583
"19916","ENSG00000211706","7",142328297,142328786,489
"19917","ENSG00000211707","7",142332182,142332701,519
"19918","ENSG00000211710","7",142313184,142313666,482
"19919","ENSG00000211713","7",142380806,142381261,455
"19920","ENSG00000211714","7",142384329,142384841,512
"19921","ENSG00000211715","7",142389202,142389668,466
"19922","ENSG00000211716","7",142391891,142392412,521
"19923","ENSG00000211717","7",142399860,142400377,517
"19924","ENSG00000211720","7",142407672,142408136,464
"19925","ENSG00000211721","7",142450947,142451448,501
"19926","ENSG00000211724","7",142469537,142470013,476
"19927","ENSG00000211725","7",142482548,142483019,471
"19928","ENSG00000211727","7",142492132,142492673,541
"19929","ENSG00000211728","7",142500028,142500534,506
"19930","ENSG00000211731","7",142520090,142520556,466
"19931","ENSG00000211734","7",142320677,142321544,867
"19932","ENSG00000211739","7",142440883,142441325,442
"19933","ENSG00000211745","7",142345421,142345985,564
"19934","ENSG00000211746","7",142618849,142619532,683
"19935","ENSG00000211747","7",142626649,142627399,750
"19936","ENSG00000211749","7",142645961,142646467,506
"19937","ENSG00000211750","7",142656701,142657213,512
"19938","ENSG00000211751","7",142791694,142793368,1674
"19939","ENSG00000211752","7",142715346,142715861,515
"19940","ENSG00000211753","7",142720660,142721160,500
"19941","ENSG00000211764","7",142796365,142796414,49
"19942","ENSG00000211765","7",142796560,142796610,50
"19943","ENSG00000211766","7",142796697,142796742,45
"19944","ENSG00000211767","7",142796847,142796895,48
"19945","ENSG00000211768","7",142796998,142797047,49
"19946","ENSG00000211771","7",142797456,142797502,46
"19947","ENSG00000211772","7",142801041,142802748,1707
"19948","ENSG00000211776","14",21712321,21712843,522
"19949","ENSG00000211777","14",21723713,21724321,608
"19950","ENSG00000211778","14",21736152,21736982,830
"19951","ENSG00000211779","14",21749178,21749705,527
"19952","ENSG00000211780","14",21768489,21769080,591
"19953","ENSG00000211781","14",21782993,21783503,510
"19954","ENSG00000211782","14",21797287,21797886,599
"19955","ENSG00000211784","14",21825472,21826075,603
"19956","ENSG00000211785","14",21841240,21841774,534
"19957","ENSG00000211786","14",21846537,21847221,684
"19958","ENSG00000211787","14",21852558,21853006,448
"19959","ENSG00000211788","14",21868839,21869365,526
"19960","ENSG00000211789","14",21887857,21888502,645
"19961","ENSG00000211790","14",21894433,21895030,597
"19962","ENSG00000211791","14",21918188,21918756,568
"19963","ENSG00000211792","14",21924063,21924651,588
"19964","ENSG00000211793","14",21941128,21941657,529
"19965","ENSG00000211794","14",21965451,21966061,610
"19966","ENSG00000211795","14",21978459,21979120,661
"19967","ENSG00000211796","14",21990496,21990938,442
"19968","ENSG00000211797","14",21997539,21998168,629
"19969","ENSG00000211798","14",22003106,22003673,567
"19970","ENSG00000211799","14",22007512,22008181,669
"19971","ENSG00000211800","14",22040594,22041153,559
"19972","ENSG00000211801","14",22052514,22053056,542
"19973","ENSG00000211802","14",22070557,22071208,651
"19974","ENSG00000211803","14",22086407,22086961,554
"19975","ENSG00000211804","14",22096032,22096619,587
"19976","ENSG00000211805","14",22105343,22105846,503
"19977","ENSG00000211806","14",22112347,22113031,684
"19978","ENSG00000211807","14",22123318,22124285,967
"19979","ENSG00000211809","14",22147995,22148633,638
"19980","ENSG00000211810","14",22163238,22163870,632
"19981","ENSG00000211812","14",22202583,22203368,785
"19982","ENSG00000211813","14",22207522,22208129,607
"19983","ENSG00000211814","14",22221896,22222475,579
"19984","ENSG00000211815","14",22226746,22227254,508
"19985","ENSG00000211816","14",22271968,22272563,595
"19986","ENSG00000211818","14",22304054,22304553,499
"19987","ENSG00000211819","14",22314490,22314919,429
"19988","ENSG00000211820","14",22320188,22320691,503
"19989","ENSG00000211821","14",22422371,22423042,671
"19990","ENSG00000211826","14",22455249,22455296,47
"19991","ENSG00000211828","14",22459098,22459156,58
"19992","ENSG00000211829","14",22462932,22465787,2855
"19993","ENSG00000211833","14",22477707,22477769,62
"19994","ENSG00000211834","14",22478872,22478934,62
"19995","ENSG00000211837","14",22483004,22483069,65
"19996","ENSG00000211838","14",22486228,22486296,68
"19997","ENSG00000211839","14",22488593,22488652,59
"19998","ENSG00000211840","14",22489488,22489543,55
"19999","ENSG00000211841","14",22490491,22490553,62
"20000","ENSG00000211842","14",22492851,22492907,56
"20001","ENSG00000211843","14",22493403,22493465,62
"20002","ENSG00000211844","14",22493925,22493990,65
"20003","ENSG00000211845","14",22494821,22494883,62
"20004","ENSG00000211846","14",22495913,22495966,53
"20005","ENSG00000211847","14",22496887,22496952,65
"20006","ENSG00000211848","14",22497657,22497718,61
"20007","ENSG00000211849","14",22499689,22499749,60
"20008","ENSG00000211850","14",22501601,22501663,62
"20009","ENSG00000211851","14",22502231,22502292,61
"20010","ENSG00000211854","14",22506644,22506702,58
"20011","ENSG00000211855","14",22507666,22507723,57
"20012","ENSG00000211856","14",22508602,22508658,56
"20013","ENSG00000211858","14",22510968,22511024,56
"20014","ENSG00000211859","14",22512852,22512908,56
"20015","ENSG00000211860","14",22513939,22513998,59
"20016","ENSG00000211861","14",22515623,22515688,65
"20017","ENSG00000211862","14",22516273,22516331,58
"20018","ENSG00000211863","14",22518446,22518505,59
"20019","ENSG00000211864","14",22518812,22518871,59
"20020","ENSG00000211865","14",22519969,22520031,62
"20021","ENSG00000211866","14",22520416,22520478,62
"20022","ENSG00000211867","14",22522040,22522102,62
"20023","ENSG00000211868","14",22523600,22523654,54
"20024","ENSG00000211869","14",22524325,22524381,56
"20025","ENSG00000211870","14",22525263,22525322,59
"20026","ENSG00000211871","14",22525650,22525715,65
"20027","ENSG00000211872","14",22526844,22526906,62
"20028","ENSG00000211873","14",22528527,22528586,59
"20029","ENSG00000211875","14",22530327,22530378,51
"20030","ENSG00000211876","14",22531076,22531138,62
"20031","ENSG00000211877","14",22531939,22531998,59
"20032","ENSG00000211878","14",22532502,22532561,59
"20033","ENSG00000211879","14",22533497,22533560,63
"20034","ENSG00000211881","14",22536145,22536204,59
"20035","ENSG00000211882","14",22537622,22537680,58
"20036","ENSG00000211883","14",22539073,22539134,61
"20037","ENSG00000211884","14",22540247,22540306,59
"20038","ENSG00000211885","14",22542199,22542261,62
"20039","ENSG00000211886","14",22543179,22543240,61
"20040","ENSG00000211887","14",22544071,22544136,65
"20041","ENSG00000211888","14",22545037,22545098,61
"20042","ENSG00000211890","14",105583731,105588395,4664
"20043","ENSG00000211891","14",105597691,105601728,4037
"20044","ENSG00000211892","14",105620506,105626066,5560
"20045","ENSG00000211893","14",105639559,105644790,5231
"20046","ENSG00000211895","14",105703995,105708665,4670
"20047","ENSG00000211896","14",105736343,105743071,6728
"20048","ENSG00000211897","14",105764503,105771405,6902
"20049","ENSG00000211898","14",105836765,105845678,8913
"20050","ENSG00000211899","14",105851705,105856218,4513
"20051","ENSG00000211904","14",105865199,105865250,51
"20052","ENSG00000211905","14",105865407,105865458,51
"20053","ENSG00000211907","14",105881034,105881053,19
"20054","ENSG00000211911","14",105886031,105886061,30
"20055","ENSG00000211914","14",105891699,105891719,20
"20056","ENSG00000211917","14",105895634,105895670,36
"20057","ENSG00000211921","14",105902649,105902671,22
"20058","ENSG00000211923","14",105904497,105904527,30
"20059","ENSG00000211924","14",105904681,105904711,30
"20060","ENSG00000211925","14",105907211,105907241,30
"20061","ENSG00000211928","14",105912257,105912276,19
"20062","ENSG00000211930","14",105914359,105914389,30
"20063","ENSG00000211931","14",105916826,105916856,30
"20064","ENSG00000211933","14",105939756,105940253,497
"20065","ENSG00000211934","14",105986582,105987083,501
"20066","ENSG00000211935","14",106005095,106005574,479
"20067","ENSG00000211937","14",106037902,106038365,463
"20068","ENSG00000211938","14",106062151,106062683,532
"20069","ENSG00000211941","14",106116635,106117204,569
"20070","ENSG00000211942","14",106129540,106130072,532
"20071","ENSG00000211943","14",106153624,106154163,539
"20072","ENSG00000211944","14",106165205,106165730,525
"20073","ENSG00000211945","14",106184901,106185394,493
"20074","ENSG00000211946","14",106210936,106211453,517
"20075","ENSG00000211947","14",106235064,106235594,530
"20076","ENSG00000211949","14",106268606,106269140,534
"20077","ENSG00000211950","14",106276548,106277043,495
"20078","ENSG00000211951","14",106301396,106301862,466
"20079","ENSG00000211952","14",106324254,106324760,506
"20080","ENSG00000211955","14",106359793,106360324,531
"20081","ENSG00000211956","14",106373663,106374145,482
"20082","ENSG00000211957","14",106389392,106389858,466
"20083","ENSG00000211958","14",106410493,106411021,528
"20084","ENSG00000211959","14",106421711,106422218,507
"20085","ENSG00000211961","14",106506996,106507491,495
"20086","ENSG00000211962","14",106511117,106511856,739
"20087","ENSG00000211964","14",106537810,106538344,534
"20088","ENSG00000211965","14",106556936,106557477,541
"20089","ENSG00000211966","14",106578744,106579236,492
"20090","ENSG00000211967","14",106592676,106593347,671
"20091","ENSG00000211968","14",106622357,106622855,498
"20092","ENSG00000211970","14",106639119,106639657,538
"20093","ENSG00000211972","14",106675017,106675544,527
"20094","ENSG00000211973","14",106714684,106715181,497
"20095","ENSG00000211974","14",106723574,106724093,519
"20096","ENSG00000211976","14",106802694,106803233,539
"20097","ENSG00000211978","14",106851123,106851417,294
"20098","ENSG00000211979","14",106874583,106875071,488
"20099","ENSG00000211991","X",70022857,70022923,66
"20100","ENSG00000211997","11",79402022,79402109,87
"20101","ENSG00000212013","X",147258760,147258850,90
"20102","ENSG00000212014","X",147259652,147259726,74
"20103","ENSG00000212017","6",57390132,57390212,80
"20104","ENSG00000212024","7",29680734,29680828,94
"20105","ENSG00000212027","X",74218547,74218618,71
"20106","ENSG00000212040","14",101031987,101032064,77
"20107","ENSG00000212051","18",24321686,24321735,49
"20108","ENSG00000212122","5",113432554,113435031,2477
"20109","ENSG00000212123","19",5782960,5784746,1786
"20110","ENSG00000212124","12",11021619,11022620,1001
"20111","ENSG00000212125","12",10964425,10965352,927
"20112","ENSG00000212126","12",10985913,10986912,999
"20113","ENSG00000212127","12",10937406,11171573,234167
"20114","ENSG00000212128","12",10907926,10909562,1636
"20115","ENSG00000212134","20",31376319,31376446,127
"20116","ENSG00000212135","11",46762389,46762499,110
"20117","ENSG00000212138","12",109059986,109060100,114
"20118","ENSG00000212144","1",234593275,234593402,127
"20119","ENSG00000212145","3",41899111,41899253,142
"20120","ENSG00000212146","3",196341609,196341715,106
"20121","ENSG00000212149","17",42940575,42940702,127
"20122","ENSG00000212161","1",159851906,159851972,66
"20123","ENSG00000212163","17",2330180,2330370,190
"20124","ENSG00000212175","2",55565703,55565850,147
"20125","ENSG00000212186","17",20126388,20126488,100
"20126","ENSG00000212190","17",30861843,30861938,95
"20127","ENSG00000212195","17",58631641,58631836,195
"20128","ENSG00000212204","2",33285769,33285887,118
"20129","ENSG00000212205","1",211803017,211803104,87
"20130","ENSG00000212206","17",8329583,8329719,136
"20131","ENSG00000212207","X",41570923,41571029,106
"20132","ENSG00000212211","3",60856389,60856605,216
"20133","ENSG00000212215","5",61664145,61664239,94
"20134","ENSG00000212221","8",143350172,143350278,106
"20135","ENSG00000212228","16",11274113,11274236,123
"20136","ENSG00000212232","20",17962710,17962946,236
"20137","ENSG00000212237","1",228647912,228648032,120
"20138","ENSG00000212240","6",28915645,28915744,99
"20139","ENSG00000212241","X",115139030,115139123,93
"20140","ENSG00000212242","6",136630243,136630355,112
"20141","ENSG00000212246","2",208019638,208019741,103
"20142","ENSG00000212248","1",99978939,99979045,106
"20143","ENSG00000212257","1",65022968,65023074,106
"20144","ENSG00000212259","5",95521369,95521475,106
"20145","ENSG00000212260","5",69530613,69530717,104
"20146","ENSG00000212266","1",117688621,117688742,121
"20147","ENSG00000212279","15",74490959,74491028,69
"20148","ENSG00000212280","8",17748118,17748230,112
"20149","ENSG00000212283","2",101272936,101273049,113
"20150","ENSG00000212293","13",32420390,32420516,126
"20151","ENSG00000212296","5",40832656,40832735,79
"20152","ENSG00000212297","3",198071311,198071417,106
"20153","ENSG00000212303","7",135665599,135665702,103
"20154","ENSG00000212306","15",100638363,100638457,94
"20155","ENSG00000212309","2",202278108,202278192,84
"20156","ENSG00000212316","9",75198071,75198177,106
"20157","ENSG00000212325","10",100398352,100398446,94
"20158","ENSG00000212327","3",9919051,9919153,102
"20159","ENSG00000212329","18",14190700,14190806,106
"20160","ENSG00000212331","10",154831,154943,112
"20161","ENSG00000212332","10",86488446,86488549,103
"20162","ENSG00000212336","6",81622200,81622319,119
"20163","ENSG00000212340","3",64511755,64511857,102
"20164","ENSG00000212342","8",130162972,130163127,155
"20165","ENSG00000212348","8",74048677,74048784,107
"20166","ENSG00000212359","4",120810469,120810569,100
"20167","ENSG00000212360","1",61852499,61852602,103
"20168","ENSG00000212365","11",14134986,14135100,114
"20169","ENSG00000212370","5",112778363,112778469,106
"20170","ENSG00000212371","14",77466284,77466436,152
"20171","ENSG00000212379","16",58378052,58378148,96
"20172","ENSG00000212380","15",25264510,25264590,80
"20173","ENSG00000212384","14",100927342,100927413,71
"20174","ENSG00000212385","1",116413766,116413869,103
"20175","ENSG00000212388","15",84939617,84939723,106
"20176","ENSG00000212389","2",147877422,147877528,106
"20177","ENSG00000212391","2",226968989,226969122,133
"20178","ENSG00000212396","10",93510548,93510680,132
"20179","ENSG00000212402","5",173020728,173020928,200
"20180","ENSG00000212409","9",111097325,111097413,88
"20181","ENSG00000212411","10",29575306,29575381,75
"20182","ENSG00000212413","10",103312436,103312568,132
"20183","ENSG00000212414","8",100004583,100004649,66
"20184","ENSG00000212418","17",76703632,76703727,95
"20185","ENSG00000212420","15",89886485,89886591,106
"20186","ENSG00000212421","9",87260450,87260585,135
"20187","ENSG00000212422","7",10222797,10223011,214
"20188","ENSG00000212429","8",80749561,80749693,132
"20189","ENSG00000212434","X",69692956,69693155,199
"20190","ENSG00000212440","12",9286673,9286822,149
"20191","ENSG00000212443","12",98599635,98599883,248
"20192","ENSG00000212445","16",68189287,68189421,134
"20193","ENSG00000212447","9",122880213,122880323,110
"20194","ENSG00000212451","8",126671522,126671654,132
"20195","ENSG00000212452","3",52692736,52692812,76
"20196","ENSG00000212457","5",116188455,116188552,97
"20197","ENSG00000212458","4",1118884,1119013,129
"20198","ENSG00000212460","5",138116573,138116680,107
"20199","ENSG00000212461","12",71639355,71639483,128
"20200","ENSG00000212464","10",100237156,100237302,146
"20201","ENSG00000212479","21",29180425,29180639,214
"20202","ENSG00000212482","7",79343266,79343372,106
"20203","ENSG00000212485","8",74079537,74079643,106
"20204","ENSG00000212493","3",52689248,52689315,67
"20205","ENSG00000212496","12",50256238,50256344,106
"20206","ENSG00000212497","19",12027913,12028021,108
"20207","ENSG00000212510","X",136773999,136774105,106
"20208","ENSG00000212517","20",5121417,5121539,122
"20209","ENSG00000212520","10",67808502,67808608,106
"20210","ENSG00000212521","9",98032230,98032335,105
"20211","ENSG00000212525","6",108252401,108252507,106
"20212","ENSG00000212526","15",30956248,30956350,102
"20213","ENSG00000212528","15",25268466,25268551,85
"20214","ENSG00000212529","5",172252334,172252478,144
"20215","ENSG00000212533","12",31076867,31077016,149
"20216","ENSG00000212534","2",202276431,202276518,87
"20217","ENSG00000212535","12",95290692,95290799,107
"20218","ENSG00000212536","20",5098387,5098476,89
"20219","ENSG00000212541","1",37991462,37991569,107
"20220","ENSG00000212542","22",31305404,31305512,108
"20221","ENSG00000212549","12",26373598,26373733,135
"20222","ENSG00000212556","3",127202372,127202473,101
"20223","ENSG00000212565","17",48880840,48880967,127
"20224","ENSG00000212567","5",40790077,40790204,127
"20225","ENSG00000212569","22",50669804,50669901,97
"20226","ENSG00000212572","18",9617964,9618072,108
"20227","ENSG00000212576","19",12106497,12106614,117
"20228","ENSG00000212579","6",35651818,35651945,127
"20229","ENSG00000212584","X",101691580,101691685,105
"20230","ENSG00000212586","6",38822307,38822404,97
"20231","ENSG00000212587","6",110848546,110848673,127
"20232","ENSG00000212588","4",52713249,52713370,121
"20233","ENSG00000212593","16",23441841,23441921,80
"20234","ENSG00000212594","12",103592112,103592243,131
"20235","ENSG00000212597","11",128993237,128993340,103
"20236","ENSG00000212601","1",93488333,93488452,119
"20237","ENSG00000212604","15",26008940,26009074,134
"20238","ENSG00000212605","X",71020275,71020438,163
"20239","ENSG00000212607","11",8685439,8685569,130
"20240","ENSG00000212615","14",45088243,45088308,65
"20241","ENSG00000212624","1",51724775,51724896,121
"20242","ENSG00000212625","15",60736769,60736886,117
"20243","ENSG00000212628","7",121083700,121083813,113
"20244","ENSG00000212643","5",112891610,112893079,1469
"20245","ENSG00000212657","17",41307700,41309253,1553
"20246","ENSG00000212659","17",41265339,41266641,1302
"20247","ENSG00000212663","X",13980066,13988820,8754
"20248","ENSG00000212664","15",71341158,71341712,554
"20249","ENSG00000212694","12",121795267,121803906,8639
"20250","ENSG00000212695","9",8713311,8713841,530
"20251","ENSG00000212710","18",22413601,22417915,4314
"20252","ENSG00000212712","18",12056676,12057822,1146
"20253","ENSG00000212719","17",21428263,21574517,146254
"20254","ENSG00000212721","17",41117181,41118360,1179
"20255","ENSG00000212724","17",41059240,41060114,874
"20256","ENSG00000212743","10",6350316,6352762,2446
"20257","ENSG00000212747","X",135020504,135022529,2025
"20258","ENSG00000212766","15",69072926,69095820,22894
"20259","ENSG00000212769","10",84081429,84081995,566
"20260","ENSG00000212789","11",18261982,18263091,1109
"20261","ENSG00000212802","6",12514110,12514724,614
"20262","ENSG00000212807","7",144228244,144239605,11361
"20263","ENSG00000212829","9",9090898,9091245,347
"20264","ENSG00000212864","9",137220247,137221581,1334
"20265","ENSG00000212900","17",40999193,40999894,701
"20266","ENSG00000212901","17",41008521,41019324,10803
"20267","ENSG00000212907","MT",10470,10766,296
"20268","ENSG00000212916","1",232804892,232808407,3515
"20269","ENSG00000212930","5",91223419,91223967,548
"20270","ENSG00000212939","22",49548681,49556473,7792
"20271","ENSG00000212952","9",42568865,42569315,450
"20272","ENSG00000212961","11",74354443,74355720,1277
"20273","ENSG00000212978","2",61141592,61144969,3377
"20274","ENSG00000212993","8",127322183,127420066,97883
"20275","ENSG00000212994","8",100895771,100896118,347
"20276","ENSG00000213003","8",70273369,70273837,468
"20277","ENSG00000213005","8",66767400,66768005,605
"20278","ENSG00000213013","19",58216180,58216561,381
"20279","ENSG00000213014","19",56317177,56318008,831
"20280","ENSG00000213015","19",55635016,55643470,8454
"20281","ENSG00000213018","X",71420083,71420514,431
"20282","ENSG00000213020","19",52702813,52735073,32260
"20283","ENSG00000213023","19",50621307,50639881,18574
"20284","ENSG00000213024","19",49906825,49929763,22938
"20285","ENSG00000213025","10",68632371,68632727,356
"20286","ENSG00000213028","1",229688999,229689904,905
"20287","ENSG00000213033","1",220266706,220267917,1211
"20288","ENSG00000213035","19",47794467,47794890,423
"20289","ENSG00000213036","1",214482813,214483387,574
"20290","ENSG00000213041","1",205202191,205202742,551
"20291","ENSG00000213045","1",200329161,200329677,516
"20292","ENSG00000213046","1",197688760,197690627,1867
"20293","ENSG00000213047","1",197504748,197775696,270948
"20294","ENSG00000213049","12",9027532,9029089,1557
"20295","ENSG00000213050","7",116972165,116972911,746
"20296","ENSG00000213051","1",185226808,185227700,892
"20297","ENSG00000213055","2",232729523,232730198,675
"20298","ENSG00000213057","1",178542752,178548889,6137
"20299","ENSG00000213058","1",178411616,178411972,356
"20300","ENSG00000213060","1",171803517,171803939,422
"20301","ENSG00000213061","10",102838011,102845473,7462
"20302","ENSG00000213062","1",169486076,169500182,14106
"20303","ENSG00000213063","1",168938467,168938923,456
"20304","ENSG00000213064","1",168225938,168253021,27083
"20305","ENSG00000213065","6",167767083,167768568,1485
"20306","ENSG00000213066","6",166999317,167094789,95472
"20307","ENSG00000213067","7",56597379,56598342,963
"20308","ENSG00000213068","1",167162423,167162837,414
"20309","ENSG00000213070","1",164356767,164357364,597
"20310","ENSG00000213071","6",160453428,160520269,66841
"20311","ENSG00000213073","6",160093082,160096212,3130
"20312","ENSG00000213075","1",161683695,161685252,1557
"20313","ENSG00000213076","6",158921271,158922150,879
"20314","ENSG00000213078","6",157365990,157366923,933
"20315","ENSG00000213079","6",154733325,154834244,100919
"20316","ENSG00000213080","1",160894980,160896076,1096
"20317","ENSG00000213082","2",207681590,207682033,443
"20318","ENSG00000213085","1",159872364,159900165,27801
"20319","ENSG00000213087","6",151225550,151225947,397
"20320","ENSG00000213088","1",159203307,159206500,3193
"20321","ENSG00000213089","6",150827663,150828384,721
"20322","ENSG00000213090","2",201410544,201413308,2764
"20323","ENSG00000213096","19",24033405,24129961,96556
"20324","ENSG00000213100","X",45983365,45984364,999
"20325","ENSG00000213104","2",197379701,197380892,1191
"20326","ENSG00000213108","6",137543897,137544372,475
"20327","ENSG00000213109","6",136900233,136901529,1296
"20328","ENSG00000213110","2",189930277,189931010,733
"20329","ENSG00000213113","3",198119721,198120778,1057
"20330","ENSG00000213115","2",188227189,188228382,1193
"20331","ENSG00000213117","6",134897874,134898759,885
"20332","ENSG00000213118","6",134393142,134393900,758
"20333","ENSG00000213121","6",153231320,153347488,116168
"20334","ENSG00000213122","6",132997551,132998040,489
"20335","ENSG00000213123","3",196291219,196318299,27080
"20336","ENSG00000213126","2",179814251,179814675,424
"20337","ENSG00000213128","17",80542203,80542605,402
"20338","ENSG00000213130","6",128580113,128580884,771
"20339","ENSG00000213131","6",127355756,127356789,1033
"20340","ENSG00000213133","6",126257921,126258355,434
"20341","ENSG00000213137","12",120845110,120845647,537
"20342","ENSG00000213139","3",186538441,186546702,8261
"20343","ENSG00000213140","14",105672308,105673314,1006
"20344","ENSG00000213144","12",119194850,119195394,544
"20345","ENSG00000213145","14",105486317,105488947,2630
"20346","ENSG00000213148","2",173431349,173431812,463
"20347","ENSG00000213149","6",110858239,110859147,908
"20348","ENSG00000213150","6",110645699,110646558,859
"20349","ENSG00000213152","12",112301870,112302663,793
"20350","ENSG00000213153","11",133864877,133865627,750
"20351","ENSG00000213155","3",181866351,181867154,803
"20352","ENSG00000213157","3",180887677,180888075,398
"20353","ENSG00000213160","2",169694488,169776989,82501
"20354","ENSG00000213167","7",116320751,116321031,280
"20355","ENSG00000213169","3",174377244,174378005,761
"20356","ENSG00000213170","10",126272818,126273411,593
"20357","ENSG00000213171","1",151800264,151806154,5890
"20358","ENSG00000213172","1",40364766,40365183,417
"20359","ENSG00000213174","3",170653846,170654259,413
"20360","ENSG00000213176","14",103041469,103042094,625
"20361","ENSG00000213177","6",100136064,100136663,599
"20362","ENSG00000213178","3",169483671,169484080,409
"20363","ENSG00000213179","17",67784753,67785293,540
"20364","ENSG00000213180","17",67224728,67225041,313
"20365","ENSG00000213183","6",96648489,96649069,580
"20366","ENSG00000213184","11",123017638,123018661,1023
"20367","ENSG00000213185","10",122849078,122879641,30563
"20368","ENSG00000213186","3",160432445,160485773,53328
"20369","ENSG00000213188","7",152128879,152129686,807
"20370","ENSG00000213189","2",159003975,159004320,345
"20371","ENSG00000213190","1",151057758,151068497,10739
"20372","ENSG00000213194","2",157210847,157211539,692
"20373","ENSG00000213197","2",152389937,152390630,693
"20374","ENSG00000213199","7",151048292,151052756,4464
"20375","ENSG00000213201","2",151186188,151186595,407
"20376","ENSG00000213203","7",150716606,150724284,7678
"20377","ENSG00000213204","6",87408012,87511634,103622
"20378","ENSG00000213205","7",150512559,150513839,1280
"20379","ENSG00000213209","7",148637179,148637587,408
"20380","ENSG00000213211","6",85287789,85289007,1218
"20381","ENSG00000213212","9",136812788,136815536,2748
"20382","ENSG00000213213","9",136796350,136807741,11391
"20383","ENSG00000213214","7",144186083,144195655,9572
"20384","ENSG00000213216","9",123029373,123029753,380
"20385","ENSG00000213218","17",63872012,63873766,1754
"20386","ENSG00000213221","9",136359480,136363744,4264
"20387","ENSG00000213222","2",131723253,131724279,1026
"20388","ENSG00000213225","2",130229379,130232106,2727
"20389","ENSG00000213226","1",147319110,147320224,1114
"20390","ENSG00000213228","17",60433678,60435996,2318
"20391","ENSG00000213231","14",95686426,95692628,6202
"20392","ENSG00000213232","13",63811014,63811608,594
"20393","ENSG00000213234","11",112267290,112268371,1081
"20394","ENSG00000213235","12",16990670,16992083,1413
"20395","ENSG00000213236","2",126557435,126558162,727
"20396","ENSG00000213237","7",138404195,138404523,328
"20397","ENSG00000213239","2",121708512,121709115,603
"20398","ENSG00000213244","1",121118195,121118610,415
"20399","ENSG00000213246","17",58345175,58353093,7918
"20400","ENSG00000213247","10",111104956,111105248,292
"20401","ENSG00000213250","12",94423744,94424969,1225
"20402","ENSG00000213252","11",106826392,106827890,1498
"20403","ENSG00000213253","19",13157959,13158788,829
"20404","ENSG00000213260","10",105686322,105687051,729
"20405","ENSG00000213261","7",131661952,131662624,672
"20406","ENSG00000213262","1",117640812,117641639,827
"20407","ENSG00000213265","7",130668648,130687432,18784
"20408","ENSG00000213269","X",74376125,74376885,760
"20409","ENSG00000213270","12",83151331,83152190,859
"20410","ENSG00000213272","12",76599671,76600470,799
"20411","ENSG00000213275","11",69303412,69303807,395
"20412","ENSG00000213277","10",103175554,103176094,540
"20413","ENSG00000213279","22",49572264,49575426,3162
"20414","ENSG00000213280","7",128570241,128570688,447
"20415","ENSG00000213281","1",114704469,114716771,12302
"20416","ENSG00000213287","11",87258851,87259259,408
"20417","ENSG00000213290","19",12559571,12561105,1534
"20418","ENSG00000213291","7",125300504,125300878,374
"20419","ENSG00000213293","19",12260126,12260537,411
"20420","ENSG00000213296","7",124480524,124481395,871
"20421","ENSG00000213297","19",12132117,12156731,24614
"20422","ENSG00000213300","3",75214631,75215636,1005
"20423","ENSG00000213303","19",11523436,11523831,395
"20424","ENSG00000213304","19",11521968,11522498,530
"20425","ENSG00000213305","11",85020785,85021655,870
"20426","ENSG00000213307","15",78661047,78661576,529
"20427","ENSG00000213309","6",63615827,63616361,534
"20428","ENSG00000213310","7",121398452,121398767,315
"20429","ENSG00000213312","6",63548708,63549508,800
"20430","ENSG00000213315","14",90766531,90766989,458
"20431","ENSG00000213316","5",179793980,179796647,2667
"20432","ENSG00000213318","16",75192465,75193247,782
"20433","ENSG00000213326","17",46721582,46722167,585
"20434","ENSG00000213328","5",178909710,178910609,899
"20435","ENSG00000213331","4",187970273,187971284,1011
"20436","ENSG00000213332","4",186328716,186329601,885
"20437","ENSG00000213333","11",75079265,75080131,866
"20438","ENSG00000213335","6",54485169,54485850,681
"20439","ENSG00000213337","2",96836611,96858016,21405
"20440","ENSG00000213338","X",154622428,154623500,1072
"20441","ENSG00000213339","19",10701430,10713437,12007
"20442","ENSG00000213341","10",100188300,100229596,41296
"20443","ENSG00000213343","12",66037235,66037714,479
"20444","ENSG00000213344","12",65645992,65646462,470
"20445","ENSG00000213347","5",177301461,177312757,11296
"20446","ENSG00000213352","12",62755227,62756233,1006
"20447","ENSG00000213355","2",94737337,94738249,912
"20448","ENSG00000213358","3",196527339,196528791,1452
"20449","ENSG00000213361","7",105244652,105244970,318
"20450","ENSG00000213362","9",15527133,15527683,550
"20451","ENSG00000213363","12",62021570,62022174,604
"20452","ENSG00000213365","11",72280151,72281178,1027
"20453","ENSG00000213366","1",109668022,109709551,41529
"20454","ENSG00000213368","11",94913047,94913766,719
"20455","ENSG00000213370","4",173633728,173634371,643
"20456","ENSG00000213371","3",120805866,120806745,879
"20457","ENSG00000213373","17",42874670,42898704,24034
"20458","ENSG00000213376","5",174513305,174514307,1002
"20459","ENSG00000213380","16",69320140,69339667,19527
"20460","ENSG00000213383","3",17871729,17872598,869
"20461","ENSG00000213384","20",20659710,20659964,254
"20462","ENSG00000213385","7",102755146,102755939,793
"20463","ENSG00000213386","5",172762521,172763258,737
"20464","ENSG00000213390","10",97222173,97292673,70500
"20465","ENSG00000213394","7",101203614,101204495,881
"20466","ENSG00000213397","X",153447666,153495516,47850
"20467","ENSG00000213398","16",67939750,67944131,4381
"20468","ENSG00000213399","2",84915868,84916660,792
"20469","ENSG00000213401","X",152733757,152737669,3912
"20470","ENSG00000213406","4",153307792,153308717,925
"20471","ENSG00000213409","11",66761575,66762399,824
"20472","ENSG00000213411","13",30539597,30543461,3864
"20473","ENSG00000213412","10",46415853,46416413,560
"20474","ENSG00000213413","7",100218241,100221490,3249
"20475","ENSG00000213420","7",100169606,100177381,7775
"20476","ENSG00000213424","17",40654665,40665181,10516
"20477","ENSG00000213430","5",21882585,21884310,1725
"20478","ENSG00000213431","3",100910975,100912175,1200
"20479","ENSG00000213432","10",93284004,93284558,554
"20480","ENSG00000213433","5",151765859,151766378,519
"20481","ENSG00000213434","4",183483490,183484185,695
"20482","ENSG00000213435","6",42727234,42727700,466
"20483","ENSG00000213438","10",123991910,123992669,759
"20484","ENSG00000213440","21",44046347,44047041,694
"20485","ENSG00000213442","12",104265309,104265836,527
"20486","ENSG00000213445","11",65638101,65650918,12817
"20487","ENSG00000213448","4",137448087,137448501,414
"20488","ENSG00000213449","10",91666780,91667782,1002
"20489","ENSG00000213450","3",77316752,77317598,846
"20490","ENSG00000213451","12",55262539,55263431,892
"20491","ENSG00000213453","2",27392784,27393367,583
"20492","ENSG00000213455","7",98454119,98454617,498
"20493","ENSG00000213462","7",64990356,65006743,16387
"20494","ENSG00000213463","14",70366499,70417090,50591
"20495","ENSG00000213465","11",65014160,65022184,8024
"20496","ENSG00000213467","9",121519816,121520424,608
"20497","ENSG00000213468","X",131688779,131830862,142083
"20498","ENSG00000213470","12",53632788,53633151,363
"20499","ENSG00000213471","15",90249530,90265482,15952
"20500","ENSG00000213478","1",51157788,51158471,683
"20501","ENSG00000213480","4",121369433,121370345,912
"20502","ENSG00000213484","10",92136875,92138370,1495
"20503","ENSG00000213486","2",61710076,61710978,902
"20504","ENSG00000213489","X",125326897,125328021,1124
"20505","ENSG00000213492","4",117574512,117576174,1662
"20506","ENSG00000213493","4",116598161,116599611,1450
"20507","ENSG00000213495","2",60711484,60711920,436
"20508","ENSG00000213509","3",57941818,57942304,486
"20509","ENSG00000213512","1",89131742,89176009,44267
"20510","ENSG00000213513","10",77780337,77781876,1539
"20511","ENSG00000213514","10",77730766,77734769,4003
"20512","ENSG00000213516","1",88979456,88992960,13504
"20513","ENSG00000213519","3",197580344,197580629,285
"20514","ENSG00000213522","4",107203349,107203924,575
"20515","ENSG00000213523","5",140537340,140558252,20912
"20516","ENSG00000213525","10",74744386,74744707,321
"20517","ENSG00000213526","X",116963049,116963676,627
"20518","ENSG00000213527","15",79751689,79752049,360
"20519","ENSG00000213529","9",112362714,112363116,402
"20520","ENSG00000213533","3",52836219,52897548,61329
"20521","ENSG00000213538","11",9094377,9095890,1513
"20522","ENSG00000213539","9",109532830,109534332,1502
"20523","ENSG00000213540","1",84085741,84086233,492
"20524","ENSG00000213542","7",77115399,77116192,793
"20525","ENSG00000213543","10",133637408,133637892,484
"20526","ENSG00000213547","16",31546805,31547737,932
"20527","ENSG00000213549","7",76113026,76113400,374
"20528","ENSG00000213551","10",73183362,73248862,65500
"20529","ENSG00000213553","2",38481851,38482804,953
"20530","ENSG00000213557","9",108040213,108040592,379
"20531","ENSG00000213559","1",80451083,80452004,921
"20532","ENSG00000213560","1",78091499,78092054,555
"20533","ENSG00000213561","1",78043383,78044148,765
"20534","ENSG00000213563","8",144525733,144529132,3399
"20535","ENSG00000213568","5",136428892,136429854,962
"20536","ENSG00000213569","X",107131659,107132269,610
"20537","ENSG00000213574","10",118932674,118933295,621
"20538","ENSG00000213579","1",75582099,75582555,456
"20539","ENSG00000213585","5",133971871,134004975,33104
"20540","ENSG00000213588","6",33453970,33457544,3574
"20541","ENSG00000213590","9",136935840,136937161,1321
"20542","ENSG00000213592","11",57718044,57718530,486
"20543","ENSG00000213593","11",57712593,57740973,28380
"20544","ENSG00000213594","2",38285410,38286410,1000
"20545","ENSG00000213598","14",58794654,58795029,375
"20546","ENSG00000213599","16",30193892,30204310,10418
"20547","ENSG00000213600","3",50239618,50239984,366
"20548","ENSG00000213601","2",189311263,189311967,704
"20549","ENSG00000213605","2",86885075,86885731,656
"20550","ENSG00000213606","10",67750284,67751225,941
"20551","ENSG00000213608","4",83477524,83478424,900
"20552","ENSG00000213609","10",63902451,63903245,794
"20553","ENSG00000213612","9",97121659,97122489,830
"20554","ENSG00000213613","10",87945502,87946024,522
"20555","ENSG00000213614","15",72340919,72376476,35557
"20556","ENSG00000213619","11",47565336,47584562,19226
"20557","ENSG00000213620","2",31290762,31291604,842
"20558","ENSG00000213621","13",20961310,20962195,885
"20559","ENSG00000213625","1",65420587,65436007,15420
"20560","ENSG00000213626","2",30231534,30323730,92196
"20561","ENSG00000213630","5",126663337,126663568,231
"20562","ENSG00000213638","19",1905399,1913447,8048
"20563","ENSG00000213639","2",28751640,28802940,51300
"20564","ENSG00000213640","7",64862999,64864370,1371
"20565","ENSG00000213641","14",55543401,55544169,768
"20566","ENSG00000213642","7",64569428,64570437,1009
"20567","ENSG00000213643","7",64149685,64150432,747
"20568","ENSG00000213645","7",63931141,63931968,827
"20569","ENSG00000213650","7",56567906,56568858,952
"20570","ENSG00000213654","6",32190766,32195523,4757
"20571","ENSG00000213658","16",28984826,28990783,5957
"20572","ENSG00000213659","10",51319826,51320660,834
"20573","ENSG00000213661","5",121616247,121616807,560
"20574","ENSG00000213663","5",119547131,119547606,475
"20575","ENSG00000213667","10",50726947,50727969,1022
"20576","ENSG00000213669","9",92676943,92677407,464
"20577","ENSG00000213671","17",20775642,20776905,1263
"20578","ENSG00000213672","3",48673844,48686364,12520
"20579","ENSG00000213673","7",54419444,54420328,884
"20580","ENSG00000213676","6",32115264,32128253,12989
"20581","ENSG00000213683","22",50754675,50755434,759
"20582","ENSG00000213684","X",76334841,76335845,1004
"20583","ENSG00000213690","1",242376923,242377432,509
"20584","ENSG00000213693","11",43897456,43899636,2180
"20585","ENSG00000213694","9",88990863,89005155,14292
"20586","ENSG00000213695","X",74409518,74410100,582
"20587","ENSG00000213697","11",43522036,43523264,1228
"20588","ENSG00000213699","2",26764284,26781231,16947
"20589","ENSG00000213700","10",73005833,73006595,762
"20590","ENSG00000213701","5",97056402,97057358,956
"20591","ENSG00000213703","1",62641122,62641667,545
"20592","ENSG00000213704","X",98389512,98390919,1407
"20593","ENSG00000213706","X",71352418,71352988,570
"20594","ENSG00000213707","22",26560526,26561088,562
"20595","ENSG00000213708","8",106215763,106217218,1455
"20596","ENSG00000213711","9",85898903,85899716,813
"20597","ENSG00000213713","11",33075566,33076460,894
"20598","ENSG00000213714","20",56533246,56536520,3274
"20599","ENSG00000213716","5",95973041,95973446,405
"20600","ENSG00000213717","7",43274159,43274582,423
"20601","ENSG00000213719","6",31730581,31739763,9182
"20602","ENSG00000213721","7",42113365,42113620,255
"20603","ENSG00000213722","6",31727038,31730617,3579
"20604","ENSG00000213724","10",34965069,34966259,1190
"20605","ENSG00000213726","19",690353,691172,819
"20606","ENSG00000213727","22",15572089,15573265,1176
"20607","ENSG00000213729","2",20155618,20156057,439
"20608","ENSG00000213730","5",93267429,93268425,996
"20609","ENSG00000213731","10",74423435,74424014,579
"20610","ENSG00000213735","1",52253621,52254176,555
"20611","ENSG00000213739","2",205949091,205950145,1054
"20612","ENSG00000213740","X",68783472,68785066,1594
"20613","ENSG00000213741","14",49570984,49599164,28180
"20614","ENSG00000213742","20",25624045,25689032,64987
"20615","ENSG00000213744","7",37375522,37376023,501
"20616","ENSG00000213750","8",97624203,97625079,876
"20617","ENSG00000213752","22",45275599,45276085,486
"20618","ENSG00000213753","19",58573503,58605223,31720
"20619","ENSG00000213754","X",64305047,64306733,1686
"20620","ENSG00000213755","5",79510434,79510919,485
"20621","ENSG00000213757","5",79284132,79284918,786
"20622","ENSG00000213759","4",69199951,69214731,14780
"20623","ENSG00000213760","6",31544462,31548427,3965
"20624","ENSG00000213761","9",95413267,95413449,182
"20625","ENSG00000213762","19",57614233,57624724,10491
"20626","ENSG00000213763","5",77784881,77786003,1122
"20627","ENSG00000213770","10",27349717,27350290,573
"20628","ENSG00000213771","10",8513687,8515106,1419
"20629","ENSG00000213772","2",9271292,9271628,336
"20630","ENSG00000213777","19",53503392,53512687,9295
"20631","ENSG00000213778","10",30517616,30518861,1245
"20632","ENSG00000213779","11",17193489,17194308,819
"20633","ENSG00000213780","6",30908207,30914106,5899
"20634","ENSG00000213781","7",27461766,27462969,1203
"20635","ENSG00000213782","12",12813316,12829981,16665
"20636","ENSG00000213783","7",27269357,27269678,321
"20637","ENSG00000213785","11",16484084,16484671,587
"20638","ENSG00000213786","7",27048169,27048628,459
"20639","ENSG00000213787","7",26922110,26922912,802
"20640","ENSG00000213790","22",42107765,42108953,1188
"20641","ENSG00000213791","8",80300869,80301481,612
"20642","ENSG00000213793","19",52904417,52923481,19064
"20643","ENSG00000213798","7",25212170,25212965,795
"20644","ENSG00000213799","19",53333746,53356906,23160
"20645","ENSG00000213801","19",52927135,52942601,15466
"20646","ENSG00000213809","12",10372353,10391874,19521
"20647","ENSG00000213816","9",42972386,42973289,903
"20648","ENSG00000213820","20",46099518,46100176,658
"20649","ENSG00000213822","19",51478622,51490952,12330
"20650","ENSG00000213830","5",69313371,69313872,501
"20651","ENSG00000213839","9",37885683,37886390,707
"20652","ENSG00000213842","3",32752910,32753901,991
"20653","ENSG00000213849","3",32507955,32508325,370
"20654","ENSG00000213851","4",43410041,43410937,896
"20655","ENSG00000213853","16",10528422,10580632,52210
"20656","ENSG00000213854","3",31181751,31182650,899
"20657","ENSG00000213856","X",49632500,49633349,849
"20658","ENSG00000213857","22",41074180,41075239,1059
"20659","ENSG00000213859","17",7351889,7354944,3055
"20660","ENSG00000213860","7",20002765,20003247,482
"20661","ENSG00000213862","15",47730144,47730935,791
"20662","ENSG00000213863","6",170615515,170728493,112978
"20663","ENSG00000213864","5",68159218,68159893,675
"20664","ENSG00000213866","9",35971344,35972318,974
"20665","ENSG00000213867","14",30821419,30821843,424
"20666","ENSG00000213871","3",25754925,25755670,745
"20667","ENSG00000213872","3",25749488,25749896,408
"20668","ENSG00000213875","7",13871856,13872513,657
"20669","ENSG00000213876","17",7140930,7141592,662
"20670","ENSG00000213880","6",29803195,29803991,796
"20671","ENSG00000213881","8",61202350,61203220,870
"20672","ENSG00000213885","21",25361821,25362431,610
"20673","ENSG00000213886","6",29555515,29559925,4410
"20674","ENSG00000213888","22",31346777,31348719,1942
"20675","ENSG00000213889","19",45488777,45502510,13733
"20676","ENSG00000213891","5",61390668,61391871,1203
"20677","ENSG00000213892","19",44699151,44710718,11567
"20678","ENSG00000213896","5",60429903,60430276,373
"20679","ENSG00000213900","6",29489271,29489676,405
"20680","ENSG00000213901","2",219161465,219170095,8630
"20681","ENSG00000213903","14",24311450,24318036,6586
"20682","ENSG00000213904","19",42397128,42652355,255227
"20683","ENSG00000213906","14",24305734,24312053,6319
"20684","ENSG00000213911","6",29229227,29230157,930
"20685","ENSG00000213917","2",214280638,214281452,814
"20686","ENSG00000213918","16",3611728,3680143,68415
"20687","ENSG00000213920","14",24213943,24216070,2127
"20688","ENSG00000213923","22",38290691,38318084,27393
"20689","ENSG00000213925","2",203772631,203773502,871
"20690","ENSG00000213926","19",39254916,39255269,353
"20691","ENSG00000213927","9",34661880,34664048,2168
"20692","ENSG00000213928","14",24161053,24166565,5512
"20693","ENSG00000213930","9",34638133,34651035,12902
"20694","ENSG00000213931","11",5268345,5505652,237307
"20695","ENSG00000213934","11",5248079,5249859,1780
"20696","ENSG00000213935","7",4865432,4865804,372
"20697","ENSG00000213937","16",3012923,3014505,1582
"20698","ENSG00000213938","2",199659551,199660729,1178
"20699","ENSG00000213939","17",4704816,4705217,401
"20700","ENSG00000213940","5",53206561,53207176,615
"20701","ENSG00000213942","12",6409637,6410013,376
"20702","ENSG00000213943","3",12787393,12788671,1278
"20703","ENSG00000213946","2",191881182,191882205,1023
"20704","ENSG00000213949","5",52787896,52959210,171314
"20705","ENSG00000213950","20",14757563,14758056,493
"20706","ENSG00000213956","5",50633124,50633602,478
"20707","ENSG00000213958","2",181961212,181962478,1266
"20708","ENSG00000213959","20",38614913,38615476,563
"20709","ENSG00000213962","2",177997273,177998770,1497
"20710","ENSG00000213963","2",177283508,177392691,109183
"20711","ENSG00000213964","3",11234256,11234582,326
"20712","ENSG00000213965","19",32691961,32713796,21835
"20713","ENSG00000213967","19",23914876,23945159,30283
"20714","ENSG00000213970","12",4323724,4324811,1087
"20715","ENSG00000213972","6",25272200,25273751,1551
"20716","ENSG00000213973","19",22752183,22784151,31968
"20717","ENSG00000213976","19",21382865,21387177,4312
"20718","ENSG00000213977","17",3662895,3668679,5784
"20719","ENSG00000213979","20",37444733,37445534,801
"20720","ENSG00000213981","2",170640374,170695374,55000
"20721","ENSG00000213983","14",23559565,23568070,8505
"20722","ENSG00000213985","19",20257720,20259418,1698
"20723","ENSG00000213987","1",41264550,41264862,312
"20724","ENSG00000213988","19",20077994,20127076,49082
"20725","ENSG00000213994","10",6197612,6202693,5081
"20726","ENSG00000213995","13",110615460,110639993,24533
"20727","ENSG00000213996","19",19264364,19273391,9027
"20728","ENSG00000213997","X",46646594,46647330,736
"20729","ENSG00000213999","19",19145567,19192131,46564
"20730","ENSG00000214003","7",152749079,152749735,656
"20731","ENSG00000214012","6",19612755,19614036,1281
"20732","ENSG00000214013","15",42273233,42356935,83702
"20733","ENSG00000214016","X",44741087,44741964,877
"20734","ENSG00000214018","X",44309314,44310476,1162
"20735","ENSG00000214019","X",44029332,44030921,1589
"20736","ENSG00000214021","3",9808086,9855138,47052
"20737","ENSG00000214022","7",150368189,150374044,5855
"20738","ENSG00000214026","11",1947278,1984522,37244
"20739","ENSG00000214027","6",15934782,15935315,533
"20740","ENSG00000214029","12",133106817,133130473,23656
"20741","ENSG00000214031","X",40760104,40761270,1166
"20742","ENSG00000214035","7",145009961,145010993,1032
"20743","ENSG00000214039","12",130032928,130045057,12129
"20744","ENSG00000214041","3",9348443,9349192,749
"20745","ENSG00000214043","12",126438837,126472790,33953
"20746","ENSG00000214046","19",16630751,16660442,29691
"20747","ENSG00000214049","19",15828206,15836328,8122
"20748","ENSG00000214050","8",28348287,28490278,141991
"20749","ENSG00000214062","4",77082403,77083126,723
"20750","ENSG00000214063","11",842812,867116,24304
"20751","ENSG00000214064","2",145337230,145338057,827
"20752","ENSG00000214067","10",110257064,110257843,779
"20753","ENSG00000214070","2",135897955,135898978,1023
"20754","ENSG00000214071","X",37077851,37078401,550
"20755","ENSG00000214073","3",1905651,1906125,474
"20756","ENSG00000214076","22",32269381,32273110,3729
"20757","ENSG00000214077","2",131423801,131424867,1066
"20758","ENSG00000214078","20",35626031,35664956,38925
"20759","ENSG00000214081","2",130680050,130685863,5813
"20760","ENSG00000214087","17",81681174,81683924,2750
"20761","ENSG00000214089","10",44414649,44415153,504
"20762","ENSG00000214093","22",31559483,31559939,456
"20763","ENSG00000214097","3",196506879,196515346,8467
"20764","ENSG00000214100","2",129922863,129934317,11454
"20765","ENSG00000214102","7",141708353,141731271,22918
"20766","ENSG00000214106","7",154928460,154952188,23728
"20767","ENSG00000214107","X",30243730,30252040,8310
"20768","ENSG00000214108","5",31908361,31909186,825
"20769","ENSG00000214110","9",14921337,14922334,997
"20770","ENSG00000214111","X",25029545,25030235,690
"20771","ENSG00000214113","6",5102593,5260939,158346
"20772","ENSG00000214114","1",38862493,38873368,10875
"20773","ENSG00000214121","9",12972843,12973438,595
"20774","ENSG00000214124","X",24513450,24513687,237
"20775","ENSG00000214125","22",31155966,31156647,681
"20776","ENSG00000214128","7",138797952,138838101,40149
"20777","ENSG00000214132","5",20304045,20305448,1403
"20778","ENSG00000214135","3",197578213,197627906,49693
"20779","ENSG00000214140","17",76527586,76553578,25992
"20780","ENSG00000214141","1",37776670,37779418,2748
"20781","ENSG00000214142","7",100139629,100140682,1053
"20782","ENSG00000214144","1",247229940,247231880,1940
"20783","ENSG00000214145","3",194296191,194322871,26680
"20784","ENSG00000214146","3",193957372,194003760,46388
"20785","ENSG00000214147","3",190830965,190832173,1208
"20786","ENSG00000214160","3",184242301,184249548,7247
"20787","ENSG00000214161","22",30481311,30481911,600
"20788","ENSG00000214174","17",64966550,64975576,9026
"20789","ENSG00000214176","17",64779259,64837154,57895
"20790","ENSG00000214182","13",81689911,81691072,1161
"20791","ENSG00000214184","2",108507515,108534196,26681
"20792","ENSG00000214185","20",34213495,34215892,2397
"20793","ENSG00000214188","7",116953899,117098806,144907
"20794","ENSG00000214189","19",12092263,12137235,44972
"20795","ENSG00000214190","9",5418373,5418976,603
"20796","ENSG00000214192","3",175718231,175718670,439
"20797","ENSG00000214193","1",36306387,36324886,18499
"20798","ENSG00000214194","7",113116718,113118560,1842
"20799","ENSG00000214195","9",5311444,5311716,272
"20800","ENSG00000214198","12",103843749,103930211,86462
"20801","ENSG00000214199","2",106697331,106698676,1345
"20802","ENSG00000214200","20",33912323,33913336,1013
"20803","ENSG00000214203","12",100009052,100009838,786
"20804","ENSG00000214204","1",115856910,115857819,909
"20805","ENSG00000214207","Y",5573145,5574431,1286
"20806","ENSG00000214210","3",164001606,164002465,859
"20807","ENSG00000214211","2",167713663,167716065,2402
"20808","ENSG00000214212","19",10836575,10869790,33215
"20809","ENSG00000214216","3",158962928,159266307,303379
"20810","ENSG00000214222","13",41384773,41385183,410
"20811","ENSG00000214223","19",11666069,11667030,961
"20812","ENSG00000214226","17",56791913,56838773,46860
"20813","ENSG00000214237","3",150871045,150905439,34394
"20814","ENSG00000214243","7",76650401,76650897,496
"20815","ENSG00000214244","5",60459848,60460739,891
"20816","ENSG00000214248","19",7898804,7903542,4738
"20817","ENSG00000214249","13",75237944,75240296,2352
"20818","ENSG00000214252","7",101287482,101289771,2289
"20819","ENSG00000214253","7",101239458,101252316,12858
"20820","ENSG00000214255","18",70430231,70431125,894
"20821","ENSG00000214259","16",85815873,85816536,663
"20822","ENSG00000214263","13",67266845,67267706,861
"20823","ENSG00000214264","11",112180773,112183191,2418
"20824","ENSG00000214265","15",24955034,25000276,45242
"20825","ENSG00000214266","13",65309855,65310953,1098
"20826","ENSG00000214269","13",64958097,64959396,1299
"20827","ENSG00000214273","4",190041342,190043414,2072
"20828","ENSG00000214274","14",20684177,20698971,14794
"20829","ENSG00000214278","5",403731,404546,815
"20830","ENSG00000214279","10",133453928,133523558,69630
"20831","ENSG00000214280","3",139582928,139583593,665
"20832","ENSG00000214282","X",45632292,45633733,1441
"20833","ENSG00000214283","3",136899076,136900076,1000
"20834","ENSG00000214286","3",17877455,17878169,714
"20835","ENSG00000214289","3",134351852,134356561,4709
"20836","ENSG00000214290","11",111298555,111308735,10180
"20837","ENSG00000214293","7",77657659,77696267,38608
"20838","ENSG00000214295","5",181099140,181100666,1526
"20839","ENSG00000214297","10",125666875,125667950,1075
"20840","ENSG00000214298","10",125166677,125166937,260
"20841","ENSG00000214300","7",100307702,100322196,14494
"20842","ENSG00000214301","3",133490824,133491505,681
"20843","ENSG00000214305","3",39161270,39161520,250
"20844","ENSG00000214309","7",100126785,100128495,1710
"20845","ENSG00000214313","7",99980762,99987535,6773
"20846","ENSG00000214318","18",63496989,63497400,411
"20847","ENSG00000214319","21",13676022,13677116,1094
"20848","ENSG00000214321","X",17282637,17283093,456
"20849","ENSG00000214322","X",17099782,17100239,457
"20850","ENSG00000214324","3",127193131,127198185,5054
"20851","ENSG00000214326","21",43551229,43551600,371
"20852","ENSG00000214329","2",91883076,91931714,48638
"20853","ENSG00000214330","2",91840601,91843802,3201
"20854","ENSG00000214331","16",74332402,74368240,35838
"20855","ENSG00000214335","13",58528615,58531026,2411
"20856","ENSG00000214336","2",88446787,88452656,5869
"20857","ENSG00000214338","6",127472794,127519191,46397
"20858","ENSG00000214342","7",94738652,94739411,759
"20859","ENSG00000214344","15",101842119,101850324,8205
"20860","ENSG00000214347","19",6393794,6412404,18610
"20861","ENSG00000214351","5",177836434,177837646,1212
"20862","ENSG00000214353","16",70755035,70773251,18216
"20863","ENSG00000214354","2",87565828,87566764,936
"20864","ENSG00000214357","5",172641266,172691540,50274
"20865","ENSG00000214359","13",50099331,50099868,537
"20866","ENSG00000214360","5",172194172,172203452,9280
"20867","ENSG00000214362","10",95594598,95595372,774
"20868","ENSG00000214367","4",2227464,2242164,14700
"20869","ENSG00000214369","2",169790093,169790885,792
"20870","ENSG00000214376","11",93818232,93850531,32299
"20871","ENSG00000214380","3",109915976,109916940,964
"20872","ENSG00000214381","3",109178143,109216965,38822
"20873","ENSG00000214389","7",98385801,98386584,783
"20874","ENSG00000214391","11",90282560,90284172,1612
"20875","ENSG00000214401","17",46193576,46196723,3147
"20876","ENSG00000214402","9",136981904,136986410,4506
"20877","ENSG00000214413","10",110898728,110919201,20473
"20878","ENSG00000214414","11",89710299,89717872,7573
"20879","ENSG00000214415","7",80458671,80512020,53349
"20880","ENSG00000214417","9",97698922,97700734,1812
"20881","ENSG00000214424","15",96756987,96758596,1609
"20882","ENSG00000214425","17",45506741,45551537,44796
"20883","ENSG00000214428","6",104025540,104026763,1223
"20884","ENSG00000214429","2",78412793,78413094,301
"20885","ENSG00000214432","15",91022619,91036611,13992
"20886","ENSG00000214433","15",90291962,90295683,3721
"20887","ENSG00000214435","10",102869470,102901899,32429
"20888","ENSG00000214439","7",77083787,77122116,38329
"20889","ENSG00000214455","13",45390353,45391267,914
"20890","ENSG00000214456","19",4522531,4535224,12693
"20891","ENSG00000214457","6",86970466,86971193,727
"20892","ENSG00000214460","6",85427453,85427966,513
"20893","ENSG00000214465","2",26149204,26150731,1527
"20894","ENSG00000214484","2",73370019,73370892,873
"20895","ENSG00000214485","5",150094302,150095048,746
"20896","ENSG00000214487","12",8427640,8428610,970
"20897","ENSG00000214491","22",30522799,30546682,23883
"20898","ENSG00000214510","5",148268180,148286255,18075
"20899","ENSG00000214511","12",50953922,50970506,16584
"20900","ENSG00000214513","2",73202258,73212513,10255
"20901","ENSG00000214514","17",41626327,41640199,13872
"20902","ENSG00000214517","11",74171267,74254703,83436
"20903","ENSG00000214525","2",68528241,68529452,1211
"20904","ENSG00000214526","22",23322543,23322927,384
"20905","ENSG00000214530","11",72754729,72793681,38952
"20906","ENSG00000214533","2",65666695,65667737,1042
"20907","ENSG00000214534","11",71814045,71821548,7503
"20908","ENSG00000214535","20",21166206,21166596,390
"20909","ENSG00000214541","20",56601701,56602113,412
"20910","ENSG00000214544","7",73242751,73280119,37368
"20911","ENSG00000214546","17",39619613,39622770,3157
"20912","ENSG00000214548","14",100779410,100861031,81621
"20913","ENSG00000214549","10",92118664,92119164,500
"20914","ENSG00000214552","3",68145004,68145630,626
"20915","ENSG00000214553","17",39027277,39053205,25928
"20916","ENSG00000214558","6",65302522,65304957,2435
"20917","ENSG00000214559","4",98251688,98261630,9942
"20918","ENSG00000214560","3",66637149,66637412,263
"20919","ENSG00000214561","6",58119741,58121029,1288
"20920","ENSG00000214562","10",87357668,87370695,13027
"20921","ENSG00000214563","6",57967687,57968661,974
"20922","ENSG00000214575","15",82543201,82648861,105660
"20923","ENSG00000214578","17",42753530,42753799,269
"20924","ENSG00000214581","16",35446898,35449411,2513
"20925","ENSG00000214584","10",79892148,79893175,1027
"20926","ENSG00000214593","9",125263845,125264090,245
"20927","ENSG00000214595","2",54723499,54972025,248526
"20928","ENSG00000214607","8",17469518,17471618,2100
"20929","ENSG00000214612","20",18504633,18505066,433
"20930","ENSG00000214614","16",32882586,32888874,6288
"20931","ENSG00000214617","16",32877469,32885501,8032
"20932","ENSG00000214626","10",74654956,74656131,1175
"20933","ENSG00000214628","X",96953630,96954195,565
"20934","ENSG00000214629","10",74371535,74372416,881
"20935","ENSG00000214641","6",51537155,51537543,388
"20936","ENSG00000214642","6",49968677,49969625,948
"20937","ENSG00000214643","6",49946021,49950265,4244
"20938","ENSG00000214646","15",77941442,77944582,3140
"20939","ENSG00000214650","12",124513222,124516798,3576
"20940","ENSG00000214651","9",121238117,121240089,1972
"20941","ENSG00000214652","7",64045434,64085339,39905
"20942","ENSG00000214653","X",140032344,140033480,1136
"20943","ENSG00000214654","9",120792403,120799918,7515
"20944","ENSG00000214655","10",73785582,73801797,16215
"20945","ENSG00000214657","2",15869939,15870243,304
"20946","ENSG00000214659","11",65726939,65728214,1275
"20947","ENSG00000214660","7",63556598,63562588,5990
"20948","ENSG00000214668","7",57014285,57020273,5988
"20949","ENSG00000214671","4",169166272,169167117,845
"20950","ENSG00000214676","4",168755816,168756382,566
"20951","ENSG00000214681","3",51873721,51875601,1880
"20952","ENSG00000214686","3",51778561,51779258,697
"20953","ENSG00000214688","10",71711701,71737824,26123
"20954","ENSG00000214691","2",41860155,41894050,33895
"20955","ENSG00000214694","2",38889841,38975449,85608
"20956","ENSG00000214695","10",79860573,79861806,1233
"20957","ENSG00000214700","12",27081058,27082514,1456
"20958","ENSG00000214706","3",50287732,50292918,5186
"20959","ENSG00000214708","17",32141226,32143135,1909
"20960","ENSG00000214711","2",31173056,31233858,60802
"20961","ENSG00000214717","X",2486414,2500976,14562
"20962","ENSG00000214719","17",30576464,30672789,96325
"20963","ENSG00000214720","X",107428630,107429461,831
"20964","ENSG00000214725","16",29863593,29868053,4460
"20965","ENSG00000214727","22",49757627,49758980,1353
"20966","ENSG00000214745","X",55961208,55962482,1274
"20967","ENSG00000214748","X",137324972,137325049,77
"20968","ENSG00000214753","11",62712630,62727472,14842
"20969","ENSG00000214754","7",47052793,47053674,881
"20970","ENSG00000214756","11",62665309,62668496,3187
"20971","ENSG00000214759","14",65268829,65269098,269
"20972","ENSG00000214760","12",122364782,122365632,850
"20973","ENSG00000214761","9",125595669,125596628,959
"20974","ENSG00000214765","7",45723780,45768985,45205
"20975","ENSG00000214770","14",64329431,64338639,9208
"20976","ENSG00000214772","12",14665655,14757963,92308
"20977","ENSG00000214773","3",47601715,47604677,2962
"20978","ENSG00000214776","12",9480608,9576275,95667
"20979","ENSG00000214782","11",60729304,60744212,14908
"20980","ENSG00000214783","7",43940895,44019175,78280
"20981","ENSG00000214784","5",111192226,111193042,816
"20982","ENSG00000214787","11",60200270,60243137,42867
"20983","ENSG00000214788","11",59942879,59970146,27267
"20984","ENSG00000214794","5",109588338,109589592,1254
"20985","ENSG00000214796","1",202851828,202861620,9792
"20986","ENSG00000214797","11",59268876,59284033,15157
"20987","ENSG00000214803","8",124192671,124247398,54727
"20988","ENSG00000214807","10",124867510,124868326,816
"20989","ENSG00000214810","6",34219439,34220066,627
"20990","ENSG00000214812","1",28120449,28121321,872
"20991","ENSG00000214814","8",123851987,124120061,268074
"20992","ENSG00000214815","7",138440690,138442238,1548
"20993","ENSG00000214819","17",20579724,20580911,1187
"20994","ENSG00000214820","3",44579938,44581026,1088
"20995","ENSG00000214821","2",170601662,170602228,566
"20996","ENSG00000214822","17",20501513,20512357,10844
"20997","ENSG00000214823","13",39169636,39169951,315
"20998","ENSG00000214825","3",44524744,44525805,1061
"20999","ENSG00000214826","12",9418673,9448229,29556
"21000","ENSG00000214827","X",155061622,155147937,86315
"21001","ENSG00000214832","17",20375369,20376840,1471
"21002","ENSG00000214835","20",10349157,10349628,471
"21003","ENSG00000214837","1",243056307,243101744,45437
"21004","ENSG00000214842","2",17510584,17518439,7855
"21005","ENSG00000214843","2",17284292,17284895,603
"21006","ENSG00000214846","4",15730962,15731627,665
"21007","ENSG00000214851","12",9055586,9065070,9484
"21008","ENSG00000214853","5",84999812,85000315,503
"21009","ENSG00000214855","19",44926804,44931386,4582
"21010","ENSG00000214856","17",18432051,18442895,10844
"21011","ENSG00000214857","5",81892490,81892721,231
"21012","ENSG00000214860","17",18377778,18389647,11869
"21013","ENSG00000214866","2",3703592,3847411,143819
"21014","ENSG00000214867","21",36295173,36295702,529
"21015","ENSG00000214869","7",27023737,27024907,1170
"21016","ENSG00000214870","7",26398593,26497595,99002
"21017","ENSG00000214872","11",57542641,57550274,7633
"21018","ENSG00000214875","10",68991137,68991707,570
"21019","ENSG00000214878","13",51161723,51162357,634
"21020","ENSG00000214880","11",55979398,55980103,705
"21021","ENSG00000214881","10",68544489,68544833,344
"21022","ENSG00000214886","4",98955982,98956767,785
"21023","ENSG00000214888","9",87857015,87859599,2584
"21024","ENSG00000214890","5",79000112,79001124,1012
"21025","ENSG00000214892","6",31275572,31278754,3182
"21026","ENSG00000214894","6",30798654,30830659,32005
"21027","ENSG00000214896","15",52885595,52886470,875
"21028","ENSG00000214897","X",153395640,153401420,5780
"21029","ENSG00000214900","14",49927571,50092643,165072
"21030","ENSG00000214908","9",86374966,86375706,740
"21031","ENSG00000214914","21",36016079,36016546,467
"21032","ENSG00000214915","X",151515551,151516245,694
"21033","ENSG00000214917","18",32075885,32076272,387
"21034","ENSG00000214919","3",155742142,155743726,1584
"21035","ENSG00000214922","6",29726601,29749049,22448
"21036","ENSG00000214925","X",141138478,141139174,696
"21037","ENSG00000214929","9",81988772,81995256,6484
"21038","ENSG00000214940","16",18317942,18336736,18794
"21039","ENSG00000214941","17",15976560,15999717,23157
"21040","ENSG00000214942","5",89900664,89990883,90219
"21041","ENSG00000214943","14",31482875,31488142,5267
"21042","ENSG00000214944","5",73626158,73941993,315835
"21043","ENSG00000214946","17",15732247,15749192,16945
"21044","ENSG00000214954","8",91101832,91219236,117404
"21045","ENSG00000214955","21",34205055,34325034,119979
"21046","ENSG00000214960","7",16087525,16421538,334013
"21047","ENSG00000214961","X",134272287,134273658,1371
"21048","ENSG00000214967","16",16379055,16393954,14899
"21049","ENSG00000214970","17",10579040,10623036,43996
"21050","ENSG00000214973","1",27200834,27201473,639
"21051","ENSG00000214975","6",24976419,24976982,563
"21052","ENSG00000214978","17",9802386,9822071,19685
"21053","ENSG00000214988","4",82490823,82491635,812
"21054","ENSG00000214992","X",119249346,119257667,8321
"21055","ENSG00000214998","7",7909300,7910449,1149
"21056","ENSG00000214999","17",8079482,8081565,2083
"21057","ENSG00000215000","X",109341813,109342697,884
"21058","ENSG00000215002","10",106550106,106551121,1015
"21059","ENSG00000215003","16",15931697,15932294,597
"21060","ENSG00000215004","3",29087396,29088599,1203
"21061","ENSG00000215005","21",28887280,28889272,1992
"21062","ENSG00000215006","5",69333929,69334249,320
"21063","ENSG00000215007","X",107351650,107352843,1193
"21064","ENSG00000215009","12",7304284,7328724,24440
"21065","ENSG00000215012","22",19846138,19854896,8758
"21066","ENSG00000215014","1",1574102,1577075,2973
"21067","ENSG00000215016","3",23134372,23134824,452
"21068","ENSG00000215018","7",7356203,7535853,179650
"21069","ENSG00000215021","12",6965327,6970825,5498
"21070","ENSG00000215022","6",13264861,13295586,30725
"21071","ENSG00000215023","2",241800916,241801907,991
"21072","ENSG00000215029","X",102456862,102471842,14980
"21073","ENSG00000215030","17",17383377,17384012,635
"21074","ENSG00000215032","5",60891935,60893577,1642
"21075","ENSG00000215035","X",44476027,44477422,1395
"21076","ENSG00000215037","13",83907301,83907781,480
"21077","ENSG00000215039","12",6439001,6451567,12566
"21078","ENSG00000215041","17",7315628,7329393,13765
"21079","ENSG00000215045","7",6497462,6551436,53974
"21080","ENSG00000215049","13",30296147,30296735,588
"21081","ENSG00000215054","X",144840777,144841660,883
"21082","ENSG00000215057","6",5972412,5974012,1600
"21083","ENSG00000215063","20",4059633,4060113,480
"21084","ENSG00000215065","10",47564256,47566016,1760
"21085","ENSG00000215067","17",6875232,7012530,137298
"21086","ENSG00000215068","5",43041575,43054603,13028
"21087","ENSG00000215070","X",99719364,99721158,1794
"21088","ENSG00000215086","10",72917641,72918534,893
"21089","ENSG00000215088","21",33481580,33482195,615
"21090","ENSG00000215093","X",86160264,86161359,1095
"21091","ENSG00000215096","8",63409064,63409457,393
"21092","ENSG00000215097","10",46774421,46776180,1759
"21093","ENSG00000215102","X",83748825,83749939,1114
"21094","ENSG00000215105","X",75740831,75746911,6080
"21095","ENSG00000215114","8",58411359,58451501,40142
"21096","ENSG00000215115","X",71714371,71718151,3780
"21097","ENSG00000215117","8",57279543,57286968,7425
"21098","ENSG00000215120","X",71527814,71530225,2411
"21099","ENSG00000215124","6",11861626,11862970,1344
"21100","ENSG00000215126","9",41131306,41199261,67955
"21101","ENSG00000215127","4",68061822,68063269,1447
"21102","ENSG00000215131","16",3493484,3495480,1996
"21103","ENSG00000215146","10",42331866,42367974,36108
"21104","ENSG00000215148","16",2798485,2805302,6817
"21105","ENSG00000215154","16",2603350,2630494,27144
"21106","ENSG00000215156","5",34190056,34193653,3597
"21107","ENSG00000215158","5",34164698,34244796,80098
"21108","ENSG00000215159","12",64759521,64779318,19797
"21109","ENSG00000215160","3",8682943,8693701,10758
"21110","ENSG00000215162","X",69179557,69209924,30367
"21111","ENSG00000215165","9",38478471,38479350,879
"21112","ENSG00000215174","X",57677067,57680260,3193
"21113","ENSG00000215177","8",47202444,47202897,453
"21114","ENSG00000215179","8",46972476,46974617,2141
"21115","ENSG00000215182","11",1157953,1201138,43185
"21116","ENSG00000215184","10",34675635,34676041,406
"21117","ENSG00000215186","15",72654738,72666394,11656
"21118","ENSG00000215187","9",35561831,35563899,2068
"21119","ENSG00000215190","6",57946074,57961501,15427
"21120","ENSG00000215193","22",18077920,18131138,53218
"21121","ENSG00000215196","5",17089296,17217047,127751
"21122","ENSG00000215198","9",35147410,35149184,1774
"21123","ENSG00000215199","9",34922184,34922921,737
"21124","ENSG00000215203","4",42893267,43030658,137391
"21125","ENSG00000215206","9",33649047,33649614,567
"21126","ENSG00000215208","12",65418731,65420027,1296
"21127","ENSG00000215210","9",30689105,30690272,1167
"21128","ENSG00000215217","5",7830378,7851151,20773
"21129","ENSG00000215218","5",6448859,6496723,47864
"21130","ENSG00000215221","9",22012155,22012536,381
"21131","ENSG00000215223","6",148478693,148480763,2070
"21132","ENSG00000215227","10",13870797,13871175,378
"21133","ENSG00000215231","5",4987789,5070314,82525
"21134","ENSG00000215236","9",15361393,15362134,741
"21135","ENSG00000215237","9",14993312,15019729,26417
"21136","ENSG00000215241","12",8235415,8242564,7149
"21137","ENSG00000215244","10",6271169,6353827,82658
"21138","ENSG00000215246","5",987180,997308,10128
"21139","ENSG00000215251","20",3146519,3159865,13346
"21140","ENSG00000215252","15",34525207,34588503,63296
"21141","ENSG00000215256","14",23938219,24052555,114336
"21142","ENSG00000215262","8",36784324,36936125,151801
"21143","ENSG00000215264","8",34322992,34323642,650
"21144","ENSG00000215267","10",5275173,5288470,13297
"21145","ENSG00000215268","22",15562017,15564276,2259
"21146","ENSG00000215270","22",15854195,15855243,1048
"21147","ENSG00000215271","14",23272422,23299447,27025
"21148","ENSG00000215274","X",49303669,49319844,16175
"21149","ENSG00000215277","14",23185316,23273477,88161
"21150","ENSG00000215278","4",17427696,17428274,578
"21151","ENSG00000215283","9",36303499,36304924,1425
"21152","ENSG00000215284","X",46725164,46725818,654
"21153","ENSG00000215286","X",45913118,45913871,753
"21154","ENSG00000215288","8",27011147,27012371,1224
"21155","ENSG00000215296","15",33235552,33247621,12069
"21156","ENSG00000215297","9",3364329,3364792,463
"21157","ENSG00000215301","X",41333284,41364472,31188
"21158","ENSG00000215302","15",30470779,30507623,36844
"21159","ENSG00000215304","15",32398956,32435233,36277
"21160","ENSG00000215305","20",2840703,2866732,26029
"21161","ENSG00000215310","X",33410944,33412173,1229
"21162","ENSG00000215311","7",149334024,149334857,833
"21163","ENSG00000215313","X",16198428,16199289,861
"21164","ENSG00000215317","21",28901779,28903697,1918
"21165","ENSG00000215319","X",9818239,9819469,1230
"21166","ENSG00000215325","5",145228811,145230054,1243
"21167","ENSG00000215326","21",27143344,27143949,605
"21168","ENSG00000215339","8",12356136,12359391,3255
"21169","ENSG00000215343","8",12104389,12115516,11127
"21170","ENSG00000215347","22",42000446,42001991,1545
"21171","ENSG00000215349","13",19304593,19305625,1032
"21172","ENSG00000215354","8",8019429,8024652,5223
"21173","ENSG00000215357","13",78849231,78851208,1977
"21174","ENSG00000215367","4",1115197,1153726,38529
"21175","ENSG00000215369","21",17894193,17894485,292
"21176","ENSG00000215372","8",7355517,7385558,30041
"21177","ENSG00000215374","8",7298744,7355359,56615
"21178","ENSG00000215375","4",673580,682033,8453
"21179","ENSG00000215378","8",6987178,6989721,2543
"21180","ENSG00000215380","11",35374265,35374474,209
"21181","ENSG00000215381","1",23244765,23245224,459
"21182","ENSG00000215386","21",15928296,16645467,717171
"21183","ENSG00000215388","20",1160584,1161697,1113
"21184","ENSG00000215397","20",661596,675802,14206
"21185","ENSG00000215399","13",101801878,101802488,610
"21186","ENSG00000215403","22",36965248,36968172,2924
"21187","ENSG00000215409","10",27331357,27341252,9895
"21188","ENSG00000215414","Y",13286638,13287378,740
"21189","ENSG00000215417","13",91347820,91354579,6759
"21190","ENSG00000215421","18",74597870,75065671,467801
"21191","ENSG00000215424","21",46229196,46259390,30194
"21192","ENSG00000215440","20",58689131,58719238,30107
"21193","ENSG00000215441","9",27608382,27610745,2363
"21194","ENSG00000215444","20",51734533,51735067,534
"21195","ENSG00000215448","20",47859788,47860672,884
"21196","ENSG00000215450","20",47160838,47161700,862
"21197","ENSG00000215452","20",46414228,46459276,45048
"21198","ENSG00000215456","22",22630065,22636153,6088
"21199","ENSG00000215457","18",51845007,51845628,621
"21200","ENSG00000215458","21",43805758,43812567,6809
"21201","ENSG00000215464","22",24269346,24270134,788
"21202","ENSG00000215467","20",43652523,43653291,768
"21203","ENSG00000215472","18",49481681,49492479,10798
"21204","ENSG00000215474","18",47206322,47251603,45281
"21205","ENSG00000215475","13",45777242,45851753,74511
"21206","ENSG00000215477","6",87121693,87122688,995
"21207","ENSG00000215478","22",23359603,23387731,28128
"21208","ENSG00000215480","13",41442770,41443666,896
"21209","ENSG00000215481","22",24632915,24650012,17097
"21210","ENSG00000215482","13",41170700,41171148,448
"21211","ENSG00000215483","13",40079106,40535807,456701
"21212","ENSG00000215486","13",36789332,36795050,5718
"21213","ENSG00000215492","18",32412214,32413176,962
"21214","ENSG00000215493","22",20450122,20451824,1702
"21215","ENSG00000215498","22",21167758,21192156,24398
"21216","ENSG00000215506","Y",26508213,26579690,71477
"21217","ENSG00000215512","18",15307663,15330282,22619
"21218","ENSG00000215515","13",32384660,32386108,1448
"21219","ENSG00000215520","1",20525989,20526751,762
"21220","ENSG00000215529","20",32858923,32961609,102686
"21221","ENSG00000215533","21",29193480,29288205,94725
"21222","ENSG00000215544","22",18855621,18858640,3019
"21223","ENSG00000215548","9",63832127,63859641,27514
"21224","ENSG00000215553","20",22732802,22734089,1287
"21225","ENSG00000215559","21",13909574,13980437,70863
"21226","ENSG00000215571","13",21319156,21320866,1710
"21227","ENSG00000215572","13",19560013,19561269,1256
"21228","ENSG00000215580","Y",19455431,19567092,111661
"21229","ENSG00000215586","20",7831798,7832322,524
"21230","ENSG00000215595","20",1203454,1208274,4820
"21231","ENSG00000215603","Y",7853686,7854876,1190
"21232","ENSG00000215606","3",141470634,141471902,1268
"21233","ENSG00000215612","4",8846076,8871839,25763
"21234","ENSG00000215630","5",71197646,71208130,10484
"21235","ENSG00000215644","17",81804132,81814008,9876
"21236","ENSG00000215692","2",241734715,241735498,783
"21237","ENSG00000215704","1",15465909,15491400,25491
"21238","ENSG00000215712","6",157289386,157323601,34215
"21239","ENSG00000215717","1",109089803,109096934,7131
"21240","ENSG00000215720","1",15191828,15192845,1017
"21241","ENSG00000215734","21",36994643,36995075,432
"21242","ENSG00000215760","10",114809375,114811170,1795
"21243","ENSG00000215765","19",54724496,54798285,73789
"21244","ENSG00000215769","17",64749663,64781707,32044
"21245","ENSG00000215771","22",41189727,41190188,461
"21246","ENSG00000215784","1",145095974,145112696,16722
"21247","ENSG00000215785","1",10990978,10991797,819
"21248","ENSG00000215788","1",6460786,6466195,5409
"21249","ENSG00000215790","1",1724838,1745999,21161
"21250","ENSG00000215795","1",247183813,247185482,1669
"21251","ENSG00000215796","1",247042791,247044021,1230
"21252","ENSG00000215800","1",242772620,242773103,483
"21253","ENSG00000215802","1",240823006,240823433,427
"21254","ENSG00000215807","6",112361437,112362722,1285
"21255","ENSG00000215808","1",238476542,238486060,9518
"21256","ENSG00000215811","1",228510425,228512305,1880
"21257","ENSG00000215812","1",227696892,227706699,9807
"21258","ENSG00000215817","1",219608010,219613145,5135
"21259","ENSG00000215833","1",168449672,168451211,1539
"21260","ENSG00000215834","1",166603916,166631400,27484
"21261","ENSG00000215835","1",166275629,166277597,1968
"21262","ENSG00000215838","1",165698750,165709968,11218
"21263","ENSG00000215840","1",161406068,161407082,1014
"21264","ENSG00000215841","11",73214998,73215913,915
"21265","ENSG00000215845","1",161037631,161038977,1346
"21266","ENSG00000215846","1",159276503,159277111,608
"21267","ENSG00000215853","1",152153595,152159228,5633
"21268","ENSG00000215859","1",147993862,148014956,21094
"21269","ENSG00000215861","1",149197992,149321732,123740
"21270","ENSG00000215864","1",119834870,119844514,9644
"21271","ENSG00000215866","1",112820170,112850643,30473
"21272","ENSG00000215867","1",111648291,111649544,1253
"21273","ENSG00000215869","1",104072983,104226678,153695
"21274","ENSG00000215871","1",100331804,100332617,813
"21275","ENSG00000215873","1",91328369,91329513,1144
"21276","ENSG00000215874","1",89394033,89394665,632
"21277","ENSG00000215875","1",81721693,81723068,1375
"21278","ENSG00000215878","6",138402585,138403560,975
"21279","ENSG00000215881","13",111596009,111642079,46070
"21280","ENSG00000215883","1",54169651,54200036,30385
"21281","ENSG00000215887","1",49841821,49846400,4579
"21282","ENSG00000215893","1",41098638,41099136,498
"21283","ENSG00000215895","1",38708931,38710890,1959
"21284","ENSG00000215899","1",31487589,31488930,1341
"21285","ENSG00000215900","1",31094987,31095558,571
"21286","ENSG00000215906","1",22953043,22965338,12295
"21287","ENSG00000215908","1",16618253,16657232,38979
"21288","ENSG00000215910","1",11761787,11789585,27798
"21289","ENSG00000215912","1",2635976,2801717,165741
"21290","ENSG00000215915","1",1449689,1470158,20469
"21291","ENSG00000215938","1",154193665,154193743,78
"21292","ENSG00000215957","14",101041363,101041445,82
"21293","ENSG00000215973","2",175167633,175167709,76
"21294","ENSG00000215991","14",23417987,23418063,76
"21295","ENSG00000216001","X",134540185,134540262,77
"21296","ENSG00000216005","X",145994784,145994860,76
"21297","ENSG00000216031","20",58818226,58818313,87
"21298","ENSG00000216035","10",29602264,29602346,82
"21299","ENSG00000216064","X",146001053,146001131,78
"21300","ENSG00000216077","5",15935182,15935260,78
"21301","ENSG00000216099","14",101047901,101047979,78
"21302","ENSG00000216101","6",30584332,30584417,85
"21303","ENSG00000216179","14",101064495,101064578,83
"21304","ENSG00000216192","12",24212421,24212495,74
"21305","ENSG00000216285","12",104030779,104031543,764
"21306","ENSG00000216306","12",94834147,94835158,1011
"21307","ENSG00000216307","6",4189116,4189806,690
"21308","ENSG00000216316","6",119269133,119269714,581
"21309","ENSG00000216324","6",87425795,87426088,293
"21310","ENSG00000216331","6",26195554,26196633,1079
"21311","ENSG00000216359","6",10514282,10514973,691
"21312","ENSG00000216360","6",5817421,5818366,945
"21313","ENSG00000216364","6",16171606,16172031,425
"21314","ENSG00000216368","6",10118452,10119253,801
"21315","ENSG00000216412","6",37091314,37091806,492
"21316","ENSG00000216425","4",105526596,105527397,801
"21317","ENSG00000216436","6",25732497,25732827,330
"21318","ENSG00000216471","6",114084168,114084792,624
"21319","ENSG00000216475","6",144257034,144257624,590
"21320","ENSG00000216480","6",159526062,159526527,465
"21321","ENSG00000216490","19",18173162,18178117,4955
"21322","ENSG00000216518","6",96750824,96751728,904
"21323","ENSG00000216560","4",3576869,3590711,13842
"21324","ENSG00000216588","19",44613563,44636781,23218
"21325","ENSG00000216613","6",136419847,136420425,578
"21326","ENSG00000216621","6",149934527,149936782,2255
"21327","ENSG00000216624","6",166058505,166066028,7523
"21328","ENSG00000216629","6",27977150,27978075,925
"21329","ENSG00000216636","6",34616538,34617258,720
"21330","ENSG00000216639","6",105298149,105298895,746
"21331","ENSG00000216642","6",143327275,143327655,380
"21332","ENSG00000216657","6",3978062,3979099,1037
"21333","ENSG00000216671","16",35040164,35084313,44149
"21334","ENSG00000216676","6",27652602,27652825,223
"21335","ENSG00000216687","6",58071720,58073134,1414
"21336","ENSG00000216718","6",25261239,25261731,492
"21337","ENSG00000216721","2",215804731,215804981,250
"21338","ENSG00000216723","6",114019621,114020483,862
"21339","ENSG00000216740","10",64825572,64826579,1007
"21340","ENSG00000216753","6",134115235,134115736,501
"21341","ENSG00000216754","6",15102946,15104130,1184
"21342","ENSG00000216762","6",27060365,27061249,884
"21343","ENSG00000216775","6",52664366,52669155,4789
"21344","ENSG00000216802","6",138650226,138650973,747
"21345","ENSG00000216809","6",118452469,118454992,2523
"21346","ENSG00000216813","6",47562622,47563018,396
"21347","ENSG00000216817","6",104017633,104019748,2115
"21348","ENSG00000216819","6",3177044,3179764,2720
"21349","ENSG00000216829","9",42667506,42668887,1381
"21350","ENSG00000216835","6",48213604,48214794,1190
"21351","ENSG00000216853","6",94446740,94447179,439
"21352","ENSG00000216854","6",56871191,56871743,552
"21353","ENSG00000216863","6",6346465,6622771,276306
"21354","ENSG00000216866","X",40934982,40935864,882
"21355","ENSG00000216867","2",110633947,110634333,386
"21356","ENSG00000216895","7",155611231,155645205,33974
"21357","ENSG00000216901","6",28176188,28176674,486
"21358","ENSG00000216906","6",149904243,149906418,2175
"21359","ENSG00000216915","6",27737000,27738494,1494
"21360","ENSG00000216917","6",131780721,131781312,591
"21361","ENSG00000216921","2",241893985,241902551,8566
"21362","ENSG00000216937","10",32446140,32882874,436734
"21363","ENSG00000216938","X",26686026,26687955,1929
"21364","ENSG00000216977","6",106642463,106642928,465
"21365","ENSG00000216990","6",87298772,87300447,1675
"21366","ENSG00000216998","6",49565924,49580166,14242
"21367","ENSG00000217004","6",35279177,35279819,642
"21368","ENSG00000217026","21",27420380,27421023,643
"21369","ENSG00000217027","6",144200447,144200965,518
"21370","ENSG00000217030","6",4979072,4979494,422
"21371","ENSG00000217041","6",110700562,110700900,338
"21372","ENSG00000217044","6",153667318,153668106,788
"21373","ENSG00000217060","6",85286076,85290849,4773
"21374","ENSG00000217078","6",16163377,16163762,385
"21375","ENSG00000217083","6",24947880,24948344,464
"21376","ENSG00000217094","10",32188323,32188817,494
"21377","ENSG00000217120","6",103002514,103003897,1383
"21378","ENSG00000217128","5",131641714,131797063,155349
"21379","ENSG00000217130","6",34744176,34744673,497
"21380","ENSG00000217135","6",3921847,3922146,299
"21381","ENSG00000217139","6",121682925,121684272,1347
"21382","ENSG00000217159","6",26164072,26164363,291
"21383","ENSG00000217165","6",39110321,39112952,2631
"21384","ENSG00000217169","6",87000045,87000291,246
"21385","ENSG00000217181","6",10574749,10575227,478
"21386","ENSG00000217195","6",144706733,144707047,314
"21387","ENSG00000217227","6",38587323,38588529,1206
"21388","ENSG00000217228","6",52765280,52778347,13067
"21389","ENSG00000217231","6",144036618,144037704,1086
"21390","ENSG00000217236","2",174334954,174338500,3546
"21391","ENSG00000217239","6",5788346,5788699,353
"21392","ENSG00000217241","6",116453014,116453565,551
"21393","ENSG00000217261","22",20689929,20698938,9009
"21394","ENSG00000217275","6",26202156,26202654,498
"21395","ENSG00000217289","2",129992889,129994040,1151
"21396","ENSG00000217314","6",19638040,19638808,768
"21397","ENSG00000217315","6",28033947,28034855,908
"21398","ENSG00000217325","6",126643488,126644390,902
"21399","ENSG00000217327","1",240012646,240013226,580
"21400","ENSG00000217330","6",118589070,118589634,564
"21401","ENSG00000217334","6",85731371,85732011,640
"21402","ENSG00000217372","6",152898047,152899280,1233
"21403","ENSG00000217379","6",19143695,19144160,465
"21404","ENSG00000217385","6",4702463,4703779,1316
"21405","ENSG00000217404","6",126683036,126683847,811
"21406","ENSG00000217414","6",18363417,18365423,2006
"21407","ENSG00000217416","5",62776877,62777263,386
"21408","ENSG00000217442","22",50551112,50562919,11807
"21409","ENSG00000217447","6",167347472,167348053,581
"21410","ENSG00000217455","7",3140234,3174654,34420
"21411","ENSG00000217488","6",75610958,75611945,987
"21412","ENSG00000217495","6",143298770,143299554,784
"21413","ENSG00000217512","6",79067692,79068138,446
"21414","ENSG00000217527","6",53336943,53337346,403
"21415","ENSG00000217539","6",28010723,28012355,1632
"21416","ENSG00000217555","16",66552563,66566251,13688
"21417","ENSG00000217566","6",3941282,3941801,519
"21418","ENSG00000217585","6",16107622,16108593,971
"21419","ENSG00000217612","6",145489630,145492092,2462
"21420","ENSG00000217624","X",41675760,41676494,734
"21421","ENSG00000217631","6",49273600,49273794,194
"21422","ENSG00000217643","2",25822469,25822950,481
"21423","ENSG00000217644","1",32979947,32980472,525
"21424","ENSG00000217646","6",27864062,27864401,339
"21425","ENSG00000217648","6",143342246,143343383,1137
"21426","ENSG00000217653","6",89814709,89815463,754
"21427","ENSG00000217680","6",75465123,75465570,447
"21428","ENSG00000217684","6",140761529,140762262,733
"21429","ENSG00000217702","2",74123965,74135640,11675
"21430","ENSG00000217707","6",3048835,3049211,376
"21431","ENSG00000217716","9",88016300,88016793,493
"21432","ENSG00000217733","6",149879962,149881572,1610
"21433","ENSG00000217746","6",7938430,7939322,892
"21434","ENSG00000217767","6",70734503,70734962,459
"21435","ENSG00000217769","6",86897118,86897421,303
"21436","ENSG00000217770","6",112365704,112367444,1740
"21437","ENSG00000217783","6",157299045,157300126,1081
"21438","ENSG00000217786","6",79326568,79327207,639
"21439","ENSG00000217791","5",53859166,53860401,1235
"21440","ENSG00000217801","1",1059708,1069355,9647
"21441","ENSG00000217805","6",25181359,25181745,386
"21442","ENSG00000217824","6",148567378,148567654,276
"21443","ENSG00000217835","X",65956289,65957196,907
"21444","ENSG00000217862","6",27807075,27807339,264
"21445","ENSG00000217889","X",153604497,153605348,851
"21446","ENSG00000217896","Y",18985175,18986398,1223
"21447","ENSG00000217897","1",39304294,39304898,604
"21448","ENSG00000217929","6",131910,145083,13173
"21449","ENSG00000217930","16",4331549,4355607,24058
"21450","ENSG00000217950","2",131442644,131444587,1943
"21451","ENSG00000218014","6",71584721,71585906,1185
"21452","ENSG00000218016","6",28188050,28189432,1382
"21453","ENSG00000218018","20",57377140,57393062,15922
"21454","ENSG00000218020","6",11514192,11516466,2274
"21455","ENSG00000218027","6",1513698,1515289,1591
"21456","ENSG00000218029","6",79354443,79354713,270
"21457","ENSG00000218048","6",63440766,63443580,2814
"21458","ENSG00000218052","15",85255369,85330334,74965
"21459","ENSG00000218069","6",27780619,27781111,492
"21460","ENSG00000218073","6",16160926,16161411,485
"21461","ENSG00000218089","6",114349483,114350648,1165
"21462","ENSG00000218107","6",43705949,43706751,802
"21463","ENSG00000218109","11",127002910,127006058,3148
"21464","ENSG00000218153","6",116457323,116458669,1346
"21465","ENSG00000218175","2",176200908,176201252,344
"21466","ENSG00000218180","6",121653795,121654690,895
"21467","ENSG00000218186","6",24598012,24599790,1778
"21468","ENSG00000218187","6",127654860,127655278,418
"21469","ENSG00000218189","6",57937458,57939015,1557
"21470","ENSG00000218198","13",27017554,27017909,355
"21471","ENSG00000218208","6",113581501,113581947,446
"21472","ENSG00000218226","6",158609706,158621636,11930
"21473","ENSG00000218227","5",178055604,178056194,590
"21474","ENSG00000218233","6",117633706,117645087,11381
"21475","ENSG00000218261","6",53378503,53378861,358
"21476","ENSG00000218265","6",13521266,13522045,779
"21477","ENSG00000218274","6",63395007,63397106,2099
"21478","ENSG00000218281","6",26233122,26233255,133
"21479","ENSG00000218283","1",220253570,220254536,966
"21480","ENSG00000218305","7",48919765,48927454,7689
"21481","ENSG00000218313","6",87173368,87174303,935
"21482","ENSG00000218336","4",182143987,182803024,659037
"21483","ENSG00000218337","6",49077712,49078051,339
"21484","ENSG00000218347","6",27523076,27524339,1263
"21485","ENSG00000218350","6",71165076,71165770,694
"21486","ENSG00000218357","22",47461299,47487111,25812
"21487","ENSG00000218358","6",149998019,150005157,7138
"21488","ENSG00000218359","6",17582034,17582305,271
"21489","ENSG00000218416","2",240449315,240456714,7399
"21490","ENSG00000218418","6",80064286,80070199,5913
"21491","ENSG00000218426","6",153282287,153282733,446
"21492","ENSG00000218428","6",116137058,116137572,514
"21493","ENSG00000218454","17",20771058,20771427,369
"21494","ENSG00000218459","6",73618346,73618597,251
"21495","ENSG00000218472","6",3913922,3914292,370
"21496","ENSG00000218475","6",101430411,101431553,1142
"21497","ENSG00000218502","13",99215372,99215758,386
"21498","ENSG00000218510","1",22024558,22031223,6665
"21499","ENSG00000218520","6",63229087,63230110,1023
"21500","ENSG00000218521","6",38002832,38003313,481
"21501","ENSG00000218536","6",102078872,102079555,683
"21502","ENSG00000218537","22",23894426,23898930,4504
"21503","ENSG00000218561","6",86729708,86730108,400
"21504","ENSG00000218565","6",139338018,139339580,1562
"21505","ENSG00000218574","6",5609227,5610195,968
"21506","ENSG00000218577","6",167607,170631,3024
"21507","ENSG00000218582","6",79953005,79954011,1006
"21508","ENSG00000218586","7",54933699,54938184,4485
"21509","ENSG00000218596","6",156976294,156977072,778
"21510","ENSG00000218631","6",157372556,157373171,615
"21511","ENSG00000218632","6",109327175,109327914,739
"21512","ENSG00000218672","7",155382076,155396356,14280
"21513","ENSG00000218676","6",111430260,111431781,1521
"21514","ENSG00000218682","2",25856461,25856966,505
"21515","ENSG00000218690","6",26272021,26272701,680
"21516","ENSG00000218698","6",87444395,87445175,780
"21517","ENSG00000218713","6",53206598,53208697,2099
"21518","ENSG00000218730","6",90116700,90117105,405
"21519","ENSG00000218739","2",37196488,37216193,19705
"21520","ENSG00000218749","6",35607628,35607934,306
"21521","ENSG00000218757","6",154845074,154845620,546
"21522","ENSG00000218772","6",134603564,134604698,1134
"21523","ENSG00000218776","6",153666627,153667318,691
"21524","ENSG00000218792","6",152705735,152706128,393
"21525","ENSG00000218793","6",87441165,87442146,981
"21526","ENSG00000218803","6",111046868,111047521,653
"21527","ENSG00000218809","6",41269875,41270239,364
"21528","ENSG00000218813","6",63797189,63798031,842
"21529","ENSG00000218819","2",21123917,21143272,19355
"21530","ENSG00000218823","7",4857738,4862030,4292
"21531","ENSG00000218839","9",34394,37269,2875
"21532","ENSG00000218857","6",131184325,131185486,1161
"21533","ENSG00000218868","6",6534697,6535631,934
"21534","ENSG00000218872","6",108856400,108856737,337
"21535","ENSG00000218890","6",66093431,66094909,1478
"21536","ENSG00000218891","19",55576774,55580848,4074
"21537","ENSG00000218896","6",143436216,143436710,494
"21538","ENSG00000218902","20",18011955,18012284,329
"21539","ENSG00000218965","6",89422099,89423048,949
"21540","ENSG00000218976","6",18366736,18368644,1908
"21541","ENSG00000218980","6",57004520,57004799,279
"21542","ENSG00000218986","6",39353747,39354172,425
"21543","ENSG00000218991","6",132698783,132699667,884
"21544","ENSG00000218996","6",150934968,150935566,598
"21545","ENSG00000219023","6",35555873,35556264,391
"21546","ENSG00000219027","16",1477830,1478583,753
"21547","ENSG00000219039","7",75835663,75836141,478
"21548","ENSG00000219061","11",49833140,49839320,6180
"21549","ENSG00000219073","1",21977021,21998642,21621
"21550","ENSG00000219074","6",53196720,53197159,439
"21551","ENSG00000219085","6",69705287,69706160,873
"21552","ENSG00000219102","1",53974969,53976031,1062
"21553","ENSG00000219133","1",204346776,204347258,482
"21554","ENSG00000219135","6",121679972,121680459,487
"21555","ENSG00000219146","6",154576309,154577079,770
"21556","ENSG00000219149","9",76549282,76549771,489
"21557","ENSG00000219150","6",110706362,110706882,520
"21558","ENSG00000219159","2",240686334,240690414,4080
"21559","ENSG00000219163","6",53235621,53236297,676
"21560","ENSG00000219186","X",37492021,37492548,527
"21561","ENSG00000219188","6",158515605,158516229,624
"21562","ENSG00000219200","17",7012417,7014532,2115
"21563","ENSG00000219201","1",77810861,77811781,920
"21564","ENSG00000219222","6",43310231,43310357,126
"21565","ENSG00000219240","6",89886156,89887848,1692
"21566","ENSG00000219249","6",158725747,158726803,1056
"21567","ENSG00000219257","6",100050372,100051236,864
"21568","ENSG00000219273","6",38762905,38764694,1789
"21569","ENSG00000219274","16",1329078,1329777,699
"21570","ENSG00000219294","6",7986537,7988192,1655
"21571","ENSG00000219314","6",17381367,17382120,753
"21572","ENSG00000219329","6",110923566,110924107,541
"21573","ENSG00000219355","12",120450437,120450803,366
"21574","ENSG00000219361","6",80470071,80470428,357
"21575","ENSG00000219375","6",7331286,7331676,390
"21576","ENSG00000219384","6",45158870,45159511,641
"21577","ENSG00000219391","2",44065894,44066154,260
"21578","ENSG00000219392","6",28115628,28116551,923
"21579","ENSG00000219395","6",151411259,151413945,2686
"21580","ENSG00000219404","6",22213306,22214237,931
"21581","ENSG00000219409","6",144397959,144398752,793
"21582","ENSG00000219410","12",6663260,6672069,8809
"21583","ENSG00000219430","10",79582298,79584877,2579
"21584","ENSG00000219433","6",149794763,149795746,983
"21585","ENSG00000219435","11",64300358,64304770,4412
"21586","ENSG00000219438","22",48489460,48850912,361452
"21587","ENSG00000219445","7",125229579,125264291,34712
"21588","ENSG00000219451","7",20827326,20827753,427
"21589","ENSG00000219470","6",43538822,43539703,881
"21590","ENSG00000219481","1",16562319,16613562,51243
"21591","ENSG00000219487","6",149112009,149112672,663
"21592","ENSG00000219491","8",36888482,36889307,825
"21593","ENSG00000219507","X",148052233,148052746,513
"21594","ENSG00000219529","11",77813319,77813676,357
"21595","ENSG00000219545","7",7640711,7968020,327309
"21596","ENSG00000219547","6",80374015,80374569,554
"21597","ENSG00000219553","6",149491567,149492289,722
"21598","ENSG00000219565","6",108782126,108787053,4927
"21599","ENSG00000219604","6",84689292,84689429,137
"21600","ENSG00000219607","6",5084581,5089487,4906
"21601","ENSG00000219608","20",35878476,35878733,257
"21602","ENSG00000219622","6",150504811,150510300,5489
"21603","ENSG00000219626","2",24076526,24169640,93114
"21604","ENSG00000219642","6",129157523,129159120,1597
"21605","ENSG00000219653","6",63857441,63857769,328
"21606","ENSG00000219665","19",11987617,12046275,58658
"21607","ENSG00000219666","6",129783769,129784045,276
"21608","ENSG00000219669","6",71075564,71076375,811
"21609","ENSG00000219682","6",25140003,25141403,1400
"21610","ENSG00000219693","9",62888535,62889921,1386
"21611","ENSG00000219699","6",127659690,127660579,889
"21612","ENSG00000219700","6",109288571,109290503,1932
"21613","ENSG00000219702","6",81764211,81764503,292
"21614","ENSG00000219712","6",669081,670307,1226
"21615","ENSG00000219722","6",75499705,75500136,431
"21616","ENSG00000219738","6",27560822,27561744,922
"21617","ENSG00000219747","6",151099529,151099933,404
"21618","ENSG00000219755","6",99575712,99576456,744
"21619","ENSG00000219758","6",113839279,113839621,342
"21620","ENSG00000219770","6",27083280,27084147,867
"21621","ENSG00000219773","6",112355841,112356714,873
"21622","ENSG00000219776","6",131469059,131469536,477
"21623","ENSG00000219790","6",56975606,56976062,456
"21624","ENSG00000219797","6",31519480,31520291,811
"21625","ENSG00000219806","6",139614438,139615204,766
"21626","ENSG00000219863","6",53354715,53355065,350
"21627","ENSG00000219867","6",91815843,91816428,585
"21628","ENSG00000219870","X",9179385,9179606,221
"21629","ENSG00000219881","6",69745871,69746851,980
"21630","ENSG00000219891","6",28091154,28093664,2510
"21631","ENSG00000219902","6",105302453,105302823,370
"21632","ENSG00000219926","13",63828840,63844125,15285
"21633","ENSG00000219928","9",87525302,87525475,173
"21634","ENSG00000219930","X",136077844,136078631,787
"21635","ENSG00000219932","10",67874332,67874911,579
"21636","ENSG00000219941","6",95991107,95992349,1242
"21637","ENSG00000219951","6",83392416,83393409,993
"21638","ENSG00000219986","6",6794915,6795402,487
"21639","ENSG00000219992","6",3754099,3754840,741
"21640","ENSG00000219993","6",7506203,7506549,346
"21641","ENSG00000220008","19",2289784,2292024,2240
"21642","ENSG00000220069","6",86086415,86087134,719
"21643","ENSG00000220091","6",82924829,82925122,293
"21644","ENSG00000220105","9",4781475,4782078,603
"21645","ENSG00000220110","6",128639188,128639653,465
"21646","ENSG00000220113","6",133150568,133150816,248
"21647","ENSG00000220130","6",89001548,89001814,266
"21648","ENSG00000220131","6",88265158,88265511,353
"21649","ENSG00000220139","6",119159297,119159476,179
"21650","ENSG00000220154","6",79278105,79278427,322
"21651","ENSG00000220157","5",80359080,80360040,960
"21652","ENSG00000220161","17",18411159,18414380,3221
"21653","ENSG00000220184","6",121858179,121858768,589
"21654","ENSG00000220201","19",10304803,10309880,5077
"21655","ENSG00000220204","11",34404663,34404949,286
"21656","ENSG00000220205","17",8159149,8163546,4397
"21657","ENSG00000220237","6",107229759,107230152,393
"21658","ENSG00000220248","22",16857619,16860718,3099
"21659","ENSG00000220256","2",239762860,239824764,61904
"21660","ENSG00000220267","6",88275882,88276989,1107
"21661","ENSG00000220305","6",159712801,159713985,1184
"21662","ENSG00000220323","1",149842875,149846486,3611
"21663","ENSG00000220343","3",167065831,167066320,489
"21664","ENSG00000220349","6",36737050,36737986,936
"21665","ENSG00000220370","6",94344737,94344962,225
"21666","ENSG00000220377","6",52687930,52703825,15895
"21667","ENSG00000220378","6",134296997,134298695,1698
"21668","ENSG00000220392","6",111353702,111354183,481
"21669","ENSG00000220412","6",137705423,137707201,1778
"21670","ENSG00000220418","6",89301783,89303114,1331
"21671","ENSG00000220446","6",5291030,5291388,358
"21672","ENSG00000220472","6",7338839,7339568,729
"21673","ENSG00000220483","6",65788417,65789287,870
"21674","ENSG00000220494","6",147406889,147408281,1392
"21675","ENSG00000220505","6",98179499,98179832,333
"21676","ENSG00000220506","6",111494991,111495713,722
"21677","ENSG00000220515","6",73055097,73055857,760
"21678","ENSG00000220517","6",25023247,25024483,1236
"21679","ENSG00000220522","6",127416535,127416952,417
"21680","ENSG00000220537","6",82263996,82264974,978
"21681","ENSG00000220540","20",17188134,17188344,210
"21682","ENSG00000220541","X",113522482,113522989,507
"21683","ENSG00000220553","6",92013842,92014734,892
"21684","ENSG00000220557","6",132868218,132868859,641
"21685","ENSG00000220563","6",85659892,85660606,714
"21686","ENSG00000220575","7",155067034,155072450,5416
"21687","ENSG00000220581","6",27033435,27034310,875
"21688","ENSG00000220583","6",34263311,34263673,362
"21689","ENSG00000220585","10",91053051,91055047,1996
"21690","ENSG00000220586","6",39934595,40000527,65932
"21691","ENSG00000220598","6",150384307,150385120,813
"21692","ENSG00000220600","6",138878899,138879407,508
"21693","ENSG00000220614","6",43328134,43328476,342
"21694","ENSG00000220643","6",34686602,34687106,504
"21695","ENSG00000220660","6",136364129,136365079,950
"21696","ENSG00000220685","6",5065795,5066982,1187
"21697","ENSG00000220694","6",127435636,127436189,553
"21698","ENSG00000220695","6",100530276,100531052,776
"21699","ENSG00000220702","22",44365551,44366284,733
"21700","ENSG00000220721","6",28073316,28074260,944
"21701","ENSG00000220733","6",153668177,153668362,185
"21702","ENSG00000220734","6",35765908,35766927,1019
"21703","ENSG00000220739","6",144708106,144708497,391
"21704","ENSG00000220744","6",127362513,127363403,890
"21705","ENSG00000220745","6",152959359,152959605,246
"21706","ENSG00000220748","6",23971879,23972941,1062
"21707","ENSG00000220749","1",212051524,212052006,482
"21708","ENSG00000220758","6",27324894,27325768,874
"21709","ENSG00000220771","6",21602128,21602383,255
"21710","ENSG00000220773","6",54624605,54625488,883
"21711","ENSG00000220785","1",32231658,32241620,9962
"21712","ENSG00000220793","16",9156402,9156881,479
"21713","ENSG00000220804","2",242088633,242160153,71520
"21714","ENSG00000220842","10",120354701,120355183,482
"21715","ENSG00000220848","6",149592687,149601878,9191
"21716","ENSG00000220867","6",157924402,157924676,274
"21717","ENSG00000220871","6",89797598,89797877,279
"21718","ENSG00000220875","6",26321876,26322292,416
"21719","ENSG00000220884","6",128928995,128929988,993
"21720","ENSG00000220891","22",22559343,22566602,7259
"21721","ENSG00000220908","6",92723003,92723829,826
"21722","ENSG00000220913","6",160905770,160913638,7868
"21723","ENSG00000220920","6",17953572,17953930,358
"21724","ENSG00000220925","X",70148582,70149654,1072
"21725","ENSG00000220937","9",4944670,4945902,1232
"21726","ENSG00000220960","6",89059628,89060109,481
"21727","ENSG00000221025","17",81133196,81133308,112
"21728","ENSG00000221033","15",64762387,64762515,128
"21729","ENSG00000221036","14",101030052,101030129,77
"21730","ENSG00000221038","17",31563768,31563894,126
"21731","ENSG00000221039","22",20249134,20249211,77
"21732","ENSG00000221042","10",92204229,92204306,77
"21733","ENSG00000221043","5",149695748,149695959,211
"21734","ENSG00000221044","17",44025020,44025223,203
"21735","ENSG00000221046","20",45778698,45778823,125
"21736","ENSG00000221059","3",87910220,87910345,125
"21737","ENSG00000221063","10",63372957,63373048,91
"21738","ENSG00000221066","16",70538005,70538098,93
"21739","ENSG00000221083","1",8511795,8511919,124
"21740","ENSG00000221091","20",50614636,50614785,149
"21741","ENSG00000221102","14",91126425,91126553,128
"21742","ENSG00000221114","14",49684544,49684665,121
"21743","ENSG00000221120","3",184241405,184241489,84
"21744","ENSG00000221164","10",73126080,73126207,127
"21745","ENSG00000221176","8",128049152,128049238,86
"21746","ENSG00000221184","10",68759318,68759414,96
"21747","ENSG00000221203","1",68183518,68183610,92
"21748","ENSG00000221214","10",110988926,110989013,87
"21749","ENSG00000221216","1",28481362,28481480,118
"21750","ENSG00000221227","4",182169293,182169378,85
"21751","ENSG00000221230","11",94466495,94466580,85
"21752","ENSG00000221238","2",70252918,70253005,87
"21753","ENSG00000221241","19",50799442,50799532,90
"21754","ENSG00000221245","4",119569699,119569825,126
"21755","ENSG00000221261","8",128150116,128150188,72
"21756","ENSG00000221263","5",100816482,100816565,83
"21757","ENSG00000221265","4",101330302,101330414,112
"21758","ENSG00000221269","9",97363554,97363681,127
"21759","ENSG00000221275","4",9556168,9556316,148
"21760","ENSG00000221288","2",132256966,132257080,114
"21761","ENSG00000221300","2",42440377,42440436,59
"21762","ENSG00000221303","14",81202695,81202834,139
"21763","ENSG00000221325","7",36919357,36919432,75
"21764","ENSG00000221331","10",12725254,12725353,99
"21765","ENSG00000221332","6",75398860,75399067,207
"21766","ENSG00000221333","11",70283955,70284070,115
"21767","ENSG00000221340","1",12569972,12570072,100
"21768","ENSG00000221348","X",32641474,32641559,85
"21769","ENSG00000221355","17",16282014,16282088,74
"21770","ENSG00000221363","18",22130603,22130729,126
"21771","ENSG00000221369","4",147344629,147344717,88
"21772","ENSG00000221375","X",139885481,139885603,122
"21773","ENSG00000221390","1",171101728,171101806,78
"21774","ENSG00000221400","10",43417249,43417438,189
"21775","ENSG00000221406","1",224257004,224257141,137
"21776","ENSG00000221430","5",154347106,154347247,141
"21777","ENSG00000221439","12",781133,781258,125
"21778","ENSG00000221445","2",25328640,25328721,81
"21779","ENSG00000221464","5",176367946,176368031,85
"21780","ENSG00000221468","10",43341786,43341910,124
"21781","ENSG00000221479","12",97491909,97491978,69
"21782","ENSG00000221491","12",48654382,48654518,136
"21783","ENSG00000221493","18",21683510,21683597,87
"21784","ENSG00000221500","6",132816802,132816877,75
"21785","ENSG00000221502","2",188978092,188978161,69
"21786","ENSG00000221507","7",144451681,144451817,136
"21787","ENSG00000221510","7",102405742,102405855,113
"21788","ENSG00000221514","16",70529509,70529588,79
"21789","ENSG00000221518","3",52560570,52560707,137
"21790","ENSG00000221520","7",92204015,92204098,83
"21791","ENSG00000221527","8",100739802,100739927,125
"21792","ENSG00000221537","14",64095024,64095125,101
"21793","ENSG00000221539","1",28578749,28578822,73
"21794","ENSG00000221540","17",19344506,19344574,68
"21795","ENSG00000221552","5",154685776,154685861,85
"21796","ENSG00000221562","5",129974891,129975001,110
"21797","ENSG00000221564","12",64939023,64939117,94
"21798","ENSG00000221571","1",220825620,220826063,443
"21799","ENSG00000221574","11",10399192,10399317,125
"21800","ENSG00000221585","3",47849555,47849629,74
"21801","ENSG00000221598","22",45200954,45201019,65
"21802","ENSG00000221604","12",50234142,50234212,70
"21803","ENSG00000221611","12",12972053,12972143,90
"21804","ENSG00000221628","2",207269275,207269424,149
"21805","ENSG00000221634","15",85770496,85770578,82
"21806","ENSG00000221639","4",73263960,73264084,124
"21807","ENSG00000221641","15",22225278,22225329,51
"21808","ENSG00000221643","1",203729581,203729705,124
"21809","ENSG00000221650","13",107531171,107531248,77
"21810","ENSG00000221656","16",2090195,2090284,89
"21811","ENSG00000221662","1",18897071,18897148,77
"21812","ENSG00000221669","7",34940760,34940834,74
"21813","ENSG00000221673","1",219962652,219962865,213
"21814","ENSG00000221676","9",134164439,134164564,125
"21815","ENSG00000221711","4",77702746,77702803,57
"21816","ENSG00000221716","X",54814370,54814497,127
"21817","ENSG00000221719","16",2796408,2796532,124
"21818","ENSG00000221737","3",125790404,125790552,148
"21819","ENSG00000221739","17",48156427,48156511,84
"21820","ENSG00000221740","7",22856613,22856686,73
"21821","ENSG00000221753","8",100023982,100024084,102
"21822","ENSG00000221760","22",26555212,26555323,111
"21823","ENSG00000221763","20",35453954,35454097,143
"21824","ENSG00000221771","8",127960633,127960695,62
"21825","ENSG00000221782","2",212426263,212426360,97
"21826","ENSG00000221783","7",21471058,21471146,88
"21827","ENSG00000221788","12",79419257,79419321,64
"21828","ENSG00000221801","16",11306440,11306527,87
"21829","ENSG00000221806","20",18611047,18611167,120
"21830","ENSG00000221808","1",20988314,20988432,118
"21831","ENSG00000221813","7",144000320,144008793,8473
"21832","ENSG00000221817","10",73495525,73520070,24545
"21833","ENSG00000221818","8",25841725,26045413,203688
"21834","ENSG00000221819","16",90028908,90029901,993
"21835","ENSG00000221821","6",42890265,42890821,556
"21836","ENSG00000221823","2",68178857,68256237,77380
"21837","ENSG00000221826","19",42721638,42740481,18843
"21838","ENSG00000221829","9",35073835,35080016,6181
"21839","ENSG00000221836","7",144048948,144058845,9897
"21840","ENSG00000221838","7",100101549,100110345,8796
"21841","ENSG00000221843","2",27537386,27582721,45335
"21842","ENSG00000221844","9",73474378,73476073,1695
"21843","ENSG00000221845","7",47655244,47661648,6404
"21844","ENSG00000221852","17",41026026,41027208,1182
"21845","ENSG00000221857","19",35138824,35151336,12512
"21846","ENSG00000221858","7",144086278,144098953,12675
"21847","ENSG00000221866","7",132123332,132648688,525356
"21848","ENSG00000221867","X",152698767,152702347,3580
"21849","ENSG00000221869","8",47736909,47739086,2177
"21850","ENSG00000221874","19",52928475,52962823,34348
"21851","ENSG00000221878","19",42924132,42937178,13046
"21852","ENSG00000221879","1",197363817,197364078,261
"21853","ENSG00000221880","17",41033884,41034855,971
"21854","ENSG00000221882","17",3276942,3386317,109375
"21855","ENSG00000221883","3",48917782,48919385,1603
"21856","ENSG00000221886","5",160393148,160400054,6906
"21857","ENSG00000221887","18",63949301,63981774,32473
"21858","ENSG00000221888","1",247754846,247760556,5710
"21859","ENSG00000221890","22",38818452,38844028,25576
"21860","ENSG00000221900","7",53035642,53036924,1282
"21861","ENSG00000221909","7",99546300,99558536,12236
"21862","ENSG00000221914","8",26291508,26372680,81172
"21863","ENSG00000221916","19",49118402,49119143,741
"21864","ENSG00000221923","19",52369917,52385795,15878
"21865","ENSG00000221926","17",15627960,15684311,56351
"21866","ENSG00000221930","X",130494965,130496588,1623
"21867","ENSG00000221931","11",123753488,123754545,1057
"21868","ENSG00000221933","7",144069811,144075870,6059
"21869","ENSG00000221937","7",143222037,143223079,1042
"21870","ENSG00000221938","7",144123176,144131188,8012
"21871","ENSG00000221944","2",232547970,232550592,2622
"21872","ENSG00000221946","19",35143250,35154301,11051
"21873","ENSG00000221947","8",70669365,70790371,121006
"21874","ENSG00000221949","12",62601751,62603690,1939
"21875","ENSG00000221953","1",247110160,247112417,2257
"21876","ENSG00000221955","3",125082636,125212864,130228
"21877","ENSG00000221957","19",54832676,54848569,15893
"21878","ENSG00000221962","3",152339695,152340990,1295
"21879","ENSG00000221963","22",35648446,35668404,19958
"21880","ENSG00000221968","11",61873519,61892051,18532
"21881","ENSG00000221970","7",144312464,144322668,10204
"21882","ENSG00000221971","7",45999621,46000778,1157
"21883","ENSG00000221978","1",1385711,1399335,13624
"21884","ENSG00000221983","19",18571730,18577550,5820
"21885","ENSG00000221986","1",109292365,109307011,14646
"21886","ENSG00000221988","6",32153441,32163678,10237
"21887","ENSG00000221990","5",441498,443160,1662
"21888","ENSG00000221994","X",47983356,48071658,88302
"21889","ENSG00000221995","17",29073521,29078857,5336
"21890","ENSG00000221996","11",4367263,4368386,1123
"21891","ENSG00000222000","2",98331389,98356005,24616
"21892","ENSG00000222001","2",233012614,233015885,3271
"21893","ENSG00000222004","7",26637871,26647305,9434
"21894","ENSG00000222005","2",46698940,46822804,123864
"21895","ENSG00000222007","2",235773855,235783387,9532
"21896","ENSG00000222009","1",44808482,44815585,7103
"21897","ENSG00000222011","7",102748971,102809225,60254
"21898","ENSG00000222012","7",157614023,157618765,4742
"21899","ENSG00000222014","2",129979664,129982738,3074
"21900","ENSG00000222017","2",197693106,197774823,81717
"21901","ENSG00000222019","16",90039761,90047773,8012
"21902","ENSG00000222020","2",239401436,239402364,928
"21903","ENSG00000222022","2",237421420,237425276,3856
"21904","ENSG00000222024","7",79353410,79354392,982
"21905","ENSG00000222028","14",23042167,23043331,1164
"21906","ENSG00000222030","2",59217708,59279400,61692
"21907","ENSG00000222031","2",151001220,151048774,47554
"21908","ENSG00000222032","2",237428920,237434822,5902
"21909","ENSG00000222033","2",170712451,170714567,2116
"21910","ENSG00000222035","2",202075410,202117062,41652
"21911","ENSG00000222037","22",22919535,22919851,316
"21912","ENSG00000222038","2",130611481,130658091,46610
"21913","ENSG00000222041","2",87454781,87636740,181959
"21914","ENSG00000222042","21",25169431,25361868,192437
"21915","ENSG00000222043","2",177264359,177265515,1156
"21916","ENSG00000222044","22",38032165,38034228,2063
"21917","ENSG00000222046","1",32209094,32216196,7102
"21918","ENSG00000222047","10",73909969,73922777,12808
"21919","ENSG00000222051","10",101622859,101622965,106
"21920","ENSG00000222057","3",121655475,121655604,129
"21921","ENSG00000222067","11",126214260,126214478,218
"21922","ENSG00000222068","2",133391109,133391398,289
"21923","ENSG00000222069","1",103523562,103523879,317
"21924","ENSG00000222072","10",100907174,100907280,106
"21925","ENSG00000222078","6",90001222,90001506,284
"21926","ENSG00000222092","10",29711915,29712008,93
"21927","ENSG00000222094","15",72045183,72045367,184
"21928","ENSG00000222095","14",100994257,100994330,73
"21929","ENSG00000222102","5",151704289,151704578,289
"21930","ENSG00000222108","10",49979665,49979780,115
"21931","ENSG00000222112","1",33336566,33336864,298
"21932","ENSG00000222123","15",25738508,25738620,112
"21933","ENSG00000222145","6",88714242,88714430,188
"21934","ENSG00000222162","11",13353208,13353523,315
"21935","ENSG00000222164","7",18807993,18808279,286
"21936","ENSG00000222177","16",68329387,68329529,142
"21937","ENSG00000222178","5",36485343,36485440,97
"21938","ENSG00000222179","18",45989653,45989945,292
"21939","ENSG00000222182","4",11414051,11414160,109
"21940","ENSG00000222185","14",100998467,100998541,74
"21941","ENSG00000222208","3",37341649,37341766,117
"21942","ENSG00000222213","5",149606637,149606741,104
"21943","ENSG00000222222","1",150236967,150237156,189
"21944","ENSG00000222224","2",28927243,28927340,97
"21945","ENSG00000222236","4",71759518,71759616,98
"21946","ENSG00000222248","6",3088686,3088809,123
"21947","ENSG00000222249","11",119289562,119289677,115
"21948","ENSG00000222255","12",101765406,101765509,103
"21949","ENSG00000222266","5",134715483,134715582,99
"21950","ENSG00000222267","8",20229779,20229877,98
"21951","ENSG00000222268","16",47505432,47505543,111
"21952","ENSG00000222276","14",96384624,96384815,191
"21953","ENSG00000222281","20",11818821,11819091,270
"21954","ENSG00000222282","1",37885023,37885117,94
"21955","ENSG00000222287","16",30701337,30701435,98
"21956","ENSG00000222297","11",125574719,125574818,99
"21957","ENSG00000222302","12",107486511,107486635,124
"21958","ENSG00000222303","X",50649641,50649740,99
"21959","ENSG00000222305","10",90880040,90880179,139
"21960","ENSG00000222317","2",209721913,209722021,108
"21961","ENSG00000222320","18",31937533,31937639,106
"21962","ENSG00000222327","9",112137797,112137900,103
"21963","ENSG00000222335","3",196202349,196202453,104
"21964","ENSG00000222337","9",99284022,99284373,351
"21965","ENSG00000222344","2",229894346,229894453,107
"21966","ENSG00000222345","3",52691378,52691453,75
"21967","ENSG00000222346","7",111953653,111953765,112
"21968","ENSG00000222351","9",122945988,122946094,106
"21969","ENSG00000222365","20",49280319,49280409,90
"21970","ENSG00000222370","1",220200546,220200676,130
"21971","ENSG00000222371","10",68158079,68158408,329
"21972","ENSG00000222375","16",29731051,29731404,353
"21973","ENSG00000222378","1",39154164,39154296,132
"21974","ENSG00000222383","6",10752791,10752926,135
"21975","ENSG00000222385","11",28261194,28261519,325
"21976","ENSG00000222386","7",103484208,103484539,331
"21977","ENSG00000222389","3",81509476,81509664,188
"21978","ENSG00000222395","18",32263135,32263234,99
"21979","ENSG00000222404","2",157298807,157299158,351
"21980","ENSG00000222405","12",70443784,70443923,139
"21981","ENSG00000222414","10",101364845,101365035,190
"21982","ENSG00000222419","X",103850797,103850911,114
"21983","ENSG00000222421","9",127832635,127832743,108
"21984","ENSG00000222427","11",22688351,22688435,84
"21985","ENSG00000222429","17",4619749,4619852,103
"21986","ENSG00000222430","10",101952605,101952704,99
"21987","ENSG00000222431","6",20452369,20452473,104
"21988","ENSG00000222432","7",77895880,77895992,112
"21989","ENSG00000222445","6",125875168,125875498,330
"21990","ENSG00000222448","5",179845832,179846152,320
"21991","ENSG00000222451","10",90163651,90163960,309
"21992","ENSG00000222452","9",78165465,78165778,313
"21993","ENSG00000222455","9",127841112,127841222,110
"21994","ENSG00000222460","20",35643143,35643462,319
"21995","ENSG00000222465","9",70188571,70188750,179
"21996","ENSG00000222467","2",121603073,121603164,91
"21997","ENSG00000222477","11",65147584,65147778,194
"21998","ENSG00000222489","14",20323179,20323326,147
"21999","ENSG00000222499","3",157017342,157017696,354
"22000","ENSG00000222501","8",128010382,128010611,229
"22001","ENSG00000222503","10",103673158,103673265,107
"22002","ENSG00000222506","3",171439526,171439627,101
"22003","ENSG00000222511","1",8796571,8796673,102
"22004","ENSG00000222515","6",22085544,22085918,374
"22005","ENSG00000222522","8",47979414,47979521,107
"22006","ENSG00000222524","19",55737285,55737600,315
"22007","ENSG00000222529","11",118970498,118970595,97
"22008","ENSG00000222536","2",72721806,72722003,197
"22009","ENSG00000222558","9",107797744,107797847,103
"22010","ENSG00000222561","11",948421,948524,103
"22011","ENSG00000222578","11",95840017,95840124,107
"22012","ENSG00000222579","12",104851824,104851918,94
"22013","ENSG00000222585","22",25715041,25715169,128
"22014","ENSG00000222588","10",119060983,119061111,128
"22015","ENSG00000222594","4",145035132,145035436,304
"22016","ENSG00000222604","14",74711936,74712045,109
"22017","ENSG00000222607","8",123262843,123262949,106
"22018","ENSG00000222609","5",120710698,120710840,142
"22019","ENSG00000222610","5",98889731,98889833,102
"22020","ENSG00000222612","20",41024205,41024394,189
"22021","ENSG00000222614","19",46736312,46736419,107
"22022","ENSG00000222627","3",128075073,128075249,176
"22023","ENSG00000222629","10",125890566,125890678,112
"22024","ENSG00000222635","12",48081319,48081428,109
"22025","ENSG00000222640","14",70360892,70361088,196
"22026","ENSG00000222644","4",75829454,75829589,135
"22027","ENSG00000222649","6",119057880,119057974,94
"22028","ENSG00000222650","1",236267780,236267958,178
"22029","ENSG00000222659","6",121580332,121580521,189
"22030","ENSG00000222666","10",28408039,28408251,212
"22031","ENSG00000222675","3",157173918,157174040,122
"22032","ENSG00000222678","2",219590687,219590984,297
"22033","ENSG00000222679","17",30288071,30288177,106
"22034","ENSG00000222682","13",106155372,106155490,118
"22035","ENSG00000222685","2",47359505,47359777,272
"22036","ENSG00000222686","6",85751581,85751753,172
"22037","ENSG00000222691","4",107867807,107867910,103
"22038","ENSG00000222705","10",28442575,28442896,321
"22039","ENSG00000222713","6",117301455,117301758,303
"22040","ENSG00000222714","2",218500729,218501037,308
"22041","ENSG00000222721","4",167662986,167663302,316
"22042","ENSG00000222724","2",88016354,88016547,193
"22043","ENSG00000222726","13",20612161,20612338,177
"22044","ENSG00000222736","X",16875146,16875267,121
"22045","ENSG00000222743","5",37619985,37620088,103
"22046","ENSG00000222744","12",66292683,66292987,304
"22047","ENSG00000222747","13",21369790,21369899,109
"22048","ENSG00000222760","9",36267783,36267922,139
"22049","ENSG00000222767","16",47313027,47313121,94
"22050","ENSG00000222777","17",39546104,39546244,140
"22051","ENSG00000222788","1",148939739,148939817,78
"22052","ENSG00000222790","5",140397323,140397444,121
"22053","ENSG00000222800","6",27109790,27109980,190
"22054","ENSG00000222808","17",77152561,77152674,113
"22055","ENSG00000222810","X",72376979,72377169,190
"22056","ENSG00000222821","1",36402721,36402859,138
"22057","ENSG00000222831","1",235853000,235853060,60
"22058","ENSG00000222832","2",216793489,216793600,111
"22059","ENSG00000222842","2",17122841,17123140,299
"22060","ENSG00000222844","11",125277552,125277657,105
"22061","ENSG00000222858","17",29641611,29641702,91
"22062","ENSG00000222862","8",27679836,27679935,99
"22063","ENSG00000222872","3",42221840,42221965,125
"22064","ENSG00000222880","12",80343515,80343792,277
"22065","ENSG00000222881","17",40391232,40391338,106
"22066","ENSG00000222889","8",69700224,69700495,271
"22067","ENSG00000222898","8",61631680,61632012,332
"22068","ENSG00000222915","22",30421045,30421148,103
"22069","ENSG00000222920","13",51027747,51027852,105
"22070","ENSG00000222921","2",134231195,134231312,117
"22071","ENSG00000222922","X",32102065,32102176,111
"22072","ENSG00000222924","5",138069355,138069458,103
"22073","ENSG00000222932","12",101796410,101796502,92
"22074","ENSG00000222937","5",138558970,138559039,69
"22075","ENSG00000222942","3",41766615,41766919,304
"22076","ENSG00000222952","1",13623184,13623284,100
"22077","ENSG00000222960","5",53912020,53912123,103
"22078","ENSG00000222969","13",98203835,98204192,357
"22079","ENSG00000222973","9",2162763,2162953,190
"22080","ENSG00000222976","17",57789449,57789732,283
"22081","ENSG00000222983","3",31228715,31228847,132
"22082","ENSG00000222985","14",65124352,65124542,190
"22083","ENSG00000222987","5",102302504,102302810,306
"22084","ENSG00000222990","14",88513498,88513663,165
"22085","ENSG00000223001","6",89063500,89063690,190
"22086","ENSG00000223006","4",121061172,121061478,306
"22087","ENSG00000223007","5",5126046,5126337,291
"22088","ENSG00000223012","9",86258358,86258646,288
"22089","ENSG00000223013","11",75934936,75935039,103
"22090","ENSG00000223023","18",23024596,23024703,107
"22091","ENSG00000223027","10",26789017,26789157,140
"22092","ENSG00000223039","6",151319635,151319950,315
"22093","ENSG00000223042","12",10084186,10084490,304
"22094","ENSG00000223044","6",82210338,82210440,102
"22095","ENSG00000223060","19",56105416,56105510,94
"22096","ENSG00000223075","1",192875686,192875985,299
"22097","ENSG00000223078","21",23281736,23281909,173
"22098","ENSG00000223080","11",8943380,8943467,87
"22099","ENSG00000223086","4",10115756,10115884,128
"22100","ENSG00000223107","10",60912765,60912927,162
"22101","ENSG00000223113","7",140370441,140370545,104
"22102","ENSG00000223117","3",190642163,190642503,340
"22103","ENSG00000223120","15",96842069,96842384,315
"22104","ENSG00000223126","12",94008739,94009047,308
"22105","ENSG00000223128","20",21424758,21425041,283
"22106","ENSG00000223131","10",22997255,22997358,103
"22107","ENSG00000223138","18",9923920,9924021,101
"22108","ENSG00000223142","22",49738677,49739003,326
"22109","ENSG00000223145","2",7141227,7141544,317
"22110","ENSG00000223156","10",16476003,16476164,161
"22111","ENSG00000223162","9",27198287,27198401,114
"22112","ENSG00000223174","14",76890263,76890613,350
"22113","ENSG00000223177","13",108301212,108301331,119
"22114","ENSG00000223179","5",119007571,119007668,97
"22115","ENSG00000223181","1",758233,758336,103
"22116","ENSG00000223188","9",130120806,130120912,106
"22117","ENSG00000223189","7",128627172,128627275,103
"22118","ENSG00000223198","2",231501990,231502201,211
"22119","ENSG00000223203","6",143449809,143449911,102
"22120","ENSG00000223220","8",70780914,70781008,94
"22121","ENSG00000223224","16",71758402,71758487,85
"22122","ENSG00000223225","4",118606450,118606553,103
"22123","ENSG00000223229","1",96695856,96696167,311
"22124","ENSG00000223238","9",111411644,111411742,98
"22125","ENSG00000223247","3",73110992,73111182,190
"22126","ENSG00000223254","1",85264296,85264402,106
"22127","ENSG00000223258","7",43207762,43207866,104
"22128","ENSG00000223259","X",76655009,76655127,118
"22129","ENSG00000223262","21",42221173,42221286,113
"22130","ENSG00000223263","1",67417214,67417318,104
"22131","ENSG00000223273","12",76315751,76316048,297
"22132","ENSG00000223274","X",1300256,1300375,119
"22133","ENSG00000223280","13",41354557,41354659,102
"22134","ENSG00000223281","8",98921233,98921550,317
"22135","ENSG00000223284","19",40708055,40708163,108
"22136","ENSG00000223294","12",64575665,64575741,76
"22137","ENSG00000223298","13",95310830,95310955,125
"22138","ENSG00000223299","14",96638187,96638514,327
"22139","ENSG00000223300","14",73858061,73858165,104
"22140","ENSG00000223302","10",110642678,110642785,107
"22141","ENSG00000223305","4",55540502,55540835,333
"22142","ENSG00000223309","X",48959179,48959282,103
"22143","ENSG00000223313","15",40529570,40529673,103
"22144","ENSG00000223318","2",164895677,164895777,100
"22145","ENSG00000223321","6",12406486,12406781,295
"22146","ENSG00000223324","11",111683111,111683424,313
"22147","ENSG00000223327","8",80585585,80585773,188
"22148","ENSG00000223335","6",32352877,32352983,106
"22149","ENSG00000223336","13",46374401,46374590,189
"22150","ENSG00000223341","13",45060729,45061086,357
"22151","ENSG00000223342","6",6901022,6918715,17693
"22152","ENSG00000223343","3",48985049,48989988,4939
"22153","ENSG00000223344","1",191858707,191890229,31522
"22154","ENSG00000223345","1",121108210,121117257,9047
"22155","ENSG00000223349","2",130692243,130693770,1527
"22156","ENSG00000223350","22",22343187,22343732,545
"22157","ENSG00000223351","3",21942566,21979828,37262
"22158","ENSG00000223356","1",156712212,156713174,962
"22159","ENSG00000223358","3",185162871,185191955,29084
"22160","ENSG00000223361","5",17353695,17354624,929
"22161","ENSG00000223373","2",212911003,212919809,8806
"22162","ENSG00000223374","2",241351340,241353104,1764
"22163","ENSG00000223375","1",218338541,218338756,215
"22164","ENSG00000223379","9",61868727,61887084,18357
"22165","ENSG00000223381","10",108708539,108840686,132147
"22166","ENSG00000223382","1",30824217,30834864,10647
"22167","ENSG00000223387","3",172560888,172595607,34719
"22168","ENSG00000223389","6",73322837,73323450,613
"22169","ENSG00000223390","1",52033391,52044279,10888
"22170","ENSG00000223392","13",95479444,95533910,54466
"22171","ENSG00000223393","1",230868259,230879141,10882
"22172","ENSG00000223394","9",33786221,33786828,607
"22173","ENSG00000223396","1",201518703,201584367,65664
"22174","ENSG00000223398","3",13460424,13460889,465
"22175","ENSG00000223400","21",41576135,41581319,5184
"22176","ENSG00000223403","14",101064151,101072937,8786
"22177","ENSG00000223404","13",87801036,87803808,2772
"22178","ENSG00000223409","3",65843890,65844446,556
"22179","ENSG00000223410","20",40121041,40126357,5316
"22180","ENSG00000223416","1",58056133,58056480,347
"22181","ENSG00000223417","11",89911111,89921767,10656
"22182","ENSG00000223419","7",30742431,30742818,387
"22183","ENSG00000223427","2",80162428,80163135,707
"22184","ENSG00000223428","10",75288333,75288682,349
"22185","ENSG00000223429","1",52162186,52163026,840
"22186","ENSG00000223430","2",133554315,133558227,3912
"22187","ENSG00000223431","21",44472895,44473739,844
"22188","ENSG00000223432","10",121615425,121615839,414
"22189","ENSG00000223433","2",207654781,207654951,170
"22190","ENSG00000223436","7",132352334,132367976,15642
"22191","ENSG00000223438","X",141625864,141626733,869
"22192","ENSG00000223440","9",32633454,32648685,15231
"22193","ENSG00000223442","5",132630589,132664272,33683
"22194","ENSG00000223443","8",12137168,12139077,1909
"22195","ENSG00000223446","9",93091460,93095546,4086
"22196","ENSG00000223450","1",180000438,180000808,370
"22197","ENSG00000223452","1",155148544,155148813,269
"22198","ENSG00000223458","13",75876886,75881127,4241
"22199","ENSG00000223459","7",143598039,143604839,6800
"22200","ENSG00000223460","13",29306778,29307785,1007
"22201","ENSG00000223461","22",19121529,19124503,2974
"22202","ENSG00000223462","10",44937508,44955725,18217
"22203","ENSG00000223466","2",195532945,195540287,7342
"22204","ENSG00000223467","X",95499604,95500036,432
"22205","ENSG00000223469","6",43851757,43852333,576
"22206","ENSG00000223470","10",33909238,33917804,8566
"22207","ENSG00000223475","7",55573171,55588336,15165
"22208","ENSG00000223476","7",64933273,64933616,343
"22209","ENSG00000223478","9",128724445,128733194,8749
"22210","ENSG00000223479","1",73635216,73715214,79998
"22211","ENSG00000223482","10",87201647,87342612,140965
"22212","ENSG00000223484","X",155985370,155986249,879
"22213","ENSG00000223485","6",169157162,169162992,5830
"22214","ENSG00000223486","X",40009276,40012182,2906
"22215","ENSG00000223489","1",116739981,116742609,2628
"22216","ENSG00000223492","20",53168643,53179550,10907
"22217","ENSG00000223495","1",143498785,143499102,317
"22218","ENSG00000223496","16",70246778,70251940,5162
"22219","ENSG00000223498","X",16897651,16898521,870
"22220","ENSG00000223500","7",135128444,135129685,1241
"22221","ENSG00000223501","6",33250272,33272047,21775
"22222","ENSG00000223502","10",51062579,51068553,5974
"22223","ENSG00000223503","1",155590601,155591262,661
"22224","ENSG00000223504","6",68055351,68060502,5151
"22225","ENSG00000223505","1",203835585,203835912,327
"22226","ENSG00000223506","14",106683395,106684350,955
"22227","ENSG00000223508","8",213186,232231,19045
"22228","ENSG00000223509","15",32519848,32536926,17078
"22229","ENSG00000223510","17",14235673,14236862,1189
"22230","ENSG00000223511","X",1732584,1763212,30628
"22231","ENSG00000223513","3",41859350,41859594,244
"22232","ENSG00000223516","X",148546878,148547397,519
"22233","ENSG00000223517","Y",14276212,14277489,1277
"22234","ENSG00000223518","15",36798596,36818459,19863
"22235","ENSG00000223519","1",246771837,246839611,67774
"22236","ENSG00000223522","2",28307063,28310560,3497
"22237","ENSG00000223523","2",188598791,188839445,240654
"22238","ENSG00000223525","1",174896958,174897996,1038
"22239","ENSG00000223528","10",126988095,127026507,38412
"22240","ENSG00000223529","3",184026369,184027756,1387
"22241","ENSG00000223530","2",23330664,23332044,1380
"22242","ENSG00000223534","6",32659880,32660729,849
"22243","ENSG00000223536","2",16728124,16769567,41443
"22244","ENSG00000223537","6",109483638,109506800,23162
"22245","ENSG00000223538","12",121107220,121107490,270
"22246","ENSG00000223539","5",135742462,135746356,3894
"22247","ENSG00000223540","10",121713607,121713994,387
"22248","ENSG00000223542","6",133435077,133439464,4387
"22249","ENSG00000223546","X",102769158,102885406,116248
"22250","ENSG00000223547","19",12064731,12081565,16834
"22251","ENSG00000223548","5",132003592,132007022,3430
"22252","ENSG00000223549","2",120215181,120217279,2098
"22253","ENSG00000223551","9",128342153,128342770,617
"22254","ENSG00000223552","3",46364955,46407059,42104
"22255","ENSG00000223553","22",20602595,20656914,54319
"22256","ENSG00000223558","7",64085560,64086576,1016
"22257","ENSG00000223559","7",56288230,56291425,3195
"22258","ENSG00000223561","7",25593304,25751032,157728
"22259","ENSG00000223563","21",26889376,26939742,50366
"22260","ENSG00000223564","2",94759259,94760279,1020
"22261","ENSG00000223566","7",63567743,63585075,17332
"22262","ENSG00000223568","9",14040716,14041861,1145
"22263","ENSG00000223569","4",9234385,9236334,1949
"22264","ENSG00000223570","1",226188870,226189221,351
"22265","ENSG00000223571","X",2334295,2336410,2115
"22266","ENSG00000223572","15",43692886,43699222,6336
"22267","ENSG00000223573","19",5558167,5578349,20182
"22268","ENSG00000223575","1",119084998,119085954,956
"22269","ENSG00000223576","13",19841827,19843672,1845
"22270","ENSG00000223581","10",7096216,7097675,1459
"22271","ENSG00000223583","1",26454653,26455187,534
"22272","ENSG00000223584","7",90631906,90632568,662
"22273","ENSG00000223586","6",133821147,133872922,51775
"22274","ENSG00000223587","3",11745,24849,13104
"22275","ENSG00000223589","1",38080572,38080911,339
"22276","ENSG00000223591","X",51710512,51712131,1619
"22277","ENSG00000223592","X",78165696,78172422,6726
"22278","ENSG00000223595","7",123230120,123230741,621
"22279","ENSG00000223597","5",7373115,7391907,18792
"22280","ENSG00000223598","6",151088103,151228447,140344
"22281","ENSG00000223599","1",153852106,153853414,1308
"22282","ENSG00000223600","Y",2995067,2995273,206
"22283","ENSG00000223601","10",22208814,22210021,1207
"22284","ENSG00000223602","9",64878790,64889063,10273
"22285","ENSG00000223603","1",159704983,159705607,624
"22286","ENSG00000223608","21",38006544,38010618,4074
"22287","ENSG00000223609","11",5232678,5243657,10979
"22288","ENSG00000223611","X",24310907,24313315,2408
"22289","ENSG00000223612","1",145233001,145233519,518
"22290","ENSG00000223614","7",64207090,64220508,13418
"22291","ENSG00000223617","13",109281973,109297690,15717
"22292","ENSG00000223619","2",202614214,202614704,490
"22293","ENSG00000223621","9",5855781,5856426,645
"22294","ENSG00000223622","6",52805613,52813460,7847
"22295","ENSG00000223623","6",25053627,25057073,3446
"22296","ENSG00000223624","1",25888970,25889109,139
"22297","ENSG00000223625","13",19458398,19458718,320
"22298","ENSG00000223626","13",112322567,112331225,8658
"22299","ENSG00000223628","15",25580969,25581122,153
"22300","ENSG00000223629","8",6950726,6951599,873
"22301","ENSG00000223631","2",131402778,131410050,7272
"22302","ENSG00000223634","2",23357516,23360376,2860
"22303","ENSG00000223635","1",229508369,229514272,5903
"22304","ENSG00000223637","Y",21394991,21401585,6594
"22305","ENSG00000223638","19",55759014,55763175,4161
"22306","ENSG00000223642","2",159386367,159404636,18269
"22307","ENSG00000223643","1",16851257,16853129,1872
"22308","ENSG00000223646","7",112616440,112896625,280185
"22309","ENSG00000223647","2",31793823,31803980,10157
"22310","ENSG00000223648","14",106657725,106658258,533
"22311","ENSG00000223650","X",74105572,74107958,2386
"22312","ENSG00000223651","20",41997131,41999397,2266
"22313","ENSG00000223652","5",123087248,123090299,3051
"22314","ENSG00000223653","1",85276388,85448124,171736
"22315","ENSG00000223656","1",99698242,99699178,936
"22316","ENSG00000223657","7",136938280,136938553,273
"22317","ENSG00000223658","2",43675151,43676429,1278
"22318","ENSG00000223660","19",54199454,54199971,517
"22319","ENSG00000223662","21",14582202,14598303,16101
"22320","ENSG00000223663","1",1378666,1379032,366
"22321","ENSG00000223665","7",91638847,91643512,4665
"22322","ENSG00000223668","3",39358545,39359922,1377
"22323","ENSG00000223669","20",62732566,62735347,2781
"22324","ENSG00000223671","21",35472095,35472432,337
"22325","ENSG00000223672","9",13322806,13323450,644
"22326","ENSG00000223675","1",94585556,94592297,6741
"22327","ENSG00000223676","13",50361410,50361763,353
"22328","ENSG00000223677","6",29026680,29027607,927
"22329","ENSG00000223679","22",22990690,23008356,17666
"22330","ENSG00000223683","1",63262113,63262707,594
"22331","ENSG00000223685","13",38050817,38350259,299442
"22332","ENSG00000223688","11",3559657,3560022,365
"22333","ENSG00000223691","2",22188336,22190313,1977
"22334","ENSG00000223692","21",46462471,46469306,6835
"22335","ENSG00000223694","1",240170155,240171291,1136
"22336","ENSG00000223695","22",36388626,36396517,7891
"22337","ENSG00000223697","8",132838117,132844298,6181
"22338","ENSG00000223698","Y",24168187,24174494,6307
"22339","ENSG00000223701","6",149884431,149919508,35077
"22340","ENSG00000223702","6",31380411,31380839,428
"22341","ENSG00000223703","2",91736726,91767439,30713
"22342","ENSG00000223704","22",26858634,26968763,110129
"22343","ENSG00000223705","7",75410322,75416787,6465
"22344","ENSG00000223707","X",85849410,85850139,729
"22345","ENSG00000223711","3",195544048,195550581,6533
"22346","ENSG00000223714","X",41275739,41276778,1039
"22347","ENSG00000223715","3",176415439,176867838,452399
"22348","ENSG00000223716","9",38360427,38376430,16003
"22349","ENSG00000223718","7",135660039,135660647,608
"22350","ENSG00000223719","3",6692319,6693088,769
"22351","ENSG00000223721","7",138701607,138703062,1455
"22352","ENSG00000223722","12",31754720,31755121,401
"22353","ENSG00000223723","X",36962196,36963425,1229
"22354","ENSG00000223724","13",49044079,49046794,2715
"22355","ENSG00000223725","2",207239864,207529795,289931
"22356","ENSG00000223726","22",27307483,27318538,11055
"22357","ENSG00000223727","3",3250687,3627296,376609
"22358","ENSG00000223728","1",147840962,147842359,1397
"22359","ENSG00000223729","9",134293931,134295397,1466
"22360","ENSG00000223730","22",44901547,44902471,924
"22361","ENSG00000223731","X",24362761,24365378,2617
"22362","ENSG00000223732","13",44982077,45083125,101048
"22363","ENSG00000223733","X",104803915,104804440,525
"22364","ENSG00000223734","2",20052134,20054496,2362
"22365","ENSG00000223740","7",56525428,56526113,685
"22366","ENSG00000223742","X",28571532,28586395,14863
"22367","ENSG00000223745","1",93262186,93346025,83839
"22368","ENSG00000223749","X",134543119,134546642,3523
"22369","ENSG00000223750","20",1665283,1708200,42917
"22370","ENSG00000223751","2",742488,747767,5279
"22371","ENSG00000223753","X",101683780,101684449,669
"22372","ENSG00000223754","2",24199839,24201698,1859
"22373","ENSG00000223756","11",3380961,3408978,28017
"22374","ENSG00000223760","2",130129621,130139417,9796
"22375","ENSG00000223764","1",916865,921016,4151
"22376","ENSG00000223765","6",71450834,71458874,8040
"22377","ENSG00000223768","21",45288050,45297806,9756
"22378","ENSG00000223770","7",82009177,82029955,20778
"22379","ENSG00000223773","X",2609348,2657229,47881
"22380","ENSG00000223774","1",201893842,201899978,6136
"22381","ENSG00000223776","1",236523052,236524508,1456
"22382","ENSG00000223777","2",176809426,176809859,433
"22383","ENSG00000223779","1",143745249,143760669,15420
"22384","ENSG00000223783","3",195836193,195860404,24211
"22385","ENSG00000223784","10",6709530,6740532,31002
"22386","ENSG00000223786","6",74069451,74690727,621276
"22387","ENSG00000223787","1",92580476,92580821,345
"22388","ENSG00000223788","2",232442034,232447418,5384
"22389","ENSG00000223791","3",23804024,23806905,2881
"22390","ENSG00000223795","9",134505472,134521442,15970
"22391","ENSG00000223797","3",40313802,40453329,139527
"22392","ENSG00000223799","21",33263873,33266260,2387
"22393","ENSG00000223800","10",55468327,55469222,895
"22394","ENSG00000223802","19",18868545,18896727,28182
"22395","ENSG00000223803","3",186900198,186900557,359
"22396","ENSG00000223804","1",120267334,120341871,74537
"22397","ENSG00000223806","21",38733890,38747460,13570
"22398","ENSG00000223807","9",32926051,32926450,399
"22399","ENSG00000223808","10",8970125,8973468,3343
"22400","ENSG00000223810","1",151949523,151950912,1389
"22401","ENSG00000223811","6",113357003,113367944,10941
"22402","ENSG00000223812","3",191425493,191591097,165604
"22403","ENSG00000223813","7",29514224,29563670,49446
"22404","ENSG00000223815","13",60144648,60153678,9030
"22405","ENSG00000223817","10",71508153,71511873,3720
"22406","ENSG00000223819","X",100800303,100800784,481
"22407","ENSG00000223820","10",87817928,87845612,27684
"22408","ENSG00000223821","6",73492025,73492742,717
"22409","ENSG00000223822","21",23390258,23390996,738
"22410","ENSG00000223823","1",1137017,1144056,7039
"22411","ENSG00000223825","2",202201384,202201886,502
"22412","ENSG00000223826","2",101479390,101486822,7432
"22413","ENSG00000223828","1",174756850,174757119,269
"22414","ENSG00000223829","7",46969644,47027481,57837
"22415","ENSG00000223831","22",30598309,30606687,8378
"22416","ENSG00000223834","10",31602862,31606218,3356
"22417","ENSG00000223836","7",57820032,57820410,378
"22418","ENSG00000223837","6",32970232,32970886,654
"22419","ENSG00000223838","7",19353531,19578606,225075
"22420","ENSG00000223839","9",40321299,40329221,7922
"22421","ENSG00000223841","10",57955295,57957178,1883
"22422","ENSG00000223842","1",219222248,219225497,3249
"22423","ENSG00000223843","22",43516107,43560063,43956
"22424","ENSG00000223845","7",64443802,64444742,940
"22425","ENSG00000223849","9",95123521,95123868,347
"22426","ENSG00000223850","2",15920399,15936017,15618
"22427","ENSG00000223855","7",520391,525238,4847
"22428","ENSG00000223859","2",67040546,67041966,1420
"22429","ENSG00000223861","1",151557446,151557940,494
"22430","ENSG00000223863","2",64486353,64500904,14551
"22431","ENSG00000223864","20",38977711,38978422,711
"22432","ENSG00000223865","6",33075990,33089696,13706
"22433","ENSG00000223870","21",25127469,25135247,7778
"22434","ENSG00000223872","7",157501322,157503908,2586
"22435","ENSG00000223873","2",181694442,181694900,458
"22436","ENSG00000223874","2",216859948,216871643,11695
"22437","ENSG00000223875","22",15852990,15893942,40952
"22438","ENSG00000223876","10",91544852,91545098,246
"22439","ENSG00000223878","17",15506866,15507354,488
"22440","ENSG00000223881","1",198597724,198598868,1144
"22441","ENSG00000223882","3",184006338,184011419,5081
"22442","ENSG00000223883","1",69055838,69229607,173769
"22443","ENSG00000223884","2",7045329,7077916,32587
"22444","ENSG00000223886","7",105530209,105530671,462
"22445","ENSG00000223890","2",205253304,205253503,199
"22446","ENSG00000223891","20",44210907,44226027,15120
"22447","ENSG00000223893","7",49942251,49944440,2189
"22448","ENSG00000223896","1",92755794,92756956,1162
"22449","ENSG00000223899","3",33033863,33034810,947
"22450","ENSG00000223901","21",46220269,46225364,5095
"22451","ENSG00000223905","1",76353583,76354246,663
"22452","ENSG00000223908","5",160023740,160024045,305
"22453","ENSG00000223910","10",43628817,43674703,45886
"22454","ENSG00000223911","2",147899401,147902956,3555
"22455","ENSG00000223912","6",132271982,132273332,1350
"22456","ENSG00000223914","12",40156113,40211419,55306
"22457","ENSG00000223915","Y",13230884,13231439,555
"22458","ENSG00000223916","3",43484972,43485880,908
"22459","ENSG00000223917","2",95486480,95488627,2147
"22460","ENSG00000223920","1",61654194,61654908,714
"22461","ENSG00000223921","2",140220584,140221485,901
"22462","ENSG00000223922","2",38810432,38811654,1222
"22463","ENSG00000223923","2",217978707,217993747,15040
"22464","ENSG00000223928","10",24157835,24158781,946
"22465","ENSG00000223930","3",178164008,178385479,221471
"22466","ENSG00000223931","16",32051825,32052280,455
"22467","ENSG00000223935","2",64395220,64453967,58747
"22468","ENSG00000223940","X",152479577,152481024,1447
"22469","ENSG00000223941","3",178419201,178457309,38108
"22470","ENSG00000223942","6",165773056,165775221,2165
"22471","ENSG00000223944","1",37154761,37325100,170339
"22472","ENSG00000223945","1",150053864,150055034,1170
"22473","ENSG00000223946","6",42030053,42031382,1329
"22474","ENSG00000223947","2",100993676,101002244,8568
"22475","ENSG00000223949","1",64094442,64171297,76855
"22476","ENSG00000223951","2",33056333,33063113,6780
"22477","ENSG00000223956","1",56414935,56417137,2202
"22478","ENSG00000223959","16",89972586,90002161,29575
"22479","ENSG00000223960","2",178413635,178440243,26608
"22480","ENSG00000223962","2",148863564,148863804,240
"22481","ENSG00000223963","1",240769420,240771534,2114
"22482","ENSG00000223965","3",31794470,31796175,1705
"22483","ENSG00000223967","6",73526744,73526879,135
"22484","ENSG00000223968","3",27624202,27624456,254
"22485","ENSG00000223969","7",90590619,90597353,6734
"22486","ENSG00000223970","7",53002420,53003429,1009
"22487","ENSG00000223972","1",11869,14409,2540
"22488","ENSG00000223973","2",111383752,111384992,1240
"22489","ENSG00000223974","7",64551498,64552066,568
"22490","ENSG00000223975","21",43465309,43467298,1989
"22491","ENSG00000223979","17",17674026,17677688,3662
"22492","ENSG00000223982","1",231475956,231476288,332
"22493","ENSG00000223984","10",21624592,21626286,1694
"22494","ENSG00000223985","2",490944,503905,12961
"22495","ENSG00000223987","10",5304431,5304865,434
"22496","ENSG00000223991","2",240981515,240986072,4557
"22497","ENSG00000223993","10",85378327,85432775,54448
"22498","ENSG00000223995","X",128838441,128838834,393
"22499","ENSG00000223999","22",22692778,22693312,534
"22500","ENSG00000224000","1",172906900,172907684,784
"22501","ENSG00000224001","9",98234709,98235567,858
"22502","ENSG00000224003","22",25647261,25649232,1971
"22503","ENSG00000224004","14",53991101,53991995,894
"22504","ENSG00000224007","2",148295656,148296679,1023
"22505","ENSG00000224008","20",55420336,55427197,6861
"22506","ENSG00000224011","17",60727165,60727482,317
"22507","ENSG00000224012","5",163709210,163709514,304
"22508","ENSG00000224014","1",247175256,247175525,269
"22509","ENSG00000224015","5",132179234,132181128,1894
"22510","ENSG00000224016","7",149891191,149909704,18513
"22511","ENSG00000224017","7",41089539,41133507,43968
"22512","ENSG00000224019","2",185956587,185957063,476
"22513","ENSG00000224020","9",124658467,124698631,40164
"22514","ENSG00000224023","10",125700436,125719566,19130
"22515","ENSG00000224025","9",68609125,68611984,2859
"22516","ENSG00000224028","2",140103583,140131780,28197
"22517","ENSG00000224029","6",150624677,150626086,1409
"22518","ENSG00000224031","X",103626076,103626492,416
"22519","ENSG00000224032","5",112160526,112164818,4292
"22520","ENSG00000224034","10",5266033,5271236,5203
"22521","ENSG00000224039","3",16692745,16694202,1457
"22522","ENSG00000224041","2",90114838,90115402,564
"22523","ENSG00000224043","2",134735464,134918710,183246
"22524","ENSG00000224045","9",135588002,135591975,3973
"22525","ENSG00000224046","7",87151422,87152420,998
"22526","ENSG00000224048","2",150612381,150635818,23437
"22527","ENSG00000224049","3",187796187,187805258,9071
"22528","ENSG00000224051","1",1324756,1328896,4140
"22529","ENSG00000224055","15",44063511,44064313,802
"22530","ENSG00000224057","7",55179750,55188934,9184
"22531","ENSG00000224058","2",47731402,47732035,633
"22532","ENSG00000224060","Y",12339813,12347495,7682
"22533","ENSG00000224061","2",106253231,106253717,486
"22534","ENSG00000224063","2",187003220,187556288,553068
"22535","ENSG00000224064","1",26983628,26984024,396
"22536","ENSG00000224066","1",32204769,32206814,2045
"22537","ENSG00000224067","9",111802980,111803435,455
"22538","ENSG00000224069","X",154897561,154898092,531
"22539","ENSG00000224072","X",46454097,46457199,3102
"22540","ENSG00000224074","3",24096269,24103238,6969
"22541","ENSG00000224075","Y",9784372,9833895,49523
"22542","ENSG00000224077","11",117098987,117108170,9183
"22543","ENSG00000224078","15",24978583,25420336,441753
"22544","ENSG00000224079","7",1074450,1078036,3586
"22545","ENSG00000224080","3",37143512,37143958,446
"22546","ENSG00000224081","1",94613814,94855426,241612
"22547","ENSG00000224083","9",5096666,5098193,1527
"22548","ENSG00000224086","22",21938269,21977632,39363
"22549","ENSG00000224087","2",130107684,130109741,2057
"22550","ENSG00000224090","2",219002215,219015721,13506
"22551","ENSG00000224091","11",5205041,5207308,2267
"22552","ENSG00000224093","1",93592199,93605573,13374
"22553","ENSG00000224094","3",45159774,45160175,401
"22554","ENSG00000224095","2",102967408,102984429,17021
"22555","ENSG00000224097","4",39480255,39481905,1650
"22556","ENSG00000224099","2",195448532,195481827,33295
"22557","ENSG00000224100","21",42964639,42965363,724
"22558","ENSG00000224101","7",36997796,37013630,15834
"22559","ENSG00000224107","X",135118955,135120526,1571
"22560","ENSG00000224109","X",51617024,51618968,1944
"22561","ENSG00000224110","8",129728744,129730445,1701
"22562","ENSG00000224114","1",206695837,206696269,432
"22563","ENSG00000224116","7",41693884,41779388,85504
"22564","ENSG00000224117","13",30553670,30554693,1023
"22565","ENSG00000224121","2",222904640,222905055,415
"22566","ENSG00000224122","7",39404590,39406579,1989
"22567","ENSG00000224124","22",24657481,24658765,1284
"22568","ENSG00000224126","17",18677261,18677757,496
"22569","ENSG00000224127","1",75127830,75133058,5228
"22570","ENSG00000224128","2",5602505,5691488,88983
"22571","ENSG00000224132","2",237257091,237257676,585
"22572","ENSG00000224136","7",117882859,117883675,816
"22573","ENSG00000224137","2",207662375,207667024,4649
"22574","ENSG00000224138","7",127350128,127351523,1395
"22575","ENSG00000224141","21",18561265,18760320,199055
"22576","ENSG00000224142","X",110305420,110307221,1801
"22577","ENSG00000224144","22",22420326,22421310,984
"22578","ENSG00000224152","2",159615296,159617082,1786
"22579","ENSG00000224153","3",184399790,184457891,58101
"22580","ENSG00000224155","7",56304678,56305526,848
"22581","ENSG00000224157","6",28896530,28897322,792
"22582","ENSG00000224159","2",218200434,218201388,954
"22583","ENSG00000224161","18",59761558,59761905,347
"22584","ENSG00000224163","7",128912732,128914063,1331
"22585","ENSG00000224164","6",24721658,24751960,30302
"22586","ENSG00000224165","2",24971390,25039716,68326
"22587","ENSG00000224167","1",112849821,112877871,28050
"22588","ENSG00000224172","7",64735933,64736743,810
"22589","ENSG00000224173","2",67562067,67620545,58478
"22590","ENSG00000224174","1",16520694,16521796,1102
"22591","ENSG00000224177","2",11391810,11403080,11270
"22592","ENSG00000224183","1",25294164,25294643,479
"22593","ENSG00000224184","2",11833926,12702913,868987
"22594","ENSG00000224185","9",64439346,64440180,834
"22595","ENSG00000224186","5",135033280,135358219,324939
"22596","ENSG00000224187","3",187958775,187976407,17632
"22597","ENSG00000224189","2",176164051,176188958,24907
"22598","ENSG00000224190","10",128912810,128916429,3619
"22599","ENSG00000224192","22",26241331,26254092,12761
"22600","ENSG00000224194","2",15668684,15680484,11800
"22601","ENSG00000224195","10",73813518,73814737,1219
"22602","ENSG00000224204","X",22162733,22172983,10250
"22603","ENSG00000224205","22",23976872,23991421,14549
"22604","ENSG00000224207","4",102734358,102734612,254
"22605","ENSG00000224208","X",71314912,71315879,967
"22606","ENSG00000224209","1",63159083,63317274,158191
"22607","ENSG00000224215","10",23343957,23345181,1224
"22608","ENSG00000224216","X",155334858,155351957,17099
"22609","ENSG00000224217","X",116748530,116748877,347
"22610","ENSG00000224218","4",76758554,76801964,43410
"22611","ENSG00000224220","2",25421117,25427643,6526
"22612","ENSG00000224221","6",73391038,73391767,729
"22613","ENSG00000224222","10",69994276,70019496,25220
"22614","ENSG00000224223","7",54556970,54571726,14756
"22615","ENSG00000224224","X",18865771,18866554,783
"22616","ENSG00000224227","1",247980872,247991204,10332
"22617","ENSG00000224228","1",172775905,173064015,288110
"22618","ENSG00000224231","2",138101878,138107178,5300
"22619","ENSG00000224232","2",241478316,241478993,677
"22620","ENSG00000224236","X",123116107,123117781,1674
"22621","ENSG00000224237","3",27214816,27215018,202
"22622","ENSG00000224238","1",119047405,119064785,17380
"22623","ENSG00000224239","3",857124,858091,967
"22624","ENSG00000224243","13",112056845,112108015,51170
"22625","ENSG00000224244","17",40687038,40689360,2322
"22626","ENSG00000224245","9",94496275,94512879,16604
"22627","ENSG00000224247","21",15493932,15496124,2192
"22628","ENSG00000224250","10",121736303,121739730,3427
"22629","ENSG00000224251","10",4995488,4997380,1892
"22630","ENSG00000224254","17",19605454,19605933,479
"22631","ENSG00000224255","1",52179848,52180553,705
"22632","ENSG00000224256","22",28835893,28836137,244
"22633","ENSG00000224257","2",214510196,214536890,26694
"22634","ENSG00000224259","1",159958035,159984750,26715
"22635","ENSG00000224260","1",209528455,209567673,39218
"22636","ENSG00000224261","1",160266340,160267225,885
"22637","ENSG00000224265","10",43323665,43327932,4267
"22638","ENSG00000224269","21",36698773,36701564,2791
"22639","ENSG00000224271","22",47630827,48023004,392177
"22640","ENSG00000224272","2",241808312,241812016,3704
"22641","ENSG00000224273","7",76108434,76132187,23753
"22642","ENSG00000224274","20",15619494,15619819,325
"22643","ENSG00000224276","1",155991390,156001787,10397
"22644","ENSG00000224277","22",23567064,23573507,6443
"22645","ENSG00000224279","22",38574931,38575431,500
"22646","ENSG00000224280","7",16583782,16586757,2975
"22647","ENSG00000224281","X",119465986,119469128,3142
"22648","ENSG00000224282","5",31822561,31823136,575
"22649","ENSG00000224286","1",170271395,170284277,12882
"22650","ENSG00000224287","2",233865437,233868444,3007
"22651","ENSG00000224288","2",143093056,143094164,1108
"22652","ENSG00000224289","10",89362294,89363487,1193
"22653","ENSG00000224292","X",48506523,48508838,2315
"22654","ENSG00000224294","X",43176994,43226598,49604
"22655","ENSG00000224295","11",5518441,5524955,6514
"22656","ENSG00000224296","5",64674853,64675387,534
"22657","ENSG00000224299","2",201550524,201551049,525
"22658","ENSG00000224301","10",63123929,63125587,1658
"22659","ENSG00000224302","10",102085476,102085730,254
"22660","ENSG00000224307","9",129282458,129312665,30207
"22661","ENSG00000224308","1",152930040,152949210,19170
"22662","ENSG00000224309","21",13038160,13067033,28873
"22663","ENSG00000224310","16",24661422,24671062,9640
"22664","ENSG00000224311","1",27229106,27234352,5246
"22665","ENSG00000224312","6",29994437,29995314,877
"22666","ENSG00000224315","1",8786211,8786913,702
"22667","ENSG00000224316","7",65773620,65802067,28447
"22668","ENSG00000224318","3",109707,197341,87634
"22669","ENSG00000224321","1",15792796,15793285,489
"22670","ENSG00000224322","7",27361591,27410358,48767
"22671","ENSG00000224323","2",186488624,186489083,459
"22672","ENSG00000224324","7",158623188,158623449,261
"22673","ENSG00000224326","1",80534978,80584363,49385
"22674","ENSG00000224328","6",30703067,30713184,10117
"22675","ENSG00000224330","7",13854355,13862118,7763
"22676","ENSG00000224331","2",164687287,164687596,309
"22677","ENSG00000224333","1",32402109,32403115,1006
"22678","ENSG00000224334","22",24686923,24688087,1164
"22679","ENSG00000224335","1",148234273,148234489,216
"22680","ENSG00000224340","1",10054445,10054781,336
"22681","ENSG00000224341","X",118877886,118879185,1299
"22682","ENSG00000224342","2",207173634,207222790,49156
"22683","ENSG00000224346","2",200844240,200845461,1221
"22684","ENSG00000224348","1",241305580,241305882,302
"22685","ENSG00000224349","6",70412828,70413950,1122
"22686","ENSG00000224352","2",130330142,130330285,143
"22687","ENSG00000224354","7",141802482,141803487,1005
"22688","ENSG00000224356","13",100535741,100587146,51405
"22689","ENSG00000224358","1",165768929,165775176,6247
"22690","ENSG00000224359","1",240530452,240530862,410
"22691","ENSG00000224361","2",23507043,23524344,17301
"22692","ENSG00000224367","18",58996734,59069338,72604
"22693","ENSG00000224370","7",56380976,56381312,336
"22694","ENSG00000224371","6",160872888,160926204,53316
"22695","ENSG00000224373","14",106627249,106627825,576
"22696","ENSG00000224374","6",135259996,135260933,937
"22697","ENSG00000224375","7",134684144,134687990,3846
"22698","ENSG00000224376","2",231388976,231394991,6015
"22699","ENSG00000224382","10",4384246,4410614,26368
"22700","ENSG00000224383","17",63998351,64004304,5953
"22701","ENSG00000224384","6",96785137,96795821,10684
"22702","ENSG00000224387","1",2492300,2493258,958
"22703","ENSG00000224389","6",32014795,32035418,20623
"22704","ENSG00000224391","2",216590426,216606938,16512
"22705","ENSG00000224394","13",93818424,93836144,17720
"22706","ENSG00000224396","X",22435598,22436818,1220
"22707","ENSG00000224397","20",50247643,50283250,35607
"22708","ENSG00000224400","2",16354256,16432702,78446
"22709","ENSG00000224401","X",47840963,47841702,739
"22710","ENSG00000224402","10",45255640,45263252,7612
"22711","ENSG00000224403","3",193993331,193993985,654
"22712","ENSG00000224404","22",34191194,34210564,19370
"22713","ENSG00000224405","13",29918647,29926651,8004
"22714","ENSG00000224406","3",186454969,186493661,38692
"22715","ENSG00000224409","1",32717734,32725237,7503
"22716","ENSG00000224411","11",27888838,27891033,2195
"22717","ENSG00000224412","10",63489461,63489638,177
"22718","ENSG00000224413","21",46037052,46039807,2755
"22719","ENSG00000224414","2",217693895,217696763,2868
"22720","ENSG00000224415","7",103141349,103141939,590
"22721","ENSG00000224416","9",21278050,21278619,569
"22722","ENSG00000224417","6",168298069,168302114,4045
"22723","ENSG00000224418","13",98577244,98578830,1586
"22724","ENSG00000224420","19",49688664,49690575,1911
"22725","ENSG00000224421","21",36388878,36389112,234
"22726","ENSG00000224424","3",48847572,48851981,4409
"22727","ENSG00000224425","2",131352214,131353239,1025
"22728","ENSG00000224426","3",172603440,172604006,566
"22729","ENSG00000224427","21",32841496,32841811,315
"22730","ENSG00000224429","13",21302862,21348721,45859
"22731","ENSG00000224430","X",74161062,74162528,1466
"22732","ENSG00000224431","5",132199456,132203487,4031
"22733","ENSG00000224435","22",15622601,15632051,9450
"22734","ENSG00000224437","9",70916997,70917501,504
"22735","ENSG00000224438","12",2781904,2782371,467
"22736","ENSG00000224439","10",28436201,28437078,877
"22737","ENSG00000224442","2",197028711,197030143,1432
"22738","ENSG00000224443","2",47705468,47705979,511
"22739","ENSG00000224445","1",99472332,99600995,128663
"22740","ENSG00000224447","6",26016379,26016601,222
"22741","ENSG00000224448","7",99638242,99638767,525
"22742","ENSG00000224451","13",51598416,51599460,1044
"22743","ENSG00000224452","20",32170390,32170790,400
"22744","ENSG00000224458","7",64100305,64150721,50416
"22745","ENSG00000224459","1",15740051,15749896,9845
"22746","ENSG00000224462","1",207165496,207183910,18414
"22747","ENSG00000224463","2",202231696,202231849,153
"22748","ENSG00000224464","2",23872268,23873014,746
"22749","ENSG00000224465","22",22170983,22171556,573
"22750","ENSG00000224467","2",161096231,161160224,63993
"22751","ENSG00000224468","1",183138402,183141282,2880
"22752","ENSG00000224470","16",71845976,71885268,39292
"22753","ENSG00000224471","X",102799563,102799883,320
"22754","ENSG00000224473","10",30403197,30403776,579
"22755","ENSG00000224475","7",97200708,97201483,775
"22756","ENSG00000224477","6",160698288,160700632,2344
"22757","ENSG00000224478","6",159094093,159116254,22161
"22758","ENSG00000224479","3",63741827,63827445,85618
"22759","ENSG00000224481","1",148295895,148344638,48743
"22760","ENSG00000224482","Y",20808776,20811809,3033
"22761","ENSG00000224484","7",57776972,57777521,549
"22762","ENSG00000224488","9",17447145,17448543,1398
"22763","ENSG00000224490","2",165933857,165949891,16034
"22764","ENSG00000224493","1",75521562,75522231,669
"22765","ENSG00000224494","1",81426456,81427605,1149
"22766","ENSG00000224500","10",77313941,77315694,1753
"22767","ENSG00000224504","10",85432863,85448961,16098
"22768","ENSG00000224505","17",45150400,45161510,11110
"22769","ENSG00000224506","6",125674353,125720218,45865
"22770","ENSG00000224509","2",104936241,105038496,102255
"22771","ENSG00000224511","13",30103178,30108895,5717
"22772","ENSG00000224513","11",3226061,3232838,6777
"22773","ENSG00000224514","3",13650696,13746638,95942
"22774","ENSG00000224515","1",161556290,161557078,788
"22775","ENSG00000224520","1",157073257,157074703,1446
"22776","ENSG00000224521","1",248548756,248565299,16543
"22777","ENSG00000224523","X",81408938,81427276,18338
"22778","ENSG00000224525","1",242203555,242210827,7272
"22779","ENSG00000224529","2",208135394,208137697,2303
"22780","ENSG00000224530","20",53421199,53421656,457
"22781","ENSG00000224531","6",11093834,11138733,44899
"22782","ENSG00000224532","6",6758276,6759291,1015
"22783","ENSG00000224533","X",155466540,155611616,145076
"22784","ENSG00000224535","1",212466699,212472905,6206
"22785","ENSG00000224536","1",201507241,201534784,27543
"22786","ENSG00000224537","9",42817105,42823213,6108
"22787","ENSG00000224539","X",135598927,135615431,16504
"22788","ENSG00000224540","1",209232196,209233419,1223
"22789","ENSG00000224541","21",26158091,26175824,17733
"22790","ENSG00000224543","19",14489388,14489609,221
"22791","ENSG00000224545","7",131520137,131520503,366
"22792","ENSG00000224546","9",96146007,96147856,1849
"22793","ENSG00000224549","9",22767175,22768316,1141
"22794","ENSG00000224550","1",107505203,107505448,245
"22795","ENSG00000224551","7",97135015,97135561,546
"22796","ENSG00000224553","2",171374931,171375278,347
"22797","ENSG00000224555","11",3989163,3989463,300
"22798","ENSG00000224557","6",33112451,33129084,16633
"22799","ENSG00000224559","2",131637025,131649615,12590
"22800","ENSG00000224563","3",188562238,188568666,6428
"22801","ENSG00000224565","20",47391925,47412327,20402
"22802","ENSG00000224566","1",228114997,228115473,476
"22803","ENSG00000224567","Y",11445708,11446101,393
"22804","ENSG00000224568","2",107529292,107556499,27207
"22805","ENSG00000224569","4",13977166,13978028,862
"22806","ENSG00000224570","1",65576129,65578380,2251
"22807","ENSG00000224574","21",45407386,45410065,2679
"22808","ENSG00000224577","2",176495255,176819180,323925
"22809","ENSG00000224578","16",51553436,51647132,93696
"22810","ENSG00000224579","19",54209092,54209418,326
"22811","ENSG00000224582","6",29528721,29533665,4944
"22812","ENSG00000224585","2",94971954,94972167,213
"22813","ENSG00000224586","6",28525925,28534952,9027
"22814","ENSG00000224590","2",201553688,201554031,343
"22815","ENSG00000224592","1",38047314,38119025,71711
"22816","ENSG00000224593","7",3337889,3338601,712
"22817","ENSG00000224594","8",48384590,48385049,459
"22818","ENSG00000224595","7",114414244,114419875,5631
"22819","ENSG00000224596","10",78943328,79067895,124567
"22820","ENSG00000224597","10",29409402,29487745,78343
"22821","ENSG00000224598","21",34135432,34136071,639
"22822","ENSG00000224599","9",65189995,65193610,3615
"22823","ENSG00000224604","2",16853820,16855284,1464
"22824","ENSG00000224606","2",70467385,70468495,1110
"22825","ENSG00000224607","2",89968867,89969335,468
"22826","ENSG00000224609","1",59131932,59296491,164559
"22827","ENSG00000224610","X",39226103,39299786,73683
"22828","ENSG00000224611","3",172522228,172522444,216
"22829","ENSG00000224613","1",103415980,103525511,109531
"22830","ENSG00000224614","3",195908076,195913986,5910
"22831","ENSG00000224616","1",100251528,100266179,14651
"22832","ENSG00000224618","3",30626423,30626797,374
"22833","ENSG00000224620","1",179447578,179448440,862
"22834","ENSG00000224621","1",16159266,16161883,2617
"22835","ENSG00000224622","12",55158847,55159723,876
"22836","ENSG00000224626","2",18784807,18787752,2945
"22837","ENSG00000224628","20",31285317,31286835,1518
"22838","ENSG00000224629","7",157263022,157263229,207
"22839","ENSG00000224631","16",61055399,61055964,565
"22840","ENSG00000224632","X",103007461,103008072,611
"22841","ENSG00000224635","20",38404893,38416797,11904
"22842","ENSG00000224637","2",44166266,44166943,677
"22843","ENSG00000224643","2",183083405,183108519,25114
"22844","ENSG00000224644","9",111574192,111575427,1235
"22845","ENSG00000224646","2",74754670,74754819,149
"22846","ENSG00000224647","17",7330452,7335413,4961
"22847","ENSG00000224649","21",29182027,29187795,5768
"22848","ENSG00000224650","14",106810442,106811131,689
"22849","ENSG00000224652","3",196142525,196160893,18368
"22850","ENSG00000224653","7",57819819,57820627,808
"22851","ENSG00000224655","2",121779133,121809962,30829
"22852","ENSG00000224656","X",47718002,47719099,1097
"22853","ENSG00000224658","6",148237585,148283408,45823
"22854","ENSG00000224659","X",49322057,49329384,7327
"22855","ENSG00000224660","3",15254184,15264515,10331
"22856","ENSG00000224661","2",3702585,3704153,1568
"22857","ENSG00000224662","9",136779939,136780218,279
"22858","ENSG00000224666","6",36386831,36393462,6631
"22859","ENSG00000224667","7",12506007,12507478,1471
"22860","ENSG00000224668","1",210859177,210862285,3108
"22861","ENSG00000224669","7",64582733,64583207,474
"22862","ENSG00000224671","1",203144694,203152579,7885
"22863","ENSG00000224672","2",201102089,201102957,868
"22864","ENSG00000224674","2",162088259,162090072,1813
"22865","ENSG00000224675","2",154435853,154457438,21585
"22866","ENSG00000224677","15",43649123,43649280,157
"22867","ENSG00000224678","1",92114803,92115796,993
"22868","ENSG00000224679","2",131535187,131536988,1801
"22869","ENSG00000224680","1",52368677,52369244,567
"22870","ENSG00000224682","9",135447446,135450154,2708
"22871","ENSG00000224683","7",16208945,16209265,320
"22872","ENSG00000224687","1",178090677,178093984,3307
"22873","ENSG00000224688","22",21141624,21142371,747
"22874","ENSG00000224689","19",9689924,9700776,10852
"22875","ENSG00000224690","1",150800473,150801031,558
"22876","ENSG00000224691","1",186176814,186177302,488
"22877","ENSG00000224692","X",103258572,103259581,1009
"22878","ENSG00000224697","10",54599678,54600683,1005
"22879","ENSG00000224699","1",110347116,110443817,96701
"22880","ENSG00000224700","11",131981096,131984661,3565
"22881","ENSG00000224701","X",45951762,45952333,571
"22882","ENSG00000224702","1",165210627,165213090,2463
"22883","ENSG00000224706","7",37116779,37117185,406
"22884","ENSG00000224707","6",20437821,20440178,2357
"22885","ENSG00000224709","12",48627879,48628836,957
"22886","ENSG00000224711","20",7347451,7367933,20482
"22887","ENSG00000224712","16",14708944,14726338,17394
"22888","ENSG00000224713","12",57612118,57619638,7520
"22889","ENSG00000224714","10",64901136,65017639,116503
"22890","ENSG00000224715","22",47345569,47373541,27972
"22891","ENSG00000224717","1",205455929,205469024,13095
"22892","ENSG00000224721","14",75574888,75579588,4700
"22893","ENSG00000224722","8",127086263,127087510,1247
"22894","ENSG00000224723","7",57177409,57180052,2643
"22895","ENSG00000224725","10",70389426,70390626,1200
"22896","ENSG00000224727","1",243267257,243268119,862
"22897","ENSG00000224728","3",15878047,15879571,1524
"22898","ENSG00000224729","7",100589402,100604206,14804
"22899","ENSG00000224730","19",54635722,54638892,3170
"22900","ENSG00000224731","2",80028012,80030551,2539
"22901","ENSG00000224733","6",128500527,128501176,649
"22902","ENSG00000224738","17",59106598,59118267,11669
"22903","ENSG00000224739","2",43001355,43006060,4705
"22904","ENSG00000224743","13",30881933,30933846,51913
"22905","ENSG00000224745","10",87878692,87880427,1735
"22906","ENSG00000224746","7",135774521,135932997,158476
"22907","ENSG00000224747","21",44469929,44472516,2587
"22908","ENSG00000224750","10",90454170,90502968,48798
"22909","ENSG00000224751","1",43850300,43851611,1311
"22910","ENSG00000224752","3",14089107,14089871,764
"22911","ENSG00000224758","10",132961340,132962237,897
"22912","ENSG00000224760","10",80024737,80025159,422
"22913","ENSG00000224761","10",38164648,38212417,47769
"22914","ENSG00000224762","9",64473040,64473826,786
"22915","ENSG00000224763","1",211660189,211661277,1088
"22916","ENSG00000224764","9",94928551,94934946,6395
"22917","ENSG00000224765","X",137556191,137564387,8196
"22918","ENSG00000224769","3",195614947,195620233,5286
"22919","ENSG00000224771","3",10626015,10629307,3292
"22920","ENSG00000224773","X",114774828,114776775,1947
"22921","ENSG00000224775","X",75582676,75585506,2830
"22922","ENSG00000224776","11",109982192,109983043,851
"22923","ENSG00000224778","13",19126399,19139611,13212
"22924","ENSG00000224781","X",52832704,52833899,1195
"22925","ENSG00000224783","1",238777049,238779200,2151
"22926","ENSG00000224785","7",23562459,23564261,1802
"22927","ENSG00000224786","4",122728532,122732482,3950
"22928","ENSG00000224788","10",10058722,10063502,4780
"22929","ENSG00000224790","21",36966461,36975164,8703
"22930","ENSG00000224791","2",203764295,203765593,1298
"22931","ENSG00000224792","3",51817603,51819635,2032
"22932","ENSG00000224794","22",39292988,39295589,2601
"22933","ENSG00000224795","11",131622451,131663583,41132
"22934","ENSG00000224796","6",33079451,33079860,409
"22935","ENSG00000224797","9",130724786,130725050,264
"22936","ENSG00000224799","X",56973510,56974796,1286
"22937","ENSG00000224800","1",150881236,150881683,447
"22938","ENSG00000224802","9",34109171,34109968,797
"22939","ENSG00000224805","1",47179250,47180339,1089
"22940","ENSG00000224806","22",24686168,24686679,511
"22941","ENSG00000224808","3",9014123,9015979,1856
"22942","ENSG00000224809","9",92171241,92173494,2253
"22943","ENSG00000224810","1",182062677,182069253,6576
"22944","ENSG00000224812","10",44793119,44959709,166590
"22945","ENSG00000224814","2",233693434,233708699,15265
"22946","ENSG00000224816","X",106466542,106467440,898
"22947","ENSG00000224817","10",101701994,101730037,28043
"22948","ENSG00000224819","2",220776818,220855873,79055
"22949","ENSG00000224820","9",72107818,72108312,494
"22950","ENSG00000224821","13",110456396,110463287,6891
"22951","ENSG00000224822","3",24455136,24459434,4298
"22952","ENSG00000224825","9",74485551,74499127,13576
"22953","ENSG00000224826","2",224169664,224171537,1873
"22954","ENSG00000224827","Y",24276245,24277026,781
"22955","ENSG00000224829","11",77313606,77314032,426
"22956","ENSG00000224830","1",247938973,247939659,686
"22957","ENSG00000224831","3",149982181,149983308,1127
"22958","ENSG00000224834","1",227434064,227434346,282
"22959","ENSG00000224837","1",168055901,168056422,521
"22960","ENSG00000224839","2",208057248,208057745,497
"22961","ENSG00000224842","9",126589594,126613700,24106
"22962","ENSG00000224843","6",26956932,27059749,102817
"22963","ENSG00000224844","2",237122910,237124097,1187
"22964","ENSG00000224846","6",2989335,2999604,10269
"22965","ENSG00000224848","9",96687050,96774318,87268
"22966","ENSG00000224851","10",91033157,91062164,29007
"22967","ENSG00000224852","2",143094789,143096555,1766
"22968","ENSG00000224853","13",73413473,73661891,248418
"22969","ENSG00000224854","9",21966929,21967751,822
"22970","ENSG00000224855","3",193618609,193627337,8728
"22971","ENSG00000224856","22",43957027,43957348,321
"22972","ENSG00000224857","1",121573946,121580524,6578
"22973","ENSG00000224858","3",37016523,37017014,491
"22974","ENSG00000224861","14",66012830,66013789,959
"22975","ENSG00000224863","1",46446600,46451317,4717
"22976","ENSG00000224865","7",131897289,131948953,51664
"22977","ENSG00000224870","1",1399520,1402046,2526
"22978","ENSG00000224875","2",42143238,42170301,27063
"22979","ENSG00000224876","20",33214920,33217067,2147
"22980","ENSG00000224877","17",81239305,81241310,2005
"22981","ENSG00000224880","7",57173357,57174362,1005
"22982","ENSG00000224881","2",87379880,87380767,887
"22983","ENSG00000224883","22",41981304,41982217,913
"22984","ENSG00000224884","3",8573726,8593124,19398
"22985","ENSG00000224885","2",3298341,3301465,3124
"22986","ENSG00000224887","9",87084161,87085151,990
"22987","ENSG00000224888","16",88731180,88741425,10245
"22988","ENSG00000224891","2",37148530,37149304,774
"22989","ENSG00000224892","13",51454164,51461315,7151
"22990","ENSG00000224895","3",47960327,47961081,754
"22991","ENSG00000224897","7",124929873,125482966,553093
"22992","ENSG00000224899","7",125151326,125153611,2285
"22993","ENSG00000224901","1",197757319,197761965,4646
"22994","ENSG00000224903","7",156654185,156659582,5397
"22995","ENSG00000224904","1",11877770,11880406,2636
"22996","ENSG00000224905","21",14027419,14144468,117049
"22997","ENSG00000224906","12",6438498,6438852,354
"22998","ENSG00000224907","10",109807651,109808129,478
"22999","ENSG00000224910","19",35596581,35601596,5015
"23000","ENSG00000224914","10",87341685,87357882,16197
"23001","ENSG00000224916","19",44942238,44949565,7327
"23002","ENSG00000224918","3",53348,54346,998
"23003","ENSG00000224920","10",37523011,37544701,21690
"23004","ENSG00000224924","21",20651450,20803816,152366
"23005","ENSG00000224927","1",109810642,109810998,356
"23006","ENSG00000224928","2",218953401,218954050,649
"23007","ENSG00000224931","X",153122145,153128323,6178
"23008","ENSG00000224932","4",117314597,117360655,46058
"23009","ENSG00000224933","13",76013023,76014501,1478
"23010","ENSG00000224934","10",99430919,99463259,32340
"23011","ENSG00000224935","9",12098660,12159148,60488
"23012","ENSG00000224936","6",30468882,30470251,1369
"23013","ENSG00000224939","1",234629311,234634780,5469
"23014","ENSG00000224940","7",128350325,128361685,11360
"23015","ENSG00000224943","1",159466321,159483376,17055
"23016","ENSG00000224944","6",91557292,91690428,133136
"23017","ENSG00000224945","9",89088604,89109934,21330
"23018","ENSG00000224946","7",33276834,33277091,257
"23019","ENSG00000224947","7",56559221,56559958,737
"23020","ENSG00000224949","X",54147372,54147659,287
"23021","ENSG00000224950","1",116493016,116499212,6196
"23022","ENSG00000224955","9",28598668,28599292,624
"23023","ENSG00000224957","3",536062,846561,310499
"23024","ENSG00000224958","9",68353614,68357893,4279
"23025","ENSG00000224959","2",111491943,111494811,2868
"23026","ENSG00000224960","X",27460211,27463341,3130
"23027","ENSG00000224961","20",10696949,10754033,57084
"23028","ENSG00000224962","3",166691187,166691712,525
"23029","ENSG00000224963","X",153479266,153487088,7822
"23030","ENSG00000224965","1",110208834,110209987,1153
"23031","ENSG00000224967","2",117934025,117934789,764
"23032","ENSG00000224968","1",177351562,177437880,86318
"23033","ENSG00000224969","1",1011997,1013193,1196
"23034","ENSG00000224970","7",142875836,142892743,16907
"23035","ENSG00000224971","7",55732144,55732431,287
"23036","ENSG00000224972","9",6902670,6978859,76189
"23037","ENSG00000224973","22",33725007,33750843,25836
"23038","ENSG00000224975","X",47204921,47205865,944
"23039","ENSG00000224976","13",19349137,19407962,58825
"23040","ENSG00000224977","1",174022509,174022985,476
"23041","ENSG00000224978","X",155212921,155213638,717
"23042","ENSG00000224980","1",56585612,56586242,630
"23043","ENSG00000224981","7",126868767,126870532,1765
"23044","ENSG00000224982","12",119593774,119643075,49301
"23045","ENSG00000224984","6",54840118,54840855,737
"23046","ENSG00000224985","1",161153760,161159349,5589
"23047","ENSG00000224986","1",48325080,48326123,1043
"23048","ENSG00000224988","9",129883693,129884170,477
"23049","ENSG00000224992","9",132768965,132770212,1247
"23050","ENSG00000224993","5",43666766,43667232,466
"23051","ENSG00000224999","6",169296471,169297959,1488
"23052","ENSG00000225000","7",18429062,18430738,1676
"23053","ENSG00000225002","9",106061354,106064825,3471
"23054","ENSG00000225005","7",73314107,73315213,1106
"23055","ENSG00000225008","X",155290360,155291353,993
"23056","ENSG00000225014","17",20111824,20112990,1166
"23057","ENSG00000225016","13",18809830,18810048,218
"23058","ENSG00000225017","8",99346052,99348256,2204
"23059","ENSG00000225018","7",55876738,55877024,286
"23060","ENSG00000225022","20",5292388,5292831,443
"23061","ENSG00000225024","2",26678219,26678510,291
"23062","ENSG00000225025","X",79323446,79325217,1771
"23063","ENSG00000225026","3",12328003,12328274,271
"23064","ENSG00000225028","1",47818066,47820237,2171
"23065","ENSG00000225031","X",111619677,111621489,1812
"23066","ENSG00000225032","9",127816066,127822520,6454
"23067","ENSG00000225036","1",105433994,105434821,827
"23068","ENSG00000225037","X",20139968,20140444,476
"23069","ENSG00000225039","13",30419519,30422237,2718
"23070","ENSG00000225043","21",46420553,46421034,481
"23071","ENSG00000225044","3",1962381,1987470,25089
"23072","ENSG00000225045","2",82815809,82817528,1719
"23073","ENSG00000225050","9",118687752,118732772,45020
"23074","ENSG00000225051","5",179679032,179694768,15736
"23075","ENSG00000225053","10",8161260,8162192,932
"23076","ENSG00000225056","20",23655225,23656390,1165
"23077","ENSG00000225057","2",238231684,238255633,23949
"23078","ENSG00000225058","3",187997422,188003990,6568
"23079","ENSG00000225062","2",218366665,218367835,1170
"23080","ENSG00000225063","1",205233821,205236867,3046
"23081","ENSG00000225064","2",207260445,207270690,10245
"23082","ENSG00000225066","X",17933349,17934823,1474
"23083","ENSG00000225067","19",15611657,15612122,465
"23084","ENSG00000225071","X",24429573,24429920,347
"23085","ENSG00000225072","9",90232185,90233141,956
"23086","ENSG00000225075","1",112693688,112696621,2933
"23087","ENSG00000225076","X",10024842,10038654,13812
"23088","ENSG00000225077","1",6234692,6239444,4752
"23089","ENSG00000225078","9",123061845,123063312,1467
"23090","ENSG00000225079","1",116775104,116775623,519
"23091","ENSG00000225080","1",148129497,148129898,401
"23092","ENSG00000225082","1",155586644,155602197,15553
"23093","ENSG00000225083","13",113351645,113361868,10223
"23094","ENSG00000225084","17",2232680,2233610,930
"23095","ENSG00000225085","9",82405188,82406239,1051
"23096","ENSG00000225087","1",72636547,72899240,262693
"23097","ENSG00000225091","20",38427309,38427442,133
"23098","ENSG00000225092","6",7183083,7185287,2204
"23099","ENSG00000225093","6",108004357,108005568,1211
"23100","ENSG00000225094","4",109553243,109554094,851
"23101","ENSG00000225096","6",57961438,58438364,476926
"23102","ENSG00000225098","22",24259929,24263764,3835
"23103","ENSG00000225099","1",42903232,42903912,680
"23104","ENSG00000225100","10",79982910,79983240,330
"23105","ENSG00000225101","11",4393783,4476361,82578
"23106","ENSG00000225102","6",11990338,12001286,10948
"23107","ENSG00000225105","13",25193107,25210295,17188
"23108","ENSG00000225106","20",61738219,61755056,16837
"23109","ENSG00000225107","2",145569294,145588024,18730
"23110","ENSG00000225108","2",109986939,109988394,1455
"23111","ENSG00000225110","X",153317681,153321822,4141
"23112","ENSG00000225111","2",207868582,207869915,1333
"23113","ENSG00000225112","10",13710415,13712054,1639
"23114","ENSG00000225117","Y",12354096,12387328,33232
"23115","ENSG00000225118","10",92878092,92878289,197
"23116","ENSG00000225121","6",63480134,63481876,1742
"23117","ENSG00000225122","1",163422405,163423164,759
"23118","ENSG00000225123","9",33574361,33574588,227
"23119","ENSG00000225124","2",203074685,203075142,457
"23120","ENSG00000225125","X",136807223,136807877,654
"23121","ENSG00000225126","1",7441096,7441554,458
"23122","ENSG00000225127","20",21085576,21106514,20938
"23123","ENSG00000225128","7",85421122,85489293,68171
"23124","ENSG00000225129","20",59352195,59357774,5579
"23125","ENSG00000225131","13",48771128,48771827,699
"23126","ENSG00000225133","13",41199832,41200807,975
"23127","ENSG00000225136","2",88922328,88922753,425
"23128","ENSG00000225137","10",50264978,50266815,1837
"23129","ENSG00000225138","5",473236,480884,7648
"23130","ENSG00000225140","10",628638,631255,2617
"23131","ENSG00000225142","1",31108188,31108623,435
"23132","ENSG00000225144","7",132264152,132271269,7117
"23133","ENSG00000225146","7",1029025,1043891,14866
"23134","ENSG00000225148","6",139856104,139877391,21287
"23135","ENSG00000225151","15",84199311,84230136,30825
"23136","ENSG00000225152","10",123425713,123427640,1927
"23137","ENSG00000225154","1",47074778,47075979,1201
"23138","ENSG00000225155","10",118643760,118644198,438
"23139","ENSG00000225156","2",44954664,44968762,14098
"23140","ENSG00000225158","1",10895761,10895998,237
"23141","ENSG00000225159","1",27206930,27207796,866
"23142","ENSG00000225163","14",96931367,96945394,14027
"23143","ENSG00000225165","5",95440044,95440687,643
"23144","ENSG00000225166","2",215453688,215486639,32951
"23145","ENSG00000225169","1",100213293,100213670,377
"23146","ENSG00000225170","20",22272052,22273454,1402
"23147","ENSG00000225171","1",166868748,166869209,461
"23148","ENSG00000225172","1",198973379,198985506,12127
"23149","ENSG00000225173","6",28837869,28839006,1137
"23150","ENSG00000225174","6",108123457,108159392,35935
"23151","ENSG00000225177","6",138692548,138697288,4740
"23152","ENSG00000225178","19",23827162,23828049,887
"23153","ENSG00000225179","13",34435450,34640803,205353
"23154","ENSG00000225180","17",81165507,81183164,17657
"23155","ENSG00000225181","20",15552157,15552885,728
"23156","ENSG00000225183","1",54089856,54090093,237
"23157","ENSG00000225185","12",98590723,98591214,491
"23158","ENSG00000225187","2",47067822,47071204,3382
"23159","ENSG00000225190","17",45435900,45490749,54849
"23160","ENSG00000225191","1",103926567,103927806,1239
"23161","ENSG00000225192","10",37794276,37796109,1833
"23162","ENSG00000225193","15",90206572,90206967,395
"23163","ENSG00000225194","9",96019724,96027993,8269
"23164","ENSG00000225195","12",64628344,64629976,1632
"23165","ENSG00000225196","1",12220794,12221109,315
"23166","ENSG00000225200","14",105978520,105979146,626
"23167","ENSG00000225203","13",75375511,75377294,1783
"23168","ENSG00000225205","2",172480840,172556596,75756
"23169","ENSG00000225206","1",97933474,98049863,116389
"23170","ENSG00000225208","10",101311018,101311505,487
"23171","ENSG00000225209","7",68020235,68036917,16682
"23172","ENSG00000225210","14",19062316,19131167,68851
"23173","ENSG00000225213","10",16721352,16748377,27025
"23174","ENSG00000225214","2",152098328,152109202,10874
"23175","ENSG00000225215","11",107403404,107404589,1185
"23176","ENSG00000225216","2",205756469,205764006,7537
"23177","ENSG00000225217","1",161606291,161608217,1926
"23178","ENSG00000225218","21",42831040,42836477,5437
"23179","ENSG00000225222","1",246178778,246179204,426
"23180","ENSG00000225224","7",157192368,157192832,464
"23181","ENSG00000225226","2",58275532,58296817,21285
"23182","ENSG00000225230","5",56900041,56910714,10673
"23183","ENSG00000225231","12",9936504,9943495,6991
"23184","ENSG00000225233","1",213492288,213579267,86979
"23185","ENSG00000225234","2",3481242,3482409,1167
"23186","ENSG00000225235","X",135520083,135520674,591
"23187","ENSG00000225236","11",117117794,117119181,1387
"23188","ENSG00000225239","13",110762674,110763133,459
"23189","ENSG00000225240","3",196452996,196453055,59
"23190","ENSG00000225243","1",171199244,171227788,28544
"23191","ENSG00000225244","7",56940341,56944353,4012
"23192","ENSG00000225246","20",34122470,34123290,820
"23193","ENSG00000225249","13",60618991,61176758,557767
"23194","ENSG00000225251","10",13057902,13058676,774
"23195","ENSG00000225253","18",41819053,41819421,368
"23196","ENSG00000225254","9",38452782,38454070,1288
"23197","ENSG00000225255","22",15746630,15778297,31667
"23198","ENSG00000225258","2",180571712,180692454,120742
"23199","ENSG00000225259","8",133408006,133409107,1101
"23200","ENSG00000225263","13",66977432,66985776,8344
"23201","ENSG00000225264","7",29598795,29685255,86460
"23202","ENSG00000225265","1",222589825,222593843,4018
"23203","ENSG00000225267","21",30263380,30263881,501
"23204","ENSG00000225269","10",4655427,4682722,27295
"23205","ENSG00000225270","7",55798034,55798876,842
"23206","ENSG00000225272","1",165676310,165676781,471
"23207","ENSG00000225279","1",160062461,160080769,18308
"23208","ENSG00000225280","20",21397740,21400391,2651
"23209","ENSG00000225282","22",23926900,23929574,2674
"23210","ENSG00000225284","2",38861720,38863133,1413
"23211","ENSG00000225285","1",1430539,1434573,4034
"23212","ENSG00000225286","7",28615097,28615888,791
"23213","ENSG00000225292","10",112888735,112906111,17376
"23214","ENSG00000225295","7",57169406,57170771,1365
"23215","ENSG00000225297","1",93199755,93199939,184
"23216","ENSG00000225298","21",27722379,27751233,28854
"23217","ENSG00000225299","10",67052609,67055028,2419
"23218","ENSG00000225300","1",246605873,246608102,2229
"23219","ENSG00000225303","10",50472814,50474246,1432
"23220","ENSG00000225308","7",21220213,21221428,1215
"23221","ENSG00000225311","6",144311699,144333301,21602
"23222","ENSG00000225313","1",33307348,33349245,41897
"23223","ENSG00000225315","1",24040835,24086799,45964
"23224","ENSG00000225316","13",19561328,19588603,27275
"23225","ENSG00000225321","20",22263065,22284029,20964
"23226","ENSG00000225325","1",166387727,166452632,64905
"23227","ENSG00000225328","2",108167125,108217886,50761
"23228","ENSG00000225329","7",104894628,104926645,32017
"23229","ENSG00000225330","21",39630271,39726085,95814
"23230","ENSG00000225331","21",44158740,44160076,1336
"23231","ENSG00000225333","1",39718028,39718595,567
"23232","ENSG00000225334","1",224766324,224779335,13011
"23233","ENSG00000225335","22",18076527,18078884,2357
"23234","ENSG00000225336","20",34833575,34834462,887
"23235","ENSG00000225337","9",68307393,68308445,1052
"23236","ENSG00000225338","1",212309051,212309518,467
"23237","ENSG00000225339","6",34248535,34286768,38233
"23238","ENSG00000225342","12",40186009,40224915,38906
"23239","ENSG00000225343","6",132518830,132519295,465
"23240","ENSG00000225345","9",38566260,38568211,1951
"23241","ENSG00000225347","9",32333457,32334354,897
"23242","ENSG00000225349","12",31534715,31535247,532
"23243","ENSG00000225355","10",36995023,36995585,562
"23244","ENSG00000225356","4",181522666,181523001,335
"23245","ENSG00000225357","20",35752814,35753719,905
"23246","ENSG00000225358","7",112735166,112738693,3527
"23247","ENSG00000225359","1",181190471,181191149,678
"23248","ENSG00000225360","9",63729702,63730173,471
"23249","ENSG00000225361","9",135462727,135480777,18050
"23250","ENSG00000225362","15",71110244,71115500,5256
"23251","ENSG00000225364","5",132948493,132948718,225
"23252","ENSG00000225365","7",158537495,158539879,2384
"23253","ENSG00000225366","X",110520312,110523021,2709
"23254","ENSG00000225370","19",54671231,54672591,1360
"23255","ENSG00000225371","7",56362458,56365270,2812
"23256","ENSG00000225376","9",101468349,101482199,13850
"23257","ENSG00000225377","20",316860,348490,31630
"23258","ENSG00000225378","2",26671254,26674464,3210
"23259","ENSG00000225383","10",10784437,10795047,10610
"23260","ENSG00000225385","9",88066915,88068037,1122
"23261","ENSG00000225386","3",26614261,26622943,8682
"23262","ENSG00000225387","1",18385829,18388514,2685
"23263","ENSG00000225391","6",136982165,136993234,11069
"23264","ENSG00000225392","2",70102551,70102862,311
"23265","ENSG00000225393","X",155468286,155487046,18760
"23266","ENSG00000225396","X",72807425,72808210,785
"23267","ENSG00000225398","2",113541937,113563298,21361
"23268","ENSG00000225399","3",49260085,49261316,1231
"23269","ENSG00000225400","X",136847384,136848034,650
"23270","ENSG00000225401","1",244394976,244395660,684
"23271","ENSG00000225402","2",37816915,37817961,1046
"23272","ENSG00000225405","4",62105660,62106049,389
"23273","ENSG00000225406","2",185547135,185547818,683
"23274","ENSG00000225407","5",76691439,76716215,24776
"23275","ENSG00000225408","9",5719021,5720244,1223
"23276","ENSG00000225411","9",63802144,63814159,12015
"23277","ENSG00000225413","22",23512494,23513602,1108
"23278","ENSG00000225415","6",138822747,138823799,1052
"23279","ENSG00000225416","7",152602213,152602892,679
"23280","ENSG00000225417","20",20214299,20215262,963
"23281","ENSG00000225418","10",5122087,5135226,13139
"23282","ENSG00000225419","20",18485265,18486052,787
"23283","ENSG00000225420","2",88538720,88575610,36890
"23284","ENSG00000225422","12",66234079,66235234,1155
"23285","ENSG00000225423","10",84390908,84392045,1137
"23286","ENSG00000225424","10",129278251,129291722,13471
"23287","ENSG00000225427","13",78786272,78840051,53779
"23288","ENSG00000225431","21",42599280,42615058,15778
"23289","ENSG00000225434","9",72305367,72356721,51354
"23290","ENSG00000225437","6",163042557,163054161,11604
"23291","ENSG00000225438","17",41406512,41411775,5263
"23292","ENSG00000225439","2",74148007,74151952,3945
"23293","ENSG00000225442","17",17076038,17077752,1714
"23294","ENSG00000225446","1",90851122,90855253,4131
"23295","ENSG00000225447","1",45645816,45646197,381
"23296","ENSG00000225449","2",129966592,129980466,13874
"23297","ENSG00000225450","22",38739003,38749041,10038
"23298","ENSG00000225451","7",63876341,63877350,1009
"23299","ENSG00000225455","4",49016682,49017154,472
"23300","ENSG00000225457","7",113100663,113146330,45667
"23301","ENSG00000225458","20",41991140,42063969,72829
"23302","ENSG00000225460","9",89472237,89472692,455
"23303","ENSG00000225465","22",29436534,29478868,42334
"23304","ENSG00000225469","X",142172866,142173989,1123
"23305","ENSG00000225470","X",73944182,74070408,126226
"23306","ENSG00000225471","X",72159845,72160346,501
"23307","ENSG00000225472","9",14317073,14358490,41417
"23308","ENSG00000225473","3",193553213,193555088,1875
"23309","ENSG00000225475","1",56619409,56619549,140
"23310","ENSG00000225476","2",143098898,143099933,1035
"23311","ENSG00000225477","11",21283779,21284955,1176
"23312","ENSG00000225479","20",8248704,8256918,8214
"23313","ENSG00000225480","22",16897445,16897546,101
"23314","ENSG00000225484","10",79661394,79826594,165200
"23315","ENSG00000225487","1",164921318,164921629,311
"23316","ENSG00000225488","7",56477588,56484386,6798
"23317","ENSG00000225489","9",6716157,6727438,11281
"23318","ENSG00000225492","1",89407679,89426243,18564
"23319","ENSG00000225493","2",238510690,238555054,44364
"23320","ENSG00000225496","2",111940302,111941036,734
"23321","ENSG00000225497","10",77147652,77150100,2448
"23322","ENSG00000225498","7",90312496,90322592,10096
"23323","ENSG00000225502","21",14774301,14775262,961
"23324","ENSG00000225505","1",92732000,92733257,1257
"23325","ENSG00000225506","1",47096653,47179271,82618
"23326","ENSG00000225507","7",47956793,47957318,525
"23327","ENSG00000225510","13",53199981,53202753,2772
"23328","ENSG00000225511","9",92141298,92160114,18816
"23329","ENSG00000225513","9",112173522,112173971,449
"23330","ENSG00000225514","1",47164510,47165920,1410
"23331","ENSG00000225518","1",226083590,226090465,6875
"23332","ENSG00000225519","10",90994620,91006390,11770
"23333","ENSG00000225521","2",241015599,241064116,48517
"23334","ENSG00000225522","1",204183006,204183537,531
"23335","ENSG00000225523","2",90021567,90022185,618
"23336","ENSG00000225526","3",12514934,12561059,46125
"23337","ENSG00000225527","10",18531849,18533336,1487
"23338","ENSG00000225528","22",39960397,39964718,4321
"23339","ENSG00000225530","13",89361160,89363224,2064
"23340","ENSG00000225531","9",107116829,107117557,728
"23341","ENSG00000225532","6",170736173,170737777,1604
"23342","ENSG00000225533","10",95183653,95184217,564
"23343","ENSG00000225535","7",115030564,115126314,95750
"23344","ENSG00000225536","X",86084716,86086339,1623
"23345","ENSG00000225538","11",56082801,56084840,2039
"23346","ENSG00000225539","2",194344190,194576578,232388
"23347","ENSG00000225542","3",21542789,21579959,37170
"23348","ENSG00000225544","22",21885282,21885673,391
"23349","ENSG00000225546","7",119495024,119907397,412373
"23350","ENSG00000225548","3",27797552,27931579,134027
"23351","ENSG00000225549","6",118757518,118783420,25902
"23352","ENSG00000225552","3",175773145,175776333,3188
"23353","ENSG00000225555","21",34353099,34375364,22265
"23354","ENSG00000225556","1",151837819,151840557,2738
"23355","ENSG00000225557","22",36175167,36175854,687
"23356","ENSG00000225558","3",37134658,37135102,444
"23357","ENSG00000225559","7",138163440,138164637,1197
"23358","ENSG00000225560","Y",9347511,9356814,9303
"23359","ENSG00000225561","1",218912757,218918714,5957
"23360","ENSG00000225564","9",103140523,103325034,184511
"23361","ENSG00000225568","1",87045875,87046700,825
"23362","ENSG00000225569","X",65270913,65273019,2106
"23363","ENSG00000225570","2",181690380,181693415,3035
"23364","ENSG00000225572","7",111808516,111821773,13257
"23365","ENSG00000225573","7",66606738,66607107,369
"23366","ENSG00000225574","X",8783514,8784461,947
"23367","ENSG00000225578","3",196939877,196942534,2657
"23368","ENSG00000225579","13",77779723,77844145,64422
"23369","ENSG00000225580","6",112616703,112617880,1177
"23370","ENSG00000225581","11",89993536,89999741,6205
"23371","ENSG00000225582","17",34479272,34482148,2876
"23372","ENSG00000225588","2",107362282,107407329,45047
"23373","ENSG00000225591","1",173741674,173741928,254
"23374","ENSG00000225595","6",28859625,28864630,5005
"23375","ENSG00000225598","1",80373364,80374621,1257
"23376","ENSG00000225602","1",11143898,11149537,5639
"23377","ENSG00000225603","1",147050817,147052481,1664
"23378","ENSG00000225605","1",75926454,76019356,92902
"23379","ENSG00000225606","7",12570125,12571392,1267
"23380","ENSG00000225610","2",205989585,206000858,11273
"23381","ENSG00000225611","3",42770612,42773635,3023
"23382","ENSG00000225612","7",155267137,155270912,3775
"23383","ENSG00000225613","6",52146814,52151119,4305
"23384","ENSG00000225614","16",88382989,88440757,57768
"23385","ENSG00000225616","1",28982278,28982608,330
"23386","ENSG00000225619","2",2319232,2327110,7878
"23387","ENSG00000225620","1",202632428,202632911,483
"23388","ENSG00000225622","20",16223750,16224535,785
"23389","ENSG00000225623","1",49374201,49472085,97884
"23390","ENSG00000225624","Y",20727254,20742900,15646
"23391","ENSG00000225625","15",56846340,56846605,265
"23392","ENSG00000225626","9",69818394,69820773,2379
"23393","ENSG00000225630","1",629640,630683,1043
"23394","ENSG00000225632","1",54285405,54287371,1966
"23395","ENSG00000225636","2",197014990,197016015,1025
"23396","ENSG00000225637","21",43363332,43366566,3234
"23397","ENSG00000225639","9",35943210,35943934,724
"23398","ENSG00000225640","20",5507875,5510002,2127
"23399","ENSG00000225642","2",8603082,8603359,277
"23400","ENSG00000225643","1",25581478,25590356,8878
"23401","ENSG00000225644","6",33389374,33389475,101
"23402","ENSG00000225647","7",108598352,108639349,40997
"23403","ENSG00000225648","7",72829425,72836701,7276
"23404","ENSG00000225649","2",12780593,13007029,226436
"23405","ENSG00000225650","1",114468315,114469282,967
"23406","ENSG00000225652","10",77354404,77376613,22209
"23407","ENSG00000225655","9",41073710,41076392,2682
"23408","ENSG00000225656","1",230823641,230824707,1066
"23409","ENSG00000225657","20",56577563,56598621,21058
"23410","ENSG00000225658","2",74351134,74351419,285
"23411","ENSG00000225660","X",146955075,146955209,134
"23412","ENSG00000225662","3",62779176,62779785,609
"23413","ENSG00000225663","17",81822361,81833302,10941
"23414","ENSG00000225670","1",159194325,159207973,13648
"23415","ENSG00000225671","1",50405430,50406024,594
"23416","ENSG00000225672","1",111007700,111015530,7830
"23417","ENSG00000225673","3",60730055,60730644,589
"23418","ENSG00000225674","13",24122065,24123814,1749
"23419","ENSG00000225675","1",53328233,53336509,8276
"23420","ENSG00000225678","11",102751070,102754943,3873
"23421","ENSG00000225680","14",53599832,53614026,14194
"23422","ENSG00000225681","17",20056287,20056630,343
"23423","ENSG00000225683","6",163163830,163192038,28208
"23424","ENSG00000225684","9",113102117,113111543,9426
"23425","ENSG00000225685","Y",10066554,10069151,2597
"23426","ENSG00000225689","X",128027322,129326707,1299385
"23427","ENSG00000225690","6",41247369,41249649,2280
"23428","ENSG00000225693","9",33019682,33020165,483
"23429","ENSG00000225695","2",201063089,201064051,962
"23430","ENSG00000225697","3",48625723,48635493,9770
"23431","ENSG00000225698","14",106790691,106791233,542
"23432","ENSG00000225703","7",76972679,76976961,4282
"23433","ENSG00000225705","7",48846426,48852898,6472
"23434","ENSG00000225706","9",8858127,8864772,6645
"23435","ENSG00000225708","20",58069054,58072070,3016
"23436","ENSG00000225710","1",16548651,16552531,3880
"23437","ENSG00000225711","1",179220938,179222125,1187
"23438","ENSG00000225712","1",209267798,209268223,425
"23439","ENSG00000225715","X",80709928,80710705,777
"23440","ENSG00000225718","7",69186821,69430923,244102
"23441","ENSG00000225720","22",39091586,39092855,1269
"23442","ENSG00000225721","1",44759037,44775810,16773
"23443","ENSG00000225724","22",22339573,22341214,1641
"23444","ENSG00000225725","8",7955014,8008755,53741
"23445","ENSG00000225726","7",77071751,77072237,486
"23446","ENSG00000225727","13",44437057,44464921,27864
"23447","ENSG00000225728","X",107939263,107939642,379
"23448","ENSG00000225730","6",46903471,46909078,5607
"23449","ENSG00000225731","21",42733594,42741758,8164
"23450","ENSG00000225733","3",14920347,14948424,28077
"23451","ENSG00000225738","10",82228985,82232920,3935
"23452","ENSG00000225739","7",36818959,36819690,731
"23453","ENSG00000225741","22",22103219,22104857,1638
"23454","ENSG00000225742","3",194202392,194250203,47811
"23455","ENSG00000225744","2",111607841,111612518,4677
"23456","ENSG00000225746","14",100894770,101038859,144089
"23457","ENSG00000225750","1",29144494,29146994,2500
"23458","ENSG00000225751","17",9452197,9470014,17817
"23459","ENSG00000225752","6",143094034,143099645,5611
"23460","ENSG00000225755","1",163237214,163239197,1983
"23461","ENSG00000225756","9",133654586,133657313,2727
"23462","ENSG00000225758","X",140470866,140471274,408
"23463","ENSG00000225760","13",110965704,110990579,24875
"23464","ENSG00000225761","10",74005137,74027915,22778
"23465","ENSG00000225762","1",47380928,47408477,27549
"23466","ENSG00000225764","3",190120964,190145107,24143
"23467","ENSG00000225765","2",104412146,104414195,2049
"23468","ENSG00000225766","14",24036453,24051028,14575
"23469","ENSG00000225767","1",50461469,50471150,9681
"23470","ENSG00000225768","10",104474939,104480274,5335
"23471","ENSG00000225770","3",196536532,196536702,170
"23472","ENSG00000225774","22",30542536,30544305,1769
"23473","ENSG00000225775","6",9124221,9161777,37556
"23474","ENSG00000225778","10",11849608,11894700,45092
"23475","ENSG00000225779","1",46370586,46370955,369
"23476","ENSG00000225781","7",143052320,143053347,1027
"23477","ENSG00000225783","22",26646411,26676475,30064
"23478","ENSG00000225785","20",52451464,52455619,4155
"23479","ENSG00000225787","2",85102389,85102694,305
"23480","ENSG00000225790","3",177930758,177940299,9541
"23481","ENSG00000225791","6",52576787,52643058,66271
"23482","ENSG00000225792","7",26369310,26376701,7391
"23483","ENSG00000225793","6",75285014,75317525,32511
"23484","ENSG00000225794","2",216594359,216611206,16847
"23485","ENSG00000225796","2",201213298,201214660,1362
"23486","ENSG00000225797","6",29464596,29469806,5210
"23487","ENSG00000225798","15",58889967,58894082,4115
"23488","ENSG00000225801","13",71296210,71297235,1025
"23489","ENSG00000225802","11",59255360,59259486,4126
"23490","ENSG00000225803","20",20854121,20854642,521
"23491","ENSG00000225805","11",71878453,71884561,6108
"23492","ENSG00000225806","20",58863528,58888809,25281
"23493","ENSG00000225807","7",100509416,100520205,10789
"23494","ENSG00000225808","2",177229191,177229506,315
"23495","ENSG00000225811","1",190264898,190362270,97372
"23496","ENSG00000225813","2",161281902,161282618,716
"23497","ENSG00000225815","2",66327349,66328984,1635
"23498","ENSG00000225818","17",71596338,71597279,941
"23499","ENSG00000225822","3",196431385,196432530,1145
"23500","ENSG00000225825","14",105881539,105881556,17
"23501","ENSG00000225826","1",168784012,168792886,8874
"23502","ENSG00000225828","1",32361270,32364278,3008
"23503","ENSG00000225830","10",49454470,49539538,85068
"23504","ENSG00000225831","20",5532878,5533335,457
"23505","ENSG00000225832","6",20722328,20723655,1327
"23506","ENSG00000225833","X",15602881,15621484,18603
"23507","ENSG00000225836","10",89646289,89650822,4533
"23508","ENSG00000225839","X",101043564,101094476,50912
"23509","ENSG00000225840","Y",10197256,10199103,1847
"23510","ENSG00000225849","20",46463719,46477232,13513
"23511","ENSG00000225850","10",97334564,97343203,8639
"23512","ENSG00000225851","6",31382074,31382288,214
"23513","ENSG00000225854","1",26326688,26327033,345
"23514","ENSG00000225855","1",155316863,155324176,7313
"23515","ENSG00000225856","9",88970887,88971341,454
"23516","ENSG00000225857","1",180906651,180909166,2515
"23517","ENSG00000225858","X",72660470,72660719,249
"23518","ENSG00000225864","6",29722981,29723971,990
"23519","ENSG00000225867","22",37550026,37551735,1709
"23520","ENSG00000225868","19",37823722,37855215,31493
"23521","ENSG00000225870","13",111095838,111103097,7259
"23522","ENSG00000225871","1",148435105,148436926,1821
"23523","ENSG00000225872","19",35785697,35797902,12205
"23524","ENSG00000225873","3",44421127,44439946,18819
"23525","ENSG00000225876","Y",26244351,26244573,222
"23526","ENSG00000225877","19",42821863,42826878,5015
"23527","ENSG00000225879","6",168920394,168964386,43992
"23528","ENSG00000225880","1",826206,827522,1316
"23529","ENSG00000225881","7",132758970,132760632,1662
"23530","ENSG00000225882","X",17970197,18104644,134447
"23531","ENSG00000225884","2",191792797,191820257,27460
"23532","ENSG00000225885","8",118282139,118400605,118466
"23533","ENSG00000225886","1",27669468,27703063,33595
"23534","ENSG00000225889","2",64143239,64252859,109620
"23535","ENSG00000225891","1",26462756,26468014,5258
"23536","ENSG00000225893","9",4633027,4633756,729
"23537","ENSG00000225898","7",93777839,93778514,675
"23538","ENSG00000225899","10",133623895,133626795,2900
"23539","ENSG00000225900","2",39098149,39098445,296
"23540","ENSG00000225901","9",80565032,80565962,930
"23541","ENSG00000225903","1",39633416,39633903,487
"23542","ENSG00000225905","1",1420245,1422691,2446
"23543","ENSG00000225907","7",30167804,30168004,200
"23544","ENSG00000225911","2",220048822,220049272,450
"23545","ENSG00000225912","X",92676519,92676954,435
"23546","ENSG00000225913","10",87607985,87659279,51294
"23547","ENSG00000225914","6",32254640,32407763,153123
"23548","ENSG00000225916","2",207226949,207228308,1359
"23549","ENSG00000225918","7",145039999,145040941,942
"23550","ENSG00000225919","1",232718071,232722250,4179
"23551","ENSG00000225920","1",219199914,219200567,653
"23552","ENSG00000225921","6",13615335,13632739,17404
"23553","ENSG00000225922","10",67793770,67794245,475
"23554","ENSG00000225923","1",96390652,96391393,741
"23555","ENSG00000225924","6",149243299,149257551,14252
"23556","ENSG00000225928","10",84454679,84456056,1377
"23557","ENSG00000225929","22",50735825,50738139,2314
"23558","ENSG00000225930","15",30195809,30217552,21743
"23559","ENSG00000225931","1",2566410,2569888,3478
"23560","ENSG00000225932","7",144183466,144186053,2587
"23561","ENSG00000225934","1",227598424,227599094,670
"23562","ENSG00000225935","7",107642765,107643023,258
"23563","ENSG00000225936","10",117239600,117241923,2323
"23564","ENSG00000225937","9",76691980,76863307,171327
"23565","ENSG00000225938","1",101235683,101236528,845
"23566","ENSG00000225940","5",56511567,56606232,94665
"23567","ENSG00000225942","2",545805,546667,862
"23568","ENSG00000225944","13",74828553,74830080,1527
"23569","ENSG00000225945","6",37815777,37819218,3441
"23570","ENSG00000225947","9",72470374,72471076,702
"23571","ENSG00000225948","10",6618716,6625346,6630
"23572","ENSG00000225950","19",49061066,49065054,3988
"23573","ENSG00000225951","9",128468957,128473012,4055
"23574","ENSG00000225952","1",22835713,22836849,1136
"23575","ENSG00000225953","2",199457700,199476935,19235
"23576","ENSG00000225956","20",13244064,13245369,1305
"23577","ENSG00000225959","7",68266319,68266859,540
"23578","ENSG00000225960","9",119973094,119974322,1228
"23579","ENSG00000225963","2",230121370,230174223,52853
"23580","ENSG00000225964","2",6819463,6840464,21001
"23581","ENSG00000225965","10",38161570,38161749,179
"23582","ENSG00000225968","7",1688119,1747954,59835
"23583","ENSG00000225969","7",73735038,73736158,1120
"23584","ENSG00000225970","X",143757737,143828133,70396
"23585","ENSG00000225971","22",30136673,30137681,1008
"23586","ENSG00000225972","1",629062,629433,371
"23587","ENSG00000225973","15",55317184,55319161,1977
"23588","ENSG00000225974","7",15689075,15690854,1779
"23589","ENSG00000225975","19",36682636,36687449,4813
"23590","ENSG00000225978","20",63102205,63104386,2181
"23591","ENSG00000225979","2",197311393,197312740,1347
"23592","ENSG00000225980","19",9265440,9268819,3379
"23593","ENSG00000225981","7",1459937,1464008,4071
"23594","ENSG00000225982","1",182086551,182090112,3561
"23595","ENSG00000225986","1",20184242,20186486,2244
"23596","ENSG00000225990","1",27211265,27211484,219
"23597","ENSG00000225992","7",38322446,38322730,284
"23598","ENSG00000225999","13",100027769,100028174,405
"23599","ENSG00000226002","7",65084103,65100232,16129
"23600","ENSG00000226003","1",160848010,160848502,492
"23601","ENSG00000226004","6",137943079,137945802,2723
"23602","ENSG00000226005","10",3911889,3935817,23928
"23603","ENSG00000226007","9",62532337,62534724,2387
"23604","ENSG00000226009","10",101818800,101828885,10085
"23605","ENSG00000226010","X",64144872,64147052,2180
"23606","ENSG00000226012","21",38237217,38238201,984
"23607","ENSG00000226014","1",240549867,240550378,511
"23608","ENSG00000226015","1",147203276,147204932,1656
"23609","ENSG00000226017","3",64187544,64200965,13421
"23610","ENSG00000226020","9",63774870,63775241,371
"23611","ENSG00000226022","3",6148484,6365885,217401
"23612","ENSG00000226023","X",120958165,120961487,3322
"23613","ENSG00000226025","19",39679374,39686373,6999
"23614","ENSG00000226026","1",95161676,95233982,72306
"23615","ENSG00000226028","1",143619994,143620527,533
"23616","ENSG00000226029","1",16460948,16468481,7533
"23617","ENSG00000226031","X",138711452,138716617,5165
"23618","ENSG00000226032","6",159042192,159095823,53631
"23619","ENSG00000226036","1",212647296,212647755,459
"23620","ENSG00000226037","13",89477608,89500509,22901
"23621","ENSG00000226038","20",43230760,43231260,500
"23622","ENSG00000226040","5",141896168,141896689,521
"23623","ENSG00000226041","2",16202430,16204226,1796
"23624","ENSG00000226042","Y",21637475,21639041,1566
"23625","ENSG00000226043","21",22209920,22420819,210899
"23626","ENSG00000226045","7",130645225,130645594,369
"23627","ENSG00000226047","9",107117459,107121705,4246
"23628","ENSG00000226048","X",46684765,46685707,942
"23629","ENSG00000226049","17",34036681,34039872,3191
"23630","ENSG00000226051","10",75243568,75373500,129932
"23631","ENSG00000226053","1",98210747,98272658,61911
"23632","ENSG00000226054","21",36130489,36131376,887
"23633","ENSG00000226055","9",37878116,37879493,1377
"23634","ENSG00000226056","X",102799942,102801399,1457
"23635","ENSG00000226057","13",18946755,19062718,115963
"23636","ENSG00000226058","2",101375587,101376055,468
"23637","ENSG00000226063","7",35258381,35259729,1348
"23638","ENSG00000226065","2",110383112,110384642,1530
"23639","ENSG00000226067","1",120913184,121009291,96107
"23640","ENSG00000226068","6",48149203,48150005,802
"23641","ENSG00000226070","6",40358744,40369474,10730
"23642","ENSG00000226072","2",169658132,169661357,3225
"23643","ENSG00000226074","3",46809359,46812558,3199
"23644","ENSG00000226075","7",63233035,63234245,1210
"23645","ENSG00000226079","6",114523443,114545335,21892
"23646","ENSG00000226080","2",11102142,11102997,855
"23647","ENSG00000226081","X",90112650,90113706,1056
"23648","ENSG00000226082","3",62926371,62926882,511
"23649","ENSG00000226083","10",18001786,18010562,8776
"23650","ENSG00000226084","1",77129114,77129668,554
"23651","ENSG00000226085","22",39875289,39876108,819
"23652","ENSG00000226086","10",38080056,38080877,821
"23653","ENSG00000226087","2",47225781,47240886,15105
"23654","ENSG00000226088","1",70359562,70360437,875
"23655","ENSG00000226089","6",81527102,81534915,7813
"23656","ENSG00000226091","12",8295986,8396803,100817
"23657","ENSG00000226094","20",62572671,62573384,713
"23658","ENSG00000226097","7",20296637,20314512,17875
"23659","ENSG00000226098","8",54522799,54523297,498
"23660","ENSG00000226101","17",72072333,72103035,30702
"23661","ENSG00000226102","7",35946294,35972587,26293
"23662","ENSG00000226107","X",134522702,134522990,288
"23663","ENSG00000226112","X",111169221,111169403,182
"23664","ENSG00000226113","10",38247922,38333155,85233
"23665","ENSG00000226121","2",161500885,161507705,6820
"23666","ENSG00000226122","7",50531759,50543463,11704
"23667","ENSG00000226124","2",199760544,199851173,90629
"23668","ENSG00000226125","2",230690065,230700529,10464
"23669","ENSG00000226128","1",97585862,97586294,432
"23670","ENSG00000226131","2",173485865,173486362,497
"23671","ENSG00000226132","14",53612724,53613405,681
"23672","ENSG00000226133","1",48050659,48091736,41077
"23673","ENSG00000226134","13",97675011,97677963,2952
"23674","ENSG00000226137","17",81029130,81034881,5751
"23675","ENSG00000226138","12",48085062,48085421,359
"23676","ENSG00000226140","10",16276871,16295858,18987
"23677","ENSG00000226141","X",154654546,154655325,779
"23678","ENSG00000226144","20",37049254,37049707,453
"23679","ENSG00000226145","17",16817983,16822579,4596
"23680","ENSG00000226147","1",52994726,52996026,1300
"23681","ENSG00000226148","1",202796030,202797094,1064
"23682","ENSG00000226149","6",129439485,129576047,136562
"23683","ENSG00000226153","X",17705339,17705691,352
"23684","ENSG00000226156","17",14947741,14948198,457
"23685","ENSG00000226158","13",114306646,114307066,420
"23686","ENSG00000226159","10",89915489,89957373,41884
"23687","ENSG00000226161","13",36938400,36939494,1094
"23688","ENSG00000226163","10",72501746,72502956,1210
"23689","ENSG00000226167","1",113856635,113901237,44602
"23690","ENSG00000226172","1",119000344,119001392,1048
"23691","ENSG00000226174","14",105398538,105450106,51568
"23692","ENSG00000226179","X",320990,321851,861
"23693","ENSG00000226180","16",87693537,87696147,2610
"23694","ENSG00000226181","6",117451130,117453525,2395
"23695","ENSG00000226185","2",95514827,95520107,5280
"23696","ENSG00000226186","2",70955899,70956234,335
"23697","ENSG00000226188","20",45745737,45746287,550
"23698","ENSG00000226191","1",247936061,247937513,1452
"23699","ENSG00000226193","6",152402398,152404966,2568
"23700","ENSG00000226194","6",169369998,169388385,18387
"23701","ENSG00000226196","1",189132350,189133292,942
"23702","ENSG00000226197","9",13386130,13836571,450441
"23703","ENSG00000226199","X",27832175,27833204,1029
"23704","ENSG00000226200","10",50623466,50641451,17985
"23705","ENSG00000226203","20",25955795,25969288,13493
"23706","ENSG00000226204","21",18953264,18967058,13794
"23707","ENSG00000226205","7",133732493,133733595,1102
"23708","ENSG00000226206","9",89799695,89821753,22058
"23709","ENSG00000226207","6",97710953,97717197,6244
"23710","ENSG00000226208","1",70715933,70720289,4356
"23711","ENSG00000226209","10",13308145,13308447,302
"23712","ENSG00000226210","12",14522,32015,17493
"23713","ENSG00000226212","7",38340700,38340998,298
"23714","ENSG00000226216","3",29390848,29391218,370
"23715","ENSG00000226218","2",145600907,145603423,2516
"23716","ENSG00000226220","7",39796593,39797911,1318
"23717","ENSG00000226221","5",56504635,56505072,437
"23718","ENSG00000226226","1",220467954,220468808,854
"23719","ENSG00000226229","20",16586333,16586693,360
"23720","ENSG00000226230","7",78486530,78487028,498
"23721","ENSG00000226232","16",69976388,69996188,19800
"23722","ENSG00000226233","22",37215738,37215891,153
"23723","ENSG00000226235","1",205373252,205387440,14188
"23724","ENSG00000226237","9",86948666,87002033,53367
"23725","ENSG00000226239","20",32005671,32031591,25920
"23726","ENSG00000226240","13",74419158,74444735,25577
"23727","ENSG00000226241","X",103087198,103089277,2079
"23728","ENSG00000226242","2",192774082,192774416,334
"23729","ENSG00000226243","20",44466564,44466842,278
"23730","ENSG00000226245","10",43643872,43645047,1175
"23731","ENSG00000226249","6",147741434,147743324,1890
"23732","ENSG00000226250","13",18905419,18935554,30135
"23733","ENSG00000226251","1",212225278,212238977,13699
"23734","ENSG00000226252","1",47225797,47230750,4953
"23735","ENSG00000226253","10",74527584,74527947,363
"23736","ENSG00000226254","7",91107374,91107793,419
"23737","ENSG00000226255","10",19051455,19052170,715
"23738","ENSG00000226258","3",6631008,6805479,174471
"23739","ENSG00000226259","5",70415352,70448015,32663
"23740","ENSG00000226261","2",202336024,202336727,703
"23741","ENSG00000226263","20",13237801,13239674,1873
"23742","ENSG00000226266","2",159670708,159712435,41727
"23743","ENSG00000226268","11",49433480,49434438,958
"23744","ENSG00000226272","5",142859604,142868922,9318
"23745","ENSG00000226276","2",215939308,215941719,2411
"23746","ENSG00000226277","2",421057,424059,3002
"23747","ENSG00000226278","7",55764797,55773288,8491
"23748","ENSG00000226279","7",22881893,22882390,497
"23749","ENSG00000226281","6",6692741,6739030,46289
"23750","ENSG00000226284","20",49134480,49135012,532
"23751","ENSG00000226285","7",79543911,79544853,942
"23752","ENSG00000226286","1",3132927,3133709,782
"23753","ENSG00000226287","22",20701114,20704606,3492
"23754","ENSG00000226288","11",4581743,4593340,11597
"23755","ENSG00000226291","7",1080863,1082178,1315
"23756","ENSG00000226292","1",166022215,166023027,812
"23757","ENSG00000226296","10",53291072,53311065,19993
"23758","ENSG00000226297","2",229003886,229004400,514
"23759","ENSG00000226299","X",53322990,53323822,832
"23760","ENSG00000226302","3",40603125,40605427,2302
"23761","ENSG00000226304","10",25924448,25933710,9262
"23762","ENSG00000226306","5",137801193,137810751,9558
"23763","ENSG00000226308","20",57266797,57282998,16201
"23764","ENSG00000226309","6",84429584,84430802,1218
"23765","ENSG00000226310","X",57121662,57127243,5581
"23766","ENSG00000226312","2",201140278,201157823,17545
"23767","ENSG00000226313","X",5169512,5170645,1133
"23768","ENSG00000226314","6",28161769,28169594,7825
"23769","ENSG00000226317","13",85363601,85544570,180969
"23770","ENSG00000226318","10",67960702,67961464,762
"23771","ENSG00000226320","3",33956972,34677247,720275
"23772","ENSG00000226321","2",240906330,240993311,86981
"23773","ENSG00000226323","7",14814131,14816565,2434
"23774","ENSG00000226324","1",71367054,71367303,249
"23775","ENSG00000226327","9",88324454,88325339,885
"23776","ENSG00000226328","22",45133020,45163781,30761
"23777","ENSG00000226329","7",22863874,22881350,17476
"23778","ENSG00000226330","1",204377850,204435846,57996
"23779","ENSG00000226332","20",62305432,62306325,893
"23780","ENSG00000226334","9",104927553,104928892,1339
"23781","ENSG00000226336","22",35703803,35704176,373
"23782","ENSG00000226337","9",68541036,68644442,103406
"23783","ENSG00000226340","2",148872253,148872797,544
"23784","ENSG00000226342","7",63908966,63910453,1487
"23785","ENSG00000226345","3",196423322,196423522,200
"23786","ENSG00000226348","16",77220406,77221258,852
"23787","ENSG00000226349","1",225710968,225736274,25306
"23788","ENSG00000226352","13",19674624,19675884,1260
"23789","ENSG00000226355","9",129438216,129447545,9329
"23790","ENSG00000226356","12",131292068,131293176,1108
"23791","ENSG00000226358","10",88727485,88728914,1429
"23792","ENSG00000226359","17",17242010,17242886,876
"23793","ENSG00000226360","3",61742455,61743106,651
"23794","ENSG00000226361","13",18680494,18681700,1206
"23795","ENSG00000226363","2",176177717,176179008,1291
"23796","ENSG00000226364","17",52862121,52899588,37467
"23797","ENSG00000226367","7",117072072,117146480,74408
"23798","ENSG00000226370","13",85065087,85078920,13833
"23799","ENSG00000226372","X",27977993,27981449,3456
"23800","ENSG00000226374","1",3944547,3949024,4477
"23801","ENSG00000226375","1",173174300,173175503,1203
"23802","ENSG00000226377","17",32876759,32881070,4311
"23803","ENSG00000226380","7",130876809,130913310,36501
"23804","ENSG00000226383","2",156011530,156254950,243420
"23805","ENSG00000226386","10",34815767,34816386,619
"23806","ENSG00000226387","10",104664608,104666200,1592
"23807","ENSG00000226389","10",49771841,49773299,1458
"23808","ENSG00000226390","20",63448051,63449329,1278
"23809","ENSG00000226393","9",21321300,21321827,527
"23810","ENSG00000226394","1",89661212,89661353,141
"23811","ENSG00000226396","1",19608114,19608568,454
"23812","ENSG00000226397","12",24993424,25006403,12979
"23813","ENSG00000226398","2",42015625,42025302,9677
"23814","ENSG00000226403","9",547135,549967,2832
"23815","ENSG00000226405","20",21488244,21488625,381
"23816","ENSG00000226406","21",14829154,14829989,835
"23817","ENSG00000226407","10",33864313,33864723,410
"23818","ENSG00000226409","6",125370034,125445193,75159
"23819","ENSG00000226410","2",186162949,186163245,296
"23820","ENSG00000226412","10",33578931,33600040,21109
"23821","ENSG00000226413","12",48442030,48442947,917
"23822","ENSG00000226414","X",126729104,126730226,1122
"23823","ENSG00000226415","1",76699789,76700538,749
"23824","ENSG00000226416","11",1983237,1989920,6683
"23825","ENSG00000226419","1",112956415,113047055,90640
"23826","ENSG00000226421","7",32471513,32472409,896
"23827","ENSG00000226423","2",242025183,242026176,993
"23828","ENSG00000226425","10",93059663,93060426,763
"23829","ENSG00000226426","10",64036345,64037280,935
"23830","ENSG00000226427","3",15375373,15375645,272
"23831","ENSG00000226428","10",114900722,114901366,644
"23832","ENSG00000226429","9",62395370,62395678,308
"23833","ENSG00000226430","8",12132417,12134438,2021
"23834","ENSG00000226431","10",103549075,103550964,1889
"23835","ENSG00000226432","5",24170370,24171246,876
"23836","ENSG00000226433","21",33152614,33159110,6496
"23837","ENSG00000226435","3",198053522,198080720,27198
"23838","ENSG00000226436","X",28659065,28659469,404
"23839","ENSG00000226438","1",39249838,39257649,7811
"23840","ENSG00000226439","4",61775449,61775850,401
"23841","ENSG00000226440","6",112236093,112307009,70916
"23842","ENSG00000226441","3",17042742,17044192,1450
"23843","ENSG00000226443","1",119533749,119534746,997
"23844","ENSG00000226445","6",169213254,169245773,32519
"23845","ENSG00000226446","1",119886304,119886927,623
"23846","ENSG00000226447","10",37976825,37992467,15642
"23847","ENSG00000226448","10",67334123,67334882,759
"23848","ENSG00000226450","22",42149886,42155001,5115
"23849","ENSG00000226453","6",81844602,82169391,324789
"23850","ENSG00000226454","6",40505507,40523963,18456
"23851","ENSG00000226455","6",89950116,89953186,3070
"23852","ENSG00000226457","1",16369150,16369530,380
"23853","ENSG00000226465","20",25697003,25752776,55773
"23854","ENSG00000226468","7",32456963,32457758,795
"23855","ENSG00000226469","12",111927018,111929017,1999
"23856","ENSG00000226470","9",17096301,17096446,145
"23857","ENSG00000226471","22",28800683,28848559,47876
"23858","ENSG00000226472","12",30978308,31006010,27702
"23859","ENSG00000226473","2",47939738,47940218,480
"23860","ENSG00000226476","1",60515716,60640507,124791
"23861","ENSG00000226478","17",16745636,16746761,1125
"23862","ENSG00000226479","2",120217479,120223400,5921
"23863","ENSG00000226480","19",9278448,9279369,921
"23864","ENSG00000226482","3",186851886,186856123,4237
"23865","ENSG00000226484","X",36365626,36440292,74666
"23866","ENSG00000226485","7",56490682,56491635,953
"23867","ENSG00000226486","1",188905688,189037564,131876
"23868","ENSG00000226487","1",20412304,20413253,949
"23869","ENSG00000226488","2",6495651,6511839,16188
"23870","ENSG00000226490","8",141514638,141518737,4099
"23871","ENSG00000226491","2",42797225,42798712,1487
"23872","ENSG00000226493","10",68499532,68499968,436
"23873","ENSG00000226496","21",41141493,41148198,6705
"23874","ENSG00000226497","6",68226972,68329899,102927
"23875","ENSG00000226498","1",236819634,236820518,884
"23876","ENSG00000226499","1",44843921,44844082,161
"23877","ENSG00000226501","21",33334571,33335096,525
"23878","ENSG00000226506","2",7886767,7899725,12958
"23879","ENSG00000226507","13",22837026,22837880,854
"23880","ENSG00000226508","2",105144113,105145424,1311
"23881","ENSG00000226509","7",153968665,153968826,161
"23882","ENSG00000226510","19",35667948,35673291,5343
"23883","ENSG00000226516","2",113577382,113578852,1470
"23884","ENSG00000226519","13",44094822,44147762,52940
"23885","ENSG00000226520","1",158025550,158031166,5616
"23886","ENSG00000226521","17",20716481,20737127,20646
"23887","ENSG00000226522","7",18892096,18899433,7337
"23888","ENSG00000226523","2",42680088,42680279,191
"23889","ENSG00000226525","13",21628413,21629015,602
"23890","ENSG00000226526","1",16978926,17005091,26165
"23891","ENSG00000226527","21",33110867,33123725,12858
"23892","ENSG00000226530","X",51395959,51465661,69702
"23893","ENSG00000226533","6",38481692,38482531,839
"23894","ENSG00000226535","9",107169569,107171148,1579
"23895","ENSG00000226536","X",15917548,15918631,1083
"23896","ENSG00000226537","13",67910986,67911951,965
"23897","ENSG00000226539","2",223704621,223705338,717
"23898","ENSG00000226540","6",135619165,135620171,1006
"23899","ENSG00000226541","6",46438310,46438619,309
"23900","ENSG00000226542","2",235084822,235088586,3764
"23901","ENSG00000226543","21",43855890,43856342,452
"23902","ENSG00000226544","5",72725419,72726151,732
"23903","ENSG00000226545","1",8798475,8799506,1031
"23904","ENSG00000226548","2",46852020,46853496,1476
"23905","ENSG00000226549","17",20784645,20785725,1080
"23906","ENSG00000226552","1",171083565,171085205,1640
"23907","ENSG00000226553","2",187001876,187003377,1501
"23908","ENSG00000226554","13",70923664,70924455,791
"23909","ENSG00000226555","Y",14639096,14640358,1262
"23910","ENSG00000226556","X",47438736,47439774,1038
"23911","ENSG00000226557","10",59136625,59138182,1557
"23912","ENSG00000226558","6",43364220,43364294,74
"23913","ENSG00000226562","9",33580695,33607874,27179
"23914","ENSG00000226564","2",180872867,180873414,547
"23915","ENSG00000226565","1",207150205,207150281,76
"23916","ENSG00000226567","3",10759350,10764209,4859
"23917","ENSG00000226570","1",182955390,182956148,758
"23918","ENSG00000226571","6",139271362,139667284,395922
"23919","ENSG00000226573","22",30105094,30105408,314
"23920","ENSG00000226576","10",48984564,49018897,34333
"23921","ENSG00000226578","10",37775371,37784131,8760
"23922","ENSG00000226580","21",17500679,17500824,145
"23923","ENSG00000226581","7",63900313,63925202,24889
"23924","ENSG00000226582","10",114117147,114117551,404
"23925","ENSG00000226592","7",145269514,145270384,870
"23926","ENSG00000226594","6",47729827,47740741,10914
"23927","ENSG00000226599","6",150650772,150652025,1253
"23928","ENSG00000226601","1",223181144,223188154,7010
"23929","ENSG00000226604","9",116285829,116288769,2940
"23930","ENSG00000226605","2",62826064,62858438,32374
"23931","ENSG00000226608","20",4023917,4024444,527
"23932","ENSG00000226609","9",112748902,112750565,1663
"23933","ENSG00000226620","13",105702699,105797539,94840
"23934","ENSG00000226621","3",11290406,11290663,257
"23935","ENSG00000226622","2",62533681,62662829,129148
"23936","ENSG00000226624","7",105819492,105820101,609
"23937","ENSG00000226625","9",39154075,39155479,1404
"23938","ENSG00000226626","9",23681894,23682662,768
"23939","ENSG00000226627","11",70626441,70635658,9217
"23940","ENSG00000226629","17",41549606,41554495,4889
"23941","ENSG00000226631","10",50025135,50027363,2228
"23942","ENSG00000226632","20",3361880,3362324,444
"23943","ENSG00000226633","13",20178978,20179462,484
"23944","ENSG00000226636","7",122159300,122162243,2943
"23945","ENSG00000226640","1",193678894,193727035,48141
"23946","ENSG00000226641","X",41322601,41323111,510
"23947","ENSG00000226642","3",12070195,12071360,1165
"23948","ENSG00000226643","1",222452738,222454705,1967
"23949","ENSG00000226644","20",2207217,2213151,5934
"23950","ENSG00000226645","11",116773389,116774205,816
"23951","ENSG00000226646","10",35697300,35698037,737
"23952","ENSG00000226647","10",5712174,5744067,31893
"23953","ENSG00000226648","20",41098019,41138003,39984
"23954","ENSG00000226649","2",3156756,3157797,1041
"23955","ENSG00000226650","5",155013755,155018132,4377
"23956","ENSG00000226652","3",186760693,186762050,1357
"23957","ENSG00000226655","4",123744923,123745673,750
"23958","ENSG00000226658","2",201066691,201067191,500
"23959","ENSG00000226659","10",80529597,80535942,6345
"23960","ENSG00000226660","7",142300924,142301432,508
"23961","ENSG00000226661","X",119356301,119393595,37294
"23962","ENSG00000226662","1",27686810,27687471,661
"23963","ENSG00000226663","1",235540053,235541415,1362
"23964","ENSG00000226664","1",20294211,20323187,28976
"23965","ENSG00000226666","2",221961737,221963765,2028
"23966","ENSG00000226668","9",92882567,92899608,17041
"23967","ENSG00000226669","9",3684076,3689626,5550
"23968","ENSG00000226673","6",14280127,14285454,5327
"23969","ENSG00000226674","2",144666312,145262988,596676
"23970","ENSG00000226676","10",79628757,79632188,3431
"23971","ENSG00000226677","14",34939324,34940332,1008
"23972","ENSG00000226679","X",38221391,38223667,2276
"23973","ENSG00000226681","2",181422154,181425749,3595
"23974","ENSG00000226683","13",80654755,80657027,2272
"23975","ENSG00000226686","19",37251885,37265535,13650
"23976","ENSG00000226688","10",95732976,96090250,357274
"23977","ENSG00000226690","7",12469621,12542222,72601
"23978","ENSG00000226693","1",218881600,218882650,1050
"23979","ENSG00000226694","10",2071845,2081097,9252
"23980","ENSG00000226695","13",24750657,24752171,1514
"23981","ENSG00000226696","19",54444807,54449045,4238
"23982","ENSG00000226699","10",133345754,133350726,4972
"23983","ENSG00000226701","10",72189941,72190576,635
"23984","ENSG00000226705","10",6293100,6294684,1584
"23985","ENSG00000226706","9",135503273,135506447,3174
"23986","ENSG00000226707","6",49823712,49824782,1070
"23987","ENSG00000226709","3",192516831,192521398,4567
"23988","ENSG00000226711","12",8180209,8216151,35942
"23989","ENSG00000226715","1",101639509,101787572,148063
"23990","ENSG00000226717","9",10613202,10620420,7218
"23991","ENSG00000226722","13",21872763,21878256,5493
"23992","ENSG00000226723","1",192246708,192247487,779
"23993","ENSG00000226724","3",186698520,186708574,10054
"23994","ENSG00000226726","2",221532668,221533008,340
"23995","ENSG00000226733","6",50093389,50181007,87618
"23996","ENSG00000226734","10",110139214,110139426,212
"23997","ENSG00000226739","6",164346489,164348644,2155
"23998","ENSG00000226741","22",27307777,27318501,10724
"23999","ENSG00000226742","18",79964582,79970822,6240
"24000","ENSG00000226744","7",97870167,97870289,122
"24001","ENSG00000226745","1",40132764,40133448,684
"24002","ENSG00000226746","17",17776686,17779529,2843
"24003","ENSG00000226747","2",185719874,185740479,20605
"24004","ENSG00000226751","21",14761710,14763090,1380
"24005","ENSG00000226752","9",120824828,120854385,29557
"24006","ENSG00000226754","1",53238550,53246482,7932
"24007","ENSG00000226755","1",117549415,117549922,507
"24008","ENSG00000226756","2",64644612,64646698,2086
"24009","ENSG00000226757","4",121764585,121766814,2229
"24010","ENSG00000226758","1",231925834,231945233,19399
"24011","ENSG00000226759","1",57860532,57880905,20373
"24012","ENSG00000226761","12",11061365,11062294,929
"24013","ENSG00000226762","10",3200829,3277649,76820
"24014","ENSG00000226763","19",43596617,43614497,17880
"24015","ENSG00000226764","2",15997049,16062885,65836
"24016","ENSG00000226766","1",243624666,243625056,390
"24017","ENSG00000226769","20",46997596,46998488,892
"24018","ENSG00000226770","7",127476883,127485804,8921
"24019","ENSG00000226771","21",21223295,21226829,3534
"24020","ENSG00000226773","1",92203148,92203991,843
"24021","ENSG00000226774","X",23351013,23351450,437
"24022","ENSG00000226777","14",105917979,105932642,14663
"24023","ENSG00000226779","3",175234861,175271096,36235
"24024","ENSG00000226780","1",206117783,206126805,9022
"24025","ENSG00000226781","X",33041395,33041721,326
"24026","ENSG00000226782","3",177337628,177349166,11538
"24027","ENSG00000226783","9",122685933,122688372,2439
"24028","ENSG00000226784","X",77968874,77969638,764
"24029","ENSG00000226789","2",127247258,127250082,2824
"24030","ENSG00000226790","10",43789249,43790387,1138
"24031","ENSG00000226791","2",98761098,98775361,14263
"24032","ENSG00000226792","13",51082119,51200252,118133
"24033","ENSG00000226794","10",69595487,69596436,949
"24034","ENSG00000226797","17",63381231,63414430,33199
"24035","ENSG00000226798","9",80869758,80871295,1537
"24036","ENSG00000226800","19",3607247,3613930,6683
"24037","ENSG00000226801","9",33968071,33968518,447
"24038","ENSG00000226803","6",57114894,57174236,59342
"24039","ENSG00000226804","1",44150594,44151753,1159
"24040","ENSG00000226806","2",135820191,135823087,2896
"24041","ENSG00000226807","8",141433829,141507230,73401
"24042","ENSG00000226808","10",43778946,43901004,122058
"24043","ENSG00000226812","20",44347552,44355185,7633
"24044","ENSG00000226813","2",126109761,126118023,8262
"24045","ENSG00000226816","7",23205787,23208045,2258
"24046","ENSG00000226818","21",19244543,19246392,1849
"24047","ENSG00000226819","2",66426735,66433470,6735
"24048","ENSG00000226822","1",108040263,108076020,35757
"24049","ENSG00000226823","9",33503655,33510711,7056
"24050","ENSG00000226824","7",66654538,66671523,16985
"24051","ENSG00000226825","9",107420191,107466613,46422
"24052","ENSG00000226827","7",11257681,11258535,854
"24053","ENSG00000226828","1",243917402,244047317,129915
"24054","ENSG00000226829","7",68149548,68319676,170128
"24055","ENSG00000226833","2",28707511,28751722,44211
"24056","ENSG00000226835","1",94247819,94411036,163217
"24057","ENSG00000226838","7",45816557,45821064,4507
"24058","ENSG00000226840","6",73327524,73329017,1493
"24059","ENSG00000226842","10",32281686,32282829,1143
"24060","ENSG00000226845","3",40596207,40597494,1287
"24061","ENSG00000226846","13",71015042,71168417,153375
"24062","ENSG00000226849","1",11068471,11073097,4626
"24063","ENSG00000226851","7",112328189,112409623,81434
"24064","ENSG00000226853","2",174487380,174488386,1006
"24065","ENSG00000226854","X",75903105,75904858,1753
"24066","ENSG00000226855","1",154378207,154379089,882
"24067","ENSG00000226856","2",118132128,118222250,90122
"24068","ENSG00000226857","7",147146342,147146756,414
"24069","ENSG00000226859","3",186476727,186478370,1643
"24070","ENSG00000226860","2",82609652,82609977,325
"24071","ENSG00000226862","1",202604268,202605293,1025
"24072","ENSG00000226863","Y",12537773,12544883,7110
"24073","ENSG00000226864","10",121928312,121951965,23653
"24074","ENSG00000226868","1",211715928,211725402,9474
"24075","ENSG00000226869","7",104738597,104804107,65510
"24076","ENSG00000226870","X",71719142,71721278,2136
"24077","ENSG00000226871","17",8318088,8318712,624
"24078","ENSG00000226872","22",21031354,21044117,12763
"24079","ENSG00000226874","7",30544053,30544431,378
"24080","ENSG00000226876","1",246108626,246113866,5240
"24081","ENSG00000226877","9",83817643,83837861,20218
"24082","ENSG00000226878","2",159056005,159056859,854
"24083","ENSG00000226881","X",50905438,50905866,428
"24084","ENSG00000226883","1",59754747,59789182,34435
"24085","ENSG00000226886","2",132037787,132037993,206
"24086","ENSG00000226887","4",52722618,52751586,28968
"24087","ENSG00000226889","1",161765325,161766227,902
"24088","ENSG00000226890","16",1625628,1626160,532
"24089","ENSG00000226891","1",64972225,65002489,30264
"24090","ENSG00000226899","10",124945204,124946432,1228
"24091","ENSG00000226900","10",132508394,132518367,9973
"24092","ENSG00000226902","X",123785009,123785451,442
"24093","ENSG00000226903","13",111865136,111901264,36128
"24094","ENSG00000226904","9",68228651,68229312,661
"24095","ENSG00000226908","13",21483834,21484174,340
"24096","ENSG00000226912","22",26644889,26645336,447
"24097","ENSG00000226913","3",49549306,49554366,5060
"24098","ENSG00000226915","2",130293822,130294405,583
"24099","ENSG00000226917","6",41499033,41519852,20819
"24100","ENSG00000226918","Y",21311268,21318895,7627
"24101","ENSG00000226919","1",240763334,240776824,13490
"24102","ENSG00000226921","13",113878489,113883651,5162
"24103","ENSG00000226925","2",102172621,102182108,9487
"24104","ENSG00000226926","5",103430406,103526618,96212
"24105","ENSG00000226927","1",220359731,220360183,452
"24106","ENSG00000226928","2",111295629,111296046,417
"24107","ENSG00000226933","3",46023296,46024156,860
"24108","ENSG00000226935","21",28539318,28540355,1037
"24109","ENSG00000226937","10",45002222,45076066,73844
"24110","ENSG00000226938","1",53348488,53349233,745
"24111","ENSG00000226939","2",139366165,139379147,12982
"24112","ENSG00000226942","16",29336,38321,8985
"24113","ENSG00000226943","7",6923804,6930835,7031
"24114","ENSG00000226944","1",6204840,6205780,940
"24115","ENSG00000226945","1",206907619,206908229,610
"24116","ENSG00000226947","1",152644393,152644717,324
"24117","ENSG00000226948","20",4627758,4685148,57390
"24118","ENSG00000226949","1",158742146,158743415,1269
"24119","ENSG00000226950","4",52712404,52720351,7947
"24120","ENSG00000226952","1",100099239,100099490,251
"24121","ENSG00000226953","2",133264968,133285445,20477
"24122","ENSG00000226954","22",49718053,49724506,6453
"24123","ENSG00000226956","21",17659276,17660384,1108
"24124","ENSG00000226957","1",46046818,46048368,1550
"24125","ENSG00000226960","1",93927714,93928302,588
"24126","ENSG00000226961","2",11351627,11352118,491
"24127","ENSG00000226963","2",172427774,172428603,829
"24128","ENSG00000226964","10",47706203,47706802,599
"24129","ENSG00000226965","7",110108031,110534757,426726
"24130","ENSG00000226968","13",32877431,32911650,34219
"24131","ENSG00000226969","1",2049203,2050070,867
"24132","ENSG00000226970","1",84244334,84244577,243
"24133","ENSG00000226971","X",48446893,48448879,1986
"24134","ENSG00000226972","2",44270621,44271106,485
"24135","ENSG00000226976","6",37044860,37045189,329
"24136","ENSG00000226977","13",95809310,95809607,297
"24137","ENSG00000226978","7",79008988,79012277,3289
"24138","ENSG00000226979","6",31572054,31574324,2270
"24139","ENSG00000226981","17",20814620,20844257,29637
"24140","ENSG00000226982","12",89500093,89502670,2577
"24141","ENSG00000226983","21",24840550,25057746,217196
"24142","ENSG00000226984","1",114459934,114460360,426
"24143","ENSG00000226985","X",13333952,13403035,69083
"24144","ENSG00000226986","1",211207239,211207897,658
"24145","ENSG00000226987","9",131240687,131241724,1037
"24146","ENSG00000226989","22",42853403,42853799,396
"24147","ENSG00000226990","10",8400860,8461863,61003
"24148","ENSG00000226991","2",110358790,110359126,336
"24149","ENSG00000226994","2",34799850,35284997,485147
"24150","ENSG00000226995","20",5426892,5471094,44202
"24151","ENSG00000226996","21",24043257,24050286,7029
"24152","ENSG00000226999","7",45534523,45534681,158
"24153","ENSG00000227001","1",21424625,21427967,3342
"24154","ENSG00000227004","2",199872172,199872378,206
"24155","ENSG00000227006","1",230258694,230272100,13406
"24156","ENSG00000227007","2",6366010,6375422,9412
"24157","ENSG00000227008","X",133670971,133671386,415
"24158","ENSG00000227009","22",39155525,39155945,420
"24159","ENSG00000227011","17",52985513,52987652,2139
"24160","ENSG00000227012","6",111900305,111909420,9115
"24161","ENSG00000227013","8",8039978,8040953,975
"24162","ENSG00000227014","7",29988600,30027543,38943
"24163","ENSG00000227016","1",72765031,72791282,26251
"24164","ENSG00000227017","7",30176387,30179014,2627
"24165","ENSG00000227018","17",15783288,15784307,1019
"24166","ENSG00000227019","13",46460609,46461121,512
"24167","ENSG00000227021","2",216868012,216869156,1144
"24168","ENSG00000227028","2",39786453,40255209,468756
"24169","ENSG00000227029","10",43912444,43914236,1792
"24170","ENSG00000227032","10",96620877,96621707,830
"24171","ENSG00000227033","2",231978488,232015720,37232
"24172","ENSG00000227034","1",99008218,99008474,256
"24173","ENSG00000227035","7",64106822,64107572,750
"24174","ENSG00000227036","17",72290091,72640472,350381
"24175","ENSG00000227038","7",76090431,76108779,18348
"24176","ENSG00000227039","21",44921051,44929678,8627
"24177","ENSG00000227040","4",56760919,56761485,566
"24178","ENSG00000227042","X",10242339,10365323,122984
"24179","ENSG00000227043","1",229812917,229892046,79129
"24180","ENSG00000227045","1",151701026,151708386,7360
"24181","ENSG00000227047","2",20499571,20501311,1740
"24182","ENSG00000227050","1",27938875,27960193,21318
"24183","ENSG00000227051","14",96039324,96093889,54565
"24184","ENSG00000227053","7",101014320,101017608,3288
"24185","ENSG00000227054","21",25692180,25692554,374
"24186","ENSG00000227055","2",159812234,159814009,1775
"24187","ENSG00000227056","1",119219314,119220096,782
"24188","ENSG00000227057","6",33279108,33289247,10139
"24189","ENSG00000227058","X",52545151,52547695,2544
"24190","ENSG00000227059","12",133218312,133236095,17783
"24191","ENSG00000227060","X",134549770,134560399,10629
"24192","ENSG00000227061","2",197569,209892,12323
"24193","ENSG00000227064","X",132907279,132907575,296
"24194","ENSG00000227066","1",20154171,20160568,6397
"24195","ENSG00000227068","9",125567579,125573023,5444
"24196","ENSG00000227069","9",40346144,40347052,908
"24197","ENSG00000227070","1",51518309,51561629,43320
"24198","ENSG00000227071","9",20683304,20684688,1384
"24199","ENSG00000227072","6",108387512,108388080,568
"24200","ENSG00000227073","7",135444461,135444925,464
"24201","ENSG00000227075","21",21933315,21975681,42366
"24202","ENSG00000227076","10",127934698,127936167,1469
"24203","ENSG00000227077","17",18572752,18572961,209
"24204","ENSG00000227078","17",19419035,19424357,5322
"24205","ENSG00000227080","7",51388430,51389114,684
"24206","ENSG00000227081","12",3211663,3211917,254
"24207","ENSG00000227082","1",121396754,121463508,66754
"24208","ENSG00000227083","X",147900178,147901459,1281
"24209","ENSG00000227087","5",80331573,80332541,968
"24210","ENSG00000227088","2",77652025,78290469,638444
"24211","ENSG00000227089","6",21354411,21355296,885
"24212","ENSG00000227091","1",110165948,110172489,6541
"24213","ENSG00000227094","1",162316852,162317794,942
"24214","ENSG00000227096","10",116439468,116440044,576
"24215","ENSG00000227097","11",82689559,82689768,209
"24216","ENSG00000227098","2",176830839,176849428,18589
"24217","ENSG00000227101","10",4024903,4053018,28115
"24218","ENSG00000227104","1",55938714,55939280,566
"24219","ENSG00000227105","13",110936759,110939784,3025
"24220","ENSG00000227107","2",237612977,237626525,13548
"24221","ENSG00000227108","14",105900638,105900654,16
"24222","ENSG00000227109","1",202096759,202096978,219
"24223","ENSG00000227110","3",7951263,8611924,660661
"24224","ENSG00000227113","7",65075023,65078780,3757
"24225","ENSG00000227115","18",51346249,51643939,297690
"24226","ENSG00000227117","22",30008742,30080480,71738
"24227","ENSG00000227118","4",98740742,98741231,489
"24228","ENSG00000227120","2",95436133,95436556,423
"24229","ENSG00000227121","10",52972612,53030024,57412
"24230","ENSG00000227123","3",44937673,44938482,809
"24231","ENSG00000227124","3",75678660,75785583,106923
"24232","ENSG00000227128","10",101229577,101270148,40571
"24233","ENSG00000227131","6",40271566,40276237,4671
"24234","ENSG00000227133","2",26160023,26161136,1113
"24235","ENSG00000227139","1",147697794,147699335,1541
"24236","ENSG00000227141","1",179586705,179589175,2470
"24237","ENSG00000227143","10",121178700,121185966,7266
"24238","ENSG00000227145","4",122618983,122689156,70173
"24239","ENSG00000227148","7",63044827,63054431,9604
"24240","ENSG00000227154","6",35443044,35449847,6803
"24241","ENSG00000227155","9",452492,492248,39756
"24242","ENSG00000227157","2",104406471,104416720,10249
"24243","ENSG00000227158","17",17422681,17423704,1023
"24244","ENSG00000227159","X",156025664,156027877,2213
"24245","ENSG00000227160","11",32112049,32343409,231360
"24246","ENSG00000227161","15",59644298,59672302,28004
"24247","ENSG00000227163","1",44087958,44088477,519
"24248","ENSG00000227165","10",120759898,120851457,91559
"24249","ENSG00000227166","Y",15547216,15593331,46115
"24250","ENSG00000227169","1",4551735,4552145,410
"24251","ENSG00000227170","8",115509602,115511325,1723
"24252","ENSG00000227172","7",39545646,39566239,20593
"24253","ENSG00000227173","10",65169438,65169869,431
"24254","ENSG00000227175","10",13528516,13530262,1746
"24255","ENSG00000227176","2",170077224,170078294,1070
"24256","ENSG00000227179","1",111382860,111391819,8959
"24257","ENSG00000227180","2",174299324,174300956,1632
"24258","ENSG00000227181","1",182712862,182714544,1682
"24259","ENSG00000227182","7",57422830,57423725,895
"24260","ENSG00000227183","X",131646639,131646890,251
"24261","ENSG00000227186","10",75023475,75024251,776
"24262","ENSG00000227187","2",175033778,175034192,414
"24263","ENSG00000227188","22",39475807,39476822,1015
"24264","ENSG00000227189","4",1151372,1153701,2329
"24265","ENSG00000227191","7",38239580,38249572,9992
"24266","ENSG00000227192","6",143039425,143042324,2899
"24267","ENSG00000227193","1",121118126,121146826,28700
"24268","ENSG00000227195","20",26167817,26251546,83729
"24269","ENSG00000227196","14",105884870,105884888,18
"24270","ENSG00000227197","7",132830693,132849593,18900
"24271","ENSG00000227199","7",116952446,116954334,1888
"24272","ENSG00000227200","9",124262876,124265809,2933
"24273","ENSG00000227201","22",30046276,30047193,917
"24274","ENSG00000227203","8",11790005,11790386,381
"24275","ENSG00000227204","Y",8127130,8144203,17073
"24276","ENSG00000227205","1",119853316,119853748,432
"24277","ENSG00000227206","6",29124210,29128908,4698
"24278","ENSG00000227207","1",72301472,72301829,357
"24279","ENSG00000227210","2",19990209,20004795,14586
"24280","ENSG00000227211","X",102615473,102615820,347
"24281","ENSG00000227212","1",144442606,144443004,398
"24282","ENSG00000227213","13",24252749,24254439,1690
"24283","ENSG00000227214","6",28986203,28987484,1281
"24284","ENSG00000227215","6",82932601,82938677,6076
"24285","ENSG00000227217","1",157691762,157696459,4697
"24286","ENSG00000227218","9",127934503,127940952,6449
"24287","ENSG00000227220","6",131950946,132077393,126447
"24288","ENSG00000227225","17",19602259,19603208,949
"24289","ENSG00000227227","2",186641339,186695287,53948
"24290","ENSG00000227230","1",243135898,243140588,4690
"24291","ENSG00000227232","1",14404,29570,15166
"24292","ENSG00000227233","7",51382284,51384660,2376
"24293","ENSG00000227234","X",141002594,141003706,1112
"24294","ENSG00000227236","1",235614674,235616397,1723
"24295","ENSG00000227237","1",248859164,248864796,5632
"24296","ENSG00000227238","2",38763534,38765221,1687
"24297","ENSG00000227240","1",193473224,194198708,725484
"24298","ENSG00000227242","1",147019656,147056593,36937
"24299","ENSG00000227243","1",162445549,162446566,1017
"24300","ENSG00000227244","10",61016275,61026420,10145
"24301","ENSG00000227245","3",43087479,43088068,589
"24302","ENSG00000227248","13",107788342,107835451,47109
"24303","ENSG00000227249","7",126511135,126512879,1744
"24304","ENSG00000227252","2",236910797,237085838,175041
"24305","ENSG00000227253","10",32266289,32269474,3185
"24306","ENSG00000227255","17",15764703,15765664,961
"24307","ENSG00000227256","21",32277863,32280988,3125
"24308","ENSG00000227257","9",96918928,96919318,390
"24309","ENSG00000227258","13",44110451,44240517,130066
"24310","ENSG00000227259","2",100591150,100591324,174
"24311","ENSG00000227260","3",30518833,30527193,8360
"24312","ENSG00000227262","6",29925983,29926973,990
"24313","ENSG00000227265","2",94734655,94735844,1189
"24314","ENSG00000227267","3",136055184,136055764,580
"24315","ENSG00000227268","10",87859158,87863437,4279
"24316","ENSG00000227269","9",99183373,99184891,1518
"24317","ENSG00000227274","17",12671862,12706135,34273
"24318","ENSG00000227278","1",40514461,40515057,596
"24319","ENSG00000227279","18",27954519,27963687,9168
"24320","ENSG00000227282","20",59515191,59516039,848
"24321","ENSG00000227288","1",81501794,81503468,1674
"24322","ENSG00000227289","Y",2881683,2890551,8868
"24323","ENSG00000227290","1",87353521,87371683,18162
"24324","ENSG00000227292","2",38203363,38239590,36227
"24325","ENSG00000227293","2",66235377,66236213,836
"24326","ENSG00000227295","1",158175850,158177755,1905
"24327","ENSG00000227300","17",16829999,16832830,2831
"24328","ENSG00000227301","9",33719690,33722555,2865
"24329","ENSG00000227302","X",48322349,48326683,4334
"24330","ENSG00000227303","X",143284977,143516803,231826
"24331","ENSG00000227304","4",82494786,82496278,1492
"24332","ENSG00000227305","7",63393745,63422053,28308
"24333","ENSG00000227306","11",1688297,1689056,759
"24334","ENSG00000227307","10",120925547,120980700,55153
"24335","ENSG00000227308","2",219685381,219737937,52556
"24336","ENSG00000227309","3",17465150,17465510,360
"24337","ENSG00000227311","1",40333078,40333557,479
"24338","ENSG00000227312","1",24563627,24563974,347
"24339","ENSG00000227313","10",35896874,35898963,2089
"24340","ENSG00000227321","9",92110865,92111897,1032
"24341","ENSG00000227329","X",53164391,53164557,166
"24342","ENSG00000227330","21",18022370,18114904,92534
"24343","ENSG00000227331","2",158548425,158549224,799
"24344","ENSG00000227337","3",32785646,32786116,470
"24345","ENSG00000227338","10",3263346,3267216,3870
"24346","ENSG00000227339","3",31452832,31455894,3062
"24347","ENSG00000227342","21",30209151,30211783,2632
"24348","ENSG00000227343","20",18090116,18090715,599
"24349","ENSG00000227344","7",53187388,53188938,1550
"24350","ENSG00000227345","10",49818279,49970203,151924
"24351","ENSG00000227347","2",136199114,136200503,1389
"24352","ENSG00000227348","2",201212283,201213081,798
"24353","ENSG00000227349","19",42949503,42950387,884
"24354","ENSG00000227350","9",107543151,107543616,465
"24355","ENSG00000227351","10",99788564,99789410,846
"24356","ENSG00000227352","13",111144305,111144733,428
"24357","ENSG00000227354","13",79406293,79427317,21024
"24358","ENSG00000227355","9",121369893,121463370,93477
"24359","ENSG00000227356","10",97828478,97849798,21320
"24360","ENSG00000227359","2",113677702,113704078,26376
"24361","ENSG00000227360","6",156493226,156505011,11785
"24362","ENSG00000227361","2",61803143,61803388,245
"24363","ENSG00000227364","2",2729908,2730957,1049
"24364","ENSG00000227365","7",155510283,155518623,8340
"24365","ENSG00000227367","22",16428947,16476870,47923
"24366","ENSG00000227370","22",42132543,42132998,455
"24367","ENSG00000227372","1",3735511,3747373,11862
"24368","ENSG00000227373","1",174110268,174160165,49897
"24369","ENSG00000227374","10",129768844,129769435,591
"24370","ENSG00000227375","3",197298252,197303755,5503
"24371","ENSG00000227376","11",77734475,77735026,551
"24372","ENSG00000227379","20",25368275,25368766,491
"24373","ENSG00000227382","10",73199826,73201225,1399
"24374","ENSG00000227383","9",34191555,34191881,326
"24375","ENSG00000227388","9",35772163,35790432,18269
"24376","ENSG00000227391","X",49664844,49668680,3836
"24377","ENSG00000227392","19",35042902,35106307,63405
"24378","ENSG00000227393","X",29369001,29369845,844
"24379","ENSG00000227394","2",64960053,64960634,581
"24380","ENSG00000227395","10",44806443,44808223,1780
"24381","ENSG00000227397","7",63789909,63790098,189
"24382","ENSG00000227398","3",47164186,47246601,82415
"24383","ENSG00000227399","9",92006062,92006544,482
"24384","ENSG00000227400","2",153421616,153593288,171672
"24385","ENSG00000227401","20",35588324,35588607,283
"24386","ENSG00000227403","2",161244730,161249050,4320
"24387","ENSG00000227404","7",38655205,38656613,1408
"24388","ENSG00000227406","21",39373763,39377066,3303
"24389","ENSG00000227407","19",54430654,54434698,4044
"24390","ENSG00000227409","1",35358822,35366077,7255
"24391","ENSG00000227411","9",101334084,101339347,5263
"24392","ENSG00000227413","22",40433136,40433641,505
"24393","ENSG00000227416","1",37782457,37782885,428
"24394","ENSG00000227417","1",203805621,203806263,642
"24395","ENSG00000227418","2",192749845,192776899,27054
"24396","ENSG00000227421","1",196044883,196065235,20352
"24397","ENSG00000227423","12",55193882,55194786,904
"24398","ENSG00000227425","1",157861197,157861460,263
"24399","ENSG00000227427","X",57766320,57767292,972
"24400","ENSG00000227431","20",49040463,49046168,5705
"24401","ENSG00000227432","2",219482073,219516877,34804
"24402","ENSG00000227433","3",195349664,195350030,366
"24403","ENSG00000227436","7",23619333,23622826,3493
"24404","ENSG00000227437","10",119638456,119639082,626
"24405","ENSG00000227438","21",46093264,46097530,4266
"24406","ENSG00000227440","3",172828736,172829176,440
"24407","ENSG00000227443","9",21638285,21638676,391
"24408","ENSG00000227449","9",62376161,62435199,59038
"24409","ENSG00000227453","1",54536796,54537758,962
"24410","ENSG00000227454","2",202617983,202618881,898
"24411","ENSG00000227455","6",164827732,164832114,4382
"24412","ENSG00000227456","21",34157724,34190244,32520
"24413","ENSG00000227462","10",22225698,22226024,326
"24414","ENSG00000227463","9",84059298,84098984,39686
"24415","ENSG00000227465","10",25647570,25648104,534
"24416","ENSG00000227466","1",66042500,66050718,8218
"24417","ENSG00000227467","11",72570660,72573229,2569
"24418","ENSG00000227470","2",108878308,108878460,152
"24419","ENSG00000227471","7",134549110,134579875,30765
"24420","ENSG00000227473","8",144141214,144143664,2450
"24421","ENSG00000227474","10",13591460,13592323,863
"24422","ENSG00000227475","10",36089086,36089389,303
"24423","ENSG00000227477","20",44963794,44966402,2608
"24424","ENSG00000227479","2",240227560,240256035,28475
"24425","ENSG00000227480","2",158166650,158236169,69519
"24426","ENSG00000227481","7",33730292,33732064,1772
"24427","ENSG00000227482","9",113650956,113682855,31899
"24428","ENSG00000227484","22",50314631,50316008,1377
"24429","ENSG00000227486","X",55908123,56209271,301148
"24430","ENSG00000227487","11",113265137,113274032,8895
"24431","ENSG00000227489","7",15066207,15068651,2444
"24432","ENSG00000227491","7",56228634,56229782,1148
"24433","ENSG00000227492","10",100229629,100234398,4769
"24434","ENSG00000227493","X",51030422,51031357,935
"24435","ENSG00000227494","Y",18481087,18487400,6313
"24436","ENSG00000227495","17",5019214,5020093,879
"24437","ENSG00000227496","1",225700264,225752258,51994
"24438","ENSG00000227498","3",34524818,34543880,19062
"24439","ENSG00000227499","7",55877912,55878164,252
"24440","ENSG00000227500","19",1905372,1926013,20641
"24441","ENSG00000227502","6",113868013,113873351,5338
"24442","ENSG00000227507","6",31580525,31582522,1997
"24443","ENSG00000227508","6",170272474,170279887,7413
"24444","ENSG00000227510","13",60916981,60945955,28974
"24445","ENSG00000227511","X",26170052,26170913,861
"24446","ENSG00000227512","9",136542881,136543835,954
"24447","ENSG00000227513","2",106344566,106345433,867
"24448","ENSG00000227514","8",113376669,113377227,558
"24449","ENSG00000227515","10",80040621,80041044,423
"24450","ENSG00000227516","6",41868622,41869731,1109
"24451","ENSG00000227517","17",69577251,69903000,325749
"24452","ENSG00000227518","9",27657,30891,3234
"24453","ENSG00000227519","22",31963357,31970400,7043
"24454","ENSG00000227521","X",94319038,94320025,987
"24455","ENSG00000227523","3",27462506,27462816,310
"24456","ENSG00000227525","12",19089151,19089888,737
"24457","ENSG00000227527","1",42335386,42338376,2990
"24458","ENSG00000227528","13",60012734,60044357,31623
"24459","ENSG00000227531","9",111139246,111284836,145590
"24460","ENSG00000227532","7",117187548,117187740,192
"24461","ENSG00000227533","1",42959049,42996814,37765
"24462","ENSG00000227534","X",65469087,65470380,1293
"24463","ENSG00000227535","6",104831129,104845820,14691
"24464","ENSG00000227536","X",71043214,71045470,2256
"24465","ENSG00000227537","10",23258211,23258545,334
"24466","ENSG00000227538","1",42040597,42041729,1132
"24467","ENSG00000227540","10",73252791,73254349,1558
"24468","ENSG00000227541","X",120202061,120202748,687
"24469","ENSG00000227542","2",191229165,191246172,17007
"24470","ENSG00000227543","17",28598790,28617377,18587
"24471","ENSG00000227544","7",35715032,35734924,19892
"24472","ENSG00000227549","3",30521664,30526254,4590
"24473","ENSG00000227550","7",142474096,142474567,471
"24474","ENSG00000227554","1",183754418,183754937,519
"24475","ENSG00000227555","9",90020654,90041499,20845
"24476","ENSG00000227556","1",78317157,78317263,106
"24477","ENSG00000227557","2",143098484,143098829,345
"24478","ENSG00000227560","10",112987476,112987865,389
"24479","ENSG00000227562","7",151950386,151954985,4599
"24480","ENSG00000227564","13",63183096,63328129,145033
"24481","ENSG00000227568","13",18807279,18808018,739
"24482","ENSG00000227573","7",122849746,122850352,606
"24483","ENSG00000227574","2",110449242,110451064,1822
"24484","ENSG00000227578","3",15141380,15142157,777
"24485","ENSG00000227579","1",177392667,177920152,527485
"24486","ENSG00000227581","X",90039213,90039834,621
"24487","ENSG00000227582","9",62860873,62864957,4084
"24488","ENSG00000227583","10",68674356,68675100,744
"24489","ENSG00000227584","7",57192695,57194068,1373
"24490","ENSG00000227585","1",221549786,221550643,857
"24491","ENSG00000227586","10",123171535,123171875,340
"24492","ENSG00000227588","3",2110409,2144241,33832
"24493","ENSG00000227589","1",3658938,3668772,9834
"24494","ENSG00000227590","13",106663437,106663847,410
"24495","ENSG00000227591","1",209661364,209724125,62761
"24496","ENSG00000227597","2",108276812,108277942,1130
"24497","ENSG00000227598","6",166969626,166999065,29439
"24498","ENSG00000227599","20",42968743,42971492,2749
"24499","ENSG00000227602","6",56331788,56332117,329
"24500","ENSG00000227606","19",43153279,43160862,7583
"24501","ENSG00000227609","6",29577459,29577748,289
"24502","ENSG00000227610","X",107512983,107545821,32838
"24503","ENSG00000227611","13",62321305,62322398,1093
"24504","ENSG00000227615","11",74745716,74746114,398
"24505","ENSG00000227616","5",132147491,132149559,2068
"24506","ENSG00000227617","2",168771951,168786961,15010
"24507","ENSG00000227619","9",129575117,129584556,9439
"24508","ENSG00000227620","11",67785273,67792335,7062
"24509","ENSG00000227621","1",223856579,223857387,808
"24510","ENSG00000227627","6",152983331,152991322,7991
"24511","ENSG00000227630","1",234724042,234736720,12678
"24512","ENSG00000227632","2",130202312,130212628,10316
"24513","ENSG00000227634","1",8201518,8215210,13692
"24514","ENSG00000227638","9",88410529,88411463,934
"24515","ENSG00000227640","13",94703454,94803430,99976
"24516","ENSG00000227646","7",89882353,90211635,329282
"24517","ENSG00000227653","2",128518788,128519177,389
"24518","ENSG00000227658","7",40775558,40785217,9659
"24519","ENSG00000227659","13",99690081,99690971,890
"24520","ENSG00000227660","6",148955628,148964684,9056
"24521","ENSG00000227666","9",94038030,94038345,315
"24522","ENSG00000227667","1",162979551,162979793,242
"24523","ENSG00000227671","1",247189851,247210856,21005
"24524","ENSG00000227673","1",155710098,155710563,465
"24525","ENSG00000227674","13",63851197,64076044,224847
"24526","ENSG00000227676","13",79566678,79571445,4767
"24527","ENSG00000227678","6",130133410,130146179,12769
"24528","ENSG00000227680","2",102987323,102988565,1242
"24529","ENSG00000227681","6",147660703,147953937,293234
"24530","ENSG00000227682","2",155269633,155270134,501
"24531","ENSG00000227683","10",45164228,45181427,17199
"24532","ENSG00000227684","1",16740280,16750968,10688
"24533","ENSG00000227685","17",20612912,20633234,20322
"24534","ENSG00000227687","1",205935128,205935768,640
"24535","ENSG00000227688","20",36620403,36621423,1020
"24536","ENSG00000227689","17",18527557,18528461,904
"24537","ENSG00000227692","2",186364598,186365128,530
"24538","ENSG00000227694","17",61069871,61070341,470
"24539","ENSG00000227695","10",99927010,99959050,32040
"24540","ENSG00000227698","21",41874756,41877613,2857
"24541","ENSG00000227700","1",148246169,148246685,516
"24542","ENSG00000227702","21",41679181,41697336,18155
"24543","ENSG00000227704","6",169725504,169738992,13488
"24544","ENSG00000227705","20",53196229,53208705,12476
"24545","ENSG00000227706","6",67878316,67889339,11023
"24546","ENSG00000227708","2",153337705,153357422,19717
"24547","ENSG00000227709","3",156175852,156176911,1059
"24548","ENSG00000227710","22",22168289,22168634,345
"24549","ENSG00000227711","1",227509028,227510618,1590
"24550","ENSG00000227712","1",119230313,119327915,97602
"24551","ENSG00000227713","2",724194,731224,7030
"24552","ENSG00000227714","13",95693983,95694495,512
"24553","ENSG00000227716","21",23477641,23490724,13083
"24554","ENSG00000227717","15",28553638,28561379,7741
"24555","ENSG00000227719","7",8114025,8116561,2536
"24556","ENSG00000227721","21",38894917,38895252,335
"24557","ENSG00000227722","1",168317497,168376876,59379
"24558","ENSG00000227723","6",134636489,134642495,6006
"24559","ENSG00000227725","4",68038544,68039647,1103
"24560","ENSG00000227726","11",70477277,70477592,315
"24561","ENSG00000227728","1",246509038,246522592,13554
"24562","ENSG00000227729","14",103940426,103942561,2135
"24563","ENSG00000227730","9",5091093,5091604,511
"24564","ENSG00000227733","1",148159213,148255012,95799
"24565","ENSG00000227734","10",19290223,19291480,1257
"24566","ENSG00000227735","1",244598391,244598687,296
"24567","ENSG00000227736","2",201552859,201553612,753
"24568","ENSG00000227737","11",124365465,124367298,1833
"24569","ENSG00000227738","2",123762171,123763071,900
"24570","ENSG00000227740","1",175904762,175921057,16295
"24571","ENSG00000227741","1",160202199,160208869,6670
"24572","ENSG00000227742","1",51561866,51594897,33031
"24573","ENSG00000227744","2",238919302,238926269,6967
"24574","ENSG00000227745","2",132132856,132139429,6573
"24575","ENSG00000227747","1",198949016,198949805,789
"24576","ENSG00000227748","6",146854983,146863460,8477
"24577","ENSG00000227755","22",23446598,23460833,14235
"24578","ENSG00000227757","21",32913649,33071104,157455
"24579","ENSG00000227758","6",29748289,29748513,224
"24580","ENSG00000227762","5",99532628,99534611,1983
"24581","ENSG00000227764","1",211639440,211654627,15187
"24582","ENSG00000227765","4",184299129,184299640,511
"24583","ENSG00000227766","6",29942075,29943067,992
"24584","ENSG00000227769","2",215004782,215085488,80706
"24585","ENSG00000227770","2",38231568,38232317,749
"24586","ENSG00000227773","1",155396010,155396978,968
"24587","ENSG00000227775","1",1724512,1737251,12739
"24588","ENSG00000227776","1",167519536,167520586,1050
"24589","ENSG00000227777","1",168542737,168543354,617
"24590","ENSG00000227782","17",16040472,16041273,801
"24591","ENSG00000227784","13",18734080,18734896,816
"24592","ENSG00000227785","7",85636013,85636344,331
"24593","ENSG00000227788","2",120211727,120212862,1135
"24594","ENSG00000227789","2",82818131,82819264,1133
"24595","ENSG00000227790","17",15829369,15908632,79263
"24596","ENSG00000227791","2",64665607,64666064,457
"24597","ENSG00000227795","3",29797652,29797825,173
"24598","ENSG00000227799","2",55224280,55225908,1628
"24599","ENSG00000227800","14",105894508,105894523,15
"24600","ENSG00000227802","2",233742750,233744015,1265
"24601","ENSG00000227803","6",20212087,20317739,105652
"24602","ENSG00000227805","10",95999778,96000243,465
"24603","ENSG00000227809","9",74371335,74384578,13243
"24604","ENSG00000227811","1",111739579,111747798,8219
"24605","ENSG00000227813","22",31890344,31891434,1090
"24606","ENSG00000227814","X",119379712,119380104,392
"24607","ENSG00000227815","1",176272483,176273402,919
"24608","ENSG00000227817","2",131328176,131330857,2681
"24609","ENSG00000227818","1",162039016,162039567,551
"24610","ENSG00000227824","2",215869923,215870518,595
"24611","ENSG00000227825","12",98453835,98457145,3310
"24612","ENSG00000227827","16",16356224,16377507,21283
"24613","ENSG00000227832","1",108502358,108503455,1097
"24614","ENSG00000227834","11",67651576,67653404,1828
"24615","ENSG00000227835","9",2907073,3053408,146335
"24616","ENSG00000227836","5",96942299,96943184,885
"24617","ENSG00000227838","22",27676559,27714970,38411
"24618","ENSG00000227841","2",201556892,201558265,1373
"24619","ENSG00000227842","2",111717508,111717837,329
"24620","ENSG00000227845","9",125372325,125372766,441
"24621","ENSG00000227846","2",233603553,233604401,848
"24622","ENSG00000227848","13",48001389,48002552,1163
"24623","ENSG00000227850","1",105698039,105698218,179
"24624","ENSG00000227852","9",35592786,35592951,165
"24625","ENSG00000227854","1",239052748,239052903,155
"24626","ENSG00000227855","7",29650227,29742594,92367
"24627","ENSG00000227857","1",46134531,46139081,4550
"24628","ENSG00000227860","1",237949736,237951536,1800
"24629","ENSG00000227863","7",89443946,89496918,52972
"24630","ENSG00000227868","1",23010834,23015852,5018
"24631","ENSG00000227874","21",13665868,13667546,1678
"24632","ENSG00000227875","1",12080293,12080547,254
"24633","ENSG00000227877","10",59736692,59756041,19349
"24634","ENSG00000227878","2",196063312,196063963,651
"24635","ENSG00000227879","13",19201637,19227432,25795
"24636","ENSG00000227880","22",27457247,27460060,2813
"24637","ENSG00000227881","X",115664895,115666133,1238
"24638","ENSG00000227882","13",26234213,26237129,2916
"24639","ENSG00000227885","6",53739266,53794904,55638
"24640","ENSG00000227887","1",208697369,208697698,329
"24641","ENSG00000227888","8",12362019,12388296,26277
"24642","ENSG00000227890","2",202179297,202179971,674
"24643","ENSG00000227892","11",7745990,7746906,916
"24644","ENSG00000227893","13",23498796,23502874,4078
"24645","ENSG00000227896","10",86521945,86525101,3156
"24646","ENSG00000227906","20",10006381,10368776,362395
"24647","ENSG00000227907","1",167052551,167058542,5991
"24648","ENSG00000227908","5",55995167,56003649,8482
"24649","ENSG00000227910","7",63924787,63926306,1519
"24650","ENSG00000227911","13",33333679,33335277,1598
"24651","ENSG00000227912","10",2150480,2169460,18980
"24652","ENSG00000227913","6",162568379,162569728,1349
"24653","ENSG00000227914","9",673478,685555,12077
"24654","ENSG00000227917","9",100804,110138,9334
"24655","ENSG00000227920","6",37545145,37550860,5715
"24656","ENSG00000227922","13",77659413,77659664,251
"24657","ENSG00000227925","1",221819842,221840717,20875
"24658","ENSG00000227927","20",14554384,14636524,82140
"24659","ENSG00000227929","3",9216895,9219508,2613
"24660","ENSG00000227930","7",23891704,23897335,5631
"24661","ENSG00000227932","10",26664206,26697295,33089
"24662","ENSG00000227933","9",35646270,35647099,829
"24663","ENSG00000227934","1",231021611,231022183,572
"24664","ENSG00000227935","1",57386576,57387450,874
"24665","ENSG00000227938","2",28448167,28450184,2017
"24666","ENSG00000227939","6",31280317,31281519,1202
"24667","ENSG00000227940","1",209325392,209328535,3143
"24668","ENSG00000227941","1",162541332,162541628,296
"24669","ENSG00000227942","X",65550898,65552421,1523
"24670","ENSG00000227945","6",128027886,128085248,57362
"24671","ENSG00000227946","2",206084605,206086564,1959
"24672","ENSG00000227947","1",47688463,47704029,15566
"24673","ENSG00000227948","7",111411319,111411883,564
"24674","ENSG00000227950","1",6834333,6834618,285
"24675","ENSG00000227953","1",246775880,246792385,16505
"24676","ENSG00000227954","6",133502252,133892802,390550
"24677","ENSG00000227958","9",135204722,135237597,32875
"24678","ENSG00000227959","1",16155211,16157329,2118
"24679","ENSG00000227960","1",81505099,81506296,1197
"24680","ENSG00000227962","1",235336806,235337087,281
"24681","ENSG00000227963","1",110286375,110339171,52796
"24682","ENSG00000227964","20",51831797,51862912,31115
"24683","ENSG00000227965","7",16888621,16888885,264
"24684","ENSG00000227969","13",67831876,67832827,951
"24685","ENSG00000227970","1",114837227,114851453,14226
"24686","ENSG00000227972","10",52411135,52413492,2357
"24687","ENSG00000227973","15",43875849,43876244,395
"24688","ENSG00000227986","7",64355078,64356199,1121
"24689","ENSG00000227992","2",111203964,111206215,2251
"24690","ENSG00000227999","21",44473723,44475097,1374
"24691","ENSG00000228000","17",18311904,18312651,747
"24692","ENSG00000228002","13",76984868,76987943,3075
"24693","ENSG00000228005","7",50141540,50142823,1283
"24694","ENSG00000228007","17",75338827,75339147,320
"24695","ENSG00000228008","3",49903845,49916937,13092
"24696","ENSG00000228010","7",6663974,6708901,44927
"24697","ENSG00000228013","1",154402328,154406564,4236
"24698","ENSG00000228014","7",64469185,64470653,1468
"24699","ENSG00000228015","7",33128988,33129143,155
"24700","ENSG00000228016","2",172677141,172736206,59065
"24701","ENSG00000228019","7",67307605,67308356,751
"24702","ENSG00000228020","1",191146025,191146961,936
"24703","ENSG00000228021","10",125683229,125709677,26448
"24704","ENSG00000228022","6",30743790,30792250,48460
"24705","ENSG00000228024","9",73042745,73056528,13783
"24706","ENSG00000228027","10",11010164,11011119,955
"24707","ENSG00000228028","3",196250542,196251654,1112
"24708","ENSG00000228030","7",158719730,158720161,431
"24709","ENSG00000228031","7",137344930,137354483,9553
"24710","ENSG00000228033","2",52722671,52961452,238781
"24711","ENSG00000228035","1",115283034,115368072,85038
"24712","ENSG00000228036","13",37993085,37994720,1635
"24713","ENSG00000228037","1",2581560,2584533,2973
"24714","ENSG00000228038","9",97093694,97094638,944
"24715","ENSG00000228039","22",23963780,23964374,594
"24716","ENSG00000228040","1",112890767,112890922,155
"24717","ENSG00000228043","2",138418284,138501698,83414
"24718","ENSG00000228044","1",234646289,234683176,36887
"24719","ENSG00000228045","22",17518676,17519029,353
"24720","ENSG00000228048","10",55506219,55513217,6998
"24721","ENSG00000228049","7",102665368,102671629,6261
"24722","ENSG00000228050","22",22223187,22224566,1379
"24723","ENSG00000228053","9",110024881,110025358,477
"24724","ENSG00000228055","10",87396561,87435035,38474
"24725","ENSG00000228056","1",63843196,63843685,489
"24726","ENSG00000228057","1",97545701,97546958,1257
"24727","ENSG00000228058","1",230002372,230007195,4823
"24728","ENSG00000228060","1",39565052,39573860,8808
"24729","ENSG00000228061","11",31618124,31767953,149829
"24730","ENSG00000228063","1",218983023,219173961,190938
"24731","ENSG00000228065","10",65570338,65880289,309951
"24732","ENSG00000228067","1",212545694,212556065,10371
"24733","ENSG00000228069","9",92109013,92110095,1082
"24734","ENSG00000228071","16",17932720,17933275,555
"24735","ENSG00000228072","9",33512959,33514773,1814
"24736","ENSG00000228073","2",189095063,189096158,1095
"24737","ENSG00000228075","18",57147087,57150410,3323
"24738","ENSG00000228076","1",108766841,108767584,743
"24739","ENSG00000228078","6",29934101,29934286,185
"24740","ENSG00000228079","2",64086353,64088246,1893
"24741","ENSG00000228081","1",209173014,209173375,361
"24742","ENSG00000228082","6",100427118,100437484,10366
"24743","ENSG00000228084","1",99968383,99969864,1481
"24744","ENSG00000228085","7",50843578,50843732,154
"24745","ENSG00000228086","1",100462399,100485997,23598
"24746","ENSG00000228092","10",77433572,77433782,210
"24747","ENSG00000228095","9",84604111,84604425,314
"24748","ENSG00000228097","9",5099560,5100229,669
"24749","ENSG00000228100","2",46392291,46394228,1937
"24750","ENSG00000228105","1",20243095,20244664,1569
"24751","ENSG00000228106","1",222815022,222837384,22362
"24752","ENSG00000228107","21",36360630,36362040,1410
"24753","ENSG00000228108","2",54516048,54540697,24649
"24754","ENSG00000228109","3",196999460,197004744,5284
"24755","ENSG00000228110","1",210265636,210267241,1605
"24756","ENSG00000228113","7",88219359,88304367,85008
"24757","ENSG00000228115","9",487774,495610,7836
"24758","ENSG00000228118","17",71620978,71621436,458
"24759","ENSG00000228120","21",43159066,43162277,3211
"24760","ENSG00000228121","1",58999676,59000494,818
"24761","ENSG00000228122","22",16876218,16876421,203
"24762","ENSG00000228123","9",82431889,82432905,1016
"24763","ENSG00000228124","6",89673469,89675783,2314
"24764","ENSG00000228125","X",68132868,68133437,569
"24765","ENSG00000228126","1",150515757,150518032,2275
"24766","ENSG00000228127","1",115904855,115931616,26761
"24767","ENSG00000228131","14",105910410,105910427,17
"24768","ENSG00000228132","9",6276640,6276974,334
"24769","ENSG00000228133","17",2017716,2020706,2990
"24770","ENSG00000228135","2",218900811,218930636,29825
"24771","ENSG00000228137","21",46246890,46247682,792
"24772","ENSG00000228139","X",120117642,120119700,2058
"24773","ENSG00000228140","1",15402979,15409433,6454
"24774","ENSG00000228141","15",82710471,82714029,3558
"24775","ENSG00000228142","9",95650154,95715718,65564
"24776","ENSG00000228143","9",106722350,106722930,580
"24777","ENSG00000228144","12",66123917,66169985,46068
"24778","ENSG00000228146","16",3144015,3149963,5948
"24779","ENSG00000228149","21",36168970,36170180,1210
"24780","ENSG00000228150","1",9942923,9949974,7051
"24781","ENSG00000228151","7",149398204,149401456,3252
"24782","ENSG00000228153","1",204663872,204664613,741
"24783","ENSG00000228154","4",25622777,25623601,824
"24784","ENSG00000228156","20",32581963,32593900,11937
"24785","ENSG00000228157","17",19092974,19096837,3863
"24786","ENSG00000228158","X",65408084,65408672,588
"24787","ENSG00000228159","21",13516107,13574999,58892
"24788","ENSG00000228162","2",234438328,234462127,23799
"24789","ENSG00000228166","9",5094139,5095014,875
"24790","ENSG00000228168","3",39334979,39335939,960
"24791","ENSG00000228169","10",114690143,114690634,491
"24792","ENSG00000228171","3",23389661,23389909,248
"24793","ENSG00000228172","1",25816749,25820797,4048
"24794","ENSG00000228173","7",48660125,48669479,9354
"24795","ENSG00000228174","9",97512706,97517836,5130
"24796","ENSG00000228175","1",89993593,89994321,728
"24797","ENSG00000228181","10",15171036,15171278,242
"24798","ENSG00000228187","1",77194825,77195395,570
"24799","ENSG00000228189","9",88627063,88652180,25117
"24800","ENSG00000228190","1",199371877,199372297,420
"24801","ENSG00000228192","1",42832522,42846422,13900
"24802","ENSG00000228195","10",116749905,116751261,1356
"24803","ENSG00000228196","1",178746683,178747754,1071
"24804","ENSG00000228201","16",648473,649200,727
"24805","ENSG00000228203","2",6911754,6918734,6980
"24806","ENSG00000228204","7",50866747,51022990,156243
"24807","ENSG00000228205","3",184149704,184150435,731
"24808","ENSG00000228208","1",218459265,218525978,66713
"24809","ENSG00000228209","2",76258034,76258897,863
"24810","ENSG00000228211","7",123814139,123829252,15113
"24811","ENSG00000228212","5",37209364,37212381,3017
"24812","ENSG00000228213","3",173910498,173920796,10298
"24813","ENSG00000228215","1",191823432,192011260,187828
"24814","ENSG00000228216","9",90957260,90965393,8133
"24815","ENSG00000228217","1",117778087,117778506,419
"24816","ENSG00000228218","17",76225751,76226806,1055
"24817","ENSG00000228219","10",21110682,21113388,2706
"24818","ENSG00000228221","3",177441910,177767379,325469
"24819","ENSG00000228222","2",167293171,167558333,265162
"24820","ENSG00000228223","6",26521709,26527404,5695
"24821","ENSG00000228224","8",101361794,101372707,10913
"24822","ENSG00000228231","6",54365335,54369971,4636
"24823","ENSG00000228232","X",39787132,39788136,1004
"24824","ENSG00000228234","20",37602852,37603185,333
"24825","ENSG00000228236","2",149068596,149068910,314
"24826","ENSG00000228237","1",46674036,46692098,18062
"24827","ENSG00000228238","1",186578279,186579299,1020
"24828","ENSG00000228239","1",157232231,157237136,4905
"24829","ENSG00000228242","3",14144637,14165978,21341
"24830","ENSG00000228247","1",217850403,217850633,230
"24831","ENSG00000228248","9",77580245,77580628,383
"24832","ENSG00000228251","2",112590796,112591939,1143
"24833","ENSG00000228252","3",130212823,130273806,60983
"24834","ENSG00000228253","MT",8366,8572,206
"24835","ENSG00000228255","1",213731416,213794587,63171
"24836","ENSG00000228259","5",179651284,179652457,1173
"24837","ENSG00000228261","10",104323369,104327004,3635
"24838","ENSG00000228262","2",33706886,34738231,1031345
"24839","ENSG00000228264","1",154414369,154415137,768
"24840","ENSG00000228271","3",194276682,194287368,10686
"24841","ENSG00000228274","22",38667585,38681847,14262
"24842","ENSG00000228275","X",101622983,101624164,1181
"24843","ENSG00000228277","4",73710302,73714527,4225
"24844","ENSG00000228278","9",114329869,114333256,3387
"24845","ENSG00000228280","10",75742740,75743755,1015
"24846","ENSG00000228283","6",146802359,146803824,1465
"24847","ENSG00000228285","6",33365548,33366243,695
"24848","ENSG00000228286","11",72249856,72251288,1432
"24849","ENSG00000228288","1",202810954,202812156,1202
"24850","ENSG00000228289","1",163769339,163769691,352
"24851","ENSG00000228290","6",84687712,84709578,21866
"24852","ENSG00000228291","10",5207169,5207742,573
"24853","ENSG00000228292","9",37205112,37205368,256
"24854","ENSG00000228293","20",2664352,2665874,1522
"24855","ENSG00000228294","14",19301704,19316914,15210
"24856","ENSG00000228295","13",73564244,73588070,23826
"24857","ENSG00000228300","19",1275530,1279244,3714
"24858","ENSG00000228302","10",12244751,12247845,3094
"24859","ENSG00000228303","7",56638943,56650696,11753
"24860","ENSG00000228304","14",19847367,19848263,896
"24861","ENSG00000228305","2",63622178,63622831,653
"24862","ENSG00000228307","9",35962195,36014623,52428
"24863","ENSG00000228308","3",176814155,176817001,2846
"24864","ENSG00000228309","1",185558371,185628944,70573
"24865","ENSG00000228312","10",15093263,15093611,348
"24866","ENSG00000228314","21",13843133,13848364,5231
"24867","ENSG00000228315","22",23638487,23717356,78869
"24868","ENSG00000228316","X",102798396,102799560,1164
"24869","ENSG00000228317","9",105554035,105558304,4269
"24870","ENSG00000228318","21",41441056,41445708,4652
"24871","ENSG00000228319","13",56214373,56216942,2569
"24872","ENSG00000228322","9",4299390,4306046,6656
"24873","ENSG00000228323","19",53854581,53869107,14526
"24874","ENSG00000228325","2",90234812,90235370,558
"24875","ENSG00000228327","1",725885,778626,52741
"24876","ENSG00000228328","X",68070520,68071767,1247
"24877","ENSG00000228329","2",68822855,68837235,14380
"24878","ENSG00000228330","10",13142185,13142977,792
"24879","ENSG00000228331","17",19496943,19497528,585
"24880","ENSG00000228334","7",3083252,3118049,34797
"24881","ENSG00000228335","7",99442890,99443496,606
"24882","ENSG00000228336","1",247770169,247779524,9355
"24883","ENSG00000228338","1",12822686,12823159,473
"24884","ENSG00000228339","10",20350049,20351100,1051
"24885","ENSG00000228340","20",60087826,60653784,565958
"24886","ENSG00000228341","7",107450083,107450362,279
"24887","ENSG00000228343","X",48579774,48581157,1383
"24888","ENSG00000228345","X",27854323,27855353,1030
"24889","ENSG00000228348","1",35122022,35122484,462
"24890","ENSG00000228349","21",39491544,39491898,354
"24891","ENSG00000228350","3",48663776,48669174,5398
"24892","ENSG00000228351","3",8079322,8125538,46216
"24893","ENSG00000228352","9",34084332,34096225,11893
"24894","ENSG00000228353","10",3767915,3768751,836
"24895","ENSG00000228355","21",45378201,45379635,1434
"24896","ENSG00000228358","4",117360596,117412712,52116
"24897","ENSG00000228360","7",139227537,139227828,291
"24898","ENSG00000228361","6",168229732,168240715,10983
"24899","ENSG00000228363","2",86562070,86618766,56696
"24900","ENSG00000228364","6",29076573,29077168,595
"24901","ENSG00000228365","6",2916894,2917733,839
"24902","ENSG00000228366","9",105710290,105710781,491
"24903","ENSG00000228368","7",116965846,116967472,1626
"24904","ENSG00000228369","1",52050918,52052683,1765
"24905","ENSG00000228372","X",135059685,135123952,64267
"24906","ENSG00000228373","9",87423634,87423893,259
"24907","ENSG00000228376","9",97075671,97081945,6274
"24908","ENSG00000228380","2",208269343,208269957,614
"24909","ENSG00000228382","1",226656640,226675067,18427
"24910","ENSG00000228383","Y",9367803,9375681,7878
"24911","ENSG00000228384","2",70994510,71002754,8244
"24912","ENSG00000228386","20",34014969,34017749,2780
"24913","ENSG00000228392","9",126270121,126298593,28472
"24914","ENSG00000228393","7",104950315,105013044,62729
"24915","ENSG00000228395","9",128528657,128552410,23753
"24916","ENSG00000228397","1",22023990,22026048,2058
"24917","ENSG00000228398","3",141865012,141865279,267
"24918","ENSG00000228399","1",101256274,101256616,342
"24919","ENSG00000228400","2",124011984,124025173,13189
"24920","ENSG00000228401","9",136648610,136660421,11811
"24921","ENSG00000228403","10",48878022,48878649,627
"24922","ENSG00000228404","21",46185079,46188941,3862
"24923","ENSG00000228407","1",52160261,52160600,339
"24924","ENSG00000228408","6",149217926,149245554,27628
"24925","ENSG00000228409","7",65751142,65763354,12212
"24926","ENSG00000228411","Y",12801973,12803830,1857
"24927","ENSG00000228412","6",19323428,19839080,515652
"24928","ENSG00000228413","3",196044695,196045254,559
"24929","ENSG00000228414","2",60823069,60881317,58248
"24930","ENSG00000228415","6",30633632,30633956,324
"24931","ENSG00000228417","10",110207850,110208591,741
"24932","ENSG00000228420","1",109828355,109871436,43081
"24933","ENSG00000228421","7",28957667,28959345,1678
"24934","ENSG00000228422","20",11800463,11878429,77966
"24935","ENSG00000228423","1",8805860,8807051,1191
"24936","ENSG00000228426","10",43665668,43667005,1337
"24937","ENSG00000228427","X",71183384,71198208,14824
"24938","ENSG00000228429","7",68640798,68641584,786
"24939","ENSG00000228430","9",81977614,82780194,802580
"24940","ENSG00000228431","1",68049360,68049745,385
"24941","ENSG00000228432","6",31366352,31366898,546
"24942","ENSG00000228433","21",32621084,32622083,999
"24943","ENSG00000228434","7",44004046,44007866,3820
"24944","ENSG00000228436","1",38859912,38965038,105126
"24945","ENSG00000228437","1",221966341,221984964,18623
"24946","ENSG00000228440","7",57170974,57172771,1797
"24947","ENSG00000228444","13",75631271,75632135,864
"24948","ENSG00000228445","2",233747214,233748079,865
"24949","ENSG00000228446","2",224499387,224500100,713
"24950","ENSG00000228451","8",26375913,26382953,7040
"24951","ENSG00000228452","1",42775813,42776790,977
"24952","ENSG00000228453","1",117138229,117138609,380
"24953","ENSG00000228459","X",3271544,3286138,14594
"24954","ENSG00000228462","10",45073146,45073541,395
"24955","ENSG00000228463","1",257864,359681,101817
"24956","ENSG00000228466","X",123561642,123562966,1324
"24957","ENSG00000228470","1",214344172,214357615,13443
"24958","ENSG00000228474","2",27070472,27071654,1182
"24959","ENSG00000228476","20",23918538,23928954,10416
"24960","ENSG00000228477","1",39962680,39963404,724
"24961","ENSG00000228478","6",10423140,10426176,3036
"24962","ENSG00000228481","2",45674701,45675476,775
"24963","ENSG00000228482","20",6731080,6736326,5246
"24964","ENSG00000228484","10",114764788,114794344,29556
"24965","ENSG00000228485","10",119208531,119211760,3229
"24966","ENSG00000228486","2",97664217,97703064,38847
"24967","ENSG00000228487","9",127213783,127221907,8124
"24968","ENSG00000228488","2",100722221,100722882,661
"24969","ENSG00000228492","X",74202834,74204595,1761
"24970","ENSG00000228495","6",132131888,132169374,37486
"24971","ENSG00000228496","2",11681460,11683328,1868
"24972","ENSG00000228499","2",235882362,235882493,131
"24973","ENSG00000228501","13",100150481,100151092,611
"24974","ENSG00000228502","1",96446930,96448318,1388
"24975","ENSG00000228503","20",47958022,47958603,581
"24976","ENSG00000228504","1",95310928,95318263,7335
"24977","ENSG00000228505","2",14616428,14630192,13764
"24978","ENSG00000228506","6",99424922,99432323,7401
"24979","ENSG00000228507","2",171491422,171491931,509
"24980","ENSG00000228509","2",190676944,190708716,31772
"24981","ENSG00000228510","9",128444587,128446628,2041
"24982","ENSG00000228513","2",203061314,203062403,1089
"24983","ENSG00000228519","X",25645722,25646327,605
"24984","ENSG00000228521","7",155204147,155205189,1042
"24985","ENSG00000228522","9",63330326,63343660,13334
"24986","ENSG00000228523","1",67278052,67278779,727
"24987","ENSG00000228525","1",226958069,226958267,198
"24988","ENSG00000228526","1",9148011,9198906,50895
"24989","ENSG00000228527","10",58304553,58305621,1068
"24990","ENSG00000228528","2",104702650,104705813,3163
"24991","ENSG00000228532","X",115718942,115719229,287
"24992","ENSG00000228536","1",219409039,219459369,50330
"24993","ENSG00000228538","2",21638068,21649572,11504
"24994","ENSG00000228539","20",24491472,24502345,10873
"24995","ENSG00000228540","7",110724159,110725825,1666
"24996","ENSG00000228541","2",62463127,62464070,943
"24997","ENSG00000228543","X",9249920,9275206,25286
"24998","ENSG00000228544","9",136803927,136808848,4921
"24999","ENSG00000228546","7",102337316,102339115,1799
"25000","ENSG00000228547","10",14999050,15000055,1005
"25001","ENSG00000228548","1",226668897,226676345,7448
"25002","ENSG00000228549","1",16870945,16883659,12714
"25003","ENSG00000228550","X",7113005,7113404,399
"25004","ENSG00000228551","2",109251422,109251646,224
"25005","ENSG00000228553","10",94225160,94227288,2128
"25006","ENSG00000228554","7",39700341,39703296,2955
"25007","ENSG00000228559","6",35539838,35546573,6735
"25008","ENSG00000228560","1",159346166,159469068,122902
"25009","ENSG00000228561","3",177683627,177691250,7623
"25010","ENSG00000228563","2",31526942,31563464,36522
"25011","ENSG00000228564","7",64024409,64030105,5696
"25012","ENSG00000228566","10",63664664,64693446,1028782
"25013","ENSG00000228568","2",72288785,72289110,325
"25014","ENSG00000228570","10",79841358,79850878,9520
"25015","ENSG00000228572","X",253743,255091,1348
"25016","ENSG00000228573","13",47825330,47835956,10626
"25017","ENSG00000228577","2",206606497,206609812,3315
"25018","ENSG00000228587","22",35685940,35689373,3433
"25019","ENSG00000228589","1",28095742,28096422,680
"25020","ENSG00000228590","2",60336446,60439828,103382
"25021","ENSG00000228592","21",23352929,23423778,70849
"25022","ENSG00000228594","1",1598012,1600135,2123
"25023","ENSG00000228596","7",44785050,44787340,2290
"25024","ENSG00000228598","7",20141916,20153531,11615
"25025","ENSG00000228599","22",40106325,40107066,741
"25026","ENSG00000228600","21",14757588,14758352,764
"25027","ENSG00000228604","20",21148741,21162890,14149
"25028","ENSG00000228606","1",160261741,160263328,1587
"25029","ENSG00000228610","X",23198339,23198690,351
"25030","ENSG00000228611","13",55999200,56000448,1248
"25031","ENSG00000228612","X",80571871,80574607,2736
"25032","ENSG00000228613","2",1546665,1620113,73448
"25033","ENSG00000228615","2",111742586,111744662,2076
"25034","ENSG00000228618","2",215476667,215480248,3581
"25035","ENSG00000228620","22",38424288,38427336,3048
"25036","ENSG00000228622","22",33105383,33106059,676
"25037","ENSG00000228623","9",112957722,113012227,54505
"25038","ENSG00000228624","6",113969701,114471705,502004
"25039","ENSG00000228625","1",227178333,227183444,5111
"25040","ENSG00000228626","1",148288001,148288951,950
"25041","ENSG00000228629","19",36528318,36535235,6917
"25042","ENSG00000228630","12",53962308,53974956,12648
"25043","ENSG00000228634","1",31933020,31933975,955
"25044","ENSG00000228636","10",9758783,9878060,119277
"25045","ENSG00000228638","3",48290793,48291375,582
"25046","ENSG00000228639","17",72021851,72034092,12241
"25047","ENSG00000228643","2",286419,301515,15096
"25048","ENSG00000228645","7",63509303,63510165,862
"25049","ENSG00000228646","1",213428708,213429077,369
"25050","ENSG00000228648","6",167241891,167245916,4025
"25051","ENSG00000228649","7",22854126,22872945,18819
"25052","ENSG00000228650","5",56770799,56772303,1504
"25053","ENSG00000228653","7",64500825,64501729,904
"25054","ENSG00000228655","2",143295421,143598002,302581
"25055","ENSG00000228656","9",63761546,63762824,1278
"25056","ENSG00000228657","10",102572757,102573225,468
"25057","ENSG00000228660","7",63963431,63964123,692
"25058","ENSG00000228661","11",3854318,3855509,1191
"25059","ENSG00000228663","20",50913731,50914411,680
"25060","ENSG00000228665","1",109030067,109030319,252
"25061","ENSG00000228666","6",28969130,28970460,1330
"25062","ENSG00000228667","10",24867645,24868190,545
"25063","ENSG00000228668","7",38345030,38345499,469
"25064","ENSG00000228669","13",62672285,62796714,124429
"25065","ENSG00000228670","2",222452400,222453126,726
"25066","ENSG00000228672","5",139390592,139395713,5121
"25067","ENSG00000228674","19",50927079,50927571,492
"25068","ENSG00000228677","21",37187666,37193926,6260
"25069","ENSG00000228679","6",83983728,84007323,23595
"25070","ENSG00000228680","7",43239066,43249268,10202
"25071","ENSG00000228681","2",224294930,224295753,823
"25072","ENSG00000228683","10",78696062,78697022,960
"25073","ENSG00000228685","10",5624931,5625126,195
"25074","ENSG00000228686","1",176017277,176018760,1483
"25075","ENSG00000228688","6",33103794,33107330,3536
"25076","ENSG00000228689","6",51599723,51623428,23705
"25077","ENSG00000228692","6",163586583,163588165,1582
"25078","ENSG00000228695","16",55760566,55793960,33394
"25079","ENSG00000228696","17",46274784,46361797,87013
"25080","ENSG00000228697","1",168400829,168495685,94856
"25081","ENSG00000228700","7",128433422,128433713,291
"25082","ENSG00000228701","10",91782835,91798304,15469
"25083","ENSG00000228702","10",45725694,45726038,344
"25084","ENSG00000228705","20",62774121,62776996,2875
"25085","ENSG00000228709","21",44485577,44490288,4711
"25086","ENSG00000228711","7",82657035,82657411,376
"25087","ENSG00000228714","9",115324932,115744330,419398
"25088","ENSG00000228716","5",80626226,80654983,28757
"25089","ENSG00000228718","6",2617144,2640001,22857
"25090","ENSG00000228719","22",36445395,36454944,9549
"25091","ENSG00000228721","2",132911096,132911261,165
"25092","ENSG00000228723","3",9192493,9194453,1960
"25093","ENSG00000228725","17",19603797,19605048,1251
"25094","ENSG00000228727","6",31762996,31764851,1855
"25095","ENSG00000228728","X",150818753,150819246,493
"25096","ENSG00000228729","1",227234269,227235355,1086
"25097","ENSG00000228730","3",190680421,190699314,18893
"25098","ENSG00000228734","1",63249920,63251771,1851
"25099","ENSG00000228735","7",54576052,54578794,2742
"25100","ENSG00000228737","5",141618414,141626481,8067
"25101","ENSG00000228739","9",6047360,6066714,19354
"25102","ENSG00000228740","15",27038978,27161319,122341
"25103","ENSG00000228741","13",23979810,24035027,55217
"25104","ENSG00000228742","7",106774955,106838480,63525
"25105","ENSG00000228744","8",7122857,7123704,847
"25106","ENSG00000228748","10",77782866,77793176,10310
"25107","ENSG00000228750","1",6724637,6730012,5375
"25108","ENSG00000228751","7",95350164,95351229,1065
"25109","ENSG00000228753","10",21028999,21030792,1793
"25110","ENSG00000228754","10",48745545,48746128,583
"25111","ENSG00000228755","10",42279734,42281819,2085
"25112","ENSG00000228757","14",106436415,106436555,140
"25113","ENSG00000228759","10",91765899,91767196,1297
"25114","ENSG00000228763","2",108676795,108678601,1806
"25115","ENSG00000228764","Y",20390051,20396796,6745
"25116","ENSG00000228766","3",182610674,182611414,740
"25117","ENSG00000228768","17",31571142,31575659,4517
"25118","ENSG00000228770","7",36228621,36228884,263
"25119","ENSG00000228772","6",22589137,22593833,4696
"25120","ENSG00000228775","7",141704003,141738346,34343
"25121","ENSG00000228777","6",115633540,115643916,10376
"25122","ENSG00000228778","10",99526948,99528467,1519
"25123","ENSG00000228779","16",125737,127219,1482
"25124","ENSG00000228781","9",78180214,78180693,479
"25125","ENSG00000228782","17",47450568,47492492,41924
"25126","ENSG00000228784","2",19868860,19885047,16187
"25127","ENSG00000228786","Y",25378300,25394719,16419
"25128","ENSG00000228787","Y",14793642,14804033,10391
"25129","ENSG00000228789","6",31053450,31059890,6440
"25130","ENSG00000228791","3",24494087,24681711,187624
"25131","ENSG00000228792","1",211635865,211644114,8249
"25132","ENSG00000228793","6",3585101,3720081,134980
"25133","ENSG00000228794","1",825138,868202,43064
"25134","ENSG00000228797","13",18697003,18697507,504
"25135","ENSG00000228799","2",899462,905539,6077
"25136","ENSG00000228800","10",30553854,30554483,629
"25137","ENSG00000228801","8",51899268,51949874,50606
"25138","ENSG00000228802","2",223965701,223967706,2005
"25139","ENSG00000228804","3",187702313,187733849,31536
"25140","ENSG00000228807","22",44483495,44483717,222
"25141","ENSG00000228808","13",99372173,99372686,513
"25142","ENSG00000228809","20",16714844,16730948,16104
"25143","ENSG00000228810","9",17589161,17591318,2157
"25144","ENSG00000228812","20",62352995,62356480,3485
"25145","ENSG00000228815","7",36109024,36110872,1848
"25146","ENSG00000228816","10",32944481,32944999,518
"25147","ENSG00000228817","21",29370497,29373709,3212
"25148","ENSG00000228818","1",240142670,240145389,2719
"25149","ENSG00000228819","X",132130091,132131352,1261
"25150","ENSG00000228820","20",51130788,51131667,879
"25151","ENSG00000228824","13",87427214,87674235,247021
"25152","ENSG00000228825","13",36922539,36922908,369
"25153","ENSG00000228826","1",121494329,121511588,17259
"25154","ENSG00000228828","10",37818606,37820982,2376
"25155","ENSG00000228829","7",76173733,76177205,3472
"25156","ENSG00000228834","6",108907615,108907873,258
"25157","ENSG00000228835","18",32769795,32774413,4618
"25158","ENSG00000228836","X",135777130,135785298,8168
"25159","ENSG00000228837","2",154940541,154941067,526
"25160","ENSG00000228838","1",53288024,53289706,1682
"25161","ENSG00000228839","22",31292499,31338021,45522
"25162","ENSG00000228842","13",66825169,66915031,89862
"25163","ENSG00000228844","1",240636599,240637052,453
"25164","ENSG00000228847","X",42098754,42099173,419
"25165","ENSG00000228848","2",148870024,148870381,357
"25166","ENSG00000228851","7",57191141,57191927,786
"25167","ENSG00000228852","1",95243167,95278940,35773
"25168","ENSG00000228857","2",113831049,113843356,12307
"25169","ENSG00000228861","21",39127568,39128040,472
"25170","ENSG00000228862","8",60629662,60653561,23899
"25171","ENSG00000228863","1",160670778,160699761,28983
"25172","ENSG00000228868","3",75328549,75339071,10522
"25173","ENSG00000228869","13",45671845,45672391,546
"25174","ENSG00000228872","2",63717122,63717899,777
"25175","ENSG00000228873","2",96145602,96147012,1410
"25176","ENSG00000228874","3",15131848,15132208,360
"25177","ENSG00000228876","2",16224047,16333978,109931
"25178","ENSG00000228877","9",134527182,134545244,18062
"25179","ENSG00000228878","7",35751856,35800676,48820
"25180","ENSG00000228879","1",246755511,246755832,321
"25181","ENSG00000228882","10",38452987,38455365,2378
"25182","ENSG00000228884","2",231585864,231586327,463
"25183","ENSG00000228886","13",45350323,45351350,1027
"25184","ENSG00000228887","19",14070342,14071237,895
"25185","ENSG00000228888","20",7146467,7254202,107735
"25186","ENSG00000228889","13",99181223,99200757,19534
"25187","ENSG00000228897","7",51386363,51387101,738
"25188","ENSG00000228903","7",44026951,44041892,14941
"25189","ENSG00000228906","X",73948973,73949558,585
"25190","ENSG00000228909","2",219903900,219904923,1023
"25191","ENSG00000228914","9",122607864,122608800,936
"25192","ENSG00000228915","11",71893410,71894433,1023
"25193","ENSG00000228917","1",161084465,161087571,3106
"25194","ENSG00000228918","1",182096338,182314061,217723
"25195","ENSG00000228919","4",7939001,7940296,1295
"25196","ENSG00000228922","X",135201731,135215232,13501
"25197","ENSG00000228923","22",24516508,24518386,1878
"25198","ENSG00000228925","2",46899275,46908678,9403
"25199","ENSG00000228927","Y",9398421,9401223,2802
"25200","ENSG00000228928","7",88564793,88566281,1488
"25201","ENSG00000228929","1",52772194,52772648,454
"25202","ENSG00000228930","21",45376191,45376382,191
"25203","ENSG00000228933","X",27174920,27399006,224086
"25204","ENSG00000228935","20",22960534,22966063,5529
"25205","ENSG00000228937","2",157961410,157962888,1478
"25206","ENSG00000228938","10",89978717,89979070,353
"25207","ENSG00000228939","1",243793205,243794400,1195
"25208","ENSG00000228940","1",40938104,40939763,1659
"25209","ENSG00000228941","21",31060600,31063168,2568
"25210","ENSG00000228944","7",24196662,24255719,59057
"25211","ENSG00000228948","9",105849710,105851425,1715
"25212","ENSG00000228950","2",20451042,20452947,1905
"25213","ENSG00000228951","10",5616626,5632499,15873
"25214","ENSG00000228952","3",187448845,187449450,605
"25215","ENSG00000228953","7",23655682,23655861,179
"25216","ENSG00000228955","1",246632251,246632478,227
"25217","ENSG00000228956","3",18445024,18920401,475377
"25218","ENSG00000228957","9",97386240,97396112,9872
"25219","ENSG00000228959","20",42014034,42015478,1444
"25220","ENSG00000228960","7",144294480,144300934,6454
"25221","ENSG00000228961","21",32958888,32960566,1678
"25222","ENSG00000228963","3",125724539,125725445,906
"25223","ENSG00000228965","X",152045314,152046193,879
"25224","ENSG00000228966","14",106460092,106461055,963
"25225","ENSG00000228970","2",97636780,97637803,1023
"25226","ENSG00000228971","1",95510059,95782342,272283
"25227","ENSG00000228973","2",219625059,219626693,1634
"25228","ENSG00000228974","7",5560743,5561055,312
"25229","ENSG00000228976","6",108618000,108618285,285
"25230","ENSG00000228979","17",63471604,63472093,489
"25231","ENSG00000228980","3",109409990,109723273,313283
"25232","ENSG00000228981","4",143349275,143350117,842
"25233","ENSG00000228983","17",19579943,19596058,16115
"25234","ENSG00000228984","8",46784800,46785928,1128
"25235","ENSG00000228986","X",155292169,155293432,1263
"25236","ENSG00000228988","1",70218589,70221023,2434
"25237","ENSG00000228992","15",27895704,27896582,878
"25238","ENSG00000228995","20",57357426,57358369,943
"25239","ENSG00000228997","10",10776223,10776661,438
"25240","ENSG00000229000","19",53772506,53773280,774
"25241","ENSG00000229001","10",69022778,69023866,1088
"25242","ENSG00000229005","20",44372746,44395706,22960
"25243","ENSG00000229007","21",32496812,32497311,499
"25244","ENSG00000229009","4",67991684,68015768,24084
"25245","ENSG00000229010","1",23140325,23141142,817
"25246","ENSG00000229011","13",79804418,79805685,1267
"25247","ENSG00000229012","X",8863861,8867601,3740
"25248","ENSG00000229015","X",135396429,135397764,1335
"25249","ENSG00000229016","1",218301262,218301972,710
"25250","ENSG00000229017","6",142966293,143059682,93389
"25251","ENSG00000229018","7",73005541,73021103,15562
"25252","ENSG00000229019","9",68426843,68429369,2526
"25253","ENSG00000229020","1",112923423,112924337,914
"25254","ENSG00000229021","1",151994531,152042774,48243
"25255","ENSG00000229022","1",241831935,241832787,852
"25256","ENSG00000229023","2",190992639,190993567,928
"25257","ENSG00000229025","21",26349780,26350634,854
"25258","ENSG00000229027","22",16827474,16829335,1861
"25259","ENSG00000229028","17",40717235,40721932,4697
"25260","ENSG00000229029","9",14593577,14594200,623
"25261","ENSG00000229031","7",69331835,69333633,1798
"25262","ENSG00000229035","1",153140491,153140709,218
"25263","ENSG00000229036","6",143490424,143506406,15982
"25264","ENSG00000229037","X",53807776,53808623,847
"25265","ENSG00000229042","20",42685404,42688562,3158
"25266","ENSG00000229043","7",1160374,1165607,5233
"25267","ENSG00000229044","1",31333067,31346799,13732
"25268","ENSG00000229046","21",31706555,31706864,309
"25269","ENSG00000229048","3",125310881,125311350,469
"25270","ENSG00000229051","1",70706441,70786468,80027
"25271","ENSG00000229052","1",92930696,92934098,3402
"25272","ENSG00000229054","7",33036212,33036382,170
"25273","ENSG00000229056","2",196260024,196264204,4180
"25274","ENSG00000229057","9",6662424,6663792,1368
"25275","ENSG00000229060","9",28148211,28149236,1025
"25276","ENSG00000229063","9",33638035,33638494,459
"25277","ENSG00000229064","7",65247608,65247758,150
"25278","ENSG00000229065","9",95113708,95114461,753
"25279","ENSG00000229066","2",175257250,175463180,205930
"25280","ENSG00000229067","1",91600171,91600321,150
"25281","ENSG00000229068","6",30466452,30467994,1542
"25282","ENSG00000229072","3",40699066,40699338,272
"25283","ENSG00000229081","10",132520827,132522449,1622
"25284","ENSG00000229082","X",131341570,131342425,855
"25285","ENSG00000229083","X",12825840,12826833,993
"25286","ENSG00000229086","21",33164809,33170649,5840
"25287","ENSG00000229087","2",15397435,15397782,347
"25288","ENSG00000229088","22",36178554,36179385,831
"25289","ENSG00000229089","2",94791103,94857282,66179
"25290","ENSG00000229091","7",10451311,10453252,1941
"25291","ENSG00000229092","14",106518582,106519027,445
"25292","ENSG00000229093","11",5291761,5292380,619
"25293","ENSG00000229097","10",70163685,70164124,439
"25294","ENSG00000229102","3",179101366,179147973,46607
"25295","ENSG00000229104","2",138897151,138898098,947
"25296","ENSG00000229105","9",116504283,116562293,58010
"25297","ENSG00000229106","1",23901471,23902737,1266
"25298","ENSG00000229107","22",20667836,20670984,3148
"25299","ENSG00000229108","7",15688378,15696886,8508
"25300","ENSG00000229109","9",83219288,83238463,19175
"25301","ENSG00000229110","7",79124739,79125750,1011
"25302","ENSG00000229111","13",48077137,48079991,2854
"25303","ENSG00000229116","10",44282489,44293998,11509
"25304","ENSG00000229117","12",56116590,56117967,1377
"25305","ENSG00000229118","2",111265283,111279880,14597
"25306","ENSG00000229119","5",166382305,166382599,294
"25307","ENSG00000229120","1",202369526,202370145,619
"25308","ENSG00000229122","2",27061038,27061815,777
"25309","ENSG00000229124","10",17214239,17229985,15746
"25310","ENSG00000229127","2",210030572,210064356,33784
"25311","ENSG00000229131","2",139469775,139477747,7972
"25312","ENSG00000229132","X",92113246,92114461,1215
"25313","ENSG00000229133","1",68242474,68243055,581
"25314","ENSG00000229140","8",128634199,129683770,1049571
"25315","ENSG00000229145","X",46288016,46289128,1112
"25316","ENSG00000229147","13",19152567,19171194,18627
"25317","ENSG00000229150","2",208108233,208112511,4278
"25318","ENSG00000229151","X",51190598,51396462,205864
"25319","ENSG00000229152","13",110894639,110899172,4533
"25320","ENSG00000229153","7",143407813,143523449,115636
"25321","ENSG00000229154","6",73130646,73143514,12868
"25322","ENSG00000229155","3",193842560,193844024,1464
"25323","ENSG00000229156","9",64462819,64463196,377
"25324","ENSG00000229160","2",38132637,38138946,6309
"25325","ENSG00000229161","7",42794906,42802494,7588
"25326","ENSG00000229162","1",24961345,24963097,1752
"25327","ENSG00000229163","Y",2929001,2931120,2119
"25328","ENSG00000229165","7",48902556,48903891,1335
"25329","ENSG00000229167","1",31571585,31577898,6313
"25330","ENSG00000229168","X",44649129,44649719,590
"25331","ENSG00000229169","22",31538352,31538589,237
"25332","ENSG00000229172","2",227801840,227804705,2865
"25333","ENSG00000229173","2",128139792,128140516,724
"25334","ENSG00000229175","13",79872586,79918042,45456
"25335","ENSG00000229177","7",134346071,134350791,4720
"25336","ENSG00000229178","3",195655565,195657927,2362
"25337","ENSG00000229180","7",66526088,66592397,66309
"25338","ENSG00000229183","11",61222216,61231927,9711
"25339","ENSG00000229184","9",2900320,2900804,484
"25340","ENSG00000229188","20",33728931,33731828,2897
"25341","ENSG00000229190","10",17695709,17700232,4523
"25342","ENSG00000229191","1",201023949,201028792,4843
"25343","ENSG00000229192","7",47000620,47079128,78508
"25344","ENSG00000229195","2",165794857,165846091,51234
"25345","ENSG00000229196","7",130141707,130142618,911
"25346","ENSG00000229197","10",69300432,69300817,385
"25347","ENSG00000229201","1",90510910,90533472,22562
"25348","ENSG00000229203","2",131829801,131832031,2230
"25349","ENSG00000229204","4",169791221,169791702,481
"25350","ENSG00000229205","10",1159768,1289426,129658
"25351","ENSG00000229206","10",11030334,11030868,534
"25352","ENSG00000229207","9",34318407,34319655,1248
"25353","ENSG00000229209","2",103109759,103176260,66501
"25354","ENSG00000229211","8",31219894,31220984,1090
"25355","ENSG00000229212","15",85180200,85234795,54595
"25356","ENSG00000229214","6",169788790,169799549,10759
"25357","ENSG00000229217","3",10057973,10058287,314
"25358","ENSG00000229220","1",200147531,200148279,748
"25359","ENSG00000229221","2",63751697,63752630,933
"25360","ENSG00000229222","20",49956745,49958032,1287
"25361","ENSG00000229224","2",29088649,29097586,8937
"25362","ENSG00000229226","4",168598240,168598757,517
"25363","ENSG00000229227","10",46597918,46612154,14236
"25364","ENSG00000229228","1",231591292,231612090,20798
"25365","ENSG00000229229","2",70402934,70422678,19744
"25366","ENSG00000229230","20",35218009,35218185,176
"25367","ENSG00000229235","10",34663859,34664101,242
"25368","ENSG00000229236","Y",20464916,20575519,110603
"25369","ENSG00000229237","X",154817099,154817401,302
"25370","ENSG00000229238","Y",26277923,26354418,76495
"25371","ENSG00000229239","1",23670294,23680259,9965
"25372","ENSG00000229240","10",10917866,10952234,34368
"25373","ENSG00000229241","3",3981981,3984295,2314
"25374","ENSG00000229243","3",27830886,27834136,3250
"25375","ENSG00000229246","13",81018176,81044691,26515
"25376","ENSG00000229249","13",77997909,78053604,55695
"25377","ENSG00000229251","7",84983556,84984506,950
"25378","ENSG00000229255","1",248484245,248485484,1239
"25379","ENSG00000229256","10",103215709,103216800,1091
"25380","ENSG00000229258","1",211829636,211853703,24067
"25381","ENSG00000229259","1",32423214,32426789,3575
"25382","ENSG00000229261","10",69215333,69232490,17157
"25383","ENSG00000229262","20",18059493,18071008,11515
"25384","ENSG00000229263","7",30796691,30803410,6719
"25385","ENSG00000229267","2",214810181,214963575,153394
"25386","ENSG00000229268","9",13986175,13987909,1734
"25387","ENSG00000229269","X",140931738,140997448,65710
"25388","ENSG00000229271","3",16687986,16697479,9493
"25389","ENSG00000229272","10",118784563,119029544,244981
"25390","ENSG00000229273","9",39809562,39810019,457
"25391","ENSG00000229274","6",29497475,29510558,13083
"25392","ENSG00000229276","6",111360641,111361607,966
"25393","ENSG00000229278","10",99651595,99659284,7689
"25394","ENSG00000229282","6",3055849,3057357,1508
"25395","ENSG00000229283","1",111317600,111323981,6381
"25396","ENSG00000229289","21",19130523,19134423,3900
"25397","ENSG00000229291","1",235957879,235971825,13946
"25398","ENSG00000229292","19",55769141,55773179,4038
"25399","ENSG00000229294","1",65279456,65306521,27065
"25400","ENSG00000229297","9",106584142,106591952,7810
"25401","ENSG00000229298","9",21811621,21812347,726
"25402","ENSG00000229301","7",63354457,63359306,4849
"25403","ENSG00000229303","13",45436121,45436660,539
"25404","ENSG00000229305","1",8189824,8192770,2946
"25405","ENSG00000229306","21",12999676,13016692,17016
"25406","ENSG00000229307","13",62323657,62328833,5176
"25407","ENSG00000229308","Y",4036497,4100320,63823
"25408","ENSG00000229309","13",81250438,81302407,51969
"25409","ENSG00000229311","9",42579414,42586534,7120
"25410","ENSG00000229312","9",69472466,69494513,22047
"25411","ENSG00000229313","6",25041839,25056664,14825
"25412","ENSG00000229314","9",114323056,114326475,3419
"25413","ENSG00000229315","6",99993934,100107613,113679
"25414","ENSG00000229320","3",160565447,160569248,3801
"25415","ENSG00000229321","2",206798325,206926876,128551
"25416","ENSG00000229324","X",71016531,71016905,374
"25417","ENSG00000229325","3",195280723,195282741,2018
"25418","ENSG00000229326","2",119698623,119700151,1528
"25419","ENSG00000229330","17",66676372,66677404,1032
"25420","ENSG00000229331","X",30671635,30672166,531
"25421","ENSG00000229334","3",194632923,194645401,12478
"25422","ENSG00000229335","X",115840964,115843050,2086
"25423","ENSG00000229336","21",19739709,19740150,441
"25424","ENSG00000229337","2",177111036,177212662,101626
"25425","ENSG00000229338","9",98890590,98891937,1347
"25426","ENSG00000229339","3",42051181,42051694,513
"25427","ENSG00000229344","1",632757,633438,681
"25428","ENSG00000229345","9",95599438,95606326,6888
"25429","ENSG00000229348","1",43453927,43456995,3068
"25430","ENSG00000229349","6",46204729,46207386,2657
"25431","ENSG00000229352","2",216799608,216805335,5727
"25432","ENSG00000229356","21",44450986,44455284,4298
"25433","ENSG00000229357","1",150903896,150904213,317
"25434","ENSG00000229358","7",32580949,32761787,180838
"25435","ENSG00000229359","1",69919322,69920317,995
"25436","ENSG00000229360","2",106940880,106941482,602
"25437","ENSG00000229367","1",229570532,229570796,264
"25438","ENSG00000229368","11",3854612,3855399,787
"25439","ENSG00000229369","9",127300093,127300982,889
"25440","ENSG00000229370","2",13537673,13609168,71495
"25441","ENSG00000229372","1",43447776,43448644,868
"25442","ENSG00000229373","13",113888306,113923512,35206
"25443","ENSG00000229375","13",19015487,19019336,3849
"25444","ENSG00000229376","1",722092,724903,2811
"25445","ENSG00000229379","7",15841297,15842360,1063
"25446","ENSG00000229380","7",561958,565619,3661
"25447","ENSG00000229382","21",45336707,45338665,1958
"25448","ENSG00000229384","X",36211096,36211635,539
"25449","ENSG00000229385","2",79492704,79513900,21196
"25450","ENSG00000229388","1",28643228,28648581,5353
"25451","ENSG00000229389","15",30052942,30073064,20122
"25452","ENSG00000229390","6",29970801,29972464,1663
"25453","ENSG00000229391","6",32552713,32560022,7309
"25454","ENSG00000229393","1",2493437,2494479,1042
"25455","ENSG00000229399","1",222641414,222641858,444
"25456","ENSG00000229400","1",224717504,224730662,13158
"25457","ENSG00000229401","6",10434316,10456781,22465
"25458","ENSG00000229402","14",99158416,99159669,1253
"25459","ENSG00000229403","7",51614251,51630870,16619
"25460","ENSG00000229404","10",84267747,84294659,26912
"25461","ENSG00000229405","2",7736438,7737095,657
"25462","ENSG00000229406","Y",18453150,18472137,18987
"25463","ENSG00000229407","1",179816184,179818191,2007
"25464","ENSG00000229409","22",49845929,49846090,161
"25465","ENSG00000229413","7",128653690,128654019,329
"25466","ENSG00000229414","11",2840135,2861568,21433
"25467","ENSG00000229415","14",36473288,36513829,40541
"25468","ENSG00000229417","10",96189366,96190219,853
"25469","ENSG00000229419","9",105520128,105526359,6231
"25470","ENSG00000229422","9",62837139,62838302,1163
"25471","ENSG00000229423","13",47766640,47767085,445
"25472","ENSG00000229424","7",36750687,36763081,12394
"25473","ENSG00000229425","21",15368966,15627342,258376
"25474","ENSG00000229427","13",31311289,31312921,1632
"25475","ENSG00000229431","1",43385113,43389155,4042
"25476","ENSG00000229433","3",184725013,184773178,48165
"25477","ENSG00000229434","2",176506245,176507702,1457
"25478","ENSG00000229435","7",159231435,159233377,1942
"25479","ENSG00000229436","7",80662331,80662585,254
"25480","ENSG00000229437","13",38567715,38622671,54956
"25481","ENSG00000229442","18",8486997,8513849,26852
"25482","ENSG00000229443","13",88494789,88607814,113025
"25483","ENSG00000229444","1",43709392,43727343,17951
"25484","ENSG00000229447","1",31263245,31263681,436
"25485","ENSG00000229452","7",29080284,29082527,2243
"25486","ENSG00000229453","3",48306842,48328341,21499
"25487","ENSG00000229454","9",85756042,85765112,9070
"25488","ENSG00000229455","10",124489823,124490578,755
"25489","ENSG00000229456","13",40618738,40621348,2610
"25490","ENSG00000229457","2",107254691,107365873,111182
"25491","ENSG00000229458","10",82224213,82229179,4966
"25492","ENSG00000229459","7",46261064,46294469,33405
"25493","ENSG00000229463","1",235839483,235840182,699
"25494","ENSG00000229466","10",105808225,105820349,12124
"25495","ENSG00000229468","3",20012452,20012606,154
"25496","ENSG00000229473","13",40992779,40993331,552
"25497","ENSG00000229474","15",44665732,44711316,45584
"25498","ENSG00000229483","13",23169835,23170597,762
"25499","ENSG00000229484","1",12527724,12528420,696
"25500","ENSG00000229485","10",42149310,42149549,239
"25501","ENSG00000229487","X",111706649,111711101,4452
"25502","ENSG00000229491","X",45183251,45333917,150666
"25503","ENSG00000229492","22",17418697,17419828,1131
"25504","ENSG00000229494","2",78088729,78127806,39077
"25505","ENSG00000229495","6",78809715,78813303,3588
"25506","ENSG00000229497","7",43767290,43767599,309
"25507","ENSG00000229498","2",85815130,85825391,10261
"25508","ENSG00000229500","20",20253303,20253838,535
"25509","ENSG00000229502","6",157872571,157875210,2639
"25510","ENSG00000229503","2",62532583,62533059,476
"25511","ENSG00000229508","7",57060590,57061301,711
"25512","ENSG00000229512","11",1763009,1763749,740
"25513","ENSG00000229515","3",46142358,46143677,1319
"25514","ENSG00000229519","1",6547905,6548619,714
"25515","ENSG00000229520","13",112106095,112106882,787
"25516","ENSG00000229521","13",77080511,77081190,679
"25517","ENSG00000229522","20",47983404,47984313,909
"25518","ENSG00000229525","2",219388496,219403633,15137
"25519","ENSG00000229526","17",18450244,18475920,25676
"25520","ENSG00000229528","1",40863914,40876670,12756
"25521","ENSG00000229530","9",92339658,92341663,2005
"25522","ENSG00000229531","1",174934947,174954261,19314
"25523","ENSG00000229533","7",19144293,19146253,1960
"25524","ENSG00000229534","11",5571247,5572192,945
"25525","ENSG00000229536","2",129825126,129877664,52538
"25526","ENSG00000229537","1",62975751,63022504,46753
"25527","ENSG00000229539","20",3888239,3888868,629
"25528","ENSG00000229541","9",100975668,100976682,1014
"25529","ENSG00000229544","10",124445243,124450035,4792
"25530","ENSG00000229547","X",84934151,84934890,739
"25531","ENSG00000229549","Y",9357797,9360599,2802
"25532","ENSG00000229550","2",4136644,4140731,4087
"25533","ENSG00000229557","13",91127613,91131407,3794
"25534","ENSG00000229558","13",23418971,23428869,9898
"25535","ENSG00000229559","6",37543553,37547280,3727
"25536","ENSG00000229560","2",82268427,82269927,1500
"25537","ENSG00000229562","X",137660519,137662242,1723
"25538","ENSG00000229563","X",45505388,45632121,126733
"25539","ENSG00000229565","4",117834145,117869960,35815
"25540","ENSG00000229567","1",93278961,93279129,168
"25541","ENSG00000229568","2",136544712,136545542,830
"25542","ENSG00000229569","10",79000484,79003803,3319
"25543","ENSG00000229570","1",119495836,119496841,1005
"25544","ENSG00000229578","13",61997136,62029572,32436
"25545","ENSG00000229582","9",125743754,125746552,2798
"25546","ENSG00000229585","4",53986587,53987058,471
"25547","ENSG00000229586","17",20481330,20483991,2661
"25548","ENSG00000229587","9",75009828,75016036,6208
"25549","ENSG00000229588","1",166165911,166339090,173179
"25550","ENSG00000229589","3",38451027,38454820,3793
"25551","ENSG00000229590","17",58157028,58157800,772
"25552","ENSG00000229591","7",152120001,152121717,1716
"25553","ENSG00000229593","2",25079901,25081689,1788
"25554","ENSG00000229594","X",55633031,55635656,2625
"25555","ENSG00000229595","1",231117831,231118325,494
"25556","ENSG00000229596","6",33338978,33339495,517
"25557","ENSG00000229598","22",38722743,38723505,762
"25558","ENSG00000229599","13",100934023,100944553,10530
"25559","ENSG00000229601","X",71413834,71414086,252
"25560","ENSG00000229603","7",108909453,108952666,43213
"25561","ENSG00000229604","2",87824942,87825143,201
"25562","ENSG00000229605","10",28898996,28899484,488
"25563","ENSG00000229606","20",61079049,61083750,4701
"25564","ENSG00000229608","22",42784462,42787100,2638
"25565","ENSG00000229609","13",27373348,27374366,1018
"25566","ENSG00000229611","9",6704270,6707780,3510
"25567","ENSG00000229612","1",168898136,168898439,303
"25568","ENSG00000229613","9",90462899,90583821,120922
"25569","ENSG00000229616","10",80017713,80017911,198
"25570","ENSG00000229618","7",12726152,13751920,1025768
"25571","ENSG00000229619","3",152245262,152269557,24295
"25572","ENSG00000229621","2",21687430,21710656,23226
"25573","ENSG00000229622","13",95692538,95693972,1434
"25574","ENSG00000229623","21",39235386,39236020,634
"25575","ENSG00000229625","8",98961428,98968284,6856
"25576","ENSG00000229626","7",107808734,107809568,834
"25577","ENSG00000229627","7",57638725,57639112,387
"25578","ENSG00000229628","7",45990905,46000898,9993
"25579","ENSG00000229629","10",102089968,102090062,94
"25580","ENSG00000229635","1",93384487,93384998,511
"25581","ENSG00000229637","17",48723185,48724758,1573
"25582","ENSG00000229638","3",185417495,185418778,1283
"25583","ENSG00000229639","1",69433255,69435409,2154
"25584","ENSG00000229642","3",5962842,6124120,161278
"25585","ENSG00000229643","Y",6357219,6369921,12702
"25586","ENSG00000229644","10",36521721,36524234,2513
"25587","ENSG00000229646","6",14597514,14599690,2176
"25588","ENSG00000229647","2",207166120,207248668,82548
"25589","ENSG00000229648","2",85490930,85491780,850
"25590","ENSG00000229649","10",101252821,101263550,10729
"25591","ENSG00000229652","1",203353365,203353651,286
"25592","ENSG00000229654","6",106695535,106699994,4459
"25593","ENSG00000229656","10",32958437,33082102,123665
"25594","ENSG00000229657","1",204946608,204947169,561
"25595","ENSG00000229659","10",73422259,73422696,437
"25596","ENSG00000229660","7",157281536,157282686,1150
"25597","ENSG00000229661","X",75201491,75201790,299
"25598","ENSG00000229662","X",48244894,48245745,851
"25599","ENSG00000229663","1",248771635,248773792,2157
"25600","ENSG00000229664","10",6025978,6036427,10449
"25601","ENSG00000229666","5",67001383,67003953,2570
"25602","ENSG00000229668","10",114501997,114502347,350
"25603","ENSG00000229670","2",209178966,209181123,2157
"25604","ENSG00000229671","11",1897015,1908656,11641
"25605","ENSG00000229672","10",3748966,3763712,14746
"25606","ENSG00000229674","X",37994252,37994918,666
"25607","ENSG00000229676","19",22634324,22667671,33347
"25608","ENSG00000229677","7",139049456,139050006,550
"25609","ENSG00000229679","7",36229280,36231107,1827
"25610","ENSG00000229688","7",16210484,16270604,60120
"25611","ENSG00000229689","2",95525345,95532405,7060
"25612","ENSG00000229690","20",60414396,60414872,476
"25613","ENSG00000229692","2",38992279,38993857,1578
"25614","ENSG00000229694","9",91118592,91182762,64170
"25615","ENSG00000229695","2",43680465,43681622,1157
"25616","ENSG00000229696","13",41925598,41927349,1751
"25617","ENSG00000229697","9",61898805,61911022,12217
"25618","ENSG00000229699","1",153174518,153191676,17158
"25619","ENSG00000229700","6",20042455,20042940,485
"25620","ENSG00000229701","2",155264163,155264823,660
"25621","ENSG00000229703","1",248691760,248716755,24995
"25622","ENSG00000229704","3",185245460,185246441,981
"25623","ENSG00000229711","10",50822692,50824525,1833
"25624","ENSG00000229715","13",31952580,31953361,781
"25625","ENSG00000229716","1",8831007,8831375,368
"25626","ENSG00000229717","4",75822966,75838389,15423
"25627","ENSG00000229719","11",64889560,64893449,3889
"25628","ENSG00000229720","6",169034197,169035642,1445
"25629","ENSG00000229721","5",180226378,180227000,622
"25630","ENSG00000229722","6",134606299,134609437,3138
"25631","ENSG00000229723","13",114329559,114333948,4389
"25632","ENSG00000229727","2",7383227,7450544,67317
"25633","ENSG00000229728","20",1361622,1362585,963
"25634","ENSG00000229731","X",27811885,27812902,1017
"25635","ENSG00000229733","X",123558350,123558584,234
"25636","ENSG00000229735","X",38484752,38485264,512
"25637","ENSG00000229738","5",132987652,132988110,458
"25638","ENSG00000229739","1",186423481,186626619,203138
"25639","ENSG00000229740","2",8139335,8144950,5615
"25640","ENSG00000229742","1",224297646,224298600,954
"25641","ENSG00000229743","2",104865407,104872595,7188
"25642","ENSG00000229749","17",16853935,16854309,374
"25643","ENSG00000229750","2",175167904,175168522,618
"25644","ENSG00000229751","10",13991815,14007526,15711
"25645","ENSG00000229752","1",81098267,81099005,738
"25646","ENSG00000229753","9",72741152,72741617,465
"25647","ENSG00000229754","2",218059155,218065729,6574
"25648","ENSG00000229757","1",168578653,168579439,786
"25649","ENSG00000229758","2",128199901,128200195,294
"25650","ENSG00000229759","3",48256350,48256938,588
"25651","ENSG00000229761","21",35724747,35725100,353
"25652","ENSG00000229762","7",55810779,55811411,632
"25653","ENSG00000229765","6",10213881,10214362,481
"25654","ENSG00000229766","20",8019180,8043512,24332
"25655","ENSG00000229769","7",142424965,142425465,500
"25656","ENSG00000229770","22",26161905,26169341,7436
"25657","ENSG00000229771","20",40696499,40698616,2117
"25658","ENSG00000229774","2",120686635,120710517,23882
"25659","ENSG00000229775","10",106140143,106188722,48579
"25660","ENSG00000229779","2",175904371,175905502,1131
"25661","ENSG00000229780","1",154553609,154555017,1408
"25662","ENSG00000229781","2",142854095,142855998,1903
"25663","ENSG00000229782","17",4497394,4499674,2280
"25664","ENSG00000229785","1",172748560,172749502,942
"25665","ENSG00000229786","1",25887360,25887610,250
"25666","ENSG00000229791","13",19408042,19409529,1487
"25667","ENSG00000229792","13",109400696,109401641,945
"25668","ENSG00000229794","X",102806741,102807824,1083
"25669","ENSG00000229795","1",235432985,235433231,246
"25670","ENSG00000229797","2",130742959,130755879,12920
"25671","ENSG00000229798","2",74306728,74308008,1280
"25672","ENSG00000229800","13",32477274,32478841,1567
"25673","ENSG00000229805","2",56077417,56090382,12965
"25674","ENSG00000229806","3",54626215,54626646,431
"25675","ENSG00000229807","X",73820649,73852723,32074
"25676","ENSG00000229808","1",161890833,161892196,1363
"25677","ENSG00000229809","16",30569346,30572734,3388
"25678","ENSG00000229814","9",71589601,71589933,332
"25679","ENSG00000229815","1",44958557,44959395,838
"25680","ENSG00000229816","2",32201600,32203999,2399
"25681","ENSG00000229817","9",114845594,114848585,2991
"25682","ENSG00000229820","1",28453541,28453934,393
"25683","ENSG00000229821","1",201222113,201223123,1010
"25684","ENSG00000229822","X",41748222,41748608,386
"25685","ENSG00000229827","2",169577371,169577746,375
"25686","ENSG00000229828","1",148080598,148093883,13285
"25687","ENSG00000229829","X",149817170,149817644,474
"25688","ENSG00000229831","2",61820208,61820566,358
"25689","ENSG00000229832","1",212357418,212358353,935
"25690","ENSG00000229833","19",7629737,7631956,2219
"25691","ENSG00000229836","6",31307815,31308549,734
"25692","ENSG00000229839","2",62069447,62146881,77434
"25693","ENSG00000229840","1",229042171,229042591,420
"25694","ENSG00000229842","1",93925406,93926072,666
"25695","ENSG00000229846","1",49025595,49187585,161990
"25696","ENSG00000229847","10",117473215,117545068,71853
"25697","ENSG00000229848","17",81514047,81527776,13729
"25698","ENSG00000229849","1",158878746,158883500,4754
"25699","ENSG00000229852","6",73263212,73301789,38577
"25700","ENSG00000229853","20",47630266,47631438,1172
"25701","ENSG00000229854","9",121574891,121576214,1323
"25702","ENSG00000229855","5",121164687,121359869,195182
"25703","ENSG00000229857","9",76992099,76993108,1009
"25704","ENSG00000229858","7",130822868,130823219,351
"25705","ENSG00000229859","11",61203307,61213098,9791
"25706","ENSG00000229862","6",73523618,73570596,46978
"25707","ENSG00000229863","3",57134142,57134723,581
"25708","ENSG00000229865","13",78422823,78423192,369
"25709","ENSG00000229867","2",119244422,119270714,26292
"25710","ENSG00000229869","10",933026,942743,9717
"25711","ENSG00000229870","10",49815096,49815562,466
"25712","ENSG00000229871","1",56207567,56208456,889
"25713","ENSG00000229873","20",62800627,62805587,4960
"25714","ENSG00000229875","9",659986,660326,340
"25715","ENSG00000229876","20",6446723,6528459,81736
"25716","ENSG00000229877","7",143545186,143546735,1549
"25717","ENSG00000229878","10",33035469,33035664,195
"25718","ENSG00000229880","21",44675868,44678086,2218
"25719","ENSG00000229882","20",62633772,62635862,2090
"25720","ENSG00000229886","7",66025126,66031544,6418
"25721","ENSG00000229887","1",58047889,58049335,1446
"25722","ENSG00000229891","22",42364390,42369284,4894
"25723","ENSG00000229893","7",27733064,27740395,7331
"25724","ENSG00000229894","4",165277812,165279679,1867
"25725","ENSG00000229896","6",12007670,12008856,1186
"25726","ENSG00000229897","9",98606833,98608133,1300
"25727","ENSG00000229899","12",40286289,40286662,373
"25728","ENSG00000229900","20",45539983,45540227,244
"25729","ENSG00000229901","1",41375004,41375669,665
"25730","ENSG00000229905","1",760911,761989,1078
"25731","ENSG00000229906","13",51496020,51496251,231
"25732","ENSG00000229909","7",56631739,56632727,988
"25733","ENSG00000229912","3",197450327,197456654,6327
"25734","ENSG00000229913","1",56823679,56826920,3241
"25735","ENSG00000229914","1",158195633,158196131,498
"25736","ENSG00000229915","2",238427077,238427729,652
"25737","ENSG00000229917","16",11027024,11027763,739
"25738","ENSG00000229918","13",98832084,98834629,2545
"25739","ENSG00000229920","2",63642455,63644038,1583
"25740","ENSG00000229921","6",167992822,167997110,4288
"25741","ENSG00000229922","6",137945366,137972522,27156
"25742","ENSG00000229923","6",130697312,130697778,466
"25743","ENSG00000229924","4",9170409,9176730,6321
"25744","ENSG00000229925","21",38888772,38903905,15133
"25745","ENSG00000229926","9",138137095,138143864,6769
"25746","ENSG00000229927","10",46634911,46635466,555
"25747","ENSG00000229930","1",224030704,224035056,4352
"25748","ENSG00000229931","6",16761138,16762652,1514
"25749","ENSG00000229932","10",23136924,23137661,737
"25750","ENSG00000229937","7",18026770,18027846,1076
"25751","ENSG00000229938","13",109101261,109101919,658
"25752","ENSG00000229939","X",111618808,111619094,286
"25753","ENSG00000229941","2",177653419,177723289,69870
"25754","ENSG00000229944","17",49424269,49424922,653
"25755","ENSG00000229948","2",69597353,69598951,1598
"25756","ENSG00000229949","7",21400920,21401613,693
"25757","ENSG00000229950","6",10409340,10416446,7106
"25758","ENSG00000229951","2",28384409,28394672,10263
"25759","ENSG00000229953","1",156646507,156661424,14917
"25760","ENSG00000229954","X",102786813,102788387,1574
"25761","ENSG00000229955","22",38387918,38388857,939
"25762","ENSG00000229956","1",71081324,71489976,408652
"25763","ENSG00000229957","20",46168404,46171237,2833
"25764","ENSG00000229960","1",244068820,244093026,24206
"25765","ENSG00000229961","1",157171116,157191963,20847
"25766","ENSG00000229964","3",194091561,194109174,17613
"25767","ENSG00000229965","1",226438564,226439344,780
"25768","ENSG00000229967","X",151904431,151913968,9537
"25769","ENSG00000229968","X",47776827,47778697,1870
"25770","ENSG00000229969","10",87009785,87015782,5997
"25771","ENSG00000229970","7",8262264,8344516,82252
"25772","ENSG00000229972","3",51826883,51830856,3973
"25773","ENSG00000229975","13",102002125,102003310,1185
"25774","ENSG00000229976","20",39757202,39815097,57895
"25775","ENSG00000229979","X",153052150,153052413,263
"25776","ENSG00000229980","17",50866679,50910774,44095
"25777","ENSG00000229981","10",107694973,108197849,502876
"25778","ENSG00000229983","1",212168207,212190259,22052
"25779","ENSG00000229985","1",27176751,27177277,526
"25780","ENSG00000229986","21",38846247,38848644,2397
"25781","ENSG00000229988","11",5241105,5243537,2432
"25782","ENSG00000229989","1",198777861,198937471,159610
"25783","ENSG00000229990","10",73841833,73847115,5282
"25784","ENSG00000229991","1",224574434,224575389,955
"25785","ENSG00000229992","1",92647048,92647630,582
"25786","ENSG00000229994","1",35350722,35351607,885
"25787","ENSG00000229996","2",241010045,241010744,699
"25788","ENSG00000229999","22",40372664,40388290,15626
"25789","ENSG00000230000","7",63348861,63351774,2913
"25790","ENSG00000230001","9",4070906,4071884,978
"25791","ENSG00000230002","2",73456764,73459482,2718
"25792","ENSG00000230005","1",227743831,227747191,3360
"25793","ENSG00000230006","2",88765807,88806612,40805
"25794","ENSG00000230009","13",57204379,57204799,420
"25795","ENSG00000230010","20",18289343,18359300,69957
"25796","ENSG00000230011","10",50705380,50708906,3526
"25797","ENSG00000230013","9",104970593,104991818,21225
"25798","ENSG00000230014","10",9275833,9287057,11224
"25799","ENSG00000230015","1",240739419,240739853,434
"25800","ENSG00000230018","10",113482616,113483113,497
"25801","ENSG00000230020","X",17552349,17557387,5038
"25802","ENSG00000230021","1",586071,827796,241725
"25803","ENSG00000230022","13",21530690,21531323,633
"25804","ENSG00000230023","1",24200240,24211693,11453
"25805","ENSG00000230026","1",235361153,235362540,1387
"25806","ENSG00000230027","1",76041691,76066349,24658
"25807","ENSG00000230030","9",108252154,108254820,2666
"25808","ENSG00000230033","7",156944721,156945645,924
"25809","ENSG00000230035","1",18166929,18179346,12417
"25810","ENSG00000230037","2",136329441,136329913,472
"25811","ENSG00000230039","X",65821255,65822249,994
"25812","ENSG00000230040","13",67326177,67379994,53817
"25813","ENSG00000230042","7",23129178,23129841,663
"25814","ENSG00000230046","2",32377631,32379599,1968
"25815","ENSG00000230047","2",231437101,231437421,320
"25816","ENSG00000230051","22",27331634,27379265,47631
"25817","ENSG00000230052","7",64105654,64105995,341
"25818","ENSG00000230053","1",88498309,88498676,367
"25819","ENSG00000230054","9",114656304,114662374,6070
"25820","ENSG00000230061","21",44414588,44425272,10684
"25821","ENSG00000230062","6",46746917,46759506,12589
"25822","ENSG00000230063","1",212297448,212299579,2131
"25823","ENSG00000230065","2",132660526,132666990,6464
"25824","ENSG00000230067","3",36767117,36784167,17050
"25825","ENSG00000230068","1",22059197,22064199,5002
"25826","ENSG00000230069","4",102727274,102730721,3447
"25827","ENSG00000230071","22",40586700,40588003,1303
"25828","ENSG00000230074","9",34665607,34774466,108859
"25829","ENSG00000230076","2",214847128,214847445,317
"25830","ENSG00000230077","3",189969030,189969861,831
"25831","ENSG00000230079","X",136295690,136300298,4608
"25832","ENSG00000230080","11",1802889,1804095,1206
"25833","ENSG00000230081","9",112280978,112281335,357
"25834","ENSG00000230082","3",9947404,9954787,7383
"25835","ENSG00000230084","3",42601963,42654388,52425
"25836","ENSG00000230086","19",40121311,40122168,857
"25837","ENSG00000230088","17",20493634,20494155,521
"25838","ENSG00000230090","2",5618327,5691118,72791
"25839","ENSG00000230091","10",80046860,80078912,32052
"25840","ENSG00000230092","1",800879,817712,16833
"25841","ENSG00000230096","10",4415305,4426179,10874
"25842","ENSG00000230097","9",29824742,29826711,1969
"25843","ENSG00000230098","10",131095218,131095777,559
"25844","ENSG00000230099","7",142462916,142463581,665
"25845","ENSG00000230100","X",48333675,48334439,764
"25846","ENSG00000230101","7",134734898,134735129,231
"25847","ENSG00000230102","3",194005259,194071025,65766
"25848","ENSG00000230104","2",172674212,172674898,686
"25849","ENSG00000230105","X",56618391,56624458,6067
"25850","ENSG00000230107","22",42438023,42446195,8172
"25851","ENSG00000230109","10",21340233,21372950,32717
"25852","ENSG00000230112","10",20841375,20841560,185
"25853","ENSG00000230113","17",30956280,30956961,681
"25854","ENSG00000230114","1",49257411,49269285,11874
"25855","ENSG00000230115","3",189238686,189240594,1908
"25856","ENSG00000230116","1",42491739,42492493,754
"25857","ENSG00000230118","2",30746444,30746701,257
"25858","ENSG00000230120","22",32159454,32160392,938
"25859","ENSG00000230121","10",7533207,7536565,3358
"25860","ENSG00000230123","3",38325237,38329070,3833
"25861","ENSG00000230124","1",180269653,180502954,233301
"25862","ENSG00000230125","10",30301823,30302072,249
"25863","ENSG00000230126","3",192515022,192516573,1551
"25864","ENSG00000230131","10",123356450,123537767,181317
"25865","ENSG00000230132","7",63480598,63480989,391
"25866","ENSG00000230133","20",24063255,24226013,162758
"25867","ENSG00000230137","22",30439837,30440318,481
"25868","ENSG00000230138","1",53366656,53368245,1589
"25869","ENSG00000230140","2",100970767,100977766,6999
"25870","ENSG00000230142","13",62212577,62249947,37370
"25871","ENSG00000230146","X",73769248,73770423,1175
"25872","ENSG00000230147","9",91169585,91170045,460
"25873","ENSG00000230148","17",48543551,48551250,7699
"25874","ENSG00000230149","22",38734730,38738990,4260
"25875","ENSG00000230153","X",150915813,150920938,5125
"25876","ENSG00000230154","2",11308025,11308941,916
"25877","ENSG00000230155","20",35476203,35490982,14779
"25878","ENSG00000230156","13",106653897,106672177,18280
"25879","ENSG00000230157","14",105536861,105537239,378
"25880","ENSG00000230159","X",116692910,116694188,1278
"25881","ENSG00000230160","7",44919669,44920329,660
"25882","ENSG00000230162","X",135942478,135947139,4661
"25883","ENSG00000230163","1",34850694,34851555,861
"25884","ENSG00000230164","6",29475025,29476071,1046
"25885","ENSG00000230166","10",49909613,49909942,329
"25886","ENSG00000230169","8",112538889,112539317,428
"25887","ENSG00000230170","X",119220782,119221742,960
"25888","ENSG00000230171","10",80125941,80126317,376
"25889","ENSG00000230172","3",14764952,14767440,2488
"25890","ENSG00000230174","6",31441667,31446973,5306
"25891","ENSG00000230175","1",165671256,165671725,469
"25892","ENSG00000230176","20",4192932,4195953,3021
"25893","ENSG00000230177","6",111273329,111278744,5415
"25894","ENSG00000230178","5",181367268,181368262,994
"25895","ENSG00000230180","X",16803233,16803353,120
"25896","ENSG00000230183","15",56005715,56007176,1461
"25897","ENSG00000230184","1",246321663,246322438,775
"25898","ENSG00000230185","9",112399512,112487204,87692
"25899","ENSG00000230186","1",143905487,143934776,29289
"25900","ENSG00000230188","9",37490421,37490893,472
"25901","ENSG00000230189","7",66427949,66453634,25685
"25902","ENSG00000230190","7",147671711,147673143,1432
"25903","ENSG00000230191","7",56163145,56163533,388
"25904","ENSG00000230194","22",19238443,19238739,296
"25905","ENSG00000230196","7",81610884,81611326,442
"25906","ENSG00000230198","21",19593841,19594108,267
"25907","ENSG00000230201","17",4856757,4857374,617
"25908","ENSG00000230202","6",117998975,117999448,473
"25909","ENSG00000230203","22",26422071,26423193,1122
"25910","ENSG00000230204","6",50912712,50913256,544
"25911","ENSG00000230205","6",148133809,148137404,3595
"25912","ENSG00000230207","9",7477045,7478320,1275
"25913","ENSG00000230212","21",36069642,36126640,56998
"25914","ENSG00000230215","3",184546714,184556918,10204
"25915","ENSG00000230216","X",49233956,49234501,545
"25916","ENSG00000230219","4",183037665,183040119,2454
"25917","ENSG00000230221","9",95292338,95294810,2472
"25918","ENSG00000230223","13",70107213,70149092,41879
"25919","ENSG00000230224","10",100248271,100249095,824
"25920","ENSG00000230225","9",5109496,5110762,1266
"25921","ENSG00000230226","20",63502287,63505111,2824
"25922","ENSG00000230227","X",35626142,35627064,922
"25923","ENSG00000230228","1",23949016,23949383,367
"25924","ENSG00000230229","10",78352597,78356100,3503
"25925","ENSG00000230231","1",166474745,166481565,6820
"25926","ENSG00000230234","6",160272617,160276130,3513
"25927","ENSG00000230239","1",16855407,16859284,3877
"25928","ENSG00000230240","10",31983885,31984554,669
"25929","ENSG00000230241","X",48135658,48136159,501
"25930","ENSG00000230246","9",87914493,87923505,9012
"25931","ENSG00000230248","6",108275642,108276546,904
"25932","ENSG00000230250","1",55915603,55944980,29377
"25933","ENSG00000230251","2",154286589,154287425,836
"25934","ENSG00000230252","7",64110547,64111550,1003
"25935","ENSG00000230257","7",102973522,102988856,15334
"25936","ENSG00000230258","17",70017324,70128859,111535
"25937","ENSG00000230260","1",197437976,197447469,9493
"25938","ENSG00000230262","9",94176492,94259545,83053
"25939","ENSG00000230266","3",195147871,195152790,4919
"25940","ENSG00000230267","16",32103245,32188107,84862
"25941","ENSG00000230268","7",124476371,124476955,584
"25942","ENSG00000230269","6",3182626,3195784,13158
"25943","ENSG00000230271","7",57772584,57773199,615
"25944","ENSG00000230273","17",17981192,17981572,380
"25945","ENSG00000230274","3",40322715,40323279,564
"25946","ENSG00000230280","1",202911812,202912729,917
"25947","ENSG00000230283","13",37220860,37221246,386
"25948","ENSG00000230284","9",114695922,114696315,393
"25949","ENSG00000230285","1",85599131,85600734,1603
"25950","ENSG00000230286","2",26950308,27009807,59499
"25951","ENSG00000230287","1",100249090,100249311,221
"25952","ENSG00000230289","9",131516558,131522229,5671
"25953","ENSG00000230290","6",108922976,108924103,1127
"25954","ENSG00000230291","12",80102899,80103333,434
"25955","ENSG00000230292","3",175079307,175115242,35935
"25956","ENSG00000230294","12",131347470,131367555,20085
"25957","ENSG00000230295","7",66880708,66882981,2273
"25958","ENSG00000230298","10",30576699,30580182,3483
"25959","ENSG00000230299","2",85262144,85262267,123
"25960","ENSG00000230300","13",33158587,33164409,5822
"25961","ENSG00000230302","9",101793454,101793756,302
"25962","ENSG00000230303","9",85783668,85805154,21486
"25963","ENSG00000230304","3",198223497,198226310,2813
"25964","ENSG00000230305","7",76524515,76532692,8177
"25965","ENSG00000230306","10",133344643,133344906,263
"25966","ENSG00000230310","19",12552597,12553644,1047
"25967","ENSG00000230311","X",73223124,73223558,434
"25968","ENSG00000230312","X",103928099,103929017,918
"25969","ENSG00000230313","6",33144783,33147767,2984
"25970","ENSG00000230314","6",11043482,11079154,35672
"25971","ENSG00000230316","7",122303658,122310119,6461
"25972","ENSG00000230317","X",51095836,51224432,128596
"25973","ENSG00000230319","22",43038585,43052366,13781
"25974","ENSG00000230320","X",102705784,102706240,456
"25975","ENSG00000230321","19",12504905,12505976,1071
"25976","ENSG00000230322","10",11168922,11171376,2454
"25977","ENSG00000230323","21",32080316,32197813,117497
"25978","ENSG00000230324","20",39213777,39224748,10971
"25979","ENSG00000230325","1",236540094,236550280,10186
"25980","ENSG00000230326","X",9865093,9865543,450
"25981","ENSG00000230327","2",50588690,50589415,725
"25982","ENSG00000230328","9",101358932,101361242,2310
"25983","ENSG00000230330","16",26032539,26032811,272
"25984","ENSG00000230333","7",11180902,11520175,339273
"25985","ENSG00000230337","1",11099675,11102100,2425
"25986","ENSG00000230338","10",94774156,94774633,477
"25987","ENSG00000230339","17",20554137,20554380,243
"25988","ENSG00000230342","3",11859674,11891172,31498
"25989","ENSG00000230355","2",66881087,66881222,135
"25990","ENSG00000230356","7",34750253,34752053,1800
"25991","ENSG00000230358","7",67278714,67286664,7950
"25992","ENSG00000230359","7",129055223,129057239,2016
"25993","ENSG00000230360","9",82086155,82088768,2613
"25994","ENSG00000230361","7",63377329,63378233,904
"25995","ENSG00000230362","3",175977497,175978570,1073
"25996","ENSG00000230364","1",171683128,171684438,1310
"25997","ENSG00000230365","9",11275314,11276314,1000
"25998","ENSG00000230366","21",37208503,37221736,13233
"25999","ENSG00000230368","1",868071,876903,8832
"26000","ENSG00000230370","7",11006399,11006876,477
"26001","ENSG00000230371","13",113130416,113132054,1638
"26002","ENSG00000230373","15",84507885,84516814,8929
"26003","ENSG00000230381","1",116429049,116433368,4319
"26004","ENSG00000230383","7",137721985,137722846,861
"26005","ENSG00000230384","2",176242111,176242993,882
"26006","ENSG00000230387","20",23179272,23190419,11147
"26007","ENSG00000230390","13",37481467,37484769,3302
"26008","ENSG00000230391","2",115468056,115468938,882
"26009","ENSG00000230392","X",119291529,119335610,44081
"26010","ENSG00000230393","2",100104919,100107504,2585
"26011","ENSG00000230395","2",87118534,87120980,2446
"26012","ENSG00000230397","10",31360955,31361215,260
"26013","ENSG00000230398","3",2362258,2362738,480
"26014","ENSG00000230399","X",118632375,118634218,1843
"26015","ENSG00000230400","20",22668480,22685344,16864
"26016","ENSG00000230401","3",194765238,194768712,3474
"26017","ENSG00000230402","1",100627049,100640613,13564
"26018","ENSG00000230403","13",30995162,30996138,976
"26019","ENSG00000230404","1",234565298,234570088,4790
"26020","ENSG00000230406","2",221592441,221592861,420
"26021","ENSG00000230407","2",199108584,199110088,1504
"26022","ENSG00000230408","2",200780495,200812170,31675
"26023","ENSG00000230409","3",37275693,37276598,905
"26024","ENSG00000230411","1",247666887,247667841,954
"26025","ENSG00000230415","1",1275223,1280420,5197
"26026","ENSG00000230417","10",78179185,78551355,372170
"26027","ENSG00000230423","6",170627303,170738203,110900
"26028","ENSG00000230424","1",19210501,19240704,30203
"26029","ENSG00000230425","10",42725857,42737159,11302
"26030","ENSG00000230426","1",187070700,187686628,615928
"26031","ENSG00000230427","1",95061596,95067545,5949
"26032","ENSG00000230428","16",451404,453461,2057
"26033","ENSG00000230433","6",524171,525581,1410
"26034","ENSG00000230434","1",95351251,95352676,1425
"26035","ENSG00000230435","7",11406955,11414078,7123
"26036","ENSG00000230437","20",12305613,12316485,10872
"26037","ENSG00000230438","6",2851230,2881407,30177
"26038","ENSG00000230440","20",26132887,26134198,1311
"26039","ENSG00000230442","7",123584859,123624957,40098
"26040","ENSG00000230444","7",1614590,1615325,735
"26041","ENSG00000230445","10",27246350,27259455,13105
"26042","ENSG00000230447","16",30904348,30910208,5860
"26043","ENSG00000230448","2",13710531,14400963,690432
"26044","ENSG00000230449","6",30696806,30697535,729
"26045","ENSG00000230450","2",131177618,131178946,1328
"26046","ENSG00000230451","1",37330852,37330996,144
"26047","ENSG00000230452","2",25204313,25209202,4889
"26048","ENSG00000230453","9",33524394,33573009,48615
"26049","ENSG00000230454","3",50260303,50263358,3055
"26050","ENSG00000230457","3",156809551,156810732,1181
"26051","ENSG00000230459","15",77278465,77278774,309
"26052","ENSG00000230461","1",213817751,213988508,170757
"26053","ENSG00000230465","3",26346681,26347638,957
"26054","ENSG00000230469","10",69778962,69779838,876
"26055","ENSG00000230470","1",184408337,184412360,4023
"26056","ENSG00000230471","22",15600908,15604882,3974
"26057","ENSG00000230474","13",103444620,103444968,348
"26058","ENSG00000230476","Y",22580989,22614081,33092
"26059","ENSG00000230478","X",87425583,87425690,107
"26060","ENSG00000230479","21",36430360,36481070,50710
"26061","ENSG00000230480","3",28447725,28448073,348
"26062","ENSG00000230481","22",16904219,16904696,477
"26063","ENSG00000230482","2",197263111,197263535,424
"26064","ENSG00000230485","22",19630750,19633574,2824
"26065","ENSG00000230487","7",1570073,1589626,19553
"26066","ENSG00000230489","1",107964443,107994607,30164
"26067","ENSG00000230490","13",33355206,33676796,321590
"26068","ENSG00000230491","X",155310247,155310490,243
"26069","ENSG00000230492","20",23010209,23030785,20576
"26070","ENSG00000230495","20",17599255,17599807,552
"26071","ENSG00000230496","2",130275592,130276257,665
"26072","ENSG00000230498","1",77067920,77086402,18482
"26073","ENSG00000230499","2",111195963,111206494,10531
"26074","ENSG00000230500","10",27744786,27767794,23008
"26075","ENSG00000230501","10",45156775,45176925,20150
"26076","ENSG00000230506","20",10172522,10200824,28302
"26077","ENSG00000230507","10",86630825,86631628,803
"26078","ENSG00000230508","X",150993501,150994091,590
"26079","ENSG00000230510","19",46480796,46601200,120404
"26080","ENSG00000230513","22",21001886,21010342,8456
"26081","ENSG00000230515","2",7671604,7672246,642
"26082","ENSG00000230516","9",32643103,32645026,1923
"26083","ENSG00000230519","12",27702338,27702906,568
"26084","ENSG00000230521","6",29887294,29888268,974
"26085","ENSG00000230523","1",29329620,29350114,20494
"26086","ENSG00000230524","3",15151833,15205959,54126
"26087","ENSG00000230525","2",66904436,66971462,67026
"26088","ENSG00000230526","10",71878356,71879107,751
"26089","ENSG00000230528","17",20436337,20447249,10912
"26090","ENSG00000230530","3",45676369,45689200,12831
"26091","ENSG00000230531","7",57194257,57196054,1797
"26092","ENSG00000230533","6",137657998,137763984,105986
"26093","ENSG00000230534","10",35098006,35127020,29014
"26094","ENSG00000230535","13",22897341,22898005,664
"26095","ENSG00000230536","9",128090969,128094457,3488
"26096","ENSG00000230537","9",91104327,91213046,108719
"26097","ENSG00000230539","7",36597834,36600120,2286
"26098","ENSG00000230542","X",2612988,2615347,2359
"26099","ENSG00000230550","1",204141404,204143327,1923
"26100","ENSG00000230551","5",149494314,149504670,10356
"26101","ENSG00000230552","2",176723614,176819310,95696
"26102","ENSG00000230555","10",43420738,43422100,1362
"26103","ENSG00000230556","7",143578907,143579072,165
"26104","ENSG00000230558","19",42560433,42561750,1317
"26105","ENSG00000230561","5",127703389,127941634,238245
"26106","ENSG00000230562","2",157379724,157380414,690
"26107","ENSG00000230563","20",5445838,5475483,29645
"26108","ENSG00000230564","7",55259809,55260256,447
"26109","ENSG00000230565","10",43645942,43648019,2077
"26110","ENSG00000230568","20",3489529,3491005,1476
"26111","ENSG00000230569","2",138470656,138473932,3276
"26112","ENSG00000230570","6",7340854,7342056,1202
"26113","ENSG00000230572","2",91686102,91714745,28643
"26114","ENSG00000230573","10",3833950,3834728,778
"26115","ENSG00000230575","10",76437408,76438775,1367
"26116","ENSG00000230576","1",247833349,247834288,939
"26117","ENSG00000230580","2",218354075,218354572,497
"26118","ENSG00000230581","9",6834456,6835577,1121
"26119","ENSG00000230583","7",66809993,66844882,34889
"26120","ENSG00000230584","13",78908919,78910542,1623
"26121","ENSG00000230585","1",50780340,50781150,810
"26122","ENSG00000230587","2",43092530,43132482,39952
"26123","ENSG00000230590","X",73940435,74293574,353139
"26124","ENSG00000230592","X",100155885,100156773,888
"26125","ENSG00000230593","11",3892398,3892887,489
"26126","ENSG00000230595","2",62561058,62561423,365
"26127","ENSG00000230596","2",110386377,110388163,1786
"26128","ENSG00000230597","6",71328942,71329806,864
"26129","ENSG00000230598","6",29212886,29216933,4047
"26130","ENSG00000230600","7",63380466,63385789,5323
"26131","ENSG00000230601","9",114666434,114682066,15632
"26132","ENSG00000230603","2",109665209,109665742,533
"26133","ENSG00000230604","1",51859778,51860135,357
"26134","ENSG00000230606","2",97416165,97433527,17362
"26135","ENSG00000230607","17",19755244,19756207,963
"26136","ENSG00000230609","10",72560264,72560456,192
"26137","ENSG00000230611","2",191174233,191174835,602
"26138","ENSG00000230612","5",132688681,132723725,35044
"26139","ENSG00000230613","20",31567707,31573263,5556
"26140","ENSG00000230614","7",85381118,85381375,257
"26141","ENSG00000230615","1",44030437,44115913,85476
"26142","ENSG00000230618","3",109409678,109410084,406
"26143","ENSG00000230622","6",31611083,31611356,273
"26144","ENSG00000230623","1",200333193,200478669,145476
"26145","ENSG00000230626","7",129126518,129130793,4275
"26146","ENSG00000230627","6",164108620,164109694,1074
"26147","ENSG00000230628","1",234669523,234696153,26630
"26148","ENSG00000230629","X",70962964,70963293,329
"26149","ENSG00000230630","1",172138397,172144840,6443
"26150","ENSG00000230631","6",14229775,14231570,1795
"26151","ENSG00000230635","9",42950566,42951630,1064
"26152","ENSG00000230637","22",25327252,25339975,12723
"26153","ENSG00000230638","1",41542069,41544310,2241
"26154","ENSG00000230639","7",63965834,63966124,290
"26155","ENSG00000230641","13",27172259,27182998,10739
"26156","ENSG00000230645","2",150169474,150356460,186986
"26157","ENSG00000230646","2",130427731,130429225,1494
"26158","ENSG00000230647","17",14374139,14421472,47333
"26159","ENSG00000230648","6",4018843,4021215,2372
"26160","ENSG00000230649","7",136025717,136084668,58951
"26161","ENSG00000230650","2",110360608,110363737,3129
"26162","ENSG00000230651","2",107823063,107826891,3828
"26163","ENSG00000230654","7",69330698,69331378,680
"26164","ENSG00000230655","3",75370448,75371342,894
"26165","ENSG00000230657","12",11307083,11310435,3352
"26166","ENSG00000230658","7",23100214,23105703,5489
"26167","ENSG00000230659","1",165819353,165819787,434
"26168","ENSG00000230661","10",70485336,70486325,989
"26169","ENSG00000230662","17",18460391,18463055,2664
"26170","ENSG00000230665","X",74396871,74399550,2679
"26171","ENSG00000230666","19",44537058,44620821,83763
"26172","ENSG00000230667","1",92074533,92075441,908
"26173","ENSG00000230668","X",140681106,140689819,8713
"26174","ENSG00000230673","X",74583088,74583546,458
"26175","ENSG00000230676","9",129430652,129451422,20770
"26176","ENSG00000230679","1",8878835,8879894,1059
"26177","ENSG00000230680","7",46477822,46481578,3756
"26178","ENSG00000230683","3",38515448,38515830,382
"26179","ENSG00000230684","9",129933536,129936541,3005
"26180","ENSG00000230686","2",191017954,191019079,1125
"26181","ENSG00000230687","1",175203228,175204849,1621
"26182","ENSG00000230690","2",104659337,104666858,7521
"26183","ENSG00000230694","9",16625676,16626390,714
"26184","ENSG00000230695","2",215436253,215436992,739
"26185","ENSG00000230696","2",109594693,109605698,11005
"26186","ENSG00000230697","3",20007852,20008247,395
"26187","ENSG00000230698","3",49899302,49903757,4455
"26188","ENSG00000230699","1",911435,914948,3513
"26189","ENSG00000230701","22",23262767,23265005,2238
"26190","ENSG00000230702","2",61856695,61857055,360
"26191","ENSG00000230703","1",24066774,24083565,16791
"26192","ENSG00000230704","1",169762929,169764648,1719
"26193","ENSG00000230707","X",140091743,140092561,818
"26194","ENSG00000230709","17",16975999,16981353,5354
"26195","ENSG00000230710","13",40172505,40195361,22856
"26196","ENSG00000230711","6",168286905,168289350,2445
"26197","ENSG00000230712","22",24248074,24249466,1392
"26198","ENSG00000230715","7",128652841,128653243,402
"26199","ENSG00000230716","11",119602875,119604306,1431
"26200","ENSG00000230718","1",97774669,97775026,357
"26201","ENSG00000230720","10",30723251,30723740,489
"26202","ENSG00000230721","1",86784913,86785467,554
"26203","ENSG00000230724","11",127204,139612,12408
"26204","ENSG00000230725","20",25139652,25149372,9720
"26205","ENSG00000230728","1",54621477,54628438,6961
"26206","ENSG00000230729","9",34521527,34524241,2714
"26207","ENSG00000230730","2",28633282,28664540,31258
"26208","ENSG00000230731","13",44234118,44256596,22478
"26209","ENSG00000230732","3",196912646,196914579,1933
"26210","ENSG00000230733","7",5475804,5479811,4007
"26211","ENSG00000230734","9",117180628,117181095,467
"26212","ENSG00000230735","1",89629725,89676386,46661
"26213","ENSG00000230736","22",32376664,32384343,7679
"26214","ENSG00000230737","2",29890371,29892354,1983
"26215","ENSG00000230739","1",162824795,162849467,24672
"26216","ENSG00000230741","22",33320865,33322813,1948
"26217","ENSG00000230746","7",145675679,145681369,5690
"26218","ENSG00000230747","2",96307263,96321731,14468
"26219","ENSG00000230748","1",165497724,165498348,624
"26220","ENSG00000230749","2",66439088,66444221,5133
"26221","ENSG00000230750","20",10385779,10387806,2027
"26222","ENSG00000230751","7",30140870,30141417,547
"26223","ENSG00000230753","20",33787373,33811109,23736
"26224","ENSG00000230755","10",69589880,69590355,475
"26225","ENSG00000230756","2",130212870,130213490,620
"26226","ENSG00000230758","20",49038357,49038602,245
"26227","ENSG00000230759","1",103414879,103425465,10586
"26228","ENSG00000230764","7",57185788,57186202,414
"26229","ENSG00000230768","1",105587575,105618991,31416
"26230","ENSG00000230769","22",40788777,40789267,490
"26231","ENSG00000230772","20",25734264,25735093,829
"26232","ENSG00000230773","2",47924181,48314224,390043
"26233","ENSG00000230777","1",175921975,175922145,170
"26234","ENSG00000230778","15",40281444,40282586,1142
"26235","ENSG00000230779","1",153225080,153226006,926
"26236","ENSG00000230781","X",84973217,84977829,4612
"26237","ENSG00000230782","9",106974833,107102988,128155
"26238","ENSG00000230783","2",159689217,159690291,1074
"26239","ENSG00000230787","1",79054945,79056055,1110
"26240","ENSG00000230788","X",106070481,106073202,2721
"26241","ENSG00000230789","5",143192500,143194166,1666
"26242","ENSG00000230790","2",11740997,11745301,4304
"26243","ENSG00000230793","13",44594858,44596082,1224
"26244","ENSG00000230794","21",35713139,35732942,19803
"26245","ENSG00000230795","6",29926459,29929232,2773
"26246","ENSG00000230796","7",57650381,57651119,738
"26247","ENSG00000230797","X",21855987,21858727,2740
"26248","ENSG00000230798","1",63320884,63324441,3557
"26249","ENSG00000230799","2",201762737,201763573,836
"26250","ENSG00000230801","20",31808503,31808749,246
"26251","ENSG00000230803","2",132285795,132294377,8582
"26252","ENSG00000230804","9",40121962,40122540,578
"26253","ENSG00000230805","14",101073718,101077910,4192
"26254","ENSG00000230806","1",121360156,121398806,38650
"26255","ENSG00000230807","3",27486247,27486617,370
"26256","ENSG00000230809","10",111498191,111498941,750
"26257","ENSG00000230815","9",94824272,94824773,501
"26258","ENSG00000230817","1",82903183,83166815,263632
"26259","ENSG00000230818","10",19747823,19748621,798
"26260","ENSG00000230823","X",63299247,63299673,426
"26261","ENSG00000230825","7",7255154,7278071,22917
"26262","ENSG00000230826","9",123736437,123751941,15504
"26263","ENSG00000230828","1",50114937,50115282,345
"26264","ENSG00000230829","5",32221932,32222347,415
"26265","ENSG00000230830","3",35650197,35651961,1764
"26266","ENSG00000230831","7",36838972,36841373,2401
"26267","ENSG00000230832","1",147082338,147083578,1240
"26268","ENSG00000230833","1",27739954,27740629,675
"26269","ENSG00000230834","11",1776930,1778388,1458
"26270","ENSG00000230835","11",64881535,64881945,410
"26271","ENSG00000230836","2",74940258,74942670,2412
"26272","ENSG00000230837","20",33752167,33752543,376
"26273","ENSG00000230838","2",215718043,215719424,1381
"26274","ENSG00000230841","1",228449163,228449621,458
"26275","ENSG00000230843","20",56295967,56299160,3193
"26276","ENSG00000230844","X",46545438,46548841,3403
"26277","ENSG00000230845","6",52873014,52879940,6926
"26278","ENSG00000230846","9",81928021,81931368,3347
"26279","ENSG00000230847","5",71074225,71093193,18968
"26280","ENSG00000230848","9",128039135,128057362,18227
"26281","ENSG00000230849","1",173141100,173142350,1250
"26282","ENSG00000230852","6",84019204,84026100,6896
"26283","ENSG00000230853","7",80096600,80097215,615
"26284","ENSG00000230863","1",75641178,75724049,82871
"26285","ENSG00000230864","1",102763322,102853842,90520
"26286","ENSG00000230865","17",17456427,17457259,832
"26287","ENSG00000230866","22",31970823,32037995,67172
"26288","ENSG00000230867","9",32727069,32727522,453
"26289","ENSG00000230869","10",45678692,45700532,21840
"26290","ENSG00000230870","21",31627127,31628600,1473
"26291","ENSG00000230871","13",99173593,99174490,897
"26292","ENSG00000230872","16",22382436,22407428,24992
"26293","ENSG00000230873","6",17102258,17131372,29114
"26294","ENSG00000230876","2",32825359,32926693,101334
"26295","ENSG00000230881","1",41535443,41535868,425
"26296","ENSG00000230882","7",76071469,76074963,3494
"26297","ENSG00000230889","X",64432401,64434145,1744
"26298","ENSG00000230891","3",25858525,25873748,15223
"26299","ENSG00000230894","9",116567636,116586328,18692
"26300","ENSG00000230896","1",45694684,45697075,2391
"26301","ENSG00000230897","17",14705076,14705534,458
"26302","ENSG00000230898","1",166147782,166165095,17313
"26303","ENSG00000230899","X",149878836,149881070,2234
"26304","ENSG00000230902","13",75688556,75689197,641
"26305","ENSG00000230908","20",23798092,23805983,7891
"26306","ENSG00000230910","6",68627879,68635161,7282
"26307","ENSG00000230911","11",112029858,112030367,509
"26308","ENSG00000230912","22",38666508,38668750,2242
"26309","ENSG00000230913","6",41666906,41667649,743
"26310","ENSG00000230914","7",2383698,2388652,4954
"26311","ENSG00000230916","X",126471705,126472403,698
"26312","ENSG00000230918","2",162073256,162077911,4655
"26313","ENSG00000230920","9",9799423,9803784,4361
"26314","ENSG00000230921","1",119368946,119370331,1385
"26315","ENSG00000230922","22",45000565,45003619,3054
"26316","ENSG00000230923","2",64185078,64205485,20407
"26317","ENSG00000230927","7",92412550,92447813,35263
"26318","ENSG00000230928","10",98252023,98256575,4552
"26319","ENSG00000230929","5",126628019,126628319,300
"26320","ENSG00000230932","1",106080801,106081379,578
"26321","ENSG00000230935","20",14003508,14003699,191
"26322","ENSG00000230936","7",55342316,55344958,2642
"26323","ENSG00000230937","1",209428817,209432838,4021
"26324","ENSG00000230941","7",109322320,109326315,3995
"26325","ENSG00000230942","1",158266753,158267320,567
"26326","ENSG00000230943","6",113616927,113650090,33163
"26327","ENSG00000230944","3",5255535,5256761,1226
"26328","ENSG00000230945","9",80030579,80034555,3976
"26329","ENSG00000230946","1",100941017,100941995,978
"26330","ENSG00000230947","22",24598054,24599398,1344
"26331","ENSG00000230948","8",108131100,108132114,1014
"26332","ENSG00000230951","3",186772589,186773476,887
"26333","ENSG00000230953","1",52920422,52920596,174
"26334","ENSG00000230956","X",88096393,88097225,832
"26335","ENSG00000230958","2",111865798,111866405,607
"26336","ENSG00000230960","6",170254334,170262569,8235
"26337","ENSG00000230962","10",85449592,85492001,42409
"26338","ENSG00000230965","21",13905960,13906488,528
"26339","ENSG00000230967","10",101322485,101323394,909
"26340","ENSG00000230968","2",77672215,77673792,1577
"26341","ENSG00000230969","17",16988329,16990177,1848
"26342","ENSG00000230970","3",42702541,42706776,4235
"26343","ENSG00000230971","17",15267461,15272290,4829
"26344","ENSG00000230972","21",23065491,23131206,65715
"26345","ENSG00000230973","X",131437055,131437670,615
"26346","ENSG00000230978","21",34723807,34737204,13397
"26347","ENSG00000230979","2",47690716,47691246,530
"26348","ENSG00000230980","11",1792553,1792870,317
"26349","ENSG00000230982","21",46653558,46654022,464
"26350","ENSG00000230986","X",74133004,74133114,110
"26351","ENSG00000230987","1",189989570,189993097,3527
"26352","ENSG00000230988","14",102662240,102662708,468
"26353","ENSG00000230989","16",83807843,83819737,11894
"26354","ENSG00000230990","20",11234170,11301525,67355
"26355","ENSG00000230991","2",154964308,154969101,4793
"26356","ENSG00000230992","2",132352722,132353318,596
"26357","ENSG00000230993","2",121658475,121658973,498
"26358","ENSG00000230997","14",89892128,89892443,315
"26359","ENSG00000230999","7",112372647,112373729,1082
"26360","ENSG00000231006","7",108510233,108510976,743
"26361","ENSG00000231007","9",87011652,87013151,1499
"26362","ENSG00000231010","22",46055740,46058160,2420
"26363","ENSG00000231011","X",22616744,22617143,399
"26364","ENSG00000231013","2",119476428,119487346,10918
"26365","ENSG00000231015","20",24679547,24680991,1444
"26366","ENSG00000231017","2",211298941,211299189,248
"26367","ENSG00000231019","13",88142867,88236082,93215
"26368","ENSG00000231022","1",188694320,188695111,791
"26369","ENSG00000231023","6",132954257,133107410,153153
"26370","ENSG00000231024","2",69700192,69713847,13655
"26371","ENSG00000231028","6",135497422,135813990,316568
"26372","ENSG00000231029","1",167591392,167591846,454
"26373","ENSG00000231031","2",15690782,15744339,53557
"26374","ENSG00000231032","2",235147016,235147500,484
"26375","ENSG00000231034","20",34688688,34688978,290
"26376","ENSG00000231035","2",217760547,217761291,744
"26377","ENSG00000231039","10",5234358,5263408,29050
"26378","ENSG00000231040","2",146837727,146878220,40493
"26379","ENSG00000231043","2",58460292,58462032,1740
"26380","ENSG00000231046","6",111227747,111259034,31287
"26381","ENSG00000231047","3",190624595,190625169,574
"26382","ENSG00000231049","11",5557096,5564327,7231
"26383","ENSG00000231050","1",1891471,1892658,1187
"26384","ENSG00000231052","9",2541097,2541635,538
"26385","ENSG00000231056","6",10474500,10478502,4002
"26386","ENSG00000231057","1",211675749,211690103,14354
"26387","ENSG00000231058","21",23101223,23103074,1851
"26388","ENSG00000231061","13",63667681,63738018,70337
"26389","ENSG00000231062","2",95051395,95053176,1781
"26390","ENSG00000231063","2",210088226,210089064,838
"26391","ENSG00000231064","1",155195004,155205495,10491
"26392","ENSG00000231066","X",14834476,14835319,843
"26393","ENSG00000231069","X",36985523,36986093,570
"26394","ENSG00000231072","1",116713833,116714835,1002
"26395","ENSG00000231073","1",150973123,150975534,2411
"26396","ENSG00000231074","6",30286690,30327382,40692
"26397","ENSG00000231078","20",57105741,57107128,1387
"26398","ENSG00000231079","2",148866470,148888823,22353
"26399","ENSG00000231080","1",66826942,66828558,1616
"26400","ENSG00000231081","20",26008791,26010531,1740
"26401","ENSG00000231082","10",80649797,80653732,3935
"26402","ENSG00000231083","2",8600892,8622942,22050
"26403","ENSG00000231084","1",185171335,185171710,375
"26404","ENSG00000231086","22",19124879,19125646,767
"26405","ENSG00000231087","7",76968197,76969250,1053
"26406","ENSG00000231090","1",55217645,55324691,107046
"26407","ENSG00000231092","2",216259595,216266130,6535
"26408","ENSG00000231095","1",55222379,55223372,993
"26409","ENSG00000231096","17",19840126,19840515,389
"26410","ENSG00000231098","7",134284500,134286055,1555
"26411","ENSG00000231099","2",109667128,109668002,874
"26412","ENSG00000231100","1",159557368,159558200,832
"26413","ENSG00000231102","6",41720396,41734032,13636
"26414","ENSG00000231104","10",118017487,118045810,28323
"26415","ENSG00000231105","1",21293290,21299874,6584
"26416","ENSG00000231106","21",36005338,36007838,2500
"26417","ENSG00000231107","9",90300885,90433566,132681
"26418","ENSG00000231108","9",6734598,6735076,478
"26419","ENSG00000231110","X",140216035,140216804,769
"26420","ENSG00000231113","6",42940364,42948360,7996
"26421","ENSG00000231114","7",137318592,137326953,8361
"26422","ENSG00000231119","20",47352561,47354633,2072
"26423","ENSG00000231120","6",149977922,149978416,494
"26424","ENSG00000231122","10",45815428,45817324,1896
"26425","ENSG00000231123","21",38238227,38238664,437
"26426","ENSG00000231124","2",201824548,201824832,284
"26427","ENSG00000231125","21",29058073,29060095,2022
"26428","ENSG00000231128","1",113812379,113870159,57780
"26429","ENSG00000231130","6",29896654,29897786,1132
"26430","ENSG00000231131","10",52450874,52755507,304633
"26431","ENSG00000231132","10",51244894,51245806,912
"26432","ENSG00000231133","20",63090806,63102631,11825
"26433","ENSG00000231134","2",85186409,85187253,844
"26434","ENSG00000231137","9",76286494,76288081,1587
"26435","ENSG00000231138","10",123776670,123777749,1079
"26436","ENSG00000231140","9",39395737,39397406,1669
"26437","ENSG00000231147","2",130006200,130009123,2923
"26438","ENSG00000231148","10",31913143,31913754,611
"26439","ENSG00000231149","9",124514938,124516056,1118
"26440","ENSG00000231150","6",38923029,38953099,30070
"26441","ENSG00000231152","10",69594041,69594932,891
"26442","ENSG00000231153","7",95018407,95018554,147
"26443","ENSG00000231154","X",103687284,103691772,4488
"26444","ENSG00000231156","2",45013214,45013668,454
"26445","ENSG00000231158","2",158065545,158066059,514
"26446","ENSG00000231160","4",38602438,38664914,62476
"26447","ENSG00000231162","6",28446973,28447807,834
"26448","ENSG00000231163","1",33868953,33893726,24773
"26449","ENSG00000231164","X",136791064,136791780,716
"26450","ENSG00000231165","9",33695767,33696059,292
"26451","ENSG00000231167","7",105582258,105583256,998
"26452","ENSG00000231169","15",52505191,52505862,671
"26453","ENSG00000231170","7",95545191,95615132,69941
"26454","ENSG00000231171","4",177728757,178028971,300214
"26455","ENSG00000231172","2",75524068,75542706,18638
"26456","ENSG00000231173","2",741977,749856,7879
"26457","ENSG00000231175","1",190624890,190801658,176768
"26458","ENSG00000231177","3",10284419,10285746,1327
"26459","ENSG00000231178","6",159353922,159383339,29417
"26460","ENSG00000231181","1",9576427,9576985,558
"26461","ENSG00000231183","7",76902480,76919191,16711
"26462","ENSG00000231184","13",19382454,19383072,618
"26463","ENSG00000231185","5",142325293,142672001,346708
"26464","ENSG00000231187","10",46580708,46598150,17442
"26465","ENSG00000231188","10",100335563,100346390,10827
"26466","ENSG00000231189","2",223498773,223504611,5838
"26467","ENSG00000231193","9",32840598,32841762,1164
"26468","ENSG00000231194","13",98435405,98435840,435
"26469","ENSG00000231195","9",21398614,21399139,525
"26470","ENSG00000231199","1",235538052,235539845,1793
"26471","ENSG00000231201","21",14971470,14992854,21384
"26472","ENSG00000231202","7",38295763,38296233,470
"26473","ENSG00000231204","2",21317660,21561313,243653
"26474","ENSG00000231205","19",20340269,20424969,84700
"26475","ENSG00000231206","X",74473017,74473953,936
"26476","ENSG00000231207","1",27389468,27390145,677
"26477","ENSG00000231208","20",63808076,63816521,8445
"26478","ENSG00000231210","7",116563594,116663829,100235
"26479","ENSG00000231212","9",62349941,62351536,1595
"26480","ENSG00000231213","3",146576555,146606216,29661
"26481","ENSG00000231216","X",13310652,13319933,9281
"26482","ENSG00000231219","1",13273539,13275627,2088
"26483","ENSG00000231221","2",108049200,108052755,3555
"26484","ENSG00000231222","13",80888348,80888867,519
"26485","ENSG00000231226","6",30105240,30114724,9484
"26486","ENSG00000231227","9",124010530,124011114,584
"26487","ENSG00000231228","5",180982273,180982611,338
"26488","ENSG00000231231","21",38323635,38333421,9786
"26489","ENSG00000231232","7",57822465,57822801,336
"26490","ENSG00000231233","10",104351591,104353575,1984
"26491","ENSG00000231234","7",66423405,66423893,488
"26492","ENSG00000231236","21",27358885,27448579,89694
"26493","ENSG00000231237","1",158694539,158695509,970
"26494","ENSG00000231238","13",18538880,18551214,12334
"26495","ENSG00000231240","2",130036958,130038422,1464
"26496","ENSG00000231241","20",37021743,37021984,241
"26497","ENSG00000231243","3",38823902,38825302,1400
"26498","ENSG00000231244","7",136713871,136715188,1317
"26499","ENSG00000231245","10",32511336,32511737,401
"26500","ENSG00000231246","1",112177234,112360625,183391
"26501","ENSG00000231248","9",61615835,61627683,11848
"26502","ENSG00000231249","3",4490891,4493163,2272
"26503","ENSG00000231252","1",60659631,60868009,208378
"26504","ENSG00000231253","22",33104330,33145861,41531
"26505","ENSG00000231254","2",212832161,212832945,784
"26506","ENSG00000231255","7",86775081,86776022,941
"26507","ENSG00000231256","17",43780435,43787612,7177
"26508","ENSG00000231258","17",20583758,20591180,7422
"26509","ENSG00000231259","2",87031815,87052992,21177
"26510","ENSG00000231261","22",41709225,41709489,264
"26511","ENSG00000231264","7",63937905,63938509,604
"26512","ENSG00000231265","20",50040716,50041504,788
"26513","ENSG00000231266","2",16227027,16228194,1167
"26514","ENSG00000231270","X",118938153,118939134,981
"26515","ENSG00000231271","22",23949918,23954042,4124
"26516","ENSG00000231272","1",234261706,234274465,12759
"26517","ENSG00000231274","19",55540656,55545543,4887
"26518","ENSG00000231290","20",58515379,58619888,104509
"26519","ENSG00000231291","5",4512262,4516776,4514
"26520","ENSG00000231292","2",113406396,113406872,476
"26521","ENSG00000231293","9",107834509,107834829,320
"26522","ENSG00000231295","7",120746738,120752514,5776
"26523","ENSG00000231296","1",40262672,40262984,312
"26524","ENSG00000231297","6",166099665,166113273,13608
"26525","ENSG00000231298","10",4650158,4678185,28027
"26526","ENSG00000231299","7",56360362,56360541,179
"26527","ENSG00000231301","6",29582508,29583025,517
"26528","ENSG00000231302","20",50620763,50621077,314
"26529","ENSG00000231304","3",20174244,21145967,971723
"26530","ENSG00000231305","3",128860620,128871540,10920
"26531","ENSG00000231307","20",38537758,38538458,700
"26532","ENSG00000231310","3",177037405,177047923,10518
"26533","ENSG00000231312","2",39436530,39665343,228813
"26534","ENSG00000231313","12",120914400,120915123,723
"26535","ENSG00000231317","7",55656768,55678490,21722
"26536","ENSG00000231322","7",78347142,78359458,12316
"26537","ENSG00000231324","21",36632681,36637033,4352
"26538","ENSG00000231326","10",2169140,2189512,20372
"26539","ENSG00000231327","2",70124036,70125317,1281
"26540","ENSG00000231328","7",23811144,23811660,516
"26541","ENSG00000231329","6",139144204,139239653,95449
"26542","ENSG00000231331","2",94953161,94953593,432
"26543","ENSG00000231332","6",73369704,73387717,18013
"26544","ENSG00000231333","1",200863808,200864152,344
"26545","ENSG00000231334","2",54747103,54750473,3370
"26546","ENSG00000231336","2",46166789,46167978,1189
"26547","ENSG00000231340","X",53142832,53143913,1081
"26548","ENSG00000231344","1",27739091,27739439,348
"26549","ENSG00000231345","10",50655967,50660472,4505
"26550","ENSG00000231346","1",111599655,111608723,9068
"26551","ENSG00000231351","2",86930250,86930754,504
"26552","ENSG00000231355","21",33482499,33484258,1759
"26553","ENSG00000231357","7",2835621,2836022,401
"26554","ENSG00000231358","13",18921888,18944284,22396
"26555","ENSG00000231359","7",6490793,6491098,305
"26556","ENSG00000231361","19",12373609,12373731,122
"26557","ENSG00000231362","3",13052967,13053122,155
"26558","ENSG00000231364","1",83445967,83480024,34057
"26559","ENSG00000231365","1",119140391,119275973,135582
"26560","ENSG00000231366","10",70794230,70794523,293
"26561","ENSG00000231367","2",38406527,38515934,109407
"26562","ENSG00000231369","22",26886909,26887548,639
"26563","ENSG00000231373","9",77456295,77526697,70402
"26564","ENSG00000231378","1",174849667,174850168,501
"26565","ENSG00000231381","9",6668999,6670008,1009
"26566","ENSG00000231382","3",36616006,36637457,21451
"26567","ENSG00000231383","3",192238037,192283097,45060
"26568","ENSG00000231384","3",172680714,172681224,510
"26569","ENSG00000231386","2",70810798,70811474,676
"26570","ENSG00000231389","6",33064569,33080775,16206
"26571","ENSG00000231390","9",40293082,40293955,873
"26572","ENSG00000231392","22",22774529,22774691,162
"26573","ENSG00000231393","9",35642514,35643517,1003
"26574","ENSG00000231394","7",55593777,55595006,1229
"26575","ENSG00000231395","3",23878981,23879498,517
"26576","ENSG00000231396","4",9210657,9212608,1951
"26577","ENSG00000231397","7",149321865,149322092,227
"26578","ENSG00000231398","10",97275012,97278097,3085
"26579","ENSG00000231401","3",8359344,8366427,7083
"26580","ENSG00000231402","6",31287510,31288964,1454
"26581","ENSG00000231403","2",11388023,11390367,2344
"26582","ENSG00000231404","13",41287741,41288320,579
"26583","ENSG00000231405","22",27143478,27159878,16400
"26584","ENSG00000231407","1",170460453,170532647,72194
"26585","ENSG00000231409","15",34943080,34943394,314
"26586","ENSG00000231412","19",43329295,43331430,2135
"26587","ENSG00000231413","1",48078787,48082196,3409
"26588","ENSG00000231414","2",70253855,70254010,155
"26589","ENSG00000231416","1",153995632,153995960,328
"26590","ENSG00000231417","13",24742677,24746184,3507
"26591","ENSG00000231418","7",31414158,31421303,7145
"26592","ENSG00000231419","7",159006522,159030195,23673
"26593","ENSG00000231420","2",150234892,150257007,22115
"26594","ENSG00000231421","17",30573471,30577000,3529
"26595","ENSG00000231422","10",25113058,25161236,48178
"26596","ENSG00000231424","1",170748573,171251857,503284
"26597","ENSG00000231426","6",139677639,139860476,182837
"26598","ENSG00000231427","7",54330670,54455093,124423
"26599","ENSG00000231428","13",110053285,110054952,1667
"26600","ENSG00000231431","2",131279290,131309068,29778
"26601","ENSG00000231434","1",158523672,158525838,2166
"26602","ENSG00000231436","Y",9610571,9621276,10705
"26603","ENSG00000231437","1",111989770,111998842,9072
"26604","ENSG00000231439","16",22910,25123,2213
"26605","ENSG00000231440","1",240588522,240590748,2226
"26606","ENSG00000231441","6",56843928,56864078,20150
"26607","ENSG00000231443","3",195937243,195938739,1496
"26608","ENSG00000231445","2",162077357,162077651,294
"26609","ENSG00000231447","X",152746817,152747762,945
"26610","ENSG00000231449","3",37196204,37196666,462
"26611","ENSG00000231453","2",174326027,174330643,4616
"26612","ENSG00000231454","9",61665579,61666386,807
"26613","ENSG00000231458","17",16683438,16684227,789
"26614","ENSG00000231460","9",23829670,23849914,20244
"26615","ENSG00000231461","6",33091753,33097295,5542
"26616","ENSG00000231464","3",195996738,195998233,1495
"26617","ENSG00000231466","22",25349543,25350322,779
"26618","ENSG00000231468","1",28526318,28527227,909
"26619","ENSG00000231473","13",48296162,48303661,7499
"26620","ENSG00000231475","14",106349283,106349792,509
"26621","ENSG00000231476","7",1620654,1621405,751
"26622","ENSG00000231477","17",19457080,19458399,1319
"26623","ENSG00000231480","21",38502445,38502621,176
"26624","ENSG00000231482","2",1366234,1580747,214513
"26625","ENSG00000231483","10",5608475,5610793,2318
"26626","ENSG00000231484","7",57828331,57837046,8715
"26627","ENSG00000231485","1",65066627,65067737,1110
"26628","ENSG00000231487","11",1662584,1663343,759
"26629","ENSG00000231490","7",51259429,51260167,738
"26630","ENSG00000231492","11",64420311,64432670,12359
"26631","ENSG00000231494","2",231559903,231560364,461
"26632","ENSG00000231496","10",10960148,10970816,10668
"26633","ENSG00000231500","6",33272075,33276511,4436
"26634","ENSG00000231501","X",126472728,126472884,156
"26635","ENSG00000231503","12",9239986,9240331,345
"26636","ENSG00000231504","7",56502284,56503044,760
"26637","ENSG00000231505","2",106521903,106538079,16176
"26638","ENSG00000231507","1",203273221,203288804,15583
"26639","ENSG00000231508","10",97393197,97393547,350
"26640","ENSG00000231509","9",5584490,5588994,4504
"26641","ENSG00000231510","1",5086459,5090899,4440
"26642","ENSG00000231512","1",243029512,243052252,22740
"26643","ENSG00000231513","X",136097835,136098348,513
"26644","ENSG00000231514","Y",26626520,26627159,639
"26645","ENSG00000231515","7",157739010,157740456,1446
"26646","ENSG00000231519","7",30069658,30075115,5457
"26647","ENSG00000231521","9",97634515,97636051,1536
"26648","ENSG00000231525","7",20588990,20590085,1095
"26649","ENSG00000231527","9",61854148,62096920,242772
"26650","ENSG00000231528","9",113113042,113119928,6886
"26651","ENSG00000231529","1",220485104,220487558,2454
"26652","ENSG00000231530","13",42043727,42044247,520
"26653","ENSG00000231531","7",143312684,143313061,377
"26654","ENSG00000231532","2",4628216,4656498,28282
"26655","ENSG00000231533","6",79420172,79529276,109104
"26656","ENSG00000231534","2",229942728,229945137,2409
"26657","ENSG00000231535","Y",3002887,3200509,197622
"26658","ENSG00000231536","2",110610916,110612404,1488
"26659","ENSG00000231537","7",57167880,57168651,771
"26660","ENSG00000231538","2",114828432,114833548,5116
"26661","ENSG00000231539","7",42829672,42844438,14766
"26662","ENSG00000231541","2",179001756,179002760,1004
"26663","ENSG00000231544","18",57838476,57838966,490
"26664","ENSG00000231546","2",236407846,236409077,1231
"26665","ENSG00000231548","11",4146112,4151104,4992
"26666","ENSG00000231549","X",74173890,74174066,176
"26667","ENSG00000231550","2",169767185,169768799,1614
"26668","ENSG00000231551","1",148402516,148432545,30029
"26669","ENSG00000231552","3",32620903,32621902,999
"26670","ENSG00000231556","7",65335174,65335668,494
"26671","ENSG00000231557","2",198882573,199071791,189218
"26672","ENSG00000231559","6",108817680,108817926,246
"26673","ENSG00000231560","12",9948137,9953336,5199
"26674","ENSG00000231561","19",42654200,42669076,14876
"26675","ENSG00000231562","9",106978776,106979554,778
"26676","ENSG00000231563","1",228407365,228410870,3505
"26677","ENSG00000231564","1",179201705,179201926,221
"26678","ENSG00000231565","22",15611759,15613096,1337
"26679","ENSG00000231566","X",45847042,45851541,4499
"26680","ENSG00000231567","2",140217651,140220368,2717
"26681","ENSG00000231569","10",87408044,87408258,214
"26682","ENSG00000231574","3",177816865,177899224,82359
"26683","ENSG00000231575","10",94109116,94121107,11991
"26684","ENSG00000231576","22",36172934,36173948,1014
"26685","ENSG00000231579","5",143332605,143333239,634
"26686","ENSG00000231583","2",110500100,110500235,135
"26687","ENSG00000231584","2",96010551,96023380,12829
"26688","ENSG00000231585","5",132011448,132013199,1751
"26689","ENSG00000231587","9",131490486,131490571,85
"26690","ENSG00000231588","10",50629532,50631075,1543
"26691","ENSG00000231589","16",62596372,62598449,2077
"26692","ENSG00000231597","2",216854389,216855132,743
"26693","ENSG00000231603","X",48412303,48415285,2982
"26694","ENSG00000231604","20",56730397,56731460,1063
"26695","ENSG00000231605","1",167175363,167195792,20429
"26696","ENSG00000231606","1",14221887,14304445,82558
"26697","ENSG00000231607","13",49956670,50125720,169050
"26698","ENSG00000231609","2",62957326,63048640,91314
"26699","ENSG00000231610","2",6495877,6496798,921
"26700","ENSG00000231612","1",245673732,245676478,2746
"26701","ENSG00000231613","1",89788914,89790492,1578
"26702","ENSG00000231615","1",173362397,173363733,1336
"26703","ENSG00000231616","9",83831586,83868532,36946
"26704","ENSG00000231621","2",197197991,197199273,1282
"26705","ENSG00000231622","1",65154480,65154650,170
"26706","ENSG00000231625","17",19615789,19633825,18036
"26707","ENSG00000231626","2",104580821,104581890,1069
"26708","ENSG00000231628","6",105279016,105281755,2739
"26709","ENSG00000231630","1",2814432,2814998,566
"26710","ENSG00000231636","2",27049683,27050264,581
"26711","ENSG00000231638","7",43508728,43522542,13814
"26712","ENSG00000231645","17",20512560,20517479,4919
"26713","ENSG00000231646","2",185652374,185800151,147777
"26714","ENSG00000231648","1",209367662,209380518,12856
"26715","ENSG00000231649","9",82057647,82063682,6035
"26716","ENSG00000231650","13",22850101,22850561,460
"26717","ENSG00000231651","X",70452958,70455994,3036
"26718","ENSG00000231652","6",73693903,73696131,2228
"26719","ENSG00000231653","2",206640073,206641282,1209
"26720","ENSG00000231654","6",166903698,166904835,1137
"26721","ENSG00000231655","2",26140263,26141264,1001
"26722","ENSG00000231662","6",19290319,19321021,30702
"26723","ENSG00000231663","1",234372807,234373593,786
"26724","ENSG00000231665","13",49210422,49212294,1872
"26725","ENSG00000231666","1",158131983,158149810,17827
"26726","ENSG00000231667","13",67902208,67903221,1013
"26727","ENSG00000231668","3",38051759,38052395,636
"26728","ENSG00000231671","1",101323337,101390303,66966
"26729","ENSG00000231672","2",217284019,217756593,472574
"26730","ENSG00000231674","13",90890954,90926597,35643
"26731","ENSG00000231675","2",158703287,158703460,173
"26732","ENSG00000231680","11",64394342,64395831,1489
"26733","ENSG00000231681","7",50202001,50262994,60993
"26734","ENSG00000231682","2",234444590,234454595,10005
"26735","ENSG00000231683","6",53561289,53617171,55882
"26736","ENSG00000231684","1",182336001,182336334,333
"26737","ENSG00000231686","X",146619597,146620584,987
"26738","ENSG00000231688","3",168858659,168859130,471
"26739","ENSG00000231689","2",187712816,188384313,671497
"26740","ENSG00000231690","6",169790057,169802873,12816
"26741","ENSG00000231691","1",204276901,204280363,3462
"26742","ENSG00000231694","X",149760779,149760874,95
"26743","ENSG00000231697","9",100175178,100176054,876
"26744","ENSG00000231698","11",131253422,131350917,97495
"26745","ENSG00000231699","2",197533803,197533965,162
"26746","ENSG00000231700","1",157709086,157709643,557
"26747","ENSG00000231701","9",65828120,65831696,3576
"26748","ENSG00000231702","1",1008076,1008229,153
"26749","ENSG00000231703","20",53397661,53412910,15249
"26750","ENSG00000231704","7",6080704,6093085,12381
"26751","ENSG00000231705","10",132419083,132420953,1870
"26752","ENSG00000231707","4",39973444,39974338,894
"26753","ENSG00000231711","22",46039907,46044853,4946
"26754","ENSG00000231713","21",39727755,39730680,2925
"26755","ENSG00000231714","1",194350943,194352426,1483
"26756","ENSG00000231715","20",50479767,50479991,224
"26757","ENSG00000231718","1",199148598,199393307,244709
"26758","ENSG00000231720","6",167237508,167240480,2972
"26759","ENSG00000231721","7",130938963,131110176,171213
"26760","ENSG00000231724","3",186807692,186818121,10429
"26761","ENSG00000231725","X",48636165,48637135,970
"26762","ENSG00000231728","X",103880668,103919548,38880
"26763","ENSG00000231729","X",63670196,63671502,1306
"26764","ENSG00000231731","2",127455394,127514623,59229
"26765","ENSG00000231735","2",173297629,173298512,883
"26766","ENSG00000231738","12",85014311,85036277,21966
"26767","ENSG00000231739","2",187415552,187415818,266
"26768","ENSG00000231740","1",58838448,58851254,12806
"26769","ENSG00000231741","9",85934588,85936599,2011
"26770","ENSG00000231742","20",50171809,50176676,4867
"26771","ENSG00000231743","10",2936021,2936441,420
"26772","ENSG00000231744","9",124598707,124599580,873
"26773","ENSG00000231747","2",112621809,112622167,358
"26774","ENSG00000231748","10",69265342,69268148,2806
"26775","ENSG00000231749","17",68944531,69042784,98253
"26776","ENSG00000231752","1",121519112,121575702,56590
"26777","ENSG00000231754","6",21521678,21523783,2105
"26778","ENSG00000231756","9",16473188,16476237,3049
"26779","ENSG00000231758","2",143629133,143656179,27046
"26780","ENSG00000231760","6",149796151,149799150,2999
"26781","ENSG00000231762","6",76660486,76662770,2284
"26782","ENSG00000231764","7",96955141,97014065,58924
"26783","ENSG00000231765","X",57229034,57229415,381
"26784","ENSG00000231767","1",192716132,192716653,521
"26785","ENSG00000231768","1",234527887,234531803,3916
"26786","ENSG00000231769","6",46096004,46129857,33853
"26787","ENSG00000231770","3",194584004,194590260,6256
"26788","ENSG00000231772","X",42252459,42699385,446926
"26789","ENSG00000231776","6",84421028,84556152,135124
"26790","ENSG00000231780","3",17333126,17333431,305
"26791","ENSG00000231781","2",81983272,82005700,22428
"26792","ENSG00000231782","4",82610974,82621610,10636
"26793","ENSG00000231784","17",752660,755336,2676
"26794","ENSG00000231787","X",103904322,103904754,432
"26795","ENSG00000231788","12",31597114,31597409,295
"26796","ENSG00000231789","1",9672426,9687555,15129
"26797","ENSG00000231793","11",67612651,67616257,3606
"26798","ENSG00000231794","7",135198401,135209837,11436
"26799","ENSG00000231795","20",34450930,34454552,3622
"26800","ENSG00000231799","9",89449558,89450754,1196
"26801","ENSG00000231801","22",44651835,44652379,544
"26802","ENSG00000231802","2",219684030,219684795,765
"26803","ENSG00000231804","9",88484852,88485325,473
"26804","ENSG00000231806","9",94555054,94603990,48936
"26805","ENSG00000231808","9",112713,113754,1041
"26806","ENSG00000231810","9",108821697,108822004,307
"26807","ENSG00000231811","6",4341756,4347162,5406
"26808","ENSG00000231812","7",97885868,97886074,206
"26809","ENSG00000231814","1",217892900,217920804,27904
"26810","ENSG00000231815","2",59434552,59442261,7709
"26811","ENSG00000231817","13",46455131,46515958,60827
"26812","ENSG00000231821","2",4514204,4515056,852
"26813","ENSG00000231822","2",99102018,99102752,734
"26814","ENSG00000231824","18",5145285,5197503,52218
"26815","ENSG00000231826","2",43027823,43040662,12839
"26816","ENSG00000231827","1",153793947,153802091,8144
"26817","ENSG00000231829","10",95109136,95168425,59289
"26818","ENSG00000231830","X",154333960,154335037,1077
"26819","ENSG00000231831","X",57392646,57395409,2763
"26820","ENSG00000231839","7",145583197,145584817,1620
"26821","ENSG00000231840","7",143255264,143287997,32733
"26822","ENSG00000231841","4",152927446,152928207,761
"26823","ENSG00000231845","3",134170487,134171085,598
"26824","ENSG00000231846","X",22428132,22494713,66581
"26825","ENSG00000231848","2",44996413,44996873,460
"26826","ENSG00000231849","1",36241898,36242156,258
"26827","ENSG00000231851","2",105092368,105103036,10668
"26828","ENSG00000231852","6",32038327,32041644,3317
"26829","ENSG00000231856","13",51803838,51813832,9994
"26830","ENSG00000231858","2",191021526,191032314,10788
"26831","ENSG00000231859","7",97906429,97906822,393
"26832","ENSG00000231861","3",98497604,98498663,1059
"26833","ENSG00000231863","6",160931080,160985624,54544
"26834","ENSG00000231866","1",52925249,52925423,174
"26835","ENSG00000231867","21",42508624,42509661,1037
"26836","ENSG00000231868","1",6443034,6447006,3972
"26837","ENSG00000231870","17",30567700,30571748,4048
"26838","ENSG00000231871","1",201688259,201829559,141300
"26839","ENSG00000231873","3",40719859,40862626,142767
"26840","ENSG00000231875","X",81363268,81364170,902
"26841","ENSG00000231876","16",26302064,26340815,38751
"26842","ENSG00000231877","1",238485445,238538305,52860
"26843","ENSG00000231881","6",44058792,44089288,30496
"26844","ENSG00000231882","13",113128155,113128880,725
"26845","ENSG00000231883","6",151196681,151197638,957
"26846","ENSG00000231887","12",10824960,11171608,346648
"26847","ENSG00000231888","3",177010719,177011067,348
"26848","ENSG00000231889","6",111483511,111598302,114791
"26849","ENSG00000231890","2",135985176,136022593,37417
"26850","ENSG00000231892","7",3196626,3198256,1630
"26851","ENSG00000231896","2",208469850,208540413,70563
"26852","ENSG00000231898","2",170332085,170408564,76479
"26853","ENSG00000231900","1",55367466,55368774,1308
"26854","ENSG00000231901","9",117840322,117897256,56934
"26855","ENSG00000231902","9",7914514,7961224,46710
"26856","ENSG00000231903","2",202178660,202179391,731
"26857","ENSG00000231905","1",179183734,179184547,813
"26858","ENSG00000231907","22",40673484,40674451,967
"26859","ENSG00000231908","2",208255247,208256181,934
"26860","ENSG00000231909","9",19460926,19464524,3598
"26861","ENSG00000231912","6",113791829,113837368,45539
"26862","ENSG00000231915","3",22989823,22991582,1759
"26863","ENSG00000231916","7",38311383,38311808,425
"26864","ENSG00000231918","2",51032601,52407917,1375316
"26865","ENSG00000231920","10",21174014,21175048,1034
"26866","ENSG00000231922","14",53917270,53917753,483
"26867","ENSG00000231924","19",42866464,42879822,13358
"26868","ENSG00000231925","6",33299694,33314387,14693
"26869","ENSG00000231926","2",114260050,114261226,1176
"26870","ENSG00000231927","7",1508655,1509427,772
"26871","ENSG00000231929","X",134961711,134962305,594
"26872","ENSG00000231931","7",138060056,138060293,237
"26873","ENSG00000231933","22",25876854,25903247,26393
"26874","ENSG00000231934","20",30323367,30362276,38909
"26875","ENSG00000231937","X",152138883,152186857,47974
"26876","ENSG00000231940","1",233288868,233289447,579
"26877","ENSG00000231942","8",81807772,81808726,954
"26878","ENSG00000231943","2",113526836,113542694,15858
"26879","ENSG00000231944","X",72688950,72712348,23398
"26880","ENSG00000231947","X",55179194,55179999,805
"26881","ENSG00000231948","2",20590775,20592548,1773
"26882","ENSG00000231952","7",32812757,32838570,25813
"26883","ENSG00000231953","1",25208139,25209437,1298
"26884","ENSG00000231954","2",130272479,130273511,1032
"26885","ENSG00000231956","7",87521461,87522410,949
"26886","ENSG00000231957","10",78068623,78069538,915
"26887","ENSG00000231964","10",45444570,45453121,8551
"26888","ENSG00000231965","8",11175051,11175570,519
"26889","ENSG00000231966","1",179829609,179836124,6515
"26890","ENSG00000231967","9",5356312,5356525,213
"26891","ENSG00000231969","2",149587196,150047447,460251
"26892","ENSG00000231970","10",97401115,97419524,18409
"26893","ENSG00000231971","6",134428239,134520585,92346
"26894","ENSG00000231976","10",26647986,26653454,5468
"26895","ENSG00000231977","20",63166797,63180903,14106
"26896","ENSG00000231978","1",21768269,21768575,306
"26897","ENSG00000231979","1",239915439,239916955,1516
"26898","ENSG00000231980","7",158027373,158031128,3755
"26899","ENSG00000231981","13",98949719,98950447,728
"26900","ENSG00000231982","3",186826549,186827337,788
"26901","ENSG00000231983","13",26052276,26053385,1109
"26902","ENSG00000231985","1",71570956,71573558,2602
"26903","ENSG00000231986","21",23888798,23890541,1743
"26904","ENSG00000231987","1",96254069,96374125,120056
"26905","ENSG00000231989","5",156850538,156852528,1990
"26906","ENSG00000231990","9",93808347,93858340,49993
"26907","ENSG00000231991","9",33624274,33625293,1019
"26908","ENSG00000231992","1",95120147,95138554,18407
"26909","ENSG00000231993","22",41174591,41197456,22865
"26910","ENSG00000231995","9",62266319,62266919,600
"26911","ENSG00000231996","1",99842610,99842761,151
"26912","ENSG00000231999","1",89581291,89632916,51625
"26913","ENSG00000232000","9",14921013,15146401,225388
"26914","ENSG00000232001","2",106521563,106544297,22734
"26915","ENSG00000232002","2",242047695,242084233,36538
"26916","ENSG00000232004","10",43604843,43606251,1408
"26917","ENSG00000232006","7",42954135,43113931,159796
"26918","ENSG00000232009","X",47389961,47392300,2339
"26919","ENSG00000232010","21",44250813,44251520,707
"26920","ENSG00000232015","1",77853355,77853893,538
"26921","ENSG00000232021","4",108167525,108258037,90512
"26922","ENSG00000232022","1",46432129,46482493,50364
"26923","ENSG00000232023","2",228475224,228841689,366465
"26924","ENSG00000232024","8",35525176,35525763,587
"26925","ENSG00000232027","1",51372270,51373224,954
"26926","ENSG00000232028","2",37325340,37326797,1457
"26927","ENSG00000232030","X",26160601,26161824,1223
"26928","ENSG00000232031","6",81724722,81736353,11631
"26929","ENSG00000232032","7",97908256,97908424,168
"26930","ENSG00000232034","2",100822661,100847220,24559
"26931","ENSG00000232035","9",10631750,10632203,453
"26932","ENSG00000232036","1",184566511,184567835,1324
"26933","ENSG00000232037","1",21908098,21908580,482
"26934","ENSG00000232040","6",28570535,28616212,45677
"26935","ENSG00000232043","20",50570975,50578041,7066
"26936","ENSG00000232044","2",5932543,6003510,70967
"26937","ENSG00000232046","2",66574030,66731223,157193
"26938","ENSG00000232048","1",67660155,67661013,858
"26939","ENSG00000232050","22",26006389,26006532,143
"26940","ENSG00000232053","7",136092913,136437785,344872
"26941","ENSG00000232054","X",124280530,124281422,892
"26942","ENSG00000232056","2",10847577,10854955,7378
"26943","ENSG00000232057","2",1824412,1828667,4255
"26944","ENSG00000232058","17",15014805,15052276,37471
"26945","ENSG00000232059","1",244694432,244694720,288
"26946","ENSG00000232060","9",30558880,30559481,601
"26947","ENSG00000232063","9",94332459,94363013,30554
"26948","ENSG00000232065","3",196631498,196632587,1089
"26949","ENSG00000232070","14",21098937,21103724,4787
"26950","ENSG00000232072","7",46890625,47049678,159053
"26951","ENSG00000232075","10",63634317,63634827,510
"26952","ENSG00000232077","1",193304745,193365953,61208
"26953","ENSG00000232079","21",28048404,28137611,89207
"26954","ENSG00000232080","6",32718005,32719170,1165
"26955","ENSG00000232081","22",33723832,33724912,1080
"26956","ENSG00000232082","6",166460663,166465383,4720
"26957","ENSG00000232083","17",80602549,80602926,377
"26958","ENSG00000232084","2",100208254,100251484,43230
"26959","ENSG00000232085","1",243164638,243169445,4807
"26960","ENSG00000232091","10",116577308,116583317,6009
"26961","ENSG00000232093","1",155045191,155046118,927
"26962","ENSG00000232097","7",97938439,97938794,355
"26963","ENSG00000232098","19",58404238,58408484,4246
"26964","ENSG00000232100","1",218043505,218059140,15635
"26965","ENSG00000232102","13",23765934,23766104,170
"26966","ENSG00000232104","9",3526723,3691814,165091
"26967","ENSG00000232109","10",42660728,42661776,1048
"26968","ENSG00000232110","10",89283765,89292125,8360
"26969","ENSG00000232111","X",9402751,9404802,2051
"26970","ENSG00000232112","3",48440257,48444208,3951
"26971","ENSG00000232113","1",173635338,173637130,1792
"26972","ENSG00000232115","10",58106423,58106879,456
"26973","ENSG00000232117","13",30151886,30159621,7735
"26974","ENSG00000232118","21",29370019,29376339,6320
"26975","ENSG00000232119","X",120594010,120621159,27149
"26976","ENSG00000232121","20",62633681,62635504,1823
"26977","ENSG00000232124","21",44200602,44207399,6797
"26978","ENSG00000232125","2",206651621,206718396,66775
"26979","ENSG00000232128","2",94900990,94901602,612
"26980","ENSG00000232131","6",125797856,125818858,21002
"26981","ENSG00000232132","13",79477364,79481231,3867
"26982","ENSG00000232134","1",220143964,220144351,387
"26983","ENSG00000232135","20",45536796,45537014,218
"26984","ENSG00000232136","20",18642782,18643634,852
"26985","ENSG00000232138","9",21231266,21231853,587
"26986","ENSG00000232139","10",118341437,118398468,57031
"26987","ENSG00000232140","2",120552481,120558119,5638
"26988","ENSG00000232142","10",70198988,70199239,251
"26989","ENSG00000232144","2",62552463,62553434,971
"26990","ENSG00000232149","X",123603139,123603931,792
"26991","ENSG00000232150","13",50172089,50173181,1092
"26992","ENSG00000232153","2",34732287,34822726,90439
"26993","ENSG00000232154","1",237948017,237949143,1126
"26994","ENSG00000232155","X",154605858,154605950,92
"26995","ENSG00000232158","9",19705338,19705655,317
"26996","ENSG00000232160","X",132217053,132432862,215809
"26997","ENSG00000232161","7",57770966,57771173,207
"26998","ENSG00000232162","13",27162855,27169135,6280
"26999","ENSG00000232163","13",23373423,23374061,638
"27000","ENSG00000232164","2",66383306,66392450,9144
"27001","ENSG00000232166","1",234284972,234285541,569
"27002","ENSG00000232170","10",8259331,8268342,9011
"27003","ENSG00000232172","9",130651799,130652383,584
"27004","ENSG00000232173","6",29573909,29574836,927
"27005","ENSG00000232175","1",232917235,232918018,783
"27006","ENSG00000232176","9",19200335,19201046,711
"27007","ENSG00000232177","X",126472885,126473281,396
"27008","ENSG00000232184","1",243702857,243740821,37964
"27009","ENSG00000232185","1",115564601,115565432,831
"27010","ENSG00000232186","X",75326772,75327999,1227
"27011","ENSG00000232187","13",22696023,22696574,551
"27012","ENSG00000232188","1",160931739,160934380,2641
"27013","ENSG00000232190","16",87057784,87070105,12321
"27014","ENSG00000232192","1",245206444,245234501,28057
"27015","ENSG00000232193","21",18917934,18935859,17925
"27016","ENSG00000232194","1",167820406,167821224,818
"27017","ENSG00000232196","16",3370979,3372740,1761
"27018","ENSG00000232197","6",170160606,170163142,2536
"27019","ENSG00000232199","7",109998434,109999624,1190
"27020","ENSG00000232200","20",24297585,24318086,20501
"27021","ENSG00000232202","2",42826322,42827617,1295
"27022","ENSG00000232203","9",31253901,31254777,876
"27023","ENSG00000232204","13",87890172,87892472,2300
"27024","ENSG00000232208","1",8907393,8907744,351
"27025","ENSG00000232211","9",86632147,86696496,64349
"27026","ENSG00000232212","1",189775465,189814918,39453
"27027","ENSG00000232215","1",248003129,248004068,939
"27028","ENSG00000232216","14",106470264,106470800,536
"27029","ENSG00000232218","22",32386668,32386868,200
"27030","ENSG00000232225","13",89214847,89236890,22043
"27031","ENSG00000232227","2",192644102,192645387,1285
"27032","ENSG00000232228","2",69594741,69595058,317
"27033","ENSG00000232229","10",89829483,89840861,11378
"27034","ENSG00000232230","10",100114417,100115223,806
"27035","ENSG00000232233","3",186810880,186825521,14641
"27036","ENSG00000232234","6",8102711,8343139,240428
"27037","ENSG00000232237","1",201113953,201127184,13231
"27038","ENSG00000232238","2",148595158,148595328,170
"27039","ENSG00000232243","13",19262797,19284823,22026
"27040","ENSG00000232245","1",54416256,54420860,4604
"27041","ENSG00000232254","22",36950529,36953723,3194
"27042","ENSG00000232258","16",8537605,8590193,52588
"27043","ENSG00000232259","10",127929376,127934517,5141
"27044","ENSG00000232260","21",17518526,17518993,467
"27045","ENSG00000232265","1",148156139,148186980,30841
"27046","ENSG00000232267","X",68771322,68772578,1256
"27047","ENSG00000232268","11",4593614,4596574,2960
"27048","ENSG00000232271","20",7069614,7146656,77042
"27049","ENSG00000232273","1",37544763,37545294,531
"27050","ENSG00000232277","2",111952144,111952671,527
"27051","ENSG00000232282","X",102785667,102786604,937
"27052","ENSG00000232283","9",96246462,96250393,3931
"27053","ENSG00000232284","1",67832303,68202987,370684
"27054","ENSG00000232285","2",48780602,48780895,293
"27055","ENSG00000232286","20",52858338,52862855,4517
"27056","ENSG00000232287","3",11006098,11019224,13126
"27057","ENSG00000232290","6",151054897,151056057,1160
"27058","ENSG00000232292","2",172893763,172894383,620
"27059","ENSG00000232294","20",52671735,52699472,27737
"27060","ENSG00000232295","6",71221457,71328228,106771
"27061","ENSG00000232298","1",24307556,24321901,14345
"27062","ENSG00000232300","17",46558830,46562795,3965
"27063","ENSG00000232301","7",101299578,101301346,1768
"27064","ENSG00000232303","9",32566148,32567126,978
"27065","ENSG00000232305","22",17424388,17424775,387
"27066","ENSG00000232306","2",238295392,238300620,5228
"27067","ENSG00000232307","13",105459055,105505681,46626
"27068","ENSG00000232309","1",182127297,182128682,1385
"27069","ENSG00000232310","6",134520163,134689399,169236
"27070","ENSG00000232311","6",109826522,109828785,2263
"27071","ENSG00000232316","6",113428540,113433555,5015
"27072","ENSG00000232320","2",161340816,161341326,510
"27073","ENSG00000232325","7",70972,95683,24711
"27074","ENSG00000232327","4",80386178,80388716,2538
"27075","ENSG00000232328","2",236733289,236754363,21074
"27076","ENSG00000232332","X",76029895,76030330,435
"27077","ENSG00000232333","20",17516843,17517307,464
"27078","ENSG00000232334","10",124004304,124004828,524
"27079","ENSG00000232335","1",35739389,35743576,4187
"27080","ENSG00000232341","1",166747379,166748660,1281
"27081","ENSG00000232342","10",74506081,74530553,24472
"27082","ENSG00000232344","17",18010643,18011822,1179
"27083","ENSG00000232346","22",32039490,32039896,406
"27084","ENSG00000232347","1",247210691,247241823,31132
"27085","ENSG00000232352","3",50266641,50267371,730
"27086","ENSG00000232353","3",192029880,192036557,6677
"27087","ENSG00000232354","3",42506465,42533258,26793
"27088","ENSG00000232355","9",134868236,134868475,239
"27089","ENSG00000232360","21",32844367,32849934,5567
"27090","ENSG00000232361","7",150614061,150614764,703
"27091","ENSG00000232362","6",122859678,122859988,310
"27092","ENSG00000232363","22",45435864,45448743,12879
"27093","ENSG00000232368","X",30630298,30630825,527
"27094","ENSG00000232369","1",44988234,44988725,491
"27095","ENSG00000232370","X",38479215,38479913,698
"27096","ENSG00000232373","13",95694569,95695705,1136
"27097","ENSG00000232374","3",158841093,158841960,867
"27098","ENSG00000232375","3",43037121,43037451,330
"27099","ENSG00000232377","2",143937073,143964156,27083
"27100","ENSG00000232379","X",136947748,136948133,385
"27101","ENSG00000232380","13",68985058,68986064,1006
"27102","ENSG00000232381","11",5719290,5720212,922
"27103","ENSG00000232383","7",26276195,26276606,411
"27104","ENSG00000232385","7",94695027,94695819,792
"27105","ENSG00000232386","15",100849561,100861756,12195
"27106","ENSG00000232387","9",122761844,122762233,389
"27107","ENSG00000232388","20",18567347,18569563,2216
"27108","ENSG00000232389","6",70608234,70609334,1100
"27109","ENSG00000232390","11",3321862,3322202,340
"27110","ENSG00000232392","X",11334233,11335901,1668
"27111","ENSG00000232393","1",91023919,91024804,885
"27112","ENSG00000232394","15",27775621,27776798,1177
"27113","ENSG00000232395","6",114477350,114488752,11402
"27114","ENSG00000232396","22",29705256,29719859,14603
"27115","ENSG00000232398","4",67766480,67773854,7374
"27116","ENSG00000232400","7",16864267,16866308,2041
"27117","ENSG00000232401","21",41715806,41717975,2169
"27118","ENSG00000232403","2",63108118,63108429,311
"27119","ENSG00000232406","20",36147334,36155760,8426
"27120","ENSG00000232407","3",60690225,60690719,494
"27121","ENSG00000232411","2",165833048,165839098,6050
"27122","ENSG00000232412","X",123959233,123961341,2108
"27123","ENSG00000232415","7",74059576,74062284,2708
"27124","ENSG00000232416","3",139104185,139125171,20986
"27125","ENSG00000232419","Y",8704472,8705283,811
"27126","ENSG00000232422","6",72986313,72987750,1437
"27127","ENSG00000232429","19",33589206,33589688,482
"27128","ENSG00000232431","15",28788243,28792002,3759
"27129","ENSG00000232434","9",136844415,136848801,4386
"27130","ENSG00000232436","1",221508559,221510979,2420
"27131","ENSG00000232437","10",75125217,75125862,645
"27132","ENSG00000232439","3",38526802,38527325,523
"27133","ENSG00000232442","20",63627227,63628824,1597
"27134","ENSG00000232444","2",16316324,16319566,3242
"27135","ENSG00000232445","7",101308270,101314800,6530
"27136","ENSG00000232446","X",26147774,26148281,507
"27137","ENSG00000232448","20",10172701,10186740,14039
"27138","ENSG00000232450","1",113698884,113699631,747
"27139","ENSG00000232451","2",23018125,23199056,180931
"27140","ENSG00000232453","1",58882868,58931897,49029
"27141","ENSG00000232454","9",37836044,37836394,350
"27142","ENSG00000232455","3",45483974,45509545,25571
"27143","ENSG00000232456","1",16035178,16040029,4851
"27144","ENSG00000232457","17",64953683,64956546,2863
"27145","ENSG00000232458","7",40964667,40979939,15272
"27146","ENSG00000232460","11",121361854,121362865,1011
"27147","ENSG00000232464","22",25959074,25983526,24452
"27148","ENSG00000232465","20",52487922,52500591,12669
"27149","ENSG00000232466","9",26880178,26880549,371
"27150","ENSG00000232467","1",45846994,45847594,600
"27151","ENSG00000232470","10",110869743,110871594,1851
"27152","ENSG00000232471","4",49550032,49557400,7368
"27153","ENSG00000232472","X",24788392,24789069,677
"27154","ENSG00000232474","2",133431666,133433897,2231
"27155","ENSG00000232479","2",202924609,202925904,1295
"27156","ENSG00000232480","1",218344196,218345678,1482
"27157","ENSG00000232482","1",23410832,23412146,1314
"27158","ENSG00000232485","2",216479030,216498761,19731
"27159","ENSG00000232486","9",105758164,105760755,2591
"27160","ENSG00000232487","13",114107569,114108820,1251
"27161","ENSG00000232489","13",30541643,30542897,1254
"27162","ENSG00000232490","3",31704058,31721652,17594
"27163","ENSG00000232491","7",66556216,66557065,849
"27164","ENSG00000232492","7",18948898,18949762,864
"27165","ENSG00000232493","20",41547422,41547922,500
"27166","ENSG00000232494","9",79874696,79886678,11982
"27167","ENSG00000232496","X",122538253,122539460,1207
"27168","ENSG00000232499","1",113449700,113450728,1028
"27169","ENSG00000232500","11",64500846,64505386,4540
"27170","ENSG00000232502","2",94760774,94761116,342
"27171","ENSG00000232503","2",130776646,130776957,311
"27172","ENSG00000232504","2",85889151,85891136,1985
"27173","ENSG00000232508","2",88364695,88365608,913
"27174","ENSG00000232512","21",25095022,25103670,8648
"27175","ENSG00000232515","22",22347807,22348164,357
"27176","ENSG00000232517","5",54808210,54872551,64341
"27177","ENSG00000232518","2",38668202,38671421,3219
"27178","ENSG00000232519","1",155609776,155610380,604
"27179","ENSG00000232520","2",230886474,230904693,18219
"27180","ENSG00000232524","7",123456629,123459856,3227
"27181","ENSG00000232526","2",42463139,42463997,858
"27182","ENSG00000232527","1",144227029,144250326,23297
"27183","ENSG00000232528","20",1767957,1779995,12038
"27184","ENSG00000232529","6",155380511,155381183,672
"27185","ENSG00000232530","22",30239194,30240538,1344
"27186","ENSG00000232531","2",91747940,91748986,1046
"27187","ENSG00000232533","7",143379692,143380495,803
"27188","ENSG00000232535","3",98306752,98312843,6091
"27189","ENSG00000232536","1",151540516,151561855,21339
"27190","ENSG00000232537","1",209147220,209266758,119538
"27191","ENSG00000232539","21",33057829,33064983,7154
"27192","ENSG00000232540","13",43394525,43394825,300
"27193","ENSG00000232542","1",97394154,97420141,25987
"27194","ENSG00000232543","14",105903616,105903631,15
"27195","ENSG00000232545","22",24101689,24103354,1665
"27196","ENSG00000232546","7",66848496,66858136,9640
"27197","ENSG00000232548","2",83522814,83523502,688
"27198","ENSG00000232549","X",139446891,139447676,785
"27199","ENSG00000232553","7",23585062,23586355,1293
"27200","ENSG00000232554","10",45099487,45154606,55119
"27201","ENSG00000232555","2",172137345,172370401,233056
"27202","ENSG00000232556","2",101520834,101521976,1142
"27203","ENSG00000232557","1",23907111,23907885,774
"27204","ENSG00000232558","1",111853762,111856905,3143
"27205","ENSG00000232560","21",17438821,17450104,11283
"27206","ENSG00000232564","22",40521800,40526707,4907
"27207","ENSG00000232568","2",186261419,186261919,500
"27208","ENSG00000232573","14",98972879,98973301,422
"27209","ENSG00000232578","5",94592771,94594791,2020
"27210","ENSG00000232579","19",12504665,12504890,225
"27211","ENSG00000232583","Y",7100733,7106502,5769
"27212","ENSG00000232586","1",180949699,180954887,5188
"27213","ENSG00000232587","13",28214513,28215897,1384
"27214","ENSG00000232590","9",73573615,73579498,5883
"27215","ENSG00000232591","10",7444340,7472040,27700
"27216","ENSG00000232593","X",53094145,53170914,76769
"27217","ENSG00000232594","2",94961047,94961503,456
"27218","ENSG00000232596","1",4571481,4594016,22535
"27219","ENSG00000232597","2",103855829,103869651,13822
"27220","ENSG00000232599","X",125203805,125204338,533
"27221","ENSG00000232600","8",144437675,144439971,2296
"27222","ENSG00000232603","22",22370829,22371120,291
"27223","ENSG00000232604","2",52864235,52866631,2396
"27224","ENSG00000232605","7",84876554,84876956,402
"27225","ENSG00000232606","2",144523912,144579434,55522
"27226","ENSG00000232608","21",39216624,39217506,882
"27227","ENSG00000232610","3",190714811,190716399,1588
"27228","ENSG00000232611","X",136840931,136847797,6866
"27229","ENSG00000232612","7",54656358,54656734,376
"27230","ENSG00000232613","2",65030727,65053017,22290
"27231","ENSG00000232615","5",1614836,1616334,1498
"27232","ENSG00000232618","6",142946406,142957945,11539
"27233","ENSG00000232621","1",207225798,207229202,3404
"27234","ENSG00000232622","1",84636158,84637106,948
"27235","ENSG00000232623","21",32306464,32308737,2273
"27236","ENSG00000232624","10",28743506,28941910,198404
"27237","ENSG00000232625","2",218841599,218842065,466
"27238","ENSG00000232626","1",202438396,202439957,1561
"27239","ENSG00000232627","7",23365618,23365976,358
"27240","ENSG00000232628","1",224208741,224213625,4884
"27241","ENSG00000232629","6",32756098,32763532,7434
"27242","ENSG00000232630","9",125150653,125151589,936
"27243","ENSG00000232631","2",211777206,211777856,650
"27244","ENSG00000232633","5",113323028,113437174,114146
"27245","ENSG00000232634","Y",21221106,21222089,983
"27246","ENSG00000232636","13",87427200,87447235,20035
"27247","ENSG00000232638","10",8051541,8053084,1543
"27248","ENSG00000232640","6",169725091,169725854,763
"27249","ENSG00000232642","2",24165884,24175005,9121
"27250","ENSG00000232644","X",26200042,26200647,605
"27251","ENSG00000232645","20",23356594,23358116,1522
"27252","ENSG00000232646","10",73065126,73065467,341
"27253","ENSG00000232648","4",183494884,183504494,9610
"27254","ENSG00000232650","1",119327399,119356182,28783
"27255","ENSG00000232653","15",32593456,32607310,13854
"27256","ENSG00000232655","22",44443327,44444788,1461
"27257","ENSG00000232656","10",1022630,1045425,22795
"27258","ENSG00000232662","13",113276616,113277734,1118
"27259","ENSG00000232663","1",8909742,8909904,162
"27260","ENSG00000232667","7",80312574,80391474,78900
"27261","ENSG00000232668","2",52883243,52883455,212
"27262","ENSG00000232671","1",151279678,151281950,2272
"27263","ENSG00000232672","1",77773865,77774864,999
"27264","ENSG00000232675","20",19693209,19697576,4367
"27265","ENSG00000232676","1",79521080,79522203,1123
"27266","ENSG00000232677","19",36313067,36331770,18703
"27267","ENSG00000232678","1",152077952,152078211,259
"27268","ENSG00000232679","1",222010825,222064773,53948
"27269","ENSG00000232680","19",35432957,35434642,1685
"27270","ENSG00000232682","10",60050668,60060743,10075
"27271","ENSG00000232684","13",112745449,112754693,9244
"27272","ENSG00000232685","13",19008259,19026802,18543
"27273","ENSG00000232687","21",29127701,29128188,487
"27274","ENSG00000232688","2",66921510,66922482,972
"27275","ENSG00000232692","21",26378552,26471698,93146
"27276","ENSG00000232693","2",65373700,65380685,6985
"27277","ENSG00000232696","2",46078015,46078828,813
"27278","ENSG00000232699","6",99174744,99175479,735
"27279","ENSG00000232701","13",74377163,74377951,788
"27280","ENSG00000232702","6",51410081,51410537,456
"27281","ENSG00000232706","10",50676743,50686326,9583
"27282","ENSG00000232709","10",92418667,92420875,2208
"27283","ENSG00000232710","22",42136433,42139927,3494
"27284","ENSG00000232712","20",21154023,21218289,64266
"27285","ENSG00000232713","2",60938204,60938604,400
"27286","ENSG00000232715","7",158590629,158591120,491
"27287","ENSG00000232716","7",130840204,130843725,3521
"27288","ENSG00000232717","2",95574901,95580769,5868
"27289","ENSG00000232718","2",3688021,3688981,960
"27290","ENSG00000232719","2",201101382,201103136,1754
"27291","ENSG00000232721","1",143736066,143739506,3440
"27292","ENSG00000232723","2",121309995,121310412,417
"27293","ENSG00000232724","17",75074306,75079549,5243
"27294","ENSG00000232725","X",153735626,153766478,30852
"27295","ENSG00000232727","7",64433830,64434592,762
"27296","ENSG00000232729","7",74688864,74729001,40137
"27297","ENSG00000232730","Y",12321623,12322835,1212
"27298","ENSG00000232732","2",199867396,199911159,43763
"27299","ENSG00000232734","10",69432972,69433371,399
"27300","ENSG00000232738","20",9575608,9577689,2081
"27301","ENSG00000232739","10",15237492,15241767,4275
"27302","ENSG00000232742","2",131460999,131461577,578
"27303","ENSG00000232743","9",87816465,87817970,1505
"27304","ENSG00000232746","3",12877522,12885211,7689
"27305","ENSG00000232747","2",89895502,89895772,270
"27306","ENSG00000232748","16",31056460,31062803,6343
"27307","ENSG00000232749","9",82451656,82455225,3569
"27308","ENSG00000232750","1",179035309,179035652,343
"27309","ENSG00000232751","1",173351689,173352004,315
"27310","ENSG00000232752","1",93924743,93925385,642
"27311","ENSG00000232754","22",41169190,41183144,13954
"27312","ENSG00000232756","7",77990384,77995171,4787
"27313","ENSG00000232757","6",30031713,30033003,1290
"27314","ENSG00000232759","7",22563337,22573996,10659
"27315","ENSG00000232760","2",131833783,131836532,2749
"27316","ENSG00000232762","1",53304536,53307462,2926
"27317","ENSG00000232765","X",55279839,55288785,8946
"27318","ENSG00000232766","3",27703129,27703568,439
"27319","ENSG00000232767","10",116670034,116672750,2716
"27320","ENSG00000232768","1",31050872,31051034,162
"27321","ENSG00000232772","2",143096839,143098007,1168
"27322","ENSG00000232774","14",61570405,61658696,88291
"27323","ENSG00000232775","22",15805263,15820884,15621
"27324","ENSG00000232778","6",107931800,107932254,454
"27325","ENSG00000232780","1",119434166,119435080,914
"27326","ENSG00000232783","3",198110112,198111878,1766
"27327","ENSG00000232788","2",172464262,172466022,1760
"27328","ENSG00000232791","1",110853939,110854892,953
"27329","ENSG00000232792","1",185071567,185072035,468
"27330","ENSG00000232793","1",245282831,245283089,258
"27331","ENSG00000232794","X",64044305,64045058,753
"27332","ENSG00000232795","13",35185294,35186679,1385
"27333","ENSG00000232797","21",13792635,13793141,506
"27334","ENSG00000232799","2",209145241,209147687,2446
"27335","ENSG00000232801","X",40890647,40891537,890
"27336","ENSG00000232803","20",62663019,62666724,3705
"27337","ENSG00000232806","21",41559125,41562958,3833
"27338","ENSG00000232807","10",5934270,5945900,11630
"27339","ENSG00000232809","1",215376484,215377374,890
"27340","ENSG00000232810","6",31575565,31578336,2771
"27341","ENSG00000232811","1",110943467,110952848,9381
"27342","ENSG00000232812","1",208728665,208736286,7621
"27343","ENSG00000232814","13",110502575,110508179,5604
"27344","ENSG00000232815","9",63817748,63818462,714
"27345","ENSG00000232818","7",23490473,23491364,891
"27346","ENSG00000232821","7",19112474,19114271,1797
"27347","ENSG00000232823","10",119683127,119683823,696
"27348","ENSG00000232824","1",198197779,198198186,407
"27349","ENSG00000232825","1",99004276,99244794,240518
"27350","ENSG00000232828","X",48698963,48737163,38200
"27351","ENSG00000232829","3",130827659,130828376,717
"27352","ENSG00000232830","3",101414228,101414633,405
"27353","ENSG00000232832","3",198038321,198039234,913
"27354","ENSG00000232835","2",5549780,5556031,6251
"27355","ENSG00000232837","21",38974429,38977774,3345
"27356","ENSG00000232838","20",18137863,18143169,5306
"27357","ENSG00000232841","7",17033089,17033478,389
"27358","ENSG00000232842","X",95973328,95974315,987
"27359","ENSG00000232843","9",92893698,92894505,807
"27360","ENSG00000232846","1",51709062,51709940,878
"27361","ENSG00000232848","1",8057245,8058463,1218
"27362","ENSG00000232850","9",128128529,128130628,2099
"27363","ENSG00000232852","20",64290187,64292998,2811
"27364","ENSG00000232855","21",28328738,28674848,346110
"27365","ENSG00000232858","13",24988577,24988925,348
"27366","ENSG00000232859","17",27878314,27894752,16438
"27367","ENSG00000232860","1",183460874,183472265,11391
"27368","ENSG00000232862","1",36080066,36084026,3960
"27369","ENSG00000232864","1",227410617,227411319,702
"27370","ENSG00000232867","9",27210327,27210626,299
"27371","ENSG00000232869","7",142740206,142740894,688
"27372","ENSG00000232871","19",48638071,48682245,44174
"27373","ENSG00000232872","13",51908218,51910621,2403
"27374","ENSG00000232873","3",194562978,194564001,1023
"27375","ENSG00000232874","3",194130616,194131201,585
"27376","ENSG00000232875","10",96915633,96915902,269
"27377","ENSG00000232876","6",135055033,135060550,5517
"27378","ENSG00000232878","1",97095923,97322955,227032
"27379","ENSG00000232879","1",161034834,161035006,172
"27380","ENSG00000232880","20",45388347,45388705,358
"27381","ENSG00000232882","1",90892992,90893612,620
"27382","ENSG00000232883","1",220316667,220317599,932
"27383","ENSG00000232884","21",14728396,14753925,25529
"27384","ENSG00000232885","13",92339794,92379536,39742
"27385","ENSG00000232886","21",16862875,16873691,10816
"27386","ENSG00000232887","7",31119284,31119572,288
"27387","ENSG00000232888","12",132825701,132826184,483
"27388","ENSG00000232891","6",150600834,150605850,5016
"27389","ENSG00000232892","1",163161675,163213023,51348
"27390","ENSG00000232893","2",236391074,236392388,1314
"27391","ENSG00000232894","13",19552571,19570288,17717
"27392","ENSG00000232896","9",110599475,110605219,5744
"27393","ENSG00000232900","20",10875333,10909279,33946
"27394","ENSG00000232901","3",10000647,10000940,293
"27395","ENSG00000232903","10",132943967,132965289,21322
"27396","ENSG00000232905","9",113850687,113851632,945
"27397","ENSG00000232906","7",65355934,65357176,1242
"27398","ENSG00000232907","20",36507702,36573391,65689
"27399","ENSG00000232908","1",247827486,247828502,1016
"27400","ENSG00000232909","6",35733867,35736947,3080
"27401","ENSG00000232912","1",8424645,8435013,10368
"27402","ENSG00000232913","10",94081950,94108814,26864
"27403","ENSG00000232915","2",138412066,138413318,1252
"27404","ENSG00000232916","5",116218026,116218295,269
"27405","ENSG00000232917","1",203903723,203904013,290
"27406","ENSG00000232920","9",37073531,37075792,2261
"27407","ENSG00000232922","7",112373733,112374250,517
"27408","ENSG00000232926","22",19887289,19887970,681
"27409","ENSG00000232927","Y",3682805,3683868,1063
"27410","ENSG00000232928","X",74121012,74131923,10911
"27411","ENSG00000232930","7",36001317,36055431,54114
"27412","ENSG00000232931","2",95807052,95835003,27951
"27413","ENSG00000232934","10",112395813,112425589,29776
"27414","ENSG00000232936","10",89645272,89652144,6872
"27415","ENSG00000232938","17",83226897,83240804,13907
"27416","ENSG00000232939","9",109760360,109772043,11683
"27417","ENSG00000232940","6",33249534,33255167,5633
"27418","ENSG00000232944","7",56408699,56409210,511
"27419","ENSG00000232946","9",6675284,6675614,330
"27420","ENSG00000232949","7",22589698,22602536,12838
"27421","ENSG00000232951","X",51921864,51922499,635
"27422","ENSG00000232952","1",105891739,105893517,1778
"27423","ENSG00000232953","3",19940269,19943310,3041
"27424","ENSG00000232956","7",44983023,44986961,3938
"27425","ENSG00000232959","1",170024077,170024683,606
"27426","ENSG00000232963","2",24330402,24330674,272
"27427","ENSG00000232964","1",230592660,230595583,2923
"27428","ENSG00000232965","10",79544087,79544356,269
"27429","ENSG00000232969","21",44339376,44340470,1094
"27430","ENSG00000232970","2",216156342,216156811,469
"27431","ENSG00000232971","1",108734256,108734725,469
"27432","ENSG00000232973","2",38073447,38231651,158204
"27433","ENSG00000232977","13",23465776,23487712,21936
"27434","ENSG00000232978","9",19291337,19292576,1239
"27435","ENSG00000232981","9",80563571,80564630,1059
"27436","ENSG00000232982","2",155263458,155263724,266
"27437","ENSG00000232983","9",34546524,34546996,472
"27438","ENSG00000232985","10",128958772,128960062,1290
"27439","ENSG00000232986","13",33657436,33659928,2492
"27440","ENSG00000232987","11",1991096,1993670,2574
"27441","ENSG00000232991","2",107754112,107822129,68017
"27442","ENSG00000232994","2",203040108,203040899,791
"27443","ENSG00000232995","1",163244505,163321894,77389
"27444","ENSG00000232998","9",77176760,77178180,1420
"27445","ENSG00000232999","6",2910613,2912113,1500
"27446","ENSG00000233002","17",15735023,15749192,14169
"27447","ENSG00000233003","1",227975390,227978193,2803
"27448","ENSG00000233005","2",21221169,21970959,749790
"27449","ENSG00000233006","5",132311285,132370170,58885
"27450","ENSG00000233007","X",38531923,38534174,2251
"27451","ENSG00000233008","1",83575776,83861023,285247
"27452","ENSG00000233009","13",100708325,101059286,350961
"27453","ENSG00000233010","22",29608900,29609501,601
"27454","ENSG00000233012","1",220625740,220628056,2316
"27455","ENSG00000233013","9",138217068,138253217,36149
"27456","ENSG00000233014","17",41323427,41329545,6118
"27457","ENSG00000233015","20",21742303,21743077,774
"27458","ENSG00000233016","9",136721366,136728184,6818
"27459","ENSG00000233017","20",62427827,62447677,19850
"27460","ENSG00000233018","1",235097187,235097412,225
"27461","ENSG00000233020","1",70530526,70531492,966
"27462","ENSG00000233021","10",437561,441170,3609
"27463","ENSG00000233024","16",18358086,18379331,21245
"27464","ENSG00000233025","7",103088664,103089610,946
"27465","ENSG00000233026","3",12165299,12165642,343
"27466","ENSG00000233028","7",56175634,56176412,778
"27467","ENSG00000233029","1",121090289,121097655,7366
"27468","ENSG00000233030","1",149785659,149793020,7361
"27469","ENSG00000233031","2",203672175,203672423,248
"27470","ENSG00000233033","X",41520036,41522336,2300
"27471","ENSG00000233036","21",30802242,30802427,185
"27472","ENSG00000233037","2",95542730,95543230,500
"27473","ENSG00000233038","7",157854529,157863011,8482
"27474","ENSG00000233040","1",197746751,197747451,700
"27475","ENSG00000233041","15",40351033,40356434,5401
"27476","ENSG00000233044","6",157107727,157119706,11979
"27477","ENSG00000233045","2",138278574,138279210,636
"27478","ENSG00000233047","1",105927620,106028277,100657
"27479","ENSG00000233048","20",12865202,12952519,87317
"27480","ENSG00000233052","10",1361001,1361637,636
"27481","ENSG00000233055","9",101501643,101501885,242
"27482","ENSG00000233056","21",42916803,42925646,8843
"27483","ENSG00000233057","1",194188967,194190342,1375
"27484","ENSG00000233058","3",194487140,194521156,34016
"27485","ENSG00000233060","2",70089721,70096100,6379
"27486","ENSG00000233061","1",83979118,83984300,5182
"27487","ENSG00000233063","X",75884546,75885136,590
"27488","ENSG00000233064","6",5851506,5870220,18714
"27489","ENSG00000233067","X",22191895,23293146,1101251
"27490","ENSG00000233068","6",3831936,3894292,62356
"27491","ENSG00000233069","1",20732880,20733952,1072
"27492","ENSG00000233070","Y",2966844,3002626,35782
"27493","ENSG00000233071","X",103206010,103206899,889
"27494","ENSG00000233072","1",21003550,21003934,384
"27495","ENSG00000233073","7",86782357,86803409,21052
"27496","ENSG00000233077","20",50310711,50321342,10631
"27497","ENSG00000233079","1",55868254,55950119,81865
"27498","ENSG00000233080","22",35119824,35231056,111232
"27499","ENSG00000233081","9",91426238,91427144,906
"27500","ENSG00000233082","7",1267353,1269267,1914
"27501","ENSG00000233083","2",52629743,52630078,335
"27502","ENSG00000233084","1",248936581,248937043,462
"27503","ENSG00000233085","6",169286534,169289216,2682
"27504","ENSG00000233086","9",79505804,79567802,61998
"27505","ENSG00000233087","2",131361111,131364142,3031
"27506","ENSG00000233090","17",15792862,15793045,183
"27507","ENSG00000233093","X",136639539,136642429,2890
"27508","ENSG00000233096","3",40970541,40971578,1037
"27509","ENSG00000233098","17",20868433,21002276,133843
"27510","ENSG00000233099","1",77346046,77349585,3539
"27511","ENSG00000233101","17",48549630,48606414,56784
"27512","ENSG00000233106","20",33272262,33272657,395
"27513","ENSG00000233108","7",7958183,7969903,11720
"27514","ENSG00000233110","4",185587909,185594003,6094
"27515","ENSG00000233111","9",37636688,37637293,605
"27516","ENSG00000233114","1",46104950,46105175,225
"27517","ENSG00000233115","8",8011782,8017011,5229
"27518","ENSG00000233117","10",4201141,4243912,42771
"27519","ENSG00000233121","3",13926813,13927778,965
"27520","ENSG00000233122","10",130106046,130108481,2435
"27521","ENSG00000233123","7",101562779,101569006,6227
"27522","ENSG00000233124","13",97168751,97187578,18827
"27523","ENSG00000233125","1",92229018,92229435,417
"27524","ENSG00000233128","2",40746481,40767452,20971
"27525","ENSG00000233129","1",93934479,93935244,765
"27526","ENSG00000233133","3",17706058,17706233,175
"27527","ENSG00000233134","2",202617284,202617627,343
"27528","ENSG00000233138","6",142748443,142753759,5316
"27529","ENSG00000233139","X",48153868,48155941,2073
"27530","ENSG00000233143","2",217261699,217336120,74421
"27531","ENSG00000233144","10",73381433,73383496,2063
"27532","ENSG00000233145","X",140017268,140018037,769
"27533","ENSG00000233146","20",33316869,33329969,13100
"27534","ENSG00000233148","9",35010703,35011285,582
"27535","ENSG00000233153","3",23194929,23202703,7774
"27536","ENSG00000233154","1",116423724,116478842,55118
"27537","ENSG00000233155","2",74418122,74418442,320
"27538","ENSG00000233157","22",43759199,43759910,711
"27539","ENSG00000233158","2",94912432,94912831,399
"27540","ENSG00000233159","2",37194382,37194737,355
"27541","ENSG00000233163","10",69161530,69161906,376
"27542","ENSG00000233167","7",14190795,14192157,1362
"27543","ENSG00000233170","8",37747338,37748004,666
"27544","ENSG00000233173","7",63934449,63935331,882
"27545","ENSG00000233175","17",45238028,45241734,3706
"27546","ENSG00000233176","8",7592006,7592916,910
"27547","ENSG00000233178","9",68393881,68406500,12619
"27548","ENSG00000233179","22",48448890,48451217,2327
"27549","ENSG00000233183","6",33891327,33927631,36304
"27550","ENSG00000233184","1",101025844,101090513,64669
"27551","ENSG00000233186","9",4803788,4804972,1184
"27552","ENSG00000233189","10",84389170,84389626,456
"27553","ENSG00000233190","10",32231849,32232245,396
"27554","ENSG00000233191","7",157513294,157518658,5364
"27555","ENSG00000233193","17",15761614,15763769,2155
"27556","ENSG00000233196","1",186580515,186581191,676
"27557","ENSG00000233197","10",69523311,69523650,339
"27558","ENSG00000233198","9",137227271,137229638,2367
"27559","ENSG00000233200","10",35219894,35230598,10704
"27560","ENSG00000233203","1",54887563,54888850,1287
"27561","ENSG00000233204","2",165285253,165286048,795
"27562","ENSG00000233205","2",87972656,87973082,426
"27563","ENSG00000233208","14",90453571,90490763,37192
"27564","ENSG00000233213","21",37717102,37719569,2467
"27565","ENSG00000233214","19",35424062,35424652,590
"27566","ENSG00000233215","21",22008756,22098518,89762
"27567","ENSG00000233217","1",200917460,200966668,49208
"27568","ENSG00000233219","7",33868501,33874231,5730
"27569","ENSG00000233220","11",130002938,130004356,1418
"27570","ENSG00000233221","2",130830978,130836994,6016
"27571","ENSG00000233223","17",7581964,7584086,2122
"27572","ENSG00000233225","7",39833571,39834718,1147
"27573","ENSG00000233228","1",92066306,92067839,1533
"27574","ENSG00000233229","X",69937166,69938017,851
"27575","ENSG00000233230","2",47905678,47907810,2132
"27576","ENSG00000233231","6",166334568,166335471,903
"27577","ENSG00000233232","16",28456372,28471175,14803
"27578","ENSG00000233234","1",2811850,2812692,842
"27579","ENSG00000233235","1",89324522,89334880,10358
"27580","ENSG00000233237","6",71343427,71420745,77318
"27581","ENSG00000233242","9",37112548,37120446,7898
"27582","ENSG00000233243","X",27863893,27864349,456
"27583","ENSG00000233246","1",33350352,33363245,12893
"27584","ENSG00000233247","X",14244382,14244928,546
"27585","ENSG00000233250","X",53432722,53433032,310
"27586","ENSG00000233251","2",56173534,56185870,12336
"27587","ENSG00000233256","10",13415202,13423133,7931
"27588","ENSG00000233258","10",83911654,83912922,1268
"27589","ENSG00000233259","13",42369259,42369657,398
"27590","ENSG00000233260","X",133762796,133763683,887
"27591","ENSG00000233261","10",26589865,26594330,4465
"27592","ENSG00000233262","9",84278219,84290131,11912
"27593","ENSG00000233264","7",7980312,7982228,1916
"27594","ENSG00000233266","2",54051334,54051760,426
"27595","ENSG00000233268","1",9660828,9662626,1798
"27596","ENSG00000233270","19",5576660,5576938,278
"27597","ENSG00000233273","13",96573659,96574499,840
"27598","ENSG00000233276","3",49357176,49358358,1182
"27599","ENSG00000233277","20",43894720,43895468,748
"27600","ENSG00000233278","9",30831878,30832225,347
"27601","ENSG00000233286","2",120212935,120213275,340
"27602","ENSG00000233287","7",131242590,131242995,405
"27603","ENSG00000233288","7",56528253,56538676,10423
"27604","ENSG00000233290","1",82212413,82848205,635792
"27605","ENSG00000233292","10",89139044,89139458,414
"27606","ENSG00000233293","20",32561093,32573888,12795
"27607","ENSG00000233295","8",7295014,7298024,3010
"27608","ENSG00000233296","2",677186,697382,20196
"27609","ENSG00000233297","7",102681836,102690469,8633
"27610","ENSG00000233300","21",27367014,27367947,933
"27611","ENSG00000233303","3",195094588,195096057,1469
"27612","ENSG00000233304","1",3940486,3955262,14776
"27613","ENSG00000233306","7",38362864,38363518,654
"27614","ENSG00000233307","2",109732731,109733136,405
"27615","ENSG00000233308","3",191213291,191234605,21314
"27616","ENSG00000233309","9",82744067,82744792,725
"27617","ENSG00000233311","2",202619185,202619896,711
"27618","ENSG00000233313","10",75276376,75276646,270
"27619","ENSG00000233316","21",38206156,38208644,2488
"27620","ENSG00000233319","10",130131770,130132241,471
"27621","ENSG00000233321","10",3433508,3502915,69407
"27622","ENSG00000233324","20",18782424,18783690,1266
"27623","ENSG00000233325","13",21298139,21306373,8234
"27624","ENSG00000233327","17",18511262,18525930,14668
"27625","ENSG00000233328","1",171670517,171670939,422
"27626","ENSG00000233330","6",149591755,149592663,908
"27627","ENSG00000233332","1",234212606,234215088,2482
"27628","ENSG00000233333","1",78170481,78171237,756
"27629","ENSG00000233334","10",124703625,124714217,10592
"27630","ENSG00000233335","2",46256860,46257177,317
"27631","ENSG00000233337","1",111437514,111438037,523
"27632","ENSG00000233338","X",12902817,12908333,5516
"27633","ENSG00000233339","2",106179542,106183797,4255
"27634","ENSG00000233340","10",112671812,112677819,6007
"27635","ENSG00000233342","6",160926269,160943110,16841
"27636","ENSG00000233343","10",35158306,35158640,334
"27637","ENSG00000233347","20",52110344,52111049,705
"27638","ENSG00000233349","13",84562364,84563236,872
"27639","ENSG00000233351","6",129479615,129481410,1795
"27640","ENSG00000233354","20",31485778,31487574,1796
"27641","ENSG00000233355","1",239703381,239770130,66749
"27642","ENSG00000233357","X",13574746,13575066,320
"27643","ENSG00000233358","6",22744395,23031780,287385
"27644","ENSG00000233359","1",102199739,102389630,189891
"27645","ENSG00000233360","22",37641832,37658377,16545
"27646","ENSG00000233363","7",154092201,154096043,3842
"27647","ENSG00000233365","6",166236969,166256947,19978
"27648","ENSG00000233366","6",28888832,28889906,1074
"27649","ENSG00000233367","9",6415145,6449558,34413
"27650","ENSG00000233369","7",73154938,73207283,52345
"27651","ENSG00000233370","2",110184054,110185179,1125
"27652","ENSG00000233372","1",30140263,30141607,1344
"27653","ENSG00000233376","20",44389624,44391537,1913
"27654","ENSG00000233377","10",94940253,94941121,868
"27655","ENSG00000233379","13",77939016,77975539,36523
"27656","ENSG00000233380","17",53756989,53757870,881
"27657","ENSG00000233381","12",31615771,31616439,668
"27658","ENSG00000233382","X",120120953,120245267,124314
"27659","ENSG00000233383","7",67089257,67089470,213
"27660","ENSG00000233384","1",224608130,224616220,8090
"27661","ENSG00000233385","7",64106065,64106819,754
"27662","ENSG00000233387","10",33096257,33116672,20415
"27663","ENSG00000233388","22",35501861,35503586,1725
"27664","ENSG00000233392","2",240954617,240967451,12834
"27665","ENSG00000233393","21",36104881,36109690,4809
"27666","ENSG00000233395","10",43909244,43981102,71858
"27667","ENSG00000233396","1",146052566,146061948,9382
"27668","ENSG00000233397","2",162092232,162095032,2800
"27669","ENSG00000233401","1",92125301,92126462,1161
"27670","ENSG00000233403","X",25878339,25893544,15205
"27671","ENSG00000233405","13",21224521,21235204,10683
"27672","ENSG00000233406","1",51250603,51251472,869
"27673","ENSG00000233407","1",50206084,50223127,17043
"27674","ENSG00000233409","10",125972188,125973126,938
"27675","ENSG00000233410","1",199006040,199021037,14997
"27676","ENSG00000233411","1",167457383,167458661,1278
"27677","ENSG00000233415","20",40031585,40043889,12304
"27678","ENSG00000233416","2",20606280,20606654,374
"27679","ENSG00000233417","7",120141016,120227213,86197
"27680","ENSG00000233419","1",25125053,25125454,401
"27681","ENSG00000233420","7",88420167,88756725,336558
"27682","ENSG00000233421","1",16533886,16536172,2286
"27683","ENSG00000233424","9",42707800,42714539,6739
"27684","ENSG00000233425","9",122837557,122838820,1263
"27685","ENSG00000233426","2",58251440,58252525,1085
"27686","ENSG00000233427","1",28870483,28877336,6853
"27687","ENSG00000233428","2",129496297,129496788,491
"27688","ENSG00000233429","7",27095647,27100265,4618
"27689","ENSG00000233430","1",143811359,143825837,14478
"27690","ENSG00000233431","1",21586472,21591187,4715
"27691","ENSG00000233432","1",121502344,121503891,1547
"27692","ENSG00000233433","X",121024964,121026563,1599
"27693","ENSG00000233435","10",133640789,133642894,2105
"27694","ENSG00000233436","11",57743514,57751781,8267
"27695","ENSG00000233437","7",56875385,56882146,6761
"27696","ENSG00000233441","3",183895900,183910936,15036
"27697","ENSG00000233445","2",233721522,233722065,543
"27698","ENSG00000233447","2",94974544,94974838,294
"27699","ENSG00000233448","7",77039944,77043776,3832
"27700","ENSG00000233451","10",22361172,22413067,51895
"27701","ENSG00000233452","6",146824539,147204614,380075
"27702","ENSG00000233454","7",63057453,63060084,2631
"27703","ENSG00000233455","1",210303684,210304540,856
"27704","ENSG00000233457","9",78150532,78151193,661
"27705","ENSG00000233459","2",203634577,203636016,1439
"27706","ENSG00000233460","13",71845981,71846317,336
"27707","ENSG00000233461","1",231520729,231528618,7889
"27708","ENSG00000233467","X",148198014,148198878,864
"27709","ENSG00000233469","13",19818121,19818619,498
"27710","ENSG00000233471","22",19257520,19258806,1286
"27711","ENSG00000233472","10",27999788,28049615,49827
"27712","ENSG00000233473","1",159081133,159081795,662
"27713","ENSG00000233476","7",22510616,22511999,1383
"27714","ENSG00000233477","10",105685383,105685865,482
"27715","ENSG00000233478","1",25644544,25659111,14567
"27716","ENSG00000233479","2",113669166,113673191,4025
"27717","ENSG00000233480","21",19893113,19900043,6930
"27718","ENSG00000233482","1",94145111,94145619,508
"27719","ENSG00000233483","17",45245186,45251129,5943
"27720","ENSG00000233485","1",15326680,15343876,17196
"27721","ENSG00000233487","3",196983890,196987558,3668
"27722","ENSG00000233491","7",81489204,81691406,202202
"27723","ENSG00000233492","20",21530122,21535665,5543
"27724","ENSG00000233493","19",55379245,55384598,5353
"27725","ENSG00000233494","2",107902997,107903134,137
"27726","ENSG00000233496","6",158001107,158002383,1276
"27727","ENSG00000233497","11",110788026,110788976,950
"27728","ENSG00000233499","11",58365836,58366763,927
"27729","ENSG00000233502","2",10083781,10086101,2320
"27730","ENSG00000233508","20",43189998,43202599,12601
"27731","ENSG00000233509","3",44617128,44624797,7669
"27732","ENSG00000233511","6",108252214,108252400,186
"27733","ENSG00000233514","1",44122153,44122512,359
"27734","ENSG00000233515","10",42644445,42691723,47278
"27735","ENSG00000233516","9",117462294,117466260,3966
"27736","ENSG00000233517","7",28987028,28988899,1871
"27737","ENSG00000233518","10",110550115,110550854,739
"27738","ENSG00000233519","1",240400671,240401123,452
"27739","ENSG00000233521","22",27221349,27225134,3785
"27740","ENSG00000233522","Y",18326253,18353210,26957
"27741","ENSG00000233523","7",73187969,73188736,767
"27742","ENSG00000233524","13",20747035,20748057,1022
"27743","ENSG00000233527","19",36573070,36594708,21638
"27744","ENSG00000233528","13",86909586,86937108,27522
"27745","ENSG00000233529","6",30945979,30954862,8883
"27746","ENSG00000233532","13",106374477,106384315,9838
"27747","ENSG00000233533","10",36944111,36944738,627
"27748","ENSG00000233534","6",135628787,135634681,5894
"27749","ENSG00000233535","X",13955393,13963904,8511
"27750","ENSG00000233536","11",94638038,94640833,2795
"27751","ENSG00000233537","1",182441577,182442362,785
"27752","ENSG00000233538","2",231452195,231453153,958
"27753","ENSG00000233539","7",46673785,46759851,86066
"27754","ENSG00000233540","1",171864187,171864687,500
"27755","ENSG00000233542","1",2013213,2015639,2426
"27756","ENSG00000233547","10",112950646,112951875,1229
"27757","ENSG00000233548","X",145176582,145176894,312
"27758","ENSG00000233551","9",16775573,16775845,272
"27759","ENSG00000233553","2",1341044,1346568,5524
"27760","ENSG00000233554","9",33166948,33182865,15917
"27761","ENSG00000233555","9",63581254,63581834,580
"27762","ENSG00000233557","1",98077000,98077468,468
"27763","ENSG00000233558","6",116258493,116259115,622
"27764","ENSG00000233559","7",130853720,130930682,76962
"27765","ENSG00000233560","12",68705634,68707066,1432
"27766","ENSG00000233562","1",183266602,183267285,683
"27767","ENSG00000233569","9",117643151,117657032,13881
"27768","ENSG00000233570","3",16524771,16541903,17132
"27769","ENSG00000233571","X",34206725,34415537,208812
"27770","ENSG00000233574","22",27276240,27286349,10109
"27771","ENSG00000233575","9",1328664,1328987,323
"27772","ENSG00000233576","3",184076779,184084219,7440
"27773","ENSG00000233577","22",25279529,25282674,3145
"27774","ENSG00000233578","20",5548840,5549481,641
"27775","ENSG00000233579","2",202840331,202841781,1450
"27776","ENSG00000233581","2",216303325,216321737,18412
"27777","ENSG00000233583","1",185262286,185264356,2070
"27778","ENSG00000233585","X",48775644,48776970,1326
"27779","ENSG00000233586","1",144418678,144419190,512
"27780","ENSG00000233587","2",22508129,22548800,40671
"27781","ENSG00000233588","13",28722386,28724021,1635
"27782","ENSG00000233589","1",68479129,68483539,4410
"27783","ENSG00000233590","10",68233251,68242379,9128
"27784","ENSG00000233593","1",90769086,90851658,82572
"27785","ENSG00000233594","2",55435156,55435622,466
"27786","ENSG00000233595","1",50017092,50017503,411
"27787","ENSG00000233597","3",142043623,142044198,575
"27788","ENSG00000233601","7",57599794,57610104,10310
"27789","ENSG00000233602","1",44243408,44244273,865
"27790","ENSG00000233603","22",40798039,40798285,246
"27791","ENSG00000233605","2",77915870,77918011,2141
"27792","ENSG00000233607","7",115061537,115231355,169818
"27793","ENSG00000233608","2",238848032,238910534,62502
"27794","ENSG00000233609","8",8961200,8979025,17825
"27795","ENSG00000233610","13",48576974,48578088,1114
"27796","ENSG00000233611","2",236167447,236294927,127480
"27797","ENSG00000233613","13",113468901,113476135,7234
"27798","ENSG00000233614","16",11555,14090,2535
"27799","ENSG00000233615","1",240919653,240920609,956
"27800","ENSG00000233616","9",122400970,122402906,1936
"27801","ENSG00000233620","1",216072465,216086917,14452
"27802","ENSG00000233621","1",37350934,37474411,123477
"27803","ENSG00000233622","19",40808474,40812100,3626
"27804","ENSG00000233623","1",10058671,10059648,977
"27805","ENSG00000233625","20",17887363,17888160,797
"27806","ENSG00000233626","1",211936249,211936634,385
"27807","ENSG00000233633","2",558153,578145,19992
"27808","ENSG00000233635","17",63193930,63339053,145123
"27809","ENSG00000233639","2",104656135,104853183,197048
"27810","ENSG00000233642","10",25158072,25176276,18204
"27811","ENSG00000233643","10",61781745,61821246,39501
"27812","ENSG00000233644","13",111122652,111144264,21612
"27813","ENSG00000233645","1",8218190,8220529,2339
"27814","ENSG00000233646","11",5566678,5567616,938
"27815","ENSG00000233647","1",46665910,46666375,465
"27816","ENSG00000233654","2",190534855,190569776,34921
"27817","ENSG00000233655","14",105913222,105913237,15
"27818","ENSG00000233656","6",11417207,11481324,64117
"27819","ENSG00000233659","9",35874810,35875194,384
"27820","ENSG00000233661","X",63349646,63352178,2532
"27821","ENSG00000233662","13",98640814,98641239,425
"27822","ENSG00000233664","1",52709122,52709442,320
"27823","ENSG00000233665","10",48976554,48993046,16492
"27824","ENSG00000233668","9",34223984,34224628,644
"27825","ENSG00000233670","17",10822470,10838087,15617
"27826","ENSG00000233671","2",87221113,87222488,1375
"27827","ENSG00000233672","13",50862172,50910764,48592
"27828","ENSG00000233673","2",86861825,86912978,51153
"27829","ENSG00000233674","1",43743471,43743741,270
"27830","ENSG00000233677","6",29906543,29906909,366
"27831","ENSG00000233680","X",100887636,100888590,954
"27832","ENSG00000233681","19",42620212,42633034,12822
"27833","ENSG00000233682","6",159165899,159170007,4108
"27834","ENSG00000233684","2",317912,342118,24206
"27835","ENSG00000233685","10",133575122,133576031,909
"27836","ENSG00000233688","X",154919578,154920182,604
"27837","ENSG00000233689","7",69026433,69046803,20370
"27838","ENSG00000233690","10",99697407,99697949,542
"27839","ENSG00000233691","1",160935537,160936126,589
"27840","ENSG00000233693","1",164769116,164774641,5525
"27841","ENSG00000233694","2",64606975,64616556,9581
"27842","ENSG00000233695","13",113815630,113845744,30114
"27843","ENSG00000233699","Y",8682594,8700977,18383
"27844","ENSG00000233701","3",139042102,139044892,2790
"27845","ENSG00000233702","2",62507545,62507823,278
"27846","ENSG00000233705","7",107650260,107662204,11944
"27847","ENSG00000233708","1",42886597,42888767,2170
"27848","ENSG00000233712","1",157636300,157640301,4001
"27849","ENSG00000233713","9",86132622,86132851,229
"27850","ENSG00000233716","2",63232453,63233577,1124
"27851","ENSG00000233717","1",151111912,151112728,816
"27852","ENSG00000233718","2",15918350,15942249,23899
"27853","ENSG00000233719","12",9641723,9643011,1288
"27854","ENSG00000233720","22",22157382,22157631,249
"27855","ENSG00000233721","9",126516417,126518808,2391
"27856","ENSG00000233723","2",58427799,59063766,635967
"27857","ENSG00000233725","13",43908669,44030461,121792
"27858","ENSG00000233729","2",132915557,132931494,15937
"27859","ENSG00000233730","1",115099672,115102658,2986
"27860","ENSG00000233732","16",32995048,32995505,457
"27861","ENSG00000233733","22",31521199,31521592,393
"27862","ENSG00000233735","1",240177839,240179644,1805
"27863","ENSG00000233741","2",119993199,119993611,412
"27864","ENSG00000233746","20",23125068,23132635,7567
"27865","ENSG00000233747","2",24334512,24335152,640
"27866","ENSG00000233750","1",131025,134836,3811
"27867","ENSG00000233751","2",222677677,222678289,612
"27868","ENSG00000233752","2",36299388,36299830,442
"27869","ENSG00000233754","21",42781074,42782229,1155
"27870","ENSG00000233755","1",25043707,25113120,69413
"27871","ENSG00000233756","21",40615378,40630767,15389
"27872","ENSG00000233757","2",95207535,95259774,52239
"27873","ENSG00000233760","7",26551686,26558880,7194
"27874","ENSG00000233762","2",171517270,171517716,446
"27875","ENSG00000233764","22",36172422,36172779,357
"27876","ENSG00000233765","9",66253424,66254464,1040
"27877","ENSG00000233766","2",191846539,192044525,197986
"27878","ENSG00000233767","21",46072085,46072248,163
"27879","ENSG00000233771","1",223947605,223950416,2811
"27880","ENSG00000233775","1",32349194,32350663,1469
"27881","ENSG00000233776","9",33732975,33738416,5441
"27882","ENSG00000233778","8",92144088,92144435,347
"27883","ENSG00000233780","13",20938564,20949599,11035
"27884","ENSG00000233782","7",63087070,63088261,1191
"27885","ENSG00000233783","21",25928754,25952614,23860
"27886","ENSG00000233785","X",23772992,23782956,9964
"27887","ENSG00000233786","2",132262328,132263042,714
"27888","ENSG00000233787","5",29881709,29882945,1236
"27889","ENSG00000233791","1",203298758,203305309,6551
"27890","ENSG00000233797","6",96199840,96521717,321877
"27891","ENSG00000233799","4",764487,765074,587
"27892","ENSG00000233806","2",241881363,242078722,197359
"27893","ENSG00000233814","9",76419934,76420631,697
"27894","ENSG00000233816","9",21367424,21368962,1538
"27895","ENSG00000233817","9",113619228,113622634,3406
"27896","ENSG00000233818","21",36445731,36532408,86677
"27897","ENSG00000233820","9",96725890,96727469,1579
"27898","ENSG00000233821","13",43543918,43548056,4138
"27899","ENSG00000233822","6",27837760,27865798,28038
"27900","ENSG00000233823","6",151813276,151814179,903
"27901","ENSG00000233824","7",25321302,25326865,5563
"27902","ENSG00000233825","10",32346499,32347179,680
"27903","ENSG00000233827","1",200213678,200214322,644
"27904","ENSG00000233828","5",87048858,87240145,191287
"27905","ENSG00000233829","2",46003942,46004309,367
"27906","ENSG00000233830","7",27458163,27458849,686
"27907","ENSG00000233832","10",38783004,38783108,104
"27908","ENSG00000233834","7",20217577,20221700,4123
"27909","ENSG00000233836","19",23762944,23833314,70370
"27910","ENSG00000233837","10",42566677,42567483,806
"27911","ENSG00000233839","1",113168994,113169403,409
"27912","ENSG00000233840","13",66990886,67002007,11121
"27913","ENSG00000233842","2",145872209,145931146,58937
"27914","ENSG00000233844","6",72630495,72678558,48063
"27915","ENSG00000233845","2",47035279,47040524,5245
"27916","ENSG00000233846","9",6278667,6279153,486
"27917","ENSG00000233847","5",60917490,60919573,2083
"27918","ENSG00000233848","6",20756103,20800694,44591
"27919","ENSG00000233850","2",95025193,95026709,1516
"27920","ENSG00000233851","13",21005157,21018122,12965
"27921","ENSG00000233852","17",13932720,13940594,7874
"27922","ENSG00000233854","7",38980370,39013551,33181
"27923","ENSG00000233858","8",48590401,48594621,4220
"27924","ENSG00000233859","6",65836930,65838039,1109
"27925","ENSG00000233860","4",76708853,76802426,93573
"27926","ENSG00000233862","2",29841187,30143804,302617
"27927","ENSG00000233866","22",15914721,15915800,1079
"27928","ENSG00000233867","10",38640971,38689068,48097
"27929","ENSG00000233868","2",221944223,221944612,389
"27930","ENSG00000233870","2",71178587,71178773,186
"27931","ENSG00000233871","10",77927372,77929824,2452
"27932","ENSG00000233872","2",74618856,74620979,2123
"27933","ENSG00000233873","13",76981175,76981916,741
"27934","ENSG00000233874","X",109568478,109570289,1811
"27935","ENSG00000233876","7",9614978,9615985,1007
"27936","ENSG00000233877","1",64941979,64942365,386
"27937","ENSG00000233882","1",191221159,191228467,7308
"27938","ENSG00000233884","9",87848113,87853526,5413
"27939","ENSG00000233885","3",183806457,183810783,4326
"27940","ENSG00000233887","X",97847263,97849017,1754
"27941","ENSG00000233888","2",202614853,202615529,676
"27942","ENSG00000233891","2",59238703,59733396,494693
"27943","ENSG00000233892","6",30186798,30188614,1816
"27944","ENSG00000233893","6",158817979,158822252,4273
"27945","ENSG00000233894","1",74468195,74469543,1348
"27946","ENSG00000233896","20",1947246,2030028,82782
"27947","ENSG00000233900","10",64620374,64620922,548
"27948","ENSG00000233901","9",129332300,129359541,27241
"27949","ENSG00000233902","6",31462728,31463336,608
"27950","ENSG00000233906","9",23671788,23672399,611
"27951","ENSG00000233907","1",95474737,95479356,4619
"27952","ENSG00000233908","6",109288440,109288562,122
"27953","ENSG00000233909","9",129791196,129791837,641
"27954","ENSG00000233910","1",40593633,40594353,720
"27955","ENSG00000233912","3",5156905,5187329,30424
"27956","ENSG00000233913","5",168616352,168616996,644
"27957","ENSG00000233915","8",86660525,86661922,1397
"27958","ENSG00000233916","6",29708125,29708547,422
"27959","ENSG00000233919","3",41162287,41168547,6260
"27960","ENSG00000233920","1",229223457,229242902,19445
"27961","ENSG00000233921","X",36374793,36375183,390
"27962","ENSG00000233922","21",45593654,45603088,9434
"27963","ENSG00000233924","14",55004813,55005687,874
"27964","ENSG00000233926","9",81689713,81776900,87187
"27965","ENSG00000233927","19",8321158,8323340,2182
"27966","ENSG00000233928","X",33726337,34346527,620190
"27967","ENSG00000233929","1",16241213,16241398,185
"27968","ENSG00000233930","11",1571353,1599184,27831
"27969","ENSG00000233932","15",48178122,48203758,25636
"27970","ENSG00000233934","2",171587093,171587259,166
"27971","ENSG00000233936","9",135245696,135252708,7012
"27972","ENSG00000233937","5",181246507,181272167,25660
"27973","ENSG00000233939","2",106304755,106305197,442
"27974","ENSG00000233941","6",106358566,106359717,1151
"27975","ENSG00000233942","7",95471835,95473998,2163
"27976","ENSG00000233944","Y",25393154,25394056,902
"27977","ENSG00000233945","10",83672406,83677122,4716
"27978","ENSG00000233947","9",78178263,78179512,1249
"27979","ENSG00000233952","7",45997540,45998071,531
"27980","ENSG00000233953","2",60495686,60499964,4278
"27981","ENSG00000233954","1",15807169,15809348,2179
"27982","ENSG00000233956","21",33518610,33519108,498
"27983","ENSG00000233960","7",52165235,52192913,27678
"27984","ENSG00000233962","7",57652736,57653459,723
"27985","ENSG00000233963","13",26094724,26154175,59451
"27986","ENSG00000233966","17",15704232,15704900,668
"27987","ENSG00000233967","6",80441295,80466674,25379
"27988","ENSG00000233968","10",19710328,19728550,18222
"27989","ENSG00000233969","7",120166443,120186064,19621
"27990","ENSG00000233970","2",692083,693235,1152
"27991","ENSG00000233971","2",71984182,71984434,252
"27992","ENSG00000233973","1",73305609,73355253,49644
"27993","ENSG00000233974","5",21481327,21484011,2684
"27994","ENSG00000233975","1",27660328,27662722,2394
"27995","ENSG00000233977","7",55592074,55593193,1119
"27996","ENSG00000233978","2",43041193,43043782,2589
"27997","ENSG00000233979","17",16084042,16084381,339
"27998","ENSG00000233980","7",76470162,76471058,896
"27999","ENSG00000233981","6",14004920,14006901,1981
"28000","ENSG00000233983","1",99464378,99464776,398
"28001","ENSG00000233984","X",74031462,74031820,358
"28002","ENSG00000233985","1",170173865,170304358,130493
"28003","ENSG00000233987","3",194702667,194727675,25008
"28004","ENSG00000233990","10",7833618,7833957,339
"28005","ENSG00000233993","20",18674395,18698709,24314
"28006","ENSG00000233994","1",72274552,72275159,607
"28007","ENSG00000233995","22",16572027,16574637,2610
"28008","ENSG00000233996","2",189486480,189487992,1512
"28009","ENSG00000233997","21",21746973,21797415,50442
"28010","ENSG00000233998","9",137640986,137641547,561
"28011","ENSG00000233999","2",87338511,87339035,524
"28012","ENSG00000234003","19",12506249,12508030,1781
"28013","ENSG00000234004","1",211173488,211173849,361
"28014","ENSG00000234005","13",99190579,99190991,412
"28015","ENSG00000234006","6",31542304,31543138,834
"28016","ENSG00000234008","21",35887195,35887807,612
"28017","ENSG00000234009","22",42776406,42777296,890
"28018","ENSG00000234015","6",12582915,12585404,2489
"28019","ENSG00000234017","10",112548632,112548872,240
"28020","ENSG00000234019","X",53093710,53094858,1148
"28021","ENSG00000234020","1",111353275,111367409,14134
"28022","ENSG00000234021","9",8936079,8963077,26998
"28023","ENSG00000234022","2",15564170,15573868,9698
"28024","ENSG00000234025","6",73157517,73158139,622
"28025","ENSG00000234026","10",95228243,95231144,2901
"28026","ENSG00000234028","2",88627539,88631821,4282
"28027","ENSG00000234030","21",43783123,43783573,450
"28028","ENSG00000234031","13",26576886,26577675,789
"28029","ENSG00000234034","21",22500604,22520058,19454
"28030","ENSG00000234036","4",76958860,76959169,309
"28031","ENSG00000234040","12",68626870,68627187,317
"28032","ENSG00000234041","1",179137764,179137934,170
"28033","ENSG00000234042","9",63703065,63703755,690
"28034","ENSG00000234043","10",91152605,91153349,744
"28035","ENSG00000234048","3",28427963,28428444,481
"28036","ENSG00000234050","X",102937770,102940561,2791
"28037","ENSG00000234052","21",27638613,27675024,36411
"28038","ENSG00000234055","9",129097854,129100266,2412
"28039","ENSG00000234056","13",25172828,25180079,7251
"28040","ENSG00000234059","Y",12930165,12948182,18017
"28041","ENSG00000234060","2",134319654,134320078,424
"28042","ENSG00000234061","2",171492905,171493095,190
"28043","ENSG00000234062","X",136909369,137022143,112774
"28044","ENSG00000234065","2",120213631,120214989,1358
"28045","ENSG00000234066","7",143437034,143437973,939
"28046","ENSG00000234068","X",55089008,55092842,3834
"28047","ENSG00000234069","20",24445391,24446314,923
"28048","ENSG00000234070","1",217781198,217785120,3922
"28049","ENSG00000234072","2",27356246,27367622,11376
"28050","ENSG00000234073","3",36880184,36880729,545
"28051","ENSG00000234076","3",188941715,188947639,5924
"28052","ENSG00000234080","1",50326131,50327007,876
"28053","ENSG00000234083","21",27954922,27985295,30373
"28054","ENSG00000234084","6",135301568,135307158,5590
"28055","ENSG00000234085","7",57654822,57655392,570
"28056","ENSG00000234088","1",62190522,62190926,404
"28057","ENSG00000234089","7",57209865,57222897,13032
"28058","ENSG00000234091","10",13729383,13756200,26817
"28059","ENSG00000234093","1",44780331,44780715,384
"28060","ENSG00000234099","1",93922574,93923945,1371
"28061","ENSG00000234102","10",68260557,68261499,942
"28062","ENSG00000234104","20",20970448,20972562,2114
"28063","ENSG00000234105","7",53514992,53517116,2124
"28064","ENSG00000234106","11",93535468,93535816,348
"28065","ENSG00000234107","21",31840341,31840858,517
"28066","ENSG00000234109","10",99047639,99048319,680
"28067","ENSG00000234111","4",157572490,157576154,3664
"28068","ENSG00000234112","1",225803148,225803448,300
"28069","ENSG00000234115","6",7516600,7517840,1240
"28070","ENSG00000234116","1",243005845,243007468,1623
"28071","ENSG00000234117","6",116492297,116497099,4802
"28072","ENSG00000234118","10",110936622,110937233,611
"28073","ENSG00000234119","2",145826285,145827830,1545
"28074","ENSG00000234120","8",7112314,7113728,1414
"28075","ENSG00000234123","3",14572852,14574792,1940
"28076","ENSG00000234125","4",129903010,129904163,1153
"28077","ENSG00000234127","6",30184455,30213427,28972
"28078","ENSG00000234129","X",10847578,11111220,263642
"28079","ENSG00000234130","X",93222220,93225015,2795
"28080","ENSG00000234132","1",201031136,201043073,11937
"28081","ENSG00000234134","10",125718771,125719365,594
"28082","ENSG00000234135","X",56242937,56243409,472
"28083","ENSG00000234136","3",197830685,197831296,611
"28084","ENSG00000234139","20",36051491,36085703,34212
"28085","ENSG00000234141","7",7949853,7950709,856
"28086","ENSG00000234142","1",166474879,166490307,15428
"28087","ENSG00000234144","1",65298755,65298980,225
"28088","ENSG00000234145","13",47763460,47764606,1146
"28089","ENSG00000234147","6",140845958,140852924,6966
"28090","ENSG00000234148","2",113512222,113515488,3266
"28091","ENSG00000234149","10",75003055,75025174,22119
"28092","ENSG00000234152","13",25365799,25366155,356
"28093","ENSG00000234155","6",85387219,85390186,2967
"28094","ENSG00000234156","9",122403407,122639685,236278
"28095","ENSG00000234159","21",15744004,15745080,1076
"28096","ENSG00000234160","9",37509150,37510299,1149
"28097","ENSG00000234161","X",91414878,91434999,20121
"28098","ENSG00000234162","2",105874509,105962386,87877
"28099","ENSG00000234163","10",33023368,33023647,279
"28100","ENSG00000234167","10",34488583,34488878,295
"28101","ENSG00000234168","13",99577112,99580368,3256
"28102","ENSG00000234169","2",100669892,100676038,6146
"28103","ENSG00000234170","10",2368561,2502200,133639
"28104","ENSG00000234171","2",3558474,3564842,6368
"28105","ENSG00000234172","2",183904529,183949112,44583
"28106","ENSG00000234173","10",54486230,54656051,169821
"28107","ENSG00000234174","2",113171535,113175360,3825
"28108","ENSG00000234175","10",13139196,13139533,337
"28109","ENSG00000234176","X",121203182,121205014,1832
"28110","ENSG00000234177","2",104746638,104757719,11081
"28111","ENSG00000234181","9",35096378,35098141,1763
"28112","ENSG00000234182","10",3009976,3013111,3135
"28113","ENSG00000234183","7",44848416,44849568,1152
"28114","ENSG00000234184","1",80535755,80646791,111036
"28115","ENSG00000234185","7",66119603,66165011,45408
"28116","ENSG00000234186","16",27066707,27069165,2458
"28117","ENSG00000234187","20",14127400,14128336,936
"28118","ENSG00000234190","1",147777590,147788953,11363
"28119","ENSG00000234191","X",39401252,39434824,33572
"28120","ENSG00000234192","10",87642607,87642954,347
"28121","ENSG00000234193","2",222917387,222919363,1976
"28122","ENSG00000234197","3",186079170,186080947,1777
"28123","ENSG00000234199","2",113970719,114007304,36585
"28124","ENSG00000234200","X",153028785,153030148,1363
"28125","ENSG00000234201","X",67791955,67792895,940
"28126","ENSG00000234202","1",92749175,92749330,155
"28127","ENSG00000234203","17",4972851,4974681,1830
"28128","ENSG00000234206","6",107509803,107511721,1918
"28129","ENSG00000234208","22",29513889,29535390,21501
"28130","ENSG00000234210","7",157466231,157499716,33485
"28131","ENSG00000234211","1",161671978,161674824,2846
"28132","ENSG00000234213","13",42255873,42256575,702
"28133","ENSG00000234215","7",69594793,69597493,2700
"28134","ENSG00000234217","9",62601226,62602672,1446
"28135","ENSG00000234219","1",207762584,207763263,679
"28136","ENSG00000234222","1",145926590,145959179,32589
"28137","ENSG00000234223","7",80246409,80312456,66047
"28138","ENSG00000234224","7",124030916,124033023,2107
"28139","ENSG00000234225","1",147001931,147003618,1687
"28140","ENSG00000234227","13",89833157,89833941,784
"28141","ENSG00000234229","9",106664754,106702662,37908
"28142","ENSG00000234230","X",24146225,24149654,3429
"28143","ENSG00000234231","2",87700984,87738105,37121
"28144","ENSG00000234232","1",149676851,149747818,70967
"28145","ENSG00000234233","1",211132588,211133374,786
"28146","ENSG00000234234","7",64107829,64108486,657
"28147","ENSG00000234235","2",241544403,241558977,14574
"28148","ENSG00000234238","3",188107072,188147310,40238
"28149","ENSG00000234241","20",6213699,6215381,1682
"28150","ENSG00000234244","10",18710269,18748342,38073
"28151","ENSG00000234253","2",49878623,49879363,740
"28152","ENSG00000234255","2",65439838,65456571,16733
"28153","ENSG00000234256","10",88876450,88877544,1094
"28154","ENSG00000234259","5",119680197,119681080,883
"28155","ENSG00000234261","6",14661829,15090170,428341
"28156","ENSG00000234262","1",153023962,153024260,298
"28157","ENSG00000234263","6",136629066,136648198,19132
"28158","ENSG00000234264","1",68496676,68538627,41951
"28159","ENSG00000234265","20",12950288,13008417,58129
"28160","ENSG00000234267","13",96941281,96984172,42891
"28161","ENSG00000234268","11",117035797,117036051,254
"28162","ENSG00000234270","3",41955445,41955763,318
"28163","ENSG00000234271","20",43523261,43523572,311
"28164","ENSG00000234272","2",152131555,152131845,290
"28165","ENSG00000234273","7",109521981,109597166,75185
"28166","ENSG00000234274","20",35850674,35850915,241
"28167","ENSG00000234277","1",227393554,227431035,37481
"28168","ENSG00000234279","2",238554541,238740849,186308
"28169","ENSG00000234281","2",210324759,210469246,144487
"28170","ENSG00000234282","20",1722045,1722537,492
"28171","ENSG00000234283","1",148271884,148280749,8865
"28172","ENSG00000234284","5",179023752,179035064,11312
"28173","ENSG00000234285","2",222503883,222504843,960
"28174","ENSG00000234286","7",23680195,23680786,591
"28175","ENSG00000234287","3",40761545,40761799,254
"28176","ENSG00000234288","X",131424301,131425239,938
"28177","ENSG00000234289","21",43565189,43565648,459
"28178","ENSG00000234290","5",132468890,132473043,4153
"28179","ENSG00000234292","5",91280097,91281142,1045
"28180","ENSG00000234293","21",29496047,29500386,4339
"28181","ENSG00000234296","10",26643228,26645016,1788
"28182","ENSG00000234297","9",15055057,15056052,995
"28183","ENSG00000234300","22",44606939,44625419,18480
"28184","ENSG00000234303","13",99726245,99728971,2726
"28185","ENSG00000234304","7",52891837,52897807,5970
"28186","ENSG00000234306","10",10365180,10366487,1307
"28187","ENSG00000234308","2",212795300,212819264,23964
"28188","ENSG00000234309","10",118572871,118573620,749
"28189","ENSG00000234311","10",132433733,132441484,7751
"28190","ENSG00000234312","7",63113635,63114805,1170
"28191","ENSG00000234315","1",45069977,45070429,452
"28192","ENSG00000234318","1",62896009,62901639,5630
"28193","ENSG00000234319","10",80215851,80216119,268
"28194","ENSG00000234322","X",93287733,93288759,1026
"28195","ENSG00000234323","9",105993310,106740875,747565
"28196","ENSG00000234324","17",15443639,15444191,552
"28197","ENSG00000234325","3",4414580,4414960,380
"28198","ENSG00000234327","17",5111468,5115004,3536
"28199","ENSG00000234329","1",45651039,45651826,787
"28200","ENSG00000234332","1",100393033,100394026,993
"28201","ENSG00000234335","10",32102522,32103293,771
"28202","ENSG00000234336","7",28180322,28243917,63595
"28203","ENSG00000234337","16",52655307,52656045,738
"28204","ENSG00000234338","7",64835280,64836882,1602
"28205","ENSG00000234340","21",22134698,22136083,1385
"28206","ENSG00000234345","X",103910305,103911352,1047
"28207","ENSG00000234350","2",170700368,170813670,113302
"28208","ENSG00000234352","7",136685559,137182107,496548
"28209","ENSG00000234353","22",23638492,23640762,2270
"28210","ENSG00000234354","13",100539901,100540248,347
"28211","ENSG00000234358","7",111971222,111971988,766
"28212","ENSG00000234361","6",157829143,157830573,1430
"28213","ENSG00000234362","2",41931599,41933909,2310
"28214","ENSG00000234367","1",145407772,145408173,401
"28215","ENSG00000234369","10",63222155,63223045,890
"28216","ENSG00000234371","3",183884924,183888449,3525
"28217","ENSG00000234373","9",33576380,33577014,634
"28218","ENSG00000234377","13",77919689,78617328,697639
"28219","ENSG00000234378","2",20063856,20106829,42973
"28220","ENSG00000234379","1",45530927,45532139,1212
"28221","ENSG00000234380","21",34745757,34784886,39129
"28222","ENSG00000234382","10",80233664,80245367,11703
"28223","ENSG00000234383","1",68161761,68163090,1329
"28224","ENSG00000234384","13",90493287,90535080,41793
"28225","ENSG00000234386","4",3901566,3902594,1028
"28226","ENSG00000234387","7",63394277,63395439,1162
"28227","ENSG00000234389","2",102438713,102440475,1762
"28228","ENSG00000234390","X",49876724,49879241,2517
"28229","ENSG00000234393","10",113710681,113719332,8651
"28230","ENSG00000234394","9",68306528,68330626,24098
"28231","ENSG00000234396","1",2212523,2220738,8215
"28232","ENSG00000234397","1",22322840,22323331,491
"28233","ENSG00000234402","14",105546610,105549694,3084
"28234","ENSG00000234405","X",103486461,103517919,31458
"28235","ENSG00000234409","22",20148427,20151065,2638
"28236","ENSG00000234413","X",53340986,53341505,519
"28237","ENSG00000234418","7",122144405,122219277,74872
"28238","ENSG00000234419","1",222468094,222470882,2788
"28239","ENSG00000234420","10",42513510,42552822,39312
"28240","ENSG00000234421","13",57314739,57315909,1170
"28241","ENSG00000234423","2",2895048,3126026,230978
"28242","ENSG00000234424","9",85753306,85786575,33269
"28243","ENSG00000234425","1",160537073,160571458,34385
"28244","ENSG00000234426","6",88177804,88442928,265124
"28245","ENSG00000234427","6",11810602,11811248,646
"28246","ENSG00000234428","12",26623369,26649479,26110
"28247","ENSG00000234432","7",5426277,5428927,2650
"28248","ENSG00000234435","20",22054074,22074654,20580
"28249","ENSG00000234436","19",54301758,54306026,4268
"28250","ENSG00000234438","15",65076816,65079939,3123
"28251","ENSG00000234444","7",64307459,64356634,49175
"28252","ENSG00000234445","13",102367539,102373666,6127
"28253","ENSG00000234446","2",221609324,221650218,40894
"28254","ENSG00000234450","7",156633355,156633787,432
"28255","ENSG00000234451","9",62609725,62610799,1074
"28256","ENSG00000234452","10",89456064,89468140,12076
"28257","ENSG00000234456","7",79452877,79471208,18331
"28258","ENSG00000234457","7",36305631,36305904,273
"28259","ENSG00000234458","3",125703349,125704312,963
"28260","ENSG00000234459","7",90266034,90270216,4182
"28261","ENSG00000234460","9",87864096,87866291,2195
"28262","ENSG00000234464","1",238238943,238404906,165963
"28263","ENSG00000234465","19",43575801,43583964,8163
"28264","ENSG00000234466","X",55054945,55055838,893
"28265","ENSG00000234469","X",9967358,9968352,994
"28266","ENSG00000234471","7",484107,496118,12011
"28267","ENSG00000234473","1",192993449,192994677,1228
"28268","ENSG00000234474","10",117144564,117169108,24544
"28269","ENSG00000234476","1",225447233,225465400,18167
"28270","ENSG00000234477","17",40921430,40975926,54496
"28271","ENSG00000234478","1",226148003,226155071,7068
"28272","ENSG00000234479","22",32121977,32133469,11492
"28273","ENSG00000234481","1",36769812,36775768,5956
"28274","ENSG00000234484","6",132752675,132753951,1276
"28275","ENSG00000234485","2",71037685,71038703,1018
"28276","ENSG00000234488","2",63684305,63684710,405
"28277","ENSG00000234489","10",62741208,62741385,177
"28278","ENSG00000234491","2",206419292,206420238,946
"28279","ENSG00000234492","4",108538190,108620460,82270
"28280","ENSG00000234493","X",119978713,120025138,46425
"28281","ENSG00000234494","17",47897330,47941410,44080
"28282","ENSG00000234497","1",74577430,74626098,48668
"28283","ENSG00000234498","12",12875499,12876107,608
"28284","ENSG00000234500","7",66511556,66545066,33510
"28285","ENSG00000234502","9",101375344,101376603,1259
"28286","ENSG00000234503","22",21177892,21179875,1983
"28287","ENSG00000234504","10",44899614,44920220,20606
"28288","ENSG00000234506","9",68543541,68546589,3048
"28289","ENSG00000234509","21",31653593,31659500,5907
"28290","ENSG00000234511","5",170232447,170252575,20128
"28291","ENSG00000234512","1",33466249,33468954,2705
"28292","ENSG00000234513","7",22773646,22773993,347
"28293","ENSG00000234515","6",32879171,32879848,677
"28294","ENSG00000234518","1",89104285,89104767,482
"28295","ENSG00000234519","6",169067764,169069427,1663
"28296","ENSG00000234520","7",112953282,112995677,42395
"28297","ENSG00000234521","2",74407797,74413603,5806
"28298","ENSG00000234522","10",120434983,120440376,5393
"28299","ENSG00000234523","1",222945725,222945900,175
"28300","ENSG00000234534","9",5040945,5041940,995
"28301","ENSG00000234535","13",33610967,33611522,555
"28302","ENSG00000234537","9",92132398,92138629,6231
"28303","ENSG00000234540","6",14394326,14404289,9963
"28304","ENSG00000234542","10",123574227,123583767,9540
"28305","ENSG00000234545","7",92560793,92590394,29601
"28306","ENSG00000234546","1",9182004,9196284,14280
"28307","ENSG00000234548","3",186439239,186457299,18060
"28308","ENSG00000234551","13",103420825,103428298,7473
"28309","ENSG00000234553","5",56536583,56537826,1243
"28310","ENSG00000234556","10",2305083,2315075,9992
"28311","ENSG00000234557","X",101443707,101444103,396
"28312","ENSG00000234558","X",116106921,116108430,1509
"28313","ENSG00000234559","2",129939848,129940217,369
"28314","ENSG00000234562","3",42145646,42146371,725
"28315","ENSG00000234565","7",149053961,149054173,212
"28316","ENSG00000234566","X",54223324,54224062,738
"28317","ENSG00000234567","6",133452857,133456605,3748
"28318","ENSG00000234568","4",82275071,82276600,1529
"28319","ENSG00000234569","10",119621068,119621880,812
"28320","ENSG00000234571","1",143875171,143904650,29479
"28321","ENSG00000234572","2",64846130,64863626,17496
"28322","ENSG00000234573","20",5013520,5013724,204
"28323","ENSG00000234575","9",87844154,87847314,3160
"28324","ENSG00000234577","6",152380546,152381564,1018
"28325","ENSG00000234578","1",53267935,53268601,666
"28326","ENSG00000234579","2",30986939,30991426,4487
"28327","ENSG00000234580","10",44591208,44602104,10896
"28328","ENSG00000234584","2",157725708,157736005,10297
"28329","ENSG00000234585","7",65038354,65074713,36359
"28330","ENSG00000234586","9",13021694,13022892,1198
"28331","ENSG00000234588","2",216805737,216806129,392
"28332","ENSG00000234589","12",3071532,3072145,613
"28333","ENSG00000234593","1",14338825,14419973,81148
"28334","ENSG00000234594","3",171534423,171534615,192
"28335","ENSG00000234595","2",181683113,181685707,2594
"28336","ENSG00000234597","2",19458220,19468961,10741
"28337","ENSG00000234601","1",239898016,239899872,1856
"28338","ENSG00000234602","5",55219614,55227315,7701
"28339","ENSG00000234604","1",169474060,169474159,99
"28340","ENSG00000234607","1",15969632,15970194,562
"28341","ENSG00000234608","12",111839764,111842902,3138
"28342","ENSG00000234611","11",75071148,75072052,904
"28343","ENSG00000234613","X",45913267,45917040,3773
"28344","ENSG00000234614","1",151841877,151850385,8508
"28345","ENSG00000234616","8",142657460,142681968,24508
"28346","ENSG00000234617","3",43346923,43352152,5229
"28347","ENSG00000234618","9",76398699,76399586,887
"28348","ENSG00000234619","1",8750430,8751087,657
"28349","ENSG00000234622","X",1767347,1768776,1429
"28350","ENSG00000234624","2",61416887,61417197,310
"28351","ENSG00000234626","22",32327064,32343105,16041
"28352","ENSG00000234627","13",24328211,24329072,861
"28353","ENSG00000234629","3",94937086,94938024,938
"28354","ENSG00000234630","22",22293733,22294794,1061
"28355","ENSG00000234632","2",74350069,74351009,940
"28356","ENSG00000234634","17",13299184,13306771,7587
"28357","ENSG00000234636","X",40735400,40738701,3301
"28358","ENSG00000234638","2",219425071,219426184,1113
"28359","ENSG00000234639","7",138022458,138024339,1881
"28360","ENSG00000234640","10",128316282,128320214,3932
"28361","ENSG00000234645","2",138288029,138288793,764
"28362","ENSG00000234646","20",23030863,23039241,8378
"28363","ENSG00000234647","6",168242938,168262581,19643
"28364","ENSG00000234650","13",100464440,100481205,16765
"28365","ENSG00000234655","13",41439834,41440847,1013
"28366","ENSG00000234660","13",89181324,89280240,98916
"28367","ENSG00000234661","3",363370,385795,22425
"28368","ENSG00000234663","2",181086076,181409321,323245
"28369","ENSG00000234664","15",29730713,29730985,272
"28370","ENSG00000234665","9",62856999,62898095,41096
"28371","ENSG00000234667","3",49873347,49877305,3958
"28372","ENSG00000234671","7",57196638,57197772,1134
"28373","ENSG00000234675","6",148017422,148020974,3552
"28374","ENSG00000234676","9",26955780,26956295,515
"28375","ENSG00000234677","10",123913574,123931597,18023
"28376","ENSG00000234678","1",201995696,202010463,14767
"28377","ENSG00000234680","9",39016969,39039594,22625
"28378","ENSG00000234682","2",134797169,134797879,710
"28379","ENSG00000234683","1",81596157,81596506,349
"28380","ENSG00000234684","20",1325405,1378735,53330
"28381","ENSG00000234685","13",22915651,22916523,872
"28382","ENSG00000234686","7",49230137,49254816,24679
"28383","ENSG00000234688","22",36703918,36721472,17554
"28384","ENSG00000234690","2",47192405,47345074,152669
"28385","ENSG00000234692","9",115252538,115254251,1713
"28386","ENSG00000234693","20",50645471,50662275,16804
"28387","ENSG00000234694","1",43354684,43358658,3974
"28388","ENSG00000234695","7",93890913,93893601,2688
"28389","ENSG00000234696","X",151175192,151177836,2644
"28390","ENSG00000234698","20",50166362,50171742,5380
"28391","ENSG00000234699","10",103452846,103462695,9849
"28392","ENSG00000234700","7",64108625,64110147,1522
"28393","ENSG00000234702","X",91982655,91983505,850
"28394","ENSG00000234703","21",35136638,35139222,2584
"28395","ENSG00000234705","9",128663134,128684477,21343
"28396","ENSG00000234706","13",26117548,26118964,1416
"28397","ENSG00000234707","7",54759348,54812727,53379
"28398","ENSG00000234709","9",99998301,99999069,768
"28399","ENSG00000234710","7",9621764,9769513,147749
"28400","ENSG00000234711","1",873292,874349,1057
"28401","ENSG00000234714","2",204090457,204109849,19392
"28402","ENSG00000234715","7",103445207,103514007,68800
"28403","ENSG00000234717","3",171815586,171900749,85163
"28404","ENSG00000234718","7",7738524,7742574,4050
"28405","ENSG00000234719","16",11927373,11976643,49270
"28406","ENSG00000234721","17",73786675,73800966,14291
"28407","ENSG00000234722","7",153355365,153413985,58620
"28408","ENSG00000234723","3",22670201,22670711,510
"28409","ENSG00000234724","10",94137748,94139500,1752
"28410","ENSG00000234735","22",43092167,43092524,357
"28411","ENSG00000234736","10",49121839,49151547,29708
"28412","ENSG00000234737","3",32258940,32260230,1290
"28413","ENSG00000234740","9",13274510,13279187,4677
"28414","ENSG00000234741","1",173858559,173868882,10323
"28415","ENSG00000234742","3",197850400,197850954,554
"28416","ENSG00000234743","10",80247219,80247683,464
"28417","ENSG00000234745","6",31269491,31357188,87697
"28418","ENSG00000234748","X",146537535,146538048,513
"28419","ENSG00000234750","19",12284337,12285185,848
"28420","ENSG00000234751","11",72940498,72941112,614
"28421","ENSG00000234752","10",8897989,8914596,16607
"28422","ENSG00000234753","6",41494853,41548621,53768
"28423","ENSG00000234754","1",221330080,221336489,6409
"28424","ENSG00000234756","10",62289521,62304033,14512
"28425","ENSG00000234758","5",131944408,131968220,23812
"28426","ENSG00000234763","6",8341937,8389183,47246
"28427","ENSG00000234764","22",18833694,18834438,744
"28428","ENSG00000234766","X",51498490,51511005,12515
"28429","ENSG00000234767","13",65866070,65922731,56661
"28430","ENSG00000234768","6",168194358,168204501,10143
"28431","ENSG00000234769","16",14381,18068,3687
"28432","ENSG00000234770","8",27560274,27589073,28799
"28433","ENSG00000234771","9",128108581,128118693,10112
"28434","ENSG00000234772","13",27236282,27250711,14429
"28435","ENSG00000234773","19",12195015,12237767,42752
"28436","ENSG00000234776","11",45906513,45907272,759
"28437","ENSG00000234777","6",159383422,159401147,17725
"28438","ENSG00000234779","9",16726814,16727524,710
"28439","ENSG00000234781","2",104488458,104510509,22051
"28440","ENSG00000234782","9",118082869,118083382,513
"28441","ENSG00000234784","1",64918443,64918683,240
"28442","ENSG00000234785","X",115702811,115704120,1309
"28443","ENSG00000234787","13",54115783,54142319,26536
"28444","ENSG00000234788","10",26714622,26715832,1210
"28445","ENSG00000234789","9",129640476,129641282,806
"28446","ENSG00000234790","1",112748095,112748475,380
"28447","ENSG00000234792","X",52612656,52613523,867
"28448","ENSG00000234793","2",241754793,241755740,947
"28449","ENSG00000234795","Y",7694707,7810305,115598
"28450","ENSG00000234796","2",910926,921124,10198
"28451","ENSG00000234797","15",59768352,59769146,794
"28452","ENSG00000234800","7",23721311,23721782,471
"28453","ENSG00000234801","4",173615936,173616906,970
"28454","ENSG00000234805","3",194755589,194757422,1833
"28455","ENSG00000234806","10",68424560,68424997,437
"28456","ENSG00000234807","1",58785128,58901109,115981
"28457","ENSG00000234810","1",55329288,56070513,741225
"28458","ENSG00000234811","10",32111644,32111789,145
"28459","ENSG00000234813","10",18940501,18940953,452
"28460","ENSG00000234814","10",30655489,30717266,61777
"28461","ENSG00000234816","6",26043989,26044357,368
"28462","ENSG00000234817","6",4136072,4157385,21313
"28463","ENSG00000234818","2",10589166,10604830,15664
"28464","ENSG00000234825","X",150231075,150232896,1821
"28465","ENSG00000234826","7",117998858,118004045,5187
"28466","ENSG00000234828","4",149351903,149896233,544330
"28467","ENSG00000234832","20",23346941,23351486,4545
"28468","ENSG00000234835","13",35251070,35251829,759
"28469","ENSG00000234838","5",66572057,66572546,489
"28470","ENSG00000234839","7",20843627,20843961,334
"28471","ENSG00000234840","9",22646200,22824213,178013
"28472","ENSG00000234841","4",112826307,112827607,1300
"28473","ENSG00000234842","2",201549631,201550307,676
"28474","ENSG00000234844","7",55638274,55638842,568
"28475","ENSG00000234848","19",12450935,12460705,9770
"28476","ENSG00000234851","3",161429127,161429597,470
"28477","ENSG00000234854","13",109728282,109730007,1725
"28478","ENSG00000234855","10",97102756,97104355,1599
"28479","ENSG00000234857","11",62690275,62727384,37109
"28480","ENSG00000234859","17",41402416,41425049,22633
"28481","ENSG00000234860","9",99531507,99583301,51794
"28482","ENSG00000234862","20",22220554,22223283,2729
"28483","ENSG00000234863","1",220455154,220455312,158
"28484","ENSG00000234864","10",42696012,42706453,10441
"28485","ENSG00000234865","5",23980587,23980938,351
"28486","ENSG00000234869","22",46541495,46548196,6701
"28487","ENSG00000234880","21",44989864,44994086,4222
"28488","ENSG00000234881","9",123843036,123843686,650
"28489","ENSG00000234882","6",73291962,73293277,1315
"28490","ENSG00000234883","21",25561909,25575168,13259
"28491","ENSG00000234884","22",25561117,25564719,3602
"28492","ENSG00000234886","X",102803041,102806138,3097
"28493","ENSG00000234889","X",97975878,97978641,2763
"28494","ENSG00000234890","2",158419955,158425303,5348
"28495","ENSG00000234891","22",34703126,34704885,1759
"28496","ENSG00000234892","22",43232141,43239010,6869
"28497","ENSG00000234894","13",19151554,19152307,753
"28498","ENSG00000234896","2",71055527,71056003,476
"28499","ENSG00000234898","2",91957436,91963610,6174
"28500","ENSG00000234899","17",72034107,72237203,203096
"28501","ENSG00000234900","20",10753278,10765286,12008
"28502","ENSG00000234902","2",207186717,207236066,49349
"28503","ENSG00000234906","19",44945971,44949566,3595
"28504","ENSG00000234911","14",64341673,64387986,46313
"28505","ENSG00000234912","17",77086716,77099902,13186
"28506","ENSG00000234913","22",18004270,18007308,3038
"28507","ENSG00000234915","1",212299495,212331713,32218
"28508","ENSG00000234917","1",42678735,42681659,2924
"28509","ENSG00000234918","10",37240887,37242049,1162
"28510","ENSG00000234919","2",195569628,195572970,3342
"28511","ENSG00000234921","9",124031624,124032524,900
"28512","ENSG00000234925","12",68642519,68642993,474
"28513","ENSG00000234928","22",23433564,23435071,1507
"28514","ENSG00000234929","2",2638178,2696285,58107
"28515","ENSG00000234931","10",83311628,83314475,2847
"28516","ENSG00000234932","2",152850653,152850824,171
"28517","ENSG00000234933","20",34402149,34402696,547
"28518","ENSG00000234936","2",43229573,43233394,3821
"28519","ENSG00000234937","1",155845367,155846624,1257
"28520","ENSG00000234938","2",215530447,215545526,15079
"28521","ENSG00000234940","2",144688413,144690185,1772
"28522","ENSG00000234942","10",85577731,85607213,29482
"28523","ENSG00000234943","2",54545368,54546677,1309
"28524","ENSG00000234944","10",42871521,42874060,2539
"28525","ENSG00000234945","2",27335520,27342599,7079
"28526","ENSG00000234946","2",23943846,23944351,505
"28527","ENSG00000234948","20",52192159,52670578,478419
"28528","ENSG00000234949","2",237591020,237595981,4961
"28529","ENSG00000234950","Y",9951553,9959423,7870
"28530","ENSG00000234952","10",117734510,117753329,18819
"28531","ENSG00000234953","1",81513880,81557702,43822
"28532","ENSG00000234956","6",137730170,137792835,62665
"28533","ENSG00000234961","10",17233325,17234833,1508
"28534","ENSG00000234962","10",1989076,2015005,25929
"28535","ENSG00000234964","11",59781318,59781722,404
"28536","ENSG00000234965","22",41909554,41914667,5113
"28537","ENSG00000234967","20",47950797,47954808,4011
"28538","ENSG00000234969","X",74069276,74070832,1556
"28539","ENSG00000234973","10",43777562,43778825,1263
"28540","ENSG00000234975","1",228687415,228687826,411
"28541","ENSG00000234977","7",1691906,1692450,544
"28542","ENSG00000234979","22",36816326,36819736,3410
"28543","ENSG00000234981","1",206528915,206529706,791
"28544","ENSG00000234982","9",14204248,14205039,791
"28545","ENSG00000234984","1",166665885,166682196,16311
"28546","ENSG00000234985","7",121440834,121441261,427
"28547","ENSG00000234986","6",170695313,170696950,1637
"28548","ENSG00000234988","2",100603752,100611542,7790
"28549","ENSG00000234993","10",45232026,45247361,15335
"28550","ENSG00000234995","7",138490581,138491361,780
"28551","ENSG00000234996","1",202861754,202875241,13487
"28552","ENSG00000234997","2",113325372,113425548,100176
"28553","ENSG00000234998","1",121087528,121116676,29148
"28554","ENSG00000234999","7",24906135,24906594,459
"28555","ENSG00000235001","Y",5337745,5338964,1219
"28556","ENSG00000235005","1",109884176,109886264,2088
"28557","ENSG00000235007","9",129258354,129259846,1492
"28558","ENSG00000235008","6",166701094,166702839,1745
"28559","ENSG00000235009","2",38431294,38433573,2279
"28560","ENSG00000235010","10",132181225,132185962,4737
"28561","ENSG00000235011","1",79323769,79324863,1094
"28562","ENSG00000235012","21",39525583,39529855,4272
"28563","ENSG00000235013","2",230957593,230957950,357
"28564","ENSG00000235015","1",153717303,153718347,1044
"28565","ENSG00000235016","3",50116022,50156085,40063
"28566","ENSG00000235018","20",62037429,62037956,527
"28567","ENSG00000235020","10",18206127,18261504,55377
"28568","ENSG00000235021","1",246690047,246691821,1774
"28569","ENSG00000235023","21",42648271,42651244,2973
"28570","ENSG00000235024","2",218944629,218961903,17274
"28571","ENSG00000235026","2",115126622,115161384,34762
"28572","ENSG00000235027","11",1760348,1762486,2138
"28573","ENSG00000235028","18",58018794,58019061,267
"28574","ENSG00000235029","7",157006307,157007132,825
"28575","ENSG00000235032","20",57214872,57215866,994
"28576","ENSG00000235033","6",39881804,39900071,18267
"28577","ENSG00000235034","19",50649445,50659310,9865
"28578","ENSG00000235035","2",70687142,70691824,4682
"28579","ENSG00000235036","20",10612861,10614229,1368
"28580","ENSG00000235038","1",58060139,58080274,20135
"28581","ENSG00000235040","6",32706124,32706955,831
"28582","ENSG00000235042","2",216385288,216412696,27408
"28583","ENSG00000235043","4",86949669,86950113,444
"28584","ENSG00000235044","20",37530039,37530543,504
"28585","ENSG00000235045","1",109651370,109652099,729
"28586","ENSG00000235047","2",175897336,175904232,6896
"28587","ENSG00000235049","12",1929202,1936574,7372
"28588","ENSG00000235050","6",53978549,54079726,101177
"28589","ENSG00000235051","6",10881780,10884349,2569
"28590","ENSG00000235052","1",23549139,23550915,1776
"28591","ENSG00000235054","1",4412027,4424689,12662
"28592","ENSG00000235055","1",68043330,68044233,903
"28593","ENSG00000235056","2",195003711,195026370,22659
"28594","ENSG00000235058","3",50341106,50345697,4591
"28595","ENSG00000235059","Y",22438940,22485592,46652
"28596","ENSG00000235060","1",180434800,180435936,1136
"28597","ENSG00000235062","22",20697962,20698934,972
"28598","ENSG00000235064","2",33839782,33840678,896
"28599","ENSG00000235065","20",21114723,21115197,474
"28600","ENSG00000235066","2",117995397,118055033,59636
"28601","ENSG00000235070","2",226180044,226185371,5327
"28602","ENSG00000235071","X",16474342,16475340,998
"28603","ENSG00000235072","2",25369136,25375845,6709
"28604","ENSG00000235076","13",21358373,21359314,941
"28605","ENSG00000235077","7",100130964,100140439,9475
"28606","ENSG00000235078","2",3519275,3523197,3922
"28607","ENSG00000235079","1",71048855,71067184,18329
"28608","ENSG00000235081","19",54229036,54230213,1177
"28609","ENSG00000235082","1",160317403,160317706,303
"28610","ENSG00000235083","1",188671353,188671759,406
"28611","ENSG00000235084","1",15604597,15605043,446
"28612","ENSG00000235085","17",4673830,4696831,23001
"28613","ENSG00000235086","6",159240786,159243329,2543
"28614","ENSG00000235088","20",41459354,41461944,2590
"28615","ENSG00000235089","1",81208568,81209210,642
"28616","ENSG00000235090","7",75922755,75923443,688
"28617","ENSG00000235091","22",45875999,45891438,15439
"28618","ENSG00000235092","2",8666636,8681864,15228
"28619","ENSG00000235095","7",57147986,57150347,2361
"28620","ENSG00000235096","1",246025897,246035603,9706
"28621","ENSG00000235097","13",44799503,44809630,10127
"28622","ENSG00000235098","1",1418420,1421769,3349
"28623","ENSG00000235099","6",93070387,93103384,32997
"28624","ENSG00000235100","10",89667181,89701274,34093
"28625","ENSG00000235101","1",160670148,160670979,831
"28626","ENSG00000235105","1",48435967,48437223,1256
"28627","ENSG00000235106","9",134025481,134034666,9185
"28628","ENSG00000235108","9",21403081,21403651,570
"28629","ENSG00000235109","6",28324693,28356271,31578
"28630","ENSG00000235110","3",143855739,143856142,403
"28631","ENSG00000235111","22",49612657,49615716,3059
"28632","ENSG00000235112","1",21161475,21162081,606
"28633","ENSG00000235115","13",28107431,28107877,446
"28634","ENSG00000235118","2",206642412,206649011,6599
"28635","ENSG00000235119","9",114396724,114398503,1779
"28636","ENSG00000235120","3",49640483,49641769,1286
"28637","ENSG00000235121","1",201723294,201737506,14212
"28638","ENSG00000235122","6",49714325,49820503,106178
"28639","ENSG00000235123","21",40383083,40385358,2275
"28640","ENSG00000235126","3",197445061,197458323,13262
"28641","ENSG00000235127","2",14886647,14907664,21017
"28642","ENSG00000235128","2",126679622,126680420,798
"28643","ENSG00000235129","2",95368507,95368885,378
"28644","ENSG00000235131","1",3712200,3714298,2098
"28645","ENSG00000235133","9",117685254,117685588,334
"28646","ENSG00000235138","9",134054290,134058805,4515
"28647","ENSG00000235139","7",84532476,84584322,51846
"28648","ENSG00000235140","10",59578467,59650345,71878
"28649","ENSG00000235141","10",7295106,7295290,184
"28650","ENSG00000235142","6",106705334,106788148,82814
"28651","ENSG00000235143","1",30858158,30860254,2096
"28652","ENSG00000235145","1",179968686,179969506,820
"28653","ENSG00000235146","1",587629,594768,7139
"28654","ENSG00000235147","2",92006680,92007121,441
"28655","ENSG00000235149","4",185918140,185919460,1320
"28656","ENSG00000235151","2",241844380,241845036,656
"28657","ENSG00000235156","3",100185687,100211766,26079
"28658","ENSG00000235158","3",1008135,1012934,4799
"28659","ENSG00000235159","22",46067356,46069891,2535
"28660","ENSG00000235160","15",26395037,26455217,60180
"28661","ENSG00000235162","12",105235290,105396097,160807
"28662","ENSG00000235166","20",55408898,55684915,276017
"28663","ENSG00000235169","1",3772761,3775982,3221
"28664","ENSG00000235172","5",170307722,170335508,27786
"28665","ENSG00000235173","8",144137774,144140851,3077
"28666","ENSG00000235174","6",73373108,73373263,155
"28667","ENSG00000235175","Y",5793300,5793737,437
"28668","ENSG00000235180","10",126413869,126421879,8010
"28669","ENSG00000235183","17",49795343,49795669,326
"28670","ENSG00000235185","1",19591802,19596832,5030
"28671","ENSG00000235186","2",94991880,94994362,2482
"28672","ENSG00000235189","X",129869064,129957528,88464
"28673","ENSG00000235191","19",48910930,48918891,7961
"28674","ENSG00000235192","2",165794851,165810010,15159
"28675","ENSG00000235194","14",23295643,23302848,7205
"28676","ENSG00000235196","X",101911529,101912072,543
"28677","ENSG00000235197","10",37894637,37896666,2029
"28678","ENSG00000235198","10",117562084,117572457,10373
"28679","ENSG00000235200","1",67522299,67532612,10313
"28680","ENSG00000235202","1",117272182,117321336,49154
"28681","ENSG00000235203","17",20543481,20550963,7482
"28682","ENSG00000235204","9",124259250,124261156,1906
"28683","ENSG00000235205","13",23243520,23247184,3664
"28684","ENSG00000235207","7",55645620,55646951,1331
"28685","ENSG00000235209","22",38921227,38924708,3481
"28686","ENSG00000235213","14",22702143,22703065,922
"28687","ENSG00000235214","20",35285251,35285756,505
"28688","ENSG00000235215","1",59055999,59078116,22117
"28689","ENSG00000235217","20",32186477,32190527,4050
"28690","ENSG00000235221","13",69221866,69322190,100324
"28691","ENSG00000235224","X",53113018,53113274,256
"28692","ENSG00000235225","2",222726457,222726834,377
"28693","ENSG00000235226","1",159759170,159759589,419
"28694","ENSG00000235227","7",64180006,64180892,886
"28695","ENSG00000235236","3",48979918,48983985,4067
"28696","ENSG00000235237","22",37166757,37182850,16093
"28697","ENSG00000235238","6",29636060,29636343,283
"28698","ENSG00000235241","1",16889095,16889602,507
"28699","ENSG00000235243","7",84847877,84848253,376
"28700","ENSG00000235244","X",115694880,115969130,274250
"28701","ENSG00000235245","10",133295187,133295977,790
"28702","ENSG00000235246","22",38231320,38232248,928
"28703","ENSG00000235251","1",87044935,87045871,936
"28704","ENSG00000235253","5",132942932,132945050,2118
"28705","ENSG00000235254","X",149768897,149771368,2471
"28706","ENSG00000235257","3",37693655,37861802,168147
"28707","ENSG00000235258","2",112286057,112286422,365
"28708","ENSG00000235262","X",53212408,53214679,2271
"28709","ENSG00000235263","1",9501092,9503471,2379
"28710","ENSG00000235264","10",133144612,133145304,692
"28711","ENSG00000235266","10",102887874,102888188,314
"28712","ENSG00000235267","2",27455156,27455862,706
"28713","ENSG00000235268","11",95025258,95027596,2338
"28714","ENSG00000235269","14",53685139,53850882,165743
"28715","ENSG00000235271","22",26903292,26920935,17643
"28716","ENSG00000235272","6",166585604,166587594,1990
"28717","ENSG00000235274","X",127728734,127730858,2124
"28718","ENSG00000235277","21",14918534,14947096,28562
"28719","ENSG00000235278","3",50786674,50788285,1611
"28720","ENSG00000235279","10",51302566,51306709,4143
"28721","ENSG00000235280","13",112967484,112968824,1340
"28722","ENSG00000235281","10",2501600,2618739,117139
"28723","ENSG00000235282","1",18513118,18513383,265
"28724","ENSG00000235284","9",131485665,131485750,85
"28725","ENSG00000235285","13",44146470,44158222,11752
"28726","ENSG00000235286","11",111670956,111672404,1448
"28727","ENSG00000235288","3",42785087,42852428,67341
"28728","ENSG00000235290","6",29956596,29958570,1974
"28729","ENSG00000235292","20",12243308,12318221,74913
"28730","ENSG00000235293","2",235177896,235178905,1009
"28731","ENSG00000235294","3",181505075,181505879,804
"28732","ENSG00000235295","22",18029385,18037968,8583
"28733","ENSG00000235296","17",81941869,81947601,5732
"28734","ENSG00000235297","18",74389884,74390297,413
"28735","ENSG00000235298","9",83972233,83975777,3544
"28736","ENSG00000235299","1",112625906,112626224,318
"28737","ENSG00000235300","17",48294335,48308762,14427
"28738","ENSG00000235303","1",170598854,170647339,48485
"28739","ENSG00000235304","X",39304956,39327362,22406
"28740","ENSG00000235308","1",88923370,88923844,474
"28741","ENSG00000235310","9",64488600,64489786,1186
"28742","ENSG00000235313","20",31563166,31564076,910
"28743","ENSG00000235314","7",44039171,44042306,3135
"28744","ENSG00000235315","13",25206049,25206506,457
"28745","ENSG00000235316","10",73731824,73733638,1814
"28746","ENSG00000235318","2",201214653,201214950,297
"28747","ENSG00000235319","2",105324210,105330529,6319
"28748","ENSG00000235321","2",169100743,169101210,467
"28749","ENSG00000235323","17",20564538,20564889,351
"28750","ENSG00000235325","2",107920763,107921248,485
"28751","ENSG00000235328","22",17093612,17093939,327
"28752","ENSG00000235330","9",477750,478423,673
"28753","ENSG00000235332","9",125194649,125195821,1172
"28754","ENSG00000235335","2",167814757,167941180,126423
"28755","ENSG00000235337","2",220127546,220212491,84945
"28756","ENSG00000235338","3",9600748,9602728,1980
"28757","ENSG00000235339","3",41977008,41978034,1026
"28758","ENSG00000235343","22",16746628,16748645,2017
"28759","ENSG00000235347","22",45792418,45793636,1218
"28760","ENSG00000235349","7",64566814,64567443,629
"28761","ENSG00000235351","2",241724615,241725693,1078
"28762","ENSG00000235354","7",103348601,103348771,170
"28763","ENSG00000235356","10",65271319,65315080,43761
"28764","ENSG00000235357","6",79803582,79833386,29804
"28765","ENSG00000235358","1",41242373,41284861,42488
"28766","ENSG00000235361","17",1181893,1185086,3193
"28767","ENSG00000235363","1",205351247,205351471,224
"28768","ENSG00000235366","13",45680184,45701184,21000
"28769","ENSG00000235368","7",57424503,57425676,1173
"28770","ENSG00000235369","2",47797826,47798091,265
"28771","ENSG00000235370","15",84398316,84411701,13385
"28772","ENSG00000235371","1",236110061,236112370,2309
"28773","ENSG00000235374","21",45070952,45074165,3213
"28774","ENSG00000235376","10",103245887,103248016,2129
"28775","ENSG00000235377","9",82130752,82131632,880
"28776","ENSG00000235381","6",155253139,155256724,3585
"28777","ENSG00000235385","X",13266048,13303452,37404
"28778","ENSG00000235387","9",35909492,35937153,27661
"28779","ENSG00000235389","9",8700595,8701552,957
"28780","ENSG00000235390","15",45321077,45321692,615
"28781","ENSG00000235397","17",19296596,19306261,9665
"28782","ENSG00000235399","6",136995170,136999504,4334
"28783","ENSG00000235400","1",78749073,78750659,1586
"28784","ENSG00000235403","2",1059133,1068341,9208
"28785","ENSG00000235407","1",110487680,110490258,2578
"28786","ENSG00000235408","20",38425083,38425354,271
"28787","ENSG00000235410","10",14074284,14087605,13321
"28788","ENSG00000235411","2",20239892,20241046,1154
"28789","ENSG00000235413","4",17911674,17912976,1302
"28790","ENSG00000235415","20",53608354,53634590,26236
"28791","ENSG00000235416","X",53456273,53457029,756
"28792","ENSG00000235419","2",230520594,230580006,59412
"28793","ENSG00000235420","15",70796597,70802688,6091
"28794","ENSG00000235422","18",2593674,2594913,1239
"28795","ENSG00000235424","3",33077204,33077491,287
"28796","ENSG00000235425","X",95679130,95679627,497
"28797","ENSG00000235426","10",79382328,79409274,26946
"28798","ENSG00000235427","7",116542718,116551969,9251
"28799","ENSG00000235429","7",133315009,133315413,404
"28800","ENSG00000235430","17",15768717,15771426,2709
"28801","ENSG00000235431","7",9869774,9985895,116121
"28802","ENSG00000235432","1",20692734,20694013,1279
"28803","ENSG00000235433","2",202615769,202616440,671
"28804","ENSG00000235434","1",19814367,19819502,5135
"28805","ENSG00000235436","7",90119400,90125600,6200
"28806","ENSG00000235437","X",63222993,63561095,338102
"28807","ENSG00000235438","13",21260015,21295003,34988
"28808","ENSG00000235440","2",26101317,26102136,819
"28809","ENSG00000235445","22",17983205,17983619,414
"28810","ENSG00000235446","1",69215835,69249477,33642
"28811","ENSG00000235447","X",76655498,76656559,1061
"28812","ENSG00000235448","9",12698554,12814377,115823
"28813","ENSG00000235449","1",202767229,202767418,189
"28814","ENSG00000235450","7",91380778,91556848,176070
"28815","ENSG00000235453","9",32551144,32568621,17477
"28816","ENSG00000235454","7",53862233,53863339,1106
"28817","ENSG00000235455","3",51873596,51875767,2171
"28818","ENSG00000235459","7",122681315,122681662,347
"28819","ENSG00000235461","X",85210684,85220021,9337
"28820","ENSG00000235462","Y",13153931,13162214,8283
"28821","ENSG00000235470","10",103479603,103517393,37790
"28822","ENSG00000235472","13",28598833,28600052,1219
"28823","ENSG00000235478","22",17121560,17132104,10544
"28824","ENSG00000235480","2",96527940,96532306,4366
"28825","ENSG00000235481","9",33775183,33818795,43612
"28826","ENSG00000235482","3",37748110,37748900,790
"28827","ENSG00000235483","X",2852740,2853760,1020
"28828","ENSG00000235485","22",34589085,34591278,2193
"28829","ENSG00000235486","2",106369724,106378247,8523
"28830","ENSG00000235488","6",15247815,15248634,819
"28831","ENSG00000235489","10",64168959,64170850,1891
"28832","ENSG00000235491","2",125710969,125765842,54873
"28833","ENSG00000235492","1",199016133,199076735,60602
"28834","ENSG00000235493","3",27916774,28059268,142494
"28835","ENSG00000235494","9",97222602,97235017,12415
"28836","ENSG00000235497","2",23375229,23381299,6070
"28837","ENSG00000235499","2",73985132,73986343,1211
"28838","ENSG00000235500","13",18892260,18895230,2970
"28839","ENSG00000235501","1",94927361,94963616,36255
"28840","ENSG00000235503","7",83355154,83362266,7112
"28841","ENSG00000235505","11",104901549,104919073,17524
"28842","ENSG00000235508","20",45640486,45641370,884
"28843","ENSG00000235510","X",36957913,36958139,226
"28844","ENSG00000235513","22",41207592,41228500,20908
"28845","ENSG00000235514","21",25762938,25763333,395
"28846","ENSG00000235518","15",26657030,26658763,1733
"28847","ENSG00000235519","2",81461358,81467468,6110
"28848","ENSG00000235522","2",105846534,105857177,10643
"28849","ENSG00000235523","9",72257336,72257783,447
"28850","ENSG00000235524","10",69591406,69592931,1525
"28851","ENSG00000235525","20",45975249,45976075,826
"28852","ENSG00000235526","1",110177643,110178719,1076
"28853","ENSG00000235527","1",113924000,113929495,5495
"28854","ENSG00000235529","2",235505751,235507566,1815
"28855","ENSG00000235530","17",21214322,21230035,15713
"28856","ENSG00000235531","8",71828167,72118393,290226
"28857","ENSG00000235532","13",74231457,74259976,28519
"28858","ENSG00000235533","9",14025971,14030115,4144
"28859","ENSG00000235535","6",123389421,123510247,120826
"28860","ENSG00000235537","2",21607465,21637197,29732
"28861","ENSG00000235538","6",163671577,164231610,560033
"28862","ENSG00000235545","1",62688482,62710694,22212
"28863","ENSG00000235546","17",20612667,20614008,1341
"28864","ENSG00000235548","2",156033247,156034080,833
"28865","ENSG00000235549","1",38958275,38958925,650
"28866","ENSG00000235550","13",38922727,38936199,13472
"28867","ENSG00000235552","18",6462144,6463015,871
"28868","ENSG00000235554","17",16616848,16617881,1033
"28869","ENSG00000235555","19",49275119,49275420,301
"28870","ENSG00000235558","5",71220356,71259238,38882
"28871","ENSG00000235559","6",28783633,28784004,371
"28872","ENSG00000235560","16",30534752,30537149,2397
"28873","ENSG00000235563","1",53114576,53118609,4033
"28874","ENSG00000235568","22",42380410,42432395,51985
"28875","ENSG00000235570","6",28648286,28649066,780
"28876","ENSG00000235571","2",94786688,94787261,573
"28877","ENSG00000235572","9",135352673,135354284,1611
"28878","ENSG00000235573","22",31113017,31113396,379
"28879","ENSG00000235574","7",27491682,27492765,1083
"28880","ENSG00000235575","1",169310665,169322479,11814
"28881","ENSG00000235576","2",7725801,7730705,4904
"28882","ENSG00000235578","22",20343203,20344365,1162
"28883","ENSG00000235579","2",201162484,201162680,196
"28884","ENSG00000235582","1",197735636,197736107,471
"28885","ENSG00000235584","2",95660588,95668727,8139
"28886","ENSG00000235586","2",38601598,38602178,580
"28887","ENSG00000235587","X",46439709,46440714,1005
"28888","ENSG00000235590","20",58818919,58850903,31984
"28889","ENSG00000235593","3",29926811,29934156,7345
"28890","ENSG00000235595","1",119462029,119463021,992
"28891","ENSG00000235597","2",104430130,104532747,102617
"28892","ENSG00000235601","9",93955597,93959140,3543
"28893","ENSG00000235602","12",8133772,8134849,1077
"28894","ENSG00000235605","1",234356704,234357141,437
"28895","ENSG00000235609","21",14818843,15014430,195587
"28896","ENSG00000235610","2",223505476,223510933,5457
"28897","ENSG00000235612","1",56145721,56155224,9503
"28898","ENSG00000235613","1",77847110,77848802,1692
"28899","ENSG00000235615","2",131964731,131979873,15142
"28900","ENSG00000235616","2",187825341,187826449,1108
"28901","ENSG00000235618","10",50021182,50067803,46621
"28902","ENSG00000235619","9",35507564,35507873,309
"28903","ENSG00000235621","20",48359884,48370636,10752
"28904","ENSG00000235623","10",14986942,14987515,573
"28905","ENSG00000235627","3",48161176,48161417,241
"28906","ENSG00000235629","3",14648194,14649432,1238
"28907","ENSG00000235631","7",122701668,122702922,1254
"28908","ENSG00000235635","5",56941307,56947152,5845
"28909","ENSG00000235636","X",47512602,47513483,881
"28910","ENSG00000235637","10",17862887,17865471,2584
"28911","ENSG00000235641","9",91159573,91166272,6699
"28912","ENSG00000235643","1",11609468,11613358,3890
"28913","ENSG00000235644","2",108712262,108712900,638
"28914","ENSG00000235645","10",69684899,69692452,7553
"28915","ENSG00000235646","7",64111752,64112572,820
"28916","ENSG00000235647","22",39750127,39751293,1166
"28917","ENSG00000235649","Y",11957208,11987386,30178
"28918","ENSG00000235651","2",135510546,135511943,1397
"28919","ENSG00000235652","6",145749917,145887430,137513
"28920","ENSG00000235655","2",174719908,174720318,410
"28921","ENSG00000235656","X",115198432,115198749,317
"28922","ENSG00000235659","9",61865755,61866965,1210
"28923","ENSG00000235660","13",52482804,52489216,6412
"28924","ENSG00000235661","11",43569306,43570395,1089
"28925","ENSG00000235663","6",31764310,31765588,1278
"28926","ENSG00000235665","2",7922425,8278186,355761
"28927","ENSG00000235669","7",29199540,29208970,9430
"28928","ENSG00000235670","3",32030196,32030678,482
"28929","ENSG00000235672","17",18908279,18908865,586
"28930","ENSG00000235673","1",37840986,37841676,690
"28931","ENSG00000235674","1",235738005,235738989,984
"28932","ENSG00000235677","10",96560185,96560922,737
"28933","ENSG00000235679","10",30383400,30383622,222
"28934","ENSG00000235681","19",54446830,54447047,217
"28935","ENSG00000235683","8",99695957,99698017,2060
"28936","ENSG00000235685","X",40514895,40515508,613
"28937","ENSG00000235686","19",12508129,12508263,134
"28938","ENSG00000235687","10",37248118,37347031,98913
"28939","ENSG00000235688","2",949627,950274,647
"28940","ENSG00000235689","22",24006305,24008258,1953
"28941","ENSG00000235690","10",45127318,45148914,21596
"28942","ENSG00000235695","3",47663626,47663934,308
"28943","ENSG00000235698","20",12380056,12381255,1199
"28944","ENSG00000235699","X",146809784,146810409,625
"28945","ENSG00000235700","1",157128362,157128671,309
"28946","ENSG00000235701","21",39171130,39172106,976
"28947","ENSG00000235703","X",149938613,150224580,285967
"28948","ENSG00000235705","10",79507597,79510982,3385
"28949","ENSG00000235706","14",95157645,95181475,23830
"28950","ENSG00000235707","9",75401889,75402992,1103
"28951","ENSG00000235711","15",79293285,79298235,4950
"28952","ENSG00000235713","7",99992397,99993050,653
"28953","ENSG00000235716","2",161580072,161581350,1278
"28954","ENSG00000235717","2",114833830,114835588,1758
"28955","ENSG00000235720","7",63893286,63894641,1355
"28956","ENSG00000235721","2",110007675,110010783,3108
"28957","ENSG00000235724","2",161222785,161308389,85604
"28958","ENSG00000235725","2",65589566,65640177,50611
"28959","ENSG00000235726","2",234803808,234913384,109576
"28960","ENSG00000235728","7",36781008,36782789,1781
"28961","ENSG00000235731","15",25456271,25578813,122542
"28962","ENSG00000235734","2",97827248,97827545,297
"28963","ENSG00000235736","1",168763365,168774490,11125
"28964","ENSG00000235738","7",55797946,55798480,534
"28965","ENSG00000235740","6",143554325,143562031,7706
"28966","ENSG00000235741","1",54516412,54517259,847
"28967","ENSG00000235742","10",117023674,117023851,177
"28968","ENSG00000235743","6",23337711,23404132,66421
"28969","ENSG00000235746","10",94646364,94647996,1632
"28970","ENSG00000235748","1",197138748,197139307,559
"28971","ENSG00000235749","1",247639630,247761255,121625
"28972","ENSG00000235750","1",175156986,175192999,36013
"28973","ENSG00000235759","22",15550904,15553838,2934
"28974","ENSG00000235760","2",47527008,47535199,8191
"28975","ENSG00000235763","10",13104574,13104793,219
"28976","ENSG00000235768","13",94757451,94759272,1821
"28977","ENSG00000235770","2",215611563,215848954,237391
"28978","ENSG00000235772","21",42560374,42561934,1560
"28979","ENSG00000235774","2",126308494,126343992,35498
"28980","ENSG00000235776","22",19792294,19793094,800
"28981","ENSG00000235777","1",97796921,97798066,1145
"28982","ENSG00000235779","2",290941,314373,23432
"28983","ENSG00000235781","6",30516266,30519217,2951
"28984","ENSG00000235782","1",70947379,70951493,4114
"28985","ENSG00000235784","13",93394977,93395855,878
"28986","ENSG00000235785","14",99262948,99264735,1787
"28987","ENSG00000235787","3",42469640,42469879,239
"28988","ENSG00000235790","1",31644049,31660162,16113
"28989","ENSG00000235794","1",93924386,93924716,330
"28990","ENSG00000235795","1",100995473,100996260,787
"28991","ENSG00000235802","X",153969325,153970087,762
"28992","ENSG00000235803","10",69590583,69591262,679
"28993","ENSG00000235804","1",65077413,65078131,718
"28994","ENSG00000235805","3",44709311,44710886,1575
"28995","ENSG00000235806","X",38770331,38799658,29327
"28996","ENSG00000235808","21",39488327,39488760,433
"28997","ENSG00000235811","1",202039851,202039934,83
"28998","ENSG00000235812","14",70245491,70247801,2310
"28999","ENSG00000235813","X",134599457,134606254,6797
"29000","ENSG00000235815","6",168716606,168723495,6889
"29001","ENSG00000235816","10",63427297,63427939,642
"29002","ENSG00000235817","1",230612009,230612412,403
"29003","ENSG00000235819","9",86414201,86488607,74406
"29004","ENSG00000235820","20",5533628,5535889,2261
"29005","ENSG00000235821","6",29750729,29751148,419
"29006","ENSG00000235823","10",100373099,100454043,80944
"29007","ENSG00000235824","10",28789188,28796113,6925
"29008","ENSG00000235828","7",15701435,15701752,317
"29009","ENSG00000235829","1",14692129,14692613,484
"29010","ENSG00000235830","3",9249742,9257507,7765
"29011","ENSG00000235831","3",4896809,4980414,83605
"29012","ENSG00000235832","9",64486164,64487069,905
"29013","ENSG00000235833","2",97523949,97524976,1027
"29014","ENSG00000235834","X",17528435,17587160,58725
"29015","ENSG00000235837","7",16695871,16719898,24027
"29016","ENSG00000235838","10",9721963,9724416,2453
"29017","ENSG00000235840","2",120319007,120326298,7291
"29018","ENSG00000235843","10",26717635,26718778,1143
"29019","ENSG00000235845","3",44899178,44900925,1747
"29020","ENSG00000235847","2",84777259,84778223,964
"29021","ENSG00000235848","2",37949911,38067041,117130
"29022","ENSG00000235849","X",132667642,132669888,2246
"29023","ENSG00000235852","2",190880797,190882059,1262
"29024","ENSG00000235855","11",67722483,67723455,972
"29025","ENSG00000235858","10",80333771,80334426,655
"29026","ENSG00000235859","7",30371508,30372741,1233
"29027","ENSG00000235861","2",241118725,241118943,218
"29028","ENSG00000235862","1",212624284,212626771,2487
"29029","ENSG00000235863","6",33277132,33284832,7700
"29030","ENSG00000235865","9",121280768,121285530,4762
"29031","ENSG00000235868","12",7566369,7567382,1013
"29032","ENSG00000235869","1",174922107,174922440,333
"29033","ENSG00000235872","12",67658991,67670919,11928
"29034","ENSG00000235875","13",111113812,111115678,1866
"29035","ENSG00000235879","13",90170866,90171799,933
"29036","ENSG00000235880","9",267966,273002,5036
"29037","ENSG00000235881","2",110709575,110716595,7020
"29038","ENSG00000235884","12",30755167,30802602,47435
"29039","ENSG00000235885","2",67086446,67311439,224993
"29040","ENSG00000235886","3",43778961,43779982,1021
"29041","ENSG00000235887","1",143499187,143500512,1325
"29042","ENSG00000235888","21",38988569,39062894,74325
"29043","ENSG00000235890","21",44506807,44516575,9768
"29044","ENSG00000235893","9",65816932,65817472,540
"29045","ENSG00000235897","3",196318330,196325570,7240
"29046","ENSG00000235899","6",53616471,53631400,14929
"29047","ENSG00000235902","4",185665885,185675417,9532
"29048","ENSG00000235903","13",46052497,46161379,108882
"29049","ENSG00000235904","3",29054570,29290726,236156
"29050","ENSG00000235907","1",33512008,33512743,735
"29051","ENSG00000235908","3",49365145,49367006,1861
"29052","ENSG00000235910","11",116836117,116856018,19901
"29053","ENSG00000235911","2",19711715,19717576,5861
"29054","ENSG00000235912","1",27649419,27649610,191
"29055","ENSG00000235914","20",14884250,14929528,45278
"29056","ENSG00000235916","X",53825887,53826309,422
"29057","ENSG00000235917","9",5098341,5099325,984
"29058","ENSG00000235919","1",155562042,155563944,1902
"29059","ENSG00000235920","7",11820317,11821294,977
"29060","ENSG00000235924","10",79981839,79982212,373
"29061","ENSG00000235927","1",77881348,77889539,8191
"29062","ENSG00000235929","X",14977959,14978463,504
"29063","ENSG00000235930","12",10770305,10770605,300
"29064","ENSG00000235931","10",59955430,59960913,5483
"29065","ENSG00000235933","1",116164284,116166241,1957
"29066","ENSG00000235934","2",170814686,170818037,3351
"29067","ENSG00000235937","2",54029552,54030682,1130
"29068","ENSG00000235939","10",49419277,49472903,53626
"29069","ENSG00000235940","10",20804293,20804577,284
"29070","ENSG00000235942","1",152842868,152843983,1115
"29071","ENSG00000235944","7",5823160,5854365,31205
"29072","ENSG00000235945","7",116873454,116876376,2922
"29073","ENSG00000235946","X",104062542,104063037,495
"29074","ENSG00000235947","3",4749192,4751590,2398
"29075","ENSG00000235951","2",204065706,204067363,1657
"29076","ENSG00000235954","22",27919376,28008581,89205
"29077","ENSG00000235955","7",45816216,45819016,2800
"29078","ENSG00000235957","13",49187479,49187670,191
"29079","ENSG00000235958","20",3106913,3150867,43954
"29080","ENSG00000235959","2",95640181,95640604,423
"29081","ENSG00000235961","X",153072482,153075018,2536
"29082","ENSG00000235962","10",33057615,33058407,792
"29083","ENSG00000235963","6",29907783,29908645,862
"29084","ENSG00000235964","10",38091764,38092051,287
"29085","ENSG00000235967","7",133727368,133727734,366
"29086","ENSG00000235972","6",150040547,150042033,1486
"29087","ENSG00000235974","19",58012589,58025926,13337
"29088","ENSG00000235975","X",138806374,138807091,717
"29089","ENSG00000235978","3",4814294,4887293,72999
"29090","ENSG00000235979","17",19417769,19492991,75222
"29091","ENSG00000235984","13",92701389,92721614,20225
"29092","ENSG00000235988","1",148317683,148318013,330
"29093","ENSG00000235989","22",30922308,30932449,10141
"29094","ENSG00000235990","1",241916123,241916543,420
"29095","ENSG00000235991","X",155137111,155156503,19392
"29096","ENSG00000235992","22",15749156,15750825,1669
"29097","ENSG00000235993","2",229701794,229702148,354
"29098","ENSG00000235994","6",167975924,167979776,3852
"29099","ENSG00000235996","20",19212852,19213477,625
"29100","ENSG00000235997","2",30346623,30361010,14387
"29101","ENSG00000236003","22",20522070,20523870,1800
"29102","ENSG00000236004","1",52189916,52190309,393
"29103","ENSG00000236007","2",211778273,211779763,1490
"29104","ENSG00000236008","2",8461703,8592903,131200
"29105","ENSG00000236009","1",21415898,21417492,1594
"29106","ENSG00000236012","1",111380291,111380571,280
"29107","ENSG00000236013","6",139976352,140093721,117369
"29108","ENSG00000236015","7",39569376,39570198,822
"29109","ENSG00000236017","X",1401769,1414028,12259
"29110","ENSG00000236018","7",157197600,157198511,911
"29111","ENSG00000236021","1",176207648,176447919,240271
"29112","ENSG00000236024","9",129712896,129718635,5739
"29113","ENSG00000236027","11",125788111,125791600,3489
"29114","ENSG00000236028","20",46901143,46901726,583
"29115","ENSG00000236031","1",243545532,243548329,2797
"29116","ENSG00000236035","1",203656969,203657760,791
"29117","ENSG00000236036","13",35697487,35699938,2451
"29118","ENSG00000236039","7",17405479,17558909,153430
"29119","ENSG00000236040","1",111250254,111256715,6461
"29120","ENSG00000236041","11",2771356,2771577,221
"29121","ENSG00000236044","13",51966742,51967149,407
"29122","ENSG00000236045","1",15334166,15335464,1298
"29123","ENSG00000236047","2",202520401,202520989,588
"29124","ENSG00000236048","7",12471352,12472545,1193
"29125","ENSG00000236049","2",150552532,150572221,19689
"29126","ENSG00000236051","13",77026767,77129717,102950
"29127","ENSG00000236052","22",34017422,34218796,201374
"29128","ENSG00000236053","13",109310135,109311773,1638
"29129","ENSG00000236054","22",32583300,32584204,904
"29130","ENSG00000236056","21",29222321,29223257,936
"29131","ENSG00000236058","10",118872054,118872602,548
"29132","ENSG00000236060","9",72007881,72008136,255
"29133","ENSG00000236062","3",12257801,12258460,659
"29134","ENSG00000236064","X",107857364,107936230,78866
"29135","ENSG00000236065","1",32987075,33032469,45394
"29136","ENSG00000236068","5",64404512,64486615,82103
"29137","ENSG00000236069","1",192517190,192538102,20912
"29138","ENSG00000236073","1",21073639,21073753,114
"29139","ENSG00000236075","6",40501631,40502393,762
"29140","ENSG00000236076","13",20102701,20103230,529
"29141","ENSG00000236077","X",116669810,116680303,10493
"29142","ENSG00000236078","7",47608465,47629893,21428
"29143","ENSG00000236079","22",44413485,44414814,1329
"29144","ENSG00000236081","7",1738630,1742291,3661
"29145","ENSG00000236086","6",2341450,2341711,261
"29146","ENSG00000236088","17",13755574,14069495,313921
"29147","ENSG00000236090","2",41819747,41820754,1007
"29148","ENSG00000236091","X",134949549,134953382,3833
"29149","ENSG00000236094","13",30880912,30883395,2483
"29150","ENSG00000236095","9",94900429,94904754,4325
"29151","ENSG00000236097","22",15349467,15350043,576
"29152","ENSG00000236098","1",94318479,94324569,6090
"29153","ENSG00000236102","7",157057709,157058514,805
"29154","ENSG00000236104","6",33314406,33317942,3536
"29155","ENSG00000236105","7",127295620,127296203,583
"29156","ENSG00000236106","2",5726253,5730355,4102
"29157","ENSG00000236107","2",165957188,166390771,433583
"29158","ENSG00000236108","1",205134646,205134950,304
"29159","ENSG00000236109","2",104583138,104621767,38629
"29160","ENSG00000236110","9",36021692,36022113,421
"29161","ENSG00000236111","1",45781277,45781957,680
"29162","ENSG00000236114","10",43523256,43525217,1961
"29163","ENSG00000236115","9",92205356,92210158,4802
"29164","ENSG00000236116","2",227616998,227617790,792
"29165","ENSG00000236117","22",43400331,43409681,9350
"29166","ENSG00000236118","22",22155582,22155942,360
"29167","ENSG00000236119","21",36082859,36090414,7555
"29168","ENSG00000236120","X",5653418,5726326,72908
"29169","ENSG00000236123","19",43278933,43284318,5385
"29170","ENSG00000236124","2",112981166,112981434,268
"29171","ENSG00000236125","8",7337115,7338707,1592
"29172","ENSG00000236129","11",131187022,131189753,2731
"29173","ENSG00000236130","9",97699625,97853080,153455
"29174","ENSG00000236132","22",31816379,31817491,1112
"29175","ENSG00000236133","13",77979817,77997881,18064
"29176","ENSG00000236136","1",209744373,209745214,841
"29177","ENSG00000236137","1",117025482,117059490,34008
"29178","ENSG00000236138","3",75668931,75670185,1254
"29179","ENSG00000236140","1",145286610,145287755,1145
"29180","ENSG00000236144","19",35540738,35546029,5291
"29181","ENSG00000236145","2",121178327,121182580,4253
"29182","ENSG00000236146","9",129380136,129380470,334
"29183","ENSG00000236148","2",64347193,64347741,548
"29184","ENSG00000236152","3",6773037,6773343,306
"29185","ENSG00000236153","2",180979427,180980090,663
"29186","ENSG00000236154","10",69575807,69577154,1347
"29187","ENSG00000236155","1",26209741,26229840,20099
"29188","ENSG00000236159","20",37165774,37166312,538
"29189","ENSG00000236162","2",10717773,10720952,3179
"29190","ENSG00000236164","6",46758296,46761158,2862
"29191","ENSG00000236165","3",36976316,36976840,524
"29192","ENSG00000236166","6",132085084,132099279,14195
"29193","ENSG00000236170","14",105919502,105919518,16
"29194","ENSG00000236172","2",6615389,6651104,35715
"29195","ENSG00000236173","6",169809318,169810102,784
"29196","ENSG00000236176","13",89548691,89553804,5113
"29197","ENSG00000236180","1",42570970,42571390,420
"29198","ENSG00000236182","3",188989382,188990135,753
"29199","ENSG00000236184","9",32979560,32980403,843
"29200","ENSG00000236185","X",95610578,95610957,379
"29201","ENSG00000236187","X",18535079,18536120,1041
"29202","ENSG00000236188","X",3659487,3668192,8705
"29203","ENSG00000236191","8",68525517,68525906,389
"29204","ENSG00000236193","2",213155806,213167712,11906
"29205","ENSG00000236194","17",42270517,42272683,2166
"29206","ENSG00000236197","7",95035731,95214338,178607
"29207","ENSG00000236199","9",2041900,2046023,4123
"29208","ENSG00000236200","1",43685123,43708138,23015
"29209","ENSG00000236202","3",7519741,7560333,40592
"29210","ENSG00000236204","2",18986451,19348067,361616
"29211","ENSG00000236206","1",165598356,165624084,25728
"29212","ENSG00000236208","10",49296112,49299018,2906
"29213","ENSG00000236209","2",74919555,74924846,5291
"29214","ENSG00000236211","2",130273908,130275449,1541
"29215","ENSG00000236213","2",37562486,37646698,84212
"29216","ENSG00000236216","1",21397987,21398362,375
"29217","ENSG00000236217","10",80031968,80032393,425
"29218","ENSG00000236226","7",103030104,103031354,1250
"29219","ENSG00000236229","3",193155456,193157208,1752
"29220","ENSG00000236230","1",222088806,222389103,300297
"29221","ENSG00000236231","2",176524879,176531683,6804
"29222","ENSG00000236232","7",112374324,112375429,1105
"29223","ENSG00000236234","17",45452844,45464065,11221
"29224","ENSG00000236235","22",15290718,15297196,6478
"29225","ENSG00000236238","7",131665507,131665858,351
"29226","ENSG00000236240","13",92484606,92510094,25488
"29227","ENSG00000236241","3",175675087,175676801,1714
"29228","ENSG00000236242","13",109163902,109201483,37581
"29229","ENSG00000236244","1",234268583,234272500,3917
"29230","ENSG00000236246","3",198121479,198123232,1753
"29231","ENSG00000236248","11",5362615,5362849,234
"29232","ENSG00000236252","9",65219987,65230861,10874
"29233","ENSG00000236253","1",53413149,53440020,26871
"29234","ENSG00000236254","9",5107937,5109290,1353
"29235","ENSG00000236255","2",117833937,117841658,7721
"29236","ENSG00000236256","X",97431286,97642589,211303
"29237","ENSG00000236257","1",158454198,158455273,1075
"29238","ENSG00000236259","2",68125265,68125747,482
"29239","ENSG00000236261","7",57652875,57653208,333
"29240","ENSG00000236262","11",70646165,70647562,1397
"29241","ENSG00000236264","11",2335135,2347685,12550
"29242","ENSG00000236266","1",7810242,7827342,17100
"29243","ENSG00000236267","11",116813204,116814003,799
"29244","ENSG00000236268","1",82970820,82986208,15388
"29245","ENSG00000236272","22",43212674,43213661,987
"29246","ENSG00000236274","1",35509742,35511438,1696
"29247","ENSG00000236276","X",43949732,43971582,21850
"29248","ENSG00000236278","1",198679139,198680033,894
"29249","ENSG00000236279","7",139523685,139544985,21300
"29250","ENSG00000236281","7",131753746,131754252,506
"29251","ENSG00000236283","2",164840661,165208261,367600
"29252","ENSG00000236284","7",63367427,63368156,729
"29253","ENSG00000236285","X",32205902,32206738,836
"29254","ENSG00000236287","11",10812074,10858796,46722
"29255","ENSG00000236289","2",16013928,16087201,73273
"29256","ENSG00000236290","1",52573114,52573816,702
"29257","ENSG00000236292","1",216194051,216204366,10315
"29258","ENSG00000236295","2",216870441,216873932,3491
"29259","ENSG00000236296","4",143559472,143561460,1988
"29260","ENSG00000236297","3",193578812,193593090,14278
"29261","ENSG00000236299","7",63888200,63900794,12594
"29262","ENSG00000236300","2",143098123,143098417,294
"29263","ENSG00000236301","11",3218332,3223131,4799
"29264","ENSG00000236303","10",130213488,130483193,269705
"29265","ENSG00000236304","11",76657056,76663866,6810
"29266","ENSG00000236305","7",100837314,100852616,15302
"29267","ENSG00000236306","9",25780032,25844585,64553
"29268","ENSG00000236307","2",111887914,111888741,827
"29269","ENSG00000236308","10",100190036,100190747,711
"29270","ENSG00000236311","10",101089321,101131126,41805
"29271","ENSG00000236312","19",22368599,22368952,353
"29272","ENSG00000236313","10",37348616,37349572,956
"29273","ENSG00000236316","9",90742526,90743380,854
"29274","ENSG00000236317","1",212855175,212855366,191
"29275","ENSG00000236318","7",17374867,17467256,92389
"29276","ENSG00000236319","17",55526964,55561577,34613
"29277","ENSG00000236320","17",35548125,35558098,9973
"29278","ENSG00000236323","22",22185941,22186619,678
"29279","ENSG00000236324","6",157885114,157892786,7672
"29280","ENSG00000236325","22",17192936,17193308,372
"29281","ENSG00000236327","1",153890595,153890865,270
"29282","ENSG00000236330","2",110967834,110968719,885
"29283","ENSG00000236332","21",27361121,27395787,34666
"29284","ENSG00000236333","12",72249964,72276954,26990
"29285","ENSG00000236334","1",148479824,148483679,3855
"29286","ENSG00000236335","1",30409560,30411638,2078
"29287","ENSG00000236336","6",4774526,4775408,882
"29288","ENSG00000236337","X",147946941,147947583,642
"29289","ENSG00000236340","7",127215127,127229927,14800
"29290","ENSG00000236341","1",56963886,56996757,32871
"29291","ENSG00000236345","6",63806836,63822642,15806
"29292","ENSG00000236347","6",113531118,113543793,12675
"29293","ENSG00000236348","2",17385091,17386417,1326
"29294","ENSG00000236349","12",94548241,94549536,1295
"29295","ENSG00000236352","20",53940160,53942508,2348
"29296","ENSG00000236354","13",38533343,38545299,11956
"29297","ENSG00000236355","6",38714051,38715217,1166
"29298","ENSG00000236358","1",234357006,234365828,8822
"29299","ENSG00000236359","11",5330592,5331360,768
"29300","ENSG00000236360","1",52993201,52993702,501
"29301","ENSG00000236364","1",165889725,165900995,11270
"29302","ENSG00000236366","6",142526455,142637889,111434
"29303","ENSG00000236373","10",90402521,90628852,226331
"29304","ENSG00000236375","10",68010205,68010862,657
"29305","ENSG00000236376","9",75579669,75588548,8879
"29306","ENSG00000236377","17",32905662,32906584,922
"29307","ENSG00000236378","6",135807148,135808466,1318
"29308","ENSG00000236380","3",21405737,21406508,771
"29309","ENSG00000236383","17",43216941,43305397,88456
"29310","ENSG00000236384","21",41711520,41715775,4255
"29311","ENSG00000236385","3",177621382,177628287,6905
"29312","ENSG00000236387","20",4422186,4431732,9546
"29313","ENSG00000236388","20",34441592,34442025,433
"29314","ENSG00000236389","6",134706060,134707349,1289
"29315","ENSG00000236390","1",201673105,201674144,1039
"29316","ENSG00000236391","2",173338219,173356208,17989
"29317","ENSG00000236393","X",40262917,40299061,36144
"29318","ENSG00000236394","9",137052662,137053375,713
"29319","ENSG00000236395","7",131702269,131702653,384
"29320","ENSG00000236396","18",11609596,11610612,1016
"29321","ENSG00000236397","2",113599036,113601261,2225
"29322","ENSG00000236398","7",143183419,143184435,1016
"29323","ENSG00000236403","9",134936524,134943207,6683
"29324","ENSG00000236404","9",2421597,2643359,221762
"29325","ENSG00000236408","7",154838388,154865483,27095
"29326","ENSG00000236409","3",47010824,47013465,2641
"29327","ENSG00000236411","3",37789921,37790445,524
"29328","ENSG00000236414","7",10702676,10707406,4730
"29329","ENSG00000236417","10",87386685,87390203,3518
"29330","ENSG00000236420","10",8619933,8620608,675
"29331","ENSG00000236423","1",3900352,3917225,16873
"29332","ENSG00000236424","Y",9527880,9530682,2802
"29333","ENSG00000236425","3",195561215,195561580,365
"29334","ENSG00000236426","10",119330233,119336182,5949
"29335","ENSG00000236427","1",152205858,152207057,1199
"29336","ENSG00000236430","1",203872574,203874187,1613
"29337","ENSG00000236431","2",95536117,95536495,378
"29338","ENSG00000236432","2",227221052,227325711,104659
"29339","ENSG00000236433","13",68331338,68331613,275
"29340","ENSG00000236434","1",51264916,51266074,1158
"29341","ENSG00000236436","2",20859771,20861661,1890
"29342","ENSG00000236437","11",116496899,116500630,3731
"29343","ENSG00000236438","3",198153287,198222513,69226
"29344","ENSG00000236439","1",202471864,202472117,253
"29345","ENSG00000236440","2",140683360,140683888,528
"29346","ENSG00000236442","10",45151445,45151915,470
"29347","ENSG00000236444","13",30422488,30428616,6128
"29348","ENSG00000236445","2",218975393,218989940,14547
"29349","ENSG00000236446","X",120872603,120875929,3326
"29350","ENSG00000236447","5",81991995,81992481,486
"29351","ENSG00000236449","2",174547141,174776720,229579
"29352","ENSG00000236450","9",62357834,62358140,306
"29353","ENSG00000236451","2",220450679,220741493,290814
"29354","ENSG00000236452","3",34203244,34268811,65567
"29355","ENSG00000236453","7",94022833,94066661,43828
"29356","ENSG00000236456","20",34245953,34246537,584
"29357","ENSG00000236459","3",42889361,42890306,945
"29358","ENSG00000236460","7",31941261,31941583,322
"29359","ENSG00000236461","9",115119539,115138409,18870
"29360","ENSG00000236463","13",30316360,30319903,3543
"29361","ENSG00000236464","22",26161834,26164303,2469
"29362","ENSG00000236466","6",46492052,46606162,114110
"29363","ENSG00000236467","10",76888044,76980624,92580
"29364","ENSG00000236468","1",199387141,199388475,1334
"29365","ENSG00000236469","2",71002531,71064743,62212
"29366","ENSG00000236471","21",15067070,15067837,767
"29367","ENSG00000236472","17",50135586,50146176,10590
"29368","ENSG00000236474","20",18420160,18421454,1294
"29369","ENSG00000236475","6",30238301,30242279,3978
"29370","ENSG00000236476","1",46742329,46743133,804
"29371","ENSG00000236478","2",216174896,216176032,1136
"29372","ENSG00000236480","1",114535995,114537840,1845
"29373","ENSG00000236481","16",26584755,26594813,10058
"29374","ENSG00000236483","19",12502675,12504106,1431
"29375","ENSG00000236484","1",161378707,161379358,651
"29376","ENSG00000236485","2",131983937,131994161,10224
"29377","ENSG00000236489","3",185606575,185606873,298
"29378","ENSG00000236491","X",135180255,135194679,14424
"29379","ENSG00000236493","10",92668745,92669743,998
"29380","ENSG00000236494","7",33793167,33803190,10023
"29381","ENSG00000236495","10",14652689,14661691,9002
"29382","ENSG00000236496","9",2875442,2876427,985
"29383","ENSG00000236497","1",232727251,232751299,24048
"29384","ENSG00000236498","2",61868432,61886082,17650
"29385","ENSG00000236499","22",20206397,20208524,2127
"29386","ENSG00000236501","2",176989418,177164656,175238
"29387","ENSG00000236502","2",44940154,44941873,1719
"29388","ENSG00000236504","17",20647287,20681799,34512
"29389","ENSG00000236505","1",40563534,40563659,125
"29390","ENSG00000236508","3",193307244,193314362,7118
"29391","ENSG00000236509","X",134607157,134607632,475
"29392","ENSG00000236510","7",3642815,3643784,969
"29393","ENSG00000236511","9",3181342,3200445,19103
"29394","ENSG00000236512","6",7620422,7620878,456
"29395","ENSG00000236513","X",4627200,4633572,6372
"29396","ENSG00000236514","10",37857740,37859110,1370
"29397","ENSG00000236516","2",131299220,131300444,1224
"29398","ENSG00000236519","21",44802577,44804717,2140
"29399","ENSG00000236520","13",94154193,94187991,33798
"29400","ENSG00000236521","9",80357029,80360338,3309
"29401","ENSG00000236523","1",203255743,203256475,732
"29402","ENSG00000236525","2",102433957,102435340,1383
"29403","ENSG00000236526","20",11909404,11918677,9273
"29404","ENSG00000236527","20",62872250,62873076,826
"29405","ENSG00000236528","1",25859613,25863420,3807
"29406","ENSG00000236529","7",65840212,65840596,384
"29407","ENSG00000236530","4",80079532,80081122,1590
"29408","ENSG00000236531","7",68091223,68119209,27986
"29409","ENSG00000236532","21",28116094,28228667,112573
"29410","ENSG00000236533","2",41850203,41850601,398
"29411","ENSG00000236534","13",71675067,71675469,402
"29412","ENSG00000236535","1",174009267,174016206,6939
"29413","ENSG00000236536","7",19119933,19121916,1983
"29414","ENSG00000236539","1",179447602,179457315,9713
"29415","ENSG00000236540","22",20058030,20070569,12539
"29416","ENSG00000236542","20",25669857,25670386,529
"29417","ENSG00000236543","9",135604345,135618952,14607
"29418","ENSG00000236544","7",155421206,155457099,35893
"29419","ENSG00000236545","21",41870633,41872054,1421
"29420","ENSG00000236546","1",39897745,39899098,1353
"29421","ENSG00000236548","6",124644434,124963165,318731
"29422","ENSG00000236549","2",47883455,47883909,454
"29423","ENSG00000236552","10",96750288,96750899,611
"29424","ENSG00000236554","13",100062296,100063601,1305
"29425","ENSG00000236555","2",112346011,112346258,247
"29426","ENSG00000236556","10",59282147,59282835,688
"29427","ENSG00000236559","20",31686216,31716825,30609
"29428","ENSG00000236562","4",66094142,66094526,384
"29429","ENSG00000236564","2",98694109,98695490,1381
"29430","ENSG00000236565","13",65787932,65788764,832
"29431","ENSG00000236567","9",5110913,5112849,1936
"29432","ENSG00000236570","3",18538673,18539899,1226
"29433","ENSG00000236572","2",37744333,37747046,2713
"29434","ENSG00000236574","7",63843314,63843505,191
"29435","ENSG00000236576","X",51856968,51858066,1098
"29436","ENSG00000236577","13",49488970,49489364,394
"29437","ENSG00000236580","7",114297114,114297429,315
"29438","ENSG00000236581","13",33180401,33281584,101183
"29439","ENSG00000236582","10",17577362,17578212,850
"29440","ENSG00000236583","8",99233048,99234459,1411
"29441","ENSG00000236591","6",149027700,149032573,4873
"29442","ENSG00000236592","7",35169224,35169535,311
"29443","ENSG00000236596","2",103494241,103495842,1601
"29444","ENSG00000236601","1",358857,366052,7195
"29445","ENSG00000236603","6",30485940,30486590,650
"29446","ENSG00000236605","2",67324627,67325304,677
"29447","ENSG00000236606","10",85708760,85709167,407
"29448","ENSG00000236608","13",60636888,60638097,1209
"29449","ENSG00000236609","7",6615610,6624290,8680
"29450","ENSG00000236611","22",23326616,23328493,1877
"29451","ENSG00000236617","12",132887842,132888583,741
"29452","ENSG00000236618","17",1516931,1518096,1165
"29453","ENSG00000236627","6",165754189,165775780,21591
"29454","ENSG00000236635","6",76521640,76593821,72181
"29455","ENSG00000236636","1",227264776,227265207,431
"29456","ENSG00000236637","9",21186694,21187671,977
"29457","ENSG00000236641","22",25212085,25213826,1741
"29458","ENSG00000236643","9",124770123,124772927,2804
"29459","ENSG00000236646","1",62038842,62039111,269
"29460","ENSG00000236648","1",17717625,17749978,32353
"29461","ENSG00000236651","2",172103006,172109982,6976
"29462","ENSG00000236653","2",198299276,198375490,76214
"29463","ENSG00000236654","7",23480753,23480959,206
"29464","ENSG00000236658","9",130933851,130945520,11669
"29465","ENSG00000236662","10",100980507,100985614,5107
"29466","ENSG00000236663","21",43140523,43141092,569
"29467","ENSG00000236664","2",177953111,178011989,58878
"29468","ENSG00000236665","2",1158310,1160424,2114
"29469","ENSG00000236666","22",15699361,15703403,4042
"29470","ENSG00000236667","2",180938830,180939298,468
"29471","ENSG00000236668","9",124006277,124009396,3119
"29472","ENSG00000236670","22",20482815,20484105,1290
"29473","ENSG00000236671","10",52230398,52314507,84109
"29474","ENSG00000236673","6",131901963,131920565,18602
"29475","ENSG00000236675","1",155230975,155234325,3350
"29476","ENSG00000236676","1",81585941,81625713,39772
"29477","ENSG00000236677","21",36060432,36064408,3976
"29478","ENSG00000236678","13",74552503,74565445,12942
"29479","ENSG00000236680","9",19026892,19028129,1237
"29480","ENSG00000236682","2",127388184,127400580,12396
"29481","ENSG00000236683","X",26748029,26749090,1061
"29482","ENSG00000236686","3",172425850,172427089,1239
"29483","ENSG00000236687","9",131816192,131820988,4796
"29484","ENSG00000236689","1",93926615,93927569,954
"29485","ENSG00000236692","7",57187892,57189437,1545
"29486","ENSG00000236695","2",194187379,194188309,930
"29487","ENSG00000236698","1",16685621,16686055,434
"29488","ENSG00000236699","4",105552620,105708093,155473
"29489","ENSG00000236700","6",134343307,134504581,161274
"29490","ENSG00000236701","9",73648828,73649839,1011
"29491","ENSG00000236703","6",135195083,135195995,912
"29492","ENSG00000236708","7",3264032,3302452,38420
"29493","ENSG00000236709","9",87553454,87554459,1005
"29494","ENSG00000236710","11",3084393,3085443,1050
"29495","ENSG00000236711","13",36849366,36850046,680
"29496","ENSG00000236712","7",7293508,7293880,372
"29497","ENSG00000236713","1",150780272,150780644,372
"29498","ENSG00000236714","5",142716229,142761035,44806
"29499","ENSG00000236716","10",28743745,28744663,918
"29500","ENSG00000236717","9",92150382,92157445,7063
"29501","ENSG00000236718","Y",9954532,10035299,80767
"29502","ENSG00000236719","1",180547436,180566520,19084
"29503","ENSG00000236720","1",177700524,177712275,11751
"29504","ENSG00000236722","3",58511310,58511676,366
"29505","ENSG00000236723","1",53209783,53213775,3992
"29506","ENSG00000236724","9",3875584,3878809,3225
"29507","ENSG00000236731","1",157629939,157630728,789
"29508","ENSG00000236732","3",32151083,32151895,812
"29509","ENSG00000236733","9",68822403,68843275,20872
"29510","ENSG00000236735","X",68600099,68600473,374
"29511","ENSG00000236739","9",22747700,22748234,534
"29512","ENSG00000236740","6",53930022,53997667,67645
"29513","ENSG00000236741","1",171762074,171762524,450
"29514","ENSG00000236744","10",55247755,55597233,349478
"29515","ENSG00000236745","9",96954820,96955461,641
"29516","ENSG00000236747","X",39367285,39391807,24522
"29517","ENSG00000236751","X",46256759,46327680,70921
"29518","ENSG00000236753","7",131309469,131328312,18843
"29519","ENSG00000236754","22",17580157,17589192,9035
"29520","ENSG00000236756","10",73247360,73276984,29624
"29521","ENSG00000236758","13",29239379,29250554,11175
"29522","ENSG00000236760","2",3131581,3145780,14199
"29523","ENSG00000236761","6",131708684,131711017,2333
"29524","ENSG00000236762","10",121133090,121133723,633
"29525","ENSG00000236763","9",101356466,101356844,378
"29526","ENSG00000236764","4",96902801,96903050,249
"29527","ENSG00000236768","3",48120669,48121215,546
"29528","ENSG00000236769","10",43900874,43912369,11495
"29529","ENSG00000236770","17",74549399,74552737,3338
"29530","ENSG00000236772","20",32449755,32453607,3852
"29531","ENSG00000236773","1",224175476,224175706,230
"29532","ENSG00000236775","1",247015068,247017291,2223
"29533","ENSG00000236776","1",56538452,56538911,459
"29534","ENSG00000236777","10",22163092,22164306,1214
"29535","ENSG00000236778","13",51452364,51554678,102314
"29536","ENSG00000236779","1",204528845,204529692,847
"29537","ENSG00000236780","2",67123357,67397980,274623
"29538","ENSG00000236782","1",26169516,26171831,2315
"29539","ENSG00000236783","9",107963703,107964045,342
"29540","ENSG00000236785","2",102411243,102412108,865
"29541","ENSG00000236786","Y",9548108,9550681,2573
"29542","ENSG00000236790","2",7988683,8488090,499407
"29543","ENSG00000236791","5",180692832,180693763,931
"29544","ENSG00000236792","1",192247505,192247947,442
"29545","ENSG00000236794","22",23179918,23180172,254
"29546","ENSG00000236795","7",147080934,147097609,16675
"29547","ENSG00000236796","9",32836575,32869595,33020
"29548","ENSG00000236797","10",75382393,75382844,451
"29549","ENSG00000236799","10",114994657,114996593,1936
"29550","ENSG00000236800","10",48664199,48672424,8225
"29551","ENSG00000236801","9",70217195,70217668,473
"29552","ENSG00000236803","13",23267506,23269150,1644
"29553","ENSG00000236804","1",119126539,119127291,752
"29554","ENSG00000236806","1",147223554,147224348,794
"29555","ENSG00000236809","1",211417025,211417934,909
"29556","ENSG00000236810","1",23706901,23778296,71395
"29557","ENSG00000236811","20",13392677,13393674,997
"29558","ENSG00000236813","X",63766875,63767400,525
"29559","ENSG00000236814","8",56050038,56051207,1169
"29560","ENSG00000236816","9",42830337,42950827,120490
"29561","ENSG00000236817","1",247565639,247640854,75215
"29562","ENSG00000236818","10",99013103,99013952,849
"29563","ENSG00000236819","17",21075362,21092351,16989
"29564","ENSG00000236822","6",142088233,142089219,986
"29565","ENSG00000236823","6",159899186,159902510,3324
"29566","ENSG00000236824","2",47335315,47335514,199
"29567","ENSG00000236827","8",11247626,11267865,20239
"29568","ENSG00000236828","X",32754940,32756400,1460
"29569","ENSG00000236829","16",382097,392960,10863
"29570","ENSG00000236830","21",36131767,36175815,44048
"29571","ENSG00000236833","3",197660565,197665757,5192
"29572","ENSG00000236834","13",19345049,19346749,1700
"29573","ENSG00000236836","X",24650073,24658237,8164
"29574","ENSG00000236837","2",52494688,52500752,6064
"29575","ENSG00000236838","17",2213697,2214414,717
"29576","ENSG00000236839","7",69187833,69189318,1485
"29577","ENSG00000236841","2",162159762,162173223,13461
"29578","ENSG00000236842","10",75430571,75431588,1017
"29579","ENSG00000236844","3",195554610,195555083,473
"29580","ENSG00000236846","1",223144049,223144954,905
"29581","ENSG00000236847","2",97035461,97037549,2088
"29582","ENSG00000236848","7",103152007,103152325,318
"29583","ENSG00000236849","9",72871130,72874135,3005
"29584","ENSG00000236852","X",62779250,62780326,1076
"29585","ENSG00000236853","7",143488462,143489402,940
"29586","ENSG00000236854","2",32927085,32946149,19064
"29587","ENSG00000236856","2",388412,416885,28473
"29588","ENSG00000236857","9",18717974,18718526,552
"29589","ENSG00000236859","2",121649320,121728563,79243
"29590","ENSG00000236860","13",102263046,102263202,156
"29591","ENSG00000236861","7",93969442,94011113,41671
"29592","ENSG00000236862","9",72655832,72656192,360
"29593","ENSG00000236863","1",235295865,235296335,470
"29594","ENSG00000236866","1",117596832,117605770,8938
"29595","ENSG00000236867","22",49817248,49817712,464
"29596","ENSG00000236869","3",44557357,44685653,128296
"29597","ENSG00000236871","X",1396427,1399402,2975
"29598","ENSG00000236872","1",45415020,45415344,324
"29599","ENSG00000236875","9",12134,13783,1649
"29600","ENSG00000236876","1",42500205,42500339,134
"29601","ENSG00000236878","2",120211054,120211715,661
"29602","ENSG00000236882","5",95838245,95860133,21888
"29603","ENSG00000236885","2",151114811,151186209,71398
"29604","ENSG00000236886","2",216694464,216994079,299615
"29605","ENSG00000236887","1",113198825,113199258,433
"29606","ENSG00000236888","1",57605847,57606206,359
"29607","ENSG00000236890","22",18081466,18081675,209
"29608","ENSG00000236892","10",3532094,3556314,24220
"29609","ENSG00000236893","3",177297161,177298386,1225
"29610","ENSG00000236894","10",26577676,26622338,44662
"29611","ENSG00000236896","9",97986551,97987656,1105
"29612","ENSG00000236897","11",5106062,5107530,1468
"29613","ENSG00000236900","10",74344550,74344805,255
"29614","ENSG00000236901","9",123109494,123115477,5983
"29615","ENSG00000236905","1",212824027,212824505,478
"29616","ENSG00000236907","7",57817601,57818012,411
"29617","ENSG00000236908","12",3318718,3325343,6625
"29618","ENSG00000236911","1",207551925,207606555,54630
"29619","ENSG00000236913","2",42469817,42470266,449
"29620","ENSG00000236914","15",38068812,38072990,4178
"29621","ENSG00000236915","1",86571181,86696311,125130
"29622","ENSG00000236920","6",98210020,98214683,4663
"29623","ENSG00000236922","4",117406166,117691188,285022
"29624","ENSG00000236924","9",6645956,6670635,24679
"29625","ENSG00000236928","7",66434634,66435154,520
"29626","ENSG00000236935","11",64325050,64329504,4454
"29627","ENSG00000236936","1",21266082,21267251,1169
"29628","ENSG00000236937","10",102845595,102845950,355
"29629","ENSG00000236938","7",94071759,94077157,5398
"29630","ENSG00000236939","8",103132963,103141475,8512
"29631","ENSG00000236940","1",151757659,151758442,783
"29632","ENSG00000236941","4",164948079,164949438,1359
"29633","ENSG00000236942","1",205625483,205626153,670
"29634","ENSG00000236946","12",68035767,68036853,1086
"29635","ENSG00000236947","1",156446167,156456763,10596
"29636","ENSG00000236950","1",208972454,208975307,2853
"29637","ENSG00000236951","Y",22100814,22147484,46670
"29638","ENSG00000236953","13",21376977,21377874,897
"29639","ENSG00000236956","2",131189834,131198007,8173
"29640","ENSG00000236957","1",157925065,157949071,24006
"29641","ENSG00000236958","10",54864674,54869122,4448
"29642","ENSG00000236961","6",43722786,43737834,15048
"29643","ENSG00000236963","1",20360579,20431234,70655
"29644","ENSG00000236965","11",5800364,5801297,933
"29645","ENSG00000236966","9",40131747,40132218,471
"29646","ENSG00000236969","2",91775944,91781169,5225
"29647","ENSG00000236972","13",73100575,73100985,410
"29648","ENSG00000236973","1",51707138,51708137,999
"29649","ENSG00000236975","1",229087114,229205428,118314
"29650","ENSG00000236976","7",64141538,64142401,863
"29651","ENSG00000236977","2",197250858,197302519,51661
"29652","ENSG00000236980","3",49177632,49191858,14226
"29653","ENSG00000236985","20",16857962,16864148,6186
"29654","ENSG00000236986","9",131132852,131167505,34653
"29655","ENSG00000236988","X",100149783,100151340,1557
"29656","ENSG00000236989","2",16085222,16105841,20619
"29657","ENSG00000236990","10",4051726,4089013,37287
"29658","ENSG00000236991","10",125725634,125752110,26476
"29659","ENSG00000236992","20",19823443,19823943,500
"29660","ENSG00000236993","10",55667341,55668350,1009
"29661","ENSG00000236996","6",53998890,54007152,8262
"29662","ENSG00000236998","9",68788307,68789670,1363
"29663","ENSG00000236999","3",10566255,10570375,4120
"29664","ENSG00000237001","13",26606544,26641793,35249
"29665","ENSG00000237002","10",36438616,36442392,3776
"29666","ENSG00000237003","1",93190740,93191060,320
"29667","ENSG00000237004","7",32728569,32753744,25175
"29668","ENSG00000237007","2",31822591,31823436,845
"29669","ENSG00000237008","1",153379821,153380799,978
"29670","ENSG00000237009","9",3898642,3901248,2606
"29671","ENSG00000237014","X",73237647,73238709,1062
"29672","ENSG00000237015","22",29260889,29262037,1148
"29673","ENSG00000237017","19",54119511,54125343,5832
"29674","ENSG00000237019","X",22698457,22768966,70509
"29675","ENSG00000237020","14",105891191,105891207,16
"29676","ENSG00000237023","Y",21661926,21674008,12082
"29677","ENSG00000237024","2",60852260,60852743,483
"29678","ENSG00000237025","X",123878590,123879296,706
"29679","ENSG00000237026","7",65235790,65236723,933
"29680","ENSG00000237027","6",89560875,89567044,6169
"29681","ENSG00000237031","2",80572681,80618777,46096
"29682","ENSG00000237032","10",14723171,14724055,884
"29683","ENSG00000237035","2",198187802,198191521,3719
"29684","ENSG00000237036","10",31206278,31320447,114169
"29685","ENSG00000237037","22",42090931,42137742,46811
"29686","ENSG00000237039","2",231256097,231256306,209
"29687","ENSG00000237040","X",155875636,155875885,249
"29688","ENSG00000237041","2",206040432,206040845,413
"29689","ENSG00000237042","6",29812565,29812696,131
"29690","ENSG00000237048","Y",7803996,7810683,6687
"29691","ENSG00000237049","1",168210616,168210969,353
"29692","ENSG00000237053","2",176804987,176806337,1350
"29693","ENSG00000237054","14",22918947,22926900,7953
"29694","ENSG00000237055","2",94899566,94900661,1095
"29695","ENSG00000237057","17",15806241,15847996,41755
"29696","ENSG00000237058","1",2632568,2636620,4052
"29697","ENSG00000237061","8",73083787,73085879,2092
"29698","ENSG00000237062","9",106615078,106615983,905
"29699","ENSG00000237063","20",36086252,36088192,1940
"29700","ENSG00000237065","7",29212302,29213214,912
"29701","ENSG00000237068","20",45490818,45491671,853
"29702","ENSG00000237070","7",15667947,15681980,14033
"29703","ENSG00000237073","9",113570190,113590019,19829
"29704","ENSG00000237074","1",207240122,207309292,69170
"29705","ENSG00000237076","1",83790280,83801465,11185
"29706","ENSG00000237077","2",77788382,77793087,4705
"29707","ENSG00000237080","6",31877808,31884204,6396
"29708","ENSG00000237082","13",100623875,100624429,554
"29709","ENSG00000237085","2",91859384,91859481,97
"29710","ENSG00000237087","2",232420661,232421461,800
"29711","ENSG00000237088","9",20532552,20533339,787
"29712","ENSG00000237089","X",75537547,75538702,1155
"29713","ENSG00000237090","1",42891094,42892430,1336
"29714","ENSG00000237092","13",53099397,53151914,52517
"29715","ENSG00000237094","1",365389,522928,157539
"29716","ENSG00000237101","1",224219613,224228043,8430
"29717","ENSG00000237107","6",42499710,42500022,312
"29718","ENSG00000237109","13",78761175,78761651,476
"29719","ENSG00000237110","6",132538290,132539336,1046
"29720","ENSG00000237111","14",105863416,105863465,49
"29721","ENSG00000237115","6",131825981,131828413,2432
"29722","ENSG00000237118","19",40818414,40826772,8358
"29723","ENSG00000237119","20",63038011,63053863,15852
"29724","ENSG00000237121","20",58740532,58783821,43289
"29725","ENSG00000237124","9",109300186,109301172,986
"29726","ENSG00000237125","4",173527270,173659696,132426
"29727","ENSG00000237126","2",232580948,232611971,31023
"29728","ENSG00000237128","10",28433008,28495813,62805
"29729","ENSG00000237129","22",36175857,36176526,669
"29730","ENSG00000237130","1",50846468,50846837,369
"29731","ENSG00000237133","2",33555047,33563547,8500
"29732","ENSG00000237135","10",30919012,30921235,2223
"29733","ENSG00000237136","4",145680115,145771032,90917
"29734","ENSG00000237139","10",73537803,73538391,588
"29735","ENSG00000237140","16",26062750,26063097,347
"29736","ENSG00000237149","10",75401519,75408982,7463
"29737","ENSG00000237153","9",16917511,17114122,196611
"29738","ENSG00000237154","6",27407697,27407996,299
"29739","ENSG00000237158","9",6568844,6569360,516
"29740","ENSG00000237159","9",34568012,34583072,15060
"29741","ENSG00000237161","15",21293653,21295201,1548
"29742","ENSG00000237162","2",62939916,62940282,366
"29743","ENSG00000237163","1",62905180,62905482,302
"29744","ENSG00000237166","2",200711535,200735186,23651
"29745","ENSG00000237167","3",197458405,197467105,8700
"29746","ENSG00000237169","10",97309138,97309958,820
"29747","ENSG00000237170","4",4507078,4507777,699
"29748","ENSG00000237172","16",67148104,67150998,2894
"29749","ENSG00000237174","6",75357214,75399300,42086
"29750","ENSG00000237175","13",22099163,22099544,381
"29751","ENSG00000237176","12",59812102,59812576,474
"29752","ENSG00000237178","2",177344443,177344836,393
"29753","ENSG00000237179","2",66696190,66703252,7062
"29754","ENSG00000237180","1",48089368,48089634,266
"29755","ENSG00000237181","7",603185,608482,5297
"29756","ENSG00000237185","16",31648307,31649222,915
"29757","ENSG00000237186","3",57530345,57530967,622
"29758","ENSG00000237187","5",93360779,93585649,224870
"29759","ENSG00000237188","1",147172755,147295734,122979
"29760","ENSG00000237190","5",134402065,134411881,9816
"29761","ENSG00000237194","2",209808804,209809580,776
"29762","ENSG00000237200","1",22517474,22519708,2234
"29763","ENSG00000237205","10",88618223,88618934,711
"29764","ENSG00000237206","X",43278125,43279658,1533
"29765","ENSG00000237207","9",41974362,41975768,1406
"29766","ENSG00000237208","X",126109762,126115562,5800
"29767","ENSG00000237210","7",55244247,55245681,1434
"29768","ENSG00000237211","X",84755136,84756003,867
"29769","ENSG00000237212","9",96065740,96101912,36172
"29770","ENSG00000237214","22",41064052,41064633,581
"29771","ENSG00000237217","2",64450096,64450524,428
"29772","ENSG00000237220","2",150566134,150568080,1946
"29773","ENSG00000237221","X",18688643,18691604,2961
"29774","ENSG00000237222","3",194708093,194826008,117915
"29775","ENSG00000237223","2",108322238,108353799,31561
"29776","ENSG00000237224","10",129693722,129702117,8395
"29777","ENSG00000237226","11",3549745,3550519,774
"29778","ENSG00000237227","1",62208136,62208442,306
"29779","ENSG00000237232","21",42009194,42055130,45936
"29780","ENSG00000237233","10",61452639,61481956,29317
"29781","ENSG00000237234","6",112154765,112166476,11711
"29782","ENSG00000237238","9",63299453,63385117,85664
"29783","ENSG00000237243","7",137953348,137957966,4618
"29784","ENSG00000237248","12",9240003,9257960,17957
"29785","ENSG00000237249","1",174892417,174893155,738
"29786","ENSG00000237250","1",237862175,237928321,66146
"29787","ENSG00000237254","7",142812586,142813399,813
"29788","ENSG00000237257","9",78741720,78742744,1024
"29789","ENSG00000237259","20",18313765,18315111,1346
"29790","ENSG00000237260","2",176338637,176339077,440
"29791","ENSG00000237261","2",14530941,14531223,282
"29792","ENSG00000237263","13",42068932,42071093,2161
"29793","ENSG00000237264","8",81521682,81522232,550
"29794","ENSG00000237265","X",71662998,71666767,3769
"29795","ENSG00000237266","2",5810641,5812670,2029
"29796","ENSG00000237267","10",85193421,85197958,4537
"29797","ENSG00000237268","7",56421857,56448375,26518
"29798","ENSG00000237271","2",204219984,204234985,15001
"29799","ENSG00000237272","11",4418060,4419011,951
"29800","ENSG00000237273","19",12096424,12096915,491
"29801","ENSG00000237274","9",6195934,6197248,1314
"29802","ENSG00000237276","1",16215909,16228027,12118
"29803","ENSG00000237279","1",52943536,52943930,394
"29804","ENSG00000237280","10",87113954,87115523,1569
"29805","ENSG00000237281","2",218326889,218357966,31077
"29806","ENSG00000237282","20",18379049,18381484,2435
"29807","ENSG00000237283","1",188705623,188732208,26585
"29808","ENSG00000237285","6",32325219,32326178,959
"29809","ENSG00000237286","7",2944035,2947091,3056
"29810","ENSG00000237289","15",43593054,43604901,11847
"29811","ENSG00000237290","1",38209034,38214806,5772
"29812","ENSG00000237292","1",181174484,181182208,7724
"29813","ENSG00000237293","2",75474453,75482579,8126
"29814","ENSG00000237294","X",66074835,66076347,1512
"29815","ENSG00000237296","16",22437008,22492220,55212
"29816","ENSG00000237297","10",44712,46884,2172
"29817","ENSG00000237298","2",178521183,178779963,258780
"29818","ENSG00000237299","22",15541436,15578006,36570
"29819","ENSG00000237300","X",102796251,102797093,842
"29820","ENSG00000237301","1",15586136,15603626,17490
"29821","ENSG00000237303","12",11481383,11481656,273
"29822","ENSG00000237306","9",92027498,92027824,326
"29823","ENSG00000237307","X",136976417,136985705,9288
"29824","ENSG00000237308","2",95496022,95496531,509
"29825","ENSG00000237309","7",57186412,57187441,1029
"29826","ENSG00000237310","7",66493607,66495758,2151
"29827","ENSG00000237311","X",65925836,66001436,75600
"29828","ENSG00000237312","6",153304595,153427154,122559
"29829","ENSG00000237317","1",174367105,174368039,934
"29830","ENSG00000237319","X",109636834,109637063,229
"29831","ENSG00000237320","2",34998273,35000160,1887
"29832","ENSG00000237321","6",123823240,123829285,6045
"29833","ENSG00000237322","2",228753324,228753786,462
"29834","ENSG00000237323","19",54652085,54652230,145
"29835","ENSG00000237324","1",74341579,74378802,37223
"29836","ENSG00000237325","21",31452466,31453223,757
"29837","ENSG00000237326","2",15801747,15810877,9130
"29838","ENSG00000237327","2",158127957,158133988,6031
"29839","ENSG00000237328","17",17759154,17770821,11667
"29840","ENSG00000237329","1",31036734,31037240,506
"29841","ENSG00000237330","1",1070967,1074306,3339
"29842","ENSG00000237331","X",123872626,123873932,1306
"29843","ENSG00000237336","9",123491884,123493156,1272
"29844","ENSG00000237337","1",50174306,50175868,1562
"29845","ENSG00000237338","21",46151614,46152647,1033
"29846","ENSG00000237339","9",135574935,135587112,12177
"29847","ENSG00000237341","X",49198966,49202454,3488
"29848","ENSG00000237343","1",144418113,144419192,1079
"29849","ENSG00000237346","6",14391094,14393929,2835
"29850","ENSG00000237347","22",19055801,19056512,711
"29851","ENSG00000237349","1",108986963,108987245,282
"29852","ENSG00000237350","4",22727375,22727950,575
"29853","ENSG00000237351","X",47156638,47158199,1561
"29854","ENSG00000237352","1",58933643,59240555,306912
"29855","ENSG00000237353","11",125833316,125840069,6753
"29856","ENSG00000237356","14",53169010,53883740,714730
"29857","ENSG00000237357","9",42566679,42569353,2674
"29858","ENSG00000237358","22",16876552,16876902,350
"29859","ENSG00000237359","9",3630947,3648390,17443
"29860","ENSG00000237360","9",108097432,108097851,419
"29861","ENSG00000237361","13",44400250,44405984,5734
"29862","ENSG00000237365","1",7008376,7014279,5903
"29863","ENSG00000237370","2",3603397,3604242,845
"29864","ENSG00000237371","20",64056803,64057084,281
"29865","ENSG00000237372","9",89639814,89719759,79945
"29866","ENSG00000237373","21",39217093,39219805,2712
"29867","ENSG00000237377","17",15276562,15279477,2915
"29868","ENSG00000237378","13",63746741,63751080,4339
"29869","ENSG00000237379","1",203954640,203955780,1140
"29870","ENSG00000237380","2",176121611,176137098,15487
"29871","ENSG00000237381","X",93388075,93389497,1422
"29872","ENSG00000237382","17",18312760,18313533,773
"29873","ENSG00000237383","2",94725674,94725935,261
"29874","ENSG00000237385","9",93430342,93431299,957
"29875","ENSG00000237387","22",25580241,25581382,1141
"29876","ENSG00000237389","10",43630882,43631564,682
"29877","ENSG00000237390","1",156388226,156395609,7383
"29878","ENSG00000237396","20",22587522,22607517,19995
"29879","ENSG00000237398","6",33131216,33143325,12109
"29880","ENSG00000237399","10",3141632,3167972,26340
"29881","ENSG00000237400","7",36463023,36504513,41490
"29882","ENSG00000237401","2",3957652,3974124,16472
"29883","ENSG00000237402","1",7368942,7370270,1328
"29884","ENSG00000237406","22",35897270,35898404,1134
"29885","ENSG00000237409","1",160020300,160020727,427
"29886","ENSG00000237410","11",64646399,64659681,13282
"29887","ENSG00000237412","2",232520463,232525716,5253
"29888","ENSG00000237413","1",78229599,78369464,139865
"29889","ENSG00000237414","9",23894990,23898054,3064
"29890","ENSG00000237415","1",110848077,110848941,864
"29891","ENSG00000237417","10",93206857,93209627,2770
"29892","ENSG00000237418","3",196298061,196298215,154
"29893","ENSG00000237419","9",138199933,138203325,3392
"29894","ENSG00000237422","9",91077138,91163087,85949
"29895","ENSG00000237423","20",47979102,47990127,11025
"29896","ENSG00000237424","1",47432133,47434641,2508
"29897","ENSG00000237425","6",28732017,28732904,887
"29898","ENSG00000237426","X",124173001,124174459,1458
"29899","ENSG00000237427","Y",21130870,21131181,311
"29900","ENSG00000237428","22",22366210,22367770,1560
"29901","ENSG00000237429","1",27525805,27530561,4756
"29902","ENSG00000237433","3",32190747,32191627,880
"29903","ENSG00000237434","9",20331446,20332277,831
"29904","ENSG00000237435","1",95937901,96022890,84989
"29905","ENSG00000237436","1",6783892,6784843,951
"29906","ENSG00000237437","9",32945996,32947222,1226
"29907","ENSG00000237438","22",17036570,17060825,24255
"29908","ENSG00000237439","22",32129689,32130612,923
"29909","ENSG00000237440","19",20535825,20565809,29984
"29910","ENSG00000237441","6",33291654,33298942,7288
"29911","ENSG00000237442","2",41143780,41157555,13775
"29912","ENSG00000237445","1",13657311,13659910,2599
"29913","ENSG00000237446","22",18019214,18020200,986
"29914","ENSG00000237447","Y",10190377,10192298,1921
"29915","ENSG00000237450","14",34485979,34486447,468
"29916","ENSG00000237451","9",62844818,62845184,366
"29917","ENSG00000237452","19",45733251,45764534,31283
"29918","ENSG00000237453","1",54792885,54794905,2020
"29919","ENSG00000237456","3",62124204,62124608,404
"29920","ENSG00000237457","1",190478551,190480735,2184
"29921","ENSG00000237458","X",118128748,118129018,270
"29922","ENSG00000237460","1",106818224,106865316,47092
"29923","ENSG00000237461","9",99396987,99819921,422934
"29924","ENSG00000237463","1",165476838,165582155,105317
"29925","ENSG00000237464","20",45487613,45490248,2635
"29926","ENSG00000237468","6",146594516,146598931,4415
"29927","ENSG00000237470","10",15015370,15021863,6493
"29928","ENSG00000237471","7",45940449,45986472,46023
"29929","ENSG00000237472","22",22988263,22988581,318
"29930","ENSG00000237473","3",173153737,173336965,183228
"29931","ENSG00000237475","X",73535503,73536241,738
"29932","ENSG00000237476","22",20957092,20964679,7587
"29933","ENSG00000237477","2",179273831,179285707,11876
"29934","ENSG00000237478","1",49691262,49691523,261
"29935","ENSG00000237479","2",216866332,216867813,1481
"29936","ENSG00000237480","1",105956694,106124564,167870
"29937","ENSG00000237481","1",229319403,229323087,3684
"29938","ENSG00000237483","3",172225428,172225872,444
"29939","ENSG00000237484","21",24306939,24547942,241003
"29940","ENSG00000237487","9",38504447,38505482,1035
"29941","ENSG00000237489","10",130020025,130110830,90805
"29942","ENSG00000237491","1",778747,810065,31318
"29943","ENSG00000237493","12",55980432,55981035,603
"29944","ENSG00000237494","6",142251847,142259632,7785
"29945","ENSG00000237499","6",137823673,137868233,44560
"29946","ENSG00000237500","10",2499721,2500570,849
"29947","ENSG00000237501","3",172830981,172831229,248
"29948","ENSG00000237505","1",87620803,88685204,1064401
"29949","ENSG00000237506","X",87703343,87704203,860
"29950","ENSG00000237510","2",95789654,95800166,10512
"29951","ENSG00000237512","10",71217224,71218228,1004
"29952","ENSG00000237513","7",104940943,105000713,59770
"29953","ENSG00000237515","16",12901598,13240416,338818
"29954","ENSG00000237517","22",18970514,18994628,24114
"29955","ENSG00000237520","1",234957231,234959989,2758
"29956","ENSG00000237521","19",9247344,9252625,5281
"29957","ENSG00000237522","2",60936819,60938049,1230
"29958","ENSG00000237523","10",80207372,80219657,12285
"29959","ENSG00000237524","2",126898864,126902097,3233
"29960","ENSG00000237525","2",215533133,215713895,180762
"29961","ENSG00000237529","9",83272280,83279499,7219
"29962","ENSG00000237530","6",44513262,44527448,14186
"29963","ENSG00000237531","X",990221,994365,4144
"29964","ENSG00000237539","X",15646167,15646875,708
"29965","ENSG00000237540","10",13159477,13159777,300
"29966","ENSG00000237541","6",32741342,32747215,5873
"29967","ENSG00000237542","2",202616700,202617212,512
"29968","ENSG00000237547","14",105864793,105864852,59
"29969","ENSG00000237548","9",121884636,121963719,79083
"29970","ENSG00000237550","15",82372196,82372912,716
"29971","ENSG00000237551","7",96283357,96283804,447
"29972","ENSG00000237552","1",76758124,76779267,21143
"29973","ENSG00000237553","9",5193339,5193558,219
"29974","ENSG00000237555","20",43388642,43389041,399
"29975","ENSG00000237556","1",111909336,111910931,1595
"29976","ENSG00000237557","9",38643042,38643768,726
"29977","ENSG00000237560","17",69961568,69994845,33277
"29978","ENSG00000237567","6",105612667,105632296,19629
"29979","ENSG00000237569","21",23407658,23409128,1470
"29980","ENSG00000237571","2",215274992,215277947,2955
"29981","ENSG00000237572","7",63209219,63211822,2603
"29982","ENSG00000237574","2",129923177,129946703,23526
"29983","ENSG00000237575","17",28226563,28228065,1502
"29984","ENSG00000237576","2",68832014,68837726,5712
"29985","ENSG00000237579","10",101176306,101194147,17841
"29986","ENSG00000237581","2",233946146,233955435,9289
"29987","ENSG00000237583","2",111675026,111675343,317
"29988","ENSG00000237584","X",137441258,137441836,578
"29989","ENSG00000237585","13",44651812,44701016,49204
"29990","ENSG00000237586","8",124301315,124301804,489
"29991","ENSG00000237588","1",156687695,156691997,4302
"29992","ENSG00000237590","10",44259602,44261813,2211
"29993","ENSG00000237592","10",42185339,42185791,452
"29994","ENSG00000237593","6",154216931,154217489,558
"29995","ENSG00000237594","21",31559245,31560487,1242
"29996","ENSG00000237595","20",50162765,50166216,3451
"29997","ENSG00000237596","6",135991936,136225751,233815
"29998","ENSG00000237603","3",26216322,26216877,555
"29999","ENSG00000237604","21",44175489,44176453,964
"30000","ENSG00000237605","1",206634196,206635714,1518
"30001","ENSG00000237606","7",104826336,104826796,460
"30002","ENSG00000237609","21",39028536,39029128,592
"30003","ENSG00000237611","5",7239781,7240018,237
"30004","ENSG00000237612","11",131234538,131251816,17278
"30005","ENSG00000237614","2",120542905,120545249,2344
"30006","ENSG00000237620","7",77461458,77462139,681
"30007","ENSG00000237621","7",141887148,141888092,944
"30008","ENSG00000237622","1",68375327,68375663,336
"30009","ENSG00000237624","1",39514956,39516490,1534
"30010","ENSG00000237626","9",89825964,90019549,193585
"30011","ENSG00000237628","X",102797531,102798128,597
"30012","ENSG00000237629","2",25994794,25995081,287
"30013","ENSG00000237630","2",127170011,127170231,220
"30014","ENSG00000237631","9",95918136,95918704,568
"30015","ENSG00000237632","7",103262000,103262311,311
"30016","ENSG00000237633","2",16523176,16555564,32388
"30017","ENSG00000237636","13",19290593,19344825,54232
"30018","ENSG00000237637","13",32025314,32031639,6325
"30019","ENSG00000237638","2",64901840,65056168,154328
"30020","ENSG00000237639","7",57650521,57650854,333
"30021","ENSG00000237640","7",99929392,99948620,19228
"30022","ENSG00000237641","2",231789481,231789887,406
"30023","ENSG00000237642","10",110450629,110451240,611
"30024","ENSG00000237643","6",70394881,70403117,8236
"30025","ENSG00000237645","3",173644231,173644711,480
"30026","ENSG00000237646","21",36803984,36806284,2300
"30027","ENSG00000237649","6",33391823,33409896,18073
"30028","ENSG00000237650","X",131204068,131205010,942
"30029","ENSG00000237651","2",61145068,61164829,19761
"30030","ENSG00000237654","11",131502735,131540867,38132
"30031","ENSG00000237661","X",40831844,40832562,718
"30032","ENSG00000237662","20",33187391,33188292,901
"30033","ENSG00000237663","1",52252062,52252773,711
"30034","ENSG00000237664","21",45338590,45341990,3400
"30035","ENSG00000237667","2",779840,868608,88768
"30036","ENSG00000237668","22",36421273,36421644,371
"30037","ENSG00000237669","6",30006121,30007116,995
"30038","ENSG00000237672","13",20070250,20072136,1886
"30039","ENSG00000237674","6",52739590,52744656,5066
"30040","ENSG00000237675","10",125574371,125578445,4074
"30041","ENSG00000237676","3",32635222,32635554,332
"30042","ENSG00000237679","9",94287699,94288550,851
"30043","ENSG00000237682","X",101537485,101539276,1791
"30044","ENSG00000237684","4",117413462,117414279,817
"30045","ENSG00000237685","6",10511036,10514546,3510
"30046","ENSG00000237686","6",43995723,44074652,78929
"30047","ENSG00000237687","20",62695024,62700480,5456
"30048","ENSG00000237689","22",16869478,16871126,1648
"30049","ENSG00000237691","9",21420234,21420813,579
"30050","ENSG00000237693","5",150846523,150900736,54213
"30051","ENSG00000237699","13",113877608,113879376,1768
"30052","ENSG00000237700","1",13303539,13308907,5368
"30053","ENSG00000237702","7",142308542,142309048,506
"30054","ENSG00000237704","8",99340305,99341761,1456
"30055","ENSG00000237705","5",56842016,56862164,20148
"30056","ENSG00000237706","11",89981441,89989559,8118
"30057","ENSG00000237707","1",169104124,169104907,783
"30058","ENSG00000237708","X",57068914,57069685,771
"30059","ENSG00000237709","7",88639014,88640416,1402
"30060","ENSG00000237711","9",5100236,5101009,773
"30061","ENSG00000237713","7",13339201,13365049,25848
"30062","ENSG00000237714","5",132184876,132192808,7932
"30063","ENSG00000237716","6",4185479,4188950,3471
"30064","ENSG00000237718","16",67614381,67616146,1765
"30065","ENSG00000237719","6",36091991,36092646,655
"30066","ENSG00000237720","2",2707368,2840512,133144
"30067","ENSG00000237728","1",7382487,7389754,7267
"30068","ENSG00000237729","7",93669826,93670077,251
"30069","ENSG00000237731","21",25643489,25644216,727
"30070","ENSG00000237732","2",222318275,222352989,34714
"30071","ENSG00000237734","9",27391734,27397563,5829
"30072","ENSG00000237735","21",16754519,16815688,61169
"30073","ENSG00000237737","2",74385474,74393882,8408
"30074","ENSG00000237738","7",5662432,5680461,18029
"30075","ENSG00000237740","10",87376896,87378481,1585
"30076","ENSG00000237742","6",125577545,125749190,171645
"30077","ENSG00000237743","9",87810642,87837225,26583
"30078","ENSG00000237745","2",107914948,107915286,338
"30079","ENSG00000237746","10",28338554,28340942,2388
"30080","ENSG00000237748","X",56737242,56737577,335
"30081","ENSG00000237749","1",37556247,37556499,252
"30082","ENSG00000237750","2",162768936,162797972,29036
"30083","ENSG00000237751","2",70887871,70889959,2088
"30084","ENSG00000237753","2",112641832,112645720,3888
"30085","ENSG00000237754","7",68241637,68242267,630
"30086","ENSG00000237756","1",163259850,163260659,809
"30087","ENSG00000237757","X",120210461,120212680,2219
"30088","ENSG00000237758","2",230725143,230725403,260
"30089","ENSG00000237759","1",244107365,244109011,1646
"30090","ENSG00000237760","7",46302120,46343621,41501
"30091","ENSG00000237761","10",104566931,104624795,57864
"30092","ENSG00000237763","1",103655290,103664554,9264
"30093","ENSG00000237765","4",15681662,15705565,23903
"30094","ENSG00000237766","12",67265842,67266966,1124
"30095","ENSG00000237767","20",40004216,40011323,7107
"30096","ENSG00000237768","10",73071295,73074008,2713
"30097","ENSG00000237770","9",81966564,81972130,5566
"30098","ENSG00000237772","2",138601599,138617469,15870
"30099","ENSG00000237773","7",16970320,17299368,329048
"30100","ENSG00000237774","12",95125760,95126389,629
"30101","ENSG00000237775","6",30866982,30875918,8936
"30102","ENSG00000237781","1",150548562,150557724,9162
"30103","ENSG00000237783","1",165581613,165582476,863
"30104","ENSG00000237784","2",234329483,234329838,355
"30105","ENSG00000237786","6",13486294,13486852,558
"30106","ENSG00000237787","3",153431856,153502697,70841
"30107","ENSG00000237788","20",49829125,49831085,1960
"30108","ENSG00000237790","2",34067226,34069550,2324
"30109","ENSG00000237793","X",153662162,153662692,530
"30110","ENSG00000237797","10",31693084,31707388,14304
"30111","ENSG00000237798","2",174575227,174587726,12499
"30112","ENSG00000237799","7",55736779,55739605,2826
"30113","ENSG00000237803","2",37820498,37876274,55776
"30114","ENSG00000237804","2",174310015,174310974,959
"30115","ENSG00000237806","3",181242345,181242901,556
"30116","ENSG00000237807","8",53493523,53524336,30813
"30117","ENSG00000237813","7",116238260,116499465,261205
"30118","ENSG00000237816","13",71704181,71704655,474
"30119","ENSG00000237818","7",97898347,97899115,768
"30120","ENSG00000237819","7",92836483,92917187,80704
"30121","ENSG00000237821","7",133169416,133170514,1098
"30122","ENSG00000237827","10",103125017,103125416,399
"30123","ENSG00000237828","X",120868611,120869807,1196
"30124","ENSG00000237832","20",14933843,14935363,1520
"30125","ENSG00000237836","X",18890296,18894974,4678
"30126","ENSG00000237837","2",97301729,97304151,2422
"30127","ENSG00000237838","3",24687919,25174305,486386
"30128","ENSG00000237840","10",45706431,45727231,20800
"30129","ENSG00000237842","1",157059232,157060762,1530
"30130","ENSG00000237843","2",204473834,204507672,33838
"30131","ENSG00000237844","2",163743913,164352223,608310
"30132","ENSG00000237845","1",235942553,235943805,1252
"30133","ENSG00000237846","9",40105822,40106527,705
"30134","ENSG00000237848","1",204394541,204394774,233
"30135","ENSG00000237849","13",63975451,63976422,971
"30136","ENSG00000237850","15",28349051,28358080,9029
"30137","ENSG00000237851","6",142788123,142794086,5963
"30138","ENSG00000237852","1",65486406,65494188,7782
"30139","ENSG00000237853","1",61248945,61253510,4565
"30140","ENSG00000237854","17",68101908,68115518,13610
"30141","ENSG00000237856","2",123065321,123067722,2401
"30142","ENSG00000237859","X",154908885,154919103,10218
"30143","ENSG00000237861","1",197222222,197223255,1033
"30144","ENSG00000237862","22",37352190,37355002,2812
"30145","ENSG00000237863","X",108736011,108739223,3212
"30146","ENSG00000237864","21",43322417,43332039,9622
"30147","ENSG00000237868","4",122077840,122078318,478
"30148","ENSG00000237870","7",116275606,116286734,11128
"30149","ENSG00000237872","1",155433178,155434262,1084
"30150","ENSG00000237874","6",83728055,83736525,8470
"30151","ENSG00000237877","2",186032884,186422432,389548
"30152","ENSG00000237879","13",30803206,30810645,7439
"30153","ENSG00000237880","2",107382715,107748270,365555
"30154","ENSG00000237882","10",75089248,75089725,477
"30155","ENSG00000237883","2",73947322,73981441,34119
"30156","ENSG00000237886","9",136546212,136549893,3681
"30157","ENSG00000237887","2",54529343,54529801,458
"30158","ENSG00000237888","17",43476198,43476665,467
"30159","ENSG00000237892","2",207120884,207122044,1160
"30160","ENSG00000237896","7",81175508,81199115,23607
"30161","ENSG00000237897","1",105890693,105891430,737
"30162","ENSG00000237899","1",40669089,40687588,18499
"30163","ENSG00000237903","X",119422917,119423547,630
"30164","ENSG00000237906","9",112959134,112962261,3127
"30165","ENSG00000237911","17",20415792,20416697,905
"30166","ENSG00000237914","20",1633508,1648472,14964
"30167","ENSG00000237916","2",109552536,109552846,310
"30168","ENSG00000237917","Y",26594851,26634652,39801
"30169","ENSG00000237919","1",70013982,70031222,17240
"30170","ENSG00000237921","7",19813685,19818090,4405
"30171","ENSG00000237922","1",236285976,236286960,984
"30172","ENSG00000237923","6",30839526,30848159,8633
"30173","ENSG00000237924","13",94760553,94761015,462
"30174","ENSG00000237926","X",51162864,51163677,813
"30175","ENSG00000237927","6",159586955,159589169,2214
"30176","ENSG00000237928","1",60912675,61056885,144210
"30177","ENSG00000237929","20",31311303,31311962,659
"30178","ENSG00000237930","2",216785774,216786144,370
"30179","ENSG00000237931","X",41076999,41077750,751
"30180","ENSG00000237934","1",29223933,29224816,883
"30181","ENSG00000237937","11",116639422,116658295,18873
"30182","ENSG00000237938","1",15720312,15736896,16584
"30183","ENSG00000237939","2",138307319,138307970,651
"30184","ENSG00000237940","2",241970683,241977276,6593
"30185","ENSG00000237941","11",2870033,2872105,2072
"30186","ENSG00000237943","10",6580419,6616921,36502
"30187","ENSG00000237945","21",33915534,33977691,62157
"30188","ENSG00000237947","6",40713411,40715363,1952
"30189","ENSG00000237948","22",36174261,36174822,561
"30190","ENSG00000237949","10",58999482,59066396,66914
"30191","ENSG00000237950","1",43937918,43946551,8633
"30192","ENSG00000237951","2",26162056,26162554,498
"30193","ENSG00000237952","13",22803296,22803648,352
"30194","ENSG00000237953","2",24968958,24969224,266
"30195","ENSG00000237954","1",95356229,95381000,24771
"30196","ENSG00000237955","19",54379489,54379960,471
"30197","ENSG00000237959","1",88577880,88578201,321
"30198","ENSG00000237961","4",49238032,49245419,7387
"30199","ENSG00000237963","X",65356890,65357547,657
"30200","ENSG00000237964","2",179399728,179400875,1147
"30201","ENSG00000237970","10",37337415,37338871,1456
"30202","ENSG00000237971","X",65185018,65187265,2247
"30203","ENSG00000237972","7",43918697,43920054,1357
"30204","ENSG00000237973","1",631074,632616,1542
"30205","ENSG00000237975","1",152168125,152445456,277331
"30206","ENSG00000237976","1",151346967,151348027,1060
"30207","ENSG00000237977","22",30902219,30902781,562
"30208","ENSG00000237978","3",178526505,178937352,410847
"30209","ENSG00000237979","2",65500993,65502138,1145
"30210","ENSG00000237980","1",212653305,212665638,12333
"30211","ENSG00000237982","3",38270283,38270767,484
"30212","ENSG00000237984","9",33673504,33677499,3995
"30213","ENSG00000237986","10",11071541,11105773,34232
"30214","ENSG00000237987","6",168225279,168226517,1238
"30215","ENSG00000237988","6",29550407,29557721,7314
"30216","ENSG00000237989","21",43358147,43362349,4202
"30217","ENSG00000237990","3",3039033,3069242,30209
"30218","ENSG00000237991","1",236981339,236981708,369
"30219","ENSG00000237992","2",19468997,19520095,51098
"30220","ENSG00000237993","1",116013813,116017705,3892
"30221","ENSG00000237994","X",28942050,28942568,518
"30222","ENSG00000237999","9",100731240,100732355,1115
"30223","ENSG00000238000","5",98213402,98214121,719
"30224","ENSG00000238001","9",32676063,32676520,457
"30225","ENSG00000238002","9",79863019,79866875,3856
"30226","ENSG00000238003","1",201978642,201978949,307
"30227","ENSG00000238004","2",154459857,154460820,963
"30228","ENSG00000238005","1",234957342,234970062,12720
"30229","ENSG00000238007","17",29012865,29016512,3647
"30230","ENSG00000238008","3",33554636,33554859,223
"30231","ENSG00000238009","1",89295,133723,44428
"30232","ENSG00000238012","2",64330481,64332801,2320
"30233","ENSG00000238013","3",46798123,46798390,267
"30234","ENSG00000238015","1",78666272,78666695,423
"30235","ENSG00000238018","2",54661011,54680045,19034
"30236","ENSG00000238020","3",184095118,184105178,10060
"30237","ENSG00000238021","10",27258762,27288824,30062
"30238","ENSG00000238022","1",165215951,165219104,3153
"30239","ENSG00000238024","6",29993209,29993605,396
"30240","ENSG00000238025","13",42933858,42934892,1034
"30241","ENSG00000238029","2",100425348,100426107,759
"30242","ENSG00000238035","5",181306502,181324685,18183
"30243","ENSG00000238038","2",33602041,33602286,245
"30244","ENSG00000238039","X",149511509,149526264,14755
"30245","ENSG00000238042","1",221880981,221978523,97542
"30246","ENSG00000238043","3",193980614,194006098,25484
"30247","ENSG00000238045","16",29808636,29821252,12616
"30248","ENSG00000238047","X",55180377,55181277,900
"30249","ENSG00000238048","11",72519986,72521733,1747
"30250","ENSG00000238049","X",103347462,103347729,267
"30251","ENSG00000238051","1",170211010,170211457,447
"30252","ENSG00000238054","1",188869474,188888540,19066
"30253","ENSG00000238055","6",108318079,108318404,325
"30254","ENSG00000238057","2",144517978,144521477,3499
"30255","ENSG00000238058","9",135907812,135916126,8314
"30256","ENSG00000238059","6",133510386,133510693,307
"30257","ENSG00000238061","1",185280844,185281816,972
"30258","ENSG00000238062","2",230984368,230996032,11664
"30259","ENSG00000238063","1",38474825,38516520,41695
"30260","ENSG00000238065","2",140898423,140899106,683
"30261","ENSG00000238072","7",129410113,129410370,257
"30262","ENSG00000238074","Y",9487313,9489893,2580
"30263","ENSG00000238076","6",10459906,10460541,635
"30264","ENSG00000238077","3",190166764,190167651,887
"30265","ENSG00000238078","1",220829255,220832429,3174
"30266","ENSG00000238079","6",108372772,108372927,155
"30267","ENSG00000238081","1",89289676,89290337,661
"30268","ENSG00000238082","2",178454716,178455428,712
"30269","ENSG00000238083","17",46511511,46555650,44139
"30270","ENSG00000238084","1",25398721,25399198,477
"30271","ENSG00000238085","1",240998451,240998794,343
"30272","ENSG00000238086","13",48316863,48320475,3612
"30273","ENSG00000238087","1",166566178,166580705,14527
"30274","ENSG00000238088","Y",18848264,18867280,19016
"30275","ENSG00000238090","7",33379964,33380886,922
"30276","ENSG00000238092","19",42781206,42786595,5389
"30277","ENSG00000238094","19",54607870,54608376,506
"30278","ENSG00000238097","3",194247638,194260720,13082
"30279","ENSG00000238098","16",2339150,2426699,87549
"30280","ENSG00000238099","6",139435636,139474658,39022
"30281","ENSG00000238102","20",7255053,7258323,3270
"30282","ENSG00000238103","X",23836742,23837321,579
"30283","ENSG00000238105","12",100156357,100173659,17302
"30284","ENSG00000238107","1",148295180,148297556,2376
"30285","ENSG00000238109","7",98998538,98999930,1392
"30286","ENSG00000238110","9",87944276,87945023,747
"30287","ENSG00000238111","2",23900693,23901149,456
"30288","ENSG00000238113","9",62801461,62813486,12025
"30289","ENSG00000238116","X",100801188,100803060,1872
"30290","ENSG00000238117","11",131877680,131897108,19428
"30291","ENSG00000238120","22",45604432,45605621,1189
"30292","ENSG00000238121","13",30340267,30377145,36878
"30293","ENSG00000238123","X",38801568,38803883,2315
"30294","ENSG00000238125","22",20652730,20654750,2020
"30295","ENSG00000238129","20",26188408,26196891,8483
"30296","ENSG00000238131","7",53926676,53947804,21128
"30297","ENSG00000238132","13",19563589,19564900,1311
"30298","ENSG00000238133","2",173166446,173282036,115590
"30299","ENSG00000238137","1",211442274,211442806,532
"30300","ENSG00000238139","1",67561073,67561446,373
"30301","ENSG00000238140","1",51461721,51463416,1695
"30302","ENSG00000238141","21",39315707,39323218,7511
"30303","ENSG00000238142","1",16887577,16889706,2129
"30304","ENSG00000238143","9",101125436,101125921,485
"30305","ENSG00000238145","1",46891639,46892830,1191
"30306","ENSG00000238149","11",28287235,28287625,390
"30307","ENSG00000238150","19",53775599,53775882,283
"30308","ENSG00000238151","20",30403123,30403384,261
"30309","ENSG00000238152","12",8414780,8415805,1025
"30310","ENSG00000238154","Y",9189629,9204611,14982
"30311","ENSG00000238156","6",75454944,75458900,3956
"30312","ENSG00000238158","6",3831933,3855737,23804
"30313","ENSG00000238160","5",132419416,132426714,7298
"30314","ENSG00000238161","11",3599595,3600706,1111
"30315","ENSG00000238164","1",2549920,2557031,7111
"30316","ENSG00000238165","2",50829442,50829678,236
"30317","ENSG00000238168","12",111581379,111581773,394
"30318","ENSG00000238169","13",25168969,25190643,21674
"30319","ENSG00000238171","2",181076051,181105968,29917
"30320","ENSG00000238172","9",100116755,100117651,896
"30321","ENSG00000238173","1",11232963,11233112,149
"30322","ENSG00000238176","10",36940109,36943932,3823
"30323","ENSG00000238178","X",16152941,16170869,17928
"30324","ENSG00000238180","2",128217588,128218072,484
"30325","ENSG00000238181","9",120720673,120721972,1299
"30326","ENSG00000238184","11",2328749,2377992,49243
"30327","ENSG00000238185","13",30973289,30977623,4334
"30328","ENSG00000238186","1",40515754,40517174,1420
"30329","ENSG00000238188","X",130645723,130646325,602
"30330","ENSG00000238189","13",43458465,43459484,1019
"30331","ENSG00000238193","X",5305714,5307128,1414
"30332","ENSG00000238194","20",59624904,59628295,3391
"30333","ENSG00000238195","22",27204211,27205126,915
"30334","ENSG00000238197","21",32728097,32747065,18968
"30335","ENSG00000238198","1",113011687,113073113,61426
"30336","ENSG00000238199","1",11278616,11279351,735
"30337","ENSG00000238201","2",64338067,64341647,3580
"30338","ENSG00000238202","7",117300861,117322236,21375
"30339","ENSG00000238205","X",40623566,40624136,570
"30340","ENSG00000238207","2",117754139,117804174,50035
"30341","ENSG00000238210","X",135252061,135253583,1522
"30342","ENSG00000238212","17",14834557,14957216,122659
"30343","ENSG00000238213","13",60274776,60276006,1230
"30344","ENSG00000238217","2",199608068,199750341,142273
"30345","ENSG00000238220","21",32624416,32625096,680
"30346","ENSG00000238221","6",7276031,7298872,22841
"30347","ENSG00000238222","X",40834485,40836005,1520
"30348","ENSG00000238224","1",245614773,245615145,372
"30349","ENSG00000238227","9",136114581,136118875,4294
"30350","ENSG00000238228","7",97946987,97947998,1011
"30351","ENSG00000238230","13",94698725,94708475,9750
"30352","ENSG00000238231","1",27990158,27990524,366
"30353","ENSG00000238232","1",219557192,219557701,509
"30354","ENSG00000238235","Y",6266593,6269275,2682
"30355","ENSG00000238236","1",235519971,235520685,714
"30356","ENSG00000238241","13",99404684,99417224,12540
"30357","ENSG00000238242","1",60114875,60149784,34909
"30358","ENSG00000238243","1",247895587,247896531,944
"30359","ENSG00000238245","9",62857208,62858484,1276
"30360","ENSG00000238246","10",20070805,20091784,20979
"30361","ENSG00000238247","X",27517884,27519759,1875
"30362","ENSG00000238249","1",8893409,8894151,742
"30363","ENSG00000238250","2",106822923,106825031,2108
"30364","ENSG00000238251","9",96407284,96407797,513
"30365","ENSG00000238257","21",30762682,30762882,200
"30366","ENSG00000238258","10",33211277,33213804,2527
"30367","ENSG00000238259","2",168231921,168232220,299
"30368","ENSG00000238260","1",3623190,3624743,1553
"30369","ENSG00000238262","11",132284302,132285081,779
"30370","ENSG00000238263","10",43630947,43631382,435
"30371","ENSG00000238265","21",21723293,21737319,14026
"30372","ENSG00000238266","10",6779549,6879450,99901
"30373","ENSG00000238267","3",39338129,39338879,750
"30374","ENSG00000238269","X",55075063,55078909,3846
"30375","ENSG00000238271","9",21455484,21456049,565
"30376","ENSG00000238272","1",173555251,173612772,57521
"30377","ENSG00000238273","2",105363038,105378839,15801
"30378","ENSG00000238275","14",106286811,106287657,846
"30379","ENSG00000238276","10",118241468,118267710,26242
"30380","ENSG00000238278","3",75415070,75422143,7073
"30381","ENSG00000238279","1",153533603,153535115,1512
"30382","ENSG00000238280","10",62682652,62805887,123235
"30383","ENSG00000238283","17",60008437,60017498,9061
"30384","ENSG00000238284","7",42661716,42706447,44731
"30385","ENSG00000238285","2",203315390,203315871,481
"30386","ENSG00000238286","13",20607268,20608131,863
"30387","ENSG00000238287","1",40493157,40508661,15504
"30388","ENSG00000238288","9",92110168,92110514,346
"30389","ENSG00000238290","1",8026738,8122702,95964
"30390","ENSG00000238295","2",177345858,177345961,103
"30391","ENSG00000238297","7",107999791,107999982,191
"30392","ENSG00000238300","9",33934296,33934376,80
"30393","ENSG00000238304","11",3781395,3781456,61
"30394","ENSG00000238311","15",65696833,65696936,103
"30395","ENSG00000238317","2",202293051,202293134,83
"30396","ENSG00000238324","7",102857450,102857755,305
"30397","ENSG00000238326","5",56000518,56000621,103
"30398","ENSG00000238344","14",20326450,20326526,76
"30399","ENSG00000238358","7",90119299,90122890,3591
"30400","ENSG00000238363","5",112161485,112161617,132
"30401","ENSG00000238364","19",10551033,10551092,59
"30402","ENSG00000238366","10",6245731,6245831,100
"30403","ENSG00000238370","12",589530,589589,59
"30404","ENSG00000238374","5",146245191,146245253,62
"30405","ENSG00000238386","6",70513294,70513356,62
"30406","ENSG00000238390","21",31664306,31664482,176
"30407","ENSG00000238391","7",74487428,74487540,112
"30408","ENSG00000238405","10",46807458,46807573,115
"30409","ENSG00000238406","9",128543916,128543977,61
"30410","ENSG00000238419","17",47259358,47259420,62
"30411","ENSG00000238420","6",107930088,107930182,94
"30412","ENSG00000238423","17",28720550,28720616,66
"30413","ENSG00000238431","7",57227001,57227066,65
"30414","ENSG00000238444","11",112032499,112032598,99
"30415","ENSG00000238446","10",71844735,71844794,59
"30416","ENSG00000238456","15",46660658,46660760,102
"30417","ENSG00000238482","1",24777873,24777979,106
"30418","ENSG00000238490","6",108060818,108060930,112
"30419","ENSG00000238498","22",42076058,42076161,103
"30420","ENSG00000238500","13",66630715,66630776,61
"30421","ENSG00000238516","17",28834722,28834822,100
"30422","ENSG00000238517","19",20399272,20399354,82
"30423","ENSG00000238558","9",132963732,132963793,61
"30424","ENSG00000238575","18",2555358,2555492,134
"30425","ENSG00000238590","7",128443449,128443510,61
"30426","ENSG00000238594","6",150164584,150164686,102
"30427","ENSG00000238606","X",38608215,38608276,61
"30428","ENSG00000238628","6",87720915,87721018,103
"30429","ENSG00000238645","16",53334562,53334664,102
"30430","ENSG00000238658","17",78066947,78067053,106
"30431","ENSG00000238685","16",12297197,12297323,126
"30432","ENSG00000238711","1",151439000,151439095,95
"30433","ENSG00000238713","4",145149537,145149649,112
"30434","ENSG00000238719","2",97913054,97913117,63
"30435","ENSG00000238724","11",114527129,114527232,103
"30436","ENSG00000238728","16",15010321,15010397,76
"30437","ENSG00000238735","2",20246326,20246387,61
"30438","ENSG00000238741","3",160514907,160515236,329
"30439","ENSG00000238745","5",138623479,138623582,103
"30440","ENSG00000238754","1",193057281,193057415,134
"30441","ENSG00000238755","3",153384934,153980186,595252
"30442","ENSG00000238777","20",59852667,59852728,61
"30443","ENSG00000238782","2",229606238,229606299,61
"30444","ENSG00000238793","17",40027542,40027645,103
"30445","ENSG00000238795","12",6967337,6967606,269
"30446","ENSG00000238797","4",39441665,39441764,99
"30447","ENSG00000238804","17",48956650,48956753,103
"30448","ENSG00000238812","2",236037250,236037311,61
"30449","ENSG00000238825","1",148388490,148388651,161
"30450","ENSG00000238829","2",201141904,201141966,62
"30451","ENSG00000238830","2",98840675,98840736,61
"30452","ENSG00000238832","7",107603363,107603507,144
"30453","ENSG00000238835","5",83064204,83064337,133
"30454","ENSG00000238837","3",182644214,182655880,11666
"30455","ENSG00000238840","10",4962436,4962568,132
"30456","ENSG00000238880","11",77566934,77566994,60
"30457","ENSG00000238886","9",33952769,33952850,81
"30458","ENSG00000238898","17",77920098,77920258,160
"30459","ENSG00000238902","3",192534009,192534112,103
"30460","ENSG00000238906","7",29912528,29912632,104
"30461","ENSG00000238908","20",40854119,40854229,110
"30462","ENSG00000238934","1",161141208,161141336,128
"30463","ENSG00000238959","3",73027808,73027873,65
"30464","ENSG00000238961","5",77080434,77080571,137
"30465","ENSG00000238962","2",10815485,10815546,61
"30466","ENSG00000238963","6",154905076,154905206,130
"30467","ENSG00000238965","11",111928400,111928508,108
"30468","ENSG00000238966","8",42043504,42043575,71
"30469","ENSG00000238987","6",14156462,14156523,61
"30470","ENSG00000238998","11",112977353,112977420,67
"30471","ENSG00000239002","12",6510222,6510551,329
"30472","ENSG00000239005","4",139436368,139436494,126
"30473","ENSG00000239021","7",130602795,130602913,118
"30474","ENSG00000239030","7",94712409,94712511,102
"30475","ENSG00000239035","15",57278570,57278673,103
"30476","ENSG00000239040","4",55412636,55412738,102
"30477","ENSG00000239041","2",172691299,172691402,103
"30478","ENSG00000239043","14",45110883,45110968,85
"30479","ENSG00000239078","8",9072455,9072516,61
"30480","ENSG00000239079","11",122726208,122726311,103
"30481","ENSG00000239082","12",121908103,121908163,60
"30482","ENSG00000239096","3",179614775,179614878,103
"30483","ENSG00000239102","9",8797135,8797194,59
"30484","ENSG00000239105","3",37573151,37573213,62
"30485","ENSG00000239112","5",9548836,9548905,69
"30486","ENSG00000239115","8",101307367,101307428,61
"30487","ENSG00000239118","16",70030346,70030422,76
"30488","ENSG00000239119","3",73593940,73594002,62
"30489","ENSG00000239122","3",195928589,195928775,186
"30490","ENSG00000239128","3",47250523,47250626,103
"30491","ENSG00000239129","17",29883006,29883109,103
"30492","ENSG00000239137","19",55167171,55167274,103
"30493","ENSG00000239143","2",85332895,85332996,101
"30494","ENSG00000239149","1",12507246,12507397,151
"30495","ENSG00000239151","15",89120779,89120840,61
"30496","ENSG00000239152","10",45856307,45856422,115
"30497","ENSG00000239153","11",115627082,115627185,103
"30498","ENSG00000239182","X",118738055,118738182,127
"30499","ENSG00000239183","9",92292461,92292593,132
"30500","ENSG00000239197","15",92417547,92417689,142
"30501","ENSG00000239198","8",28299683,28300566,883
"30502","ENSG00000239200","14",18692032,18692408,376
"30503","ENSG00000239201","12",92168400,92168877,477
"30504","ENSG00000239202","2",231645998,231646273,275
"30505","ENSG00000239203","17",16427474,16428719,1245
"30506","ENSG00000239205","3",165150006,165158062,8056
"30507","ENSG00000239207","3",138777832,138778810,978
"30508","ENSG00000239210","19",34533427,34534084,657
"30509","ENSG00000239211","8",101397636,101397933,297
"30510","ENSG00000239212","3",155657760,155658612,852
"30511","ENSG00000239213","3",136835345,136862618,27273
"30512","ENSG00000239215","12",123721246,123721639,393
"30513","ENSG00000239216","1",119000618,119001405,787
"30514","ENSG00000239218","8",38434347,38435664,1317
"30515","ENSG00000239219","3",169939353,169966734,27381
"30516","ENSG00000239221","17",16191832,16192151,319
"30517","ENSG00000239223","17",27274107,27274477,370
"30518","ENSG00000239224","14",102582888,102583177,289
"30519","ENSG00000239238","3",167888414,167888715,301
"30520","ENSG00000239246","17",62516321,62516767,446
"30521","ENSG00000239247","4",2316197,2316506,309
"30522","ENSG00000239249","22",28056153,28056453,300
"30523","ENSG00000239250","3",71827177,71827471,294
"30524","ENSG00000239254","7",139172516,139174266,1750
"30525","ENSG00000239256","17",29340482,29340822,340
"30526","ENSG00000239263","3",69471452,69472532,1080
"30527","ENSG00000239264","6",7881517,7910814,29297
"30528","ENSG00000239265","3",150852484,151080726,228242
"30529","ENSG00000239268","3",117672154,117997592,325438
"30530","ENSG00000239269","14",94726288,94727175,887
"30531","ENSG00000239272","14",77683202,77683989,787
"30532","ENSG00000239279","4",113419840,113420136,296
"30533","ENSG00000239280","3",113740823,113741254,431
"30534","ENSG00000239281","8",41271431,41271566,135
"30535","ENSG00000239282","22",30285117,30289627,4510
"30536","ENSG00000239291","17",47159191,47159993,802
"30537","ENSG00000239293","7",143047213,143047580,367
"30538","ENSG00000239300","2",9501466,9512413,10947
"30539","ENSG00000239305","2",86603398,86623866,20468
"30540","ENSG00000239306","11",66616582,66627347,10765
"30541","ENSG00000239311","3",111466313,111497095,30782
"30542","ENSG00000239316","6",89478141,89478433,292
"30543","ENSG00000239317","5",146138771,146139008,237
"30544","ENSG00000239322","2",70941817,70948610,6793
"30545","ENSG00000239323","14",31462795,31463371,576
"30546","ENSG00000239332","2",46816697,46859007,42310
"30547","ENSG00000239333","X",16539137,16539439,302
"30548","ENSG00000239335","12",66130751,66134449,3698
"30549","ENSG00000239344","8",103768281,103769029,748
"30550","ENSG00000239345","X",100855288,100856379,1091
"30551","ENSG00000239351","3",149938997,149939799,802
"30552","ENSG00000239354","11",111105547,111105895,348
"30553","ENSG00000239356","11",65695552,65695837,285
"30554","ENSG00000239365","14",104830838,104831171,333
"30555","ENSG00000239367","19",1570575,1570860,285
"30556","ENSG00000239374","12",116755395,116755874,479
"30557","ENSG00000239377","7",150379854,150383885,4031
"30558","ENSG00000239381","3",181534177,181700611,166434
"30559","ENSG00000239382","19",36009120,36014239,5119
"30560","ENSG00000239388","3",57268347,57292682,24335
"30561","ENSG00000239389","5",140882124,141012347,130223
"30562","ENSG00000239390","5",144140879,144141166,287
"30563","ENSG00000239392","9",34133157,34134696,1539
"30564","ENSG00000239393","5",177346073,177346426,353
"30565","ENSG00000239395","1",247711813,247723764,11951
"30566","ENSG00000239396","2",45569199,45569492,293
"30567","ENSG00000239397","12",46004038,46004685,647
"30568","ENSG00000239398","18",59972914,59973207,293
"30569","ENSG00000239402","2",130429827,130441413,11586
"30570","ENSG00000239405","3",128538020,128538631,611
"30571","ENSG00000239407","X",102884414,102906158,21744
"30572","ENSG00000239408","3",149464839,149465201,362
"30573","ENSG00000239413","12",101424441,101424691,250
"30574","ENSG00000239415","21",46251549,46254133,2584
"30575","ENSG00000239419","7",143290615,143290910,295
"30576","ENSG00000239428","1",171392229,171392790,561
"30577","ENSG00000239435","22",16575363,16582707,7344
"30578","ENSG00000239437","3",129591349,129591635,286
"30579","ENSG00000239440","3",81986138,82463675,477537
"30580","ENSG00000239443","3",155309427,155309807,380
"30581","ENSG00000239445","3",98706236,98732757,26521
"30582","ENSG00000239453","3",113588748,113590189,1441
"30583","ENSG00000239454","3",73999805,74005609,5804
"30584","ENSG00000239455","3",107104911,107107000,2089
"30585","ENSG00000239462","3",98902424,99018562,116138
"30586","ENSG00000239464","4",43598544,43598844,300
"30587","ENSG00000239465","15",64631109,64631914,805
"30588","ENSG00000239466","4",84687725,84688000,275
"30589","ENSG00000239467","2",170766878,170778729,11851
"30590","ENSG00000239468","7",148890226,148890513,287
"30591","ENSG00000239470","11",9660438,9660920,482
"30592","ENSG00000239472","6",5918564,5918844,280
"30593","ENSG00000239473","12",80028893,80029631,738
"30594","ENSG00000239474","2",169509702,169526258,16556
"30595","ENSG00000239480","7",102426818,102434780,7962
"30596","ENSG00000239482","3",112302478,112332791,30313
"30597","ENSG00000239483","3",128798841,128799201,360
"30598","ENSG00000239486","7",102380465,102382737,2272
"30599","ENSG00000239490","18",22586465,22587227,762
"30600","ENSG00000239494","1",169859756,169860052,296
"30601","ENSG00000239498","2",220105656,220450778,345122
"30602","ENSG00000239503","3",128748538,128749489,951
"30603","ENSG00000239504","1",88477828,88478114,286
"30604","ENSG00000239508","3",155449184,155457753,8569
"30605","ENSG00000239510","14",58564146,58564616,470
"30606","ENSG00000239511","22",21125660,21128063,2403
"30607","ENSG00000239513","3",137771660,137780882,9222
"30608","ENSG00000239517","5",74931662,74931817,155
"30609","ENSG00000239519","3",85992183,86028007,35824
"30610","ENSG00000239521","7",100200653,100272232,71579
"30611","ENSG00000239523","3",123585300,123644568,59268
"30612","ENSG00000239524","19",5277734,5278133,399
"30613","ENSG00000239525","4",83502699,83503034,335
"30614","ENSG00000239528","5",116562562,116562930,368
"30615","ENSG00000239532","4",37821361,37821838,477
"30616","ENSG00000239533","Y",24209567,24215581,6014
"30617","ENSG00000239542","17",41730127,41730405,278
"30618","ENSG00000239544","14",72963645,72964008,363
"30619","ENSG00000239545","4",55215624,55215919,295
"30620","ENSG00000239547","22",17352881,17353177,296
"30621","ENSG00000239552","17",48557262,48560333,3071
"30622","ENSG00000239553","11",66712720,66713009,289
"30623","ENSG00000239555","16",55291379,55291675,296
"30624","ENSG00000239556","7",43984995,43990207,5212
"30625","ENSG00000239557","3",52373652,52374882,1230
"30626","ENSG00000239559","11",67682772,67683058,286
"30627","ENSG00000239560","1",44117098,44117397,299
"30628","ENSG00000239569","7",105013425,105014321,896
"30629","ENSG00000239570","3",151269440,151270129,689
"30630","ENSG00000239571","2",89936859,89937679,820
"30631","ENSG00000239572","3",87641412,87793629,152217
"30632","ENSG00000239576","3",49758483,49758656,173
"30633","ENSG00000239577","X",72198712,72199050,338
"30634","ENSG00000239586","3",106901068,106901965,897
"30635","ENSG00000239589","3",94937980,95168351,230371
"30636","ENSG00000239590","9",122519141,122520082,941
"30637","ENSG00000239593","9",121279863,121282730,2867
"30638","ENSG00000239595","17",31465543,31465832,289
"30639","ENSG00000239600","11",115951105,115951491,386
"30640","ENSG00000239602","5",146137755,146138381,626
"30641","ENSG00000239605","2",47045538,47155308,109770
"30642","ENSG00000239608","3",128075810,128079056,3246
"30643","ENSG00000239614","3",93988634,93988946,312
"30644","ENSG00000239617","12",48903418,48903813,395
"30645","ENSG00000239620","3",127283784,127288046,4262
"30646","ENSG00000239622","7",25689580,25689959,379
"30647","ENSG00000239625","10",30366064,30366299,235
"30648","ENSG00000239626","6",73290403,73291262,859
"30649","ENSG00000239627","4",41389115,41389593,478
"30650","ENSG00000239628","3",170345678,170353961,8283
"30651","ENSG00000239632","3",106895729,106896408,679
"30652","ENSG00000239636","1",35569813,35577729,7916
"30653","ENSG00000239640","1",52714399,52714695,296
"30654","ENSG00000239641","3",142654784,142656745,1961
"30655","ENSG00000239642","5",131806990,131945698,138708
"30656","ENSG00000239648","7",141803701,141804652,951
"30657","ENSG00000239649","2",33722721,33728207,5486
"30658","ENSG00000239650","6",57919784,57930291,10507
"30659","ENSG00000239653","3",64004022,64012148,8126
"30660","ENSG00000239659","18",58631259,58632120,861
"30661","ENSG00000239665","10",13631143,13668445,37302
"30662","ENSG00000239670","1",32986952,32988233,1281
"30663","ENSG00000239671","17",42714299,42714643,344
"30664","ENSG00000239672","17",51153536,51162428,8892
"30665","ENSG00000239674","22",32141267,32143272,2005
"30666","ENSG00000239677","3",73621713,73626796,5083
"30667","ENSG00000239679","4",43863274,43863549,275
"30668","ENSG00000239683","18",35383354,35384025,671
"30669","ENSG00000239686","14",55282296,55282643,347
"30670","ENSG00000239690","1",234904186,234904488,302
"30671","ENSG00000239694","5",41951313,41952193,880
"30672","ENSG00000239696","7",7078302,7079742,1440
"30673","ENSG00000239697","17",7549058,7557890,8832
"30674","ENSG00000239699","3",80216261,80217234,973
"30675","ENSG00000239701","12",7032108,7032398,290
"30676","ENSG00000239702","17",44290856,44291151,295
"30677","ENSG00000239703","15",56029684,56029981,297
"30678","ENSG00000239704","17",15436015,15503608,67593
"30679","ENSG00000239705","9",125241663,125257071,15408
"30680","ENSG00000239706","3",156988117,156988712,595
"30681","ENSG00000239710","1",92974827,92975114,287
"30682","ENSG00000239713","22",39077067,39087743,10676
"30683","ENSG00000239715","7",174920,176013,1093
"30684","ENSG00000239716","3",157976561,157978136,1575
"30685","ENSG00000239718","3",149086332,149102823,16491
"30686","ENSG00000239719","7",149191043,149191223,180
"30687","ENSG00000239722","7",128693450,128693924,474
"30688","ENSG00000239726","11",118931216,118931490,274
"30689","ENSG00000239731","10",31992087,31992381,294
"30690","ENSG00000239732","3",52221080,52226163,5083
"30691","ENSG00000239736","19",41599735,41605984,6249
"30692","ENSG00000239739","3",170740351,170741365,1014
"30693","ENSG00000239742","20",50557682,50557998,316
"30694","ENSG00000239745","X",74390692,74390989,297
"30695","ENSG00000239748","18",70512727,70513008,281
"30696","ENSG00000239763","16",74312609,74313390,781
"30697","ENSG00000239767","3",86258936,86267424,8488
"30698","ENSG00000239774","3",180566718,180601935,35217
"30699","ENSG00000239779","2",74458400,74460891,2491
"30700","ENSG00000239780","18",50457887,50458795,908
"30701","ENSG00000239783","20",47071865,47072236,371
"30702","ENSG00000239789","7",55951877,55956500,4623
"30703","ENSG00000239791","16",30572039,30583860,11821
"30704","ENSG00000239793","4",78768499,78768750,251
"30705","ENSG00000239794","1",91829774,91830066,292
"30706","ENSG00000239797","3",145824257,145824739,482
"30707","ENSG00000239799","3",52823935,52825314,1379
"30708","ENSG00000239801","3",57628810,57654918,26108
"30709","ENSG00000239804","3",125787888,125788146,258
"30710","ENSG00000239805","3",181847526,181847885,359
"30711","ENSG00000239808","5",104260531,104260826,295
"30712","ENSG00000239809","17",62381668,62382015,347
"30713","ENSG00000239819","2",90220727,90221384,657
"30714","ENSG00000239820","14",67751228,67751544,316
"30715","ENSG00000239822","10",430239,430504,265
"30716","ENSG00000239823","17",64390158,64390263,105
"30717","ENSG00000239825","7",100906291,100906572,281
"30718","ENSG00000239827","13",40882577,40921774,39197
"30719","ENSG00000239828","3",107272611,107421338,148727
"30720","ENSG00000239830","19",9683294,9684073,779
"30721","ENSG00000239831","3",57519669,57520010,341
"30722","ENSG00000239835","3",120028740,120029868,1128
"30723","ENSG00000239839","8",7015869,7018297,2428
"30724","ENSG00000239840","16",47150132,47150566,434
"30725","ENSG00000239855","2",88966262,88966767,505
"30726","ENSG00000239856","11",86324012,86324309,297
"30727","ENSG00000239857","7",876554,896436,19882
"30728","ENSG00000239861","11",103045237,103045712,475
"30729","ENSG00000239862","2",89297264,89297785,521
"30730","ENSG00000239868","19",41286424,41286693,269
"30731","ENSG00000239873","1",119558755,119559774,1019
"30732","ENSG00000239877","3",118943073,118948241,5168
"30733","ENSG00000239880","3",180323107,180325059,1952
"30734","ENSG00000239881","12",120369440,120371688,2248
"30735","ENSG00000239883","10",45854093,45972154,118061
"30736","ENSG00000239884","17",2680958,2681236,278
"30737","ENSG00000239887","1",162378841,162386812,7971
"30738","ENSG00000239888","17",15408384,15408688,304
"30739","ENSG00000239893","Y",8068445,8126293,57848
"30740","ENSG00000239899","2",11584773,11585047,274
"30741","ENSG00000239900","22",40346500,40390463,43963
"30742","ENSG00000239906","1",139790,140339,549
"30743","ENSG00000239908","9",100102559,100102839,280
"30744","ENSG00000239910","14",74174456,74174753,297
"30745","ENSG00000239911","7",151877042,151879223,2181
"30746","ENSG00000239912","19",53413190,53413345,155
"30747","ENSG00000239917","8",117523271,117524061,790
"30748","ENSG00000239919","7",129477875,129478101,226
"30749","ENSG00000239920","11",5254392,5678434,424042
"30750","ENSG00000239921","3",127480690,127537817,57127
"30751","ENSG00000239922","3",147939905,148007127,67222
"30752","ENSG00000239923","20",14223041,14223325,284
"30753","ENSG00000239926","3",64174401,64175147,746
"30754","ENSG00000239930","21",42496539,42497443,904
"30755","ENSG00000239932","17",60696313,60696605,292
"30756","ENSG00000239941","3",152118173,152151724,33551
"30757","ENSG00000239942","10",67825310,67825600,290
"30758","ENSG00000239944","7",142386378,142386647,269
"30759","ENSG00000239946","3",114873114,114876514,3400
"30760","ENSG00000239948","19",43660500,43660776,276
"30761","ENSG00000239951","2",89142574,89143160,586
"30762","ENSG00000239953","6",37361185,37361483,298
"30763","ENSG00000239959","3",75446769,75491202,44433
"30764","ENSG00000239961","19",54333185,54339162,5977
"30765","ENSG00000239964","6",36522191,36522501,310
"30766","ENSG00000239967","7",144077721,144077825,104
"30767","ENSG00000239969","7",102364162,102380633,16471
"30768","ENSG00000239975","2",89913982,89916052,2070
"30769","ENSG00000239983","4",33968174,33968526,352
"30770","ENSG00000239988","19",32963499,32963865,366
"30771","ENSG00000239991","3",55166910,55175732,8822
"30772","ENSG00000239992","7",142681415,142681869,454
"30773","ENSG00000239994","3",119744139,119750350,6211
"30774","ENSG00000239995","2",48632856,48633353,497
"30775","ENSG00000239997","3",106848671,106849260,589
"30776","ENSG00000239998","19",54572920,54590287,17367
"30777","ENSG00000240002","3",114930541,114931449,908
"30778","ENSG00000240003","5",80500332,80501400,1068
"30779","ENSG00000240005","4",26859806,26860632,826
"30780","ENSG00000240006","3",134313576,134321171,7595
"30781","ENSG00000240012","3",143342246,143347071,4825
"30782","ENSG00000240014","4",147808926,147809209,283
"30783","ENSG00000240015","8",38123274,38124651,1377
"30784","ENSG00000240021","1",178513109,178548602,35493
"30785","ENSG00000240023","14",35388121,35389069,948
"30786","ENSG00000240024","3",183447608,183456013,8405
"30787","ENSG00000240027","12",63760358,63760612,254
"30788","ENSG00000240031","7",141862860,141863737,877
"30789","ENSG00000240032","3",146066344,146069185,2841
"30790","ENSG00000240033","3",166835021,166844956,9935
"30791","ENSG00000240034","3",106900593,106900855,262
"30792","ENSG00000240036","11",27581680,27582055,375
"30793","ENSG00000240038","1",103553815,103579534,25719
"30794","ENSG00000240040","2",88811186,88861563,50377
"30795","ENSG00000240045","3",155290227,155293683,3456
"30796","ENSG00000240047","8",74055882,74056647,765
"30797","ENSG00000240048","3",154352136,154354799,2663
"30798","ENSG00000240051","14",96456576,96457041,465
"30799","ENSG00000240053","6",31670167,31673776,3609
"30800","ENSG00000240057","3",113019468,113184377,164909
"30801","ENSG00000240058","5",122675795,122676755,960
"30802","ENSG00000240063","3",182783236,182793394,10158
"30803","ENSG00000240065","6",32844136,32859851,15715
"30804","ENSG00000240068","3",154023835,154024298,463
"30805","ENSG00000240074","17",29855759,29856332,573
"30806","ENSG00000240083","5",88381957,88382725,768
"30807","ENSG00000240086","3",135138469,135439888,301419
"30808","ENSG00000240087","12",68552995,68553882,887
"30809","ENSG00000240089","10",86992253,87000435,8182
"30810","ENSG00000240093","7",182935,194180,11245
"30811","ENSG00000240096","14",93223598,93224139,541
"30812","ENSG00000240097","3",60616822,60618079,1257
"30813","ENSG00000240098","11",126245035,126245282,247
"30814","ENSG00000240100","12",116908312,116908627,315
"30815","ENSG00000240103","17",22527324,22529570,2246
"30816","ENSG00000240106","19",16539688,16539984,296
"30817","ENSG00000240107","3",103538635,103540487,1852
"30818","ENSG00000240108","20",26103416,26114028,10612
"30819","ENSG00000240116","8",22977877,22978127,250
"30820","ENSG00000240122","22",16595089,16595485,396
"30821","ENSG00000240125","17",40439467,40439917,450
"30822","ENSG00000240128","3",169902980,169904260,1280
"30823","ENSG00000240131","14",23229961,23230116,155
"30824","ENSG00000240132","7",151501878,151503463,1585
"30825","ENSG00000240135","3",72876737,72878102,1365
"30826","ENSG00000240137","3",150703564,150723005,19441
"30827","ENSG00000240138","3",161324913,161326219,1306
"30828","ENSG00000240143","X",129794994,129796963,1969
"30829","ENSG00000240152","4",61143656,61153962,10306
"30830","ENSG00000240159","4",184254509,184255330,821
"30831","ENSG00000240160","22",23261782,23262071,289
"30832","ENSG00000240163","15",60390371,60390682,311
"30833","ENSG00000240167","4",42471810,42472380,570
"30834","ENSG00000240173","7",140645829,140646126,297
"30835","ENSG00000240174","11",84639993,84640565,572
"30836","ENSG00000240175","3",65893816,65925297,31481
"30837","ENSG00000240179","14",28489910,28490362,452
"30838","ENSG00000240183","2",111930175,111930467,292
"30839","ENSG00000240184","5",141475947,141512977,37030
"30840","ENSG00000240189","8",33580210,33580508,298
"30841","ENSG00000240194","1",110480752,110491277,10525
"30842","ENSG00000240198","3",56940040,56960854,20814
"30843","ENSG00000240199","16",75698531,75698816,285
"30844","ENSG00000240203","3",42676189,42676491,302
"30845","ENSG00000240204","7",129502531,129512918,10387
"30846","ENSG00000240205","12",115717725,115718013,288
"30847","ENSG00000240207","3",158732263,158784070,51807
"30848","ENSG00000240210","14",68338728,68339528,800
"30849","ENSG00000240211","7",100436204,100438504,2300
"30850","ENSG00000240216","3",149229356,149291800,62444
"30851","ENSG00000240219","1",204626775,204629712,2937
"30852","ENSG00000240224","2",233712992,233773299,60307
"30853","ENSG00000240225","19",56368099,56379828,11729
"30854","ENSG00000240230","7",898778,975549,76771
"30855","ENSG00000240231","19",23597341,23597592,251
"30856","ENSG00000240233","14",77547566,77547846,280
"30857","ENSG00000240235","9",99185587,99185866,279
"30858","ENSG00000240236","3",122317609,122318741,1132
"30859","ENSG00000240237","8",133002605,133003075,470
"30860","ENSG00000240238","15",59552615,59553093,478
"30861","ENSG00000240240","9",40223402,40329221,105819
"30862","ENSG00000240241","3",78266940,78294731,27791
"30863","ENSG00000240244","1",119596167,119597179,1012
"30864","ENSG00000240247","8",6996766,6999195,2429
"30865","ENSG00000240250","5",134517810,134518092,282
"30866","ENSG00000240253","2",130690133,130718831,28698
"30867","ENSG00000240254","3",119226486,119290666,64180
"30868","ENSG00000240255","3",87630301,87631619,1318
"30869","ENSG00000240268","7",142240740,142247067,6327
"30870","ENSG00000240270","17",80976454,80976948,494
"30871","ENSG00000240271","8",105011107,105011568,461
"30872","ENSG00000240280","17",63849292,63864379,15087
"30873","ENSG00000240286","2",209178804,209182018,3214
"30874","ENSG00000240288","3",10285754,10294903,9149
"30875","ENSG00000240291","10",18513115,18545651,32536
"30876","ENSG00000240294","10",24908522,24908812,290
"30877","ENSG00000240299","9",121494519,121494821,302
"30878","ENSG00000240302","2",199901081,199901377,296
"30879","ENSG00000240303","3",132558138,132660082,101944
"30880","ENSG00000240305","17",44719760,44720597,837
"30881","ENSG00000240306","9",26895678,26895970,292
"30882","ENSG00000240311","16",3496201,3496768,567
"30883","ENSG00000240317","2",219102434,219102719,285
"30884","ENSG00000240322","7",143298516,143298814,298
"30885","ENSG00000240328","12",19508904,19509245,341
"30886","ENSG00000240338","16",75226074,75228197,2123
"30887","ENSG00000240342","12",118246084,118246962,878
"30888","ENSG00000240344","2",200870907,200889303,18396
"30889","ENSG00000240350","2",111491273,111570974,79701
"30890","ENSG00000240354","3",161816909,161821908,4999
"30891","ENSG00000240356","2",113610502,113627090,16588
"30892","ENSG00000240366","15",75186651,75186968,317
"30893","ENSG00000240370","12",6873389,6884741,11352
"30894","ENSG00000240371","11",57576292,57577080,788
"30895","ENSG00000240373","3",169978536,169985715,7179
"30896","ENSG00000240374","1",35292196,35292498,302
"30897","ENSG00000240375","3",113919222,113920200,978
"30898","ENSG00000240376","5",33162179,33162807,628
"30899","ENSG00000240382","2",89117342,89117844,502
"30900","ENSG00000240385","11",4018948,4019118,170
"30901","ENSG00000240388","5",91354478,91354934,456
"30902","ENSG00000240392","14",35262462,35263036,574
"30903","ENSG00000240395","8",42341767,42342634,867
"30904","ENSG00000240399","12",48054813,48055591,778
"30905","ENSG00000240401","2",55282350,55346049,63699
"30906","ENSG00000240403","19",54850443,54867207,16764
"30907","ENSG00000240404","3",81612790,81613075,285
"30908","ENSG00000240405","3",69999550,70518064,518514
"30909","ENSG00000240409","1",633535,633741,206
"30910","ENSG00000240411","5",82777797,82778586,789
"30911","ENSG00000240412","5",58822503,58823714,1211
"30912","ENSG00000240418","19",16412684,16413576,892
"30913","ENSG00000240419","16",7126293,7126639,346
"30914","ENSG00000240423","3",107834586,107928907,94321
"30915","ENSG00000240426","4",76401251,76401569,318
"30916","ENSG00000240429","3",179259028,179261273,2245
"30917","ENSG00000240435","16",68209442,68209778,336
"30918","ENSG00000240436","5",62575951,62576271,320
"30919","ENSG00000240439","X",25060649,25060939,290
"30920","ENSG00000240440","2",207235299,207237875,2576
"30921","ENSG00000240441","12",107719599,107720133,534
"30922","ENSG00000240445","17",18667629,18682262,14633
"30923","ENSG00000240449","7",150363777,150372590,8813
"30924","ENSG00000240452","3",120722024,120722311,287
"30925","ENSG00000240454","11",13685499,13685656,157
"30926","ENSG00000240457","14",102077180,102077472,292
"30927","ENSG00000240459","4",112116510,112116903,393
"30928","ENSG00000240463","14",34568689,34569129,440
"30929","ENSG00000240470","15",90166233,90166526,293
"30930","ENSG00000240471","3",119791829,119792553,724
"30931","ENSG00000240474","20",38872770,38873074,304
"30932","ENSG00000240476","3",98981058,98983096,2038
"30933","ENSG00000240477","3",150050729,150051456,727
"30934","ENSG00000240480","17",7754320,7754976,656
"30935","ENSG00000240481","12",24706788,24707083,295
"30936","ENSG00000240484","15",92719393,92719740,347
"30937","ENSG00000240487","3",114231398,114233021,1623
"30938","ENSG00000240489","3",155987304,155988176,872
"30939","ENSG00000240490","1",19424384,19424671,287
"30940","ENSG00000240497","3",171459248,171469702,10454
"30941","ENSG00000240498","9",21994139,22128103,133964
"30942","ENSG00000240499","7",122328469,122440388,111919
"30943","ENSG00000240502","1",230894141,230894427,286
"30944","ENSG00000240505","17",16929816,16972118,42302
"30945","ENSG00000240509","8",93957338,93957691,353
"30946","ENSG00000240518","5",140609085,140609400,315
"30947","ENSG00000240519","8",26771790,26772140,350
"30948","ENSG00000240520","1",84363706,84397831,34125
"30949","ENSG00000240521","3",148850933,148960112,109179
"30950","ENSG00000240522","19",21149648,21150438,790
"30951","ENSG00000240527","10",95833508,95873758,40250
"30952","ENSG00000240531","17",29716279,29716685,406
"30953","ENSG00000240533","12",6095699,6095970,271
"30954","ENSG00000240534","8",52313154,52313500,346
"30955","ENSG00000240535","5",55021299,55042844,21545
"30956","ENSG00000240540","8",79571153,79572335,1182
"30957","ENSG00000240541","3",149377778,149386583,8805
"30958","ENSG00000240545","4",56794348,56794642,294
"30959","ENSG00000240549","3",63860645,63861819,1174
"30960","ENSG00000240553","1",23020147,23088058,67911
"30961","ENSG00000240554","11",29725764,29726565,801
"30962","ENSG00000240562","3",127489553,127490787,1234
"30963","ENSG00000240563","1",62194849,62212328,17479
"30964","ENSG00000240567","3",161426427,161448242,21815
"30965","ENSG00000240571","7",130173718,130205361,31643
"30966","ENSG00000240573","3",78087404,78092270,4866
"30967","ENSG00000240577","10",5631463,5631755,292
"30968","ENSG00000240578","7",142641746,142642196,450
"30969","ENSG00000240579","7",127857852,127858488,636
"30970","ENSG00000240583","7",30911694,30925517,13823
"30971","ENSG00000240589","17",44409059,44409358,299
"30972","ENSG00000240590","8",110105076,110105964,888
"30973","ENSG00000240591","22",31452881,31464304,11423
"30974","ENSG00000240596","3",156215560,156227883,12323
"30975","ENSG00000240602","3",151770428,151784894,14466
"30976","ENSG00000240606","6",122745280,122745529,249
"30977","ENSG00000240613","9",15525782,15526081,299
"30978","ENSG00000240616","19",12894133,12894880,747
"30979","ENSG00000240621","7",144176740,144177142,402
"30980","ENSG00000240622","3",124151960,124153063,1103
"30981","ENSG00000240625","6",43036196,43036500,304
"30982","ENSG00000240631","12",106910757,106911109,352
"30983","ENSG00000240632","9",81913437,81919926,6489
"30984","ENSG00000240634","16",28813980,28814673,693
"30985","ENSG00000240641","6",51975673,51975959,286
"30986","ENSG00000240647","22",31981147,31981427,280
"30987","ENSG00000240652","11",107908420,107908764,344
"30988","ENSG00000240654","13",24307166,24322535,15369
"30989","ENSG00000240661","3",120349449,120423826,74377
"30990","ENSG00000240665","3",75395188,75395320,132
"30991","ENSG00000240666","3",155158370,155183285,24915
"30992","ENSG00000240668","3",138101478,138102917,1439
"30993","ENSG00000240669","4",152613875,152614333,458
"30994","ENSG00000240671","2",88992409,88992931,522
"30995","ENSG00000240673","19",20079818,20080539,721
"30996","ENSG00000240674","4",165012366,165012845,479
"30997","ENSG00000240677","7",141811805,141812257,452
"30998","ENSG00000240680","7",130823205,130823511,306
"30999","ENSG00000240682","3",129127415,129161293,33878
"31000","ENSG00000240687","2",9638745,9712920,74175
"31001","ENSG00000240692","1",69879592,69879895,303
"31002","ENSG00000240694","8",26504701,26514092,9391
"31003","ENSG00000240695","3",136736500,136737229,729
"31004","ENSG00000240698","11",108690289,108690956,667
"31005","ENSG00000240704","3",170952850,170953897,1047
"31006","ENSG00000240707","10",132965534,132976354,10820
"31007","ENSG00000240708","3",55226862,55300738,73876
"31008","ENSG00000240710","1",204603035,204616565,13530
"31009","ENSG00000240718","7",6047721,6048023,302
"31010","ENSG00000240720","7",92141643,92179531,37888
"31011","ENSG00000240723","4",139100377,139100658,281
"31012","ENSG00000240729","5",177264766,177265241,475
"31013","ENSG00000240731","1",1317581,1318689,1108
"31014","ENSG00000240733","6",36450912,36451201,289
"31015","ENSG00000240738","8",33859480,33860223,743
"31016","ENSG00000240739","12",7994770,7995084,314
"31017","ENSG00000240747","3",42809483,42942792,133309
"31018","ENSG00000240750","1",28031884,28032180,296
"31019","ENSG00000240751","3",113360267,113361319,1052
"31020","ENSG00000240752","3",78758974,78759374,400
"31021","ENSG00000240758","7",128455937,128469197,13260
"31022","ENSG00000240759","12",42678873,42679124,251
"31023","ENSG00000240764","5",141489121,141512979,23858
"31024","ENSG00000240766","3",111676736,111677433,697
"31025","ENSG00000240767","13",46169458,46169748,290
"31026","ENSG00000240770","21",17763315,17792523,29208
"31027","ENSG00000240771","12",57610180,57617245,7065
"31028","ENSG00000240772","4",167400495,167400762,267
"31029","ENSG00000240775","4",122840343,122840690,347
"31030","ENSG00000240776","3",113850237,113850731,494
"31031","ENSG00000240777","3",55610603,55613104,2501
"31032","ENSG00000240785","5",18049232,18049872,640
"31033","ENSG00000240787","3",111570638,111571054,416
"31034","ENSG00000240790","7",127644685,127652012,7327
"31035","ENSG00000240791","9",92110575,92110868,293
"31036","ENSG00000240792","3",163455568,163479500,23932
"31037","ENSG00000240793","16",48334471,48334854,383
"31038","ENSG00000240796","3",106902173,106902523,350
"31039","ENSG00000240808","11",17137976,17138265,289
"31040","ENSG00000240809","3",76434018,76435428,1410
"31041","ENSG00000240813","17",10745553,10746543,990
"31042","ENSG00000240823","11",61444149,61444423,274
"31043","ENSG00000240828","17",43079302,43079780,478
"31044","ENSG00000240842","3",69564106,69571172,7066
"31045","ENSG00000240846","19",1307401,1307719,318
"31046","ENSG00000240847","15",41191965,41192265,300
"31047","ENSG00000240849","20",50118254,50153734,35480
"31048","ENSG00000240853","9",131725168,131725467,299
"31049","ENSG00000240854","3",132175402,132176711,1309
"31050","ENSG00000240857","2",18554723,18560679,5956
"31051","ENSG00000240859","7",149549,155465,5916
"31052","ENSG00000240861","16",74552251,74552746,495
"31053","ENSG00000240863","16",58199568,58199836,268
"31054","ENSG00000240864","2",89099859,89100361,502
"31055","ENSG00000240869","6",20421583,20421887,304
"31056","ENSG00000240870","8",98782055,98782628,573
"31057","ENSG00000240873","17",28116239,28116406,167
"31058","ENSG00000240874","15",57555951,57556379,428
"31059","ENSG00000240875","3",156747343,156817062,69719
"31060","ENSG00000240877","7",149125690,149125986,296
"31061","ENSG00000240882","3",120306726,120307952,1226
"31062","ENSG00000240888","3",143313067,143314429,1362
"31063","ENSG00000240889","7",140695336,140697077,1741
"31064","ENSG00000240890","3",132386522,132389074,2552
"31065","ENSG00000240891","3",111674676,111846447,171771
"31066","ENSG00000240893","3",112736447,112749319,12872
"31067","ENSG00000240895","3",110527482,110529582,2100
"31068","ENSG00000240898","17",3665220,3665702,482
"31069","ENSG00000240905","8",55980240,55980540,300
"31070","ENSG00000240912","3",114103249,114103628,379
"31071","ENSG00000240914","14",94800849,94801463,614
"31072","ENSG00000240915","8",63013068,63014681,1613
"31073","ENSG00000240919","8",53532908,53533704,796
"31074","ENSG00000240922","3",116360024,116370090,10066
"31075","ENSG00000240925","12",120247460,120247791,331
"31076","ENSG00000240927","15",101773238,101773513,275
"31077","ENSG00000240934","15",58200606,58201018,412
"31078","ENSG00000240935","2",106382171,106393031,10860
"31079","ENSG00000240940","10",62350006,62350297,291
"31080","ENSG00000240950","3",142827096,142827728,632
"31081","ENSG00000240951","3",89587886,89588570,684
"31082","ENSG00000240954","14",21750269,21751546,1277
"31083","ENSG00000240960","2",9746704,9746869,165
"31084","ENSG00000240963","1",244375100,244409592,34492
"31085","ENSG00000240964","3",78938009,78938292,283
"31086","ENSG00000240966","4",87386883,87387174,291
"31087","ENSG00000240970","11",119003012,119003446,434
"31088","ENSG00000240972","22",23894383,23895227,844
"31089","ENSG00000240973","7",115679345,115682618,3273
"31090","ENSG00000240974","5",141588935,141589142,207
"31091","ENSG00000240975","11",39161453,39161967,514
"31092","ENSG00000240977","2",139982684,139982986,302
"31093","ENSG00000240983","18",46722975,46723223,248
"31094","ENSG00000240990","7",27184507,27189298,4791
"31095","ENSG00000240991","12",133125479,133125952,473
"31096","ENSG00000240992","4",145269810,145270558,748
"31097","ENSG00000240993","12",19176288,19176589,301
"31098","ENSG00000240996","10",89694295,89697928,3633
"31099","ENSG00000240997","6",87845650,87845947,297
"31100","ENSG00000241002","4",112738672,112739106,434
"31101","ENSG00000241003","8",94688228,94688610,382
"31102","ENSG00000241007","7",152367519,152368661,1142
"31103","ENSG00000241008","11",7783697,7784407,710
"31104","ENSG00000241014","1",34975699,34978706,3007
"31105","ENSG00000241015","19",53431984,53444670,12686
"31106","ENSG00000241026","8",22389865,22390655,790
"31107","ENSG00000241030","12",120522664,120523443,779
"31108","ENSG00000241032","8",37908738,37909037,299
"31109","ENSG00000241035","14",21398925,21399282,357
"31110","ENSG00000241042","1",59054397,59056049,1652
"31111","ENSG00000241045","12",76721534,76722286,752
"31112","ENSG00000241048","3",150202174,150225190,23016
"31113","ENSG00000241052","14",35144021,35144480,459
"31114","ENSG00000241054","20",20094401,20095684,1283
"31115","ENSG00000241057","7",43961590,43973323,11733
"31116","ENSG00000241058","10",18545561,18659285,113724
"31117","ENSG00000241059","5",91355380,91356026,646
"31118","ENSG00000241061","15",24908932,24909825,893
"31119","ENSG00000241064","3",15506623,15506905,282
"31120","ENSG00000241067","16",16094192,16095209,1017
"31121","ENSG00000241073","1",100057990,100084471,26481
"31122","ENSG00000241074","2",168451324,168451606,282
"31123","ENSG00000241081","14",76886377,76886750,373
"31124","ENSG00000241082","11",62935982,62936234,252
"31125","ENSG00000241084","9",129259062,129261581,2519
"31126","ENSG00000241088","18",62415678,62416227,549
"31127","ENSG00000241095","3",82806515,82808021,1506
"31128","ENSG00000241097","11",74738478,74738796,318
"31129","ENSG00000241098","3",182446970,182486364,39394
"31130","ENSG00000241101","3",64103470,64106056,2586
"31131","ENSG00000241104","19",43211791,43248646,36855
"31132","ENSG00000241105","8",70506251,70506818,567
"31133","ENSG00000241106","6",32812763,32820466,7703
"31134","ENSG00000241111","3",64067964,64103131,35167
"31135","ENSG00000241112","5",149545383,149545810,427
"31136","ENSG00000241119","2",233671898,233773300,101402
"31137","ENSG00000241120","3",167694355,167694642,287
"31138","ENSG00000241127","7",39566385,39610320,43935
"31139","ENSG00000241128","1",247722957,247724043,1086
"31140","ENSG00000241129","12",124935455,124935895,440
"31141","ENSG00000241130","15",50798670,50798951,281
"31142","ENSG00000241131","3",148076432,148089134,12702
"31143","ENSG00000241134","7",150749736,150750094,358
"31144","ENSG00000241135","3",157089634,157135557,45923
"31145","ENSG00000241136","7",143782667,143784284,1617
"31146","ENSG00000241143","3",150150538,150150944,406
"31147","ENSG00000241144","4",102348392,102348691,299
"31148","ENSG00000241146","12",52885429,52886385,956
"31149","ENSG00000241149","7",63998874,64016130,17256
"31150","ENSG00000241151","3",151637174,151657966,20792
"31151","ENSG00000241155","3",119314293,119322760,8467
"31152","ENSG00000241156","3",116582552,116582830,278
"31153","ENSG00000241157","17",60245288,60245647,359
"31154","ENSG00000241158","3",64561322,64592757,31435
"31155","ENSG00000241159","2",70965584,70965867,283
"31156","ENSG00000241162","6",110439996,110440303,307
"31157","ENSG00000241163","3",71943592,72279503,335911
"31158","ENSG00000241168","3",163026396,163232149,205753
"31159","ENSG00000241169","1",27457198,27459582,2384
"31160","ENSG00000241170","11",74876286,74920022,43736
"31161","ENSG00000241172","19",18957957,18958258,301
"31162","ENSG00000241175","15",50244628,50244931,303
"31163","ENSG00000241179","5",134804778,134805132,354
"31164","ENSG00000241180","1",914171,914971,800
"31165","ENSG00000241185","17",11998353,12021508,23155
"31166","ENSG00000241186","3",46574534,46582457,7923
"31167","ENSG00000241187","5",154729231,154729694,463
"31168","ENSG00000241188","1",26814822,26815112,290
"31169","ENSG00000241198","X",131134086,131134390,304
"31170","ENSG00000241204","8",70424125,70424576,451
"31171","ENSG00000241207","X",48276704,48277578,874
"31172","ENSG00000241211","3",159765387,159768612,3225
"31173","ENSG00000241213","3",117678693,117691005,12312
"31174","ENSG00000241217","12",56670450,56670746,296
"31175","ENSG00000241218","3",107327830,107329197,1367
"31176","ENSG00000241219","3",113050912,113063443,12531
"31177","ENSG00000241220","3",153357107,153374186,17079
"31178","ENSG00000241221","2",202617695,202617987,292
"31179","ENSG00000241223","18",3571215,3571511,296
"31180","ENSG00000241224","3",109118252,109150514,32262
"31181","ENSG00000241226","19",45651510,45651805,295
"31182","ENSG00000241227","3",5252926,5253223,297
"31183","ENSG00000241228","11",35997226,35997675,449
"31184","ENSG00000241229","20",44007248,44007537,289
"31185","ENSG00000241230","5",54048007,54048308,301
"31186","ENSG00000241231","3",181372732,181442597,69865
"31187","ENSG00000241233","11",71538025,71539207,1182
"31188","ENSG00000241241","17",41101502,41102209,707
"31189","ENSG00000241243","5",87294189,87294473,284
"31190","ENSG00000241244","2",90100236,90100738,502
"31191","ENSG00000241246","9",124607159,124607458,299
"31192","ENSG00000241248","X",140085855,140086150,295
"31193","ENSG00000241250","4",56710060,56710614,554
"31194","ENSG00000241251","12",43560784,43561297,513
"31195","ENSG00000241255","11",33237008,33237409,401
"31196","ENSG00000241258","7",66114604,66154568,39964
"31197","ENSG00000241269","7",5419827,5420767,940
"31198","ENSG00000241278","3",125848223,125909372,61149
"31199","ENSG00000241280","3",101960358,101997926,37568
"31200","ENSG00000241281","4",147425974,147426351,377
"31201","ENSG00000241282","19",22699352,22699685,333
"31202","ENSG00000241286","12",110841538,110842387,849
"31203","ENSG00000241288","3",125827238,125916384,89146
"31204","ENSG00000241293","3",87051192,87052738,1546
"31205","ENSG00000241294","2",89176328,89177160,832
"31206","ENSG00000241295","3",114684580,114687609,3029
"31207","ENSG00000241307","3",155760617,155761217,600
"31208","ENSG00000241313","3",149656999,149661364,4365
"31209","ENSG00000241316","3",67654669,67947713,293044
"31210","ENSG00000241317","10",79504073,79506281,2208
"31211","ENSG00000241318","1",91534666,91535593,927
"31212","ENSG00000241319","3",81612238,81612805,567
"31213","ENSG00000241322","17",15565483,15619512,54029
"31214","ENSG00000241324","7",124337380,124349860,12480
"31215","ENSG00000241328","3",86481943,86496996,15053
"31216","ENSG00000241333","22",37669464,37669739,275
"31217","ENSG00000241336","3",155240919,155258766,17847
"31218","ENSG00000241343","X",101390824,101396154,5330
"31219","ENSG00000241344","4",62248294,62248770,476
"31220","ENSG00000241345","7",123994622,124027659,33037
"31221","ENSG00000241350","7",77011551,77015853,4302
"31222","ENSG00000241351","2",89027171,89027731,560
"31223","ENSG00000241352","12",12850982,12851740,758
"31224","ENSG00000241356","11",56819573,56820516,943
"31225","ENSG00000241357","7",100435257,100436510,1253
"31226","ENSG00000241358","3",146391363,146416603,25240
"31227","ENSG00000241359","3",63423596,63550051,126455
"31228","ENSG00000241360","22",37658723,37666932,8209
"31229","ENSG00000241361","1",108272943,108337853,64910
"31230","ENSG00000241362","15",89687937,89688243,306
"31231","ENSG00000241369","3",163109152,163361563,252411
"31232","ENSG00000241370","6",30345131,30346884,1753
"31233","ENSG00000241383","3",169003022,169038416,35394
"31234","ENSG00000241388","12",120941728,120980965,39237
"31235","ENSG00000241391","6",149291352,149291646,294
"31236","ENSG00000241392","4",131720260,131720543,283
"31237","ENSG00000241395","1",211792111,211792406,295
"31238","ENSG00000241399","2",159768628,159798255,29627
"31239","ENSG00000241400","3",141258418,141258779,361
"31240","ENSG00000241404","6",32164595,32168281,3686
"31241","ENSG00000241406","13",41807677,41807973,296
"31242","ENSG00000241409","2",232760146,232767949,7803
"31243","ENSG00000241411","4",134952259,134952889,630
"31244","ENSG00000241413","12",109866214,109866509,295
"31245","ENSG00000241416","3",170495627,170496636,1009
"31246","ENSG00000241418","X",131795657,131796167,510
"31247","ENSG00000241420","7",33045798,33046090,292
"31248","ENSG00000241423","12",58244378,58244865,487
"31249","ENSG00000241429","3",138825063,138826329,1266
"31250","ENSG00000241431","8",56588385,56588787,402
"31251","ENSG00000241438","3",136155549,136155996,447
"31252","ENSG00000241439","3",125958556,125958817,261
"31253","ENSG00000241449","7",150033653,150076655,43002
"31254","ENSG00000241456","7",151427683,151439124,11441
"31255","ENSG00000241457","3",146589602,146590325,723
"31256","ENSG00000241458","5",138473744,138474361,617
"31257","ENSG00000241461","3",49083233,49083532,299
"31258","ENSG00000241462","17",58897776,58899692,1916
"31259","ENSG00000241464","19",18285343,18285495,152
"31260","ENSG00000241468","7",99448475,99466331,17856
"31261","ENSG00000241469","3",107840228,107882250,42022
"31262","ENSG00000241472","3",62221249,62369406,148157
"31263","ENSG00000241473","3",180820544,180821612,1068
"31264","ENSG00000241475","1",234660271,234667104,6833
"31265","ENSG00000241478","3",137880295,137882237,1942
"31266","ENSG00000241479","3",169447867,169477052,29185
"31267","ENSG00000241484","22",44752558,44862788,110230
"31268","ENSG00000241487","14",73040619,73040914,295
"31269","ENSG00000241489","X",149477104,149540926,63822
"31270","ENSG00000241490","3",114214313,114236204,21891
"31271","ENSG00000241493","7",128669087,128669892,805
"31272","ENSG00000241494","14",101677943,101678380,437
"31273","ENSG00000241499","14",93244010,93244323,313
"31274","ENSG00000241505","1",190480379,190494297,13918
"31275","ENSG00000241506","3",68635705,68637024,1319
"31276","ENSG00000241511","8",30117384,30117779,395
"31277","ENSG00000241520","2",216483032,216487196,4164
"31278","ENSG00000241525","17",404468,414023,9555
"31279","ENSG00000241526","3",141724425,141724526,101
"31280","ENSG00000241527","22",19031564,19034564,3000
"31281","ENSG00000241529","3",113632704,113632998,294
"31282","ENSG00000241532","3",75653561,75654773,1212
"31283","ENSG00000241535","3",88095408,88095968,560
"31284","ENSG00000241537","3",72772539,72773471,932
"31285","ENSG00000241539","7",6924078,6924513,435
"31286","ENSG00000241542","14",67705954,67706252,298
"31287","ENSG00000241544","3",157081738,157088547,6809
"31288","ENSG00000241546","3",120041190,120041537,347
"31289","ENSG00000241547","1",27325329,27325796,467
"31290","ENSG00000241549","6",26871484,26956554,85070
"31291","ENSG00000241550","8",80204606,80204902,296
"31292","ENSG00000241552","5",18547312,18547605,293
"31293","ENSG00000241553","3",9792495,9807726,15231
"31294","ENSG00000241556","12",95467397,95467861,464
"31295","ENSG00000241560","3",114351771,114388978,37207
"31296","ENSG00000241562","15",99551382,99552117,735
"31297","ENSG00000241563","1",10449719,10451902,2183
"31298","ENSG00000241566","2",90004797,90005629,832
"31299","ENSG00000241568","9",35049271,35049563,292
"31300","ENSG00000241570","3",142960650,143001559,40909
"31301","ENSG00000241577","10",48883955,48935213,51258
"31302","ENSG00000241582","14",34694170,34694644,474
"31303","ENSG00000241587","3",66323855,66324152,297
"31304","ENSG00000241592","3",142960372,142960543,171
"31305","ENSG00000241593","3",81246579,81297345,50766
"31306","ENSG00000241596","3",115658533,115661279,2746
"31307","ENSG00000241597","5",98954394,98954972,578
"31308","ENSG00000241598","11",1620958,1622138,1180
"31309","ENSG00000241599","1",160446,161525,1079
"31310","ENSG00000241612","4",19813749,19814231,482
"31311","ENSG00000241613","13",53258077,53258372,295
"31312","ENSG00000241621","10",30364410,30374386,9976
"31313","ENSG00000241622","3",75658534,75659014,480
"31314","ENSG00000241625","2",62491178,62491468,290
"31315","ENSG00000241627","3",148985868,148987668,1800
"31316","ENSG00000241631","17",30702504,30702775,271
"31317","ENSG00000241634","3",108543367,108543875,508
"31318","ENSG00000241635","2",233760248,233773299,13051
"31319","ENSG00000241636","3",164670878,164686076,15198
"31320","ENSG00000241640","15",59049399,59050385,986
"31321","ENSG00000241641","16",12081237,12081902,665
"31322","ENSG00000241644","7",30697985,30757602,59617
"31323","ENSG00000241648","3",85799987,85828050,28063
"31324","ENSG00000241651","4",128069014,128069612,598
"31325","ENSG00000241652","4",173141643,173141938,295
"31326","ENSG00000241654","17",9589902,9590482,580
"31327","ENSG00000241656","12",115592604,115592983,379
"31328","ENSG00000241657","7",142433895,142434394,499
"31329","ENSG00000241661","7",140292752,140293339,587
"31330","ENSG00000241665","3",69769487,69769773,286
"31331","ENSG00000241666","1",167627385,167630674,3289
"31332","ENSG00000241667","3",69591341,69593121,1780
"31333","ENSG00000241668","5",31053565,31054153,588
"31334","ENSG00000241669","3",167392796,167408519,15723
"31335","ENSG00000241671","3",153129074,153129640,566
"31336","ENSG00000241673","3",129218093,129218350,257
"31337","ENSG00000241678","11",6685891,6686369,478
"31338","ENSG00000241679","3",143123362,143131893,8531
"31339","ENSG00000241680","12",110460988,110461362,374
"31340","ENSG00000241684","3",64684909,65053439,368530
"31341","ENSG00000241685","7",99325898,99366262,40364
"31342","ENSG00000241690","20",2814968,2818066,3098
"31343","ENSG00000241693","22",38231720,38231993,273
"31344","ENSG00000241696","3",180413008,180476778,63770
"31345","ENSG00000241697","9",100473149,100577636,104487
"31346","ENSG00000241709","7",73732569,73732868,299
"31347","ENSG00000241717","22",16690103,16704477,14374
"31348","ENSG00000241720","1",109725820,109775252,49432
"31349","ENSG00000241721","20",53875252,53875557,305
"31350","ENSG00000241722","4",111551854,111552173,319
"31351","ENSG00000241723","3",158275809,158276421,612
"31352","ENSG00000241735","7",152435695,152443176,7481
"31353","ENSG00000241738","3",101357292,101359242,1950
"31354","ENSG00000241739","5",31840492,31840971,479
"31355","ENSG00000241741","4",112788083,112788878,795
"31356","ENSG00000241745","1",52150104,52150419,315
"31357","ENSG00000241746","8",80265528,80266155,627
"31358","ENSG00000241749","12",65758020,65826997,68977
"31359","ENSG00000241754","3",102621061,102673986,52925
"31360","ENSG00000241755","2",89009982,89010515,533
"31361","ENSG00000241757","14",98351367,98351664,297
"31362","ENSG00000241764","7",107739999,107744581,4582
"31363","ENSG00000241765","12",69422656,69422995,339
"31364","ENSG00000241767","3",164714095,164831480,117385
"31365","ENSG00000241769","X",149527591,149540959,13368
"31366","ENSG00000241770","3",157163452,157169133,5681
"31367","ENSG00000241772","2",138569090,138574458,5368
"31368","ENSG00000241782","11",77868722,77869195,473
"31369","ENSG00000241785","12",54255627,54255910,283
"31370","ENSG00000241787","3",106894352,106895718,1366
"31371","ENSG00000241791","2",46448224,46448511,287
"31372","ENSG00000241792","3",148093175,148127233,34058
"31373","ENSG00000241794","1",153056120,153057512,1392
"31374","ENSG00000241804","3",59535863,59536415,552
"31375","ENSG00000241810","3",153067278,153067551,273
"31376","ENSG00000241818","15",32656084,32673065,16981
"31377","ENSG00000241821","20",56688401,56688695,294
"31378","ENSG00000241825","12",68684595,68686308,1713
"31379","ENSG00000241829","5",34883057,34883520,463
"31380","ENSG00000241832","22",17256859,17266733,9874
"31381","ENSG00000241834","8",41840059,41840339,280
"31382","ENSG00000241837","21",33903453,33915814,12361
"31383","ENSG00000241838","22",15721486,15722608,1122
"31384","ENSG00000241839","15",64841883,64868002,26119
"31385","ENSG00000241846","12",25409293,25409445,152
"31386","ENSG00000241852","8",22599599,22604150,4551
"31387","ENSG00000241853","4",88163579,88163967,388
"31388","ENSG00000241859","Y",13703902,13915824,211922
"31389","ENSG00000241860","1",141474,173862,32388
"31390","ENSG00000241866","18",73744935,73745232,297
"31391","ENSG00000241868","3",196397508,196397778,270
"31392","ENSG00000241869","15",90855935,90856207,272
"31393","ENSG00000241870","5",181065086,181065677,591
"31394","ENSG00000241877","4",178286695,178287285,590
"31395","ENSG00000241878","22",31618491,31662432,43941
"31396","ENSG00000241882","3",168288553,168291228,2675
"31397","ENSG00000241884","3",67296300,67306359,10059
"31398","ENSG00000241886","X",30698207,30721932,23725
"31399","ENSG00000241889","3",113885298,113886031,733
"31400","ENSG00000241890","15",75388267,75388828,561
"31401","ENSG00000241899","3",141709016,141709832,816
"31402","ENSG00000241907","5",150021567,150021921,354
"31403","ENSG00000241912","3",153376831,153377562,731
"31404","ENSG00000241913","17",59912197,59912366,169
"31405","ENSG00000241917","12",101936216,101936674,458
"31406","ENSG00000241921","7",126378970,126424185,45215
"31407","ENSG00000241923","4",140366240,140366861,621
"31408","ENSG00000241926","7",141801315,141802059,744
"31409","ENSG00000241929","3",149462182,149464830,2648
"31410","ENSG00000241933","3",57693205,57696596,3391
"31411","ENSG00000241935","10",97584323,97612802,28479
"31412","ENSG00000241939","3",43314951,43315255,304
"31413","ENSG00000241941","12",62658823,62659225,402
"31414","ENSG00000241942","8",71895991,71896330,339
"31415","ENSG00000241943","11",16576851,16577135,284
"31416","ENSG00000241945","21",44107373,44131181,23808
"31417","ENSG00000241947","3",149999645,150000690,1045
"31418","ENSG00000241954","22",32383786,32385631,1845
"31419","ENSG00000241956","5",164296696,165171643,874947
"31420","ENSG00000241959","7",151464650,151464938,288
"31421","ENSG00000241962","2",99141485,99322741,181256
"31422","ENSG00000241963","5",154349428,154349725,297
"31423","ENSG00000241973","22",20707691,20859417,151726
"31424","ENSG00000241975","1",88829102,88829419,317
"31425","ENSG00000241978","9",110048598,110172512,123914
"31426","ENSG00000241981","4",102662611,102663073,462
"31427","ENSG00000241983","19",39369153,39369448,295
"31428","ENSG00000241984","14",39156742,39157852,1110
"31429","ENSG00000241985","3",149648997,149650184,1187
"31430","ENSG00000241990","22",46053705,46057210,3505
"31431","ENSG00000241991","5",62561859,62562216,357
"31432","ENSG00000241997","8",56022019,56022313,294
"31433","ENSG00000242001","3",125681305,125681453,148
"31434","ENSG00000242009","3",81840514,81953534,113020
"31435","ENSG00000242012","3",182365147,182368256,3109
"31436","ENSG00000242014","6",33540694,33541000,306
"31437","ENSG00000242017","3",156044155,156044948,793
"31438","ENSG00000242019","19",54724479,54736536,12057
"31439","ENSG00000242020","5",141479316,141479625,309
"31440","ENSG00000242021","X",27042907,27176298,133391
"31441","ENSG00000242028","15",43796142,43803043,6901
"31442","ENSG00000242029","3",109648107,109810861,162754
"31443","ENSG00000242034","4",9553614,9553985,371
"31444","ENSG00000242041","12",49863173,49863503,330
"31445","ENSG00000242042","1",246516039,246524287,8248
"31446","ENSG00000242048","7",151806490,151810820,4330
"31447","ENSG00000242049","3",128463594,128472317,8723
"31448","ENSG00000242052","3",119635526,119636150,624
"31449","ENSG00000242058","18",9020029,9020764,735
"31450","ENSG00000242060","18",60149576,60150365,789
"31451","ENSG00000242061","14",22694098,22694535,437
"31452","ENSG00000242062","3",128852112,128853008,896
"31453","ENSG00000242067","17",48691116,48691694,578
"31454","ENSG00000242068","3",180772750,180773914,1164
"31455","ENSG00000242071","14",69885340,69886140,800
"31456","ENSG00000242076","2",89266494,89268506,2012
"31457","ENSG00000242078","7",129783370,129785185,1815
"31458","ENSG00000242079","8",5142411,5142707,296
"31459","ENSG00000242080","5",152495718,152496017,299
"31460","ENSG00000242082","22",32205115,32278382,73267
"31461","ENSG00000242083","4",56356135,56356932,797
"31462","ENSG00000242085","14",105374618,105374971,353
"31463","ENSG00000242086","3",195658062,195739964,81902
"31464","ENSG00000242087","12",63871739,63872044,305
"31465","ENSG00000242088","15",24910874,24911125,251
"31466","ENSG00000242094","3",71570255,71574457,4202
"31467","ENSG00000242097","3",151759747,151762011,2264
"31468","ENSG00000242100","19",29956369,29956988,619
"31469","ENSG00000242101","7",100530362,100530659,297
"31470","ENSG00000242102","4",140577925,140578222,297
"31471","ENSG00000242104","3",141660536,141729405,68869
"31472","ENSG00000242107","3",160016024,160031423,15399
"31473","ENSG00000242110","5",33986165,34008104,21939
"31474","ENSG00000242111","9",104270228,104286955,16727
"31475","ENSG00000242113","2",151372003,151372287,284
"31476","ENSG00000242114","22",30425623,30429054,3431
"31477","ENSG00000242118","2",81967079,81967374,295
"31478","ENSG00000242119","3",151499639,151499806,167
"31479","ENSG00000242121","2",182314284,182314544,260
"31480","ENSG00000242125","1",28505980,28510892,4912
"31481","ENSG00000242134","4",142286917,142287625,708
"31482","ENSG00000242136","2",9103440,9105114,1674
"31483","ENSG00000242137","12",120594015,120594548,533
"31484","ENSG00000242140","3",181146233,181146463,230
"31485","ENSG00000242142","3",53064283,53065091,808
"31486","ENSG00000242145","3",81208193,81208914,721
"31487","ENSG00000242147","10",5594984,5632435,37451
"31488","ENSG00000242152","3",155431229,155433398,2169
"31489","ENSG00000242154","7",105304277,105306642,2365
"31490","ENSG00000242156","22",29419155,29423193,4038
"31491","ENSG00000242158","2",60640705,60641002,297
"31492","ENSG00000242159","3",88317156,88319022,1866
"31493","ENSG00000242163","14",81332961,81333361,400
"31494","ENSG00000242165","11",100641975,100642273,298
"31495","ENSG00000242169","4",188349376,188350024,648
"31496","ENSG00000242170","8",125270604,125270902,298
"31497","ENSG00000242173","16",280450,283010,2560
"31498","ENSG00000242175","4",78898855,78899154,299
"31499","ENSG00000242178","3",166160021,166160370,349
"31500","ENSG00000242182","18",23004564,23004862,298
"31501","ENSG00000242190","3",81762706,81764756,2050
"31502","ENSG00000242193","1",178006136,178037950,31814
"31503","ENSG00000242197","4",40491733,40492024,291
"31504","ENSG00000242198","5",75374463,75374809,346
"31505","ENSG00000242199","3",124733418,124733754,336
"31506","ENSG00000242201","3",194145674,194145971,297
"31507","ENSG00000242206","8",118761856,118762201,345
"31508","ENSG00000242207","17",48628675,48634932,6257
"31509","ENSG00000242208","11",56357328,56358221,893
"31510","ENSG00000242209","4",13647697,13648400,703
"31511","ENSG00000242214","3",106896483,106896821,338
"31512","ENSG00000242220","21",32573721,32587373,13652
"31513","ENSG00000242221","19",43064209,43083045,18836
"31514","ENSG00000242222","3",135925891,135926167,276
"31515","ENSG00000242229","3",125795106,125795885,779
"31516","ENSG00000242236","20",25654595,25654881,286
"31517","ENSG00000242241","7",128970734,128971029,295
"31518","ENSG00000242242","3",110893708,111071553,177845
"31519","ENSG00000242244","3",138889255,138889957,702
"31520","ENSG00000242247","22",42796502,42858106,61604
"31521","ENSG00000242248","11",92161106,92161889,783
"31522","ENSG00000242251","22",31757202,31757498,296
"31523","ENSG00000242252","1",156242184,156243317,1133
"31524","ENSG00000242256","9",112242550,112242839,289
"31525","ENSG00000242258","7",150433654,150448140,14486
"31526","ENSG00000242259","22",19351368,19448232,96864
"31527","ENSG00000242262","4",47706372,47706987,615
"31528","ENSG00000242265","7",94656325,94669695,13370
"31529","ENSG00000242267","1",48096092,48182428,86336
"31530","ENSG00000242268","3",168902194,168924590,22396
"31531","ENSG00000242272","2",31823413,31823817,404
"31532","ENSG00000242276","15",71063101,71063989,888
"31533","ENSG00000242278","16",5270174,5270954,780
"31534","ENSG00000242281","9",129370170,129370461,291
"31535","ENSG00000242282","2",3531813,3536873,5060
"31536","ENSG00000242285","3",160584945,160585787,842
"31537","ENSG00000242288","10",73674295,73730466,56171
"31538","ENSG00000242290","3",114445521,114529452,83931
"31539","ENSG00000242291","19",21233335,21233652,317
"31540","ENSG00000242292","5",36588506,36588661,155
"31541","ENSG00000242293","14",69023150,69023308,158
"31542","ENSG00000242294","7",100336079,100351900,15821
"31543","ENSG00000242295","15",96448154,96448493,339
"31544","ENSG00000242296","8",12393209,12400366,7157
"31545","ENSG00000242299","3",101576489,101576947,458
"31546","ENSG00000242307","16",13922332,13922679,347
"31547","ENSG00000242314","12",31948334,31948827,493
"31548","ENSG00000242317","3",55493830,55505261,11431
"31549","ENSG00000242318","4",98409290,98409763,473
"31550","ENSG00000242320","18",55635833,55636310,477
"31551","ENSG00000242321","3",138796851,138797240,389
"31552","ENSG00000242324","20",1516759,1557653,40894
"31553","ENSG00000242325","19",32636078,32636475,397
"31554","ENSG00000242327","15",52095295,52095747,452
"31555","ENSG00000242329","12",12840804,12841079,275
"31556","ENSG00000242330","14",71448689,71448958,269
"31557","ENSG00000242337","3",133661998,133754576,92578
"31558","ENSG00000242338","10",73715843,73730469,14626
"31559","ENSG00000242339","3",84881984,84893379,11395
"31560","ENSG00000242341","5",178377924,178378220,296
"31561","ENSG00000242348","20",1666360,1666640,280
"31562","ENSG00000242352","1",143766540,143769083,2543
"31563","ENSG00000242353","11",30368148,30368646,498
"31564","ENSG00000242360","13",27989296,27989584,288
"31565","ENSG00000242366","2",233617645,233773310,155665
"31566","ENSG00000242370","3",156441157,156446905,5748
"31567","ENSG00000242371","2",89319625,89320146,521
"31568","ENSG00000242372","20",35278911,35284985,6074
"31569","ENSG00000242375","9",97195351,97197687,2336
"31570","ENSG00000242385","3",116921431,116932238,10807
"31571","ENSG00000242389","Y",21903618,21918067,14449
"31572","ENSG00000242390","3",142580910,142582399,1489
"31573","ENSG00000242391","1",52881216,52881730,514
"31574","ENSG00000242396","1",54886875,54888001,1126
"31575","ENSG00000242405","12",12155262,12155772,510
"31576","ENSG00000242407","17",48733091,48733888,797
"31577","ENSG00000242411","19",56217168,56217777,609
"31578","ENSG00000242412","2",63117851,63119542,1691
"31579","ENSG00000242419","5",141484997,141512979,27982
"31580","ENSG00000242428","3",58824437,59019093,194656
"31581","ENSG00000242430","16",14601823,14602094,271
"31582","ENSG00000242431","4",47490967,47491471,504
"31583","ENSG00000242435","7",77004662,77005774,1112
"31584","ENSG00000242436","19",32655016,32655308,292
"31585","ENSG00000242439","17",30830901,30831318,417
"31586","ENSG00000242440","3",148279682,148401084,121402
"31587","ENSG00000242441","2",48617798,48733148,115350
"31588","ENSG00000242444","12",4109661,4118132,8471
"31589","ENSG00000242445","3",121494110,121494908,798
"31590","ENSG00000242456","3",166161203,166161968,765
"31591","ENSG00000242457","3",94075912,94077175,1263
"31592","ENSG00000242473","19",54755023,54767371,12348
"31593","ENSG00000242474","7",135853,149527,13674
"31594","ENSG00000242477","5",86884231,86884881,650
"31595","ENSG00000242483","8",11379395,11379675,280
"31596","ENSG00000242485","1",1401909,1407293,5384
"31597","ENSG00000242488","14",75838157,75839114,957
"31598","ENSG00000242493","5",37246173,37246479,306
"31599","ENSG00000242498","15",89895006,89912952,17946
"31600","ENSG00000242507","20",35520852,35528255,7403
"31601","ENSG00000242509","20",36870099,36870402,303
"31602","ENSG00000242510","3",67513940,67514320,380
"31603","ENSG00000242512","3",181952343,182035644,83301
"31604","ENSG00000242515","2",233636454,233773305,136851
"31605","ENSG00000242516","3",75672300,75742048,69748
"31606","ENSG00000242520","X",152114599,152115540,941
"31607","ENSG00000242522","3",183548735,183552326,3591
"31608","ENSG00000242524","6",29268462,29269421,959
"31609","ENSG00000242525","3",112524187,112525201,1014
"31610","ENSG00000242527","11",27483850,27484128,278
"31611","ENSG00000242531","3",122416882,122417012,130
"31612","ENSG00000242534","2",89959979,89960754,775
"31613","ENSG00000242536","3",157814822,158088997,274175
"31614","ENSG00000242537","3",156111432,156114198,2766
"31615","ENSG00000242540","2",5696220,5719670,23450
"31616","ENSG00000242550","18",63897174,63936111,38937
"31617","ENSG00000242551","3",128674735,128677005,2270
"31618","ENSG00000242553","21",37221419,37237744,16325
"31619","ENSG00000242559","X",41683168,41683462,294
"31620","ENSG00000242560","6",96282567,96282863,296
"31621","ENSG00000242561","3",152800434,152800732,298
"31622","ENSG00000242562","7",106125371,106126700,1329
"31623","ENSG00000242565","1",153704088,153704385,297
"31624","ENSG00000242571","14",90366697,90367179,482
"31625","ENSG00000242574","6",32934629,32941028,6399
"31626","ENSG00000242575","2",153420677,153421957,1280
"31627","ENSG00000242578","3",170410512,170418615,8103
"31628","ENSG00000242580","2",90209873,90210529,656
"31629","ENSG00000242583","3",170062244,170062951,707
"31630","ENSG00000242588","7",128574751,128626473,51722
"31631","ENSG00000242593","7",124032126,124489572,457446
"31632","ENSG00000242595","8",58113189,58113622,433
"31633","ENSG00000242598","1",81557121,81557832,711
"31634","ENSG00000242599","X",152733827,152740985,7158
"31635","ENSG00000242600","10",79920178,79923119,2941
"31636","ENSG00000242602","5",72878868,72879185,317
"31637","ENSG00000242607","8",12570350,12571130,780
"31638","ENSG00000242608","5",13250235,13250662,427
"31639","ENSG00000242610","X",131398072,131398957,885
"31640","ENSG00000242611","7",77038,81178,4140
"31641","ENSG00000242612","16",401858,412487,10629
"31642","ENSG00000242613","3",120388029,120389315,1286
"31643","ENSG00000242615","19",12141806,12143322,1516
"31644","ENSG00000242616","9",111661605,111670226,8621
"31645","ENSG00000242618","3",72202944,72209914,6970
"31646","ENSG00000242622","3",120094895,120136783,41888
"31647","ENSG00000242628","2",24210650,24222201,11551
"31648","ENSG00000242634","15",67232446,67232837,391
"31649","ENSG00000242635","4",160818422,160818869,447
"31650","ENSG00000242636","19",7750684,7751161,477
"31651","ENSG00000242638","3",75182754,75183048,294
"31652","ENSG00000242640","4",25678850,25679020,170
"31653","ENSG00000242641","3",84638405,84881924,243519
"31654","ENSG00000242651","18",9830330,9830627,297
"31655","ENSG00000242653","7",34753424,34753719,295
"31656","ENSG00000242657","X",70222006,70222314,308
"31657","ENSG00000242659","3",113746872,113747408,536
"31658","ENSG00000242660","17",35566517,35566672,155
"31659","ENSG00000242661","12",8359054,8359834,780
"31660","ENSG00000242667","15",60404463,60404960,497
"31661","ENSG00000242668","19",53629713,53630041,328
"31662","ENSG00000242673","11",131004128,131004429,301
"31663","ENSG00000242675","19",45332698,45333124,426
"31664","ENSG00000242683","5",139035148,139035987,839
"31665","ENSG00000242686","4",652850,656213,3363
"31666","ENSG00000242689","11",58622665,58625733,3068
"31667","ENSG00000242692","17",10258762,10259232,470
"31668","ENSG00000242696","2",202357076,202357417,341
"31669","ENSG00000242697","4",98025390,98026240,850
"31670","ENSG00000242699","2",29681027,29681323,296
"31671","ENSG00000242703","7",140997952,140999800,1848
"31672","ENSG00000242705","3",88948142,88950928,2786
"31673","ENSG00000242706","5",80498534,80498971,437
"31674","ENSG00000242707","18",13715102,13715368,266
"31675","ENSG00000242715","13",36222008,36297840,75832
"31676","ENSG00000242719","8",42881236,42881517,281
"31677","ENSG00000242728","3",70140217,70140488,271
"31678","ENSG00000242729","11",41538434,41538986,552
"31679","ENSG00000242731","7",6931684,6939603,7919
"31680","ENSG00000242732","X",72127110,72131901,4791
"31681","ENSG00000242736","7",142299177,142299460,283
"31682","ENSG00000242737","15",50466738,50467096,358
"31683","ENSG00000242741","3",73805754,73902960,97206
"31684","ENSG00000242747","15",58869659,58870134,475
"31685","ENSG00000242748","20",41196691,41197157,466
"31686","ENSG00000242752","17",19603274,19603345,71
"31687","ENSG00000242753","6",11414636,11515710,101074
"31688","ENSG00000242756","13",18837768,18838098,330
"31689","ENSG00000242759","3",106449775,107240671,790896
"31690","ENSG00000242764","1",92402389,92402685,296
"31691","ENSG00000242766","2",90082635,90083291,656
"31692","ENSG00000242767","3",115100423,115103061,2638
"31693","ENSG00000242768","4",21656511,21656869,358
"31694","ENSG00000242770","3",112802478,112812819,10341
"31695","ENSG00000242775","3",55360443,55361829,1386
"31696","ENSG00000242779","19",52966896,53037898,71002
"31697","ENSG00000242781","3",80764862,80789388,24526
"31698","ENSG00000242790","3",155291188,155294176,2988
"31699","ENSG00000242791","3",149976755,149979355,2600
"31700","ENSG00000242794","1",232222866,232223145,279
"31701","ENSG00000242795","3",169613510,169623951,10441
"31702","ENSG00000242797","3",52288580,52299067,10487
"31703","ENSG00000242798","7",100115214,100127139,11925
"31704","ENSG00000242802","7",4775615,4794397,18782
"31705","ENSG00000242808","3",180989762,181836880,847118
"31706","ENSG00000242810","3",151475804,151476174,370
"31707","ENSG00000242811","3",180736405,180736703,298
"31708","ENSG00000242814","5",124808828,124809233,405
"31709","ENSG00000242816","3",117719859,117794384,74525
"31710","ENSG00000242818","10",119768247,119768538,291
"31711","ENSG00000242828","3",80761042,80788963,27921
"31712","ENSG00000242829","3",119298665,119299012,347
"31713","ENSG00000242836","3",106896891,106897671,780
"31714","ENSG00000242837","14",103241492,103241972,480
"31715","ENSG00000242841","3",63096374,63097711,1337
"31716","ENSG00000242849","3",52193170,52194785,1615
"31717","ENSG00000242852","19",12461184,12513854,52670
"31718","ENSG00000242853","10",119212857,119213146,289
"31719","ENSG00000242855","7",39888375,39888664,289
"31720","ENSG00000242856","19",54647944,54648853,909
"31721","ENSG00000242858","5",83746388,83746989,601
"31722","ENSG00000242860","1",62072448,62072741,293
"31723","ENSG00000242861","1",225840883,225846522,5639
"31724","ENSG00000242863","15",97353497,97353815,318
"31725","ENSG00000242866","15",43599563,43618800,19237
"31726","ENSG00000242876","22",20481935,20482213,278
"31727","ENSG00000242880","3",115147605,115564389,416784
"31728","ENSG00000242882","4",173419245,173420137,892
"31729","ENSG00000242887","14",105864587,105864635,48
"31730","ENSG00000242888","14",99974336,99975149,813
"31731","ENSG00000242889","17",57618108,57618393,285
"31732","ENSG00000242893","13",51593919,51594215,296
"31733","ENSG00000242894","14",104013642,104013933,291
"31734","ENSG00000242899","3",132243528,132244265,737
"31735","ENSG00000242902","7",128850162,128862626,12464
"31736","ENSG00000242908","3",151751443,151928175,176732
"31737","ENSG00000242911","3",94935760,94936120,360
"31738","ENSG00000242912","10",114423770,114424067,297
"31739","ENSG00000242925","3",155485803,155487121,1318
"31740","ENSG00000242928","5",149722070,149722372,302
"31741","ENSG00000242931","17",76430417,76431124,707
"31742","ENSG00000242936","4",95644952,95645293,341
"31743","ENSG00000242941","14",68693090,68693583,493
"31744","ENSG00000242943","1",143487772,143488353,581
"31745","ENSG00000242945","18",53605254,53605725,471
"31746","ENSG00000242948","7",46781373,46783443,2070
"31747","ENSG00000242950","7",92468380,92477986,9606
"31748","ENSG00000242951","14",75595805,75596206,401
"31749","ENSG00000242952","14",76634775,76635661,886
"31750","ENSG00000242953","3",75395404,75395536,132
"31751","ENSG00000242958","8",28810103,28810418,315
"31752","ENSG00000242960","3",72929044,72929593,549
"31753","ENSG00000242963","12",130216807,130217157,350
"31754","ENSG00000242968","3",136808551,136809623,1072
"31755","ENSG00000242970","8",58588420,58588764,344
"31756","ENSG00000242971","18",21793883,21794159,276
"31757","ENSG00000242973","6",46670444,46688165,17721
"31758","ENSG00000242976","5",153755382,153755680,298
"31759","ENSG00000242979","5",179933805,179934196,391
"31760","ENSG00000242983","3",54047749,54048793,1044
"31761","ENSG00000242985","18",8471831,8472128,297
"31762","ENSG00000242986","12",29658376,29658798,422
"31763","ENSG00000242989","6",15112968,15113221,253
"31764","ENSG00000242990","12",57674665,57675250,585
"31765","ENSG00000242991","12",17121716,17122460,744
"31766","ENSG00000242992","3",128764466,128765018,552
"31767","ENSG00000242993","11",95963219,95963624,405
"31768","ENSG00000242999","11",74845910,74846209,299
"31769","ENSG00000243004","7",19918981,20140453,221472
"31770","ENSG00000243005","4",24563193,24563461,268
"31771","ENSG00000243007","15",72379215,72379710,495
"31772","ENSG00000243008","13",24566873,24597676,30803
"31773","ENSG00000243014","3",117026698,117027039,341
"31774","ENSG00000243016","3",127221194,127221881,687
"31775","ENSG00000243018","7",151249325,151254390,5065
"31776","ENSG00000243020","12",64867956,64868699,743
"31777","ENSG00000243022","3",128848673,128849399,726
"31778","ENSG00000243023","14",58141279,58141660,381
"31779","ENSG00000243024","12",64222337,64397065,174728
"31780","ENSG00000243025","3",158609610,158610857,1247
"31781","ENSG00000243029","2",65545401,65545696,295
"31782","ENSG00000243033","3",143503275,143504273,998
"31783","ENSG00000243035","13",77947497,77947772,275
"31784","ENSG00000243038","14",50052857,50053569,712
"31785","ENSG00000243040","Y",22308859,22321825,12966
"31786","ENSG00000243048","X",37043023,37043571,548
"31787","ENSG00000243049","17",2557753,2558094,341
"31788","ENSG00000243051","1",169957942,169958246,304
"31789","ENSG00000243053","17",28802444,28802822,378
"31790","ENSG00000243055","X",30699998,30724174,24176
"31791","ENSG00000243056","5",140547662,140549576,1914
"31792","ENSG00000243062","1",179730191,179742697,12506
"31793","ENSG00000243063","2",88978468,88979081,613
"31794","ENSG00000243064","21",14236206,14362754,126548
"31795","ENSG00000243066","19",14588357,14588656,299
"31796","ENSG00000243069","3",154024401,154121347,96946
"31797","ENSG00000243071","12",76660405,76660884,479
"31798","ENSG00000243072","3",125679573,125679781,208
"31799","ENSG00000243075","12",50841498,50841785,287
"31800","ENSG00000243081","3",112396647,112409134,12487
"31801","ENSG00000243083","3",72151236,72207776,56540
"31802","ENSG00000243089","3",99507187,99529985,22798
"31803","ENSG00000243094","15",34085911,34086314,403
"31804","ENSG00000243095","8",39157538,39158701,1163
"31805","ENSG00000243099","7",138688980,138689522,542
"31806","ENSG00000243101","16",78825281,78826006,725
"31807","ENSG00000243103","14",50637691,50637981,290
"31808","ENSG00000243104","2",120213344,120213631,287
"31809","ENSG00000243107","7",92200014,92206857,6843
"31810","ENSG00000243116","3",159721524,159722401,877
"31811","ENSG00000243122","15",37490691,37491103,412
"31812","ENSG00000243125","2",223248498,223248794,296
"31813","ENSG00000243129","12",13021260,13021606,346
"31814","ENSG00000243130","19",43007656,43026474,18818
"31815","ENSG00000243135","2",233729108,233773299,44191
"31816","ENSG00000243136","9",35671776,35672044,268
"31817","ENSG00000243137","19",43192702,43207299,14597
"31818","ENSG00000243141","12",12338776,12339254,478
"31819","ENSG00000243144","7",91311368,91515427,204059
"31820","ENSG00000243147","2",27771717,27988087,216370
"31821","ENSG00000243149","3",65174916,65193509,18593
"31822","ENSG00000243150","3",158545189,158571066,25877
"31823","ENSG00000243155","1",180944042,180976482,32440
"31824","ENSG00000243156","22",17787649,18024561,236912
"31825","ENSG00000243160","5",79529302,79530093,791
"31826","ENSG00000243167","19",42670005,42670816,811
"31827","ENSG00000243171","8",105287830,105288365,535
"31828","ENSG00000243173","1",162777730,162778014,284
"31829","ENSG00000243175","4",143424753,143426013,1260
"31830","ENSG00000243176","3",157174201,157381265,207064
"31831","ENSG00000243179","2",113979909,113983258,3349
"31832","ENSG00000243181","8",34874159,34874633,474
"31833","ENSG00000243187","3",180680084,180700449,20365
"31834","ENSG00000243188","3",108325520,108326814,1294
"31835","ENSG00000243193","7",107066591,107133733,67142
"31836","ENSG00000243197","3",116709235,116723581,14346
"31837","ENSG00000243199","4",65573459,65574328,869
"31838","ENSG00000243207","19",10106223,10114780,8557
"31839","ENSG00000243220","7",116563594,116571234,7640
"31840","ENSG00000243224","3",52239258,52241097,1839
"31841","ENSG00000243225","14",76968683,76969145,462
"31842","ENSG00000243227","4",109450772,109451068,296
"31843","ENSG00000243230","7",129209775,129213545,3770
"31844","ENSG00000243232","5",140966470,141012347,45877
"31845","ENSG00000243234","19",57953158,57953759,601
"31846","ENSG00000243236","6",52939726,52957521,17795
"31847","ENSG00000243238","2",89244781,89245596,815
"31848","ENSG00000243243","7",116237929,116327896,89967
"31849","ENSG00000243244","2",48529383,48598513,69130
"31850","ENSG00000243250","11",112235371,112236025,654
"31851","ENSG00000243254","8",99613783,99614081,298
"31852","ENSG00000243256","18",61404858,61405205,347
"31853","ENSG00000243260","4",39761000,39761298,298
"31854","ENSG00000243264","2",89947512,89948279,767
"31855","ENSG00000243265","8",23206918,23207369,451
"31856","ENSG00000243267","1",10616836,10617115,279
"31857","ENSG00000243273","3",150890636,151038818,148182
"31858","ENSG00000243274","13",76134931,76135225,294
"31859","ENSG00000243276","3",118004819,118810836,806017
"31860","ENSG00000243279","X",49071161,49074002,2841
"31861","ENSG00000243280","4",112171215,112171527,312
"31862","ENSG00000243284","1",159854316,159862657,8341
"31863","ENSG00000243287","8",108378831,108379545,714
"31864","ENSG00000243289","10",46816516,46832476,15960
"31865","ENSG00000243290","2",89040224,89040745,521
"31866","ENSG00000243295","3",59050164,59754808,704644
"31867","ENSG00000243297","19",36901742,36902117,375
"31868","ENSG00000243302","7",128651185,128652334,1149
"31869","ENSG00000243303","18",21854640,21854987,347
"31870","ENSG00000243304","5",115264669,115265464,795
"31871","ENSG00000243305","3",152457759,152496813,39054
"31872","ENSG00000243307","6",26896952,26898777,1825
"31873","ENSG00000243312","4",86870191,86871404,1213
"31874","ENSG00000243313","6",37832922,37833185,263
"31875","ENSG00000243314","3",158496561,158496934,373
"31876","ENSG00000243316","10",112308181,112356574,48393
"31877","ENSG00000243317","7",135662496,135693418,30922
"31878","ENSG00000243319","13",102292327,102394519,102192
"31879","ENSG00000243321","3",150077494,150080117,2623
"31880","ENSG00000243323","1",202168051,202189455,21404
"31881","ENSG00000243328","8",143065915,143066587,672
"31882","ENSG00000243333","5",119306343,119306631,288
"31883","ENSG00000243335","7",66628767,66649067,20300
"31884","ENSG00000243339","3",196399911,196400207,296
"31885","ENSG00000243345","7",115789729,115791049,1320
"31886","ENSG00000243347","3",148192872,148280098,87226
"31887","ENSG00000243349","10",45147394,45171389,23995
"31888","ENSG00000243352","7",104911928,104912193,265
"31889","ENSG00000243353","11",113751116,113751286,170
"31890","ENSG00000243355","18",32779039,32779286,247
"31891","ENSG00000243359","3",115837870,115838159,289
"31892","ENSG00000243364","1",155063737,155069553,5816
"31893","ENSG00000243365","15",76976915,76977210,295
"31894","ENSG00000243366","13",98671980,98672278,298
"31895","ENSG00000243368","3",183016255,183017808,1553
"31896","ENSG00000243370","17",17178414,17178749,335
"31897","ENSG00000243373","6",158437797,158438088,291
"31898","ENSG00000243374","7",148438309,148438577,268
"31899","ENSG00000243383","4",105293664,105293946,282
"31900","ENSG00000243384","3",58572744,58574319,1575
"31901","ENSG00000243388","14",56978409,56979621,1212
"31902","ENSG00000243389","2",112589040,112614431,25391
"31903","ENSG00000243396","3",101599243,101599644,401
"31904","ENSG00000243398","3",172237326,172237591,265
"31905","ENSG00000243402","8",129864478,129865052,574
"31906","ENSG00000243403","15",64592979,64593326,347
"31907","ENSG00000243404","15",66446455,66446777,322
"31908","ENSG00000243406","13",52167709,52194465,26756
"31909","ENSG00000243414","5",115578650,115602479,23829
"31910","ENSG00000243415","3",146064042,146105204,41162
"31911","ENSG00000243417","4",152551277,152552364,1087
"31912","ENSG00000243420","12",75957833,75958130,297
"31913","ENSG00000243422","3",75624275,75670156,45881
"31914","ENSG00000243423","17",35076737,35077007,270
"31915","ENSG00000243426","17",78532813,78533055,242
"31916","ENSG00000243429","3",125712139,125713045,906
"31917","ENSG00000243431","11",118560690,118561580,890
"31918","ENSG00000243433","7",151028781,151029754,973
"31919","ENSG00000243437","1",77645324,77645618,294
"31920","ENSG00000243438","7",106315225,106315743,518
"31921","ENSG00000243444","9",109640788,109951476,310688
"31922","ENSG00000243445","16",2332313,2332732,419
"31923","ENSG00000243446","10",77912271,77912545,274
"31924","ENSG00000243449","4",2041993,2043970,1977
"31925","ENSG00000243455","19",18048637,18049090,453
"31926","ENSG00000243466","2",88947301,88947957,656
"31927","ENSG00000243468","X",71491682,71492928,1246
"31928","ENSG00000243469","19",51648862,51649610,748
"31929","ENSG00000243477","3",50296402,50299421,3019
"31930","ENSG00000243478","2",200738608,200794239,55631
"31931","ENSG00000243479","7",157010805,157016426,5621
"31932","ENSG00000243480","1",103616811,103625780,8969
"31933","ENSG00000243483","3",113041390,113041814,424
"31934","ENSG00000243485","1",29554,31109,1555
"31935","ENSG00000243486","3",153881526,153940836,59310
"31936","ENSG00000243488","19",14584095,14584395,300
"31937","ENSG00000243491","2",9757496,9770341,12845
"31938","ENSG00000243494","19",54973817,54974417,600
"31939","ENSG00000243498","8",123236852,123237062,210
"31940","ENSG00000243499","12",131667492,131668246,754
"31941","ENSG00000243501","6",73209746,73263196,53450
"31942","ENSG00000243504","8",97865054,97865485,431
"31943","ENSG00000243505","11",29721399,29721684,285
"31944","ENSG00000243507","12",3468950,3469296,346
"31945","ENSG00000243508","3",125344085,125344797,712
"31946","ENSG00000243510","2",118016385,118016669,284
"31947","ENSG00000243514","17",72627231,72627624,393
"31948","ENSG00000243517","12",31251992,31252597,605
"31949","ENSG00000243518","3",155401329,155403399,2070
"31950","ENSG00000243519","22",32376682,32377135,453
"31951","ENSG00000243521","17",50847950,50849270,1320
"31952","ENSG00000243531","7",6900424,6900623,199
"31953","ENSG00000243532","8",70654578,70654883,305
"31954","ENSG00000243538","5",16902294,16902641,347
"31955","ENSG00000243541","2",15950689,15950981,292
"31956","ENSG00000243543","20",45534196,45539495,5299
"31957","ENSG00000243544","3",121653994,121654296,302
"31958","ENSG00000243546","14",68236243,68236539,296
"31959","ENSG00000243547","3",96349554,96350939,1385
"31960","ENSG00000243548","4",28711198,28711476,278
"31961","ENSG00000243550","3",150265407,150296605,31198
"31962","ENSG00000243554","7",97969005,97972254,3249
"31963","ENSG00000243560","19",46688797,46689068,271
"31964","ENSG00000243562","11",440399,440693,294
"31965","ENSG00000243566","7",76510428,76516521,6093
"31966","ENSG00000243568","15",72134641,72135436,795
"31967","ENSG00000243572","3",55178172,55189214,11042
"31968","ENSG00000243574","7",124274671,124288852,14181
"31969","ENSG00000243584","3",183613620,183616742,3122
"31970","ENSG00000243592","5",56136979,56137531,552
"31971","ENSG00000243593","3",120833440,120836360,2920
"31972","ENSG00000243601","8",105737280,105737765,485
"31973","ENSG00000243607","11",126278257,126278577,320
"31974","ENSG00000243609","16",48577524,48578369,845
"31975","ENSG00000243620","3",146909685,147370656,460971
"31976","ENSG00000243621","7",111394875,111395043,168
"31977","ENSG00000243629","3",157081667,157128595,46928
"31978","ENSG00000243633","7",21215537,21215830,293
"31979","ENSG00000243635","3",104502700,104503266,566
"31980","ENSG00000243636","1",207179296,207184062,4766
"31981","ENSG00000243641","9",36002909,36003867,958
"31982","ENSG00000243642","19",58069970,58070288,318
"31983","ENSG00000243646","21",33266367,33310187,43820
"31984","ENSG00000243648","5",134422838,134423335,497
"31985","ENSG00000243649","6",31945650,31952084,6434
"31986","ENSG00000243650","2",230507101,230507386,285
"31987","ENSG00000243655","17",22524563,22525330,767
"31988","ENSG00000243658","3",106898889,106900591,1702
"31989","ENSG00000243659","1",27311240,27311838,598
"31990","ENSG00000243660","10",43436841,43483181,46340
"31991","ENSG00000243663","12",1757231,1758011,780
"31992","ENSG00000243664","5",180945756,180945907,151
"31993","ENSG00000243667","2",68122936,68157549,34613
"31994","ENSG00000243669","11",123035867,123036224,357
"31995","ENSG00000243672","11",67925651,67926431,780
"31996","ENSG00000243674","3",75347833,75348787,954
"31997","ENSG00000243675","3",158763431,158763753,322
"31998","ENSG00000243678","17",51165435,51171747,6312
"31999","ENSG00000243679","7",128653969,128654722,753
"32000","ENSG00000243680","19",52143043,52143336,293
"32001","ENSG00000243687","3",160342685,160343015,330
"32002","ENSG00000243694","3",80993854,81105182,111328
"32003","ENSG00000243696","3",52813282,52835729,22447
"32004","ENSG00000243697","16",86525457,86526252,795
"32005","ENSG00000243701","3",107220744,107348464,127720
"32006","ENSG00000243702","20",18592330,18592619,289
"32007","ENSG00000243704","17",1604374,1604672,298
"32008","ENSG00000243705","16",87268185,87268337,152
"32009","ENSG00000243708","15",41837775,41848147,10372
"32010","ENSG00000243709","1",225886282,225911382,25100
"32011","ENSG00000243710","1",43172149,43254358,82209
"32012","ENSG00000243711","15",78863247,78863729,482
"32013","ENSG00000243715","3",54874605,54901255,26650
"32014","ENSG00000243716","16",22479121,22536521,57400
"32015","ENSG00000243720","18",3406342,3406818,476
"32016","ENSG00000243721","11",43718676,43719146,470
"32017","ENSG00000243723","2",158447166,158447461,295
"32018","ENSG00000243725","1",54715861,54742657,26796
"32019","ENSG00000243729","6",29353749,29431967,78218
"32020","ENSG00000243730","14",36577543,36578005,462
"32021","ENSG00000243733","3",143111802,143112359,557
"32022","ENSG00000243738","9",121203159,121203435,276
"32023","ENSG00000243742","11",61615036,61639449,24413
"32024","ENSG00000243744","5",13637919,13638381,462
"32025","ENSG00000243746","7",144647186,144648575,1389
"32026","ENSG00000243749","1",34981535,34985353,3818
"32027","ENSG00000243753","6",30259584,30293014,33430
"32028","ENSG00000243758","5",117301104,117301442,338
"32029","ENSG00000243759","3",143517123,143518229,1106
"32030","ENSG00000243761","8",86043102,86043507,405
"32031","ENSG00000243766","7",27198575,27207259,8684
"32032","ENSG00000243770","2",174240143,174240457,314
"32033","ENSG00000243771","19",17589595,17590071,476
"32034","ENSG00000243772","19",54738515,54753052,14537
"32035","ENSG00000243775","6",158841117,158857632,16515
"32036","ENSG00000243777","11",102295060,102295806,746
"32037","ENSG00000243779","18",13919603,13919923,320
"32038","ENSG00000243782","10",87832818,87833098,280
"32039","ENSG00000243789","15",41828092,41837581,9489
"32040","ENSG00000243792","2",158853755,158854576,821
"32041","ENSG00000243794","3",75521803,75522012,209
"32042","ENSG00000243795","3",113142350,113167819,25469
"32043","ENSG00000243797","7",106372251,106770207,397956
"32044","ENSG00000243799","3",179875376,179881609,6233
"32045","ENSG00000243801","14",56824375,56824656,281
"32046","ENSG00000243802","11",47191181,47191542,361
"32047","ENSG00000243806","5",94825961,94826694,733
"32048","ENSG00000243810","20",20258407,20267809,9402
"32049","ENSG00000243811","22",39021113,39033277,12164
"32050","ENSG00000243813","3",121099108,121099774,666
"32051","ENSG00000243817","14",20963579,20963867,288
"32052","ENSG00000243818","3",142912116,142942537,30421
"32053","ENSG00000243819","2",10690344,10692099,1755
"32054","ENSG00000243824","14",34740336,34740833,497
"32055","ENSG00000243828","6",64728837,64733837,5000
"32056","ENSG00000243829","19",49719498,49720081,583
"32057","ENSG00000243830","12",8460618,8461232,614
"32058","ENSG00000243831","6",160666228,160676523,10295
"32059","ENSG00000243832","3",134055256,134057648,2392
"32060","ENSG00000243836","7",151409161,151413354,4193
"32061","ENSG00000243838","3",161328924,161330238,1314
"32062","ENSG00000243844","8",29632091,29632644,553
"32063","ENSG00000243845","9",125512902,125513207,305
"32064","ENSG00000243847","2",23996795,23997085,290
"32065","ENSG00000243849","3",113403988,113433992,30004
"32066","ENSG00000243853","7",150541754,150542098,344
"32067","ENSG00000243854","12",19303480,19303775,295
"32068","ENSG00000243859","5",85464434,85465310,876
"32069","ENSG00000243864","19",33340686,33341984,1298
"32070","ENSG00000243870","17",78370852,78371135,283
"32071","ENSG00000243871","15",43391384,43391727,343
"32072","ENSG00000243872","1",220571739,220572035,296
"32073","ENSG00000243883","4",153381729,153382015,286
"32074","ENSG00000243885","3",149384179,149385800,1621
"32075","ENSG00000243894","4",4076711,4077491,780
"32076","ENSG00000243896","7",144257663,144264792,7129
"32077","ENSG00000243900","13",51469753,51470047,294
"32078","ENSG00000243902","22",37339583,37427445,87862
"32079","ENSG00000243904","14",103374033,103374916,883
"32080","ENSG00000243905","1",26593243,26593546,303
"32081","ENSG00000243910","2",219253243,219272188,18945
"32082","ENSG00000243911","9",112272596,112272837,241
"32083","ENSG00000243914","5",31847271,31848148,877
"32084","ENSG00000243915","3",86012561,86015120,2559
"32085","ENSG00000243916","12",15439527,15440401,874
"32086","ENSG00000243918","3",122660613,122662438,1825
"32087","ENSG00000243925","18",26098839,26099226,387
"32088","ENSG00000243926","3",156671862,156674446,2584
"32089","ENSG00000243927","21",34073224,34143034,69810
"32090","ENSG00000243943","2",27582969,27623217,40248
"32091","ENSG00000243944","3",150039214,150213726,174512
"32092","ENSG00000243951","8",80776666,80776962,296
"32093","ENSG00000243953","3",154969283,154970223,940
"32094","ENSG00000243954","16",8683254,8683551,297
"32095","ENSG00000243955","6",52791371,52803860,12489
"32096","ENSG00000243957","3",78115158,78115457,299
"32097","ENSG00000243959","5",176547433,176547726,293
"32098","ENSG00000243960","1",111438638,111441364,2726
"32099","ENSG00000243961","20",9986088,10007116,21028
"32100","ENSG00000243964","11",9606142,9606609,467
"32101","ENSG00000243967","1",108375838,108410814,34976
"32102","ENSG00000243968","19",35881890,35882153,263
"32103","ENSG00000243969","3",154827016,154861017,34001
"32104","ENSG00000243970","1",39522280,39559671,37391
"32105","ENSG00000243974","3",100225374,100226073,699
"32106","ENSG00000243976","14",100319073,100319370,297
"32107","ENSG00000243977","3",179649494,179650200,706
"32108","ENSG00000243978","X",110358816,110456334,97518
"32109","ENSG00000243979","8",94891239,94892107,868
"32110","ENSG00000243980","Y",12273473,12273764,291
"32111","ENSG00000243981","7",57628479,57645189,16710
"32112","ENSG00000243986","3",124862094,124863317,1223
"32113","ENSG00000243988","16",56906534,56906956,422
"32114","ENSG00000243989","3",51983340,51989197,5857
"32115","ENSG00000243995","20",45230868,45233331,2463
"32116","ENSG00000244002","4",80161129,80162011,882
"32117","ENSG00000244003","16",58770524,58770820,296
"32118","ENSG00000244004","4",9563171,9563950,779
"32119","ENSG00000244005","20",35668052,35699355,31303
"32120","ENSG00000244006","X",64210691,64210988,297
"32121","ENSG00000244009","3",160452598,160453403,805
"32122","ENSG00000244018","8",18774547,18774918,371
"32123","ENSG00000244020","1",237004103,237004418,315
"32124","ENSG00000244021","4",127812720,127813200,480
"32125","ENSG00000244025","21",30491464,30491985,521
"32126","ENSG00000244026","3",75421552,75435110,13558
"32127","ENSG00000244034","4",55063738,55064026,288
"32128","ENSG00000244036","7",129953234,130026989,73755
"32129","ENSG00000244038","1",20651767,20661544,9777
"32130","ENSG00000244040","3",159902045,160225299,323254
"32131","ENSG00000244041","6",2987967,2991173,3206
"32132","ENSG00000244043","16",59088837,59089091,254
"32133","ENSG00000244044","17",66364029,66364320,291
"32134","ENSG00000244045","17",28357642,28363683,6041
"32135","ENSG00000244048","3",95171920,95172377,457
"32136","ENSG00000244050","12",8199599,8218911,19312
"32137","ENSG00000244052","8",102923371,102924255,884
"32138","ENSG00000244053","14",47200575,47201104,529
"32139","ENSG00000244055","7",92457564,92495601,38037
"32140","ENSG00000244056","15",84394072,84394336,264
"32141","ENSG00000244060","12",111879338,111880249,911
"32142","ENSG00000244061","5",72381794,72382393,599
"32143","ENSG00000244062","3",133760300,133762363,2063
"32144","ENSG00000244063","2",113829390,113831119,1729
"32145","ENSG00000244065","3",128843564,128844404,840
"32146","ENSG00000244067","6",52750087,52763475,13388
"32147","ENSG00000244071","19",51621136,51621701,565
"32148","ENSG00000244073","5",37085056,37085852,796
"32149","ENSG00000244076","5",80315671,80315826,155
"32150","ENSG00000244080","19",11516047,11516330,283
"32151","ENSG00000244083","4",122815771,122816117,346
"32152","ENSG00000244086","17",38855314,38855670,356
"32153","ENSG00000244088","5",121575848,121576320,472
"32154","ENSG00000244089","3",148824782,148825387,605
"32155","ENSG00000244091","12",94515476,94515760,284
"32156","ENSG00000244094","1",153112121,153113516,1395
"32157","ENSG00000244097","17",656794,657547,753
"32158","ENSG00000244101","3",136609050,136609602,552
"32159","ENSG00000244104","9",107811616,107811914,298
"32160","ENSG00000244107","8",54420468,54420725,257
"32161","ENSG00000244112","12",118993857,118994159,302
"32162","ENSG00000244113","8",17150301,17150888,587
"32163","ENSG00000244115","9",111631386,111670229,38843
"32164","ENSG00000244116","2",89221698,89222461,763
"32165","ENSG00000244119","3",101712472,101713191,719
"32166","ENSG00000244122","2",233681938,233773299,91361
"32167","ENSG00000244124","3",141918252,141919021,769
"32168","ENSG00000244128","3",165206929,165846519,639590
"32169","ENSG00000244130","3",72006774,72006975,201
"32170","ENSG00000244131","12",8742428,8743072,644
"32171","ENSG00000244134","11",72708186,72708565,379
"32172","ENSG00000244137","1",230710698,230795492,84794
"32173","ENSG00000244139","3",120121909,120122206,297
"32174","ENSG00000244142","3",111478737,111478943,206
"32175","ENSG00000244144","3",112185480,112185998,518
"32176","ENSG00000244146","4",164920618,164921063,445
"32177","ENSG00000244151","7",151074742,151076530,1788
"32178","ENSG00000244153","3",98657802,98660570,2768
"32179","ENSG00000244155","13",18741730,18742718,988
"32180","ENSG00000244157","3",115279125,115279860,735
"32181","ENSG00000244158","6",116460739,116463692,2953
"32182","ENSG00000244159","8",53887008,53887244,236
"32183","ENSG00000244161","3",58162547,58170636,8089
"32184","ENSG00000244165","19",10111693,10115372,3679
"32185","ENSG00000244167","7",7177952,7178324,372
"32186","ENSG00000244171","3",143176327,143177617,1290
"32187","ENSG00000244176","11",62011751,62012602,851
"32188","ENSG00000244183","3",60732144,60732636,492
"32189","ENSG00000244184","17",4704230,4705529,1299
"32190","ENSG00000244187","9",136791344,136793317,1973
"32191","ENSG00000244192","5",130989897,130990428,531
"32192","ENSG00000244196","3",109471329,109471812,483
"32193","ENSG00000244197","13",21790537,21790845,308
"32194","ENSG00000244198","7",144194858,144280547,85689
"32195","ENSG00000244203","3",71289769,71305853,16084
"32196","ENSG00000244215","3",127322307,127390670,68363
"32197","ENSG00000244217","8",94352923,94353653,730
"32198","ENSG00000244218","7",128761338,128761598,260
"32199","ENSG00000244219","7",99598267,99611045,12778
"32200","ENSG00000244222","3",75598652,75599673,1021
"32201","ENSG00000244226","3",65687301,65688468,1167
"32202","ENSG00000244227","3",167864773,167924011,59238
"32203","ENSG00000244229","18",76834429,76834888,459
"32204","ENSG00000244230","9",21699314,21699596,282
"32205","ENSG00000244232","3",128785147,128785448,301
"32206","ENSG00000244234","5",178184503,178187432,2929
"32207","ENSG00000244235","8",42101318,42101836,518
"32208","ENSG00000244236","2",69516751,69517046,295
"32209","ENSG00000244239","7",8262233,8262821,588
"32210","ENSG00000244242","11",1732406,1750595,18189
"32211","ENSG00000244245","5",108593609,108593967,358
"32212","ENSG00000244247","3",182498187,182536772,38585
"32213","ENSG00000244249","3",159386756,159387440,684
"32214","ENSG00000244251","15",40480752,40481315,563
"32215","ENSG00000244256","1",63655743,63656047,304
"32216","ENSG00000244257","16",16310341,16334190,23849
"32217","ENSG00000244259","11",115950196,115950801,605
"32218","ENSG00000244260","2",9671875,9708413,36538
"32219","ENSG00000244264","13",41121876,41122171,295
"32220","ENSG00000244265","3",150761937,150873554,111617
"32221","ENSG00000244266","12",50365652,50366086,434
"32222","ENSG00000244267","11",44629357,44629674,317
"32223","ENSG00000244268","3",153156511,153161775,5264
"32224","ENSG00000244273","7",142722358,142722764,406
"32225","ENSG00000244274","20",45406057,45410610,4553
"32226","ENSG00000244278","21",25055535,25069906,14371
"32227","ENSG00000244280","2",232385750,232387457,1707
"32228","ENSG00000244283","17",6749718,6750188,470
"32229","ENSG00000244286","3",124781155,124787757,6602
"32230","ENSG00000244289","8",12628476,12629256,780
"32231","ENSG00000244292","7",141911217,141911943,726
"32232","ENSG00000244294","21",33918995,33919338,343
"32233","ENSG00000244296","22",19365766,19366044,278
"32234","ENSG00000244300","3",128489212,128502970,13758
"32235","ENSG00000244301","2",200678233,200734109,55876
"32236","ENSG00000244302","3",179898199,179921895,23696
"32237","ENSG00000244306","14",19268853,19337730,68877
"32238","ENSG00000244307","8",144785298,144785588,290
"32239","ENSG00000244308","3",120110498,120110786,288
"32240","ENSG00000244310","2",9110457,9116947,6490
"32241","ENSG00000244313","11",46428653,46429150,497
"32242","ENSG00000244314","3",195146728,195147003,275
"32243","ENSG00000244318","7",96940068,96940364,296
"32244","ENSG00000244321","3",166569693,166570763,1070
"32245","ENSG00000244326","5",74317986,74318285,299
"32246","ENSG00000244327","3",142465315,142472337,7022
"32247","ENSG00000244329","18",27355406,27355764,358
"32248","ENSG00000244331","5",157931258,157931563,305
"32249","ENSG00000244332","10",94577439,94611238,33799
"32250","ENSG00000244335","X",153666226,153666510,284
"32251","ENSG00000244342","3",62950430,63125062,174632
"32252","ENSG00000244345","3",72504806,72550552,45746
"32253","ENSG00000244346","3",182950783,182956307,5524
"32254","ENSG00000244349","6",28986800,28988536,1736
"32255","ENSG00000244355","6",31715356,31717804,2448
"32256","ENSG00000244356","10",33288304,33288601,297
"32257","ENSG00000244357","3",45742675,45742970,295
"32258","ENSG00000244361","5",10488820,10489142,322
"32259","ENSG00000244362","21",30560875,30561314,439
"32260","ENSG00000244363","5",77582376,77583122,746
"32261","ENSG00000244371","1",146957117,146957659,542
"32262","ENSG00000244372","2",160877547,160877850,303
"32263","ENSG00000244376","20",50429190,50429483,293
"32264","ENSG00000244378","16",69033675,69036042,2367
"32265","ENSG00000244380","3",48440352,48446656,6304
"32266","ENSG00000244381","3",169709295,169709765,470
"32267","ENSG00000244383","3",58607080,58644491,37411
"32268","ENSG00000244384","2",232649849,232650136,287
"32269","ENSG00000244389","1",70180144,70180440,296
"32270","ENSG00000244390","12",59020169,59020894,725
"32271","ENSG00000244391","12",94361220,94361526,306
"32272","ENSG00000244398","11",16974693,16975013,320
"32273","ENSG00000244399","2",85442495,85442791,296
"32274","ENSG00000244400","11",121250270,121250978,708
"32275","ENSG00000244402","10",37297398,37297689,291
"32276","ENSG00000244405","3",186046314,186110318,64004
"32277","ENSG00000244411","11",71527267,71528674,1407
"32278","ENSG00000244414","1",196819757,196832189,12432
"32279","ENSG00000244425","22",23879493,23879790,297
"32280","ENSG00000244432","12",68001394,68001548,154
"32281","ENSG00000244437","2",89085177,89085787,610
"32282","ENSG00000244441","3",120512850,120513188,338
"32283","ENSG00000244451","11",130082495,130082781,286
"32284","ENSG00000244459","4",1574062,1580253,6191
"32285","ENSG00000244461","3",78038705,78046794,8089
"32286","ENSG00000244462","20",35648925,35664956,16031
"32287","ENSG00000244464","3",99598064,99637308,39244
"32288","ENSG00000244468","3",149284782,149333653,48871
"32289","ENSG00000244470","4",104886118,104886955,837
"32290","ENSG00000244474","2",233718778,233773299,54521
"32291","ENSG00000244476","6",11102489,11111725,9236
"32292","ENSG00000244479","7",144300395,144356181,55786
"32293","ENSG00000244480","7",30523143,30524535,1392
"32294","ENSG00000244482","19",54236592,54242791,6199
"32295","ENSG00000244485","16",76235055,76235623,568
"32296","ENSG00000244486","22",20424815,20437826,13011
"32297","ENSG00000244490","7",105301522,105302086,564
"32298","ENSG00000244493","3",143381338,143382161,823
"32299","ENSG00000244501","5",170866835,170867144,309
"32300","ENSG00000244502","3",13476982,13480053,3071
"32301","ENSG00000244503","3",149494660,149495995,1335
"32302","ENSG00000244509","22",39014257,39020352,6095
"32303","ENSG00000244510","7",66480394,66490108,9714
"32304","ENSG00000244512","4",184278936,184279233,297
"32305","ENSG00000244513","3",69013941,69056622,42681
"32306","ENSG00000244514","17",48765554,48765847,293
"32307","ENSG00000244515","3",157162663,157163932,1269
"32308","ENSG00000244527","18",21119182,21119661,479
"32309","ENSG00000244532","12",6783854,6784161,307
"32310","ENSG00000244535","11",32758268,32758614,346
"32311","ENSG00000244538","4",22594196,22594450,254
"32312","ENSG00000244540","12",51106817,51107144,327
"32313","ENSG00000244541","3",150238519,150244232,5713
"32314","ENSG00000244544","4",152264150,152264445,295
"32315","ENSG00000244545","3",152648146,152650447,2301
"32316","ENSG00000244556","7",129028889,129030527,1638
"32317","ENSG00000244558","20",44694892,44746021,51129
"32318","ENSG00000244560","7",149285281,149297312,12031
"32319","ENSG00000244564","3",64445231,64456070,10839
"32320","ENSG00000244573","12",14356842,14365503,8661
"32321","ENSG00000244575","2",89213423,89213928,505
"32322","ENSG00000244578","3",138935189,138944020,8831
"32323","ENSG00000244582","17",21504558,21505059,501
"32324","ENSG00000244585","12",120916745,120917236,491
"32325","ENSG00000244586","3",55487699,55488308,609
"32326","ENSG00000244588","20",1226056,1296421,70365
"32327","ENSG00000244593","8",18383274,18383917,643
"32328","ENSG00000244604","17",8561230,8561576,346
"32329","ENSG00000244607","3",42708269,42773253,64984
"32330","ENSG00000244610","17",67457023,67457290,267
"32331","ENSG00000244615","13",24566843,24570728,3885
"32332","ENSG00000244617","2",69960089,69962265,2176
"32333","ENSG00000244618","6",25031009,25031287,278
"32334","ENSG00000244619","1",145892847,145893483,636
"32335","ENSG00000244620","14",105890084,105896577,6493
"32336","ENSG00000244623","7",99875987,99877057,1070
"32337","ENSG00000244624","21",30616425,30616699,274
"32338","ENSG00000244625","22",26672747,26780893,108146
"32339","ENSG00000244627","22",38335762,38398929,63167
"32340","ENSG00000244630","5",80855507,80855843,336
"32341","ENSG00000244632","3",62796124,62796419,295
"32342","ENSG00000244640","3",68633706,68634356,650
"32343","ENSG00000244641","11",123049787,123050353,566
"32344","ENSG00000244642","8",119862662,119862956,294
"32345","ENSG00000244649","17",48646923,48707346,60423
"32346","ENSG00000244650","3",148160911,148226606,65695
"32347","ENSG00000244661","7",142415224,142415666,442
"32348","ENSG00000244662","12",24642687,24643166,479
"32349","ENSG00000244668","3",150719997,150720836,839
"32350","ENSG00000244671","22",21722895,21723182,287
"32351","ENSG00000244674","3",75542149,75542929,780
"32352","ENSG00000244675","3",194496317,194501503,5186
"32353","ENSG00000244676","21",17793488,17810845,17357
"32354","ENSG00000244677","14",68149617,68149908,291
"32355","ENSG00000244681","3",95654423,95683193,28770
"32356","ENSG00000244682","1",161581339,161605662,24323
"32357","ENSG00000244687","20",50081124,50115959,34835
"32358","ENSG00000244691","14",103412119,103412761,642
"32359","ENSG00000244692","3",139609669,139609939,270
"32360","ENSG00000244693","7",144266701,144269288,2587
"32361","ENSG00000244694","6",47878028,48068689,190661
"32362","ENSG00000244699","3",75384059,75391810,7751
"32363","ENSG00000244701","7",141652381,141656810,4429
"32364","ENSG00000244703","1",207645234,207657410,12176
"32365","ENSG00000244705","15",40312352,40313289,937
"32366","ENSG00000244706","3",167866500,167950292,83792
"32367","ENSG00000244708","8",36581180,36581591,411
"32368","ENSG00000244710","6",106283413,106283711,298
"32369","ENSG00000244712","12",28564678,28565141,463
"32370","ENSG00000244716","1",108992282,108992836,554
"32371","ENSG00000244717","5",69469883,69470136,253
"32372","ENSG00000244720","3",111633672,111635089,1417
"32373","ENSG00000244722","3",110682286,110683154,868
"32374","ENSG00000244723","22",23649213,23653334,4121
"32375","ENSG00000244730","3",49775285,49775614,329
"32376","ENSG00000244731","6",31982057,32002681,20624
"32377","ENSG00000244732","3",47560229,47560524,295
"32378","ENSG00000244733","10",79660891,79677996,17105
"32379","ENSG00000244734","11",5225464,5229395,3931
"32380","ENSG00000244738","3",170656562,170662123,5561
"32381","ENSG00000244740","3",136205540,136205915,375
"32382","ENSG00000244743","12",32863118,32863433,315
"32383","ENSG00000244748","5",72314397,72314688,291
"32384","ENSG00000244752","22",25212564,25231870,19306
"32385","ENSG00000244753","17",10860535,10861462,927
"32386","ENSG00000244754","13",32432417,32538885,106468
"32387","ENSG00000244756","14",60572024,60572311,287
"32388","ENSG00000244757","9",116288618,116318689,30071
"32389","ENSG00000244791","8",126325454,126329538,4084
"32390","ENSG00000244879","15",50354959,50372202,17243
"32391","ENSG00000244921","5",134923303,134924049,746
"32392","ENSG00000244926","11",43909289,43920944,11655
"32393","ENSG00000244932","3",129381298,129394149,12851
"32394","ENSG00000244945","5",179595904,179603741,7837
"32395","ENSG00000244952","15",32613733,32615111,1378
"32396","ENSG00000244953","11",43943787,43947206,3419
"32397","ENSG00000244968","5",38556765,38671216,114451
"32398","ENSG00000244998","8",141389939,141392574,2635
"32399","ENSG00000245008","11",128614340,128686922,72582
"32400","ENSG00000245017","12",98485544,98503855,18311
"32401","ENSG00000245025","8",22984596,23019335,34739
"32402","ENSG00000245059","16",81077319,81078861,1542
"32403","ENSG00000245060","5",180830326,180839742,9416
"32404","ENSG00000245067","4",57109762,57207459,97697
"32405","ENSG00000245080","8",95066808,95073182,6374
"32406","ENSG00000245105","12",9065163,9068689,3526
"32407","ENSG00000245112","4",143513472,143514635,1163
"32408","ENSG00000245146","5",140071312,140109274,37962
"32409","ENSG00000245148","11",72700474,72705607,5133
"32410","ENSG00000245149","8",124462485,124474582,12097
"32411","ENSG00000245156","11",66269832,66278525,8693
"32412","ENSG00000245164","8",125859721,126292788,433067
"32413","ENSG00000245205","12",19456244,19457648,1404
"32414","ENSG00000245213","4",173094868,173169652,74784
"32415","ENSG00000245248","11",119364359,119526664,162305
"32416","ENSG00000245275","5",154325568,154445850,120282
"32417","ENSG00000245281","8",18084386,18097644,13258
"32418","ENSG00000245293","4",107863473,107989679,126206
"32419","ENSG00000245311","12",27389789,27446625,56836
"32420","ENSG00000245317","5",179859013,179861283,2270
"32421","ENSG00000245322","4",99950006,100195099,245093
"32422","ENSG00000245330","8",119867419,119874488,7069
"32423","ENSG00000245384","4",104490849,104734546,243697
"32424","ENSG00000245466","14",70608798,70641298,32500
"32425","ENSG00000245468","4",7093776,7103394,9618
"32426","ENSG00000245479","15",90660207,90664967,4760
"32427","ENSG00000245498","11",124800424,124834487,34063
"32428","ENSG00000245522","11",9754770,9759533,4763
"32429","ENSG00000245526","5",88507546,88691057,183511
"32430","ENSG00000245532","11",65422774,65445540,22766
"32431","ENSG00000245534","15",60479152,60630637,151485
"32432","ENSG00000245552","11",95150539,95234391,83852
"32433","ENSG00000245556","5",78342365,78360507,18142
"32434","ENSG00000245571","11",59130133,59143015,12882
"32435","ENSG00000245573","11",27506830,27698231,191401
"32436","ENSG00000245598","19",46660364,46677447,17083
"32437","ENSG00000245614","12",31019434,31073847,54413
"32438","ENSG00000245648","12",10363638,10398506,34868
"32439","ENSG00000245651","12",57869834,57896482,26648
"32440","ENSG00000245662","5",25187800,25324386,136586
"32441","ENSG00000245667","12",6543504,6544931,1427
"32442","ENSG00000245680","19",37181579,37218153,36574
"32443","ENSG00000245685","4",189764391,189940733,176342
"32444","ENSG00000245688","5",178438681,178443094,4413
"32445","ENSG00000245694","16",54845189,54929189,84000
"32446","ENSG00000245711","5",36221055,36221902,847
"32447","ENSG00000245719","15",67834310,67838879,4569
"32448","ENSG00000245729","5",8333481,8457558,124077
"32449","ENSG00000245748","4",7030554,7046231,15677
"32450","ENSG00000245750","15",69462921,69843120,380199
"32451","ENSG00000245768","16",58733910,59199395,465485
"32452","ENSG00000245812","5",159100483,159117478,16995
"32453","ENSG00000245832","11",81821272,82718299,897027
"32454","ENSG00000245848","19",33299934,33302534,2600
"32455","ENSG00000245849","15",40686183,40695107,8924
"32456","ENSG00000245857","8",6835535,6885276,49741
"32457","ENSG00000245864","5",88676033,88779088,103055
"32458","ENSG00000245869","11",118885841,118887742,1901
"32459","ENSG00000245870","4",41872747,41882955,10208
"32460","ENSG00000245888","16",27268205,27290492,22287
"32461","ENSG00000245904","12",92145573,92226557,80984
"32462","ENSG00000245910","8",66921684,66926398,4714
"32463","ENSG00000245928","4",75980790,76005942,25152
"32464","ENSG00000245937","5",127939152,128083172,144020
"32465","ENSG00000245954","4",152090459,152104720,14261
"32466","ENSG00000245958","4",119454791,119552025,97234
"32467","ENSG00000245970","8",98041726,98044121,2395
"32468","ENSG00000245975","15",58768072,58770974,2902
"32469","ENSG00000246016","5",10479371,10482309,2938
"32470","ENSG00000246022","3",126180012,126210169,30157
"32471","ENSG00000246067","11",83072052,83107789,35737
"32472","ENSG00000246082","3",131361898,131365122,3224
"32473","ENSG00000246084","14",97427071,97582146,155075
"32474","ENSG00000246089","8",6403551,6407142,3591
"32475","ENSG00000246090","4",99088805,99301356,212551
"32476","ENSG00000246095","4",13546075,13547801,1726
"32477","ENSG00000246100","11",115753889,115760646,6757
"32478","ENSG00000246115","12",8512374,8512726,352
"32479","ENSG00000246130","8",23068229,23083619,15390
"32480","ENSG00000246145","8",66419589,66428977,9388
"32481","ENSG00000246174","11",78139771,78225909,86138
"32482","ENSG00000246203","1",155614726,155660245,45519
"32483","ENSG00000246211","11",74311362,74324705,13343
"32484","ENSG00000246214","5",16615926,16681905,65979
"32485","ENSG00000246223","14",97924637,97978124,53487
"32486","ENSG00000246225","11",22829380,22945393,116013
"32487","ENSG00000246228","8",127289817,127482139,192322
"32488","ENSG00000246250","11",43827517,43880726,53209
"32489","ENSG00000246263","8",102239394,102253750,14356
"32490","ENSG00000246273","11",9758268,9811335,53067
"32491","ENSG00000246308","11",10809204,10822931,13727
"32492","ENSG00000246316","5",114475339,114668410,193071
"32493","ENSG00000246323","5",138032774,138037266,4492
"32494","ENSG00000246331","12",30755074,30780739,25665
"32495","ENSG00000246334","5",177438503,177447699,9196
"32496","ENSG00000246339","8",28690215,28702030,11815
"32497","ENSG00000246350","6",28587378,28591747,4369
"32498","ENSG00000246363","12",89010681,89309566,298885
"32499","ENSG00000246366","8",70608577,70663279,54702
"32500","ENSG00000246375","4",88284507,88331421,46914
"32501","ENSG00000246379","16",55984009,56191118,207109
"32502","ENSG00000246394","12",133030389,133037222,6833
"32503","ENSG00000246422","5",141558311,141565263,6952
"32504","ENSG00000246430","8",56496048,56559823,63775
"32505","ENSG00000246451","14",103682362,103684015,1653
"32506","ENSG00000246465","16",28284885,28292064,7179
"32507","ENSG00000246477","8",11315859,11325429,9570
"32508","ENSG00000246523","11",86955616,87021909,66293
"32509","ENSG00000246526","4",6687448,6690519,3071
"32510","ENSG00000246528","8",69834111,69854971,20860
"32511","ENSG00000246548","14",77041064,77069503,28439
"32512","ENSG00000246560","4",102828055,102844075,16020
"32513","ENSG00000246575","2",85315041,85316529,1488
"32514","ENSG00000246582","8",23224471,23230926,6455
"32515","ENSG00000246596","5",177619059,177672209,53150
"32516","ENSG00000246627","12",2676001,2691200,15199
"32517","ENSG00000246640","17",50050349,50055739,5390
"32518","ENSG00000246662","8",93213302,93700433,487131
"32519","ENSG00000246695","12",25936683,25959765,23082
"32520","ENSG00000246705","12",14774383,14778002,3619
"32521","ENSG00000246731","17",74209980,74213342,3362
"32522","ENSG00000246740","15",41972763,41999094,26331
"32523","ENSG00000246763","5",98769618,98773469,3851
"32524","ENSG00000246774","4",109303035,109316135,13100
"32525","ENSG00000246777","16",66751752,66754740,2988
"32526","ENSG00000246790","11",121447331,121453013,5682
"32527","ENSG00000246792","8",90646420,90670929,24509
"32528","ENSG00000246820","11",8169167,8178903,9736
"32529","ENSG00000246851","9",131189910,131194205,4295
"32530","ENSG00000246859","5",111510396,111739726,229330
"32531","ENSG00000246863","15",39921042,39925880,4838
"32532","ENSG00000246876","4",129612330,129771527,159197
"32533","ENSG00000246877","15",75727670,75738623,10953
"32534","ENSG00000246889","11",70372246,70398488,26242
"32535","ENSG00000246898","16",66408524,66412135,3611
"32536","ENSG00000246922","15",65092770,65115197,22427
"32537","ENSG00000246982","6",36146698,36197205,50507
"32538","ENSG00000246985","12",93542022,93571768,29746
"32539","ENSG00000247011","17",50934989,50944713,9724
"32540","ENSG00000247077","12",132710819,132722734,11915
"32541","ENSG00000247081","8",103153394,103298772,145378
"32542","ENSG00000247092","14",95521943,95534889,12946
"32543","ENSG00000247095","11",565660,568457,2797
"32544","ENSG00000247121","5",96814028,96935809,121781
"32545","ENSG00000247130","4",188140822,188143379,2557
"32546","ENSG00000247131","12",69713633,69738574,24941
"32547","ENSG00000247134","8",32927913,33045445,117532
"32548","ENSG00000247137","11",83184491,83193794,9303
"32549","ENSG00000247151","11",33161657,33191598,29941
"32550","ENSG00000247157","12",11548030,11590369,42339
"32551","ENSG00000247193","4",36244116,36274220,30104
"32552","ENSG00000247199","5",148088125,148383907,295782
"32553","ENSG00000247213","12",108434130,108515023,80893
"32554","ENSG00000247228","16",70138337,70173483,35146
"32555","ENSG00000247240","15",74461265,74513636,52371
"32556","ENSG00000247271","11",10858179,10908972,50793
"32557","ENSG00000247287","14",61294909,61322838,27929
"32558","ENSG00000247311","5",122114598,122154856,40258
"32559","ENSG00000247315","20",296968,300321,3353
"32560","ENSG00000247317","8",142981738,143018437,36699
"32561","ENSG00000247324","16",71462278,71465941,3663
"32562","ENSG00000247345","5",59039761,59063503,23742
"32563","ENSG00000247363","12",68674371,68687755,13384
"32564","ENSG00000247372","5",75320155,75336914,16759
"32565","ENSG00000247373","12",123575891,123585115,9224
"32566","ENSG00000247400","13",95648733,95676955,28222
"32567","ENSG00000247402","5",102605635,102606197,562
"32568","ENSG00000247416","11",112959279,112963460,4181
"32569","ENSG00000247473","11",3029009,3041260,12251
"32570","ENSG00000247498","12",12927726,12984645,56919
"32571","ENSG00000247516","5",8450701,8486930,36229
"32572","ENSG00000247556","15",41283990,41309737,25747
"32573","ENSG00000247570","8",69942948,69944648,1700
"32574","ENSG00000247572","5",81201341,81301565,100224
"32575","ENSG00000247595","11",18588781,18610255,21474
"32576","ENSG00000247596","3",52228612,52239158,10546
"32577","ENSG00000247624","4",14909961,15002045,92084
"32578","ENSG00000247626","2",197705369,197708387,3018
"32579","ENSG00000247627","5",134926660,134928036,1376
"32580","ENSG00000247675","11",46846412,46874421,28009
"32581","ENSG00000247679","5",177611240,177619754,8514
"32582","ENSG00000247699","5",160195744,160204826,9082
"32583","ENSG00000247708","4",4542131,4787359,245228
"32584","ENSG00000247728","15",30616998,30625773,8775
"32585","ENSG00000247735","16",29926836,29928933,2097
"32586","ENSG00000247746","X",55484616,55489202,4586
"32587","ENSG00000247763","5",43231812,43233173,1361
"32588","ENSG00000247765","15",21298233,21325241,27008
"32589","ENSG00000247774","12",47205898,47216456,10558
"32590","ENSG00000247775","4",89836408,89841978,5570
"32591","ENSG00000247796","5",53109816,53127673,17857
"32592","ENSG00000247809","15",96110040,96327361,217321
"32593","ENSG00000247810","4",37073681,37133849,60168
"32594","ENSG00000247828","5",88268891,88439337,170446
"32595","ENSG00000247853","12",6578622,6584739,6117
"32596","ENSG00000247867","11",75758455,75768647,10192
"32597","ENSG00000247872","5",816346,817001,655
"32598","ENSG00000247877","5",100428124,100535262,107138
"32599","ENSG00000247903","12",26971586,26979582,7996
"32600","ENSG00000247911","5",71537652,71537846,194
"32601","ENSG00000247925","6",11173452,11259099,85647
"32602","ENSG00000247934","12",28163298,28190738,27440
"32603","ENSG00000247950","4",109347475,109433817,86342
"32604","ENSG00000247970","14",99604556,99625740,21184
"32605","ENSG00000247982","15",57300365,57307769,7404
"32606","ENSG00000248008","12",120488079,120495946,7867
"32607","ENSG00000248015","19",1392170,1396467,4297
"32608","ENSG00000248019","4",88709298,88730103,20805
"32609","ENSG00000248027","11",100684162,100687955,3793
"32610","ENSG00000248029","5",55063179,55066230,3051
"32611","ENSG00000248049","4",67701209,68080952,379743
"32612","ENSG00000248050","8",109644115,109648084,3969
"32613","ENSG00000248079","15",35546154,35860199,314045
"32614","ENSG00000248092","5",43571594,43603230,31636
"32615","ENSG00000248098","19",41397808,41425002,27194
"32616","ENSG00000248099","19",17816512,17821574,5062
"32617","ENSG00000248100","12",27547050,27552773,5723
"32618","ENSG00000248103","5",181281375,181283652,2277
"32619","ENSG00000248106","5",140764110,140764821,711
"32620","ENSG00000248107","5",126179565,126193858,14293
"32621","ENSG00000248109","5",148221650,148243580,21930
"32622","ENSG00000248112","5",82919376,82921119,1743
"32623","ENSG00000248113","4",82580117,82581384,1267
"32624","ENSG00000248114","2",233738952,233741957,3005
"32625","ENSG00000248115","4",52945649,52958087,12438
"32626","ENSG00000248118","5",3357264,3536094,178830
"32627","ENSG00000248120","5",40967505,40967763,258
"32628","ENSG00000248121","17",30600796,30615980,15184
"32629","ENSG00000248122","4",68304343,68304939,596
"32630","ENSG00000248124","16",21796106,21820410,24304
"32631","ENSG00000248125","5",145429811,145451108,21297
"32632","ENSG00000248126","5",1598127,1598247,120
"32633","ENSG00000248127","5",76081946,76084186,2240
"32634","ENSG00000248128","4",78003143,78003439,296
"32635","ENSG00000248131","5",12574830,12804363,229533
"32636","ENSG00000248132","5",58107631,58122375,14744
"32637","ENSG00000248138","4",16400430,16512187,111757
"32638","ENSG00000248143","4",43457527,43492543,35016
"32639","ENSG00000248144","4",99336497,99352746,16249
"32640","ENSG00000248148","5",45035199,45098647,63448
"32641","ENSG00000248150","5",16373361,16440081,66720
"32642","ENSG00000248152","4",112973272,113071962,98690
"32643","ENSG00000248155","4",2607870,2608146,276
"32644","ENSG00000248159","8",30237382,30240997,3615
"32645","ENSG00000248161","4",102418602,102450010,31408
"32646","ENSG00000248162","4",164725310,164726706,1396
"32647","ENSG00000248165","4",74993877,75034824,40947
"32648","ENSG00000248167","6",30328907,30346854,17947
"32649","ENSG00000248172","17",49996889,50016844,19955
"32650","ENSG00000248174","4",174091766,174220398,128632
"32651","ENSG00000248176","4",29118304,29211696,93392
"32652","ENSG00000248180","4",87207092,87208086,994
"32653","ENSG00000248184","4",54332892,54355954,23062
"32654","ENSG00000248187","4",128567972,128570531,2559
"32655","ENSG00000248188","4",15743196,15743582,386
"32656","ENSG00000248191","4",134327063,134328798,1735
"32657","ENSG00000248192","5",82073055,82073702,647
"32658","ENSG00000248196","4",87166844,87167734,890
"32659","ENSG00000248197","4",181064089,181159149,95060
"32660","ENSG00000248200","4",110146374,110147248,874
"32661","ENSG00000248202","5",97840912,97923497,82585
"32662","ENSG00000248203","5",103246048,103253519,7471
"32663","ENSG00000248206","4",183987669,183996680,9011
"32664","ENSG00000248208","4",153658572,153659653,1081
"32665","ENSG00000248210","4",149154279,149278123,123844
"32666","ENSG00000248211","5",136214048,136222159,8111
"32667","ENSG00000248213","4",118635970,118638782,2812
"32668","ENSG00000248215","4",36496128,36641939,145811
"32669","ENSG00000248216","5",37505688,37506857,1169
"32670","ENSG00000248221","4",4476121,4481700,5579
"32671","ENSG00000248222","5",169013227,169037998,24771
"32672","ENSG00000248223","5",17353910,17354899,989
"32673","ENSG00000248227","4",38366914,38385759,18845
"32674","ENSG00000248228","4",20392154,20394856,2702
"32675","ENSG00000248229","4",164987265,164987787,522
"32676","ENSG00000248234","5",38429892,38430160,268
"32677","ENSG00000248235","8",22589274,22602084,12810
"32678","ENSG00000248238","4",19172335,19456994,284659
"32679","ENSG00000248240","5",43515274,43525310,10036
"32680","ENSG00000248242","4",104653874,104966793,312919
"32681","ENSG00000248243","3",130089433,130094304,4871
"32682","ENSG00000248245","5",133160438,133224413,63975
"32683","ENSG00000248249","4",175962061,175962485,424
"32684","ENSG00000248254","4",47556731,47560259,3528
"32685","ENSG00000248256","4",48852008,48860203,8195
"32686","ENSG00000248257","19",42839368,42855718,16350
"32687","ENSG00000248261","5",102141893,102146874,4981
"32688","ENSG00000248262","4",11914667,11919688,5021
"32689","ENSG00000248265","12",54058254,54122235,63981
"32690","ENSG00000248266","4",182144852,182190382,45530
"32691","ENSG00000248268","5",111277517,111302567,25050
"32692","ENSG00000248275","5",181261169,181272307,11138
"32693","ENSG00000248278","17",48874860,48908983,34123
"32694","ENSG00000248279","5",32947443,32962467,15024
"32695","ENSG00000248281","4",30006951,30008316,1365
"32696","ENSG00000248283","4",42561457,42562425,968
"32697","ENSG00000248285","5",63957893,63981043,23150
"32698","ENSG00000248288","5",65209921,65210948,1027
"32699","ENSG00000248290","6",32008614,32012472,3858
"32700","ENSG00000248296","5",124492775,124536348,43573
"32701","ENSG00000248300","4",11740948,11769468,28520
"32702","ENSG00000248302","4",49096,50124,1028
"32703","ENSG00000248305","4",138481255,138482096,841
"32704","ENSG00000248307","4",137978547,138131182,152635
"32705","ENSG00000248309","5",88883328,89466398,583070
"32706","ENSG00000248311","5",4775476,4805769,30293
"32707","ENSG00000248313","2",130048426,130049440,1014
"32708","ENSG00000248315","7",64105292,64105576,284
"32709","ENSG00000248318","8",120761253,120776832,15579
"32710","ENSG00000248319","4",169917761,169975904,58143
"32711","ENSG00000248322","1",225936411,225937557,1146
"32712","ENSG00000248323","5",91054834,91314547,259713
"32713","ENSG00000248327","4",165547532,165551060,3528
"32714","ENSG00000248329","4",164877178,164898965,21787
"32715","ENSG00000248332","11",8060038,8069373,9335
"32716","ENSG00000248333","1",1635227,1659012,23785
"32717","ENSG00000248334","15",28737583,28759204,21621
"32718","ENSG00000248335","4",140712168,140716081,3913
"32719","ENSG00000248336","4",62510469,62510771,302
"32720","ENSG00000248338","4",29214253,29291869,77616
"32721","ENSG00000248339","4",171289475,171298267,8792
"32722","ENSG00000248340","4",26873561,26874349,788
"32723","ENSG00000248343","4",21697450,21719026,21576
"32724","ENSG00000248346","4",146957438,146975457,18019
"32725","ENSG00000248347","8",47089572,47198861,109289
"32726","ENSG00000248349","5",35896188,35896290,102
"32727","ENSG00000248350","5",112363456,112363666,210
"32728","ENSG00000248356","4",145642336,145650624,8288
"32729","ENSG00000248358","14",21714795,21716262,1467
"32730","ENSG00000248359","5",68508223,68565515,57292
"32731","ENSG00000248360","4",14470465,14888169,417704
"32732","ENSG00000248362","5",147886086,147886878,792
"32733","ENSG00000248364","4",9459255,9460244,989
"32734","ENSG00000248367","5",180293245,180295253,2008
"32735","ENSG00000248370","4",188159705,188161157,1452
"32736","ENSG00000248371","5",72574120,72660669,86549
"32737","ENSG00000248373","4",104900125,105120000,219875
"32738","ENSG00000248374","3",143620528,143627690,7162
"32739","ENSG00000248375","4",52720081,52720831,750
"32740","ENSG00000248377","3",134385197,134385494,297
"32741","ENSG00000248378","5",31743988,31744451,463
"32742","ENSG00000248383","5",140926369,141012344,85975
"32743","ENSG00000248385","19",54069895,54081365,11470
"32744","ENSG00000248388","4",176669621,176706145,36524
"32745","ENSG00000248391","5",29304305,29396095,91790
"32746","ENSG00000248394","4",128155389,128156204,815
"32747","ENSG00000248397","4",138298856,138312658,13802
"32748","ENSG00000248399","4",2463797,2464124,327
"32749","ENSG00000248400","5",82968888,82977153,8265
"32750","ENSG00000248401","4",83247179,83248206,1027
"32751","ENSG00000248405","22",44702233,44862706,160473
"32752","ENSG00000248408","4",79663761,79696837,33076
"32753","ENSG00000248409","22",23392553,23394792,2239
"32754","ENSG00000248415","15",64528667,64529671,1004
"32755","ENSG00000248416","4",722275,724034,1759
"32756","ENSG00000248419","4",10478524,10478923,399
"32757","ENSG00000248420","4",155457961,155458640,679
"32758","ENSG00000248423","8",15688914,15689562,648
"32759","ENSG00000248424","11",5430653,5431602,949
"32760","ENSG00000248425","4",14390439,14393992,3553
"32761","ENSG00000248428","5",110970951,111008899,37948
"32762","ENSG00000248429","4",158170752,158202877,32125
"32763","ENSG00000248430","5",112452703,112452989,286
"32764","ENSG00000248431","4",162705359,162907428,202069
"32765","ENSG00000248432","4",111804418,111809694,5276
"32766","ENSG00000248434","4",135067233,135097658,30425
"32767","ENSG00000248440","5",109497877,109499108,1231
"32768","ENSG00000248441","15",95186634,95327129,140495
"32769","ENSG00000248443","5",124829472,124830290,818
"32770","ENSG00000248444","4",24771467,24772420,953
"32771","ENSG00000248445","5",116447547,116508276,60729
"32772","ENSG00000248448","4",81919995,81920387,392
"32773","ENSG00000248449","5",141426286,141429158,2872
"32774","ENSG00000248455","5",17403889,17443619,39730
"32775","ENSG00000248456","4",135112905,135123779,10874
"32776","ENSG00000248457","5",12914068,13032886,118818
"32777","ENSG00000248458","1",66665864,66677027,11163
"32778","ENSG00000248459","3",129998531,129998936,405
"32779","ENSG00000248461","5",38025568,38184717,159149
"32780","ENSG00000248464","5",44388732,44413989,25257
"32781","ENSG00000248466","4",36065060,36065726,666
"32782","ENSG00000248468","3",131502573,131520880,18307
"32783","ENSG00000248469","5",176049678,176062021,12343
"32784","ENSG00000248472","15",101976558,101979093,2535
"32785","ENSG00000248473","5",181178821,181191852,13031
"32786","ENSG00000248474","5",74084068,74103216,19148
"32787","ENSG00000248475","5",58741581,58817099,75518
"32788","ENSG00000248476","21",29351634,29361894,10260
"32789","ENSG00000248477","5",69607099,69624049,16950
"32790","ENSG00000248479","4",65702202,65705553,3351
"32791","ENSG00000248482","5",135124380,135131249,6869
"32792","ENSG00000248483","5",93733220,93741637,8417
"32793","ENSG00000248484","5",176707356,176726243,18887
"32794","ENSG00000248485","1",161258745,161285450,26705
"32795","ENSG00000248487","3",51971426,51981199,9773
"32796","ENSG00000248489","5",98929171,98995013,65842
"32797","ENSG00000248490","5",27406530,27436421,29891
"32798","ENSG00000248491","4",127094410,127470569,376159
"32799","ENSG00000248493","5",145997218,145998003,785
"32800","ENSG00000248494","4",53592956,53604047,11091
"32801","ENSG00000248498","8",46579213,46638886,59673
"32802","ENSG00000248503","X",77910741,77964890,54149
"32803","ENSG00000248505","4",57424495,57478341,53846
"32804","ENSG00000248508","15",40039242,40076539,37297
"32805","ENSG00000248510","4",96310701,96818864,508163
"32806","ENSG00000248514","5",181205361,181206120,759
"32807","ENSG00000248515","4",19455418,19938448,483030
"32808","ENSG00000248516","4",4321962,4334182,12220
"32809","ENSG00000248517","4",184988997,185005186,16189
"32810","ENSG00000248518","4",54376002,54376752,750
"32811","ENSG00000248521","4",150422645,150423642,997
"32812","ENSG00000248522","8",55449509,55455139,5630
"32813","ENSG00000248525","5",9621377,9658458,37081
"32814","ENSG00000248527","1",633696,634376,680
"32815","ENSG00000248528","5",92907180,92939591,32411
"32816","ENSG00000248529","5",61658474,61698432,39958
"32817","ENSG00000248530","3",131526447,131527179,732
"32818","ENSG00000248532","4",49523648,49523857,209
"32819","ENSG00000248533","5",37953402,37966964,13562
"32820","ENSG00000248537","5",9363275,9422481,59206
"32821","ENSG00000248538","8",9151695,9425524,273829
"32822","ENSG00000248539","5",37899363,37920869,21506
"32823","ENSG00000248540","15",74125915,74129341,3426
"32824","ENSG00000248542","5",17649046,17649643,597
"32825","ENSG00000248544","5",157375741,157384950,9209
"32826","ENSG00000248545","4",25608711,25619468,10757
"32827","ENSG00000248546","4",164197007,164197711,704
"32828","ENSG00000248548","4",155455050,155456411,1361
"32829","ENSG00000248550","14",56813183,57152177,338994
"32830","ENSG00000248551","4",175346358,175403110,56752
"32831","ENSG00000248553","11",5551662,5552563,901
"32832","ENSG00000248554","5",43511058,43521811,10753
"32833","ENSG00000248555","5",90153052,90290078,137026
"32834","ENSG00000248557","3",126624792,126626061,1269
"32835","ENSG00000248559","5",134399495,134401921,2426
"32836","ENSG00000248560","5",181114106,181115674,1568
"32837","ENSG00000248564","4",338097,338583,486
"32838","ENSG00000248565","4",124462863,124463790,927
"32839","ENSG00000248568","5",146706381,146707600,1219
"32840","ENSG00000248569","5",80351021,80351956,935
"32841","ENSG00000248571","4",152666368,152670107,3739
"32842","ENSG00000248572","5",38399814,38403471,3657
"32843","ENSG00000248576","12",54163139,54168595,5456
"32844","ENSG00000248578","8",56101199,56102267,1068
"32845","ENSG00000248583","4",49486926,49489554,2628
"32846","ENSG00000248585","8",38201699,38204238,2539
"32847","ENSG00000248586","5",57317989,57320020,2031
"32848","ENSG00000248587","5",37811589,37953827,142238
"32849","ENSG00000248588","5",92823935,92844992,21057
"32850","ENSG00000248590","4",56593004,56595681,2677
"32851","ENSG00000248592","3",52833121,52897562,64441
"32852","ENSG00000248593","12",6884682,6885786,1104
"32853","ENSG00000248596","5",176143085,176185155,42070
"32854","ENSG00000248597","5",1963346,1967251,3905
"32855","ENSG00000248599","8",101034868,101076407,41539
"32856","ENSG00000248605","5",25404733,25445925,41192
"32857","ENSG00000248607","3",126056923,126058228,1305
"32858","ENSG00000248608","4",25504997,25506675,1678
"32859","ENSG00000248610","5",130140031,130141950,1919
"32860","ENSG00000248611","4",154555208,154555985,777
"32861","ENSG00000248613","4",68900651,68900910,259
"32862","ENSG00000248616","5",136857628,136858342,714
"32863","ENSG00000248624","5",31657218,31665067,7849
"32864","ENSG00000248625","4",169832653,169833363,710
"32865","ENSG00000248626","5",159950493,159951498,1005
"32866","ENSG00000248627","4",92833685,92838842,5157
"32867","ENSG00000248629","4",156841359,156842236,877
"32868","ENSG00000248633","4",112693459,112693792,333
"32869","ENSG00000248634","5",128663978,128742829,78851
"32870","ENSG00000248635","4",68704600,68712498,7898
"32871","ENSG00000248636","12",119361247,119668079,306832
"32872","ENSG00000248637","4",172380028,172380487,459
"32873","ENSG00000248640","4",77987860,77988813,953
"32874","ENSG00000248641","4",73098822,73099145,323
"32875","ENSG00000248643","11",66616626,66646469,29843
"32876","ENSG00000248645","4",164938322,164939990,1668
"32877","ENSG00000248646","4",75361207,75434449,73242
"32878","ENSG00000248647","5",149163955,149276776,112821
"32879","ENSG00000248648","5",133003119,133003365,246
"32880","ENSG00000248654","4",25720516,25721056,540
"32881","ENSG00000248656","4",111632172,111648962,16790
"32882","ENSG00000248659","3",129632019,129632492,473
"32883","ENSG00000248663","5",117415509,117546298,130789
"32884","ENSG00000248664","5",69113112,69136394,23282
"32885","ENSG00000248668","5",41869927,41872241,2314
"32886","ENSG00000248671","11",71673885,71818238,144353
"32887","ENSG00000248672","2",159771851,159904710,132859
"32888","ENSG00000248673","5",74111690,74536976,425286
"32889","ENSG00000248676","4",99594799,99625913,31114
"32890","ENSG00000248677","5",6686325,6707711,21386
"32891","ENSG00000248682","10",48510525,48511589,1064
"32892","ENSG00000248684","5",75910565,75911867,1302
"32893","ENSG00000248685","4",34120090,34335351,215261
"32894","ENSG00000248690","8",121639293,121994185,354892
"32895","ENSG00000248692","4",62071752,62165554,93802
"32896","ENSG00000248693","5",18704433,18746173,41740
"32897","ENSG00000248694","4",182772565,182773931,1366
"32898","ENSG00000248696","5",150014785,150015154,369
"32899","ENSG00000248697","4",112455924,112457785,1861
"32900","ENSG00000248698","4",14111968,14140052,28084
"32901","ENSG00000248704","7",64104093,64105295,1202
"32902","ENSG00000248705","2",233750617,233753656,3039
"32903","ENSG00000248708","5",87665345,87733269,67924
"32904","ENSG00000248709","5",115738978,115756543,17565
"32905","ENSG00000248710","3",160227454,160449829,222375
"32906","ENSG00000248711","7",40151613,40154151,2538
"32907","ENSG00000248712","11",119189638,119196769,7131
"32908","ENSG00000248713","4",99636529,99654648,18119
"32909","ENSG00000248714","17",49361150,49369998,8848
"32910","ENSG00000248716","4",114103938,114104225,287
"32911","ENSG00000248717","5",180684766,180686546,1780
"32912","ENSG00000248719","4",80182637,80197410,14773
"32913","ENSG00000248724","3",132721750,132874223,152473
"32914","ENSG00000248725","4",85246157,85246912,755
"32915","ENSG00000248727","5",56451627,56481946,30319
"32916","ENSG00000248729","5",5395378,5395957,579
"32917","ENSG00000248730","5",38282264,38290986,8722
"32918","ENSG00000248733","5",58846885,58863414,16529
"32919","ENSG00000248734","5",96784777,96785999,1222
"32920","ENSG00000248735","4",133124104,133126063,1959
"32921","ENSG00000248736","5",2921496,2967955,46459
"32922","ENSG00000248738","8",22877972,22888022,10050
"32923","ENSG00000248740","4",103255822,103454667,198845
"32924","ENSG00000248744","4",45009540,45051652,42112
"32925","ENSG00000248746","11",66546395,66563334,16939
"32926","ENSG00000248747","4",141240739,141278789,38050
"32927","ENSG00000248749","4",84371393,84380189,8796
"32928","ENSG00000248751","22",30285238,30299482,14244
"32929","ENSG00000248752","5",125333369,126368755,1035386
"32930","ENSG00000248757","5",103528434,103541985,13551
"32931","ENSG00000248758","5",97188090,97201880,13790
"32932","ENSG00000248761","5",180967848,180968567,719
"32933","ENSG00000248762","8",95986108,95993103,6995
"32934","ENSG00000248763","4",69066395,69069888,3493
"32935","ENSG00000248764","4",146934001,146945471,11470
"32936","ENSG00000248765","5",8619178,8620310,1132
"32937","ENSG00000248767","7",290170,294422,4252
"32938","ENSG00000248769","5",69653248,69654334,1086
"32939","ENSG00000248770","4",181237358,181237564,206
"32940","ENSG00000248771","4",164754064,164803795,49731
"32941","ENSG00000248773","3",140972744,140973255,511
"32942","ENSG00000248774","4",173322206,173329694,7488
"32943","ENSG00000248777","4",10199823,10200672,849
"32944","ENSG00000248779","5",44752949,44765744,12795
"32945","ENSG00000248780","4",40786110,40786710,600
"32946","ENSG00000248781","5",56275304,56276630,1326
"32947","ENSG00000248783","5",12553890,12574637,20747
"32948","ENSG00000248785","4",109673843,109674124,281
"32949","ENSG00000248787","3",125907765,125916360,8595
"32950","ENSG00000248789","5",52008031,52080987,72956
"32951","ENSG00000248790","3",139466430,139466795,365
"32952","ENSG00000248791","5",14620020,14621313,1293
"32953","ENSG00000248794","5",81242330,81242599,269
"32954","ENSG00000248795","4",138560704,138561941,1237
"32955","ENSG00000248796","2",131201142,131202941,1799
"32956","ENSG00000248799","5",127651693,127664029,12336
"32957","ENSG00000248801","8",68302246,68331689,29443
"32958","ENSG00000248802","4",128582999,128601407,18408
"32959","ENSG00000248803","5",66622868,66623177,309
"32960","ENSG00000248809","4",146077717,146121913,44196
"32961","ENSG00000248810","4",141302910,141357096,54186
"32962","ENSG00000248813","5",31741833,31742327,494
"32963","ENSG00000248816","4",182697902,182708042,10140
"32964","ENSG00000248817","4",92182477,92184052,1575
"32965","ENSG00000248822","4",170099818,170100104,286
"32966","ENSG00000248827","5",107724961,107727117,2156
"32967","ENSG00000248830","19",34542462,34545395,2933
"32968","ENSG00000248831","4",77350370,77351235,865
"32969","ENSG00000248834","5",15384220,15384853,633
"32970","ENSG00000248837","4",22989147,23193740,204593
"32971","ENSG00000248839","3",98522570,98525334,2764
"32972","ENSG00000248840","4",3312512,3313058,546
"32973","ENSG00000248842","5",146400981,146407359,6378
"32974","ENSG00000248843","4",3323977,3324762,785
"32975","ENSG00000248844","11",70056230,70065371,9141
"32976","ENSG00000248846","5",66205120,66209893,4773
"32977","ENSG00000248848","4",74054038,74055399,1361
"32978","ENSG00000248850","3",126672106,126673223,1117
"32979","ENSG00000248851","4",16307456,16308167,711
"32980","ENSG00000248854","5",55838801,55840025,1224
"32981","ENSG00000248858","8",92699742,92879502,179760
"32982","ENSG00000248859","5",176743205,176743871,666
"32983","ENSG00000248863","4",139426299,139430884,4585
"32984","ENSG00000248866","4",52659406,52661668,2262
"32985","ENSG00000248869","4",136795919,137212799,416880
"32986","ENSG00000248870","5",82586776,82587411,635
"32987","ENSG00000248871","17",7549099,7561601,12502
"32988","ENSG00000248872","4",171040564,171059163,18599
"32989","ENSG00000248873","5",42465400,42468868,3468
"32990","ENSG00000248874","5",23951348,24178263,226915
"32991","ENSG00000248878","5",31725539,31725902,363
"32992","ENSG00000248880","4",188387471,188389666,2195
"32993","ENSG00000248884","5",68430427,68434481,4054
"32994","ENSG00000248885","5",119126782,119128444,1662
"32995","ENSG00000248886","4",69517667,69518400,733
"32996","ENSG00000248890","4",144642922,144661357,18435
"32997","ENSG00000248893","15",101954885,101956412,1527
"32998","ENSG00000248895","17",48881122,48881316,194
"32999","ENSG00000248896","8",10729314,10772910,43596
"33000","ENSG00000248898","5",52673186,52872925,199739
"33001","ENSG00000248901","5",98085866,98161352,75486
"33002","ENSG00000248903","11",71568680,71568934,254
"33003","ENSG00000248905","15",32765545,33194733,429188
"33004","ENSG00000248907","4",155461633,155462663,1030
"33005","ENSG00000248908","5",24835280,24840583,5303
"33006","ENSG00000248909","5",78644265,78644845,580
"33007","ENSG00000248912","4",156686664,156692636,5972
"33008","ENSG00000248915","4",106836498,106837601,1103
"33009","ENSG00000248916","3",129323046,129325426,2380
"33010","ENSG00000248919","7",99419749,99466197,46448
"33011","ENSG00000248923","5",134924648,134926459,1811
"33012","ENSG00000248925","5",269858,271516,1658
"33013","ENSG00000248926","4",77958000,77958780,780
"33014","ENSG00000248927","5",120781218,120790778,9560
"33015","ENSG00000248930","5",73020700,73021279,579
"33016","ENSG00000248931","5",97677547,97678681,1134
"33017","ENSG00000248932","3",139389761,139782699,392938
"33018","ENSG00000248935","5",60021249,60033020,11771
"33019","ENSG00000248936","4",37588087,37588875,788
"33020","ENSG00000248939","4",43133867,43234956,101089
"33021","ENSG00000248942","5",74258689,74321255,62566
"33022","ENSG00000248946","4",49246601,49246915,314
"33023","ENSG00000248949","5",946315,956520,10205
"33024","ENSG00000248954","17",49887598,49900893,13295
"33025","ENSG00000248956","4",77963940,77964511,571
"33026","ENSG00000248964","8",29815004,29854543,39539
"33027","ENSG00000248965","5",168993000,168995677,2677
"33028","ENSG00000248966","5",110948029,110950780,2751
"33029","ENSG00000248967","5",80746339,80746819,480
"33030","ENSG00000248968","5",10248325,10249915,1590
"33031","ENSG00000248969","5",35678484,35827018,148534
"33032","ENSG00000248971","4",102728746,102730171,1425
"33033","ENSG00000248973","5",4451930,4866311,414381
"33034","ENSG00000248975","14",29952397,30297043,344646
"33035","ENSG00000248977","4",40142198,40142365,167
"33036","ENSG00000248979","5",119132651,119132882,231
"33037","ENSG00000248980","4",176308268,176320458,12190
"33038","ENSG00000248984","4",91108023,91112790,4767
"33039","ENSG00000248988","4",159007119,159007835,716
"33040","ENSG00000248990","11",28679183,28683469,4286
"33041","ENSG00000248991","4",151919468,151943933,24465
"33042","ENSG00000248993","6",32937364,32953122,15758
"33043","ENSG00000248994","5",1931064,2119926,188862
"33044","ENSG00000248995","12",64920845,64982524,61679
"33045","ENSG00000248996","5",177494995,177503647,8652
"33046","ENSG00000248998","4",65142703,65145763,3060
"33047","ENSG00000249000","4",134759399,134817289,57890
"33048","ENSG00000249001","4",87568035,87733956,165921
"33049","ENSG00000249002","4",119006032,119006401,369
"33050","ENSG00000249003","4",190057902,190063005,5103
"33051","ENSG00000249004","4",147458724,147459321,597
"33052","ENSG00000249006","4",2088718,2090617,1899
"33053","ENSG00000249007","1",202011370,202015657,4287
"33054","ENSG00000249008","4",177242539,177248773,6234
"33055","ENSG00000249012","4",151259503,151262849,3346
"33056","ENSG00000249013","4",156006478,156006988,510
"33057","ENSG00000249014","5",76242024,76242404,380
"33058","ENSG00000249017","5",102500541,102505670,5129
"33059","ENSG00000249019","4",39713842,39714451,609
"33060","ENSG00000249020","3",131479097,131479233,136
"33061","ENSG00000249021","5",115691462,115692167,705
"33062","ENSG00000249022","4",153034211,153091563,57352
"33063","ENSG00000249023","5",85429702,85430184,482
"33064","ENSG00000249026","5",115389643,115392370,2727
"33065","ENSG00000249028","12",1380060,1391502,11442
"33066","ENSG00000249031","5",174561776,174562063,287
"33067","ENSG00000249035","5",151676945,151725473,48528
"33068","ENSG00000249036","4",77394491,77494286,99795
"33069","ENSG00000249041","4",154754756,154781873,27117
"33070","ENSG00000249042","5",80411231,80488095,76864
"33071","ENSG00000249047","4",2234251,2234499,248
"33072","ENSG00000249049","4",91319034,91325306,6272
"33073","ENSG00000249050","8",9453698,9457418,3720
"33074","ENSG00000249051","4",73777636,73778060,424
"33075","ENSG00000249053","5",12794731,12795522,791
"33076","ENSG00000249054","12",36602,38133,1531
"33077","ENSG00000249055","4",98909537,98909848,311
"33078","ENSG00000249056","4",184559175,184559783,608
"33079","ENSG00000249057","5",66662331,66662988,657
"33080","ENSG00000249061","5",86967321,87137712,170391
"33081","ENSG00000249064","4",40020240,40021517,1277
"33082","ENSG00000249065","4",99160514,99161645,1131
"33083","ENSG00000249066","4",60750575,60796103,45528
"33084","ENSG00000249068","5",109840128,109840692,564
"33085","ENSG00000249069","5",54313564,54415238,101674
"33086","ENSG00000249071","5",38345347,38346551,1204
"33087","ENSG00000249072","4",78008512,78008688,176
"33088","ENSG00000249077","4",2324467,2325082,615
"33089","ENSG00000249079","4",49212251,49212624,373
"33090","ENSG00000249082","5",135038831,135040047,1216
"33091","ENSG00000249084","4",177343004,177357032,14028
"33092","ENSG00000249085","5",72794405,72816565,22160
"33093","ENSG00000249086","11",1864177,1866667,2490
"33094","ENSG00000249087","1",23368997,23371839,2842
"33095","ENSG00000249089","5",39022411,39022558,147
"33096","ENSG00000249091","4",138277115,138281784,4669
"33097","ENSG00000249092","5",42892319,42892817,498
"33098","ENSG00000249094","12",109880676,109888467,7791
"33099","ENSG00000249096","4",184365180,184382416,17236
"33100","ENSG00000249098","3",130918226,130919120,894
"33101","ENSG00000249099","5",26382519,26399819,17300
"33102","ENSG00000249102","5",33008934,33026025,17091
"33103","ENSG00000249105","4",58117758,58118070,312
"33104","ENSG00000249106","4",175790307,175812189,21882
"33105","ENSG00000249109","5",177782197,177794396,12199
"33106","ENSG00000249112","5",124707827,124710737,2910
"33107","ENSG00000249114","5",31738269,31738660,391
"33108","ENSG00000249115","19",35612735,35625355,12620
"33109","ENSG00000249116","5",1883966,1884649,683
"33110","ENSG00000249119","5",134924123,134924644,521
"33111","ENSG00000249125","4",123490242,123522106,31864
"33112","ENSG00000249129","5",177971316,177972281,965
"33113","ENSG00000249131","5",139740951,139747406,6455
"33114","ENSG00000249138","4",184798296,184799046,750
"33115","ENSG00000249139","20",45534196,45547662,13466
"33116","ENSG00000249140","5",179572156,179572741,585
"33117","ENSG00000249141","6",166858094,166956124,98030
"33118","ENSG00000249142","5",32522758,32523865,1107
"33119","ENSG00000249145","4",8320105,8327165,7060
"33120","ENSG00000249148","4",13631820,13632599,779
"33121","ENSG00000249149","5",73382384,73410509,28125
"33122","ENSG00000249158","5",140868183,141012344,144161
"33123","ENSG00000249159","5",8387638,8457564,69926
"33124","ENSG00000249160","5",10504996,10522084,17088
"33125","ENSG00000249163","14",45083045,45083977,932
"33126","ENSG00000249166","5",10493291,10494094,803
"33127","ENSG00000249167","5",116574482,116611200,36718
"33128","ENSG00000249169","5",92654848,92679141,24293
"33129","ENSG00000249170","4",71300258,71301235,977
"33130","ENSG00000249171","4",83668510,83731755,63245
"33131","ENSG00000249173","4",184892858,184899553,6695
"33132","ENSG00000249174","5",18965861,19142346,176485
"33133","ENSG00000249175","5",94788789,94793599,4810
"33134","ENSG00000249176","17",49939122,49939819,697
"33135","ENSG00000249177","2",201554384,201556051,1667
"33136","ENSG00000249180","5",96741079,96742698,1619
"33137","ENSG00000249183","5",69068925,69069200,275
"33138","ENSG00000249184","4",151798917,151833097,34180
"33139","ENSG00000249186","5",177856262,177871227,14965
"33140","ENSG00000249188","8",8154308,8216916,62608
"33141","ENSG00000249189","19",54246101,54247322,1221
"33142","ENSG00000249192","5",134928393,134928527,134
"33143","ENSG00000249196","12",129109629,129113294,3665
"33144","ENSG00000249197","1",159405423,159406409,986
"33145","ENSG00000249198","5",57751192,57751717,525
"33146","ENSG00000249199","5",17367588,17375653,8065
"33147","ENSG00000249201","5",1173141,1178605,5464
"33148","ENSG00000249203","5",44495099,44658569,163470
"33149","ENSG00000249207","4",39066974,39182258,115284
"33150","ENSG00000249210","19",46558641,46559642,1001
"33151","ENSG00000249212","4",42029209,42030123,914
"33152","ENSG00000249215","5",139494256,139496116,1860
"33153","ENSG00000249216","4",41688858,41692797,3939
"33154","ENSG00000249219","4",9922814,9924146,1332
"33155","ENSG00000249222","22",42639803,42640601,798
"33156","ENSG00000249225","3",98099908,98148134,48226
"33157","ENSG00000249226","5",29001760,29003357,1597
"33158","ENSG00000249228","4",29046591,29048765,2174
"33159","ENSG00000249231","16",52552084,52652132,100048
"33160","ENSG00000249234","4",16178939,16183120,4181
"33161","ENSG00000249235","4",68861332,68861610,278
"33162","ENSG00000249237","1",84344678,84349939,5261
"33163","ENSG00000249238","5",67636382,67638942,2560
"33164","ENSG00000249239","4",92821986,92822918,932
"33165","ENSG00000249240","15",64841883,64930920,89037
"33166","ENSG00000249241","4",40316485,40330419,13934
"33167","ENSG00000249242","4",82483170,82562357,79187
"33168","ENSG00000249244","4",119391831,119395335,3504
"33169","ENSG00000249245","4",145624159,145626035,1876
"33170","ENSG00000249247","4",155451617,155452405,788
"33171","ENSG00000249249","5",115602057,115623897,21840
"33172","ENSG00000249252","4",15004942,15427914,422972
"33173","ENSG00000249256","4",24658072,24658375,303
"33174","ENSG00000249258","8",17131181,17149789,18608
"33175","ENSG00000249261","5",124868972,124869914,942
"33176","ENSG00000249263","22",16653892,16659628,5736
"33177","ENSG00000249264","4",105484698,105486080,1382
"33178","ENSG00000249266","5",41967139,41968366,1227
"33179","ENSG00000249267","12",125958688,125983665,24977
"33180","ENSG00000249269","4",188757678,188779343,21665
"33181","ENSG00000249270","5",51930808,51932036,1228
"33182","ENSG00000249271","15",65816302,65817481,1179
"33183","ENSG00000249272","4",8959628,8963981,4353
"33184","ENSG00000249274","3",98782188,98783193,1005
"33185","ENSG00000249275","4",157637687,157667044,29357
"33186","ENSG00000249277","4",25686202,25686458,256
"33187","ENSG00000249278","4",76509284,76509719,435
"33188","ENSG00000249279","5",61201304,61304811,103507
"33189","ENSG00000249283","4",102961956,102963327,1371
"33190","ENSG00000249284","4",175286605,175290767,4162
"33191","ENSG00000249286","5",43586918,43588223,1305
"33192","ENSG00000249287","5",180967189,180970762,3573
"33193","ENSG00000249288","22",16645695,16646581,886
"33194","ENSG00000249289","5",23329427,23329892,465
"33195","ENSG00000249290","3",140449435,140460351,10916
"33196","ENSG00000249293","5",73778039,73786491,8452
"33197","ENSG00000249295","5",69477472,69502466,24994
"33198","ENSG00000249297","4",171536034,171638763,102729
"33199","ENSG00000249302","4",139546266,139546727,461
"33200","ENSG00000249304","4",113943256,113944320,1064
"33201","ENSG00000249306","5",174336295,174532457,196162
"33202","ENSG00000249307","4",78939485,79309673,370188
"33203","ENSG00000249309","4",153720327,153727722,7395
"33204","ENSG00000249310","22",38991559,38998209,6650
"33205","ENSG00000249311","4",136355110,136356336,1226
"33206","ENSG00000249312","5",130529419,130529889,470
"33207","ENSG00000249316","8",11281364,11282501,1137
"33208","ENSG00000249317","4",148940941,148942415,1474
"33209","ENSG00000249318","5",111265809,111270089,4280
"33210","ENSG00000249319","7",66087761,66152277,64516
"33211","ENSG00000249320","4",25472517,25473815,1298
"33212","ENSG00000249326","5",1887332,1900493,13161
"33213","ENSG00000249328","8",79769372,79871759,102387
"33214","ENSG00000249330","4",46390255,46510194,119939
"33215","ENSG00000249334","4",10685003,10697661,12658
"33216","ENSG00000249335","5",68792609,69007185,214576
"33217","ENSG00000249337","4",49588772,49589529,757
"33218","ENSG00000249341","4",53659208,53737156,77948
"33219","ENSG00000249343","5",74321293,74341236,19943
"33220","ENSG00000249345","12",126915199,127060565,145366
"33221","ENSG00000249346","6",33867506,33896914,29408
"33222","ENSG00000249348","4",39528019,39594707,66688
"33223","ENSG00000249349","5",85112342,85112756,414
"33224","ENSG00000249351","4",65216616,65217433,817
"33225","ENSG00000249352","5",68970692,69030165,59473
"33226","ENSG00000249353","5",93682838,93683667,829
"33227","ENSG00000249359","5",21323873,21341375,17502
"33228","ENSG00000249360","5",33502072,33503135,1063
"33229","ENSG00000249363","5",145728360,145729349,989
"33230","ENSG00000249364","5",67379378,67806600,427222
"33231","ENSG00000249367","4",159026139,159026527,388
"33232","ENSG00000249372","5",78222184,78222517,333
"33233","ENSG00000249373","4",113031287,113034551,3264
"33234","ENSG00000249375","8",127686343,127733967,47624
"33235","ENSG00000249378","4",188400736,188681051,280315
"33236","ENSG00000249379","6",53503109,53507660,4551
"33237","ENSG00000249381","4",138425523,138436869,11346
"33238","ENSG00000249382","4",58939288,58988182,48894
"33239","ENSG00000249383","17",51312609,51335165,22556
"33240","ENSG00000249386","4",155458870,155459563,693
"33241","ENSG00000249388","12",54081736,54102699,20963
"33242","ENSG00000249392","4",59551142,59630324,79182
"33243","ENSG00000249395","8",75223127,75324741,101614
"33244","ENSG00000249396","5",10493291,10502728,9437
"33245","ENSG00000249400","5",123468781,123469429,648
"33246","ENSG00000249405","5",50858760,50860020,1260
"33247","ENSG00000249406","17",50199876,50215922,16046
"33248","ENSG00000249407","3",136959125,136982196,23071
"33249","ENSG00000249409","4",120639090,120650796,11706
"33250","ENSG00000249412","5",179963615,179964419,804
"33251","ENSG00000249413","4",65998846,66150012,151166
"33252","ENSG00000249416","4",131768233,131768578,345
"33253","ENSG00000249417","3",141267353,141367137,99784
"33254","ENSG00000249418","5",130598348,130598779,431
"33255","ENSG00000249419","4",162022733,162047567,24834
"33256","ENSG00000249421","5",129424782,129461076,36294
"33257","ENSG00000249426","5",118760474,118785459,24985
"33258","ENSG00000249429","5",143489855,143531350,41495
"33259","ENSG00000249436","5",57574027,57619816,45789
"33260","ENSG00000249437","5",70968483,71025114,56631
"33261","ENSG00000249439","5",111846050,111846566,516
"33262","ENSG00000249443","4",9521910,9522276,366
"33263","ENSG00000249444","5",99489559,99499367,9808
"33264","ENSG00000249446","14",22476306,22476362,56
"33265","ENSG00000249448","5",98410235,98411792,1557
"33266","ENSG00000249449","5",163039291,163039599,308
"33267","ENSG00000249451","17",50503412,50508328,4916
"33268","ENSG00000249453","4",23779590,23782560,2970
"33269","ENSG00000249454","5",55073015,55096553,23538
"33270","ENSG00000249456","10",124917143,124942881,25738
"33271","ENSG00000249458","4",176866614,176875457,8843
"33272","ENSG00000249459","17",18658429,18682259,23830
"33273","ENSG00000249460","4",181260442,181265145,4703
"33274","ENSG00000249462","4",189973599,189973847,248
"33275","ENSG00000249463","4",132027175,132028434,1259
"33276","ENSG00000249464","4",123539026,123962698,423672
"33277","ENSG00000249465","4",109346326,109347459,1133
"33278","ENSG00000249467","X",36719918,36720221,303
"33279","ENSG00000249471","19",58451611,58457833,6222
"33280","ENSG00000249472","4",68614419,68615013,594
"33281","ENSG00000249476","5",109237120,109326369,89249
"33282","ENSG00000249478","5",133243764,133248781,5017
"33283","ENSG00000249479","4",156642580,156643569,989
"33284","ENSG00000249481","6",44342660,44377167,34507
"33285","ENSG00000249482","4",9229641,9231233,1592
"33286","ENSG00000249483","5",81851601,81852201,600
"33287","ENSG00000249484","5",152618965,153223543,604578
"33288","ENSG00000249485","5",14797125,14798400,1275
"33289","ENSG00000249487","15",88585566,88605110,19544
"33290","ENSG00000249488","4",17552117,17552752,635
"33291","ENSG00000249489","11",88408179,88409223,1044
"33292","ENSG00000249490","5",20606710,20616441,9731
"33293","ENSG00000249491","5",38425036,38427376,2340
"33294","ENSG00000249492","5",43483913,43509356,25443
"33295","ENSG00000249493","21",14064325,14069087,4762
"33296","ENSG00000249494","5",119006347,119070902,64555
"33297","ENSG00000249497","17",49457861,49461749,3888
"33298","ENSG00000249500","4",165684639,165762778,78139
"33299","ENSG00000249502","4",17586267,17614585,28318
"33300","ENSG00000249503","5",148221360,148221642,282
"33301","ENSG00000249505","3",129045763,129046921,1158
"33302","ENSG00000249506","4",16360686,16397323,36637
"33303","ENSG00000249509","4",112515385,112546881,31496
"33304","ENSG00000249510","8",94201913,94203052,1139
"33305","ENSG00000249513","4",132985510,132988677,3167
"33306","ENSG00000249515","5",99549432,99577957,28525
"33307","ENSG00000249516","5",42917414,42917984,570
"33308","ENSG00000249518","5",147851644,147852659,1015
"33309","ENSG00000249520","4",185064981,185065323,342
"33310","ENSG00000249521","5",4773481,4774865,1384
"33311","ENSG00000249522","4",3910283,3910604,321
"33312","ENSG00000249526","5",139684645,139745010,60365
"33313","ENSG00000249532","4",112646476,112650051,3575
"33314","ENSG00000249534","4",38420662,38523180,102518
"33315","ENSG00000249539","4",186900540,186900838,298
"33316","ENSG00000249540","3",141307612,141307933,321
"33317","ENSG00000249541","5",2787451,2788549,1098
"33318","ENSG00000249545","5",94979151,94980893,1742
"33319","ENSG00000249547","4",23234625,23285573,50948
"33320","ENSG00000249550","12",113583886,113773726,189840
"33321","ENSG00000249551","5",118575575,118581324,5749
"33322","ENSG00000249553","5",146914207,146919506,5299
"33323","ENSG00000249558","3",126766434,126767475,1041
"33324","ENSG00000249562","5",24578294,24578561,267
"33325","ENSG00000249563","4",9733370,9742361,8991
"33326","ENSG00000249565","4",78180866,78182046,1180
"33327","ENSG00000249568","4",161378953,161388417,9464
"33328","ENSG00000249572","5",33424025,33440619,16594
"33329","ENSG00000249574","7",379359,382712,3353
"33330","ENSG00000249577","5",127465822,127466118,296
"33331","ENSG00000249579","5",63022919,63023489,570
"33332","ENSG00000249580","3",106897671,106898268,597
"33333","ENSG00000249581","4",17515165,17527104,11939
"33334","ENSG00000249582","5",117778826,117779532,706
"33335","ENSG00000249584","5",57890327,57899162,8835
"33336","ENSG00000249588","5",68523878,68530007,6129
"33337","ENSG00000249592","4",760202,781859,21657
"33338","ENSG00000249593","5",139012647,139051203,38556
"33339","ENSG00000249599","4",94743668,94757681,14013
"33340","ENSG00000249601","5",170191579,170199141,7562
"33341","ENSG00000249602","1",151763384,151769501,6117
"33342","ENSG00000249604","4",107936031,107941255,5224
"33343","ENSG00000249605","5",144369334,144385310,15976
"33344","ENSG00000249609","4",168828919,168832937,4018
"33345","ENSG00000249610","5",122154496,122156015,1519
"33346","ENSG00000249613","4",106433489,106453449,19960
"33347","ENSG00000249614","4",103961616,104037543,75927
"33348","ENSG00000249616","5",26739753,26741183,1430
"33349","ENSG00000249618","4",129771596,129975329,203733
"33350","ENSG00000249619","5",111572102,111572239,137
"33351","ENSG00000249621","5",122321291,122323358,2067
"33352","ENSG00000249623","4",168647896,168648587,691
"33353","ENSG00000249624","21",33229901,33297160,67259
"33354","ENSG00000249626","3",197634315,197635811,1496
"33355","ENSG00000249628","12",1500525,1504424,3899
"33356","ENSG00000249631","4",11625714,11823906,198192
"33357","ENSG00000249633","11",5527277,5528174,897
"33358","ENSG00000249634","Y",18490915,18494295,3380
"33359","ENSG00000249635","4",106003317,106022478,19161
"33360","ENSG00000249637","5",140370891,140401460,30569
"33361","ENSG00000249638","5",7362979,7364531,1552
"33362","ENSG00000249639","5",135450613,135458697,8084
"33363","ENSG00000249641","12",53935328,53939643,4315
"33364","ENSG00000249642","4",187613708,187712329,98621
"33365","ENSG00000249646","4",79587302,79588130,828
"33366","ENSG00000249647","5",135236234,135248179,11945
"33367","ENSG00000249650","5",602620,612210,9590
"33368","ENSG00000249654","19",54320204,54321212,1008
"33369","ENSG00000249655","5",80630313,80631590,1277
"33370","ENSG00000249661","4",140641840,140645489,3649
"33371","ENSG00000249662","5",17444010,17486829,42819
"33372","ENSG00000249664","5",83012285,83013109,824
"33373","ENSG00000249667","4",38509767,38518056,8289
"33374","ENSG00000249669","5",149406689,149432835,26146
"33375","ENSG00000249673","4",2934882,2961738,26856
"33376","ENSG00000249675","4",166388701,166526119,137418
"33377","ENSG00000249678","4",30776257,30793970,17713
"33378","ENSG00000249679","4",185471461,185507055,35594
"33379","ENSG00000249680","22",21065462,21070097,4635
"33380","ENSG00000249681","4",109879070,109879897,827
"33381","ENSG00000249684","5",177950335,177963960,13625
"33382","ENSG00000249685","4",39133913,39135608,1695
"33383","ENSG00000249688","5",31754219,31754656,437
"33384","ENSG00000249690","4",150579089,150581545,2456
"33385","ENSG00000249691","3",134510531,134511413,882
"33386","ENSG00000249692","4",154770568,154770916,348
"33387","ENSG00000249693","4",56530609,56603507,72898
"33388","ENSG00000249695","12",137411,149169,11758
"33389","ENSG00000249697","5",56313905,56321397,7492
"33390","ENSG00000249698","4",155457180,155457960,780
"33391","ENSG00000249699","4",27217479,27282225,64746
"33392","ENSG00000249700","4",55363971,55395847,31876
"33393","ENSG00000249706","4",53899871,53916835,16964
"33394","ENSG00000249708","4",151887543,151891263,3720
"33395","ENSG00000249709","19",12525373,12551542,26169
"33396","ENSG00000249710","4",100190033,100215505,25472
"33397","ENSG00000249713","5",76606608,76608970,2362
"33398","ENSG00000249715","2",96642737,96704887,62150
"33399","ENSG00000249717","4",74955974,74970362,14388
"33400","ENSG00000249721","5",67692812,67693200,388
"33401","ENSG00000249722","5",174329612,174330503,891
"33402","ENSG00000249725","3",133015004,133037052,22048
"33403","ENSG00000249727","4",54836041,54845470,9429
"33404","ENSG00000249729","4",44840380,44841402,1022
"33405","ENSG00000249730","1",159432204,159433138,934
"33406","ENSG00000249731","5",1968094,1969013,919
"33407","ENSG00000249736","5",67632266,67646789,14523
"33408","ENSG00000249737","5",16428536,16432436,3900
"33409","ENSG00000249738","5",159310745,159805536,494791
"33410","ENSG00000249740","5",38682581,38845829,163248
"33411","ENSG00000249741","4",143911514,143912053,539
"33412","ENSG00000249742","4",186979490,187027451,47961
"33413","ENSG00000249743","5",73213930,73295258,81328
"33414","ENSG00000249746","5",96213346,96215075,1729
"33415","ENSG00000249747","4",187201986,187209346,7360
"33416","ENSG00000249748","5",35938822,35939993,1171
"33417","ENSG00000249751","5",139448560,139462743,14183
"33418","ENSG00000249752","4",149027445,149062522,35077
"33419","ENSG00000249753","12",63623788,63795718,171930
"33420","ENSG00000249755","4",88527160,88528170,1010
"33421","ENSG00000249763","4",69242628,69250815,8187
"33422","ENSG00000249764","4",98713804,98713971,167
"33423","ENSG00000249767","4",9079023,9141608,62585
"33424","ENSG00000249768","5",126737438,126737995,557
"33425","ENSG00000249771","4",41883060,41935075,52015
"33426","ENSG00000249772","5",81113385,81114852,1467
"33427","ENSG00000249773","7",55887277,55955239,67962
"33428","ENSG00000249774","5",31923367,31923532,165
"33429","ENSG00000249776","5",92410256,92660863,250607
"33430","ENSG00000249779","5",43206709,43207811,1102
"33431","ENSG00000249780","4",12640298,12640637,339
"33432","ENSG00000249781","5",9641305,9903852,262547
"33433","ENSG00000249782","5",8525144,8561682,36538
"33434","ENSG00000249784","4",1974636,1974760,124
"33435","ENSG00000249785","5",28285964,28287807,1843
"33436","ENSG00000249786","3",15436171,15455940,19769
"33437","ENSG00000249787","5",100399047,100526912,127865
"33438","ENSG00000249790","12",8788253,8795789,7536
"33439","ENSG00000249791","5",115188563,115188932,369
"33440","ENSG00000249792","5",85212958,85213614,656
"33441","ENSG00000249795","4",127498327,127498807,480
"33442","ENSG00000249797","5",117730515,118266267,535752
"33443","ENSG00000249798","1",119538509,119545913,7404
"33444","ENSG00000249799","4",9583942,9584131,189
"33445","ENSG00000249803","5",136466645,136521432,54787
"33446","ENSG00000249806","4",142566019,142660950,94931
"33447","ENSG00000249807","5",10137138,10138365,1227
"33448","ENSG00000249808","5",3177835,3181487,3652
"33449","ENSG00000249815","4",111826881,112072698,245817
"33450","ENSG00000249816","8",124823702,124962531,138829
"33451","ENSG00000249818","4",151904932,151928710,23778
"33452","ENSG00000249820","3",133409955,133410843,888
"33453","ENSG00000249825","5",80052374,80083654,31280
"33454","ENSG00000249828","4",49203171,49203726,555
"33455","ENSG00000249829","5",79191549,79191747,198
"33456","ENSG00000249830","5",3452816,3461660,8844
"33457","ENSG00000249833","3",126393032,126394851,1819
"33458","ENSG00000249834","5",148307298,148308258,960
"33459","ENSG00000249835","5",83531352,83581320,49968
"33460","ENSG00000249837","4",124149377,124252044,102667
"33461","ENSG00000249839","15",43663654,43684339,20685
"33462","ENSG00000249840","19",11585246,11587135,1889
"33463","ENSG00000249842","5",85446974,85447758,784
"33464","ENSG00000249844","4",4174319,4175238,919
"33465","ENSG00000249846","3",130111669,130201336,89667
"33466","ENSG00000249847","4",134932889,134934131,1242
"33467","ENSG00000249848","8",10336782,10337677,895
"33468","ENSG00000249849","5",177682294,177713969,31675
"33469","ENSG00000249850","5",36885206,36886497,1291
"33470","ENSG00000249851","5",138266996,138267757,761
"33471","ENSG00000249852","7",227554,229557,2003
"33472","ENSG00000249853","6",114055586,114343045,287459
"33473","ENSG00000249854","5",20305565,20347972,42407
"33474","ENSG00000249855","5",43495073,43496454,1381
"33475","ENSG00000249856","5",74917726,75023928,106202
"33476","ENSG00000249857","5",82940458,82940983,525
"33477","ENSG00000249858","4",76344550,76345590,1040
"33478","ENSG00000249859","8",127794526,128187101,392575
"33479","ENSG00000249860","10",55599303,55600041,738
"33480","ENSG00000249863","4",37868292,37869978,1686
"33481","ENSG00000249865","5",7367929,7373074,5145
"33482","ENSG00000249866","4",9512905,9513874,969
"33483","ENSG00000249867","11",28702607,29064322,361715
"33484","ENSG00000249868","8",311133,331026,19893
"33485","ENSG00000249869","3",130013182,130013541,359
"33486","ENSG00000249870","17",51042524,51085471,42947
"33487","ENSG00000249873","12",126869010,126874725,5715
"33488","ENSG00000249875","4",174354854,174376445,21591
"33489","ENSG00000249876","5",179939457,179940132,675
"33490","ENSG00000249877","4",189288677,189291336,2659
"33491","ENSG00000249881","5",143605628,143828772,223144
"33492","ENSG00000249882","4",31506422,31558831,52409
"33493","ENSG00000249884","2",86505668,86721122,215454
"33494","ENSG00000249885","4",105561591,105570238,8647
"33495","ENSG00000249889","8",12178697,12182719,4022
"33496","ENSG00000249892","4",59767816,59792114,24298
"33497","ENSG00000249894","5",67800740,67890096,89356
"33498","ENSG00000249896","4",6200733,6239937,39204
"33499","ENSG00000249898","8",6617310,6708224,90914
"33500","ENSG00000249899","5",52930606,52990278,59672
"33501","ENSG00000249906","17",49505657,49574064,68407
"33502","ENSG00000249908","5",767382,768930,1548
"33503","ENSG00000249910","11",48945694,48951895,6201
"33504","ENSG00000249912","7",142695699,142696183,484
"33505","ENSG00000249915","5",271621,314974,43353
"33506","ENSG00000249916","5",122369762,122383568,13806
"33507","ENSG00000249917","8",115950511,116325062,374551
"33508","ENSG00000249920","4",73938604,73939558,954
"33509","ENSG00000249921","5",108784098,108785552,1454
"33510","ENSG00000249923","22",20198729,20204918,6189
"33511","ENSG00000249924","4",155286162,155287136,974
"33512","ENSG00000249926","12",131662596,131664704,2108
"33513","ENSG00000249928","5",14874400,14874711,311
"33514","ENSG00000249930","4",15492729,15492972,243
"33515","ENSG00000249931","15",32392782,32403292,10510
"33516","ENSG00000249934","4",88508591,88510403,1812
"33517","ENSG00000249936","4",46723830,46724408,578
"33518","ENSG00000249937","5",17684584,17955857,271273
"33519","ENSG00000249941","5",4866521,4874759,8238
"33520","ENSG00000249942","4",74552584,74589481,36897
"33521","ENSG00000249944","5",115489634,115489931,297
"33522","ENSG00000249945","4",175457726,175473197,15471
"33523","ENSG00000249947","5",112885094,112885745,651
"33524","ENSG00000249948","4",22692914,22819575,126661
"33525","ENSG00000249951","4",94675245,94702570,27325
"33526","ENSG00000249955","4",169981744,169994488,12744
"33527","ENSG00000249956","4",69408828,69423164,14336
"33528","ENSG00000249958","5",92889387,92890840,1453
"33529","ENSG00000249959","5",107699392,107716841,17449
"33530","ENSG00000249960","4",82571137,82571814,677
"33531","ENSG00000249961","16",66754976,66801620,46644
"33532","ENSG00000249963","5",99996547,99997932,1385
"33533","ENSG00000249965","4",109555170,109555732,562
"33534","ENSG00000249966","5",1850950,1851497,547
"33535","ENSG00000249967","10",97584374,97673910,89536
"33536","ENSG00000249970","4",73543822,73544013,191
"33537","ENSG00000249973","4",87785920,87786371,451
"33538","ENSG00000249976","4",73337233,73337771,538
"33539","ENSG00000249978","7",38335041,38335514,473
"33540","ENSG00000249981","5",71445616,71446569,953
"33541","ENSG00000249984","5",92675956,92688254,12298
"33542","ENSG00000249986","3",141600276,141600579,303
"33543","ENSG00000249987","19",34022656,34023427,771
"33544","ENSG00000249988","4",14164455,14242813,78358
"33545","ENSG00000249992","3",45224466,45226278,1812
"33546","ENSG00000249993","3",133429269,133455776,26507
"33547","ENSG00000249994","5",4033713,4041764,8051
"33548","ENSG00000249996","5",123036271,123054667,18396
"33549","ENSG00000249998","4",16973275,17073903,100628
"33550","ENSG00000250001","5",9519853,9523178,3325
"33551","ENSG00000250006","4",77311397,77312111,714
"33552","ENSG00000250007","15",34755084,34813505,58421
"33553","ENSG00000250011","2",230515023,230515638,615
"33554","ENSG00000250012","3",126083659,126095349,11690
"33555","ENSG00000250015","5",116302354,116304134,1780
"33556","ENSG00000250016","4",49233289,49233965,676
"33557","ENSG00000250017","5",45574590,45576612,2022
"33558","ENSG00000250021","15",89834308,89912882,78574
"33559","ENSG00000250024","4",188990715,189002075,11360
"33560","ENSG00000250025","5",146307098,146376963,69865
"33561","ENSG00000250026","4",68184081,68218080,33999
"33562","ENSG00000250027","4",163108785,163119965,11180
"33563","ENSG00000250030","4",67446267,67446574,307
"33564","ENSG00000250031","8",58424588,58426685,2097
"33565","ENSG00000250032","5",37939365,37947955,8590
"33566","ENSG00000250033","4",138057464,138178177,120713
"33567","ENSG00000250037","5",8455946,8456558,612
"33568","ENSG00000250038","4",28343862,28402936,59074
"33569","ENSG00000250039","4",21949015,22330330,381315
"33570","ENSG00000250041","11",10884158,10899364,15206
"33571","ENSG00000250042","4",187370648,187371921,1273
"33572","ENSG00000250043","4",173877471,173913252,35781
"33573","ENSG00000250045","5",112777630,112778161,531
"33574","ENSG00000250046","4",112693047,112706810,13763
"33575","ENSG00000250048","5",39892138,40053324,161186
"33576","ENSG00000250049","5",92082597,92479426,396829
"33577","ENSG00000250050","4",25718082,25719745,1663
"33578","ENSG00000250053","4",190037916,190038399,483
"33579","ENSG00000250056","5",6582136,6600288,18152
"33580","ENSG00000250057","4",83233512,83247213,13701
"33581","ENSG00000250060","5",6868554,6888087,19533
"33582","ENSG00000250062","4",86117912,86219926,102014
"33583","ENSG00000250064","4",28435449,28600275,164826
"33584","ENSG00000250066","5",68963246,68967845,4599
"33585","ENSG00000250067","19",19528861,19537581,8720
"33586","ENSG00000250068","9",112581779,112582590,811
"33587","ENSG00000250069","5",140200163,140203187,3024
"33588","ENSG00000250071","5",74798994,74800100,1106
"33589","ENSG00000250072","5",149063254,149129578,66324
"33590","ENSG00000250073","11",124759129,124766119,6990
"33591","ENSG00000250075","4",67417305,67468251,50946
"33592","ENSG00000250076","4",33010948,33011746,798
"33593","ENSG00000250078","4",58562160,58565212,3052
"33594","ENSG00000250081","5",65486444,65487048,604
"33595","ENSG00000250091","12",123925461,123934984,9523
"33596","ENSG00000250092","4",21582096,21613728,31632
"33597","ENSG00000250095","5",111912508,112017309,104801
"33598","ENSG00000250098","4",12947574,12948670,1096
"33599","ENSG00000250101","5",177939622,177983054,43432
"33600","ENSG00000250102","4",131379717,131591825,212108
"33601","ENSG00000250103","4",110595513,110615458,19945
"33602","ENSG00000250105","11",66558866,66560384,1518
"33603","ENSG00000250106","5",10627260,10628225,965
"33604","ENSG00000250107","17",50556207,50562108,5901
"33605","ENSG00000250114","5",163416525,163416731,206
"33606","ENSG00000250115","8",143057060,143057816,756
"33607","ENSG00000250116","2",46568256,46580238,11982
"33608","ENSG00000250120","5",140855883,141012347,156464
"33609","ENSG00000250122","5",45890216,45895970,5754
"33610","ENSG00000250125","4",64914281,65024485,110204
"33611","ENSG00000250126","4",137645265,137655174,9909
"33612","ENSG00000250127","5",58541567,58558243,16676
"33613","ENSG00000250129","3",131053317,131072339,19022
"33614","ENSG00000250130","15",44354691,44355692,1001
"33615","ENSG00000250131","4",177442519,177681381,238862
"33616","ENSG00000250132","12",974133,991190,17057
"33617","ENSG00000250133","12",53993810,53996785,2975
"33618","ENSG00000250137","4",23560923,23768652,207729
"33619","ENSG00000250138","5",69631963,69636399,4436
"33620","ENSG00000250140","5",34860783,34861506,723
"33621","ENSG00000250141","4",141569931,141576077,6146
"33622","ENSG00000250144","4",135045464,135046850,1386
"33623","ENSG00000250145","5",106543066,106544330,1264
"33624","ENSG00000250147","4",54086926,54087783,857
"33625","ENSG00000250148","5",60743563,60744970,1407
"33626","ENSG00000250149","4",125676718,126017357,340639
"33627","ENSG00000250150","4",167306910,167308789,1879
"33628","ENSG00000250151","3",9793082,9835401,42319
"33629","ENSG00000250155","5",36666214,36725195,58981
"33630","ENSG00000250156","5",88408982,88439090,30108
"33631","ENSG00000250158","5",96247776,96278751,30975
"33632","ENSG00000250159","5",137809780,137889394,79614
"33633","ENSG00000250162","5",98833382,98833711,329
"33634","ENSG00000250164","5",31747644,31748078,434
"33635","ENSG00000250166","12",22409237,22618868,209631
"33636","ENSG00000250167","5",135559577,135634874,75297
"33637","ENSG00000250170","3",141525133,141526121,988
"33638","ENSG00000250173","5",979365,981300,1935
"33639","ENSG00000250174","3",123689644,123692407,2763
"33640","ENSG00000250182","5",14651941,14653329,1388
"33641","ENSG00000250183","4",119937557,119963898,26341
"33642","ENSG00000250185","4",108788745,108789779,1034
"33643","ENSG00000250189","4",141405172,141407586,2414
"33644","ENSG00000250190","4",28996498,29017256,20758
"33645","ENSG00000250192","4",57154577,57156452,1875
"33646","ENSG00000250193","4",129299175,129305022,5847
"33647","ENSG00000250195","4",138819954,139012646,192692
"33648","ENSG00000250197","5",115289036,115289330,294
"33649","ENSG00000250198","5",8839700,8898052,58352
"33650","ENSG00000250202","4",86876338,86876652,314
"33651","ENSG00000250207","2",129992602,129993105,503
"33652","ENSG00000250208","12",130144315,130162256,17941
"33653","ENSG00000250214","4",77864508,77864804,296
"33654","ENSG00000250215","4",114713579,114714920,1341
"33655","ENSG00000250218","3",126103640,126108069,4429
"33656","ENSG00000250219","4",120091046,120092282,1236
"33657","ENSG00000250220","4",73259209,73317953,58744
"33658","ENSG00000250221","5",98392070,98393530,1460
"33659","ENSG00000250222","5",181191875,181194429,2554
"33660","ENSG00000250227","4",164915565,164916983,1418
"33661","ENSG00000250230","11",61588442,61607550,19108
"33662","ENSG00000250234","5",34656412,34657250,838
"33663","ENSG00000250237","5",69038518,69043821,5303
"33664","ENSG00000250238","4",105959,107114,1155
"33665","ENSG00000250240","5",95701249,95732295,31046
"33666","ENSG00000250241","4",133075311,133149147,73836
"33667","ENSG00000250243","4",21304468,21350673,46205
"33668","ENSG00000250244","5",133256492,133275977,19485
"33669","ENSG00000250247","5",14960232,14961393,1161
"33670","ENSG00000250250","5",15602189,15619109,16920
"33671","ENSG00000250251","16",15125242,15154564,29322
"33672","ENSG00000250252","4",149147793,149154175,6382
"33673","ENSG00000250254","4",37960398,37961128,730
"33674","ENSG00000250256","5",174618164,174625775,7611
"33675","ENSG00000250257","11",83814571,83815263,692
"33676","ENSG00000250258","5",79774348,79816190,41842
"33677","ENSG00000250260","5",138039199,138039979,780
"33678","ENSG00000250261","22",20587496,20592218,4722
"33679","ENSG00000250263","4",176875688,176908031,32343
"33680","ENSG00000250266","4",170226535,170283723,57188
"33681","ENSG00000250267","8",109298598,109316513,17915
"33682","ENSG00000250271","3",151797047,151808249,11202
"33683","ENSG00000250274","5",170308701,170312716,4015
"33684","ENSG00000250277","4",68996935,68997709,774
"33685","ENSG00000250280","12",65281657,65286728,5071
"33686","ENSG00000250282","17",50100704,50101920,1216
"33687","ENSG00000250284","5",136734830,136763409,28579
"33688","ENSG00000250286","17",50525520,50538761,13241
"33689","ENSG00000250290","8",120635558,120638204,2646
"33690","ENSG00000250293","4",97916353,97917401,1048
"33691","ENSG00000250295","8",73297711,73356461,58750
"33692","ENSG00000250298","4",106357485,106368825,11340
"33693","ENSG00000250299","13",52600119,52637446,37327
"33694","ENSG00000250302","4",52712394,52866821,154427
"33695","ENSG00000250303","11",112270749,112362534,91785
"33696","ENSG00000250305","8",12945642,13031503,85861
"33697","ENSG00000250306","5",88382948,88383260,312
"33698","ENSG00000250308","5",57422464,57424391,1927
"33699","ENSG00000250310","17",49544788,49577962,33174
"33700","ENSG00000250312","4",124501,202303,77802
"33701","ENSG00000250313","5",66507380,66511644,4264
"33702","ENSG00000250316","8",19237737,19241912,4175
"33703","ENSG00000250317","4",25861830,25929874,68044
"33704","ENSG00000250318","22",30653877,30654814,937
"33705","ENSG00000250320","5",84382424,84490765,108341
"33706","ENSG00000250321","4",342821,342962,141
"33707","ENSG00000250324","4",56320719,56321334,615
"33708","ENSG00000250325","4",82401578,82402456,878
"33709","ENSG00000250326","4",142933195,143184861,251666
"33710","ENSG00000250327","4",186157896,186158843,947
"33711","ENSG00000250328","5",122436497,122479087,42590
"33712","ENSG00000250329","5",128109486,128110994,1508
"33713","ENSG00000250330","5",79229904,79230588,684
"33714","ENSG00000250331","5",97504663,97690180,185517
"33715","ENSG00000250332","5",23303565,23305143,1578
"33716","ENSG00000250333","4",57605694,57658800,53106
"33717","ENSG00000250334","4",79491802,79623479,131677
"33718","ENSG00000250337","5",27217714,27496994,279280
"33719","ENSG00000250338","4",40265472,40266457,985
"33720","ENSG00000250340","4",58524515,58536328,11813
"33721","ENSG00000250341","4",137193756,137198367,4611
"33722","ENSG00000250342","4",9051842,9052051,209
"33723","ENSG00000250343","5",147180204,147234859,54655
"33724","ENSG00000250344","4",121071429,121080476,9047
"33725","ENSG00000250345","4",143760399,143762093,1694
"33726","ENSG00000250346","5",147922179,147923421,1242
"33727","ENSG00000250347","5",142036707,142037125,418
"33728","ENSG00000250348","5",76285542,76311462,25920
"33729","ENSG00000250350","4",151279030,151279192,162
"33730","ENSG00000250354","4",148146471,148208880,62409
"33731","ENSG00000250356","4",74917822,74918138,316
"33732","ENSG00000250357","4",148693032,148694323,1291
"33733","ENSG00000250358","5",112628436,112642483,14047
"33734","ENSG00000250359","5",86087526,86087847,321
"33735","ENSG00000250360","5",50965687,50967008,1321
"33736","ENSG00000250361","4",143996104,144019345,23241
"33737","ENSG00000250362","5",95861786,95874519,12733
"33738","ENSG00000250365","14",31420286,31452883,32597
"33739","ENSG00000250366","14",95876392,95925571,49179
"33740","ENSG00000250371","4",12859101,12864961,5860
"33741","ENSG00000250372","4",176012038,176014417,2379
"33742","ENSG00000250374","4",165053864,165060554,6690
"33743","ENSG00000250376","4",68784618,68787474,2856
"33744","ENSG00000250377","5",88691757,88695041,3284
"33745","ENSG00000250378","5",135812667,135827546,14879
"33746","ENSG00000250379","15",41825099,41827936,2837
"33747","ENSG00000250381","4",4143458,4150421,6963
"33748","ENSG00000250383","5",108818041,108830790,12749
"33749","ENSG00000250384","4",57072683,57073132,449
"33750","ENSG00000250385","5",524109,527448,3339
"33751","ENSG00000250386","5",17625551,17625959,408
"33752","ENSG00000250387","5",71337182,71446772,109590
"33753","ENSG00000250390","11",95482406,95497553,15147
"33754","ENSG00000250391","5",99948295,99949583,1288
"33755","ENSG00000250392","4",119939540,119964293,24753
"33756","ENSG00000250393","4",10143367,10143655,288
"33757","ENSG00000250397","11",856880,859795,2915
"33758","ENSG00000250402","5",125376828,125377439,611
"33759","ENSG00000250403","4",99990737,99991477,740
"33760","ENSG00000250406","4",144851572,144874787,23215
"33761","ENSG00000250407","5",146563226,146617004,53778
"33762","ENSG00000250409","5",133387773,133388549,776
"33763","ENSG00000250410","4",185370725,185390928,20203
"33764","ENSG00000250412","4",119334329,119378233,43904
"33765","ENSG00000250413","4",10006482,10009725,3243
"33766","ENSG00000250415","5",16617225,16621276,4051
"33767","ENSG00000250416","4",35487812,35489750,1938
"33768","ENSG00000250417","5",1855970,1856568,598
"33769","ENSG00000250418","5",44698431,44700808,2377
"33770","ENSG00000250420","5",178764861,178818435,53574
"33771","ENSG00000250421","5",67699429,67902600,203171
"33772","ENSG00000250422","5",45557919,45559986,2067
"33773","ENSG00000250423","X",119078635,119150579,71944
"33774","ENSG00000250424","7",30852273,30923812,71539
"33775","ENSG00000250425","4",9754898,9755778,880
"33776","ENSG00000250426","4",68182292,68212470,30178
"33777","ENSG00000250427","5",118282575,118284782,2207
"33778","ENSG00000250428","8",124920428,124922076,1648
"33779","ENSG00000250430","4",165026261,165026944,683
"33780","ENSG00000250431","4",174977571,174979381,1810
"33781","ENSG00000250432","12",54085132,54125992,40860
"33782","ENSG00000250433","3",140505611,140508789,3178
"33783","ENSG00000250436","4",73508803,73534128,25325
"33784","ENSG00000250437","5",89581209,89677701,96492
"33785","ENSG00000250441","5",108894347,108894628,281
"33786","ENSG00000250442","4",116043407,116044045,638
"33787","ENSG00000250444","5",115512077,115513694,1617
"33788","ENSG00000250446","5",74327995,74334766,6771
"33789","ENSG00000250447","5",53776644,53819686,43042
"33790","ENSG00000250448","5",16180238,16185585,5347
"33791","ENSG00000250451","12",53999022,54000010,988
"33792","ENSG00000250455","5",37377049,37377971,922
"33793","ENSG00000250456","4",54603211,54607131,3920
"33794","ENSG00000250461","5",61375112,61375855,743
"33795","ENSG00000250462","17",30629680,30637466,7786
"33796","ENSG00000250470","22",23976904,23977585,681
"33797","ENSG00000250471","4",8174421,8174999,578
"33798","ENSG00000250472","5",115148764,115149644,880
"33799","ENSG00000250473","4",51865050,51865535,485
"33800","ENSG00000250474","7",107628553,107629550,997
"33801","ENSG00000250475","4",157968412,157969615,1203
"33802","ENSG00000250476","4",3967034,3967660,626
"33803","ENSG00000250479","22",23765834,23768443,2609
"33804","ENSG00000250481","5",4974690,5034267,59577
"33805","ENSG00000250483","8",15806149,15807283,1134
"33806","ENSG00000250486","4",164956948,164959122,2174
"33807","ENSG00000250490","5",6310441,6339884,29443
"33808","ENSG00000250492","5",39718984,39721513,2529
"33809","ENSG00000250493","11",120867933,120894797,26864
"33810","ENSG00000250496","4",99022311,99023131,820
"33811","ENSG00000250497","4",13777377,13782157,4780
"33812","ENSG00000250501","4",138773537,138803567,30030
"33813","ENSG00000250505","4",10284961,10285708,747
"33814","ENSG00000250506","17",76000906,76005999,5093
"33815","ENSG00000250507","19",54328272,54331434,3162
"33816","ENSG00000250508","11",68870664,68874542,3878
"33817","ENSG00000250509","5",180416949,180443240,26291
"33818","ENSG00000250510","12",6821624,6829972,8348
"33819","ENSG00000250511","4",110512488,110519505,7017
"33820","ENSG00000250514","16",76634998,76658478,23480
"33821","ENSG00000250515","5",140732290,140732863,573
"33822","ENSG00000250516","8",28225929,28227562,1633
"33823","ENSG00000250517","12",63003553,63006902,3349
"33824","ENSG00000250519","11",94185439,94282203,96764
"33825","ENSG00000250522","4",105540190,105552355,12165
"33826","ENSG00000250526","5",14639426,14641018,1592
"33827","ENSG00000250529","5",5069192,5078311,9119
"33828","ENSG00000250532","4",74418917,74440457,21540
"33829","ENSG00000250535","6",32013270,32013787,517
"33830","ENSG00000250536","1",214605470,214608840,3370
"33831","ENSG00000250538","4",155206529,155209027,2498
"33832","ENSG00000250539","5",123400922,123402344,1422
"33833","ENSG00000250540","4",143497412,143498126,714
"33834","ENSG00000250541","4",25770266,25773577,3311
"33835","ENSG00000250544","5",86746818,86749777,2959
"33836","ENSG00000250546","4",83796436,84299189,502753
"33837","ENSG00000250547","4",163265575,163266583,1008
"33838","ENSG00000250548","14",61556273,61570653,14380
"33839","ENSG00000250551","5",96050115,96215519,165404
"33840","ENSG00000250561","7",6879627,6880626,999
"33841","ENSG00000250563","8",126072587,126074231,1644
"33842","ENSG00000250564","5",134429051,134460615,31564
"33843","ENSG00000250565","2",46490750,46542577,51827
"33844","ENSG00000250566","4",68509441,68517647,8206
"33845","ENSG00000250567","5",103408941,103412511,3570
"33846","ENSG00000250568","4",39973128,39973442,314
"33847","ENSG00000250569","8",86481754,86483002,1248
"33848","ENSG00000250571","8",143267433,143276931,9498
"33849","ENSG00000250572","4",87261931,87266822,4891
"33850","ENSG00000250574","5",76510440,76510766,326
"33851","ENSG00000250575","1",491225,493241,2016
"33852","ENSG00000250576","5",10775058,10777062,2004
"33853","ENSG00000250577","4",138923930,138924232,302
"33854","ENSG00000250579","5",5132101,5140119,8018
"33855","ENSG00000250582","4",145497073,145502971,5898
"33856","ENSG00000250583","5",33519616,33522230,2614
"33857","ENSG00000250584","5",1353896,1380107,26211
"33858","ENSG00000250590","4",187532873,187672755,139882
"33859","ENSG00000250592","3",130899414,130929976,30562
"33860","ENSG00000250596","4",174523701,174540344,16643
"33861","ENSG00000250597","4",34657606,34669432,11826
"33862","ENSG00000250600","5",10441290,10441792,502
"33863","ENSG00000250602","5",126372477,126509021,136544
"33864","ENSG00000250603","5",127838486,127857804,19318
"33865","ENSG00000250608","3",131325092,131381656,56564
"33866","ENSG00000250609","4",154523487,154524807,1320
"33867","ENSG00000250613","4",10410996,10411644,648
"33868","ENSG00000250614","7",76474587,76478856,4269
"33869","ENSG00000250616","16",30096430,30104116,7686
"33870","ENSG00000250618","7",57817996,57818197,201
"33871","ENSG00000250619","5",9001774,9045940,44166
"33872","ENSG00000250620","4",187408232,187415748,7516
"33873","ENSG00000250622","4",156972631,156972956,325
"33874","ENSG00000250623","4",2139673,2141058,1385
"33875","ENSG00000250624","4",30884443,30885182,739
"33876","ENSG00000250625","X",142194352,142195490,1138
"33877","ENSG00000250626","4",188777672,188818522,40850
"33878","ENSG00000250629","5",38783580,38792754,9174
"33879","ENSG00000250632","4",3673593,3677855,4262
"33880","ENSG00000250634","4",13654374,14003756,349382
"33881","ENSG00000250635","5",139648999,139649728,729
"33882","ENSG00000250637","8",43442902,43452912,10010
"33883","ENSG00000250640","11",14987671,14988694,1023
"33884","ENSG00000250641","6",31706904,31717918,11014
"33885","ENSG00000250643","3",129954105,129969294,15189
"33886","ENSG00000250644","11",1734821,1763954,29133
"33887","ENSG00000250645","5",418703,419109,406
"33888","ENSG00000250646","4",55053060,55092534,39474
"33889","ENSG00000250651","4",102896725,102898237,1512
"33890","ENSG00000250654","12",54076838,54081903,5065
"33891","ENSG00000250656","4",67716375,67717388,1013
"33892","ENSG00000250657","4",43340875,43345600,4725
"33893","ENSG00000250658","4",187304083,187309682,5599
"33894","ENSG00000250659","11",62537312,62542018,4706
"33895","ENSG00000250662","5",14877667,14877919,252
"33896","ENSG00000250665","4",136125909,136138874,12965
"33897","ENSG00000250666","4",189881515,189884868,3353
"33898","ENSG00000250667","5",17495658,17495826,168
"33899","ENSG00000250668","5",7346986,7348671,1685
"33900","ENSG00000250669","5",67690033,67690437,404
"33901","ENSG00000250670","4",104556960,104568877,11917
"33902","ENSG00000250673","4",146214515,146230878,16363
"33903","ENSG00000250674","5",179455415,179456095,680
"33904","ENSG00000250677","4",83237303,83237444,141
"33905","ENSG00000250678","5",119010060,119010542,482
"33906","ENSG00000250681","4",3633029,3633975,946
"33907","ENSG00000250682","5",102604220,102671765,67545
"33908","ENSG00000250684","8",102688317,102688906,589
"33909","ENSG00000250685","16",84192558,84197053,4495
"33910","ENSG00000250686","6",61630233,61681049,50816
"33911","ENSG00000250687","5",70462244,70479215,16971
"33912","ENSG00000250688","14",22481697,22481753,56
"33913","ENSG00000250692","5",139848290,139856389,8099
"33914","ENSG00000250694","5",24352309,24353443,1134
"33915","ENSG00000250696","4",69182100,69216766,34666
"33916","ENSG00000250697","5",32888236,33298066,409830
"33917","ENSG00000250698","4",140128015,140134565,6550
"33918","ENSG00000250699","11",117316362,117328038,11676
"33919","ENSG00000250705","5",88602780,88603117,337
"33920","ENSG00000250706","4",152146385,152178573,32188
"33921","ENSG00000250708","4",173699082,174001488,302406
"33922","ENSG00000250709","13",36168794,36297842,129048
"33923","ENSG00000250710","4",4156522,4157443,921
"33924","ENSG00000250711","5",42972624,42973092,468
"33925","ENSG00000250712","4",165010459,165011851,1392
"33926","ENSG00000250716","5",3496229,3504004,7775
"33927","ENSG00000250719","1",46175486,46176478,992
"33928","ENSG00000250722","5",42799880,42887392,87512
"33929","ENSG00000250723","4",33850591,33982349,131758
"33930","ENSG00000250725","4",165664350,165665671,1321
"33931","ENSG00000250726","4",184072403,184073039,636
"33932","ENSG00000250730","5",6289857,6290624,767
"33933","ENSG00000250731","19",53479350,53480091,741
"33934","ENSG00000250732","5",65251127,65251784,657
"33935","ENSG00000250733","8",139931172,139933946,2774
"33936","ENSG00000250734","1",151612038,151613363,1325
"33937","ENSG00000250739","4",189659605,189661486,1881
"33938","ENSG00000250740","4",105927060,105932722,5662
"33939","ENSG00000250741","2",18555545,18589564,34019
"33940","ENSG00000250742","12",54126082,54147485,21403
"33941","ENSG00000250746","4",164188311,164190367,2056
"33942","ENSG00000250747","5",73152416,73152938,522
"33943","ENSG00000250748","12",65466820,65642372,175552
"33944","ENSG00000250749","5",180534184,180534642,458
"33945","ENSG00000250751","17",49708334,49720060,11726
"33946","ENSG00000250752","8",6898878,6899468,590
"33947","ENSG00000250753","4",49579833,49580189,356
"33948","ENSG00000250754","4",185051081,185115500,64419
"33949","ENSG00000250761","5",7707802,7749766,41964
"33950","ENSG00000250762","1",167819898,167820248,350
"33951","ENSG00000250764","5",32103445,32121941,18496
"33952","ENSG00000250767","5",33997044,33997724,680
"33953","ENSG00000250769","4",49507764,49508806,1042
"33954","ENSG00000250770","12",3296202,3366122,69920
"33955","ENSG00000250771","4",153640168,153681180,41012
"33956","ENSG00000250772","4",119799089,119804554,5465
"33957","ENSG00000250775","4",63465511,63529761,64250
"33958","ENSG00000250777","4",137690477,137734977,44500
"33959","ENSG00000250781","4",42281830,42391651,109821
"33960","ENSG00000250782","5",17634460,17635053,593
"33961","ENSG00000250786","5",9546200,9550609,4409
"33962","ENSG00000250787","5",56381781,56382075,294
"33963","ENSG00000250790","12",132911470,132914732,3262
"33964","ENSG00000250791","4",116489364,116515619,26255
"33965","ENSG00000250794","8",12421032,12425000,3968
"33966","ENSG00000250796","3",128869624,128870026,402
"33967","ENSG00000250799","19",35799988,35813299,13311
"33968","ENSG00000250801","5",175972606,175987666,15060
"33969","ENSG00000250802","5",77086688,77166909,80221
"33970","ENSG00000250803","5",122129622,122183949,54327
"33971","ENSG00000250806","5",100654112,100657970,3858
"33972","ENSG00000250808","5",5395972,5396335,363
"33973","ENSG00000250814","5",9854371,9899970,45599
"33974","ENSG00000250815","4",53927499,53928138,639
"33975","ENSG00000250816","5",17202274,17203145,871
"33976","ENSG00000250819","4",17171757,17186079,14322
"33977","ENSG00000250821","4",55819819,55837487,17668
"33978","ENSG00000250822","5",17378906,17387310,8404
"33979","ENSG00000250825","15",96441566,96442313,747
"33980","ENSG00000250826","4",82128535,82129656,1121
"33981","ENSG00000250829","4",186890969,186892366,1397
"33982","ENSG00000250831","5",89466537,89470039,3502
"33983","ENSG00000250833","10",30353706,30357365,3659
"33984","ENSG00000250834","4",135371177,135371924,747
"33985","ENSG00000250835","4",142317238,142317546,308
"33986","ENSG00000250838","17",48995266,48997492,2226
"33987","ENSG00000250842","5",145337932,145381670,43738
"33988","ENSG00000250846","4",65669961,65698029,28068
"33989","ENSG00000250848","5",288833,290321,1488
"33990","ENSG00000250850","9",37002697,37008040,5343
"33991","ENSG00000250853","5",55530156,55530701,545
"33992","ENSG00000250855","4",111802801,111839886,37085
"33993","ENSG00000250858","4",27585145,27586144,999
"33994","ENSG00000250859","5",127511464,127512842,1378
"33995","ENSG00000250860","5",42466893,42468300,1407
"33996","ENSG00000250862","5",124220579,124221077,498
"33997","ENSG00000250863","4",43972921,44025516,52595
"33998","ENSG00000250865","4",135792384,135805904,13520
"33999","ENSG00000250866","5",5142138,5176214,34076
"34000","ENSG00000250869","8",67133554,67135911,2357
"34001","ENSG00000250874","5",85663232,85664684,1452
"34002","ENSG00000250877","4",72323028,72330751,7723
"34003","ENSG00000250878","13",102880099,102896033,15934
"34004","ENSG00000250882","5",112173570,112175548,1978
"34005","ENSG00000250884","4",9483718,9484702,984
"34006","ENSG00000250886","5",35081223,35081992,769
"34007","ENSG00000250891","5",118000253,118562199,561946
"34008","ENSG00000250892","4",201409,205009,3600
"34009","ENSG00000250893","4",40426119,40427585,1466
"34010","ENSG00000250894","1",13245863,13248652,2789
"34011","ENSG00000250896","4",11371975,11372892,917
"34012","ENSG00000250899","12",3041437,3044950,3513
"34013","ENSG00000250900","5",181195496,181203103,7607
"34014","ENSG00000250902","4",145514615,145517118,2503
"34015","ENSG00000250903","6",2245718,2525976,280258
"34016","ENSG00000250905","4",149666057,149711149,45092
"34017","ENSG00000250906","4",40812779,40826151,13372
"34018","ENSG00000250908","4",93318623,93319786,1163
"34019","ENSG00000250909","5",176347941,176353584,5643
"34020","ENSG00000250910","4",155173716,155381694,207978
"34021","ENSG00000250915","4",8745391,8747727,2336
"34022","ENSG00000250917","20",34234840,34281173,46333
"34023","ENSG00000250919","4",69027831,69044578,16747
"34024","ENSG00000250920","4",103550586,103559277,8691
"34025","ENSG00000250921","5",4135638,4147429,11791
"34026","ENSG00000250923","7",57773183,57773381,198
"34027","ENSG00000250927","4",28823244,28824211,967
"34028","ENSG00000250928","5",119011471,119012056,585
"34029","ENSG00000250929","8",103121032,103132966,11934
"34030","ENSG00000250930","4",53496400,53549578,53178
"34031","ENSG00000250933","18",3977649,3978615,966
"34032","ENSG00000250934","3",126266747,126291525,24778
"34033","ENSG00000250938","4",120066958,120564789,497831
"34034","ENSG00000250940","4",4086638,4086814,176
"34035","ENSG00000250942","4",9677308,9677934,626
"34036","ENSG00000250945","4",127043430,127077762,34332
"34037","ENSG00000250947","5",136303757,136316100,12343
"34038","ENSG00000250948","17",49375380,49380094,4714
"34039","ENSG00000250950","4",119456350,119457277,927
"34040","ENSG00000250954","4",33775498,34039914,264416
"34041","ENSG00000250955","5",95964999,95986311,21312
"34042","ENSG00000250956","5",127179756,127179900,144
"34043","ENSG00000250957","4",174135055,174154637,19582
"34044","ENSG00000250959","10",73730562,73737311,6749
"34045","ENSG00000250961","5",57395060,57534504,139444
"34046","ENSG00000250962","8",88485110,88486094,984
"34047","ENSG00000250966","4",112564988,112565398,410
"34048","ENSG00000250968","4",170742469,170743718,1249
"34049","ENSG00000250969","4",143286293,143329858,43565
"34050","ENSG00000250971","4",187005944,187060930,54986
"34051","ENSG00000250972","5",144439206,144439478,272
"34052","ENSG00000250974","5",6839460,7219291,379831
"34053","ENSG00000250976","17",50563203,50563783,580
"34054","ENSG00000250977","4",138664725,138665569,844
"34055","ENSG00000250978","5",67463809,67475592,11783
"34056","ENSG00000250979","8",72202751,72251565,48814
"34057","ENSG00000250980","4",152796063,152796831,768
"34058","ENSG00000250981","5",16129178,16141602,12424
"34059","ENSG00000250982","16",28239693,28240668,975
"34060","ENSG00000250983","3",133546071,133546272,201
"34061","ENSG00000250986","4",3758748,3763390,4642
"34062","ENSG00000250988","15",82750564,82757206,6642
"34063","ENSG00000250990","7",77246340,77258123,11783
"34064","ENSG00000250992","5",176036593,176042888,6295
"34065","ENSG00000250993","4",179389134,179465305,76171
"34066","ENSG00000250994","5",134436711,134492519,55808
"34067","ENSG00000250995","X",118769796,118770857,1061
"34068","ENSG00000250999","5",179657762,179665136,7374
"34069","ENSG00000251000","5",95834424,95835046,622
"34070","ENSG00000251001","5",80997183,80998047,864
"34071","ENSG00000251002","14",22197446,22482959,285513
"34072","ENSG00000251003","8",105546089,106060524,514435
"34073","ENSG00000251008","4",186170863,186171257,394
"34074","ENSG00000251009","4",25864881,25869550,4669
"34075","ENSG00000251011","3",133245603,133257207,11604
"34076","ENSG00000251013","8",100550724,100551713,989
"34077","ENSG00000251015","13",45418162,45420371,2209
"34078","ENSG00000251017","4",74085995,74086672,677
"34079","ENSG00000251018","5",163483065,163494058,10993
"34080","ENSG00000251022","4",82893009,82900960,7951
"34081","ENSG00000251023","5",93860669,93863825,3156
"34082","ENSG00000251025","4",180573464,180574027,563
"34083","ENSG00000251026","5",104079847,104406121,326274
"34084","ENSG00000251027","5",106815197,107011052,195855
"34085","ENSG00000251031","5",144856890,145228982,372092
"34086","ENSG00000251033","5",26711551,26749997,38446
"34087","ENSG00000251034","8",22481588,22553444,71856
"34088","ENSG00000251039","2",89851791,89852497,706
"34089","ENSG00000251040","4",52044805,52046954,2149
"34090","ENSG00000251045","5",135648584,135653935,5351
"34091","ENSG00000251046","4",110415898,110418504,2606
"34092","ENSG00000251048","4",18488062,18489508,1446
"34093","ENSG00000251049","4",57595940,57605872,9932
"34094","ENSG00000251050","5",80019609,80019920,311
"34095","ENSG00000251054","5",97223371,97227957,4586
"34096","ENSG00000251056","4",49502145,49506022,3877
"34097","ENSG00000251058","3",140461000,140462825,1825
"34098","ENSG00000251059","4",81164922,81193395,28473
"34099","ENSG00000251061","4",170343089,170372311,29222
"34100","ENSG00000251062","5",32887990,32888145,155
"34101","ENSG00000251066","5",85549409,85549952,543
"34102","ENSG00000251072","5",126751963,126776486,24523
"34103","ENSG00000251073","4",158182825,158183393,568
"34104","ENSG00000251074","4",68626847,68628899,2052
"34105","ENSG00000251075","4",3049094,3074538,25444
"34106","ENSG00000251076","5",112228283,112257309,29026
"34107","ENSG00000251078","5",75752570,75753479,909
"34108","ENSG00000251079","10",47538377,47551954,13577
"34109","ENSG00000251080","4",27133996,27140051,6055
"34110","ENSG00000251081","4",107258700,107301870,43170
"34111","ENSG00000251087","4",9703754,9710812,7058
"34112","ENSG00000251088","3",98233651,98457898,224247
"34113","ENSG00000251090","3",98100793,98105672,4879
"34114","ENSG00000251093","5",91226475,91227071,596
"34115","ENSG00000251095","4",89410960,89726752,315792
"34116","ENSG00000251101","4",68615393,68616137,744
"34117","ENSG00000251102","5",98576341,98577260,919
"34118","ENSG00000251108","5",72417489,72418335,846
"34119","ENSG00000251111","4",55351812,55352408,596
"34120","ENSG00000251112","5",12794100,12794731,631
"34121","ENSG00000251118","5",115770586,115770989,403
"34122","ENSG00000251122","5",174923090,174923945,855
"34123","ENSG00000251125","5",51451158,51462089,10931
"34124","ENSG00000251126","4",112880298,112882330,2032
"34125","ENSG00000251128","4",183233628,183240634,7006
"34126","ENSG00000251129","4",31997376,32228543,231167
"34127","ENSG00000251131","5",43018429,43024678,6249
"34128","ENSG00000251132","5",115031273,115031894,621
"34129","ENSG00000251135","5",121040090,121044032,3942
"34130","ENSG00000251136","8",89585872,89757812,171940
"34131","ENSG00000251138","12",73820315,74402600,582285
"34132","ENSG00000251139","4",184813619,184821300,7681
"34133","ENSG00000251141","5",44742420,44808777,66357
"34134","ENSG00000251142","8",57240057,57240541,484
"34135","ENSG00000251143","11",72014291,72020910,6619
"34136","ENSG00000251144","5",174820027,174826324,6297
"34137","ENSG00000251148","4",2295584,2319089,23505
"34138","ENSG00000251149","4",101972423,101972798,375
"34139","ENSG00000251151","12",53981509,53985519,4010
"34140","ENSG00000251152","4",11469250,11478196,8946
"34141","ENSG00000251154","7",90469787,90488964,19177
"34142","ENSG00000251155","4",118640673,118640858,185
"34143","ENSG00000251158","5",69898867,69903198,4331
"34144","ENSG00000251159","4",44533615,44533880,265
"34145","ENSG00000251161","15",40906811,40910337,3526
"34146","ENSG00000251163","5",42897262,42897832,570
"34147","ENSG00000251165","4",186286094,186500997,214903
"34148","ENSG00000251166","4",3889356,3890249,893
"34149","ENSG00000251168","5",7924292,7925398,1106
"34150","ENSG00000251169","5",134506552,134509229,2677
"34151","ENSG00000251171","4",169201794,169220349,18555
"34152","ENSG00000251172","3",97481177,97481506,329
"34153","ENSG00000251173","4",41220074,41256727,36653
"34154","ENSG00000251174","4",175494614,175496000,1386
"34155","ENSG00000251175","4",105746245,105827172,80927
"34156","ENSG00000251176","4",171553000,171564267,11267
"34157","ENSG00000251177","4",69572391,69585527,13136
"34158","ENSG00000251178","3",130034553,130035539,986
"34159","ENSG00000251179","17",50281577,50287855,6278
"34160","ENSG00000251182","4",31171013,31211678,40665
"34161","ENSG00000251183","5",153887428,153898987,11559
"34162","ENSG00000251185","4",75269068,75361182,92114
"34163","ENSG00000251186","4",8453410,8454942,1532
"34164","ENSG00000251187","5",112192020,112210139,18119
"34165","ENSG00000251188","4",268982,269531,549
"34166","ENSG00000251189","5",38682070,38685126,3056
"34167","ENSG00000251191","8",29673922,29748109,74187
"34168","ENSG00000251192","X",46497727,46545457,47730
"34169","ENSG00000251194","11",35212550,35214007,1457
"34170","ENSG00000251199","4",134026665,134327977,301312
"34171","ENSG00000251201","5",115578642,115626161,47519
"34172","ENSG00000251203","8",26433029,26434065,1036
"34173","ENSG00000251204","5",106415576,106417241,1665
"34174","ENSG00000251205","5",143531331,143598434,67103
"34175","ENSG00000251206","5",67268022,67270182,2160
"34176","ENSG00000251209","15",97572185,97875650,303465
"34177","ENSG00000251210","4",12223445,12251286,27841
"34178","ENSG00000251211","5",178165702,178166562,860
"34179","ENSG00000251215","5",39169210,39170335,1125
"34180","ENSG00000251216","4",173924207,173991024,66817
"34181","ENSG00000251218","8",134849935,134881899,31964
"34182","ENSG00000251221","5",80608623,80622524,13901
"34183","ENSG00000251224","3",32730635,32737454,6819
"34184","ENSG00000251226","11",134735596,134763810,28214
"34185","ENSG00000251229","4",2505081,2506279,1198
"34186","ENSG00000251230","4",184844554,184855751,11197
"34187","ENSG00000251234","8",93939364,93942877,3513
"34188","ENSG00000251235","5",76376675,76377149,474
"34189","ENSG00000251237","5",52889666,52889954,288
"34190","ENSG00000251244","4",155496110,155520353,24243
"34191","ENSG00000251246","1",155063748,155086807,23059
"34192","ENSG00000251247","19",36850361,36913029,62668
"34193","ENSG00000251248","4",142514446,142518983,4537
"34194","ENSG00000251249","4",151955991,151969381,13390
"34195","ENSG00000251250","5",7289891,7326609,36718
"34196","ENSG00000251252","4",14505865,14506480,615
"34197","ENSG00000251254","4",147506091,147506765,674
"34198","ENSG00000251256","4",54845568,54859241,13673
"34199","ENSG00000251257","5",38460925,38468339,7414
"34200","ENSG00000251258","6",112347330,112351294,3964
"34201","ENSG00000251259","4",105137280,105140619,3339
"34202","ENSG00000251260","4",84796614,84810403,13789
"34203","ENSG00000251266","4",58984215,59046959,62744
"34204","ENSG00000251270","3",141115124,141124182,9058
"34205","ENSG00000251271","4",3935447,3942519,7072
"34206","ENSG00000251273","5",25087450,25190956,103506
"34207","ENSG00000251276","7",78939850,78940895,1045
"34208","ENSG00000251279","5",61162070,61232040,69970
"34209","ENSG00000251281","5",33011322,33017607,6285
"34210","ENSG00000251283","4",156634494,156642454,7960
"34211","ENSG00000251284","4",69125274,69126451,1177
"34212","ENSG00000251286","4",52440494,52441535,1041
"34213","ENSG00000251287","3",130081831,130113227,31396
"34214","ENSG00000251288","4",102751401,102752641,1240
"34215","ENSG00000251291","4",134383467,134545648,162181
"34216","ENSG00000251292","4",23723262,23733579,10317
"34217","ENSG00000251293","5",120245448,120333502,88054
"34218","ENSG00000251294","5",24554018,24613222,59204
"34219","ENSG00000251297","4",189982523,189984871,2348
"34220","ENSG00000251298","4",147609552,147617245,7693
"34221","ENSG00000251299","13",24943575,24944498,923
"34222","ENSG00000251301","12",68332888,68451663,118775
"34223","ENSG00000251303","5",60630514,60630973,459
"34224","ENSG00000251306","5",59528861,59529251,390
"34225","ENSG00000251307","5",55233934,55295201,61267
"34226","ENSG00000251309","4",101976894,102036903,60009
"34227","ENSG00000251310","4",189193100,189204877,11777
"34228","ENSG00000251311","5",116742991,116762209,19218
"34229","ENSG00000251313","4",9030286,9031066,780
"34230","ENSG00000251314","5",95962001,96631085,669084
"34231","ENSG00000251320","5",147887112,147887704,592
"34232","ENSG00000251321","4",79827471,79877770,50299
"34233","ENSG00000251322","22",50674415,50733298,58883
"34234","ENSG00000251323","11",78423982,78429836,5854
"34235","ENSG00000251324","5",73454187,73472896,18709
"34236","ENSG00000251325","4",27262506,27267254,4748
"34237","ENSG00000251326","4",130376229,130432227,55998
"34238","ENSG00000251329","4",32351038,32353220,2182
"34239","ENSG00000251330","5",148430159,148430807,648
"34240","ENSG00000251332","4",37995494,37996203,709
"34241","ENSG00000251333","4",145375543,145376253,710
"34242","ENSG00000251334","4",48936582,48936880,298
"34243","ENSG00000251336","4",181820019,181829973,9954
"34244","ENSG00000251339","4",58780626,58984194,203568
"34245","ENSG00000251340","5",94569540,94570676,1136
"34246","ENSG00000251342","5",76078666,76079763,1097
"34247","ENSG00000251345","4",129133106,129134098,992
"34248","ENSG00000251348","5",95768999,95770700,1701
"34249","ENSG00000251349","9",100442271,100577636,135365
"34250","ENSG00000251350","4",44016700,44022063,5363
"34251","ENSG00000251352","5",180671892,180672598,706
"34252","ENSG00000251353","4",25720099,25720431,332
"34253","ENSG00000251354","8",47546804,47547926,1122
"34254","ENSG00000251356","5",91476382,91477018,636
"34255","ENSG00000251357","22",23862188,23895223,33035
"34256","ENSG00000251359","4",183097017,183099199,2182
"34257","ENSG00000251360","6",73209083,73210080,997
"34258","ENSG00000251361","5",93019663,93068669,49006
"34259","ENSG00000251363","14",40954693,41149309,194616
"34260","ENSG00000251364","11",7418826,7513644,94818
"34261","ENSG00000251365","5",6765891,6833120,67229
"34262","ENSG00000251366","5",80603383,80603644,261
"34263","ENSG00000251367","5",109467353,109467952,599
"34264","ENSG00000251368","5",55750206,55750401,195
"34265","ENSG00000251369","19",57535257,57559863,24606
"34266","ENSG00000251370","5",9511333,9518086,6753
"34267","ENSG00000251371","5",4640731,4648254,7523
"34268","ENSG00000251372","4",138309613,138663403,353790
"34269","ENSG00000251374","5",82265157,82265259,102
"34270","ENSG00000251376","5",55054428,55055140,712
"34271","ENSG00000251377","4",152206987,152225870,18883
"34272","ENSG00000251378","7",45818582,45819097,515
"34273","ENSG00000251379","4",15358141,15420032,61891
"34274","ENSG00000251381","11",12961541,12989597,28056
"34275","ENSG00000251383","4",75354076,75362566,8490
"34276","ENSG00000251387","5",139772528,139775406,2878
"34277","ENSG00000251388","4",133871246,134010690,139444
"34278","ENSG00000251389","5",97368776,97370421,1645
"34279","ENSG00000251391","5",66298394,66393521,95127
"34280","ENSG00000251393","14",73462362,73477175,14813
"34281","ENSG00000251396","8",60289928,60516795,226867
"34282","ENSG00000251398","4",132591064,132678503,87439
"34283","ENSG00000251399","4",79596542,79597173,631
"34284","ENSG00000251400","5",77290268,77291800,1532
"34285","ENSG00000251401","4",90682996,90683123,127
"34286","ENSG00000251402","8",12415080,12418090,3010
"34287","ENSG00000251405","5",157363382,157365501,2119
"34288","ENSG00000251408","4",6202328,6206649,4321
"34289","ENSG00000251409","5",95835943,95852721,16778
"34290","ENSG00000251410","4",27964517,27985063,20546
"34291","ENSG00000251411","4",86913266,86914817,1551
"34292","ENSG00000251413","10",48624004,48625093,1089
"34293","ENSG00000251414","5",176354206,176356168,1962
"34294","ENSG00000251416","4",177686673,177691068,4395
"34295","ENSG00000251417","16",28802743,28817828,15085
"34296","ENSG00000251418","4",148526493,148527139,646
"34297","ENSG00000251419","5",75831255,75832764,1509
"34298","ENSG00000251421","5",124395603,124400655,5052
"34299","ENSG00000251423","5",13860303,13901036,40733
"34300","ENSG00000251424","4",68834213,68834368,155
"34301","ENSG00000251426","5",5046796,5049497,2701
"34302","ENSG00000251429","4",158270378,158278676,8298
"34303","ENSG00000251432","4",128292751,128519398,226647
"34304","ENSG00000251433","4",181905790,181906467,677
"34305","ENSG00000251434","4",31350284,31351725,1441
"34306","ENSG00000251435","5",56192530,56193633,1103
"34307","ENSG00000251436","4",125681177,125683668,2491
"34308","ENSG00000251438","4",36311190,36392410,81220
"34309","ENSG00000251440","4",137425426,137425864,438
"34310","ENSG00000251441","4",112356135,112370959,14824
"34311","ENSG00000251442","4",78638780,78683185,44405
"34312","ENSG00000251443","5",33229516,33284642,55126
"34313","ENSG00000251445","4",169010430,169010939,509
"34314","ENSG00000251446","5",176726942,176739458,12516
"34315","ENSG00000251447","3",131537571,131537685,114
"34316","ENSG00000251448","3",126288123,126301213,13090
"34317","ENSG00000251450","5",80947694,80960907,13213
"34318","ENSG00000251451","7",66407288,66409239,1951
"34319","ENSG00000251452","4",144920713,144921164,451
"34320","ENSG00000251453","5",140581504,140582335,831
"34321","ENSG00000251454","4",75341279,75359024,17745
"34322","ENSG00000251455","4",151674483,151677893,3410
"34323","ENSG00000251456","5",124734618,124735175,557
"34324","ENSG00000251459","4",57490808,57495844,5036
"34325","ENSG00000251460","4",8066528,8067724,1196
"34326","ENSG00000251461","17",49004731,49013725,8994
"34327","ENSG00000251463","4",118193405,118194751,1346
"34328","ENSG00000251467","5",72996920,72997642,722
"34329","ENSG00000251468","8",12958387,12962200,3813
"34330","ENSG00000251470","8",46697630,46698688,1058
"34331","ENSG00000251471","3",139837220,139859894,22674
"34332","ENSG00000251473","4",105102891,105104004,1113
"34333","ENSG00000251474","3",129382922,129399655,16733
"34334","ENSG00000251476","5",5396477,5396968,491
"34335","ENSG00000251477","5",117719240,117722097,2857
"34336","ENSG00000251478","5",41585882,41587787,1905
"34337","ENSG00000251483","4",110945109,110945799,690
"34338","ENSG00000251484","1",109103535,109104766,1231
"34339","ENSG00000251485","2",232343116,232343903,787
"34340","ENSG00000251487","5",19035197,19038799,3602
"34341","ENSG00000251488","4",132836772,132981677,144905
"34342","ENSG00000251490","4",187516153,187517208,1055
"34343","ENSG00000251491","2",158862311,158863285,974
"34344","ENSG00000251493","5",73444827,73448777,3950
"34345","ENSG00000251495","5",82009602,82010094,492
"34346","ENSG00000251497","12",123081384,123084744,3360
"34347","ENSG00000251503","1",10430102,10452153,22051
"34348","ENSG00000251504","4",177729638,177907936,178298
"34349","ENSG00000251506","5",4967764,4970425,2661
"34350","ENSG00000251513","5",97089075,97437217,348142
"34351","ENSG00000251516","4",22607501,22611063,3562
"34352","ENSG00000251517","4",42706107,42707335,1228
"34353","ENSG00000251518","5",37948491,37951055,2564
"34354","ENSG00000251520","1",180964511,180965909,1398
"34355","ENSG00000251521","8",81605569,81631134,25565
"34356","ENSG00000251523","4",98496364,98509935,13571
"34357","ENSG00000251525","X",102173100,102185021,11921
"34358","ENSG00000251526","4",123505279,123527525,22246
"34359","ENSG00000251527","4",65858761,65860204,1443
"34360","ENSG00000251532","5",1544107,1551710,7603
"34361","ENSG00000251533","14",103187221,103189028,1807
"34362","ENSG00000251535","4",336258,336786,528
"34363","ENSG00000251536","12",129852208,129854944,2736
"34364","ENSG00000251537","17",15571491,15651653,80162
"34365","ENSG00000251538","5",122628952,122730685,101733
"34366","ENSG00000251539","4",49561479,49562149,670
"34367","ENSG00000251543","5",73337906,73338533,627
"34368","ENSG00000251544","5",94567461,94568909,1448
"34369","ENSG00000251545","5",179522457,179525074,2617
"34370","ENSG00000251546","2",89862482,89862981,499
"34371","ENSG00000251548","5",10664495,10665113,618
"34372","ENSG00000251550","17",49037122,49037429,307
"34373","ENSG00000251552","5",83279921,83280644,723
"34374","ENSG00000251555","4",131930031,131975952,45921
"34375","ENSG00000251556","5",146099406,146120412,21006
"34376","ENSG00000251557","11",43120762,43269393,148631
"34377","ENSG00000251562","11",65497688,65506516,8828
"34378","ENSG00000251563","8",87598462,87601634,3172
"34379","ENSG00000251566","5",77146568,77147165,597
"34380","ENSG00000251567","4",136118675,136395471,276796
"34381","ENSG00000251568","5",5375723,5376836,1113
"34382","ENSG00000251569","2",169479480,169525922,46442
"34383","ENSG00000251573","5",50969217,50970167,950
"34384","ENSG00000251574","5",104383298,105392970,1009672
"34385","ENSG00000251575","5",61732774,61735715,2941
"34386","ENSG00000251576","3",14348451,14352568,4117
"34387","ENSG00000251577","4",103548745,103624534,75789
"34388","ENSG00000251578","7",142636924,142637384,460
"34389","ENSG00000251579","3",130927754,130928276,522
"34390","ENSG00000251580","4",6648695,6673965,25270
"34391","ENSG00000251583","5",149932014,149932668,654
"34392","ENSG00000251584","4",174522617,174541047,18430
"34393","ENSG00000251586","4",105171354,105178063,6709
"34394","ENSG00000251590","3",32063974,32066611,2637
"34395","ENSG00000251593","5",25909503,25911234,1731
"34396","ENSG00000251595","4",425435,474129,48694
"34397","ENSG00000251596","4",165404067,165406350,2283
"34398","ENSG00000251598","4",131978485,132345621,367136
"34399","ENSG00000251599","5",73132008,73150592,18584
"34400","ENSG00000251600","4",143559457,144343750,784293
"34401","ENSG00000251602","14",105416884,105419739,2855
"34402","ENSG00000251605","5",78307503,78307914,411
"34403","ENSG00000251609","4",120895494,120897083,1589
"34404","ENSG00000251610","3",130048143,130055920,7777
"34405","ENSG00000251611","4",151407551,151408835,1284
"34406","ENSG00000251613","5",72687112,72771733,84621
"34407","ENSG00000251614","3",132645831,132650383,4552
"34408","ENSG00000251615","4",8355090,8358338,3248
"34409","ENSG00000251616","5",133111055,133114475,3420
"34410","ENSG00000251619","4",188776657,188785511,8854
"34411","ENSG00000251620","4",97366681,97491899,125218
"34412","ENSG00000251621","2",161424015,161428774,4759
"34413","ENSG00000251623","5",176119545,176156937,37392
"34414","ENSG00000251624","4",9493736,9498066,4330
"34415","ENSG00000251629","5",20611806,20937800,325994
"34416","ENSG00000251630","4",49561285,49561470,185
"34417","ENSG00000251632","4",137545731,137603430,57699
"34418","ENSG00000251633","8",73905357,73915010,9653
"34419","ENSG00000251634","5",71102898,71128753,25855
"34420","ENSG00000251635","4",38564003,38572022,8019
"34421","ENSG00000251636","4",100812255,100814280,2025
"34422","ENSG00000251637","11",67886477,67906350,19873
"34423","ENSG00000251638","4",24768049,24768331,282
"34424","ENSG00000251639","4",1100016,1101558,1542
"34425","ENSG00000251642","4",38286994,38287491,497
"34426","ENSG00000251648","5",65732973,65733654,681
"34427","ENSG00000251649","4",126064128,126073370,9242
"34428","ENSG00000251652","4",1113639,1132977,19338
"34429","ENSG00000251654","5",25218973,25298612,79639
"34430","ENSG00000251655","12",11351823,11395566,43743
"34431","ENSG00000251656","5",42908208,42908667,459
"34432","ENSG00000251661","11",318640,325631,6991
"34433","ENSG00000251663","5",75225424,75225668,244
"34434","ENSG00000251664","5",140875302,141012347,137045
"34435","ENSG00000251665","17",50944104,50948750,4646
"34436","ENSG00000251666","5",177051714,177052963,1249
"34437","ENSG00000251667","5",176308063,176309013,950
"34438","ENSG00000251669","4",3941760,3955419,13659
"34439","ENSG00000251675","5",80128361,80143883,15522
"34440","ENSG00000251676","4",131727587,131791492,63905
"34441","ENSG00000251678","5",7344579,7345921,1342
"34442","ENSG00000251679","4",14134936,14143592,8656
"34443","ENSG00000251680","5",129500361,129905917,405556
"34444","ENSG00000251682","5",61347126,61347716,590
"34445","ENSG00000251685","4",69004862,69020414,15552
"34446","ENSG00000251687","4",145833118,145839580,6462
"34447","ENSG00000251688","4",147567606,147594589,26983
"34448","ENSG00000251689","4",269866,270175,309
"34449","ENSG00000251692","16",1485886,1488981,3095
"34450","ENSG00000251697","9",34478622,34478905,283
"34451","ENSG00000251698","17",66639269,66639383,114
"34452","ENSG00000251703","4",57002692,57002792,100
"34453","ENSG00000251706","16",30483135,30483195,60
"34454","ENSG00000251718","2",11561194,11561306,112
"34455","ENSG00000251720","1",63536711,63536770,59
"34456","ENSG00000251722","4",48574453,48574520,67
"34457","ENSG00000251724","5",75538598,75538658,60
"34458","ENSG00000251726","14",34845300,34845360,60
"34459","ENSG00000251728","7",140094697,140094792,95
"34460","ENSG00000251730","3",183454128,183454262,134
"34461","ENSG00000251733","9",19063656,19063786,130
"34462","ENSG00000251739","4",183705931,183706031,100
"34463","ENSG00000251745","9",37936707,37936768,61
"34464","ENSG00000251748","9",33868540,33868665,125
"34465","ENSG00000251752","9",83275941,83276114,173
"34466","ENSG00000251754","1",245043928,245044032,104
"34467","ENSG00000251756","14",51692752,51692861,109
"34468","ENSG00000251768","6",127317883,127317973,90
"34469","ENSG00000251774","3",12514706,12514807,101
"34470","ENSG00000251775","2",63883249,63883391,142
"34471","ENSG00000251778","21",41882205,41882300,95
"34472","ENSG00000251779","17",76319376,76319473,97
"34473","ENSG00000251783","10",42605158,42605263,105
"34474","ENSG00000251785","1",77614869,77614952,83
"34475","ENSG00000251787","3",142801207,142801268,61
"34476","ENSG00000251788","12",64228560,64228675,115
"34477","ENSG00000251791","2",233288676,233288940,264
"34478","ENSG00000251792","14",50086982,50087083,101
"34479","ENSG00000251794","16",74456541,74456611,70
"34480","ENSG00000251799","4",56818218,56818314,96
"34481","ENSG00000251804","3",142407657,142407737,80
"34482","ENSG00000251805","2",24273614,24273741,127
"34483","ENSG00000251807","X",41919254,41919349,95
"34484","ENSG00000251811","3",43472477,43472596,119
"34485","ENSG00000251812","17",4186326,4186424,98
"34486","ENSG00000251814","6",117299364,117299638,274
"34487","ENSG00000251815","15",25099499,25099594,95
"34488","ENSG00000251819","15",100551820,100551922,102
"34489","ENSG00000251821","4",127891991,127892082,91
"34490","ENSG00000251829","17",15782341,15782455,114
"34491","ENSG00000251834","9",15431899,15432006,107
"34492","ENSG00000251835","8",54152807,54152882,75
"34493","ENSG00000251841","Y",2784749,2784853,104
"34494","ENSG00000251842","5",149057554,149057656,102
"34495","ENSG00000251844","12",97552137,97552228,91
"34496","ENSG00000251850","2",69181897,69182003,106
"34497","ENSG00000251852","7",103433461,103433561,100
"34498","ENSG00000251858","14",41594463,41594591,128
"34499","ENSG00000251861","1",204727991,204728106,115
"34500","ENSG00000251862","11",34941837,34941920,83
"34501","ENSG00000251864","6",36672838,36672944,106
"34502","ENSG00000251865","17",58835899,58835994,95
"34503","ENSG00000251866","1",15542165,15542304,139
"34504","ENSG00000251867","8",80484561,80486699,2138
"34505","ENSG00000251868","16",72821933,72821992,59
"34506","ENSG00000251870","18",58926197,58926296,99
"34507","ENSG00000251874","4",83003412,83003517,105
"34508","ENSG00000251875","1",179576268,179576349,81
"34509","ENSG00000251878","4",184431966,184432049,83
"34510","ENSG00000251880","5",37327135,37327196,61
"34511","ENSG00000251883","20",25611153,25611223,70
"34512","ENSG00000251884","9",95142449,95142541,92
"34513","ENSG00000251887","5",31832439,31832535,96
"34514","ENSG00000251889","2",48340687,48340826,139
"34515","ENSG00000251891","15",85389823,85389884,61
"34516","ENSG00000251892","8",106729795,106729856,61
"34517","ENSG00000251893","12",75689152,75689304,152
"34518","ENSG00000251896","15",25101575,25101666,91
"34519","ENSG00000251898","12",6581474,6581609,135
"34520","ENSG00000251900","2",65555432,65555534,102
"34521","ENSG00000251906","4",104974672,104974771,99
"34522","ENSG00000251914","1",20841241,20841302,61
"34523","ENSG00000251916","6",32549940,32550090,150
"34524","ENSG00000251919","11",72621766,72621827,61
"34525","ENSG00000251922","10",6017054,6017194,140
"34526","ENSG00000251931","12",59450673,59450772,99
"34527","ENSG00000251934","11",3714772,3714875,103
"34528","ENSG00000251935","2",190553264,190553480,216
"34529","ENSG00000251939","18",46121615,46121721,106
"34530","ENSG00000251957","10",11923181,11923288,107
"34531","ENSG00000251958","1",78088988,78089083,95
"34532","ENSG00000251971","2",238028971,238029063,92
"34533","ENSG00000251972","21",25943044,25943145,101
"34534","ENSG00000251980","2",157912772,157912885,113
"34535","ENSG00000251982","2",217251556,217251875,319
"34536","ENSG00000251985","22",45624531,45624632,101
"34537","ENSG00000251988","6",159720415,159720540,125
"34538","ENSG00000251990","5",17156971,17157071,100
"34539","ENSG00000251991","11",14478892,14478953,61
"34540","ENSG00000251993","7",22298594,22298706,112
"34541","ENSG00000251994","18",9518119,9518260,141
"34542","ENSG00000252002","4",9792751,9792861,110
"34543","ENSG00000252003","7",122081720,122081781,61
"34544","ENSG00000252010","2",233275727,233276002,275
"34545","ENSG00000252011","1",246833448,246833529,81
"34546","ENSG00000252015","2",141167257,141167357,100
"34547","ENSG00000252018","1",52754322,52754462,140
"34548","ENSG00000252019","14",54859215,54859330,115
"34549","ENSG00000252021","20",45004348,45004454,106
"34550","ENSG00000252023","7",120672871,120672975,104
"34551","ENSG00000252026","16",68284223,68284318,95
"34552","ENSG00000252032","1",51538625,51538729,104
"34553","ENSG00000252033","11",78579255,78579356,101
"34554","ENSG00000252034","18",46077004,46077099,95
"34555","ENSG00000252036","10",110756456,110756723,267
"34556","ENSG00000252039","17",42891338,42891435,97
"34557","ENSG00000252040","16",68630223,68630354,131
"34558","ENSG00000252045","21",32538299,32538434,135
"34559","ENSG00000252050","X",38308112,38308241,129
"34560","ENSG00000252051","1",229410500,229410767,267
"34561","ENSG00000252053","3",194533503,194533583,80
"34562","ENSG00000252060","19",11996809,11996916,107
"34563","ENSG00000252061","15",78898840,78898936,96
"34564","ENSG00000252062","4",84886386,84886486,100
"34565","ENSG00000252066","15",53651977,53652123,146
"34566","ENSG00000252072","10",73706490,73706613,123
"34567","ENSG00000252076","10",58869184,58869528,344
"34568","ENSG00000252080","16",6748908,6748969,61
"34569","ENSG00000252081","11",105974826,105974931,105
"34570","ENSG00000252082","3",172703124,172703225,101
"34571","ENSG00000252087","4",90370123,90370427,304
"34572","ENSG00000252096","20",4868984,4869118,134
"34573","ENSG00000252097","18",76800664,76800774,110
"34574","ENSG00000252098","1",27255464,27255567,103
"34575","ENSG00000252101","16",75286712,75286800,88
"34576","ENSG00000252103","20",1529056,1529159,103
"34577","ENSG00000252104","4",64397694,64397787,93
"34578","ENSG00000252112","17",30246757,30246820,63
"34579","ENSG00000252118","10",12456483,12456631,148
"34580","ENSG00000252122","16",75409332,75409466,134
"34581","ENSG00000252126","7",66344303,66344414,111
"34582","ENSG00000252128","13",21139886,21139957,71
"34583","ENSG00000252130","2",191370938,191371044,106
"34584","ENSG00000252132","10",38043873,38043975,102
"34585","ENSG00000252135","1",148385829,148385963,134
"34586","ENSG00000252147","X",119456558,119456658,100
"34587","ENSG00000252148","2",201079842,201079944,102
"34588","ENSG00000252153","9",94809962,94810057,95
"34589","ENSG00000252156","6",75768059,75768158,99
"34590","ENSG00000252157","4",183653572,183653676,104
"34591","ENSG00000252164","9",34206134,34206241,107
"34592","ENSG00000252170","X",129518576,129518647,71
"34593","ENSG00000252171","15",45047103,45047215,112
"34594","ENSG00000252172","3",149917342,149917449,107
"34595","ENSG00000252174","3",196072819,196072880,61
"34596","ENSG00000252179","8",13536029,13536135,106
"34597","ENSG00000252183","4",121192797,121192903,106
"34598","ENSG00000252184","3",62118300,62118510,210
"34599","ENSG00000252192","12",122492113,122492241,128
"34600","ENSG00000252198","14",58441844,58441992,148
"34601","ENSG00000252200","19",44725984,44726058,74
"34602","ENSG00000252202","5",179847035,179847130,95
"34603","ENSG00000252204","12",31811088,31811190,102
"34604","ENSG00000252205","X",152250572,152250676,104
"34605","ENSG00000252206","12",56352387,56352450,63
"34606","ENSG00000252207","12",89726936,89727042,106
"34607","ENSG00000252210","8",68223318,68223402,84
"34608","ENSG00000252211","19",58363438,58363562,124
"34609","ENSG00000252212","17",59129276,59129458,182
"34610","ENSG00000252213","5",139276180,139276320,140
"34611","ENSG00000252214","2",74319399,74319501,102
"34612","ENSG00000252217","15",65502741,65502836,95
"34613","ENSG00000252218","6",43544144,43544270,126
"34614","ENSG00000252219","X",145992750,145992826,76
"34615","ENSG00000252222","1",184821428,184821489,61
"34616","ENSG00000252224","9",33174170,33174295,125
"34617","ENSG00000252225","22",36440880,36440970,90
"34618","ENSG00000252230","19",34637696,34637781,85
"34619","ENSG00000252231","1",173921070,173921200,130
"34620","ENSG00000252233","4",139794125,139794433,308
"34621","ENSG00000252236","1",156192063,156192203,140
"34622","ENSG00000252237","12",28319335,28319463,128
"34623","ENSG00000252242","17",64825765,64825819,54
"34624","ENSG00000252244","6",149516956,149517017,61
"34625","ENSG00000252246","2",33332898,33333007,109
"34626","ENSG00000252250","2",69334600,69334692,92
"34627","ENSG00000252254","1",8328067,8328179,112
"34628","ENSG00000252257","3",181968459,181968681,222
"34629","ENSG00000252262","1",162338643,162338742,99
"34630","ENSG00000252263","14",70496107,70496210,103
"34631","ENSG00000252266","4",5426885,5426984,99
"34632","ENSG00000252269","12",132995190,132995302,112
"34633","ENSG00000252271","16",58384442,58384542,100
"34634","ENSG00000252272","19",29001670,29001775,105
"34635","ENSG00000252274","17",72818836,72818972,136
"34636","ENSG00000252277","15",25108268,25108352,84
"34637","ENSG00000252279","17",43445507,43445613,106
"34638","ENSG00000252282","1",245023015,245023118,103
"34639","ENSG00000252283","17",28061967,28062068,101
"34640","ENSG00000252284","18",58600631,58600698,67
"34641","ENSG00000252290","1",237555040,237555171,131
"34642","ENSG00000252291","X",6061644,6061749,105
"34643","ENSG00000252294","X",102678707,102678813,106
"34644","ENSG00000252297","8",123342414,123342519,105
"34645","ENSG00000252307","4",9411178,9411253,75
"34646","ENSG00000252311","16",85781775,85781899,124
"34647","ENSG00000252312","14",36231555,36231774,219
"34648","ENSG00000252313","9",32293558,32293692,134
"34649","ENSG00000252316","7",148963315,148963410,95
"34650","ENSG00000252317","1",240341385,240341477,92
"34651","ENSG00000252321","2",85820435,85820612,177
"34652","ENSG00000252322","4",88583666,88583972,306
"34653","ENSG00000252325","18",21879801,21879904,103
"34654","ENSG00000252326","15",25097663,25097754,91
"34655","ENSG00000252329","11",12904817,12904988,171
"34656","ENSG00000252332","7",139448740,139448843,103
"34657","ENSG00000252333","2",229937814,229937882,68
"34658","ENSG00000252334","19",58483749,58483843,94
"34659","ENSG00000252335","13",95019235,95019336,101
"34660","ENSG00000252339","16",71563430,71563528,98
"34661","ENSG00000252341","5",10292041,10292148,107
"34662","ENSG00000252349","17",19662000,19662090,90
"34663","ENSG00000252350","4",156986372,156986693,321
"34664","ENSG00000252351","11",131385249,131385363,114
"34665","ENSG00000252353","18",3093568,3093629,61
"34666","ENSG00000252355","11",43435132,43435397,265
"34667","ENSG00000252357","1",173808489,173808622,133
"34668","ENSG00000252361","11",62815966,62816067,101
"34669","ENSG00000252363","17",8511125,8511188,63
"34670","ENSG00000252367","20",5113993,5114083,90
"34671","ENSG00000252370","17",34120056,34120167,111
"34672","ENSG00000252371","1",238325687,238325788,101
"34673","ENSG00000252373","5",31820564,31820638,74
"34674","ENSG00000252376","15",50463381,50463498,117
"34675","ENSG00000252377","X",51870706,51870809,103
"34676","ENSG00000252383","17",16098704,16098807,103
"34677","ENSG00000252390","12",31594093,31594206,113
"34678","ENSG00000252391","17",78696694,78696797,103
"34679","ENSG00000252393","12",121604902,121605012,110
"34680","ENSG00000252396","1",237120807,237121109,302
"34681","ENSG00000252408","19",3521248,3521320,72
"34682","ENSG00000252409","3",41687868,41688033,165
"34683","ENSG00000252410","3",45034474,45034588,114
"34684","ENSG00000252412","22",37013225,37013319,94
"34685","ENSG00000252414","2",64578892,64578997,105
"34686","ENSG00000252415","12",73679188,73679296,108
"34687","ENSG00000252417","1",15608078,15608145,67
"34688","ENSG00000252420","3",61739127,61739229,102
"34689","ENSG00000252421","12",31802958,31803090,132
"34690","ENSG00000252422","20",18433842,18433944,102
"34691","ENSG00000252424","14",49552633,49552748,115
"34692","ENSG00000252427","11",46758766,46758873,107
"34693","ENSG00000252431","6",151280515,151280612,97
"34694","ENSG00000252433","1",67102645,67102779,134
"34695","ENSG00000252438","10",12415928,12416000,72
"34696","ENSG00000252441","X",115545637,115545717,80
"34697","ENSG00000252444","6",106304176,106304286,110
"34698","ENSG00000252448","1",37884237,37884317,80
"34699","ENSG00000252450","1",32286452,32286561,109
"34700","ENSG00000252451","4",150970671,150970782,111
"34701","ENSG00000252452","2",232782665,232782766,101
"34702","ENSG00000252456","17",4056756,4056876,120
"34703","ENSG00000252461","16",28881480,28881607,127
"34704","ENSG00000252464","5",178619728,178619998,270
"34705","ENSG00000252469","14",103550345,103550406,61
"34706","ENSG00000252473","2",39283657,39283791,134
"34707","ENSG00000252474","14",49839725,49839827,102
"34708","ENSG00000252479","10",31259599,31259704,105
"34709","ENSG00000252480","7",39768341,39768444,103
"34710","ENSG00000252481","14",95533355,95533629,274
"34711","ENSG00000252485","2",206007880,206007974,94
"34712","ENSG00000252487","6",151298841,151298933,92
"34713","ENSG00000252489","4",56288485,56288584,99
"34714","ENSG00000252490","2",43772120,43772350,230
"34715","ENSG00000252491","X",26790142,26790286,144
"34716","ENSG00000252494","11",78133420,78133522,102
"34717","ENSG00000252496","13",79389534,79389631,97
"34718","ENSG00000252498","6",75644084,75644177,93
"34719","ENSG00000252499","13",27488138,27488232,94
"34720","ENSG00000252503","4",139055475,139055578,103
"34721","ENSG00000252505","8",33540040,33540137,97
"34722","ENSG00000252510","1",116962347,116962471,124
"34723","ENSG00000252512","6",32078508,32078628,120
"34724","ENSG00000252516","1",247204570,247204661,91
"34725","ENSG00000252519","11",23849778,23849882,104
"34726","ENSG00000252537","10",16005808,16005923,115
"34727","ENSG00000252539","19",453134,453245,111
"34728","ENSG00000252540","20",49794811,49794914,103
"34729","ENSG00000252542","9",133350847,133350912,65
"34730","ENSG00000252544","4",151300518,151300613,95
"34731","ENSG00000252546","19",12070164,12070271,107
"34732","ENSG00000252549","20",35647328,35647430,102
"34733","ENSG00000252552","1",174996524,174996629,105
"34734","ENSG00000252554","6",129436875,129436980,105
"34735","ENSG00000252562","3",23613661,23613759,98
"34736","ENSG00000252568","11",9843815,9843876,61
"34737","ENSG00000252569","16",53443228,53443332,104
"34738","ENSG00000252577","17",60231516,60231646,130
"34739","ENSG00000252578","1",23163953,23164053,100
"34740","ENSG00000252581","3",149525631,149525726,95
"34741","ENSG00000252583","X",147250151,147250230,79
"34742","ENSG00000252585","12",27752874,27752986,112
"34743","ENSG00000252591","19",17972025,17972117,92
"34744","ENSG00000252598","18",72751952,72752051,99
"34745","ENSG00000252604","4",154790291,154790484,193
"34746","ENSG00000252606","21",43996322,43996420,98
"34747","ENSG00000252608","16",81106533,81106639,106
"34748","ENSG00000252611","10",114969460,114969568,108
"34749","ENSG00000252612","1",185266535,185266627,92
"34750","ENSG00000252614","15",101648206,101648312,106
"34751","ENSG00000252615","6",151378000,151378099,99
"34752","ENSG00000252618","17",40374089,40374176,87
"34753","ENSG00000252619","21",42417497,42417593,96
"34754","ENSG00000252620","3",195523087,195523221,134
"34755","ENSG00000252621","10",37303000,37303109,109
"34756","ENSG00000252623","20",32008351,32008472,121
"34757","ENSG00000252627","X",123874459,123874565,106
"34758","ENSG00000252633","Y",7324297,7324595,298
"34759","ENSG00000252634","10",21785292,21785587,295
"34760","ENSG00000252636","17",49036352,49036455,103
"34761","ENSG00000252637","8",67099302,67099425,123
"34762","ENSG00000252639","10",27193358,27193500,142
"34763","ENSG00000252641","3",133664926,133665034,108
"34764","ENSG00000252643","7",102834605,102834708,103
"34765","ENSG00000252652","11",43331261,43331356,95
"34766","ENSG00000252653","17",66267743,66267848,105
"34767","ENSG00000252657","17",29777619,29777744,125
"34768","ENSG00000252658","6",157934168,157934257,89
"34769","ENSG00000252660","12",62935701,62935802,101
"34770","ENSG00000252661","19",15145215,15145318,103
"34771","ENSG00000252671","5",10337277,10337386,109
"34772","ENSG00000252677","18",21711950,21712119,169
"34773","ENSG00000252680","18",9844717,9844846,129
"34774","ENSG00000252684","5",76948791,76948870,79
"34775","ENSG00000252685","17",66638271,66638374,103
"34776","ENSG00000252686","14",29811916,29812018,102
"34777","ENSG00000252688","2",133333829,133333930,101
"34778","ENSG00000252690","15",82752884,82757208,4324
"34779","ENSG00000252692","1",206080239,206080324,85
"34780","ENSG00000252695","13",24162416,24162504,88
"34781","ENSG00000252707","17",12036496,12036637,141
"34782","ENSG00000252711","6",47715283,47715601,318
"34783","ENSG00000252713","7",73507208,73507274,66
"34784","ENSG00000252719","X",139909904,139910034,130
"34785","ENSG00000252739","4",102837047,102837099,52
"34786","ENSG00000252742","2",128350829,128350927,98
"34787","ENSG00000252743","6",31756951,31757053,102
"34788","ENSG00000252744","1",148330271,148330394,123
"34789","ENSG00000252746","14",37187219,37187314,95
"34790","ENSG00000252747","12",88051701,88051778,77
"34791","ENSG00000252750","1",112634719,112634784,65
"34792","ENSG00000252751","3",124407691,124407783,92
"34793","ENSG00000252755","8",98048856,98048962,106
"34794","ENSG00000252756","2",36867398,36867495,97
"34795","ENSG00000252757","4",86336318,86336614,296
"34796","ENSG00000252759","2",200863152,200863247,95
"34797","ENSG00000252761","6",30932618,30932709,91
"34798","ENSG00000252763","3",159808416,159808570,154
"34799","ENSG00000252764","8",100683488,100683574,86
"34800","ENSG00000252766","Y",19018983,19019087,104
"34801","ENSG00000252767","6",40407853,40407955,102
"34802","ENSG00000252768","3",52551846,52551943,97
"34803","ENSG00000252769","11",7889182,7889279,97
"34804","ENSG00000252770","12",68911921,68911982,61
"34805","ENSG00000252772","9",92820977,92821079,102
"34806","ENSG00000252777","1",28689665,28689794,129
"34807","ENSG00000252779","2",171856566,171856670,104
"34808","ENSG00000252782","14",58292293,58292388,95
"34809","ENSG00000252784","1",63338263,63338372,109
"34810","ENSG00000252796","4",39621012,39621073,61
"34811","ENSG00000252797","1",89987713,89987944,231
"34812","ENSG00000252798","16",21587627,21587864,237
"34813","ENSG00000252800","14",63479272,63479413,141
"34814","ENSG00000252804","2",43408307,43408412,105
"34815","ENSG00000252814","16",76287630,76287739,109
"34816","ENSG00000252815","4",55031965,55032071,106
"34817","ENSG00000252816","11",21383801,21383909,108
"34818","ENSG00000252820","7",138175045,138175136,91
"34819","ENSG00000252821","7",33001950,33002054,104
"34820","ENSG00000252822","1",236060677,236060772,95
"34821","ENSG00000252824","7",102194076,102194164,88
"34822","ENSG00000252835","17",7906122,7906260,138
"34823","ENSG00000252839","14",73246818,73246880,62
"34824","ENSG00000252845","2",96956708,96956815,107
"34825","ENSG00000252847","9",95859904,95860016,112
"34826","ENSG00000252854","13",46249942,46250213,271
"34827","ENSG00000252859","22",41168217,41168316,99
"34828","ENSG00000252860","1",200054061,200054165,104
"34829","ENSG00000252864","8",140940562,140940663,101
"34830","ENSG00000252874","11",47820200,47820289,89
"34831","ENSG00000252879","1",212099521,212099676,155
"34832","ENSG00000252882","17",43395993,43396091,98
"34833","ENSG00000252886","12",119631090,119631386,296
"34834","ENSG00000252887","16",89443318,89443424,106
"34835","ENSG00000252892","2",64994746,64994860,114
"34836","ENSG00000252903","X",31348192,31348296,104
"34837","ENSG00000252904","5",65961183,65961319,136
"34838","ENSG00000252905","11",8845263,8845358,95
"34839","ENSG00000252906","1",175968398,175968540,142
"34840","ENSG00000252908","5",17240611,17240715,104
"34841","ENSG00000252913","4",48932755,48932854,99
"34842","ENSG00000252914","3",136721394,136721495,101
"34843","ENSG00000252915","21",39344537,39344628,91
"34844","ENSG00000252916","2",200899020,200899121,101
"34845","ENSG00000252917","12",42347061,42347214,153
"34846","ENSG00000252919","14",49592236,49592337,101
"34847","ENSG00000252927","16",9600097,9600228,131
"34848","ENSG00000252929","7",6057500,6057604,104
"34849","ENSG00000252933","19",1616492,1616595,103
"34850","ENSG00000252942","9",99145840,99145966,126
"34851","ENSG00000252944","6",104766822,104766926,104
"34852","ENSG00000252947","1",27834401,27834566,165
"34853","ENSG00000252950","21",32563075,32563210,135
"34854","ENSG00000252951","4",147745303,147745417,114
"34855","ENSG00000252952","13",23217432,23217534,102
"34856","ENSG00000252956","1",9437669,9437778,109
"34857","ENSG00000252957","15",100074081,100074190,109
"34858","ENSG00000252960","9",18651147,18651450,303
"34859","ENSG00000252962","19",2503047,2503141,94
"34860","ENSG00000252965","3",125528244,125528349,105
"34861","ENSG00000252970","4",39936753,39936855,102
"34862","ENSG00000252971","17",20290257,20290358,101
"34863","ENSG00000252973","19",19232855,19232947,92
"34864","ENSG00000252975","4",39710085,39710176,91
"34865","ENSG00000252980","3",44071087,44071186,99
"34866","ENSG00000252982","3",174057641,174057864,223
"34867","ENSG00000252983","7",43194421,43194482,61
"34868","ENSG00000252984","15",57405074,57405175,101
"34869","ENSG00000252985","9",126426893,126426970,77
"34870","ENSG00000252990","6",39620345,39620464,119
"34871","ENSG00000252991","9",1001858,1001963,105
"34872","ENSG00000252992","11",117263799,117263952,153
"34873","ENSG00000252993","10",92076242,92076365,123
"34874","ENSG00000252994","10",102803929,102804031,102
"34875","ENSG00000252995","15",79817349,79817450,101
"34876","ENSG00000252996","12",2954240,2954338,98
"34877","ENSG00000253006","2",229236340,229236609,269
"34878","ENSG00000253008","2",207109987,207110073,86
"34879","ENSG00000253010","6",53415294,53415607,313
"34880","ENSG00000253013","4",186130021,186130155,134
"34881","ENSG00000253015","5",139333038,139333365,327
"34882","ENSG00000253019","4",151576766,151576916,150
"34883","ENSG00000253020","3",174631823,174632064,241
"34884","ENSG00000253021","19",44085213,44085303,90
"34885","ENSG00000253022","1",6540854,6540964,110
"34886","ENSG00000253024","11",67395210,67395311,101
"34887","ENSG00000253025","1",176243862,176244029,167
"34888","ENSG00000253030","15",59171183,59171262,79
"34889","ENSG00000253032","5",56125671,56125770,99
"34890","ENSG00000253039","1",44932323,44932431,108
"34891","ENSG00000253040","18",42270589,42270715,126
"34892","ENSG00000253041","9",101322477,101322533,56
"34893","ENSG00000253042","1",202527310,202527427,117
"34894","ENSG00000253043","8",130004528,130004601,73
"34895","ENSG00000253047","1",150600539,150600659,120
"34896","ENSG00000253048","19",42472875,42473009,134
"34897","ENSG00000253049","3",3102913,3103015,102
"34898","ENSG00000253054","10",35135443,35135502,59
"34899","ENSG00000253059","14",35756327,35756463,136
"34900","ENSG00000253064","17",29424762,29424867,105
"34901","ENSG00000253066","10",114111414,114111517,103
"34902","ENSG00000253070","10",35231331,35231394,63
"34903","ENSG00000253077","4",151971497,151971613,116
"34904","ENSG00000253079","9",126408041,126408410,369
"34905","ENSG00000253080","12",111339527,111339621,94
"34906","ENSG00000253084","17",35093909,35093973,64
"34907","ENSG00000253085","1",13696070,13696199,129
"34908","ENSG00000253086","1",11152350,11152452,102
"34909","ENSG00000253087","3",134780527,134780627,100
"34910","ENSG00000253088","7",152402780,152402893,113
"34911","ENSG00000253089","12",127321355,127321529,174
"34912","ENSG00000253092","3",183452567,183452764,197
"34913","ENSG00000253093","5",16853994,16854114,120
"34914","ENSG00000253097","1",205566716,205566799,83
"34915","ENSG00000253098","5",40911067,40911128,61
"34916","ENSG00000253099","11",111383092,111383219,127
"34917","ENSG00000253100","8",25593197,25688786,95589
"34918","ENSG00000253102","17",50396438,50397888,1450
"34919","ENSG00000253103","8",111093263,111236203,142940
"34920","ENSG00000253104","5",22139247,22141468,2221
"34921","ENSG00000253105","8",96370800,96387438,16638
"34922","ENSG00000253106","8",124488510,124491643,3133
"34923","ENSG00000253108","8",34228439,34346731,118292
"34924","ENSG00000253109","5",174039751,174040240,489
"34925","ENSG00000253110","5",171773652,171774739,1087
"34926","ENSG00000253111","8",125466939,125541373,74434
"34927","ENSG00000253112","8",30596914,30597532,618
"34928","ENSG00000253114","8",54696398,54697127,729
"34929","ENSG00000253115","8",74103516,74106744,3228
"34930","ENSG00000253116","8",58091442,58106294,14852
"34931","ENSG00000253119","5",154337471,154338452,981
"34932","ENSG00000253120","22",22580014,22580296,282
"34933","ENSG00000253121","8",63024372,63025294,922
"34934","ENSG00000253122","8",110609241,110632394,23153
"34935","ENSG00000253123","8",37326575,37331991,5416
"34936","ENSG00000253125","8",22690150,22798616,108466
"34937","ENSG00000253126","22",22198560,22199011,451
"34938","ENSG00000253130","8",8561386,8574038,12652
"34939","ENSG00000253131","14",106609762,106610196,434
"34940","ENSG00000253132","14",106643142,106643585,443
"34941","ENSG00000253133","8",41509593,41578421,68828
"34942","ENSG00000253137","8",84678798,84679842,1044
"34943","ENSG00000253138","8",66192093,66197315,5222
"34944","ENSG00000253139","8",56536758,56540497,3739
"34945","ENSG00000253140","8",48515852,48518157,2305
"34946","ENSG00000253141","5",173463484,173484584,21100
"34947","ENSG00000253142","8",22895434,22897813,2379
"34948","ENSG00000253143","8",70471112,70480623,9511
"34949","ENSG00000253146","5",154559308,154560440,1132
"34950","ENSG00000253147","8",20953127,20968904,15777
"34951","ENSG00000253148","1",192316992,192367285,50293
"34952","ENSG00000253152","22",22738944,22739187,243
"34953","ENSG00000253153","8",101562008,101562488,480
"34954","ENSG00000253154","8",85833377,85951083,117706
"34955","ENSG00000253155","5",157422439,157422873,434
"34956","ENSG00000253156","8",111621458,111621797,339
"34957","ENSG00000253159","5",141430507,141512975,82468
"34958","ENSG00000253160","8",39309909,39310443,534
"34959","ENSG00000253161","8",37421341,37554183,132842
"34960","ENSG00000253163","5",179377531,179378761,1230
"34961","ENSG00000253164","8",20350210,20372769,22559
"34962","ENSG00000253165","8",133775551,133777352,1801
"34963","ENSG00000253166","8",202660,202897,237
"34964","ENSG00000253167","8",125040684,125044989,4305
"34965","ENSG00000253168","8",17703988,17706187,2199
"34966","ENSG00000253171","8",87974165,88019113,44948
"34967","ENSG00000253172","5",173144162,173145039,877
"34968","ENSG00000253173","8",70103798,70104179,381
"34969","ENSG00000253175","8",94565036,94565715,679
"34970","ENSG00000253176","8",27838477,27840382,1905
"34971","ENSG00000253177","8",92668660,92683450,14790
"34972","ENSG00000253180","8",99003407,99003842,435
"34973","ENSG00000253181","8",37717579,37733756,16177
"34974","ENSG00000253183","7",139502453,139503812,1359
"34975","ENSG00000253184","8",16604255,16664879,60624
"34976","ENSG00000253186","8",43253732,43254089,357
"34977","ENSG00000253187","7",27168619,27171915,3296
"34978","ENSG00000253188","7",142487863,142488295,432
"34979","ENSG00000253189","8",6036433,6036974,541
"34980","ENSG00000253190","8",66112667,66126632,13965
"34981","ENSG00000253191","2",89928422,89928867,445
"34982","ENSG00000253194","6",118934770,119182745,247975
"34983","ENSG00000253196","8",142763116,142766427,3311
"34984","ENSG00000253197","8",92882984,92965645,82661
"34985","ENSG00000253199","8",20972021,20995119,23098
"34986","ENSG00000253200","8",22613908,22616657,2749
"34987","ENSG00000253203","5",69639459,69679259,39800
"34988","ENSG00000253204","8",30921060,30921335,275
"34989","ENSG00000253205","8",63384839,63470205,85366
"34990","ENSG00000253206","8",49536386,49554414,18028
"34991","ENSG00000253207","8",113600310,113616958,16648
"34992","ENSG00000253208","8",26547669,26548463,794
"34993","ENSG00000253209","14",106666092,106666532,440
"34994","ENSG00000253210","8",141124717,141130064,5347
"34995","ENSG00000253213","5",171251866,171252982,1116
"34996","ENSG00000253214","8",81149107,81165266,16159
"34997","ENSG00000253215","8",17882043,17882661,618
"34998","ENSG00000253217","8",100337595,100350707,13112
"34999","ENSG00000253218","5",172254418,172255439,1021
"35000","ENSG00000253220","8",126497385,126500440,3055
"35001","ENSG00000253223","8",66984135,66986187,2052
"35002","ENSG00000253224","5",109884610,109885423,813
"35003","ENSG00000253227","8",124271667,124279580,7913
"35004","ENSG00000253228","8",107983116,107983965,849
"35005","ENSG00000253229","8",75302296,75302574,278
"35006","ENSG00000253230","8",9899871,9906678,6807
"35007","ENSG00000253232","8",33523154,33523291,137
"35008","ENSG00000253233","8",39867436,39867812,376
"35009","ENSG00000253234","22",22856762,22857038,276
"35010","ENSG00000253235","8",73326991,73370601,43610
"35011","ENSG00000253236","5",164448161,164467879,19718
"35012","ENSG00000253237","8",80351132,80351416,284
"35013","ENSG00000253238","8",80265907,80484481,218574
"35014","ENSG00000253239","22",22026076,22026593,517
"35015","ENSG00000253240","14",106392774,106393231,457
"35016","ENSG00000253242","22",22075366,22075666,300
"35017","ENSG00000253244","5",174056060,174056585,525
"35018","ENSG00000253245","11",103407441,103408376,935
"35019","ENSG00000253247","14",106827869,106828163,294
"35020","ENSG00000253250","8",90958471,90985238,26767
"35021","ENSG00000253251","5",65624765,65630891,6126
"35022","ENSG00000253252","8",9180251,9182519,2268
"35023","ENSG00000253256","5",159209921,159248796,38875
"35024","ENSG00000253257","8",13353401,13353530,129
"35025","ENSG00000253258","8",123181638,123182788,1150
"35026","ENSG00000253260","8",59561324,59604774,43450
"35027","ENSG00000253263","8",102891876,102893608,1732
"35028","ENSG00000253266","8",141055290,141060596,5306
"35029","ENSG00000253267","8",1565509,1622417,56908
"35030","ENSG00000253269","5",169772966,169779365,6399
"35031","ENSG00000253270","8",19678572,19688934,10362
"35032","ENSG00000253271","8",117055818,117056145,327
"35033","ENSG00000253273","8",73831143,73831947,804
"35034","ENSG00000253274","14",106680603,106681042,439
"35035","ENSG00000253276","7",106654360,106661158,6798
"35036","ENSG00000253278","2",89019992,89020686,694
"35037","ENSG00000253279","8",29920560,29953724,33164
"35038","ENSG00000253280","8",19254241,19257334,3093
"35039","ENSG00000253281","8",58255771,58272137,16366
"35040","ENSG00000253282","8",101287445,101293783,6338
"35041","ENSG00000253283","8",85086615,85087186,571
"35042","ENSG00000253284","12",19147074,19154659,7585
"35043","ENSG00000253286","8",123614219,123667248,53029
"35044","ENSG00000253287","8",71779605,71792875,13270
"35045","ENSG00000253288","8",137809444,138083657,274213
"35046","ENSG00000253290","8",27903229,27903495,266
"35047","ENSG00000253291","7",142511626,142512127,501
"35048","ENSG00000253292","8",86593755,86594589,834
"35049","ENSG00000253293","7",27170592,27180261,9669
"35050","ENSG00000253294","14",106440950,106441007,57
"35051","ENSG00000253295","5",172755457,172762587,7130
"35052","ENSG00000253297","5",148644687,148646390,1703
"35053","ENSG00000253298","5",159448556,159466291,17735
"35054","ENSG00000253299","8",100165226,100165478,252
"35055","ENSG00000253300","8",20655184,20700152,44968
"35056","ENSG00000253301","8",57142659,57244793,102134
"35057","ENSG00000253302","8",73420004,73441526,21522
"35058","ENSG00000253304","1",29119429,29123903,4474
"35059","ENSG00000253305","5",141408021,141512979,104958
"35060","ENSG00000253307","8",141252286,141253292,1006
"35061","ENSG00000253308","7",27239243,27241228,1985
"35062","ENSG00000253309","13",51335773,51364735,28962
"35063","ENSG00000253310","14",106831767,106832052,285
"35064","ENSG00000253311","5",159698586,159937766,239180
"35065","ENSG00000253313","1",43281883,43285617,3734
"35066","ENSG00000253314","8",46822174,46907309,85135
"35067","ENSG00000253315","5",159227715,159245127,17412
"35068","ENSG00000253317","8",72196334,72202269,5935
"35069","ENSG00000253318","8",105194990,105196969,1979
"35070","ENSG00000253320","8",102864271,103002424,138153
"35071","ENSG00000253321","5",90353037,90356609,3572
"35072","ENSG00000253325","14",106377300,106377733,433
"35073","ENSG00000253326","1",243054861,243056394,1533
"35074","ENSG00000253327","8",116874424,116876868,2444
"35075","ENSG00000253328","8",102242040,102242619,579
"35076","ENSG00000253330","8",47511034,47512141,1107
"35077","ENSG00000253331","5",164119098,164234097,114999
"35078","ENSG00000253333","5",70495100,70500903,5803
"35079","ENSG00000253334","8",81791823,81815714,23891
"35080","ENSG00000253335","8",18989279,19000952,11673
"35081","ENSG00000253336","8",123288355,123290503,2148
"35082","ENSG00000253338","22",22661299,22661542,243
"35083","ENSG00000253339","8",73358670,73364212,5542
"35084","ENSG00000253340","8",50859530,50860062,532
"35085","ENSG00000253341","8",74603244,74604244,1000
"35086","ENSG00000253342","8",25776679,25777456,777
"35087","ENSG00000253343","8",8555738,8560965,5227
"35088","ENSG00000253344","8",37626015,37674387,48372
"35089","ENSG00000253346","8",30331961,30332277,316
"35090","ENSG00000253347","17",47409322,47423526,14204
"35091","ENSG00000253348","5",170747047,170788650,41603
"35092","ENSG00000253351","8",95206876,95216525,9649
"35093","ENSG00000253352","22",30969245,30979395,10150
"35094","ENSG00000253354","8",40369981,40402010,32029
"35095","ENSG00000253355","8",101128987,101133486,4499
"35096","ENSG00000253356","8",38148741,38163772,15031
"35097","ENSG00000253357","5",167721363,167729124,7761
"35098","ENSG00000253358","8",91016588,91018655,2067
"35099","ENSG00000253359","14",106396676,106397114,438
"35100","ENSG00000253361","8",38543276,38560877,17601
"35101","ENSG00000253362","8",84163449,84164564,1115
"35102","ENSG00000253363","8",36378069,36779209,401140
"35103","ENSG00000253364","14",105647924,105649057,1133
"35104","ENSG00000253366","5",70751184,70795914,44730
"35105","ENSG00000253368","1",26993692,27000886,7194
"35106","ENSG00000253369","8",53394110,53484067,89957
"35107","ENSG00000253370","5",156458398,156458507,109
"35108","ENSG00000253372","8",122807746,122816517,8771
"35109","ENSG00000253373","8",69175579,69178189,2610
"35110","ENSG00000253374","8",81521618,81533275,11657
"35111","ENSG00000253376","8",57888975,57934329,45354
"35112","ENSG00000253377","8",31275542,31390805,115263
"35113","ENSG00000253380","8",49496763,49512180,15417
"35114","ENSG00000253383","8",73590574,73590883,309
"35115","ENSG00000253384","8",18088569,18089687,1118
"35116","ENSG00000253385","8",102854455,102856075,1620
"35117","ENSG00000253389","8",41660991,41665566,4575
"35118","ENSG00000253390","8",23458601,23484971,26370
"35119","ENSG00000253392","19",2908371,2926817,18446
"35120","ENSG00000253394","8",90221341,90687863,466522
"35121","ENSG00000253395","8",101122145,101126158,4013
"35122","ENSG00000253396","8",41435298,41440419,5121
"35123","ENSG00000253397","8",27904481,27910310,5829
"35124","ENSG00000253398","8",119419910,119462350,42440
"35125","ENSG00000253399","4",1358479,1359461,982
"35126","ENSG00000253400","9",26801733,26805862,4129
"35127","ENSG00000253401","8",87575598,87576508,910
"35128","ENSG00000253403","5",161687347,161689408,2061
"35129","ENSG00000253404","5",138744434,138753309,8875
"35130","ENSG00000253405","7",27241429,27247229,5800
"35131","ENSG00000253406","5",149216523,149276805,60282
"35132","ENSG00000253407","8",131129761,131144948,15187
"35133","ENSG00000253408","8",42233674,42271266,37592
"35134","ENSG00000253409","7",142455174,142455635,461
"35135","ENSG00000253412","14",106142287,106142577,290
"35136","ENSG00000253413","8",59760047,59760263,216
"35137","ENSG00000253414","8",37516399,37521447,5048
"35138","ENSG00000253415","8",98904603,98905671,1068
"35139","ENSG00000253416","8",76904591,76913399,8808
"35140","ENSG00000253417","5",160931778,160938626,6848
"35141","ENSG00000253418","8",43513643,43514421,778
"35142","ENSG00000253420","8",105662352,105685765,23413
"35143","ENSG00000253421","8",142858354,142858797,443
"35144","ENSG00000253424","5",158256137,158258436,2299
"35145","ENSG00000253428","5",173689459,173705849,16390
"35146","ENSG00000253430","8",26422593,26423929,1336
"35147","ENSG00000253431","8",62863082,62864181,1099
"35148","ENSG00000253433","8",134838069,134842637,4568
"35149","ENSG00000253434","8",111376639,111757710,381071
"35150","ENSG00000253435","2",88931666,88932380,714
"35151","ENSG00000253437","8",38122374,38122480,106
"35152","ENSG00000253438","8",126556323,127419050,862727
"35153","ENSG00000253439","5",173085342,173086210,868
"35154","ENSG00000253440","14",106369107,106369546,439
"35155","ENSG00000253441","14",106289029,106289479,450
"35156","ENSG00000253445","5",172690454,172697720,7266
"35157","ENSG00000253447","5",174081506,174086618,5112
"35158","ENSG00000253448","22",22850375,22850624,249
"35159","ENSG00000253449","5",158225352,158234376,9024
"35160","ENSG00000253451","22",22664473,22664907,434
"35161","ENSG00000253452","8",35862123,36191194,329071
"35162","ENSG00000253454","8",104566086,104566429,343
"35163","ENSG00000253455","8",48620465,48623895,3430
"35164","ENSG00000253456","5",158985806,158987199,1393
"35165","ENSG00000253457","8",30638600,30646064,7464
"35166","ENSG00000253458","14",106163583,106163802,219
"35167","ENSG00000253460","22",16921443,16922173,730
"35168","ENSG00000253463","8",123123106,123123682,576
"35169","ENSG00000253467","14",106425359,106425654,295
"35170","ENSG00000253468","8",98412882,98413784,902
"35171","ENSG00000253469","5",167164934,167168401,3467
"35172","ENSG00000253470","8",125749055,125750241,1186
"35173","ENSG00000253471","8",23707141,23789487,82346
"35174","ENSG00000253472","5",151378003,151378640,637
"35175","ENSG00000253474","8",49086301,49229174,142873
"35176","ENSG00000253475","8",51895957,51896374,417
"35177","ENSG00000253476","8",25425521,25426580,1059
"35178","ENSG00000253477","8",103483398,103501676,18278
"35179","ENSG00000253479","8",69424849,69448282,23433
"35180","ENSG00000253481","22",16933521,16934003,482
"35181","ENSG00000253482","14",106314651,106314975,324
"35182","ENSG00000253483","8",23483016,23483534,518
"35183","ENSG00000253484","8",49817586,49820944,3358
"35184","ENSG00000253485","5",141364232,141512979,148747
"35185","ENSG00000253488","8",23634876,23635507,631
"35186","ENSG00000253489","8",111179193,111179872,679
"35187","ENSG00000253490","8",29748309,29798492,50183
"35188","ENSG00000253495","8",119618162,119618474,312
"35189","ENSG00000253496","8",16598758,16915044,316286
"35190","ENSG00000253497","2",89045995,89046466,471
"35191","ENSG00000253500","8",87540835,87755718,214883
"35192","ENSG00000253502","8",47194002,47194347,345
"35193","ENSG00000253503","8",82514568,82677153,162585
"35194","ENSG00000253504","8",36277763,36278886,1123
"35195","ENSG00000253505","8",8414204,8424648,10444
"35196","ENSG00000253506","17",61590426,61591202,776
"35197","ENSG00000253507","8",131308545,131317632,9087
"35198","ENSG00000253508","7",27186573,27193448,6875
"35199","ENSG00000253509","8",41275115,41277003,1888
"35200","ENSG00000253510","8",5506068,5509126,3058
"35201","ENSG00000253513","8",124996985,124998198,1213
"35202","ENSG00000253515","2",46499731,46501278,1547
"35203","ENSG00000253516","8",80812142,80812581,439
"35204","ENSG00000253517","8",62855068,62857134,2066
"35205","ENSG00000253519","5",157565964,157569098,3134
"35206","ENSG00000253520","5",179527224,179527513,289
"35207","ENSG00000253521","8",132507962,132565246,57284
"35208","ENSG00000253522","5",160438594,160487426,48832
"35209","ENSG00000253523","8",58031334,58032682,1348
"35210","ENSG00000253524","8",36004316,36095046,90730
"35211","ENSG00000253525","8",91157285,91158748,1463
"35212","ENSG00000253526","8",105826570,105834038,7468
"35213","ENSG00000253527","5",167306273,167309870,3597
"35214","ENSG00000253528","8",94974573,94974853,280
"35215","ENSG00000253532","8",99119352,99120581,1229
"35216","ENSG00000253534","7",142507382,142507810,428
"35217","ENSG00000253535","8",24295814,24912073,616259
"35218","ENSG00000253536","5",71475761,71476316,555
"35219","ENSG00000253537","5",141382739,141512975,130236
"35220","ENSG00000253539","8",99796615,99799187,2572
"35221","ENSG00000253540","3",130099092,130111472,12380
"35222","ENSG00000253541","8",56476826,56477987,1161
"35223","ENSG00000253542","8",56373064,56395365,22301
"35224","ENSG00000253543","8",126582631,126583006,375
"35225","ENSG00000253544","8",61909984,61910802,818
"35226","ENSG00000253545","14",106586376,106586826,450
"35227","ENSG00000253547","11",63046785,63048126,1341
"35228","ENSG00000253548","3",191461163,191461456,293
"35229","ENSG00000253549","8",85440596,85464915,24319
"35230","ENSG00000253550","8",6473845,6474288,443
"35231","ENSG00000253551","8",52194362,52199580,5218
"35232","ENSG00000253552","7",27107777,27134302,26525
"35233","ENSG00000253553","8",88326836,88887573,560737
"35234","ENSG00000253554","8",63687179,64369176,681997
"35235","ENSG00000253556","8",103088796,103090671,1875
"35236","ENSG00000253557","8",19084992,19259469,174477
"35237","ENSG00000253558","5",78041879,78044138,2259
"35238","ENSG00000253559","2",189762704,189765556,2852
"35239","ENSG00000253560","8",27697217,27697526,309
"35240","ENSG00000253561","8",133771409,133814537,43128
"35241","ENSG00000253562","8",99091738,99094060,2322
"35242","ENSG00000253563","14",36519278,36523016,3738
"35243","ENSG00000253564","8",73215929,73216627,698
"35244","ENSG00000253567","8",28447264,28455902,8638
"35245","ENSG00000253569","8",33722305,33723079,774
"35246","ENSG00000253570","8",38600661,38601200,539
"35247","ENSG00000253571","8",5848697,5849692,995
"35248","ENSG00000253572","5",77942757,77946438,3681
"35249","ENSG00000253573","8",126766196,126846981,80785
"35250","ENSG00000253574","8",139911238,139916620,5382
"35251","ENSG00000253576","8",91975908,91977418,1510
"35252","ENSG00000253577","8",92765651,92858297,92646
"35253","ENSG00000253578","2",89170775,89171212,437
"35254","ENSG00000253579","8",31131539,31131802,263
"35255","ENSG00000253581","8",82979411,82979886,475
"35256","ENSG00000253582","8",106520474,106657548,137074
"35257","ENSG00000253583","8",63586000,63589408,3408
"35258","ENSG00000253584","5",104917492,105246364,328872
"35259","ENSG00000253585","8",94097764,94104322,6558
"35260","ENSG00000253586","8",38799643,38802296,2653
"35261","ENSG00000253590","22",22762294,22762516,222
"35262","ENSG00000253591","5",170639158,170681437,42279
"35263","ENSG00000253593","8",133886496,133902407,15911
"35264","ENSG00000253595","8",141340505,141344621,4116
"35265","ENSG00000253596","8",74347757,74350050,2293
"35266","ENSG00000253598","8",81693607,81696174,2567
"35267","ENSG00000253602","8",142247585,142247866,281
"35268","ENSG00000253603","8",56074592,56075274,682
"35269","ENSG00000253604","8",29905735,29908956,3221
"35270","ENSG00000253605","8",141459075,141460031,956
"35271","ENSG00000253606","8",43270198,43271960,1762
"35272","ENSG00000253607","8",123002560,123030751,28191
"35273","ENSG00000253608","8",48551567,48698510,146943
"35274","ENSG00000253611","8",43219960,43220809,849
"35275","ENSG00000253614","8",57261226,57266613,5387
"35276","ENSG00000253615","8",27903566,27903715,149
"35277","ENSG00000253616","8",23071377,23074488,3111
"35278","ENSG00000253618","5",149348116,149357642,9526
"35279","ENSG00000253619","8",120913065,121119754,206689
"35280","ENSG00000253620","8",64091,64320,229
"35281","ENSG00000253621","8",89243401,89243793,392
"35282","ENSG00000253623","8",66480648,66481486,838
"35283","ENSG00000253626","10",79512601,79516440,3839
"35284","ENSG00000253627","8",134211865,134320447,108582
"35285","ENSG00000253628","5",172816592,172819958,3366
"35286","ENSG00000253630","5",157747504,157747707,203
"35287","ENSG00000253631","22",22450202,22450652,450
"35288","ENSG00000253632","8",29527312,29530323,3011
"35289","ENSG00000253633","8",102528740,102539943,11203
"35290","ENSG00000253634","8",92460539,92655576,195037
"35291","ENSG00000253636","8",73052178,73063061,10883
"35292","ENSG00000253639","8",97858049,97858947,898
"35293","ENSG00000253641","8",10474565,10482388,7823
"35294","ENSG00000253642","8",33604856,34039104,434248
"35295","ENSG00000253643","8",24490312,24514856,24544
"35296","ENSG00000253644","8",101387299,101393255,5956
"35297","ENSG00000253647","5",170389493,170422844,33351
"35298","ENSG00000253649","8",10482878,10547585,64707
"35299","ENSG00000253651","8",125951861,125952314,453
"35300","ENSG00000253652","5",179503322,179515579,12257
"35301","ENSG00000253653","5",157260122,157266625,6503
"35302","ENSG00000253655","8",84980073,84980547,474
"35303","ENSG00000253656","8",130595299,130655712,60413
"35304","ENSG00000253657","8",108572643,108573174,531
"35305","ENSG00000253658","8",68880139,69104242,224103
"35306","ENSG00000253659","8",79259402,79314951,55549
"35307","ENSG00000253660","5",167937717,167953469,15752
"35308","ENSG00000253661","8",76491200,76683308,192108
"35309","ENSG00000253663","8",103016744,103017589,845
"35310","ENSG00000253664","8",51257688,51321118,63430
"35311","ENSG00000253665","8",40114651,40127468,12817
"35312","ENSG00000253666","8",100475667,100501148,25481
"35313","ENSG00000253667","8",53971231,53974210,2979
"35314","ENSG00000253669","8",102805517,102810039,4522
"35315","ENSG00000253671","8",17808361,17822183,13822
"35316","ENSG00000253673","5",158175396,158200016,24620
"35317","ENSG00000253674","14",106865627,106865895,268
"35318","ENSG00000253676","8",106697427,106698013,586
"35319","ENSG00000253677","8",81254870,81255229,359
"35320","ENSG00000253678","8",10476591,10479446,2855
"35321","ENSG00000253679","8",101261541,101262903,1362
"35322","ENSG00000253681","8",76576551,76579345,2794
"35323","ENSG00000253682","8",92402920,92413681,10761
"35324","ENSG00000253683","5",172656522,172656713,191
"35325","ENSG00000253686","5",173707614,173746279,38665
"35326","ENSG00000253687","5",160613873,160639183,25310
"35327","ENSG00000253688","8",48551527,48556441,4914
"35328","ENSG00000253690","8",28250063,28339255,89192
"35329","ENSG00000253691","22",16914235,16914981,746
"35330","ENSG00000253692","14",105721794,105722527,733
"35331","ENSG00000253693","5",165349030,165778689,429659
"35332","ENSG00000253695","8",10839964,10847594,7630
"35333","ENSG00000253696","8",1971397,1976478,5081
"35334","ENSG00000253699","8",86180418,86212236,31818
"35335","ENSG00000253702","8",48597458,48621018,23560
"35336","ENSG00000253703","14",106703846,106704286,440
"35337","ENSG00000253704","8",94553668,94570648,16980
"35338","ENSG00000253706","8",74798784,74866939,68155
"35339","ENSG00000253708","8",30176554,30180888,4334
"35340","ENSG00000253709","14",106145891,106146131,240
"35341","ENSG00000253710","13",52012398,52033600,21202
"35342","ENSG00000253711","8",61300164,61301069,905
"35343","ENSG00000253712","8",75167704,75176656,8952
"35344","ENSG00000253713","5",167116318,167119585,3267
"35345","ENSG00000253715","8",142785374,142812120,26746
"35346","ENSG00000253716","8",143280161,143281690,1529
"35347","ENSG00000253717","8",110766863,110772759,5896
"35348","ENSG00000253719","12",74537827,74545430,7603
"35349","ENSG00000253720","8",129939844,129951056,11212
"35350","ENSG00000253721","8",69987415,69987697,282
"35351","ENSG00000253725","5",178840097,178841134,1037
"35352","ENSG00000253726","8",72732045,72751843,19798
"35353","ENSG00000253728","8",142834138,142834940,802
"35354","ENSG00000253729","8",47773108,47960183,187075
"35355","ENSG00000253730","17",50158333,50161276,2943
"35356","ENSG00000253731","5",141373914,141512979,139065
"35357","ENSG00000253733","8",20275773,20290458,14685
"35358","ENSG00000253734","8",63769428,63813937,44509
"35359","ENSG00000253735","8",9351238,9358441,7203
"35360","ENSG00000253736","5",172762980,172782334,19354
"35361","ENSG00000253737","8",101139665,101140929,1264
"35362","ENSG00000253738","8",91059318,91070583,11265
"35363","ENSG00000253739","8",38166012,38166118,106
"35364","ENSG00000253740","8",100618581,100619993,1412
"35365","ENSG00000253741","8",142701857,142727016,25159
"35366","ENSG00000253742","14",106631197,106631653,456
"35367","ENSG00000253744","5",66144156,66144795,639
"35368","ENSG00000253745","8",46922561,46928832,6271
"35369","ENSG00000253746","8",37405439,37406724,1285
"35370","ENSG00000253750","8",64554236,64554475,239
"35371","ENSG00000253752","22",22079770,22080263,493
"35372","ENSG00000253754","8",108226200,108227544,1344
"35373","ENSG00000253755","14",105664633,105669843,5210
"35374","ENSG00000253759","14",106618894,106619173,279
"35375","ENSG00000253760","8",80568050,80568506,456
"35376","ENSG00000253762","8",63703077,63751677,48600
"35377","ENSG00000253763","14",106055549,106055998,449
"35378","ENSG00000253764","8",1971153,1974637,3484
"35379","ENSG00000253766","5",21616262,21779522,163260
"35380","ENSG00000253767","5",141390157,141512979,122822
"35381","ENSG00000253768","5",173562478,173573199,10721
"35382","ENSG00000253770","8",29218905,29219472,567
"35383","ENSG00000253771","13",24924677,24968487,43810
"35384","ENSG00000253772","5",160247517,160248217,700
"35385","ENSG00000253773","8",95204456,95811254,606798
"35386","ENSG00000253774","8",8559894,8562124,2230
"35387","ENSG00000253775","8",20079114,20124857,45743
"35388","ENSG00000253776","5",104773641,104799772,26131
"35389","ENSG00000253778","8",86765935,86818558,52623
"35390","ENSG00000253779","22",22679097,22679345,248
"35391","ENSG00000253780","14",106001534,106001824,290
"35392","ENSG00000253781","8",93646066,93647092,1026
"35393","ENSG00000253782","8",46930604,46951850,21246
"35394","ENSG00000253784","8",72874859,72881740,6881
"35395","ENSG00000253785","5",172975511,172976374,863
"35396","ENSG00000253787","5",68189876,68198407,8531
"35397","ENSG00000253789","8",62110524,62119898,9374
"35398","ENSG00000253790","8",39997869,39998499,630
"35399","ENSG00000253793","8",30983459,30984321,862
"35400","ENSG00000253796","8",108871128,109063417,192289
"35401","ENSG00000253797","13",52024691,52033600,8909
"35402","ENSG00000253798","5",157682985,157690878,7893
"35403","ENSG00000253799","8",90592804,90606065,13261
"35404","ENSG00000253802","8",40298697,40353133,54436
"35405","ENSG00000253803","8",46870902,46872045,1143
"35406","ENSG00000253805","8",2033508,2035587,2079
"35407","ENSG00000253807","5",124059794,124438625,378831
"35408","ENSG00000253810","8",49740216,49741321,1105
"35409","ENSG00000253811","5",158983006,158984789,1783
"35410","ENSG00000253813","8",26835817,26836300,483
"35411","ENSG00000253814","8",122091480,122091609,129
"35412","ENSG00000253816","5",70219918,70258930,39012
"35413","ENSG00000253817","8",47198032,47198323,291
"35414","ENSG00000253818","22",22404207,22404721,514
"35415","ENSG00000253819","8",122485194,122733804,248610
"35416","ENSG00000253821","8",57492884,57592451,99567
"35417","ENSG00000253822","22",22694439,22694952,513
"35418","ENSG00000253823","22",22086561,22087110,549
"35419","ENSG00000253824","8",100380486,100464613,84127
"35420","ENSG00000253825","4",120035033,120040615,5582
"35421","ENSG00000253829","8",38844866,38846439,1573
"35422","ENSG00000253831","1",157092043,157099808,7765
"35423","ENSG00000253832","8",24992002,25009777,17775
"35424","ENSG00000253833","8",73984493,73984883,390
"35425","ENSG00000253834","8",61821481,61825252,3771
"35426","ENSG00000253836","8",82862779,82958696,95917
"35427","ENSG00000253837","8",23336171,23366125,29954
"35428","ENSG00000253838","8",39914229,39915721,1492
"35429","ENSG00000253842","8",100427559,100432726,5167
"35430","ENSG00000253844","8",51961458,52022974,61516
"35431","ENSG00000253846","5",141412987,141512979,99992
"35432","ENSG00000253848","8",93741193,93744534,3341
"35433","ENSG00000253849","8",50381015,50382275,1260
"35434","ENSG00000253852","5",150608428,150615354,6926
"35435","ENSG00000253853","8",2726956,2926689,199733
"35436","ENSG00000253854","8",93719574,93721167,1593
"35437","ENSG00000253855","8",2518998,2522182,3184
"35438","ENSG00000253857","8",55161446,55164727,3281
"35439","ENSG00000253858","5",170483806,170486407,2601
"35440","ENSG00000253859","8",81439436,81521818,82382
"35441","ENSG00000253865","5",149372174,149375116,2942
"35442","ENSG00000253866","8",20934435,20934837,402
"35443","ENSG00000253868","8",124044395,124171522,127127
"35444","ENSG00000253869","5",178922064,178922716,652
"35445","ENSG00000253870","2",89253571,89254015,444
"35446","ENSG00000253871","8",57341021,57365444,24423
"35447","ENSG00000253872","8",95505406,95527524,22118
"35448","ENSG00000253873","5",141421047,141512975,91928
"35449","ENSG00000253875","8",27732915,27758552,25637
"35450","ENSG00000253877","8",110899996,111040372,140376
"35451","ENSG00000253878","8",94950037,94951396,1359
"35452","ENSG00000253879","8",59601319,59620227,18908
"35453","ENSG00000253880","8",6044353,6257537,213184
"35454","ENSG00000253882","7",143761790,143836933,75143
"35455","ENSG00000253883","14",106196700,106196990,290
"35456","ENSG00000253885","8",124151923,124152433,510
"35457","ENSG00000253886","5",154493576,154494743,1167
"35458","ENSG00000253887","8",9255349,9260295,4946
"35459","ENSG00000253888","8",27171914,27210783,38869
"35460","ENSG00000253891","8",24169001,24177080,8079
"35461","ENSG00000253892","8",48657260,48658894,1634
"35462","ENSG00000253893","8",8167819,8226614,58795
"35463","ENSG00000253894","8",63465831,63478745,12914
"35464","ENSG00000253896","8",72601,79775,7174
"35465","ENSG00000253897","5",151366299,151436953,70654
"35466","ENSG00000253898","8",83403758,83408900,5142
"35467","ENSG00000253899","8",27063996,27065278,1282
"35468","ENSG00000253900","5",71132993,71133287,294
"35469","ENSG00000253901","8",91542924,91907619,364695
"35470","ENSG00000253907","8",28238430,28238905,475
"35471","ENSG00000253908","5",180257680,180258366,686
"35472","ENSG00000253910","5",141360042,141512979,152937
"35473","ENSG00000253911","8",98603253,98606340,3087
"35474","ENSG00000253912","8",99804159,99804341,182
"35475","ENSG00000253915","8",135625185,135625981,796
"35476","ENSG00000253916","8",133755845,133756646,801
"35477","ENSG00000253917","4",3915183,3955419,40236
"35478","ENSG00000253919","8",78760142,78762431,2289
"35479","ENSG00000253920","22",22604445,22605165,720
"35480","ENSG00000253921","5",151753992,151767247,13255
"35481","ENSG00000253923","8",102417979,102418953,974
"35482","ENSG00000253924","8",52294455,52301942,7487
"35483","ENSG00000253925","5",168085329,168187719,102390
"35484","ENSG00000253927","5",135900353,135918161,17808
"35485","ENSG00000253930","8",23189279,23190675,1396
"35486","ENSG00000253931","8",143412749,143417054,4305
"35487","ENSG00000253932","8",13338574,13342754,4180
"35488","ENSG00000253934","8",16374618,16375082,464
"35489","ENSG00000253936","14",106652237,106652681,444
"35490","ENSG00000253939","8",39903775,39995248,91473
"35491","ENSG00000253942","8",101223941,101224573,632
"35492","ENSG00000253943","8",41511240,41512521,1281
"35493","ENSG00000253944","8",17801345,17861069,59724
"35494","ENSG00000253945","8",95403802,95403894,92
"35495","ENSG00000253947","5",167965187,167967086,1899
"35496","ENSG00000253948","8",98958277,99013743,55466
"35497","ENSG00000253952","8",77013751,77014028,277
"35498","ENSG00000253953","5",141387698,141512979,125281
"35499","ENSG00000253954","15",92711808,92712110,302
"35500","ENSG00000253955","5",173578275,173585068,6793
"35501","ENSG00000253957","14",106257762,106258223,461
"35502","ENSG00000253958","8",8701938,8704106,2168
"35503","ENSG00000253959","5",173642519,173658194,15675
"35504","ENSG00000253960","8",93215925,93234878,18953
"35505","ENSG00000253961","8",31167078,31177167,10089
"35506","ENSG00000253963","22",22873212,22873440,228
"35507","ENSG00000253964","8",68293446,68293818,372
"35508","ENSG00000253965","5",140348484,140357794,9310
"35509","ENSG00000253966","5",170896929,170904461,7532
"35510","ENSG00000253967","8",70471134,70485687,14553
"35511","ENSG00000253968","5",173383941,173451591,67650
"35512","ENSG00000253971","8",142995850,142996482,632
"35513","ENSG00000253972","8",119214625,119246848,32223
"35514","ENSG00000253973","11",9004093,9067776,63683
"35515","ENSG00000253974","8",32026210,32139495,113285
"35516","ENSG00000253976","8",55135203,55142358,7155
"35517","ENSG00000253978","5",168229583,168269415,39832
"35518","ENSG00000253980","5",157199242,157224380,25138
"35519","ENSG00000253981","8",8236003,8244667,8664
"35520","ENSG00000253982","8",1761054,1764508,3454
"35521","ENSG00000253983","8",74093545,74208536,114991
"35522","ENSG00000253985","5",71372676,71374898,2222
"35523","ENSG00000253986","8",23493009,23494198,1189
"35524","ENSG00000253988","8",138063268,138073240,9972
"35525","ENSG00000253989","14",106418018,106418299,281
"35526","ENSG00000253992","8",130935409,130949665,14256
"35527","ENSG00000253993","8",33226848,33227147,299
"35528","ENSG00000253995","8",33540185,33540493,308
"35529","ENSG00000253998","2",89234174,89234912,738
"35530","ENSG00000253999","2",89929701,89930202,501
"35531","ENSG00000254000","8",123924759,123925933,1174
"35532","ENSG00000254001","8",78148101,78153913,5812
"35533","ENSG00000254002","8",23714066,23743042,28976
"35534","ENSG00000254003","7",88216660,88219226,2566
"35535","ENSG00000254004","19",36510687,36528271,17584
"35536","ENSG00000254006","8",64801236,64817573,16337
"35537","ENSG00000254007","8",5659679,5670140,10461
"35538","ENSG00000254008","8",142198356,142209003,10647
"35539","ENSG00000254011","5",174173101,174181814,8713
"35540","ENSG00000254012","5",171366299,171366611,312
"35541","ENSG00000254013","8",30027713,30028900,1187
"35542","ENSG00000254015","8",18200924,18201205,281
"35543","ENSG00000254016","12",8227734,8231764,4030
"35544","ENSG00000254017","9",5113549,5114804,1255
"35545","ENSG00000254019","8",141254565,141256817,2252
"35546","ENSG00000254021","8",106265435,106268741,3306
"35547","ENSG00000254024","8",101461177,101492499,31322
"35548","ENSG00000254027","8",81279871,81281446,1575
"35549","ENSG00000254028","8",134832747,134834482,1735
"35550","ENSG00000254029","22",22910828,22911075,247
"35551","ENSG00000254030","22",22915635,22915927,292
"35552","ENSG00000254031","8",71155454,71204223,48769
"35553","ENSG00000254033","8",34229294,34248946,19652
"35554","ENSG00000254034","8",28798142,28802085,3943
"35555","ENSG00000254035","5",178969390,178990116,20726
"35556","ENSG00000254037","8",119480279,119480775,496
"35557","ENSG00000254038","8",37067441,37069418,1977
"35558","ENSG00000254039","17",49914403,49932918,18515
"35559","ENSG00000254040","8",21023276,21030368,7092
"35560","ENSG00000254041","8",105142860,105188606,45746
"35561","ENSG00000254042","5",168706567,168720884,14317
"35562","ENSG00000254043","8",74891151,74896302,5151
"35563","ENSG00000254044","4",97334635,97633823,299188
"35564","ENSG00000254046","14",106174342,106174760,418
"35565","ENSG00000254048","8",58991720,58992938,1218
"35566","ENSG00000254049","8",32440704,32448803,8099
"35567","ENSG00000254050","8",62473217,62474269,1052
"35568","ENSG00000254051","8",68176768,68177221,453
"35569","ENSG00000254052","14",106695102,106695397,295
"35570","ENSG00000254054","8",17900484,17908011,7527
"35571","ENSG00000254056","14",106775157,106775618,461
"35572","ENSG00000254057","8",93834454,93846743,12289
"35573","ENSG00000254060","8",81036964,81040831,3867
"35574","ENSG00000254061","8",33436268,33436700,432
"35575","ENSG00000254064","8",22254576,22275162,20586
"35576","ENSG00000254065","8",47592147,47592609,462
"35577","ENSG00000254066","5",165220577,165241756,21179
"35578","ENSG00000254067","8",39522976,39580134,57158
"35579","ENSG00000254069","8",43493937,43494762,825
"35580","ENSG00000254080","8",74609698,74633320,23622
"35581","ENSG00000254081","8",65526738,65562781,36043
"35582","ENSG00000254083","8",135234131,135299719,65588
"35583","ENSG00000254086","8",29864644,29871661,7017
"35584","ENSG00000254087","8",55879835,56014169,134334
"35585","ENSG00000254088","8",86503591,86505061,1470
"35586","ENSG00000254089","8",93259667,93298528,38861
"35587","ENSG00000254090","8",33015261,33017043,1782
"35588","ENSG00000254092","8",20942863,21298168,355305
"35589","ENSG00000254093","8",10764961,10839884,74923
"35590","ENSG00000254094","4",1356581,1358075,1494
"35591","ENSG00000254095","8",31339197,31346479,7282
"35592","ENSG00000254098","2",89196096,89196829,733
"35593","ENSG00000254099","5",141970637,141982687,12050
"35594","ENSG00000254101","8",135859369,137092183,1232814
"35595","ENSG00000254102","8",64574306,64581921,7615
"35596","ENSG00000254103","8",58503588,58504068,480
"35597","ENSG00000254104","8",264315,264672,357
"35598","ENSG00000254105","8",73651289,73651602,313
"35599","ENSG00000254106","5",109883182,109884751,1569
"35600","ENSG00000254109","8",30382119,30385401,3282
"35601","ENSG00000254111","8",37559992,37567477,7485
"35602","ENSG00000254112","8",98633547,98633865,318
"35603","ENSG00000254114","17",60851382,60851745,363
"35604","ENSG00000254115","8",86707547,86765023,57476
"35605","ENSG00000254119","8",61785047,61944180,159133
"35606","ENSG00000254120","8",61889839,61894206,4367
"35607","ENSG00000254122","5",141417645,141512979,95334
"35608","ENSG00000254123","8",82098451,82160577,62126
"35609","ENSG00000254124","8",111225585,111227049,1464
"35610","ENSG00000254126","2",106487364,106544297,56933
"35611","ENSG00000254127","22",32199919,32200234,315
"35612","ENSG00000254129","8",29110573,29140729,30156
"35613","ENSG00000254130","5",166905222,166926370,21148
"35614","ENSG00000254131","8",42484600,42485019,419
"35615","ENSG00000254132","5",94568929,94569470,541
"35616","ENSG00000254134","14",106821174,106821414,240
"35617","ENSG00000254135","5",158485190,158588546,103356
"35618","ENSG00000254136","8",51996210,52008355,12145
"35619","ENSG00000254138","5",31093977,31267610,173633
"35620","ENSG00000254139","8",57746149,57750199,4050
"35621","ENSG00000254141","8",105669991,105679031,9040
"35622","ENSG00000254143","8",40161458,40172612,11154
"35623","ENSG00000254151","8",81617220,81618560,1340
"35624","ENSG00000254152","8",30349866,30350347,481
"35625","ENSG00000254153","8",8456909,8461337,4428
"35626","ENSG00000254154","1",177928788,178038007,109219
"35627","ENSG00000254157","2",89128724,89129483,759
"35628","ENSG00000254158","5",178997969,178998815,846
"35629","ENSG00000254160","8",1246789,1248760,1971
"35630","ENSG00000254162","8",80535006,80539135,4129
"35631","ENSG00000254163","5",156704058,156739812,35754
"35632","ENSG00000254164","5",173574938,173576275,1337
"35633","ENSG00000254165","8",42537529,42538304,775
"35634","ENSG00000254166","8",127072694,127227541,154847
"35635","ENSG00000254167","14",106583506,106583807,301
"35636","ENSG00000254170","5",78708734,78716082,7348
"35637","ENSG00000254171","5",166128498,166155439,26941
"35638","ENSG00000254174","14",106122420,106122709,289
"35639","ENSG00000254176","14",106823687,106824147,460
"35640","ENSG00000254177","8",81058523,81067744,9221
"35641","ENSG00000254178","8",25834129,25840135,6006
"35642","ENSG00000254180","8",90198389,90620077,421688
"35643","ENSG00000254181","8",80594815,80595703,888
"35644","ENSG00000254182","8",90701082,90701876,794
"35645","ENSG00000254183","8",141968091,141968841,750
"35646","ENSG00000254185","8",109470131,109471117,986
"35647","ENSG00000254186","5",162424042,163437326,1013284
"35648","ENSG00000254187","5",167653228,167660481,7253
"35649","ENSG00000254192","5",168654513,168667761,13248
"35650","ENSG00000254194","8",33973701,34009595,35894
"35651","ENSG00000254197","8",141278228,141292862,14634
"35652","ENSG00000254198","8",43125995,43126397,402
"35653","ENSG00000254200","5",173225836,173226423,587
"35654","ENSG00000254201","8",19246350,19249240,2890
"35655","ENSG00000254202","8",83912713,84142463,229750
"35656","ENSG00000254203","14",106367385,106367664,279
"35657","ENSG00000254204","8",53515170,53515905,735
"35658","ENSG00000254205","8",80122852,80127670,4818
"35659","ENSG00000254206","16",29381354,29404029,22675
"35660","ENSG00000254207","8",725188,725877,689
"35661","ENSG00000254208","8",85177522,85178150,628
"35662","ENSG00000254209","8",121668934,121697600,28666
"35663","ENSG00000254211","5",173778527,173809039,30512
"35664","ENSG00000254213","8",73277364,73278046,682
"35665","ENSG00000254215","14",106120207,106120473,266
"35666","ENSG00000254219","8",91042690,91044762,2072
"35667","ENSG00000254220","2",90052581,90053372,791
"35668","ENSG00000254221","5",141350102,141512979,162877
"35669","ENSG00000254222","8",61264624,61292039,27415
"35670","ENSG00000254224","8",96235427,96239149,3722
"35671","ENSG00000254225","8",51721670,51722164,494
"35672","ENSG00000254226","5",151949571,152270449,320878
"35673","ENSG00000254227","8",125998994,126001001,2007
"35674","ENSG00000254228","14",106463256,106463691,435
"35675","ENSG00000254229","8",8027077,8032305,5228
"35676","ENSG00000254230","8",22565997,22567171,1174
"35677","ENSG00000254231","8",86333274,86343429,10155
"35678","ENSG00000254233","4",184584093,184625030,40937
"35679","ENSG00000254236","8",103020187,103021428,1241
"35680","ENSG00000254237","8",9367898,9436205,68307
"35681","ENSG00000254238","8",75026428,75029460,3032
"35682","ENSG00000254239","5",135897637,135900250,2613
"35683","ENSG00000254240","22",22715290,22715419,129
"35684","ENSG00000254242","8",19091703,19145449,53746
"35685","ENSG00000254244","8",4787332,4788584,1252
"35686","ENSG00000254245","5",141343829,141512979,169150
"35687","ENSG00000254246","5",157104788,157114900,10112
"35688","ENSG00000254247","8",118982579,118982875,296
"35689","ENSG00000254248","8",95071732,95087924,16192
"35690","ENSG00000254251","8",90806474,90859240,52766
"35691","ENSG00000254252","5",166028567,166029311,744
"35692","ENSG00000254254","8",56445807,56556513,110706
"35693","ENSG00000254258","8",139460062,139463016,2954
"35694","ENSG00000254260","8",20941428,20950175,8747
"35695","ENSG00000254261","9",26746953,26786874,39921
"35696","ENSG00000254263","8",129890465,129901758,11293
"35697","ENSG00000254265","8",1730206,1731452,1246
"35698","ENSG00000254266","8",78268637,78558503,289866
"35699","ENSG00000254270","7",139534240,139534549,309
"35700","ENSG00000254271","10",60734342,60741828,7486
"35701","ENSG00000254272","8",22492631,22493044,413
"35702","ENSG00000254273","8",73511276,73511654,378
"35703","ENSG00000254274","8",54073114,54073566,452
"35704","ENSG00000254275","8",128405269,128564679,159410
"35705","ENSG00000254277","8",71675300,71702786,27486
"35706","ENSG00000254278","8",119062942,119068782,5840
"35707","ENSG00000254283","8",94594411,94594601,190
"35708","ENSG00000254285","8",61578220,61579668,1448
"35709","ENSG00000254287","8",39918076,39920890,2814
"35710","ENSG00000254288","8",74052340,74099853,47513
"35711","ENSG00000254289","14",106331106,106331563,457
"35712","ENSG00000254290","8",37597480,37599858,2378
"35713","ENSG00000254291","8",141326130,141327137,1007
"35714","ENSG00000254293","5",154483917,154486150,2233
"35715","ENSG00000254294","8",123400582,123402095,1513
"35716","ENSG00000254295","5",172954907,172957162,2255
"35717","ENSG00000254297","5",167296234,167303372,7138
"35718","ENSG00000254298","5",151158106,151158462,356
"35719","ENSG00000254299","5",172543403,172559202,15799
"35720","ENSG00000254300","8",76406654,76524356,117702
"35721","ENSG00000254302","8",34174886,34207513,32627
"35722","ENSG00000254303","8",121954640,122127184,172544
"35723","ENSG00000254305","8",76603240,76603852,612
"35724","ENSG00000254306","8",37600537,37625873,25336
"35725","ENSG00000254308","22",22179228,22179477,249
"35726","ENSG00000254310","5",78753596,78753873,277
"35727","ENSG00000254311","8",8116745,8116949,204
"35728","ENSG00000254314","8",52150820,52154892,4072
"35729","ENSG00000254315","8",94533628,94534391,763
"35730","ENSG00000254316","8",30249502,30250092,590
"35731","ENSG00000254317","8",129832301,129844504,12203
"35732","ENSG00000254319","8",2648075,2728577,80502
"35733","ENSG00000254321","8",38699274,38704855,5581
"35734","ENSG00000254324","8",140732564,140732653,89
"35735","ENSG00000254325","8",55893595,55895739,2144
"35736","ENSG00000254326","14",106317823,106318236,413
"35737","ENSG00000254328","5",172986680,172987198,518
"35738","ENSG00000254329","14",106637718,106637973,255
"35739","ENSG00000254330","8",64703774,64734459,30685
"35740","ENSG00000254332","8",69129598,69130345,747
"35741","ENSG00000254333","5",150475531,150485968,10437
"35742","ENSG00000254334","8",21297933,21309486,11553
"35743","ENSG00000254336","5",157604707,157605637,930
"35744","ENSG00000254337","8",68848737,68852763,4026
"35745","ENSG00000254338","8",143417679,143419150,1471
"35746","ENSG00000254339","8",114282067,114295839,13772
"35747","ENSG00000254340","8",9141424,9145503,4079
"35748","ENSG00000254343","8",120052180,120056201,4021
"35749","ENSG00000254344","8",34784028,34865364,81336
"35750","ENSG00000254348","8",47189305,47189560,255
"35751","ENSG00000254349","8",74599775,74823313,223538
"35752","ENSG00000254350","5",158424585,158452758,28173
"35753","ENSG00000254351","5",162761833,162762313,480
"35754","ENSG00000254352","8",78723796,78724136,340
"35755","ENSG00000254357","8",55517240,55520977,3737
"35756","ENSG00000254361","8",137852204,138019873,167669
"35757","ENSG00000254362","8",26440491,26442595,2104
"35758","ENSG00000254363","5",140157319,140173051,15732
"35759","ENSG00000254364","8",100492528,100493713,1185
"35760","ENSG00000254365","5",167287320,167294273,6953
"35761","ENSG00000254366","8",77399072,77537290,138218
"35762","ENSG00000254367","8",8723693,8782479,58786
"35763","ENSG00000254369","7",27129977,27155928,25951
"35764","ENSG00000254370","8",28415524,28420055,4531
"35765","ENSG00000254372","8",135455865,135456952,1087
"35766","ENSG00000254373","5",160258253,160258585,332
"35767","ENSG00000254377","8",64373151,64383787,10636
"35768","ENSG00000254380","8",85495693,85540511,44818
"35769","ENSG00000254383","8",40900016,40901854,1838
"35770","ENSG00000254387","8",93849561,93850075,514
"35771","ENSG00000254388","8",123352181,123352643,462
"35772","ENSG00000254389","8",143366631,143368548,1917
"35773","ENSG00000254391","5",160685351,160692889,7538
"35774","ENSG00000254392","8",50490795,50491465,670
"35775","ENSG00000254394","8",82033533,82961926,928393
"35776","ENSG00000254395","14",106606101,106606551,450
"35777","ENSG00000254396","9",27102630,27104728,2098
"35778","ENSG00000254397","11",9430356,9433486,3130
"35779","ENSG00000254398","15",28679405,28682252,2847
"35780","ENSG00000254399","11",59042737,59050971,8234
"35781","ENSG00000254401","11",11020883,11183611,162728
"35782","ENSG00000254402","8",144522388,144527033,4645
"35783","ENSG00000254403","11",59728519,59729492,973
"35784","ENSG00000254404","11",62213427,62260549,47122
"35785","ENSG00000254406","11",119821304,119822129,825
"35786","ENSG00000254408","11",49898267,49899186,919
"35787","ENSG00000254409","11",43921059,44001157,80098
"35788","ENSG00000254411","11",56495760,56496412,652
"35789","ENSG00000254413","22",50568869,50582965,14096
"35790","ENSG00000254415","19",51642553,51646801,4248
"35791","ENSG00000254416","11",110355130,110407613,52483
"35792","ENSG00000254417","11",70072434,70075433,2999
"35793","ENSG00000254418","11",14262846,14273691,10845
"35794","ENSG00000254419","20",58710795,58711633,838
"35795","ENSG00000254420","11",78324758,78444049,119291
"35796","ENSG00000254423","8",12374366,12375546,1180
"35797","ENSG00000254424","11",62072882,62073052,170
"35798","ENSG00000254427","11",45355371,45367490,12119
"35799","ENSG00000254428","11",119003742,119004893,1151
"35800","ENSG00000254429","11",75260127,75261025,898
"35801","ENSG00000254430","11",123861822,123862521,699
"35802","ENSG00000254431","8",125348196,125351416,3220
"35803","ENSG00000254432","8",60808735,60809606,871
"35804","ENSG00000254433","11",106085990,106101975,15985
"35805","ENSG00000254434","11",80321620,80327911,6291
"35806","ENSG00000254438","11",13921450,13924863,3413
"35807","ENSG00000254440","6",138215986,138218491,2505
"35808","ENSG00000254441","11",82835509,82837222,1713
"35809","ENSG00000254442","11",134316782,134317088,306
"35810","ENSG00000254443","11",6362799,6365267,2468
"35811","ENSG00000254444","11",6108135,6185576,77441
"35812","ENSG00000254445","11",111912736,111926871,14135
"35813","ENSG00000254447","11",67735600,67784229,48629
"35814","ENSG00000254449","11",123597946,123599452,1506
"35815","ENSG00000254450","11",111817214,111829212,11998
"35816","ENSG00000254451","12",75234740,75298508,63768
"35817","ENSG00000254453","11",20043846,20049303,5457
"35818","ENSG00000254454","11",62371146,62373168,2022
"35819","ENSG00000254455","11",65145691,65145972,281
"35820","ENSG00000254456","11",25734757,25782017,47260
"35821","ENSG00000254458","11",66312853,66319237,6384
"35822","ENSG00000254459","11",77829654,77872262,42608
"35823","ENSG00000254460","11",75506937,75508391,1454
"35824","ENSG00000254461","11",66259567,66261834,2267
"35825","ENSG00000254462","11",57712605,57791586,78981
"35826","ENSG00000254463","11",43466392,43466871,479
"35827","ENSG00000254466","11",59473315,59479361,6046
"35828","ENSG00000254467","11",123668499,123675569,7070
"35829","ENSG00000254469","11",71865509,71928654,63145
"35830","ENSG00000254470","11",65775893,65780802,4909
"35831","ENSG00000254471","11",79987513,79989630,2117
"35832","ENSG00000254472","11",49915013,49915644,631
"35833","ENSG00000254473","9",83707594,83713378,5784
"35834","ENSG00000254475","11",75131138,75131880,742
"35835","ENSG00000254477","11",59752578,59754975,2397
"35836","ENSG00000254479","11",85934737,85935663,926
"35837","ENSG00000254480","11",4179675,4202663,22988
"35838","ENSG00000254481","11",134123828,134124329,501
"35839","ENSG00000254482","11",109637468,109638128,660
"35840","ENSG00000254483","9",97238645,97246184,7539
"35841","ENSG00000254484","11",70319928,70321415,1487
"35842","ENSG00000254485","3",9292588,9363303,70715
"35843","ENSG00000254486","11",12030875,12061785,30910
"35844","ENSG00000254487","11",49817778,49825553,7775
"35845","ENSG00000254488","Y",21038289,21044724,6435
"35846","ENSG00000254489","11",30584130,30632583,48453
"35847","ENSG00000254491","8",13583889,13584533,644
"35848","ENSG00000254495","11",70358198,70358677,479
"35849","ENSG00000254497","11",45253884,45254649,765
"35850","ENSG00000254498","11",36696317,36697867,1550
"35851","ENSG00000254499","22",50740593,50743520,2927
"35852","ENSG00000254500","11",74652636,74652911,275
"35853","ENSG00000254501","11",65110714,65111695,981
"35854","ENSG00000254502","11",86195132,86196266,1134
"35855","ENSG00000254503","19",17417031,17418288,1257
"35856","ENSG00000254505","14",24209583,24213869,4286
"35857","ENSG00000254506","11",101584295,101595156,10861
"35858","ENSG00000254507","8",12003400,12004082,682
"35859","ENSG00000254508","11",33774699,33775670,971
"35860","ENSG00000254509","11",124791228,124791660,432
"35861","ENSG00000254510","11",66409158,66417137,7979
"35862","ENSG00000254511","11",81970994,81987813,16819
"35863","ENSG00000254512","11",43733759,43734564,805
"35864","ENSG00000254514","11",45582525,45583474,949
"35865","ENSG00000254516","11",37938601,37954663,16062
"35866","ENSG00000254518","11",50298579,50304656,6077
"35867","ENSG00000254519","11",45722279,45748029,25750
"35868","ENSG00000254521","19",51491357,51501789,10432
"35869","ENSG00000254522","11",83040806,83041403,597
"35870","ENSG00000254527","8",12205759,12206389,630
"35871","ENSG00000254528","11",117833719,117838942,5223
"35872","ENSG00000254529","11",18863558,18864509,951
"35873","ENSG00000254530","11",29335878,29989328,653450
"35874","ENSG00000254531","4",101347780,101348883,1103
"35875","ENSG00000254532","11",30044053,30322988,278935
"35876","ENSG00000254533","8",144698614,144699185,571
"35877","ENSG00000254535","4",134196333,134201789,5456
"35878","ENSG00000254536","10",133380017,133420271,40254
"35879","ENSG00000254537","11",33403216,33403605,389
"35880","ENSG00000254538","8",73670441,73732897,62456
"35881","ENSG00000254539","1",149048576,149051273,2697
"35882","ENSG00000254540","11",22361213,22362294,1081
"35883","ENSG00000254542","11",19978699,19981337,2638
"35884","ENSG00000254543","8",7891003,7892555,1552
"35885","ENSG00000254545","1",31789130,31791322,2192
"35886","ENSG00000254547","11",55867569,55874537,6968
"35887","ENSG00000254548","8",143718246,143718891,645
"35888","ENSG00000254550","11",77102840,77103331,491
"35889","ENSG00000254551","11",83209431,83213379,3948
"35890","ENSG00000254552","2",167123904,167140955,17051
"35891","ENSG00000254553","1",32465057,32600792,135735
"35892","ENSG00000254554","11",10302657,10303704,1047
"35893","ENSG00000254556","8",11136898,11138607,1709
"35894","ENSG00000254557","8",69713390,69719722,6332
"35895","ENSG00000254558","11",89863848,89865550,1702
"35896","ENSG00000254560","11",27047186,27220113,172927
"35897","ENSG00000254561","11",119608423,119659284,50861
"35898","ENSG00000254562","11",38646451,38686323,39872
"35899","ENSG00000254563","11",78749250,78756480,7230
"35900","ENSG00000254565","11",103406213,103407241,1028
"35901","ENSG00000254566","11",36321158,36323440,2282
"35902","ENSG00000254567","11",49133653,49134800,1147
"35903","ENSG00000254569","11",104873264,104873417,153
"35904","ENSG00000254571","9",99915077,99929896,14819
"35905","ENSG00000254572","11",122613444,122614486,1042
"35906","ENSG00000254573","11",134563396,134573056,9660
"35907","ENSG00000254574","8",143709007,143713584,4577
"35908","ENSG00000254577","11",43390283,43395495,5212
"35909","ENSG00000254579","11",40444371,40513269,68898
"35910","ENSG00000254580","11",106112459,106132116,19657
"35911","ENSG00000254582","11",87329407,87330052,645
"35912","ENSG00000254584","11",32035979,32041318,5339
"35913","ENSG00000254585","15",23643549,23647867,4318
"35914","ENSG00000254586","11",17695010,17697556,2546
"35915","ENSG00000254587","11",96590317,96985810,395493
"35916","ENSG00000254588","11",128526142,128530389,4247
"35917","ENSG00000254589","11",58242043,58243097,1054
"35918","ENSG00000254590","11",119402792,119404088,1296
"35919","ENSG00000254592","11",3336721,3340630,3909
"35920","ENSG00000254593","11",71903194,71904081,887
"35921","ENSG00000254594","11",24235477,24262218,26741
"35922","ENSG00000254595","11",6488186,6489377,1191
"35923","ENSG00000254596","11",66454234,66454581,347
"35924","ENSG00000254598","11",11351942,11353357,1415
"35925","ENSG00000254601","11",58005386,58005705,319
"35926","ENSG00000254602","11",57638024,57652790,14766
"35927","ENSG00000254603","11",56512235,56513171,936
"35928","ENSG00000254604","11",70282367,70363368,81001
"35929","ENSG00000254605","11",70014858,70021059,6201
"35930","ENSG00000254606","11",28516832,28519341,2509
"35931","ENSG00000254607","11",126652852,126682104,29252
"35932","ENSG00000254610","11",67934563,67955802,21239
"35933","ENSG00000254612","11",127940913,127941654,741
"35934","ENSG00000254613","11",123839035,123841930,2895
"35935","ENSG00000254614","11",65177606,65181834,4228
"35936","ENSG00000254615","8",106270144,106272902,2758
"35937","ENSG00000254616","11",134173095,134173680,585
"35938","ENSG00000254617","11",89887366,89889991,2625
"35939","ENSG00000254619","11",33810145,33811178,1033
"35940","ENSG00000254620","20",58594417,58603973,9556
"35941","ENSG00000254621","11",118833846,118834556,710
"35942","ENSG00000254622","11",19510890,19519896,9006
"35943","ENSG00000254625","8",6928608,6930473,1865
"35944","ENSG00000254627","11",32064912,32072173,7261
"35945","ENSG00000254629","11",83789977,83791578,1601
"35946","ENSG00000254630","11",75635883,75638587,2704
"35947","ENSG00000254631","11",74397549,74485742,88193
"35948","ENSG00000254632","11",76759916,76768622,8706
"35949","ENSG00000254634","16",29425800,29447026,21226
"35950","ENSG00000254635","10",28522652,28533066,10414
"35951","ENSG00000254636","10",122454653,122457352,2699
"35952","ENSG00000254638","11",112165197,112172606,7409
"35953","ENSG00000254639","11",46238382,46239267,885
"35954","ENSG00000254644","8",103568603,103568978,375
"35955","ENSG00000254645","11",15701265,15758898,57633
"35956","ENSG00000254647","11",2159779,2161341,1562
"35957","ENSG00000254648","11",134035832,134037107,1275
"35958","ENSG00000254649","11",78388061,78392405,4344
"35959","ENSG00000254650","11",87815035,87816157,1122
"35960","ENSG00000254653","11",46116578,46117318,740
"35961","ENSG00000254654","11",44973770,44978028,4258
"35962","ENSG00000254656","14",100879753,100903722,23969
"35963","ENSG00000254658","11",56208985,56215222,6237
"35964","ENSG00000254659","11",109741625,109823893,82268
"35965","ENSG00000254661","11",15910528,15930951,20423
"35966","ENSG00000254662","11",57325603,57327958,2355
"35967","ENSG00000254664","11",45215815,45235292,19477
"35968","ENSG00000254669","11",35579430,35585310,5880
"35969","ENSG00000254670","11",13001090,13009159,8069
"35970","ENSG00000254672","11",35967010,35968676,1666
"35971","ENSG00000254675","11",78022933,78023721,788
"35972","ENSG00000254676","11",83180144,83184520,4376
"35973","ENSG00000254677","11",91114724,91115951,1227
"35974","ENSG00000254678","11",117143891,117144191,300
"35975","ENSG00000254681","16",18374521,18401940,27419
"35976","ENSG00000254682","11",71448674,71452157,3483
"35977","ENSG00000254684","11",85336075,85336572,497
"35978","ENSG00000254685","1",74198212,74234086,35874
"35979","ENSG00000254687","8",53177571,53242683,65112
"35980","ENSG00000254688","11",12822435,12823667,1232
"35981","ENSG00000254689","8",81841952,81924348,82396
"35982","ENSG00000254691","11",77850604,77851511,907
"35983","ENSG00000254692","14",24189157,24213473,24316
"35984","ENSG00000254693","11",44604508,44605337,829
"35985","ENSG00000254694","11",126208611,126209027,416
"35986","ENSG00000254695","11",15605484,15705376,99892
"35987","ENSG00000254697","11",78581675,78582156,481
"35988","ENSG00000254698","11",82963681,83039115,75434
"35989","ENSG00000254699","11",86192787,86193482,695
"35990","ENSG00000254703","11",128691672,128696023,4351
"35991","ENSG00000254704","11",59287339,59289486,2147
"35992","ENSG00000254705","11",92400191,92408176,7985
"35993","ENSG00000254706","1",162365407,162383531,18124
"35994","ENSG00000254707","11",7705288,7709517,4229
"35995","ENSG00000254708","11",34335118,34336003,885
"35996","ENSG00000254709","22",22887780,22896107,8327
"35997","ENSG00000254710","11",123188802,123228502,39700
"35998","ENSG00000254712","11",6843664,6844666,1002
"35999","ENSG00000254713","11",84545131,84546846,1715
"36000","ENSG00000254714","11",49850629,49862528,11899
"36001","ENSG00000254715","8",7705182,7706113,931
"36002","ENSG00000254717","11",58878302,58893460,15158
"36003","ENSG00000254718","14",60240121,60248765,8644
"36004","ENSG00000254719","11",10272052,10272259,207
"36005","ENSG00000254722","11",56331347,56332488,1141
"36006","ENSG00000254724","8",12703066,12704056,990
"36007","ENSG00000254726","1",156072013,156082465,10452
"36008","ENSG00000254727","11",86432098,86432575,477
"36009","ENSG00000254730","11",108727741,108730104,2363
"36010","ENSG00000254731","11",86703099,86714092,10993
"36011","ENSG00000254732","11",57742163,57793243,51080
"36012","ENSG00000254733","11",86431590,86622867,191277
"36013","ENSG00000254734","11",29713909,29881714,167805
"36014","ENSG00000254735","11",120936102,120936654,552
"36015","ENSG00000254737","11",124012997,124018732,5735
"36016","ENSG00000254739","11",528907,529659,752
"36017","ENSG00000254740","11",119372706,119381613,8907
"36018","ENSG00000254743","11",59741325,59742049,724
"36019","ENSG00000254744","15",99970215,99974010,3795
"36020","ENSG00000254746","11",45486867,45542487,55620
"36021","ENSG00000254747","11",81552226,81552516,290
"36022","ENSG00000254748","11",87024583,87025777,1194
"36023","ENSG00000254750","11",105063345,105071541,8196
"36024","ENSG00000254753","8",13844101,13849109,5008
"36025","ENSG00000254754","11",25924188,25926808,2620
"36026","ENSG00000254756","11",66334494,66339875,5381
"36027","ENSG00000254757","11",3469319,3531328,62009
"36028","ENSG00000254758","11",107642887,107643871,984
"36029","ENSG00000254759","11",126067539,126068601,1062
"36030","ENSG00000254760","19",51414298,51414965,667
"36031","ENSG00000254762","11",66267635,66268129,494
"36032","ENSG00000254764","11",48985868,48991881,6013
"36033","ENSG00000254768","11",22283730,22338245,54515
"36034","ENSG00000254771","11",126179497,126179698,201
"36035","ENSG00000254772","11",62559596,62574086,14490
"36036","ENSG00000254775","8",60046755,60136599,89844
"36037","ENSG00000254776","8",7793716,7795870,2154
"36038","ENSG00000254777","8",60910053,60966557,56504
"36039","ENSG00000254780","11",47905323,47905607,284
"36040","ENSG00000254781","11",6748131,6750324,2193
"36041","ENSG00000254783","11",86283927,86284668,741
"36042","ENSG00000254785","11",89895799,89900449,4650
"36043","ENSG00000254786","11",58995439,58999689,4250
"36044","ENSG00000254788","16",66552587,66579135,26548
"36045","ENSG00000254789","11",15571817,15622447,50630
"36046","ENSG00000254790","11",125940496,125941193,697
"36047","ENSG00000254791","11",13669327,13670149,822
"36048","ENSG00000254793","15",42939310,42940358,1048
"36049","ENSG00000254799","11",59263389,59263802,413
"36050","ENSG00000254800","11",49882999,49884093,1094
"36051","ENSG00000254802","8",60965802,60967775,1973
"36052","ENSG00000254804","11",55684141,55686160,2019
"36053","ENSG00000254805","11",71690453,71690657,204
"36054","ENSG00000254806","20",45363200,45410610,47410
"36055","ENSG00000254810","11",76654169,76656712,2543
"36056","ENSG00000254811","11",106250019,106264905,14886
"36057","ENSG00000254812","8",143632071,143633756,1685
"36058","ENSG00000254813","8",12765849,12811478,45629
"36059","ENSG00000254814","11",75800877,75803415,2538
"36060","ENSG00000254815","11",557595,560107,2512
"36061","ENSG00000254816","11",21169748,21170137,389
"36062","ENSG00000254817","8",12033646,12034612,966
"36063","ENSG00000254818","11",89944035,89949402,5367
"36064","ENSG00000254819","11",26285578,26331289,45711
"36065","ENSG00000254821","6",4135423,4146053,10630
"36066","ENSG00000254822","11",41876634,41877078,444
"36067","ENSG00000254823","11",123313657,123315340,1683
"36068","ENSG00000254824","11",103409580,103409657,77
"36069","ENSG00000254826","11",75775904,75776929,1025
"36070","ENSG00000254827","11",2887780,2903740,15960
"36071","ENSG00000254832","11",48512273,48513220,947
"36072","ENSG00000254833","11",126160714,126176035,15321
"36073","ENSG00000254836","11",32052843,32053260,417
"36074","ENSG00000254837","11",74493366,74498533,5167
"36075","ENSG00000254838","11",6713536,6746439,32903
"36076","ENSG00000254839","8",11062647,11067089,4442
"36077","ENSG00000254840","11",50307681,50361706,54025
"36078","ENSG00000254842","11",130844191,130865561,21370
"36079","ENSG00000254843","11",87094734,87096585,1851
"36080","ENSG00000254844","11",117818443,117821992,3549
"36081","ENSG00000254846","14",20344233,20346888,2655
"36082","ENSG00000254847","11",12538083,12540967,2884
"36083","ENSG00000254850","11",67935558,67935926,368
"36084","ENSG00000254851","11",117135528,117138582,3054
"36085","ENSG00000254853","11",58072378,58075438,3060
"36086","ENSG00000254854","11",119729583,119739623,10040
"36087","ENSG00000254855","11",66264777,66265666,889
"36088","ENSG00000254856","11",68488609,68488840,231
"36089","ENSG00000254857","11",18153277,18154255,978
"36090","ENSG00000254858","19",18193182,18196948,3766
"36091","ENSG00000254859","8",143541973,143549729,7756
"36092","ENSG00000254860","11",8964510,8977527,13017
"36093","ENSG00000254861","11",23761330,23808255,46925
"36094","ENSG00000254862","11",27471729,27482433,10704
"36095","ENSG00000254863","11",119987952,119995037,7085
"36096","ENSG00000254864","11",7568866,7572046,3180
"36097","ENSG00000254865","11",10149192,10165109,15917
"36098","ENSG00000254866","8",12150895,12151134,239
"36099","ENSG00000254867","11",65983679,65984331,652
"36100","ENSG00000254870","6",31530219,31546608,16389
"36101","ENSG00000254872","11",1049880,1055749,5869
"36102","ENSG00000254873","11",118397095,118401895,4800
"36103","ENSG00000254874","11",92965797,92966603,806
"36104","ENSG00000254876","9",97238449,97297314,58865
"36105","ENSG00000254877","11",58967596,58968291,695
"36106","ENSG00000254878","11",16023190,16031515,8325
"36107","ENSG00000254879","11",48014406,48015855,1449
"36108","ENSG00000254880","11",125158461,125164609,6148
"36109","ENSG00000254883","11",67744322,67744645,323
"36110","ENSG00000254884","11",9311284,9311689,405
"36111","ENSG00000254885","11",79191558,79193160,1602
"36112","ENSG00000254887","19",42132555,42137099,4544
"36113","ENSG00000254890","11",109486968,109487424,456
"36114","ENSG00000254893","5",76173629,76174183,554
"36115","ENSG00000254895","11",103402013,103402586,573
"36116","ENSG00000254896","11",133360029,133366080,6051
"36117","ENSG00000254897","11",85452282,85453698,1416
"36118","ENSG00000254898","8",38335981,38337551,1570
"36119","ENSG00000254900","11",8679089,8680913,1824
"36120","ENSG00000254901","19",19176903,19192591,15688
"36121","ENSG00000254905","11",126292922,126294254,1332
"36122","ENSG00000254906","11",20670425,20671297,872
"36123","ENSG00000254907","11",43328748,43359296,30548
"36124","ENSG00000254909","11",119005727,119005934,207
"36125","ENSG00000254910","11",310139,311141,1002
"36126","ENSG00000254911","11",93721513,93721865,352
"36127","ENSG00000254912","15",32494003,32500346,6343
"36128","ENSG00000254913","1",149006309,149009527,3218
"36129","ENSG00000254914","11",42939775,42939998,223
"36130","ENSG00000254915","11",75942129,75942435,306
"36131","ENSG00000254916","11",90051837,90053736,1899
"36132","ENSG00000254917","8",12696307,12697273,966
"36133","ENSG00000254919","11",35915051,35918739,3688
"36134","ENSG00000254921","11",8035446,8039718,4272
"36135","ENSG00000254923","8",12128107,12129298,1191
"36136","ENSG00000254924","11",71506061,71506380,319
"36137","ENSG00000254926","11",58748999,58761053,12054
"36138","ENSG00000254927","11",13826843,13879499,52656
"36139","ENSG00000254929","10",47517816,47553514,35698
"36140","ENSG00000254930","11",13844862,13870616,25754
"36141","ENSG00000254931","11",103402588,103403422,834
"36142","ENSG00000254932","11",125258626,125266798,8172
"36143","ENSG00000254933","11",76190725,76195071,4346
"36144","ENSG00000254934","11",27617626,27634627,17001
"36145","ENSG00000254936","8",11123381,11126064,2683
"36146","ENSG00000254938","11",126920188,126940659,20471
"36147","ENSG00000254939","11",98565074,98566827,1753
"36148","ENSG00000254941","11",124807822,124808269,447
"36149","ENSG00000254943","11",124891304,124892126,822
"36150","ENSG00000254944","11",122960327,122961086,759
"36151","ENSG00000254946","11",15552855,15604169,51314
"36152","ENSG00000254947","11",56142516,56143387,871
"36153","ENSG00000254948","8",11919900,11920809,909
"36154","ENSG00000254949","11",111864254,111864460,206
"36155","ENSG00000254951","11",7754393,7905955,151562
"36156","ENSG00000254952","11",60159687,60160822,1135
"36157","ENSG00000254953","11",56736316,56736462,146
"36158","ENSG00000254957","11",11135482,11137658,2176
"36159","ENSG00000254959","7",30752137,30892081,139944
"36160","ENSG00000254960","11",126940746,126945090,4344
"36161","ENSG00000254964","11",62606161,62606405,244
"36162","ENSG00000254965","11",83111060,83111442,382
"36163","ENSG00000254966","11",18706537,18740568,34031
"36164","ENSG00000254968","11",112393118,112624567,231449
"36165","ENSG00000254971","11",89753982,89754953,971
"36166","ENSG00000254972","11",71701268,71705404,4136
"36167","ENSG00000254973","8",143758153,143771870,13717
"36168","ENSG00000254974","11",74485580,74486051,471
"36169","ENSG00000254975","11",76675079,76703195,28116
"36170","ENSG00000254976","11",124324871,124325789,918
"36171","ENSG00000254978","11",71800541,71804640,4099
"36172","ENSG00000254979","11",57387365,57424059,36694
"36173","ENSG00000254980","11",111514043,111526755,12712
"36174","ENSG00000254983","11",12303533,12308216,4683
"36175","ENSG00000254984","11",66771246,66771667,421
"36176","ENSG00000254985","11",77717712,77718411,699
"36177","ENSG00000254986","11",66480013,66509657,29644
"36178","ENSG00000254987","11",103675994,103895271,219277
"36179","ENSG00000254988","11",76955417,76978619,23202
"36180","ENSG00000254990","11",111768668,111778350,9682
"36181","ENSG00000254991","11",12066929,12073014,6085
"36182","ENSG00000254992","11",118322789,118323083,294
"36183","ENSG00000254993","11",49117010,49124570,7560
"36184","ENSG00000254995","20",58651434,58715410,63976
"36185","ENSG00000254996","5",140401908,140549569,147661
"36186","ENSG00000254997","11",71548418,71549553,1135
"36187","ENSG00000254999","3",10115675,10127190,11515
"36188","ENSG00000255000","8",145047860,145048889,1029
"36189","ENSG00000255001","11",50290749,50290933,184
"36190","ENSG00000255002","14",65197254,65222443,25189
"36191","ENSG00000255003","11",83328926,83329246,320
"36192","ENSG00000255004","11",35281813,35286009,4196
"36193","ENSG00000255005","11",85916502,85923682,7180
"36194","ENSG00000255007","11",46256355,46274547,18192
"36195","ENSG00000255008","11",59560298,59566283,5985
"36196","ENSG00000255010","11",83106580,83106961,381
"36197","ENSG00000255014","11",80653429,80653988,559
"36198","ENSG00000255015","11",122294938,122301763,6825
"36199","ENSG00000255020","8",11345748,11347502,1754
"36200","ENSG00000255021","3",14272373,14303845,31472
"36201","ENSG00000255022","11",87816224,87816524,300
"36202","ENSG00000255026","11",287305,288987,1682
"36203","ENSG00000255027","11",125903247,125938916,35669
"36204","ENSG00000255028","11",109355085,109583907,228822
"36205","ENSG00000255029","11",29482807,29552861,70054
"36206","ENSG00000255031","11",68050740,68053762,3022
"36207","ENSG00000255032","11",44719392,44736692,17300
"36208","ENSG00000255033","8",111380603,111380868,265
"36209","ENSG00000255035","11",17435672,17436181,509
"36210","ENSG00000255036","9",97238497,97377287,138790
"36211","ENSG00000255038","11",66067277,66069619,2342
"36212","ENSG00000255039","11",97222644,97259987,37343
"36213","ENSG00000255040","11",14673606,14674555,949
"36214","ENSG00000255042","11",50279828,50298452,18624
"36215","ENSG00000255043","11",19502672,19507229,4557
"36216","ENSG00000255045","11",124744634,124746337,1703
"36217","ENSG00000255046","8",11797928,11802568,4640
"36218","ENSG00000255048","11",124404234,124405102,868
"36219","ENSG00000255050","8",143573490,143577397,3907
"36220","ENSG00000255051","11",83132056,83134737,2681
"36221","ENSG00000255052","8",12115767,12177550,61783
"36222","ENSG00000255057","11",130008586,130009765,1179
"36223","ENSG00000255058","11",65160194,65160382,188
"36224","ENSG00000255059","11",100666459,100666962,503
"36225","ENSG00000255060","11",36425447,36426122,675
"36226","ENSG00000255062","11",126294298,126304318,10020
"36227","ENSG00000255063","11",82805354,82806509,1155
"36228","ENSG00000255065","11",106310045,106311791,1746
"36229","ENSG00000255067","11",12848795,12849433,638
"36230","ENSG00000255071","11",18231423,18248635,17212
"36231","ENSG00000255073","11",58579172,58624639,45467
"36232","ENSG00000255074","11",14440787,14441677,890
"36233","ENSG00000255076","8",14879057,14879819,762
"36234","ENSG00000255079","11",44694863,44696301,1438
"36235","ENSG00000255081","11",75914201,75915213,1012
"36236","ENSG00000255082","11",88504576,88524054,19478
"36237","ENSG00000255083","11",57018100,57019021,921
"36238","ENSG00000255084","11",78533176,78558565,25389
"36239","ENSG00000255085","8",144700353,144708517,8164
"36240","ENSG00000255087","11",127021736,127172363,150627
"36241","ENSG00000255091","11",45651529,45652691,1162
"36242","ENSG00000255092","11",44606170,44608101,1931
"36243","ENSG00000255094","11",27978669,28019575,40906
"36244","ENSG00000255097","11",9242448,9245509,3061
"36245","ENSG00000255099","8",109777912,109782288,4376
"36246","ENSG00000255100","11",76782581,76783062,481
"36247","ENSG00000255101","8",42705583,42721946,16363
"36248","ENSG00000255102","11",88061774,88098147,36373
"36249","ENSG00000255104","17",15699692,15744778,45086
"36250","ENSG00000255105","8",103559099,103559389,290
"36251","ENSG00000255106","11",44539778,44540693,915
"36252","ENSG00000255107","8",69859264,69860540,1276
"36253","ENSG00000255108","11",823634,832883,9249
"36254","ENSG00000255109","11",42183292,42253721,70429
"36255","ENSG00000255111","11",49892262,49893777,1515
"36256","ENSG00000255112","18",11851396,11854449,3053
"36257","ENSG00000255114","11",119044188,119045493,1305
"36258","ENSG00000255115","11",77914990,77915275,285
"36259","ENSG00000255117","11",29594326,29631515,37189
"36260","ENSG00000255118","11",62336911,62338090,1179
"36261","ENSG00000255119","11",67605521,67606642,1121
"36262","ENSG00000255120","11",65789051,65790868,1817
"36263","ENSG00000255121","11",118994824,118998004,3180
"36264","ENSG00000255122","8",12580287,12581063,776
"36265","ENSG00000255127","11",92914603,92931322,16719
"36266","ENSG00000255128","8",7418991,7420546,1555
"36267","ENSG00000255129","11",113278250,113314482,36232
"36268","ENSG00000255130","8",67732587,67735665,3078
"36269","ENSG00000255133","11",33813873,33822378,8505
"36270","ENSG00000255135","11",76435559,76444687,9128
"36271","ENSG00000255136","11",75206048,75241173,35125
"36272","ENSG00000255139","11",59565923,59639861,73938
"36273","ENSG00000255141","11",3972881,3974237,1356
"36274","ENSG00000255142","11",781645,782105,460
"36275","ENSG00000255143","11",70129297,70149623,20326
"36276","ENSG00000255144","8",11895850,11896870,1020
"36277","ENSG00000255145","9",99397024,99906605,509581
"36278","ENSG00000255146","11",58044110,58060138,16028
"36279","ENSG00000255147","11",67749043,67756968,7925
"36280","ENSG00000255148","1",149018671,149026269,7598
"36281","ENSG00000255150","12",104303739,104305205,1466
"36282","ENSG00000255151","11",59086307,59094786,8479
"36283","ENSG00000255152","6",31740020,31764851,24831
"36284","ENSG00000255153","11",1309769,1310707,938
"36285","ENSG00000255154","3",58306262,58318574,12312
"36286","ENSG00000255155","11",130544643,130544856,213
"36287","ENSG00000255156","22",20475203,20475311,108
"36288","ENSG00000255157","11",71856277,71863658,7381
"36289","ENSG00000255158","11",665910,678391,12481
"36290","ENSG00000255159","11",8768778,8810231,41453
"36291","ENSG00000255160","11",19299883,19308358,8475
"36292","ENSG00000255161","11",33787054,33787795,741
"36293","ENSG00000255162","11",89785945,89787838,1893
"36294","ENSG00000255163","11",118208932,118209211,279
"36295","ENSG00000255164","8",144992914,144994837,1923
"36296","ENSG00000255165","11",44071462,44072403,941
"36297","ENSG00000255167","11",21260061,21262570,2509
"36298","ENSG00000255169","11",33804768,33805641,873
"36299","ENSG00000255171","11",41714534,41857733,143199
"36300","ENSG00000255174","8",11999087,11999468,381
"36301","ENSG00000255175","11",38618264,38646384,28120
"36302","ENSG00000255176","11",118636620,118638097,1477
"36303","ENSG00000255178","11",80751200,80762826,11626
"36304","ENSG00000255179","11",7222933,7230863,7930
"36305","ENSG00000255181","8",143706694,143708109,1415
"36306","ENSG00000255182","8",144495458,144505444,9986
"36307","ENSG00000255183","11",87718354,87719411,1057
"36308","ENSG00000255185","16",70010751,70065945,55194
"36309","ENSG00000255186","11",36386521,36388250,1729
"36310","ENSG00000255187","11",91157994,91234388,76394
"36311","ENSG00000255189","11",58978787,58994120,15333
"36312","ENSG00000255190","11",49874945,49876638,1693
"36313","ENSG00000255191","11",69985876,70015815,29939
"36314","ENSG00000255192","15",35084193,35085110,917
"36315","ENSG00000255193","11",23730588,23796970,66382
"36316","ENSG00000255197","11",47381509,47409369,27860
"36317","ENSG00000255198","16",1964959,1965509,550
"36318","ENSG00000255199","11",50100892,50102898,2006
"36319","ENSG00000255200","11",65174117,65176470,2353
"36320","ENSG00000255201","8",38421889,38426096,4207
"36321","ENSG00000255202","11",33665220,33696701,31481
"36322","ENSG00000255203","11",86857059,86857947,888
"36323","ENSG00000255204","11",55863932,55881243,17311
"36324","ENSG00000255206","8",68082204,68095081,12877
"36325","ENSG00000255213","11",62330946,62331813,867
"36326","ENSG00000255214","11",49871826,49874067,2241
"36327","ENSG00000255216","11",120008044,120013620,5576
"36328","ENSG00000255219","11",122295190,122308019,12829
"36329","ENSG00000255220","11",130295641,130296946,1305
"36330","ENSG00000255221","11",105092469,105101431,8962
"36331","ENSG00000255222","11",86294760,86295576,816
"36332","ENSG00000255224","8",144078002,144079265,1263
"36333","ENSG00000255225","11",124338783,124339662,879
"36334","ENSG00000255226","11",45749454,45752279,2825
"36335","ENSG00000255229","11",129279,186136,56857
"36336","ENSG00000255231","11",112208601,112208898,297
"36337","ENSG00000255232","11",3961277,3961538,261
"36338","ENSG00000255233","11",93240133,93241168,1035
"36339","ENSG00000255234","11",83286120,83423516,137396
"36340","ENSG00000255236","11",68121624,68130518,8894
"36341","ENSG00000255237","11",462930,463899,969
"36342","ENSG00000255238","19",55777553,55778900,1347
"36343","ENSG00000255239","11",118688033,118690599,2566
"36344","ENSG00000255240","11",58933643,59058659,125016
"36345","ENSG00000255241","11",88098591,88115835,17244
"36346","ENSG00000255243","11",26189123,26208347,19224
"36347","ENSG00000255244","11",18934985,18939721,4736
"36348","ENSG00000255246","11",82603529,82643445,39916
"36349","ENSG00000255247","11",119709920,119713925,4005
"36350","ENSG00000255248","11",122028325,122556721,528396
"36351","ENSG00000255250","11",86727355,86765467,38112
"36352","ENSG00000255253","8",12638428,12638602,174
"36353","ENSG00000255254","11",18106583,18106841,258
"36354","ENSG00000255255","11",75911204,75911628,424
"36355","ENSG00000255256","11",35972428,35989007,16579
"36356","ENSG00000255258","11",133783671,133810376,26705
"36357","ENSG00000255260","11",11243188,11243715,527
"36358","ENSG00000255262","11",130032866,130033220,354
"36359","ENSG00000255265","11",58796237,58796854,617
"36360","ENSG00000255266","11",57870322,57870571,249
"36361","ENSG00000255267","11",45371397,45388511,17114
"36362","ENSG00000255269","11",46213150,46220438,7288
"36363","ENSG00000255270","11",19380484,19385014,4530
"36364","ENSG00000255272","11",33776188,33779495,3307
"36365","ENSG00000255274","11",118003634,118088299,84665
"36366","ENSG00000255276","11",4137116,4138257,1141
"36367","ENSG00000255277","16",14820792,14824702,3910
"36368","ENSG00000255279","11",41855920,41875997,20077
"36369","ENSG00000255282","11",102746968,102836766,89798
"36370","ENSG00000255283","11",55279447,55284749,5302
"36371","ENSG00000255284","11",777578,784297,6719
"36372","ENSG00000255286","11",111945639,111946892,1253
"36373","ENSG00000255288","11",30167163,30167306,143
"36374","ENSG00000255289","8",60660820,60664530,3710
"36375","ENSG00000255291","11",20574186,20575042,856
"36376","ENSG00000255292","11",112086903,112193805,106902
"36377","ENSG00000255293","11",23403805,23406103,2298
"36378","ENSG00000255296","11",71938671,71939544,873
"36379","ENSG00000255297","11",48589760,48590687,927
"36380","ENSG00000255298","11",124256376,124266218,9842
"36381","ENSG00000255299","11",58497888,58505758,7870
"36382","ENSG00000255300","11",41993381,42163851,170470
"36383","ENSG00000255302","15",48877886,48880183,2297
"36384","ENSG00000255303","11",57861948,57873588,11640
"36385","ENSG00000255305","11",89978540,89980661,2121
"36386","ENSG00000255306","11",68024809,68030461,5652
"36387","ENSG00000255307","11",6169330,6170408,1078
"36388","ENSG00000255308","11",19196775,19281426,84651
"36389","ENSG00000255310","8",11107788,11109726,1938
"36390","ENSG00000255311","11",83643602,83725390,81788
"36391","ENSG00000255313","8",124936328,124943765,7437
"36392","ENSG00000255314","11",46123031,46177106,54075
"36393","ENSG00000255316","11",81555910,81556425,515
"36394","ENSG00000255317","11",126992452,126995458,3006
"36395","ENSG00000255319","11",71711740,71781183,69443
"36396","ENSG00000255320","11",66244840,66246239,1399
"36397","ENSG00000255321","8",60551957,60553036,1079
"36398","ENSG00000255323","11",22445673,22492073,46400
"36399","ENSG00000255325","8",122485515,122489815,4300
"36400","ENSG00000255326","11",75583196,75594665,11469
"36401","ENSG00000255327","11",134950708,134951568,860
"36402","ENSG00000255328","11",327171,330122,2951
"36403","ENSG00000255329","11",70278921,70279297,376
"36404","ENSG00000255330","6",127438406,127519001,80595
"36405","ENSG00000255331","11",60077350,60078401,1051
"36406","ENSG00000255332","11",91794319,91872086,77767
"36407","ENSG00000255334","11",112015307,112016124,817
"36408","ENSG00000255335","11",17695266,17696994,1728
"36409","ENSG00000255337","11",102452919,102462008,9089
"36410","ENSG00000255339","10",100505628,100529881,24253
"36411","ENSG00000255340","11",43378882,43385671,6789
"36412","ENSG00000255342","11",123135923,123136376,453
"36413","ENSG00000255343","8",143833270,143834063,793
"36414","ENSG00000255344","11",134712539,134716250,3711
"36415","ENSG00000255345","11",79092848,79098003,5155
"36416","ENSG00000255346","15",68930525,69062762,132237
"36417","ENSG00000255348","11",134178824,134186166,7342
"36418","ENSG00000255349","11",54692450,54693359,909
"36419","ENSG00000255350","11",103404309,103405834,1525
"36420","ENSG00000255353","11",107176286,107177530,1244
"36421","ENSG00000255355","11",59669312,59676041,6729
"36422","ENSG00000255358","11",130285023,130285833,810
"36423","ENSG00000255359","11",22846931,22860426,13495
"36424","ENSG00000255361","8",42725547,42726228,681
"36425","ENSG00000255362","11",76210956,76216025,5069
"36426","ENSG00000255363","11",76607853,76630465,22612
"36427","ENSG00000255364","8",122414332,122428551,14219
"36428","ENSG00000255366","8",47190772,47193262,2490
"36429","ENSG00000255367","11",3481520,3581211,99691
"36430","ENSG00000255370","11",31280672,31280987,315
"36431","ENSG00000255372","11",22261209,22262256,1047
"36432","ENSG00000255374","12",11091287,11092313,1026
"36433","ENSG00000255375","11",32132657,32143723,11066
"36434","ENSG00000255376","11",96642671,96643225,554
"36435","ENSG00000255377","11",119444991,119445519,528
"36436","ENSG00000255379","11",108822333,108822650,317
"36437","ENSG00000255381","11",59142121,59142610,489
"36438","ENSG00000255382","11",82781502,82817741,36239
"36439","ENSG00000255384","11",118433121,118435206,2085
"36440","ENSG00000255385","11",89700764,89701325,561
"36441","ENSG00000255387","11",4210354,4212091,1737
"36442","ENSG00000255388","11",41518895,41714492,195597
"36443","ENSG00000255389","6",111599875,111602295,2420
"36444","ENSG00000255391","11",87480736,87481297,561
"36445","ENSG00000255393","11",59978020,60031077,53057
"36446","ENSG00000255394","8",11761256,11763223,1967
"36447","ENSG00000255395","11",75099172,75140148,40976
"36448","ENSG00000255396","11",84997226,84997768,542
"36449","ENSG00000255397","8",60937705,60939871,2166
"36450","ENSG00000255398","12",122714756,122716892,2136
"36451","ENSG00000255399","12",114408173,114412831,4658
"36452","ENSG00000255400","11",12086891,12089441,2550
"36453","ENSG00000255403","11",105706299,105707937,1638
"36454","ENSG00000255406","11",134008215,134030167,21952
"36455","ENSG00000255408","5",140801028,141012347,211319
"36456","ENSG00000255409","11",77738680,77739568,888
"36457","ENSG00000255410","11",6630504,6658396,27892
"36458","ENSG00000255411","11",13784017,13848002,63985
"36459","ENSG00000255413","8",13741809,13742781,972
"36460","ENSG00000255417","11",103403512,103404167,655
"36461","ENSG00000255418","11",23154683,23203161,48478
"36462","ENSG00000255420","11",8011278,8016520,5242
"36463","ENSG00000255421","11",76137315,76137731,416
"36464","ENSG00000255422","11",118700427,118750263,49836
"36465","ENSG00000255423","3",73061659,73063337,1678
"36466","ENSG00000255424","11",19029697,19030438,741
"36467","ENSG00000255425","11",124211707,124215828,4121
"36468","ENSG00000255426","11",45733994,45735766,1772
"36469","ENSG00000255427","11",34570876,34573982,3106
"36470","ENSG00000255428","11",111414242,111418186,3944
"36471","ENSG00000255429","11",89546637,89589611,42974
"36472","ENSG00000255430","11",105122661,105123339,678
"36473","ENSG00000255433","11",56848478,56878078,29600
"36474","ENSG00000255434","11",75596144,75597270,1126
"36475","ENSG00000255435","11",118510273,118531094,20821
"36476","ENSG00000255437","8",14022687,14023422,735
"36477","ENSG00000255438","20",47677901,47686297,8396
"36478","ENSG00000255439","16",31083439,31094956,11517
"36479","ENSG00000255440","11",74398825,74416379,17554
"36480","ENSG00000255441","19",51415724,51417425,1701
"36481","ENSG00000255442","11",50170156,50190441,20285
"36482","ENSG00000255443","11",35210343,35214985,4642
"36483","ENSG00000255444","11",74482250,74482542,292
"36484","ENSG00000255445","11",93152075,93152750,675
"36485","ENSG00000255446","11",62421845,62426724,4879
"36486","ENSG00000255447","11",45813219,45825258,12039
"36487","ENSG00000255449","11",77866412,77870091,3679
"36488","ENSG00000255450","11",29275655,29276565,910
"36489","ENSG00000255451","11",44468464,44470429,1965
"36490","ENSG00000255455","11",130866254,130870247,3993
"36491","ENSG00000255456","8",144584040,144586488,2448
"36492","ENSG00000255457","8",13695574,13705506,9932
"36493","ENSG00000255458","4",39639107,39666879,27772
"36494","ENSG00000255459","8",8086022,8086765,743
"36495","ENSG00000255462","11",11570084,11573782,3698
"36496","ENSG00000255467","11",108105074,108121684,16610
"36497","ENSG00000255468","11",66347950,66364804,16854
"36498","ENSG00000255469","11",102880492,102880846,354
"36499","ENSG00000255470","11",18140186,18189495,49309
"36500","ENSG00000255471","11",86892214,86925037,32823
"36501","ENSG00000255474","12",4700417,4720102,19685
"36502","ENSG00000255476","11",9839143,9929263,90120
"36503","ENSG00000255477","11",38498995,38500186,1191
"36504","ENSG00000255478","11",65367438,65375299,7861
"36505","ENSG00000255479","11",76625462,76626834,1372
"36506","ENSG00000255480","11",30425552,30429268,3716
"36507","ENSG00000255481","11",6045807,6046747,940
"36508","ENSG00000255482","11",102467255,102498801,31546
"36509","ENSG00000255483","11",107600379,107600868,489
"36510","ENSG00000255484","11",112534220,112555802,21582
"36511","ENSG00000255487","8",38275888,38276680,792
"36512","ENSG00000255489","11",24701275,24701575,300
"36513","ENSG00000255491","8",124811042,124857516,46474
"36514","ENSG00000255492","11",11856490,11856859,369
"36515","ENSG00000255495","8",12194467,12196280,1813
"36516","ENSG00000255496","11",27696312,27877648,181336
"36517","ENSG00000255500","11",50268161,50269273,1112
"36518","ENSG00000255501","11",105137721,105531697,393976
"36519","ENSG00000255502","11",97878475,97959558,81083
"36520","ENSG00000255503","11",83072402,83097196,24794
"36521","ENSG00000255504","11",101208905,101209450,545
"36522","ENSG00000255506","11",92748732,92766867,18135
"36523","ENSG00000255507","11",75803431,75815406,11975
"36524","ENSG00000255508","11",62559603,62591531,31928
"36525","ENSG00000255510","11",124460534,124461485,951
"36526","ENSG00000255512","11",135061781,135075908,14127
"36527","ENSG00000255515","11",93609760,93610333,573
"36528","ENSG00000255516","11",88050106,88062110,12004
"36529","ENSG00000255517","11",66473490,66480233,6743
"36530","ENSG00000255520","11",47123104,47130801,7697
"36531","ENSG00000255521","11",35132655,35138032,5377
"36532","ENSG00000255523","11",58917015,58928689,11674
"36533","ENSG00000255524","16",28637654,28658682,21028
"36534","ENSG00000255525","11",31305685,31314548,8863
"36535","ENSG00000255526","14",24213955,24232352,18397
"36536","ENSG00000255527","11",48907103,48908946,1843
"36537","ENSG00000255529","15",57706695,57782762,76067
"36538","ENSG00000255532","11",49305714,49379669,73955
"36539","ENSG00000255533","11",303856,304144,288
"36540","ENSG00000255534","11",48526064,48526971,907
"36541","ENSG00000255535","11",130040365,130041071,706
"36542","ENSG00000255537","11",125495214,125499528,4314
"36543","ENSG00000255538","11",59748811,59749574,763
"36544","ENSG00000255539","11",70324871,70327209,2338
"36545","ENSG00000255541","11",83209399,83209634,235
"36546","ENSG00000255542","11",35419057,35421002,1945
"36547","ENSG00000255545","11",134412284,134505665,93381
"36548","ENSG00000255547","11",100336856,100337625,769
"36549","ENSG00000255548","11",103945548,103946546,998
"36550","ENSG00000255549","8",12448013,12511278,63265
"36551","ENSG00000255550","11",49854080,49859402,5322
"36552","ENSG00000255552","6",31711771,31714065,2294
"36553","ENSG00000255553","11",62049863,62082184,32321
"36554","ENSG00000255554","11",67974286,67975243,957
"36555","ENSG00000255555","11",84936689,84955705,19016
"36556","ENSG00000255556","8",12378679,12380265,1586
"36557","ENSG00000255557","11",65745729,65771585,25856
"36558","ENSG00000255559","8",145002811,145006046,3235
"36559","ENSG00000255561","11",111874056,111881243,7187
"36560","ENSG00000255562","11",71603260,71608040,4780
"36561","ENSG00000255565","12",15780068,15782120,2052
"36562","ENSG00000255566","12",64442510,64443330,820
"36563","ENSG00000255568","21",39313935,39314962,1027
"36564","ENSG00000255569","14",21621838,21622567,729
"36565","ENSG00000255571","15",89361579,89398487,36908
"36566","ENSG00000255572","12",7166674,7189069,22395
"36567","ENSG00000255575","12",120057035,120057180,145
"36568","ENSG00000255580","11",115363629,115377931,14302
"36569","ENSG00000255581","12",8017201,8017860,659
"36570","ENSG00000255582","14",21633836,21634940,1104
"36571","ENSG00000255583","12",63682523,63724935,42412
"36572","ENSG00000255585","9",137776539,137789235,12696
"36573","ENSG00000255587","6",36697826,36733184,35358
"36574","ENSG00000255595","12",126191151,126434227,243076
"36575","ENSG00000255599","11",115628065,115629743,1678
"36576","ENSG00000255605","11",95698086,95700623,2537
"36577","ENSG00000255606","11",69438365,69444743,6378
"36578","ENSG00000255608","12",4838955,4842675,3720
"36579","ENSG00000255618","12",118773031,118775137,2106
"36580","ENSG00000255621","12",13000451,13040679,40228
"36581","ENSG00000255622","5",141155996,141159061,3065
"36582","ENSG00000255624","10",122879681,122898615,18934
"36583","ENSG00000255627","12",22008348,22008880,532
"36584","ENSG00000255628","12",34149839,34162238,12399
"36585","ENSG00000255633","6",61574328,61574402,74
"36586","ENSG00000255639","12",4649101,4774184,125083
"36587","ENSG00000255641","12",10412312,10436001,23689
"36588","ENSG00000255642","12",63822021,63823895,1874
"36589","ENSG00000255644","12",21759980,21766705,6725
"36590","ENSG00000255647","5",90410000,90410669,669
"36591","ENSG00000255648","12",18714795,18737878,23083
"36592","ENSG00000255649","12",14530124,14543575,13451
"36593","ENSG00000255650","12",109734166,109773508,39342
"36594","ENSG00000255652","12",34190471,34219246,28775
"36595","ENSG00000255655","12",109445410,109447497,2087
"36596","ENSG00000255660","12",15151923,15155283,3360
"36597","ENSG00000255663","11",114400682,114443932,43250
"36598","ENSG00000255664","14",21649728,21650337,609
"36599","ENSG00000255666","11",94638045,94652884,14839
"36600","ENSG00000255669","12",2761200,2775658,14458
"36601","ENSG00000255670","12",12485353,12491581,6228
"36602","ENSG00000255671","12",193036,194130,1094
"36603","ENSG00000255672","11",72354516,72363555,9039
"36604","ENSG00000255679","11",96447132,96506826,59694
"36605","ENSG00000255680","11",6618790,6619764,974
"36606","ENSG00000255689","11",115582297,115600339,18042
"36607","ENSG00000255690","7",28953358,28958292,4934
"36608","ENSG00000255692","12",119699768,119701011,1243
"36609","ENSG00000255693","12",64883394,64990646,107252
"36610","ENSG00000255703","12",132899984,132900368,384
"36611","ENSG00000255704","12",131596857,131597115,258
"36612","ENSG00000255710","11",113820856,113821885,1029
"36613","ENSG00000255714","12",118645315,118648724,3409
"36614","ENSG00000255717","11",62851984,62855953,3969
"36615","ENSG00000255723","4",87317170,87345210,28040
"36616","ENSG00000255725","12",25803298,25804526,1228
"36617","ENSG00000255726","6",31222913,31223093,180
"36618","ENSG00000255727","12",15001787,15006999,5212
"36619","ENSG00000255730","19",41350853,41425001,74148
"36620","ENSG00000255733","12",67989445,68234686,245241
"36621","ENSG00000255734","12",10111738,10112471,733
"36622","ENSG00000255737","12",57726271,57728356,2085
"36623","ENSG00000255741","11",68941503,68942852,1349
"36624","ENSG00000255745","12",24704503,24775565,71062
"36625","ENSG00000255746","12",253442,257299,3857
"36626","ENSG00000255749","12",14254912,14255226,314
"36627","ENSG00000255750","12",26229548,26319720,90172
"36628","ENSG00000255753","12",9314402,9316173,1771
"36629","ENSG00000255757","12",127876999,127877516,517
"36630","ENSG00000255760","12",31876969,31959316,82347
"36631","ENSG00000255763","12",14237091,14237321,230
"36632","ENSG00000255769","15",82472993,82513950,40957
"36633","ENSG00000255772","12",67929235,67970017,40782
"36634","ENSG00000255774","11",69475567,69481545,5978
"36635","ENSG00000255775","12",6155035,6160719,5684
"36636","ENSG00000255776","12",9036344,9037244,900
"36637","ENSG00000255780","12",64032412,64032665,253
"36638","ENSG00000255786","11",73452020,73452344,324
"36639","ENSG00000255790","12",11399381,11486708,87327
"36640","ENSG00000255794","12",97430884,97598415,167531
"36641","ENSG00000255801","12",8548361,8567613,19252
"36642","ENSG00000255807","12",133033503,133033956,453
"36643","ENSG00000255808","11",72643237,72659407,16170
"36644","ENSG00000255811","1",34761426,34788097,26671
"36645","ENSG00000255814","12",118782926,118833536,50610
"36646","ENSG00000255815","9",99305176,99306611,1435
"36647","ENSG00000255817","12",64108763,64120489,11726
"36648","ENSG00000255819","12",10372353,10410146,37793
"36649","ENSG00000255823","11",10507887,10509189,1302
"36650","ENSG00000255825","12",590633,591269,636
"36651","ENSG00000255829","12",8664011,8669011,5000
"36652","ENSG00000255833","5",135444226,135452351,8125
"36653","ENSG00000255835","1",225886696,225924278,37582
"36654","ENSG00000255836","12",7438780,7439990,1210
"36655","ENSG00000255837","12",10996495,10997875,1380
"36656","ENSG00000255838","12",128944274,128945203,929
"36657","ENSG00000255843","11",72302139,72302965,826
"36658","ENSG00000255845","11",60813932,60821739,7807
"36659","ENSG00000255847","11",73963657,73970287,6630
"36660","ENSG00000255850","12",63804739,63822156,17417
"36661","ENSG00000255851","17",49017793,49018061,268
"36662","ENSG00000255853","12",126510910,126511711,801
"36663","ENSG00000255856","12",122007434,122020063,12629
"36664","ENSG00000255857","12",120201291,120213231,11940
"36665","ENSG00000255858","12",26301098,26317813,16715
"36666","ENSG00000255860","11",72172455,72177954,5499
"36667","ENSG00000255866","12",65556925,65560889,3964
"36668","ENSG00000255867","12",31589923,31615666,25743
"36669","ENSG00000255871","12",16693800,16695977,2177
"36670","ENSG00000255872","9",37588413,38068687,480274
"36671","ENSG00000255874","13",110863987,110870251,6264
"36672","ENSG00000255875","19",52809824,52810708,884
"36673","ENSG00000255882","12",9867027,9869808,2781
"36674","ENSG00000255883","5",73508685,73509254,569
"36675","ENSG00000255885","12",7870852,7871370,518
"36676","ENSG00000255886","12",64038562,64097618,59056
"36677","ENSG00000255892","12",18358443,18358967,524
"36678","ENSG00000255893","11",94472908,94473570,662
"36679","ENSG00000255903","11",115578049,115578243,194
"36680","ENSG00000255909","12",19413153,19413461,308
"36681","ENSG00000255910","12",19775451,20012261,236810
"36682","ENSG00000255916","12",132329850,132331575,1725
"36683","ENSG00000255920","12",4247981,4276252,28271
"36684","ENSG00000255921","12",24949163,24960158,10995
"36685","ENSG00000255928","11",73722349,73722694,345
"36686","ENSG00000255929","11",94545330,94740355,195025
"36687","ENSG00000255931","11",61496440,61506649,10209
"36688","ENSG00000255933","12",131756966,131758047,1081
"36689","ENSG00000255944","12",126628172,126690322,62150
"36690","ENSG00000255945","12",127598168,127599715,1547
"36691","ENSG00000255946","12",120740470,120761592,21122
"36692","ENSG00000255947","11",61654665,61655702,1037
"36693","ENSG00000255951","12",28164958,28165662,704
"36694","ENSG00000255959","11",60835996,60842965,6969
"36695","ENSG00000255960","12",18424663,18425140,477
"36696","ENSG00000255964","12",8015024,8016406,1382
"36697","ENSG00000255965","12",124383381,124383510,129
"36698","ENSG00000255966","12",6532290,6533498,1208
"36699","ENSG00000255967","12",8634367,8637608,3241
"36700","ENSG00000255968","12",26318953,26421462,102509
"36701","ENSG00000255970","12",67709047,67729475,20428
"36702","ENSG00000255973","12",5583797,5584085,288
"36703","ENSG00000255974","19",40843541,40850447,6906
"36704","ENSG00000255980","11",69425690,69429621,3931
"36705","ENSG00000255982","11",114512706,114513431,725
"36706","ENSG00000255983","12",5388589,5406651,18062
"36707","ENSG00000255986","16",56635739,56637086,1347
"36708","ENSG00000255987","17",35514766,35515186,420
"36709","ENSG00000255991","12",39466442,39467345,903
"36710","ENSG00000255992","12",131924736,131929351,4615
"36711","ENSG00000255993","12",18692762,18694096,1334
"36712","ENSG00000255998","12",126688341,126720333,31992
"36713","ENSG00000256001","12",127142029,127146532,4503
"36714","ENSG00000256004","12",8678773,8679670,897
"36715","ENSG00000256006","11",18405609,18406731,1122
"36716","ENSG00000256007","11",72685075,72693808,8733
"36717","ENSG00000256008","12",120628830,120641591,12761
"36718","ENSG00000256011","12",12962300,12963539,1239
"36719","ENSG00000256019","12",11048332,11049256,924
"36720","ENSG00000256020","12",585865,586486,621
"36721","ENSG00000256021","12",21447545,21448314,769
"36722","ENSG00000256022","12",127631248,127636488,5240
"36723","ENSG00000256025","12",2219485,2223479,3994
"36724","ENSG00000256028","12",122975320,122982907,7587
"36725","ENSG00000256029","1",159834474,159873053,38579
"36726","ENSG00000256030","12",2786931,2794295,7364
"36727","ENSG00000256034","11",73760563,73761070,507
"36728","ENSG00000256035","11",102806948,102807916,968
"36729","ENSG00000256037","12",67351436,67352039,603
"36730","ENSG00000256039","12",10553362,10572688,19326
"36731","ENSG00000256041","11",63032503,63033103,600
"36732","ENSG00000256043","4",155924118,155953866,29748
"36733","ENSG00000256045","X",55181391,55182920,1529
"36734","ENSG00000256050","14",104681146,104684932,3786
"36735","ENSG00000256053","14",103562962,103607523,44561
"36736","ENSG00000256056","12",27592461,27594039,1578
"36737","ENSG00000256060","19",57363511,57365353,1842
"36738","ENSG00000256061","15",55410525,55508234,97709
"36739","ENSG00000256064","12",130419535,130421019,1484
"36740","ENSG00000256069","12",9228533,9275817,47284
"36741","ENSG00000256070","12",33454345,33455452,1107
"36742","ENSG00000256071","12",117889454,117891008,1554
"36743","ENSG00000256072","12",66251745,66257434,5689
"36744","ENSG00000256073","21",32393130,32393960,830
"36745","ENSG00000256075","12",68473741,68474902,1161
"36746","ENSG00000256077","12",67571197,67589987,18790
"36747","ENSG00000256079","12",25435581,25436238,657
"36748","ENSG00000256081","14",21585290,21586280,990
"36749","ENSG00000256083","12",65934777,65948479,13702
"36750","ENSG00000256084","12",14216590,14221297,4707
"36751","ENSG00000256085","12",129521303,129522763,1460
"36752","ENSG00000256087","19",52031378,52095738,64360
"36753","ENSG00000256091","11",113711720,113712398,678
"36754","ENSG00000256092","12",123363868,123366113,2245
"36755","ENSG00000256098","11",74142151,74142358,207
"36756","ENSG00000256101","12",8321876,8329614,7738
"36757","ENSG00000256103","12",6270168,6270425,257
"36758","ENSG00000256108","12",132745156,132745729,573
"36759","ENSG00000256115","12",5226196,5244199,18003
"36760","ENSG00000256116","11",64229214,64234352,5138
"36761","ENSG00000256120","12",24223233,24260056,36823
"36762","ENSG00000256124","17",72030291,72041310,11019
"36763","ENSG00000256128","12",126729787,126772519,42732
"36764","ENSG00000256134","12",15971890,15972609,719
"36765","ENSG00000256137","12",129681427,129698227,16800
"36766","ENSG00000256139","12",109111218,109125594,14376
"36767","ENSG00000256148","11",73510658,73510820,162
"36768","ENSG00000256149","12",118849354,118908930,59576
"36769","ENSG00000256150","12",2695765,2812902,117137
"36770","ENSG00000256151","12",130990138,130993976,3838
"36771","ENSG00000256155","12",10358464,10361045,2581
"36772","ENSG00000256159","12",31477506,31477987,481
"36773","ENSG00000256162","6",130827406,130837135,9729
"36774","ENSG00000256166","6",31293908,31301642,7734
"36775","ENSG00000256167","11",113789231,113791366,2135
"36776","ENSG00000256171","12",8141168,8142697,1529
"36777","ENSG00000256172","12",67440998,67442559,1561
"36778","ENSG00000256176","12",31311617,31312029,412
"36779","ENSG00000256181","11",63265836,63266256,420
"36780","ENSG00000256185","12",26335864,26336950,1086
"36781","ENSG00000256188","12",11132958,11134644,1686
"36782","ENSG00000256189","11",73991283,73992180,897
"36783","ENSG00000256193","12",127914707,127960028,45321
"36784","ENSG00000256195","11",114343052,114396219,53167
"36785","ENSG00000256196","11",60916339,60925397,9058
"36786","ENSG00000256197","12",3149797,3151476,1679
"36787","ENSG00000256199","12",64507166,64533638,26472
"36788","ENSG00000256206","11",14493783,14520344,26561
"36789","ENSG00000256209","12",131462853,131529894,67041
"36790","ENSG00000256210","19",14792318,14792533,215
"36791","ENSG00000256211","12",16989126,16989936,810
"36792","ENSG00000256218","12",5366048,5367774,1726
"36793","ENSG00000256222","20",57358442,57359980,1538
"36794","ENSG00000256223","12",133130575,133159465,28890
"36795","ENSG00000256226","12",27105151,27161393,56242
"36796","ENSG00000256229","19",20167214,20200488,33274
"36797","ENSG00000256232","12",31363481,31369301,5820
"36798","ENSG00000256234","12",26211164,26335856,124692
"36799","ENSG00000256235","5",150777946,150796734,18788
"36800","ENSG00000256237","12",11541395,11555838,14443
"36801","ENSG00000256238","12",16399274,16402406,3132
"36802","ENSG00000256243","14",35235180,35235651,471
"36803","ENSG00000256249","12",122687125,122715979,28854
"36804","ENSG00000256250","12",130810606,130812438,1832
"36805","ENSG00000256254","11",102766801,102767927,1126
"36806","ENSG00000256257","12",2048352,2049463,1111
"36807","ENSG00000256258","12",131621891,131623203,1312
"36808","ENSG00000256259","12",66027725,66031066,3341
"36809","ENSG00000256262","12",109052350,109053952,1602
"36810","ENSG00000256263","12",12310,13501,1191
"36811","ENSG00000256268","12",65589111,65613000,23889
"36812","ENSG00000256269","11",119084866,119093549,8683
"36813","ENSG00000256271","12",2668500,2672220,3720
"36814","ENSG00000256273","12",68344664,68349959,5295
"36815","ENSG00000256274","12",11076769,11079171,2402
"36816","ENSG00000256278","15",84611689,84614969,3280
"36817","ENSG00000256280","11",63834667,63834943,276
"36818","ENSG00000256282","11",18595459,18599683,4224
"36819","ENSG00000256283","12",15255213,15255823,610
"36820","ENSG00000256286","12",126874804,126888718,13914
"36821","ENSG00000256287","12",20014780,20098868,84088
"36822","ENSG00000256288","12",10332861,10338292,5431
"36823","ENSG00000256292","12",127274265,127284328,10063
"36824","ENSG00000256293","12",64338178,64338797,619
"36825","ENSG00000256294","19",44112181,44134822,22641
"36826","ENSG00000256298","12",130047132,130048376,1244
"36827","ENSG00000256299","12",130810821,130812622,1801
"36828","ENSG00000256306","12",13526854,13547582,20728
"36829","ENSG00000256310","12",126524248,126524626,378
"36830","ENSG00000256311","12",119225834,119259017,33183
"36831","ENSG00000256312","12",132190213,132190997,784
"36832","ENSG00000256314","12",64654060,64655019,959
"36833","ENSG00000256315","11",115396756,115397658,902
"36834","ENSG00000256321","12",23175648,23191587,15939
"36835","ENSG00000256325","12",68828118,68828553,435
"36836","ENSG00000256331","12",7604350,7605214,864
"36837","ENSG00000256338","15",28315651,28316059,408
"36838","ENSG00000256339","12",14841092,14844708,3616
"36839","ENSG00000256340","16",18571162,18598328,27166
"36840","ENSG00000256341","11",64118272,64119210,938
"36841","ENSG00000256343","12",130651342,130669233,17891
"36842","ENSG00000256347","11",73248779,73249867,1088
"36843","ENSG00000256349","11",66509079,66533613,24534
"36844","ENSG00000256351","12",109859767,109860420,653
"36845","ENSG00000256355","12",67424272,67424986,714
"36846","ENSG00000256356","12",4097451,4099519,2068
"36847","ENSG00000256357","14",94430633,94464730,34097
"36848","ENSG00000256358","17",64308316,64308690,374
"36849","ENSG00000256361","11",18511043,18511475,432
"36850","ENSG00000256362","12",127324152,127340109,15957
"36851","ENSG00000256371","12",22573425,22575105,1680
"36852","ENSG00000256372","12",31853021,31853407,386
"36853","ENSG00000256377","12",27696388,27710803,14415
"36854","ENSG00000256379","14",21903077,21904598,1521
"36855","ENSG00000256381","12",4645496,4648027,2531
"36856","ENSG00000256385","14",21611924,21612381,457
"36857","ENSG00000256389","12",17479446,17709867,230421
"36858","ENSG00000256393","12",93083598,93083675,77
"36859","ENSG00000256394","4",155829729,155866273,36544
"36860","ENSG00000256399","12",63887379,63888598,1219
"36861","ENSG00000256400","12",11097179,11097274,95
"36862","ENSG00000256403","11",72410716,72412079,1363
"36863","ENSG00000256407","1",54132686,54200073,67387
"36864","ENSG00000256417","12",5290480,5383653,93173
"36865","ENSG00000256420","12",66563967,66569194,5227
"36866","ENSG00000256422","11",104445868,104609498,163630
"36867","ENSG00000256424","12",131639396,131661823,22427
"36868","ENSG00000256427","12",9240406,9261050,20644
"36869","ENSG00000256433","12",6393879,6396148,2269
"36870","ENSG00000256436","12",11030387,11031407,1020
"36871","ENSG00000256440","12",25831416,25834182,2766
"36872","ENSG00000256442","12",9647014,9648084,1070
"36873","ENSG00000256443","11",61539516,61542259,2743
"36874","ENSG00000256448","11",73405297,73410682,5385
"36875","ENSG00000256450","12",16513445,16514371,926
"36876","ENSG00000256452","11",113818077,113822458,4381
"36877","ENSG00000256458","2",203328459,203329226,767
"36878","ENSG00000256463","18",78980275,79002677,22402
"36879","ENSG00000256464","11",18490243,18490955,712
"36880","ENSG00000256465","12",31893370,31893702,332
"36881","ENSG00000256469","11",94874052,94925521,51469
"36882","ENSG00000256473","12",23637973,23638487,514
"36883","ENSG00000256474","14",21829539,21830070,531
"36884","ENSG00000256480","12",7237432,7240986,3554
"36885","ENSG00000256481","11",64081690,64087175,5485
"36886","ENSG00000256482","12",24830421,24836558,6137
"36887","ENSG00000256484","12",131366660,131371059,4399
"36888","ENSG00000256494","12",126400792,126405528,4736
"36889","ENSG00000256496","12",127317709,127319986,2277
"36890","ENSG00000256499","12",20120980,20136163,15183
"36891","ENSG00000256500","14",103562962,103685924,122962
"36892","ENSG00000256502","12",127344258,127344402,144
"36893","ENSG00000256504","12",27704568,27708365,3797
"36894","ENSG00000256508","11",69012283,69018447,6164
"36895","ENSG00000256513","12",28821975,28825831,3856
"36896","ENSG00000256514","11",67351572,67373584,22012
"36897","ENSG00000256518","11",72158822,72159734,912
"36898","ENSG00000256525","17",64477785,64497054,19269
"36899","ENSG00000256533","11",114453064,114454123,1059
"36900","ENSG00000256537","12",11171222,11176016,4794
"36901","ENSG00000256538","12",34037232,34058745,21513
"36902","ENSG00000256540","12",166856,182399,15543
"36903","ENSG00000256542","12",132277349,132280900,3551
"36904","ENSG00000256546","12",122063306,122068616,5310
"36905","ENSG00000256551","12",128086621,128118656,32035
"36906","ENSG00000256552","12",8320381,8369555,49174
"36907","ENSG00000256553","14",21642889,21643578,689
"36908","ENSG00000256557","12",27608733,27609046,313
"36909","ENSG00000256560","12",109354083,109359488,5405
"36910","ENSG00000256563","12",132972338,132972890,552
"36911","ENSG00000256564","12",16567411,16573940,6529
"36912","ENSG00000256566","20",2467212,2508907,41695
"36913","ENSG00000256568","11",73157946,73181724,23778
"36914","ENSG00000256571","12",63878787,63879474,687
"36915","ENSG00000256574","10",45302298,45315608,13310
"36916","ENSG00000256576","12",132186735,132189695,2960
"36917","ENSG00000256577","12",203642,205094,1452
"36918","ENSG00000256581","12",129013336,129016663,3327
"36919","ENSG00000256582","12",9704077,9709350,5273
"36920","ENSG00000256588","11",18507608,18508820,1212
"36921","ENSG00000256589","12",8254527,8308855,54328
"36922","ENSG00000256590","14",22469041,22469698,657
"36923","ENSG00000256591","11",61429220,61485822,56602
"36924","ENSG00000256594","12",9648047,9658412,10365
"36925","ENSG00000256596","12",124206228,124209018,2790
"36926","ENSG00000256597","12",127881616,127898645,17029
"36927","ENSG00000256603","11",113770393,113771691,1298
"36928","ENSG00000256609","12",119182048,119183259,1211
"36929","ENSG00000256612","19",40924219,40950660,26441
"36930","ENSG00000256615","12",21662313,21760032,97719
"36931","ENSG00000256616","18",12073232,12076654,3422
"36932","ENSG00000256618","17",22523111,22524663,1552
"36933","ENSG00000256625","12",27121910,27147664,25754
"36934","ENSG00000256628","3",101676475,101679217,2742
"36935","ENSG00000256630","12",128437778,128439206,1428
"36936","ENSG00000256632","12",132688049,132714912,26863
"36937","ENSG00000256633","11",72584572,72587979,3407
"36938","ENSG00000256637","2",103874310,104077778,203468
"36939","ENSG00000256640","12",26800843,26801302,459
"36940","ENSG00000256642","16",34158585,34160036,1451
"36941","ENSG00000256643","12",128023788,128027166,3378
"36942","ENSG00000256646","7",42909273,42932174,22901
"36943","ENSG00000256650","12",15112363,15114698,2335
"36944","ENSG00000256651","12",10831074,10832016,942
"36945","ENSG00000256654","12",4909867,5026012,116145
"36946","ENSG00000256657","12",11196075,11196996,921
"36947","ENSG00000256658","12",12723297,12724011,714
"36948","ENSG00000256659","12",128116730,128123103,6373
"36949","ENSG00000256660","12",10010627,10018796,8169
"36950","ENSG00000256661","12",8776219,8830947,54728
"36951","ENSG00000256663","12",20551590,20553012,1422
"36952","ENSG00000256667","12",10588063,10599669,11606
"36953","ENSG00000256670","12",64599078,64609459,10381
"36954","ENSG00000256671","2",110446640,110473075,26435
"36955","ENSG00000256672","12",674801,684127,9326
"36956","ENSG00000256673","12",9398355,9414851,16496
"36957","ENSG00000256674","11",114583253,114584692,1439
"36958","ENSG00000256678","12",68805011,68805479,468
"36959","ENSG00000256681","11",73850469,73851211,742
"36960","ENSG00000256682","12",10894943,10896952,2009
"36961","ENSG00000256683","19",51964340,51986856,22516
"36962","ENSG00000256684","11",96508425,96514748,6323
"36963","ENSG00000256686","12",25782706,25814171,31465
"36964","ENSG00000256690","11",62832234,62834043,1809
"36965","ENSG00000256691","12",3462718,3463586,868
"36966","ENSG00000256694","12",164664,166321,1657
"36967","ENSG00000256695","12",120389502,120395995,6493
"36968","ENSG00000256699","12",129208601,129212662,4061
"36969","ENSG00000256704","18",60009994,60011143,1149
"36970","ENSG00000256705","14",101833435,101839531,6096
"36971","ENSG00000256706","12",1917951,1922867,4916
"36972","ENSG00000256708","12",68143318,68143690,372
"36973","ENSG00000256712","12",11166090,11171353,5263
"36974","ENSG00000256713","11",61241042,61251448,10406
"36975","ENSG00000256714","12",22395088,22398075,2987
"36976","ENSG00000256717","11",115659658,115843146,183488
"36977","ENSG00000256720","12",9135084,9135591,507
"36978","ENSG00000256721","12",2269776,2288937,19161
"36979","ENSG00000256723","11",73994972,73996151,1179
"36980","ENSG00000256732","12",126610034,126690318,80284
"36981","ENSG00000256733","11",61055392,61067597,12205
"36982","ENSG00000256734","11",18450112,18450868,756
"36983","ENSG00000256737","14",21563819,21565084,1265
"36984","ENSG00000256739","11",72351347,72353210,1863
"36985","ENSG00000256742","12",121580792,121593504,12712
"36986","ENSG00000256745","11",94188449,94188997,548
"36987","ENSG00000256746","11",47270657,47272110,1453
"36988","ENSG00000256747","12",27779821,27781067,1246
"36989","ENSG00000256748","12",4601991,4603420,1429
"36990","ENSG00000256750","12",118758217,118761739,3522
"36991","ENSG00000256751","12",14567393,14624191,56798
"36992","ENSG00000256757","11",113405321,113412117,6796
"36993","ENSG00000256762","17",45999250,45999694,444
"36994","ENSG00000256769","12",2603350,2607440,4090
"36995","ENSG00000256771","19",19865886,19894674,28788
"36996","ENSG00000256779","11",95037482,95039811,2329
"36997","ENSG00000256783","12",132457160,132460024,2864
"36998","ENSG00000256789","11",63637677,63658962,21285
"36999","ENSG00000256797","12",9881489,9895833,14344
"37000","ENSG00000256799","12",4635349,4636140,791
"37001","ENSG00000256802","15",29674990,29680957,5967
"37002","ENSG00000256803","12",10015240,10030606,15366
"37003","ENSG00000256806","17",6651718,6693202,41484
"37004","ENSG00000256810","12",131030570,131035487,4917
"37005","ENSG00000256811","12",121856259,121857059,800
"37006","ENSG00000256812","16",55566672,55567687,1015
"37007","ENSG00000256813","11",60841806,60851081,9275
"37008","ENSG00000256814","12",125150058,125151394,1336
"37009","ENSG00000256817","12",9155881,9156372,491
"37010","ENSG00000256824","11",64035970,64103653,67683
"37011","ENSG00000256825","12",133130984,133202369,71385
"37012","ENSG00000256826","17",64491523,64491789,266
"37013","ENSG00000256827","12",124005871,124006225,354
"37014","ENSG00000256837","12",2018213,2020532,2319
"37015","ENSG00000256843","12",31748100,31748240,140
"37016","ENSG00000256844","12",19107854,19108183,329
"37017","ENSG00000256847","11",63243085,63244004,919
"37018","ENSG00000256849","12",19941521,19943018,1497
"37019","ENSG00000256852","12",24583561,24584549,988
"37020","ENSG00000256862","12",3871579,3910382,38803
"37021","ENSG00000256863","11",63237957,63239114,1157
"37022","ENSG00000256870","12",101155493,101210407,54914
"37023","ENSG00000256875","12",132462242,132462856,614
"37024","ENSG00000256879","12",20361732,20370262,8530
"37025","ENSG00000256884","12",119174065,119176484,2419
"37026","ENSG00000256888","12",10750188,10777446,27258
"37027","ENSG00000256892","10",37601440,37602974,1534
"37028","ENSG00000256894","12",26125155,26126617,1462
"37029","ENSG00000256896","12",17383352,17384647,1295
"37030","ENSG00000256897","11",47220218,47221751,1533
"37031","ENSG00000256898","11",73921665,73922196,531
"37032","ENSG00000256902","12",2752597,2753132,535
"37033","ENSG00000256904","12",8819816,8820713,897
"37034","ENSG00000256906","12",130070325,130072685,2360
"37035","ENSG00000256912","12",9817350,9818025,675
"37036","ENSG00000256913","12",6477714,6480207,2493
"37037","ENSG00000256915","12",65622273,65663299,41026
"37038","ENSG00000256916","11",102606916,102628070,21154
"37039","ENSG00000256925","10",133083073,133088491,5418
"37040","ENSG00000256937","12",9127783,9128645,862
"37041","ENSG00000256940","11",64245961,64248218,2257
"37042","ENSG00000256943","12",132275391,132278329,2938
"37043","ENSG00000256944","11",60913166,60914052,886
"37044","ENSG00000256947","11",114210616,114356571,145955
"37045","ENSG00000256948","12",106524,111850,5326
"37046","ENSG00000256950","12",121888809,121921470,32661
"37047","ENSG00000256955","12",131857420,131864538,7118
"37048","ENSG00000256963","12",121079842,121080124,282
"37049","ENSG00000256966","9",37512547,37592469,79922
"37050","ENSG00000256967","12",7129079,7131198,2119
"37051","ENSG00000256968","9",6748703,6748981,278
"37052","ENSG00000256969","12",4012902,4026658,13756
"37053","ENSG00000256971","12",127933689,127983854,50165
"37054","ENSG00000256972","11",115333577,115340262,6685
"37055","ENSG00000256973","12",22460519,22463914,3395
"37056","ENSG00000256975","12",9506347,9508440,2093
"37057","ENSG00000256977","2",109898428,109924868,26440
"37058","ENSG00000256980","6",73223544,73225770,2226
"37059","ENSG00000256981","12",11158785,11159694,909
"37060","ENSG00000256982","16",89046172,89052966,6794
"37061","ENSG00000256984","12",31012503,31015806,3303
"37062","ENSG00000256987","12",31953889,31955268,1379
"37063","ENSG00000256988","12",4804499,4830747,26248
"37064","ENSG00000256994","12",17509353,17590049,80696
"37065","ENSG00000256995","12",22699859,23188807,488948
"37066","ENSG00000257002","11",62909546,62918361,8815
"37067","ENSG00000257004","12",12668982,12685075,16093
"37068","ENSG00000257005","12",63651627,63651930,303
"37069","ENSG00000257008","17",74367407,74372622,5215
"37070","ENSG00000257009","12",25585994,25592928,6934
"37071","ENSG00000257012","11",95040411,95041571,1160
"37072","ENSG00000257016","12",10551266,10551535,269
"37073","ENSG00000257017","16",72054592,72061055,6463
"37074","ENSG00000257022","12",21827210,21887957,60747
"37075","ENSG00000257023","12",22609228,22625015,15787
"37076","ENSG00000257025","12",128399978,128404814,4836
"37077","ENSG00000257027","12",9658567,9662085,3518
"37078","ENSG00000257035","12",127624153,127626267,2114
"37079","ENSG00000257038","11",73307235,73309361,2126
"37080","ENSG00000257042","12",27958517,27969813,11296
"37081","ENSG00000257043","11",18665050,18665548,498
"37082","ENSG00000257045","2",199325310,199329362,4052
"37083","ENSG00000257046","12",20815674,21090245,274571
"37084","ENSG00000257048","12",3367833,3371346,3513
"37085","ENSG00000257052","11",60906789,60909742,2953
"37086","ENSG00000257056","14",28782909,28785798,2889
"37087","ENSG00000257057","11",94512432,94532123,19691
"37088","ENSG00000257058","11",62545999,62547699,1700
"37089","ENSG00000257060","15",93230034,93569483,339449
"37090","ENSG00000257062","12",21047179,21176895,129716
"37091","ENSG00000257065","6",143807092,143844617,37525
"37092","ENSG00000257067","11",115920248,115943181,22933
"37093","ENSG00000257069","11",64291722,64304769,13047
"37094","ENSG00000257070","11",113769660,113769994,334
"37095","ENSG00000257074","19",34296277,34296592,315
"37096","ENSG00000257075","11",72131282,72131907,625
"37097","ENSG00000257078","12",7041156,7041641,485
"37098","ENSG00000257083","12",66950754,67096410,145656
"37099","ENSG00000257084","12",6963246,6964447,1201
"37100","ENSG00000257086","11",64246939,64249494,2555
"37101","ENSG00000257087","11",115538869,115539384,515
"37102","ENSG00000257093","7",141656728,141702166,45438
"37103","ENSG00000257094","12",32007127,32007435,308
"37104","ENSG00000257095","12",119031039,119116961,85922
"37105","ENSG00000257097","12",122395542,122400857,5315
"37106","ENSG00000257101","11",113791466,113791752,286
"37107","ENSG00000257103","19",34172504,34229515,57011
"37108","ENSG00000257105","12",8987175,8996566,9391
"37109","ENSG00000257108","16",567005,569495,2490
"37110","ENSG00000257113","12",74274952,74275231,279
"37111","ENSG00000257114","12",42687195,42717120,29925
"37112","ENSG00000257119","12",106901283,106901984,701
"37113","ENSG00000257120","14",29652809,29657916,5107
"37114","ENSG00000257121","12",95100531,95101045,514
"37115","ENSG00000257122","16",22418672,22437715,19043
"37116","ENSG00000257125","12",52751978,52753821,1843
"37117","ENSG00000257126","14",28726675,28765292,38617
"37118","ENSG00000257127","12",92421531,92431002,9471
"37119","ENSG00000257128","12",41911256,41912212,956
"37120","ENSG00000257129","12",107910403,107912620,2217
"37121","ENSG00000257135","2",10448689,10457693,9004
"37122","ENSG00000257137","12",52205392,52213583,8191
"37123","ENSG00000257139","12",70180338,70202004,21666
"37124","ENSG00000257146","12",59719698,59719944,246
"37125","ENSG00000257150","12",95551582,95673999,122417
"37126","ENSG00000257155","14",31558507,31561334,2827
"37127","ENSG00000257157","12",97679879,97680047,168
"37128","ENSG00000257159","12",57967058,57968399,1341
"37129","ENSG00000257164","12",42646583,42686701,40118
"37130","ENSG00000257165","12",78448995,78540675,91680
"37131","ENSG00000257167","12",98512973,98516422,3449
"37132","ENSG00000257169","12",96386818,96387194,376
"37133","ENSG00000257175","14",18634955,18637208,2253
"37134","ENSG00000257176","12",29277955,29317848,39893
"37135","ENSG00000257178","17",48579630,48582259,2629
"37136","ENSG00000257179","14",25267064,25267336,272
"37137","ENSG00000257180","16",6056975,6092954,35979
"37138","ENSG00000257183","12",74248637,74283669,35032
"37139","ENSG00000257185","14",26809340,26836458,27118
"37140","ENSG00000257191","12",78960258,79045644,85386
"37141","ENSG00000257193","12",104170395,104177659,7264
"37142","ENSG00000257194","12",90107739,90112779,5040
"37143","ENSG00000257195","12",92883773,92884700,927
"37144","ENSG00000257198","9",34832295,34838586,6291
"37145","ENSG00000257199","12",76984079,76984669,590
"37146","ENSG00000257202","12",101923410,101924719,1309
"37147","ENSG00000257207","2",110402934,110473075,70141
"37148","ENSG00000257210","12",93124063,93124543,480
"37149","ENSG00000257218","12",120446444,120463749,17305
"37150","ENSG00000257219","12",76259836,76305969,46133
"37151","ENSG00000257220","12",78130337,78131004,667
"37152","ENSG00000257221","12",108628668,108642349,13681
"37153","ENSG00000257222","12",102063355,102074820,11465
"37154","ENSG00000257225","12",42459366,42466128,6762
"37155","ENSG00000257226","2",143765940,143776119,10179
"37156","ENSG00000257228","12",41409467,41473510,64043
"37157","ENSG00000257230","12",59523278,59524184,906
"37158","ENSG00000257231","12",113789542,113789807,265
"37159","ENSG00000257239","12",41829898,41932592,102694
"37160","ENSG00000257241","12",69946543,69947081,538
"37161","ENSG00000257242","12",91984976,92142914,157938
"37162","ENSG00000257243","12",49595148,49595688,540
"37163","ENSG00000257246","12",51124628,51125381,753
"37164","ENSG00000257252","12",93316722,93377753,61031
"37165","ENSG00000257253","12",49861207,49865802,4595
"37166","ENSG00000257256","12",50219604,50229984,10380
"37167","ENSG00000257258","12",29142969,29158537,15568
"37168","ENSG00000257259","12",58565959,58781747,215788
"37169","ENSG00000257261","12",46383652,46876784,493132
"37170","ENSG00000257262","12",30200983,30217916,16933
"37171","ENSG00000257264","16",14901499,14902174,675
"37172","ENSG00000257265","12",71007773,71032083,24310
"37173","ENSG00000257267","18",35290282,35328390,38108
"37174","ENSG00000257268","12",110831779,110845963,14184
"37175","ENSG00000257270","14",105467793,105470617,2824
"37176","ENSG00000257271","11",126543947,126610948,67001
"37177","ENSG00000257272","14",35873857,35875303,1446
"37178","ENSG00000257275","14",95711747,95757656,45909
"37179","ENSG00000257277","2",143674315,143741294,66979
"37180","ENSG00000257279","12",116977442,116987337,9895
"37181","ENSG00000257281","12",108281103,108282235,1132
"37182","ENSG00000257283","12",93894965,93943603,48638
"37183","ENSG00000257284","2",143162078,143172172,10094
"37184","ENSG00000257285","14",22929607,22956374,26767
"37185","ENSG00000257288","12",59052980,59054184,1204
"37186","ENSG00000257289","12",68913804,68914022,218
"37187","ENSG00000257292","12",38205098,38206009,911
"37188","ENSG00000257294","12",60092864,60096071,3207
"37189","ENSG00000257298","12",50185580,50191363,5783
"37190","ENSG00000257302","12",70671918,70672856,938
"37191","ENSG00000257303","12",56300076,56317992,17916
"37192","ENSG00000257307","14",35881001,35881709,708
"37193","ENSG00000257310","14",19244962,19247673,2711
"37194","ENSG00000257315","1",203795714,203854999,59285
"37195","ENSG00000257316","12",32985838,32987070,1232
"37196","ENSG00000257319","12",45050901,45103107,52206
"37197","ENSG00000257322","12",93003415,93215679,212264
"37198","ENSG00000257325","12",100852331,100859262,6931
"37199","ENSG00000257327","12",103841451,103844664,3213
"37200","ENSG00000257329","12",75964440,75967062,2622
"37201","ENSG00000257331","12",45063473,45065351,1878
"37202","ENSG00000257332","12",63271404,63272336,932
"37203","ENSG00000257335","7",141907813,142106747,198934
"37204","ENSG00000257336","12",68957377,68957677,300
"37205","ENSG00000257337","12",53012884,53054450,41566
"37206","ENSG00000257341","14",105487199,105492267,5068
"37207","ENSG00000257345","12",92999218,93019820,20602
"37208","ENSG00000257346","12",49090208,49093312,3104
"37209","ENSG00000257350","12",55122668,55124120,1452
"37210","ENSG00000257354","12",62602752,62622213,19461
"37211","ENSG00000257360","12",94140077,94141337,1260
"37212","ENSG00000257365","14",64986895,65062652,75757
"37213","ENSG00000257368","12",45444766,45445438,672
"37214","ENSG00000257373","12",42979254,42996486,17232
"37215","ENSG00000257376","12",42431665,42433357,1692
"37216","ENSG00000257379","12",53441741,53467528,25787
"37217","ENSG00000257384","12",55732366,55732648,282
"37218","ENSG00000257390","12",55757275,55827546,70271
"37219","ENSG00000257391","16",15154903,15157020,2117
"37220","ENSG00000257398","12",107809483,107864562,55079
"37221","ENSG00000257400","12",94491546,94496442,4896
"37222","ENSG00000257403","16",21347139,21352138,4999
"37223","ENSG00000257407","12",115582061,115639734,57673
"37224","ENSG00000257408","16",21938865,21944987,6122
"37225","ENSG00000257429","12",80583683,80593701,10018
"37226","ENSG00000257431","12",82512677,82515817,3140
"37227","ENSG00000257433","12",47706083,47742294,36211
"37228","ENSG00000257434","12",75020969,75044793,23824
"37229","ENSG00000257435","12",32988763,32993754,4991
"37230","ENSG00000257438","12",106103163,106106165,3002
"37231","ENSG00000257443","12",58920639,59064238,143599
"37232","ENSG00000257446","19",12043805,12052939,9134
"37233","ENSG00000257449","12",56029649,56041806,12157
"37234","ENSG00000257452","12",112907628,113017751,110123
"37235","ENSG00000257453","12",76030494,76031378,884
"37236","ENSG00000257454","12",71034122,71104526,70404
"37237","ENSG00000257456","12",29519731,29529974,10243
"37238","ENSG00000257458","12",98931682,98976656,44974
"37239","ENSG00000257464","12",49442424,49442652,228
"37240","ENSG00000257467","12",81270669,81312422,41753
"37241","ENSG00000257470","12",97024021,97127626,103605
"37242","ENSG00000257472","14",31925801,31930146,4345
"37243","ENSG00000257474","12",79540203,79550535,10332
"37244","ENSG00000257475","12",53012104,53013921,1817
"37245","ENSG00000257476","12",114238970,114241770,2800
"37246","ENSG00000257477","12",54428303,54429403,1100
"37247","ENSG00000257480","12",89752913,89753831,918
"37248","ENSG00000257488","12",47826854,47837898,11044
"37249","ENSG00000257489","12",100173196,100199783,26587
"37250","ENSG00000257494","12",112256800,112259091,2291
"37251","ENSG00000257495","12",52601467,52615305,13838
"37252","ENSG00000257496","12",46384233,46386991,2758
"37253","ENSG00000257497","12",75483454,75489820,6366
"37254","ENSG00000257501","12",97713412,97761859,48447
"37255","ENSG00000257507","12",69449470,69460724,11254
"37256","ENSG00000257509","12",55761550,55762628,1078
"37257","ENSG00000257510","12",42615221,42646547,31326
"37258","ENSG00000257511","12",32726383,32727387,1004
"37259","ENSG00000257512","12",93314809,93315941,1132
"37260","ENSG00000257513","18",11619509,11639699,20190
"37261","ENSG00000257514","12",101646720,101659970,13250
"37262","ENSG00000257515","12",71709171,71710374,1203
"37263","ENSG00000257517","12",114768674,114771851,3177
"37264","ENSG00000257519","12",115263170,115270596,7426
"37265","ENSG00000257520","14",36473207,36519521,46314
"37266","ENSG00000257522","14",29210986,29392048,181062
"37267","ENSG00000257523","14",28875404,29064993,189589
"37268","ENSG00000257524","9",127867850,127906022,38172
"37269","ENSG00000257526","12",76562294,76615567,53273
"37270","ENSG00000257527","16",18411309,18411851,542
"37271","ENSG00000257529","X",101391011,101412297,21286
"37272","ENSG00000257530","12",32104117,32107528,3411
"37273","ENSG00000257531","12",50217662,50218343,681
"37274","ENSG00000257534","12",54162065,54164452,2387
"37275","ENSG00000257539","12",111381867,111385638,3771
"37276","ENSG00000257542","12",52084744,52108261,23517
"37277","ENSG00000257543","12",101408372,101409060,688
"37278","ENSG00000257545","12",106495958,106774926,278968
"37279","ENSG00000257548","12",107093298,107123314,30016
"37280","ENSG00000257550","12",53513891,53517608,3717
"37281","ENSG00000257551","1",220832763,220880140,47377
"37282","ENSG00000257556","14",105093609,105100131,6522
"37283","ENSG00000257557","12",79934901,79942712,7811
"37284","ENSG00000257558","14",18667249,18667370,121
"37285","ENSG00000257564","12",78793526,78794114,588
"37286","ENSG00000257568","12",62482349,62484932,2583
"37287","ENSG00000257569","12",55900300,55900618,318
"37288","ENSG00000257570","12",49709237,49709336,99
"37289","ENSG00000257572","12",45071769,45072843,1074
"37290","ENSG00000257576","12",56511002,56512703,1701
"37291","ENSG00000257579","12",107610034,107617721,7687
"37292","ENSG00000257582","10",99526350,99531177,4827
"37293","ENSG00000257585","14",36070427,36165288,94861
"37294","ENSG00000257587","12",73906940,73919337,12397
"37295","ENSG00000257588","12",49951512,49962924,11412
"37296","ENSG00000257591","19",12142090,12156729,14639
"37297","ENSG00000257594","12",89519412,89524796,5384
"37298","ENSG00000257595","12",111369261,111403310,34049
"37299","ENSG00000257596","12",54262615,54279063,16448
"37300","ENSG00000257599","12",29389289,29487488,98199
"37301","ENSG00000257603","12",114077133,114079902,2769
"37302","ENSG00000257604","12",79500119,79500687,568
"37303","ENSG00000257605","12",53298655,53300314,1659
"37304","ENSG00000257611","12",106170004,106172437,2433
"37305","ENSG00000257612","14",26873092,26918594,45502
"37306","ENSG00000257613","12",70219132,70221862,2730
"37307","ENSG00000257614","14",35947556,35950044,2488
"37308","ENSG00000257616","12",52730425,52732865,2440
"37309","ENSG00000257621","14",58265365,58298134,32769
"37310","ENSG00000257622","14",105152194,105181194,29000
"37311","ENSG00000257624","12",112000739,112000985,246
"37312","ENSG00000257634","12",54682973,54687434,4461
"37313","ENSG00000257635","14",18698639,18699978,1339
"37314","ENSG00000257636","14",30437992,30573629,135637
"37315","ENSG00000257639","16",21532945,21550373,17428
"37316","ENSG00000257642","12",105304867,105327017,22150
"37317","ENSG00000257643","12",32692504,32692848,344
"37318","ENSG00000257645","12",38532895,38533050,155
"37319","ENSG00000257647","15",25027736,25032047,4311
"37320","ENSG00000257654","12",116698336,116703130,4794
"37321","ENSG00000257657","12",45475520,45610620,135100
"37322","ENSG00000257658","12",112321759,112323089,1330
"37323","ENSG00000257660","12",48789147,48790535,1388
"37324","ENSG00000257662","14",28593779,28593919,140
"37325","ENSG00000257663","12",52076841,52082084,5243
"37326","ENSG00000257666","12",95286318,95286838,520
"37327","ENSG00000257668","12",57983795,57984761,966
"37328","ENSG00000257671","12",52245048,52247448,2400
"37329","ENSG00000257674","12",42286911,42288560,1649
"37330","ENSG00000257675","12",52748776,52750127,1351
"37331","ENSG00000257677","12",77219603,77317234,97631
"37332","ENSG00000257680","12",40728811,40729897,1086
"37333","ENSG00000257681","12",103746315,103768858,22543
"37334","ENSG00000257682","12",73203815,73206835,3020
"37335","ENSG00000257683","12",115810359,115886137,75778
"37336","ENSG00000257691","16",29475064,29475355,291
"37337","ENSG00000257696","12",100143058,100144671,1613
"37338","ENSG00000257698","12",57930115,57936345,6230
"37339","ENSG00000257700","12",52692605,52696788,4183
"37340","ENSG00000257702","2",74502595,74504678,2083
"37341","ENSG00000257703","12",103079634,103178675,99041
"37342","ENSG00000257704","19",47274453,47275707,1254
"37343","ENSG00000257711","12",106678583,106684707,6124
"37344","ENSG00000257715","12",96025323,96027971,2648
"37345","ENSG00000257718","12",38906451,38909592,3141
"37346","ENSG00000257725","12",89947693,89949726,2033
"37347","ENSG00000257726","12",115363012,115364745,1733
"37348","ENSG00000257727","12",56309842,56316119,6277
"37349","ENSG00000257729","12",84154434,84294562,140128
"37350","ENSG00000257732","12",104262314,104280722,18408
"37351","ENSG00000257735","12",48350945,48442411,91466
"37352","ENSG00000257737","12",103654780,103657995,3215
"37353","ENSG00000257738","12",45200817,45201551,734
"37354","ENSG00000257740","12",56308868,56309449,581
"37355","ENSG00000257741","12",80763151,80770717,7566
"37356","ENSG00000257743","7",142111749,142222324,110575
"37357","ENSG00000257746","12",93090480,93108629,18149
"37358","ENSG00000257747","12",81953719,81993136,39417
"37359","ENSG00000257748","14",28800084,28830204,30120
"37360","ENSG00000257750","12",73758657,73846188,87531
"37361","ENSG00000257752","12",88057876,88058578,702
"37362","ENSG00000257754","12",103819610,103822085,2475
"37363","ENSG00000257756","12",30230779,30296707,65928
"37364","ENSG00000257759","14",70425812,70547464,121652
"37365","ENSG00000257761","12",71582293,71594404,12111
"37366","ENSG00000257762","12",103547751,103578947,31196
"37367","ENSG00000257763","12",48355792,48356614,822
"37368","ENSG00000257766","12",103668575,103669406,831
"37369","ENSG00000257767","12",111753890,111791418,37528
"37370","ENSG00000257769","16",15608474,15610563,2089
"37371","ENSG00000257771","12",49900311,49932764,32453
"37372","ENSG00000257773","12",106015897,106017006,1109
"37373","ENSG00000257777","12",75600047,75601551,1504
"37374","ENSG00000257779","12",63002469,63002795,326
"37375","ENSG00000257780","12",54608187,54610462,2275
"37376","ENSG00000257781","12",115755262,115799936,44674
"37377","ENSG00000257784","12",41764144,41774671,10527
"37378","ENSG00000257786","12",80561017,80561560,543
"37379","ENSG00000257787","12",90809207,90810689,1482
"37380","ENSG00000257790","12",53153272,53154484,1212
"37381","ENSG00000257797","15",42006132,42010117,3985
"37382","ENSG00000257800","2",74120680,74123218,2538
"37383","ENSG00000257802","12",71849228,71850428,1200
"37384","ENSG00000257803","12",100578744,100580197,1453
"37385","ENSG00000257807","12",47484689,47485722,1033
"37386","ENSG00000257808","12",53159586,53161000,1414
"37387","ENSG00000257809","12",56150796,56158220,7424
"37388","ENSG00000257813","12",43569769,43572038,2269
"37389","ENSG00000257815","12",69901918,70243379,341461
"37390","ENSG00000257817","12",114682292,114767989,85697
"37391","ENSG00000257818","12",69284397,69285485,1088
"37392","ENSG00000257823","12",75305452,75306357,905
"37393","ENSG00000257826","14",36061026,36067190,6164
"37394","ENSG00000257829","12",52306616,52308371,1755
"37395","ENSG00000257830","12",52274647,52279156,4509
"37396","ENSG00000257831","14",31248628,31302739,54111
"37397","ENSG00000257835","12",77379770,77390869,11099
"37398","ENSG00000257838","16",22545698,22576865,31167
"37399","ENSG00000257842","14",26598369,26806467,208098
"37400","ENSG00000257845","14",26775495,26822107,46612
"37401","ENSG00000257846","14",19668829,19670003,1174
"37402","ENSG00000257847","12",94590821,94591093,272
"37403","ENSG00000257848","12",48171590,48173353,1763
"37404","ENSG00000257849","12",42966122,42967353,1231
"37405","ENSG00000257851","12",51712469,51713606,1137
"37406","ENSG00000257852","12",32072734,32072880,146
"37407","ENSG00000257853","14",18912805,18916642,3837
"37408","ENSG00000257859","12",105704203,105744062,39859
"37409","ENSG00000257860","12",103151834,103179247,27413
"37410","ENSG00000257863","12",91901458,91906187,4729
"37411","ENSG00000257864","12",44248432,44249004,572
"37412","ENSG00000257869","14",28318141,28418612,100471
"37413","ENSG00000257870","12",55009746,55014247,4501
"37414","ENSG00000257872","12",76137425,76138610,1185
"37415","ENSG00000257875","12",82468456,82468948,492
"37416","ENSG00000257878","12",95996521,96011489,14968
"37417","ENSG00000257879","12",78426826,78442952,16126
"37418","ENSG00000257880","12",62139999,62145643,5644
"37419","ENSG00000257883","12",116661582,116698065,36483
"37420","ENSG00000257884","14",19677837,19680104,2267
"37421","ENSG00000257885","12",48168847,48169659,812
"37422","ENSG00000257890","12",106050961,106058254,7293
"37423","ENSG00000257891","14",18920109,18934078,13969
"37424","ENSG00000257893","12",91876924,91880659,3735
"37425","ENSG00000257894","12",79341205,79503396,162191
"37426","ENSG00000257896","12",43736628,43741067,4439
"37427","ENSG00000257897","12",86015697,86016441,744
"37428","ENSG00000257900","14",45377268,45389286,12018
"37429","ENSG00000257904","14",29940745,29980212,39467
"37430","ENSG00000257905","12",47593208,47593440,232
"37431","ENSG00000257906","12",47377638,47420192,42554
"37432","ENSG00000257907","12",43659827,43661101,1274
"37433","ENSG00000257910","12",76878193,76880352,2159
"37434","ENSG00000257912","12",87795733,87802028,6295
"37435","ENSG00000257913","12",48998367,49019235,20868
"37436","ENSG00000257918","12",106714924,106733066,18142
"37437","ENSG00000257920","12",97272692,97276209,3517
"37438","ENSG00000257921","12",57772660,57797554,24894
"37439","ENSG00000257923","7",101815904,102283958,468054
"37440","ENSG00000257924","12",47353754,47369935,16181
"37441","ENSG00000257925","12",47237734,47279021,41287
"37442","ENSG00000257927","12",43054089,43054386,297
"37443","ENSG00000257932","12",30320834,30321617,783
"37444","ENSG00000257935","12",113472003,113480624,8621
"37445","ENSG00000257940","12",87816486,87817831,1345
"37446","ENSG00000257941","12",76057538,76058115,577
"37447","ENSG00000257943","12",95311312,95442482,131170
"37448","ENSG00000257947","12",44244394,44263982,19588
"37449","ENSG00000257948","12",78794132,78808995,14863
"37450","ENSG00000257949","17",75979240,76000586,21346
"37451","ENSG00000257950","17",3663063,3696194,33131
"37452","ENSG00000257951","12",107880581,107883386,2805
"37453","ENSG00000257953","12",57837092,57842745,5653
"37454","ENSG00000257954","12",49389516,49390162,646
"37455","ENSG00000257955","12",48019771,48025382,5611
"37456","ENSG00000257956","12",79558782,79559166,384
"37457","ENSG00000257957","14",35765795,35767110,1315
"37458","ENSG00000257958","12",115077325,115080153,2828
"37459","ENSG00000257959","14",18555677,18596310,40633
"37460","ENSG00000257962","8",85246295,85249848,3553
"37461","ENSG00000257964","12",49576840,49577505,665
"37462","ENSG00000257966","12",55870048,55872602,2554
"37463","ENSG00000257976","14",25431193,25432234,1041
"37464","ENSG00000257979","12",116169045,116169258,213
"37465","ENSG00000257985","12",48011304,48025469,14165
"37466","ENSG00000257986","14",25647304,26143305,496001
"37467","ENSG00000257987","12",48727435,48765786,38351
"37468","ENSG00000257989","12",52092485,52104297,11812
"37469","ENSG00000257991","12",71835034,71835396,362
"37470","ENSG00000257995","12",90617759,90622822,5063
"37471","ENSG00000257997","12",114080381,114113489,33108
"37472","ENSG00000257998","12",74728038,74728851,813
"37473","ENSG00000258001","12",57431116,57433935,2819
"37474","ENSG00000258007","12",101038420,101039094,674
"37475","ENSG00000258010","15",80433795,80445152,11357
"37476","ENSG00000258011","12",110429959,110430282,323
"37477","ENSG00000258012","12",92858079,92859273,1194
"37478","ENSG00000258013","4",84544304,84544519,215
"37479","ENSG00000258016","12",53142053,53142327,274
"37480","ENSG00000258017","12",49127782,49188484,60702
"37481","ENSG00000258018","12",116482073,116521047,38974
"37482","ENSG00000258021","12",51900565,51901336,771
"37483","ENSG00000258024","12",48385417,48386265,848
"37484","ENSG00000258026","12",81094371,81125863,31492
"37485","ENSG00000258028","14",28936889,29372406,435517
"37486","ENSG00000258033","12",101066734,101069232,2498
"37487","ENSG00000258034","12",115961187,115962733,1546
"37488","ENSG00000258035","12",94167528,94187724,20196
"37489","ENSG00000258038","14",28829881,28968400,138519
"37490","ENSG00000258039","12",99093359,99105011,11652
"37491","ENSG00000258044","12",79823778,79825496,1718
"37492","ENSG00000258045","12",55731264,55731531,267
"37493","ENSG00000258048","12",79690144,79778451,88307
"37494","ENSG00000258050","14",55196727,55199013,2286
"37495","ENSG00000258051","12",48160245,48160878,633
"37496","ENSG00000258052","12",69801669,69855363,53694
"37497","ENSG00000258053","12",71047402,71118247,70845
"37498","ENSG00000258056","12",55729104,55730852,1748
"37499","ENSG00000258057","12",49827913,49841143,13230
"37500","ENSG00000258064","12",71674204,71698968,24764
"37501","ENSG00000258066","12",77775783,77783576,7793
"37502","ENSG00000258068","12",42485353,42498979,13626
"37503","ENSG00000258071","12",52763405,52763893,488
"37504","ENSG00000258072","12",107903270,107903948,678
"37505","ENSG00000258073","12",84939524,84939668,144
"37506","ENSG00000258077","12",75563202,75984015,420813
"37507","ENSG00000258080","14",19688261,19691194,2933
"37508","ENSG00000258081","14",26599755,27295516,695761
"37509","ENSG00000258082","1",234979647,234980804,1157
"37510","ENSG00000258083","7",141916399,141920625,4226
"37511","ENSG00000258084","12",78352519,78483030,130511
"37512","ENSG00000258086","12",54353792,54466985,113193
"37513","ENSG00000258088","12",75694010,75698816,4806
"37514","ENSG00000258090","12",76757191,76757914,723
"37515","ENSG00000258092","12",2797136,2803938,6802
"37516","ENSG00000258096","12",46371463,46373778,2315
"37517","ENSG00000258098","14",25124467,25156314,31847
"37518","ENSG00000258099","12",111599498,111600256,758
"37519","ENSG00000258100","12",91327045,91368607,41562
"37520","ENSG00000258101","12",49232790,49264756,31966
"37521","ENSG00000258102","12",116548105,116576597,28492
"37522","ENSG00000258104","12",49619334,49619612,278
"37523","ENSG00000258107","14",29390074,29436412,46338
"37524","ENSG00000258108","12",115569394,115581739,12345
"37525","ENSG00000258111","12",104514029,104514439,410
"37526","ENSG00000258112","12",75257635,75258634,999
"37527","ENSG00000258115","12",72046149,72057377,11228
"37528","ENSG00000258116","12",47341614,47342089,475
"37529","ENSG00000258117","12",63292625,63360037,67412
"37530","ENSG00000258118","12",30861921,30862179,258
"37531","ENSG00000258119","12",38544177,38589812,45635
"37532","ENSG00000258120","12",52630339,52634456,4117
"37533","ENSG00000258121","12",48483287,48500961,17674
"37534","ENSG00000258122","16",66841433,66853448,12015
"37535","ENSG00000258123","12",73159190,73208317,49127
"37536","ENSG00000258125","12",91680131,91680873,742
"37537","ENSG00000258128","12",87782163,87784568,2405
"37538","ENSG00000258130","16",30204316,30209071,4755
"37539","ENSG00000258131","12",96985656,97185609,199953
"37540","ENSG00000258133","12",58394596,58395138,542
"37541","ENSG00000258134","12",32227410,32228154,744
"37542","ENSG00000258135","12",49908882,49911863,2981
"37543","ENSG00000258136","12",107736555,107759968,23413
"37544","ENSG00000258137","12",54353661,54497688,144027
"37545","ENSG00000258140","12",69212108,69224242,12134
"37546","ENSG00000258144","12",39087347,39145482,58135
"37547","ENSG00000258148","12",91193709,91193942,233
"37548","ENSG00000258150","16",29464967,29467833,2866
"37549","ENSG00000258153","12",101873316,101873623,307
"37550","ENSG00000258159","12",113015607,113016098,491
"37551","ENSG00000258162","12",81378042,81556637,178595
"37552","ENSG00000258167","12",40395853,40443847,47994
"37553","ENSG00000258168","12",70468080,70543040,74960
"37554","ENSG00000258169","12",102809280,102824399,15119
"37555","ENSG00000258170","12",82481118,82497560,16442
"37556","ENSG00000258171","12",93173470,93182299,8829
"37557","ENSG00000258172","12",94272150,94277195,5045
"37558","ENSG00000258175","14",28592223,28613623,21400
"37559","ENSG00000258177","12",96222797,96223973,1176
"37560","ENSG00000258179","12",87820654,87820918,264
"37561","ENSG00000258181","12",47248124,47257539,9415
"37562","ENSG00000258183","12",90280894,90300974,20080
"37563","ENSG00000258185","12",86599578,86838998,239420
"37564","ENSG00000258196","14",31553358,31558498,5140
"37565","ENSG00000258199","12",56162359,56190284,27925
"37566","ENSG00000258203","12",48005277,48011227,5950
"37567","ENSG00000258204","12",98794485,98794964,479
"37568","ENSG00000258210","12",110387463,110445548,58085
"37569","ENSG00000258212","12",44008620,44010143,1523
"37570","ENSG00000258216","12",89712048,90100763,388715
"37571","ENSG00000258220","12",78326680,78359746,33066
"37572","ENSG00000258223","7",142252143,142258058,5915
"37573","ENSG00000258224","12",91871122,91871230,108
"37574","ENSG00000258225","12",78052181,78091737,39556
"37575","ENSG00000258227","7",141927357,141947007,19650
"37576","ENSG00000258230","12",101773114,101773755,641
"37577","ENSG00000258231","12",58544124,58813060,268936
"37578","ENSG00000258232","12",49265156,49273306,8150
"37579","ENSG00000258233","14",18623852,18626787,2935
"37580","ENSG00000258234","12",48231098,48284210,53112
"37581","ENSG00000258239","12",41698495,41699182,687
"37582","ENSG00000258240","12",110951683,110957820,6137
"37583","ENSG00000258244","12",114588194,114588802,608
"37584","ENSG00000258245","12",75688794,75689096,302
"37585","ENSG00000258249","12",116599270,116603585,4315
"37586","ENSG00000258254","12",114621761,114622922,1161
"37587","ENSG00000258256","8",85222446,85245717,23271
"37588","ENSG00000258260","12",56267793,56270104,2311
"37589","ENSG00000258265","14",18944199,18945139,940
"37590","ENSG00000258271","12",93529560,93529989,429
"37591","ENSG00000258272","12",96422326,96485442,63116
"37592","ENSG00000258273","12",48333755,48333901,146
"37593","ENSG00000258274","12",93707791,93737823,30032
"37594","ENSG00000258279","12",52164115,52223813,59698
"37595","ENSG00000258282","14",28673241,28673727,486
"37596","ENSG00000258284","12",49594091,49594258,167
"37597","ENSG00000258285","12",117099481,117142091,42610
"37598","ENSG00000258288","12",101963901,101964340,439
"37599","ENSG00000258289","14",64914361,64944591,30230
"37600","ENSG00000258292","12",95803097,95823307,20210
"37601","ENSG00000258300","14",35819837,35820220,383
"37602","ENSG00000258301","14",76781733,76786724,4991
"37603","ENSG00000258302","12",89561129,89594878,33749
"37604","ENSG00000258303","12",93836167,93838038,1871
"37605","ENSG00000258308","12",101954992,101962414,7422
"37606","ENSG00000258311","12",55716036,55724703,8667
"37607","ENSG00000258312","12",98113014,98292445,179431
"37608","ENSG00000258313","12",95387890,95388558,668
"37609","ENSG00000258314","14",19024090,19055551,31461
"37610","ENSG00000258315","17",7014495,7017525,3030
"37611","ENSG00000258316","12",62234390,62235515,1125
"37612","ENSG00000258317","12",56120033,56129619,9586
"37613","ENSG00000258320","12",74170445,74171830,1385
"37614","ENSG00000258323","12",112063909,112065755,1846
"37615","ENSG00000258325","12",2796877,2812902,16025
"37616","ENSG00000258331","12",43155315,43163110,7795
"37617","ENSG00000258332","12",74039024,74049981,10957
"37618","ENSG00000258334","12",49292631,49324576,31945
"37619","ENSG00000258337","12",116174502,116181295,6793
"37620","ENSG00000258342","14",35897936,36068261,170325
"37621","ENSG00000258343","12",95791733,95858839,67106
"37622","ENSG00000258344","12",54276631,54345083,68452
"37623","ENSG00000258346","12",116368764,116389471,20707
"37624","ENSG00000258352","12",47135498,47138370,2872
"37625","ENSG00000258354","16",14909887,14911345,1458
"37626","ENSG00000258355","12",106245613,106246956,1343
"37627","ENSG00000258357","12",94521090,94521869,779
"37628","ENSG00000258359","12",111669852,111670362,510
"37629","ENSG00000258365","12",94277758,94282844,5086
"37630","ENSG00000258366","20",63657810,63696253,38443
"37631","ENSG00000258367","14",18562928,18568790,5862
"37632","ENSG00000258368","12",37575587,37576384,797
"37633","ENSG00000258373","12",111992996,111993875,879
"37634","ENSG00000258375","12",81545326,81546450,1124
"37635","ENSG00000258376","14",73242651,73245979,3328
"37636","ENSG00000258378","14",58398557,58427125,28568
"37637","ENSG00000258379","14",97786565,97789256,2691
"37638","ENSG00000258380","14",89399995,89409469,9474
"37639","ENSG00000258383","14",99324799,99332015,7216
"37640","ENSG00000258384","15",90952239,90955225,2986
"37641","ENSG00000258385","14",41296286,41298734,2448
"37642","ENSG00000258386","14",32006902,32018685,11783
"37643","ENSG00000258388","6",32153845,32171978,18133
"37644","ENSG00000258390","14",95573520,95582305,8785
"37645","ENSG00000258392","14",46996454,46997174,720
"37646","ENSG00000258394","14",42362983,42703655,340672
"37647","ENSG00000258399","14",100836269,100947194,110925
"37648","ENSG00000258400","14",49707667,49708792,1125
"37649","ENSG00000258402","14",76280943,76310066,29123
"37650","ENSG00000258404","14",101634454,101731108,96654
"37651","ENSG00000258405","19",52453553,52516882,63329
"37652","ENSG00000258407","14",88010787,88015611,4824
"37653","ENSG00000258408","14",73539221,73539781,560
"37654","ENSG00000258410","15",20128745,20147953,19208
"37655","ENSG00000258412","14",96210860,96214818,3958
"37656","ENSG00000258413","14",55262222,55272075,9853
"37657","ENSG00000258414","14",37564047,37579125,15078
"37658","ENSG00000258416","14",79893080,79974169,81089
"37659","ENSG00000258419","14",79199982,79201632,1650
"37660","ENSG00000258422","14",70187123,70230187,43064
"37661","ENSG00000258423","14",51756996,51757988,992
"37662","ENSG00000258424","14",90402523,90405235,2712
"37663","ENSG00000258425","14",74552181,74560048,7867
"37664","ENSG00000258426","14",83018201,83039602,21401
"37665","ENSG00000258427","14",60397757,60398281,524
"37666","ENSG00000258428","14",56633244,56648658,15414
"37667","ENSG00000258429","16",69326913,69330588,3675
"37668","ENSG00000258431","14",70858844,70859429,585
"37669","ENSG00000258433","15",95034108,95047108,13000
"37670","ENSG00000258435","12",121391962,121399859,7897
"37671","ENSG00000258436","14",20590193,20590823,630
"37672","ENSG00000258437","14",90675118,90676294,1176
"37673","ENSG00000258438","14",19733355,19734302,947
"37674","ENSG00000258439","14",74658049,74658590,541
"37675","ENSG00000258440","14",52155740,52156179,439
"37676","ENSG00000258441","14",21200079,21206900,6821
"37677","ENSG00000258443","14",73517233,73520648,3415
"37678","ENSG00000258444","14",23415339,23415686,347
"37679","ENSG00000258445","14",60779978,60780595,617
"37680","ENSG00000258446","14",91419449,91419751,302
"37681","ENSG00000258448","14",73068108,73068618,510
"37682","ENSG00000258449","12",25096868,25100980,4112
"37683","ENSG00000258450","14",49629291,49629890,599
"37684","ENSG00000258451","14",20693480,20707120,13640
"37685","ENSG00000258452","14",80822524,80822796,272
"37686","ENSG00000258454","14",76235817,76263474,27657
"37687","ENSG00000258455","14",55325834,55339501,13667
"37688","ENSG00000258456","14",20524287,20525422,1135
"37689","ENSG00000258457","14",22982698,22999078,16380
"37690","ENSG00000258458","14",22701476,22766562,65086
"37691","ENSG00000258459","14",20305730,20306811,1081
"37692","ENSG00000258460","14",101332511,101335497,2986
"37693","ENSG00000258461","15",42348103,42412317,64214
"37694","ENSG00000258463","15",19899334,19899559,225
"37695","ENSG00000258464","14",23699797,23729757,29960
"37696","ENSG00000258465","1",160216800,160285130,68330
"37697","ENSG00000258466","14",67659820,67690367,30547
"37698","ENSG00000258467","14",36533506,36534538,1032
"37699","ENSG00000258468","14",20179189,20180156,967
"37700","ENSG00000258469","14",55298644,55299231,587
"37701","ENSG00000258471","14",20995837,21014822,18985
"37702","ENSG00000258472","17",28455752,28614197,158445
"37703","ENSG00000258473","14",77048172,77086457,38285
"37704","ENSG00000258474","14",31944853,31950382,5529
"37705","ENSG00000258476","15",93835490,93878822,43332
"37706","ENSG00000258477","14",68421698,68422196,498
"37707","ENSG00000258478","14",78744398,78753878,9480
"37708","ENSG00000258479","14",51333068,51365557,32489
"37709","ENSG00000258482","14",21950406,21950654,248
"37710","ENSG00000258483","15",98003038,98087384,84346
"37711","ENSG00000258484","15",68818221,68946811,128590
"37712","ENSG00000258485","14",60919240,60920155,915
"37713","ENSG00000258487","14",44444747,44480626,35879
"37714","ENSG00000258489","15",95463587,95493843,30256
"37715","ENSG00000258490","14",66969038,66969816,778
"37716","ENSG00000258491","14",50704343,50705511,1168
"37717","ENSG00000258494","15",20969282,20970215,933
"37718","ENSG00000258497","14",101257332,101278318,20986
"37719","ENSG00000258498","14",101552221,101560431,8210
"37720","ENSG00000258499","14",92905697,92907482,1785
"37721","ENSG00000258500","14",100480952,100481274,322
"37722","ENSG00000258502","14",66111557,66131716,20159
"37723","ENSG00000258503","14",53011971,53012267,296
"37724","ENSG00000258506","14",84951274,84951373,99
"37725","ENSG00000258507","4",8858715,8860827,2112
"37726","ENSG00000258509","14",44887434,44887741,307
"37727","ENSG00000258510","14",77359423,77359916,493
"37728","ENSG00000258511","14",98136074,98139242,3168
"37729","ENSG00000258512","14",101730437,101732522,2085
"37730","ENSG00000258513","14",74192589,74192823,234
"37731","ENSG00000258515","14",20451305,20451918,613
"37732","ENSG00000258516","14",95828763,95866486,37723
"37733","ENSG00000258517","14",71212633,71218216,5583
"37734","ENSG00000258520","14",69239166,69260567,21401
"37735","ENSG00000258521","14",100339832,100340554,722
"37736","ENSG00000258524","14",73571159,73571667,508
"37737","ENSG00000258525","14",30876179,30889808,13629
"37738","ENSG00000258526","14",39432599,40390547,957948
"37739","ENSG00000258527","15",92795647,92796439,792
"37740","ENSG00000258531","14",68936602,68936864,262
"37741","ENSG00000258532","14",83903437,83915377,11940
"37742","ENSG00000258534","14",103854366,103880111,25745
"37743","ENSG00000258535","14",51765276,51825422,60146
"37744","ENSG00000258536","14",41742639,41742963,324
"37745","ENSG00000258537","14",51454512,51599952,145440
"37746","ENSG00000258538","14",88175391,88180198,4807
"37747","ENSG00000258539","10",124617080,124791727,174647
"37748","ENSG00000258544","14",90107675,90107995,320
"37749","ENSG00000258545","X",120036236,120146854,110618
"37750","ENSG00000258546","12",25092715,25093900,1185
"37751","ENSG00000258548","14",27612577,27639636,27059
"37752","ENSG00000258550","14",51763056,51764076,1020
"37753","ENSG00000258551","15",91408708,91605873,197165
"37754","ENSG00000258552","14",77173075,77173652,577
"37755","ENSG00000258553","14",59969116,60091783,122667
"37756","ENSG00000258555","22",24270898,24442356,171458
"37757","ENSG00000258556","14",60323236,60323907,671
"37758","ENSG00000258558","14",30734926,30822702,87776
"37759","ENSG00000258559","14",74289127,74294425,5298
"37760","ENSG00000258560","14",100052803,100074878,22075
"37761","ENSG00000258561","14",66212810,66509394,296584
"37762","ENSG00000258562","15",92762757,92763750,993
"37763","ENSG00000258563","14",60179382,60180016,634
"37764","ENSG00000258564","14",19796345,19797293,948
"37765","ENSG00000258565","14",68867857,68869951,2094
"37766","ENSG00000258568","14",49599994,49600572,578
"37767","ENSG00000258569","14",76710658,76761388,50730
"37768","ENSG00000258571","14",71085482,71085833,351
"37769","ENSG00000258572","14",95516136,95517911,1775
"37770","ENSG00000258573","14",20587644,20607221,19577
"37771","ENSG00000258577","14",50571919,50572140,221
"37772","ENSG00000258578","14",76013679,76014143,464
"37773","ENSG00000258580","14",32373337,32417974,44637
"37774","ENSG00000258581","14",100366628,100366920,292
"37775","ENSG00000258583","14",58646631,59184247,537616
"37776","ENSG00000258584","14",93904730,93927066,22336
"37777","ENSG00000258585","15",21911559,21912590,1031
"37778","ENSG00000258586","14",73822559,73830135,7576
"37779","ENSG00000258587","14",74873684,74874254,570
"37780","ENSG00000258588","11",5596725,5644398,47673
"37781","ENSG00000258590","15",20657638,20688408,30770
"37782","ENSG00000258591","14",39108342,39108707,365
"37783","ENSG00000258592","14",57066260,57112660,46400
"37784","ENSG00000258593","14",104857792,104858836,1044
"37785","ENSG00000258594","15",27621534,27629289,7755
"37786","ENSG00000258595","14",93138066,93138465,399
"37787","ENSG00000258597","14",94364313,94366698,2385
"37788","ENSG00000258599","14",20983155,20985066,1911
"37789","ENSG00000258600","14",83017106,83018144,1038
"37790","ENSG00000258602","14",76959638,76965802,6164
"37791","ENSG00000258603","14",73555115,73633941,78826
"37792","ENSG00000258604","14",21024172,21029271,5099
"37793","ENSG00000258605","14",81412970,81413239,269
"37794","ENSG00000258608","14",45290036,45290386,350
"37795","ENSG00000258609","18",57054558,57072119,17561
"37796","ENSG00000258611","15",93065586,93066606,1020
"37797","ENSG00000258613","14",65266638,65267690,1052
"37798","ENSG00000258615","14",95199039,95199345,306
"37799","ENSG00000258616","14",45706250,45715952,9702
"37800","ENSG00000258619","14",32241524,32243093,1569
"37801","ENSG00000258620","14",100406599,100408928,2329
"37802","ENSG00000258622","14",42657763,42657918,155
"37803","ENSG00000258623","14",68683411,68685565,2154
"37804","ENSG00000258626","14",67652300,67652614,314
"37805","ENSG00000258628","15",20228620,20277503,48883
"37806","ENSG00000258629","14",65879592,65881070,1478
"37807","ENSG00000258630","14",95320285,95335757,15472
"37808","ENSG00000258631","15",93589867,93760886,171019
"37809","ENSG00000258633","14",44876874,44897077,20203
"37810","ENSG00000258634","1",110058340,110062555,4215
"37811","ENSG00000258636","14",41583657,41604988,21331
"37812","ENSG00000258637","14",79661666,79791263,129597
"37813","ENSG00000258639","14",48045481,48046216,735
"37814","ENSG00000258640","14",31111569,31112239,670
"37815","ENSG00000258642","14",20874305,20875768,1463
"37816","ENSG00000258643","14",23306835,23325369,18534
"37817","ENSG00000258644","14",70326064,70417074,91010
"37818","ENSG00000258645","14",63601509,63601814,305
"37819","ENSG00000258646","14",75004719,75008481,3762
"37820","ENSG00000258647","15",92567817,92574529,6712
"37821","ENSG00000258648","14",30683045,30683598,553
"37822","ENSG00000258649","14",38190983,38202923,11940
"37823","ENSG00000258651","14",39103140,39103812,672
"37824","ENSG00000258653","14",73851971,73932278,80307
"37825","ENSG00000258654","15",20344736,20359166,14430
"37826","ENSG00000258655","14",32074946,32076793,1847
"37827","ENSG00000258657","14",24595723,24657774,62051
"37828","ENSG00000258658","14",58370023,58395641,25618
"37829","ENSG00000258659","11",5619764,5644398,24634
"37830","ENSG00000258661","14",36647083,36658801,11718
"37831","ENSG00000258662","14",79246668,79249023,2355
"37832","ENSG00000258667","14",61707564,61751099,43535
"37833","ENSG00000258670","14",60515119,60554916,39797
"37834","ENSG00000258672","14",99691445,99693648,2203
"37835","ENSG00000258673","1",110082688,110109719,27031
"37836","ENSG00000258674","19",19516227,19536076,19849
"37837","ENSG00000258675","14",81441987,81450371,8384
"37838","ENSG00000258676","15",92580741,92600545,19804
"37839","ENSG00000258677","8",73688691,73878854,190163
"37840","ENSG00000258678","14",90452063,90455127,3064
"37841","ENSG00000258679","12",56822985,56874268,51283
"37842","ENSG00000258680","14",38835389,38835788,399
"37843","ENSG00000258682","14",58264662,58269681,5019
"37844","ENSG00000258684","15",21160305,21167357,7052
"37845","ENSG00000258687","14",50848122,50865659,17537
"37846","ENSG00000258689","14",70698698,70712153,13455
"37847","ENSG00000258691","14",96204844,96263929,59085
"37848","ENSG00000258692","14",60493766,60496885,3119
"37849","ENSG00000258693","14",99977115,99978098,983
"37850","ENSG00000258694","14",52111122,52129625,18503
"37851","ENSG00000258695","14",73522878,73530610,7732
"37852","ENSG00000258696","14",38003113,38004847,1734
"37853","ENSG00000258698","14",52792875,52820034,27159
"37854","ENSG00000258699","14",89355060,89356571,1511
"37855","ENSG00000258700","14",45891087,46501903,610816
"37856","ENSG00000258701","14",104821201,104823718,2517
"37857","ENSG00000258702","14",96592399,96605974,13575
"37858","ENSG00000258703","14",56759379,56765757,6378
"37859","ENSG00000258704","14",34920858,34982532,61674
"37860","ENSG00000258705","14",22011910,22014964,3054
"37861","ENSG00000258708","14",37171888,37173811,1923
"37862","ENSG00000258710","15",20940380,21058440,118060
"37863","ENSG00000258711","14",50956259,50962002,5743
"37864","ENSG00000258712","15",21372793,21373881,1088
"37865","ENSG00000258713","20",2814987,2815833,846
"37866","ENSG00000258716","14",90697333,90699374,2041
"37867","ENSG00000258717","14",100675930,100679884,3954
"37868","ENSG00000258718","14",81727780,81743749,15969
"37869","ENSG00000258719","14",78695321,78698122,2801
"37870","ENSG00000258721","15",22009547,22010529,982
"37871","ENSG00000258723","14",78279572,78283376,3804
"37872","ENSG00000258724","8",10725399,10839847,114448
"37873","ENSG00000258725","15",90966340,90988625,22285
"37874","ENSG00000258727","14",23561097,23568073,6976
"37875","ENSG00000258728","9",34646645,34657113,10468
"37876","ENSG00000258730","14",93067452,93072152,4700
"37877","ENSG00000258731","14",53153354,53157528,4174
"37878","ENSG00000258732","15",22278971,22282872,3901
"37879","ENSG00000258733","14",85911438,86161500,250062
"37880","ENSG00000258734","14",58827679,58828176,497
"37881","ENSG00000258735","14",103847721,103858049,10328
"37882","ENSG00000258736","14",104653548,104655787,2239
"37883","ENSG00000258737","14",74305425,74306527,1102
"37884","ENSG00000258738","14",34874343,34876459,2116
"37885","ENSG00000258739","15",92420860,92422735,1875
"37886","ENSG00000258740","14",75238616,75269283,30667
"37887","ENSG00000258741","15",92715710,92734195,18485
"37888","ENSG00000258742","14",92886352,92893508,7156
"37889","ENSG00000258743","14",82642605,82746664,104059
"37890","ENSG00000258744","14",24443016,24508688,65672
"37891","ENSG00000258745","14",50912226,50913358,1132
"37892","ENSG00000258746","14",45502742,45503140,398
"37893","ENSG00000258747","14",44507385,44567467,60082
"37894","ENSG00000258748","14",104137150,104137898,748
"37895","ENSG00000258751","14",48394815,48491767,96952
"37896","ENSG00000258752","14",89349377,89366081,16704
"37897","ENSG00000258754","15",93718542,94070898,352356
"37898","ENSG00000258758","14",57040885,57042504,1619
"37899","ENSG00000258759","14",67799004,67799609,605
"37900","ENSG00000258760","14",65236480,65318790,82310
"37901","ENSG00000258761","15",92162798,92172436,9638
"37902","ENSG00000258763","12",55434734,55585471,150737
"37903","ENSG00000258765","15",91643017,91649114,6097
"37904","ENSG00000258766","14",80211419,80455469,244050
"37905","ENSG00000258768","14",20260480,20264308,3828
"37906","ENSG00000258769","14",74482985,74483435,450
"37907","ENSG00000258770","14",87634379,87655294,20915
"37908","ENSG00000258772","14",20916766,20928580,11814
"37909","ENSG00000258773","15",95078481,95150534,72053
"37910","ENSG00000258774","14",91604402,91605319,917
"37911","ENSG00000258776","14",56817570,56893710,76140
"37912","ENSG00000258777","14",61681041,61695823,14782
"37913","ENSG00000258778","14",63734697,63735923,1226
"37914","ENSG00000258779","16",73386771,73504954,118183
"37915","ENSG00000258780","15",20153776,20160826,7050
"37916","ENSG00000258783","14",35511825,35513089,1264
"37917","ENSG00000258784","14",55748208,55773203,24995
"37918","ENSG00000258785","15",93894431,93984150,89719
"37919","ENSG00000258787","15",93430659,93431217,558
"37920","ENSG00000258788","14",96223108,96223347,239
"37921","ENSG00000258789","14",88551597,88552493,896
"37922","ENSG00000258790","14",35122549,35317474,194925
"37923","ENSG00000258791","14",55781132,55796731,15599
"37924","ENSG00000258792","14",89628921,89642671,13750
"37925","ENSG00000258793","14",96259411,96268624,9213
"37926","ENSG00000258794","12",34208415,34209675,1260
"37927","ENSG00000258796","14",66760532,66761018,486
"37928","ENSG00000258798","14",91418266,91421176,2910
"37929","ENSG00000258802","14",52798904,52799061,157
"37930","ENSG00000258803","14",56514331,56551309,36978
"37931","ENSG00000258804","14",86905778,86922755,16977
"37932","ENSG00000258806","14",20229402,20230346,944
"37933","ENSG00000258807","14",87710419,87872291,161872
"37934","ENSG00000258808","14",51392128,51397135,5007
"37935","ENSG00000258810","14",20783888,20784293,405
"37936","ENSG00000258811","14",104842663,104845916,3253
"37937","ENSG00000258812","14",22190158,22190713,555
"37938","ENSG00000258813","14",73057925,73059415,1490
"37939","ENSG00000258814","14",85385927,85388765,2838
"37940","ENSG00000258815","12",85318060,85342912,24852
"37941","ENSG00000258818","14",20684560,20701216,16656
"37942","ENSG00000258819","14",77069169,77076392,7223
"37943","ENSG00000258820","14",75259411,75271950,12539
"37944","ENSG00000258823","14",22723476,22726572,3096
"37945","ENSG00000258824","14",64422935,64448557,25622
"37946","ENSG00000258826","14",88018181,88036319,18138
"37947","ENSG00000258827","14",37097062,37098563,1501
"37948","ENSG00000258828","14",43540883,43541826,943
"37949","ENSG00000258829","14",79072132,79074767,2635
"37950","ENSG00000258830","12",57249609,57296484,46875
"37951","ENSG00000258831","15",93882082,93886743,4661
"37952","ENSG00000258835","14",22155079,22155638,559
"37953","ENSG00000258836","14",58100985,58101574,589
"37954","ENSG00000258837","14",68125004,68130196,5192
"37955","ENSG00000258839","16",89912119,89920977,8858
"37956","ENSG00000258841","14",81661428,81662874,1446
"37957","ENSG00000258842","14",62069518,62081154,11636
"37958","ENSG00000258843","14",50821880,50823501,1621
"37959","ENSG00000258844","14",36213200,36235608,22408
"37960","ENSG00000258845","14",45567995,45569069,1074
"37961","ENSG00000258846","12",96900697,96902698,2001
"37962","ENSG00000258847","14",65957297,66004523,47226
"37963","ENSG00000258849","14",51771789,51772086,297
"37964","ENSG00000258851","14",103553421,103561877,8456
"37965","ENSG00000258854","14",51982520,51987219,4699
"37966","ENSG00000258855","15",20960675,20961581,906
"37967","ENSG00000258856","14",57629841,57631162,1321
"37968","ENSG00000258857","14",50397013,50398345,1332
"37969","ENSG00000258858","14",104690091,104691284,1193
"37970","ENSG00000258859","14",87353070,87573022,219952
"37971","ENSG00000258860","14",35362232,35363628,1396
"37972","ENSG00000258861","14",101045157,101051795,6638
"37973","ENSG00000258864","5",112827213,112867582,40369
"37974","ENSG00000258866","14",95047353,95050957,3604
"37975","ENSG00000258867","14",88024519,88098025,73506
"37976","ENSG00000258868","14",49057713,49077505,19792
"37977","ENSG00000258869","14",97749264,97763989,14725
"37978","ENSG00000258870","14",21419620,21419960,340
"37979","ENSG00000258871","14",72552580,72595125,42545
"37980","ENSG00000258872","14",54884849,54886213,1364
"37981","ENSG00000258873","19",57154021,57167443,13422
"37982","ENSG00000258874","14",78703615,78709934,6319
"37983","ENSG00000258875","14",91242759,91252211,9452
"37984","ENSG00000258876","14",75970924,75971587,663
"37985","ENSG00000258878","14",65234515,65235101,586
"37986","ENSG00000258881","2",70939318,70995336,56018
"37987","ENSG00000258883","15",21250180,21260147,9967
"37988","ENSG00000258884","14",90820064,90828199,8135
"37989","ENSG00000258886","14",30964347,30964622,275
"37990","ENSG00000258888","15",93257198,93260475,3277
"37991","ENSG00000258890","17",64506865,64542461,35596
"37992","ENSG00000258891","14",73896164,73938114,41950
"37993","ENSG00000258893","14",51436038,51436963,925
"37994","ENSG00000258895","15",94033658,94034177,519
"37995","ENSG00000258896","14",60158976,60159324,348
"37996","ENSG00000258900","14",58521223,58521988,765
"37997","ENSG00000258902","14",85362457,85516934,154477
"37998","ENSG00000258903","14",62103122,62117175,14053
"37999","ENSG00000258904","14",100263781,100265405,1624
"38000","ENSG00000258905","14",22185562,22186057,495
"38001","ENSG00000258907","12",55654558,55655168,610
"38002","ENSG00000258909","15",93416850,93422576,5726
"38003","ENSG00000258910","2",118766965,118835110,68145
"38004","ENSG00000258912","14",86006893,86062981,56088
"38005","ENSG00000258913","14",104223584,104288069,64485
"38006","ENSG00000258915","14",80981988,80983638,1650
"38007","ENSG00000258917","14",77696591,77697377,786
"38008","ENSG00000258918","14",20897985,20936255,38270
"38009","ENSG00000258919","14",101628984,101632530,3546
"38010","ENSG00000258920","14",89417354,89419793,2439
"38011","ENSG00000258921","12",55638912,55659795,20883
"38012","ENSG00000258922","15",92805770,92808567,2797
"38013","ENSG00000258923","14",84173791,84175510,1719
"38014","ENSG00000258924","17",28357647,28381697,24050
"38015","ENSG00000258925","15",92285841,92286678,837
"38016","ENSG00000258926","14",61535385,61545484,10099
"38017","ENSG00000258927","14",95620914,95643285,22371
"38018","ENSG00000258928","14",51916145,51918571,2426
"38019","ENSG00000258930","14",71031686,71031970,284
"38020","ENSG00000258931","15",26050538,26052276,1738
"38021","ENSG00000258932","14",27258717,27845286,586569
"38022","ENSG00000258933","14",94960277,94962976,2699
"38023","ENSG00000258935","14",90567495,90569976,2481
"38024","ENSG00000258938","14",35819224,35826765,7541
"38025","ENSG00000258940","14",39265703,39267061,1358
"38026","ENSG00000258942","14",51344914,51385603,40689
"38027","ENSG00000258943","14",63298126,63299547,1421
"38028","ENSG00000258944","14",73272182,73274081,1899
"38029","ENSG00000258945","14",85528599,85529386,787
"38030","ENSG00000258947","16",89921392,89938761,17369
"38031","ENSG00000258948","14",38727275,38728481,1206
"38032","ENSG00000258949","14",44898908,44911863,12955
"38033","ENSG00000258951","14",70594552,70595770,1218
"38034","ENSG00000258952","14",60639216,60642589,3373
"38035","ENSG00000258954","15",91532891,91535095,2204
"38036","ENSG00000258955","14",51304108,51331918,27810
"38037","ENSG00000258956","14",61831861,61832369,508
"38038","ENSG00000258957","14",69183017,69214092,31075
"38039","ENSG00000258958","14",87323753,87332390,8637
"38040","ENSG00000258959","14",102036315,102066228,29913
"38041","ENSG00000258960","14",65900932,65901451,519
"38042","ENSG00000258962","14",91709111,91710617,1506
"38043","ENSG00000258963","14",20734578,20735011,433
"38044","ENSG00000258964","14",61734138,61776260,42122
"38045","ENSG00000258966","14",71044375,71044640,265
"38046","ENSG00000258968","14",31018446,31018796,350
"38047","ENSG00000258970","15",27418796,27420735,1939
"38048","ENSG00000258971","15",93301416,93301647,231
"38049","ENSG00000258973","14",24332310,24337382,5072
"38050","ENSG00000258975","14",88136733,88159845,23112
"38051","ENSG00000258976","14",74614693,74616647,1954
"38052","ENSG00000258977","14",81605338,81623086,17748
"38053","ENSG00000258978","14",75116426,75116600,174
"38054","ENSG00000258979","14",96738021,96793084,55063
"38055","ENSG00000258980","14",65528830,65529574,744
"38056","ENSG00000258981","14",52117602,52117995,393
"38057","ENSG00000258982","14",100207407,100238555,31148
"38058","ENSG00000258983","14",88499334,88515502,16168
"38059","ENSG00000258984","2",237967014,238099412,132398
"38060","ENSG00000258986","14",104474678,104605647,130969
"38061","ENSG00000258987","14",93939497,93944194,4697
"38062","ENSG00000258988","14",67199062,67200327,1265
"38063","ENSG00000258989","14",61529128,61657964,128836
"38064","ENSG00000258990","14",89110148,89111223,1075
"38065","ENSG00000258992","Y",9466955,9469748,2793
"38066","ENSG00000258993","14",53023055,53023597,542
"38067","ENSG00000258994","14",86332376,86401285,68909
"38068","ENSG00000258997","15",21927657,21946641,18984
"38069","ENSG00000258998","14",44763153,44782829,19676
"38070","ENSG00000259000","14",44860316,44866247,5931
"38071","ENSG00000259001","14",20343048,20343685,637
"38072","ENSG00000259002","14",34541740,34546329,4589
"38073","ENSG00000259003","14",22556640,22559037,2397
"38074","ENSG00000259004","14",101120856,101123542,2686
"38075","ENSG00000259005","14",74474007,74474864,857
"38076","ENSG00000259006","16",89919827,89922662,2835
"38077","ENSG00000259009","19",47860113,47861512,1399
"38078","ENSG00000259010","14",64600243,64601644,1401
"38079","ENSG00000259011","15",25865295,25877211,11916
"38080","ENSG00000259013","14",101969364,101969601,237
"38081","ENSG00000259015","14",72960595,72961993,1398
"38082","ENSG00000259017","14",35447003,35447625,622
"38083","ENSG00000259019","14",44077534,44077884,350
"38084","ENSG00000259020","14",92026566,92026887,321
"38085","ENSG00000259021","10",79499666,79499984,318
"38086","ENSG00000259022","14",35430260,35430631,371
"38087","ENSG00000259023","14",101405984,101408258,2274
"38088","ENSG00000259024","17",15436021,15563561,127540
"38089","ENSG00000259025","15",21053004,21054702,1698
"38090","ENSG00000259026","14",97110416,97119247,8831
"38091","ENSG00000259028","14",87568181,87569399,1218
"38092","ENSG00000259030","1",74198235,74544393,346158
"38093","ENSG00000259031","14",100538939,100540409,1470
"38094","ENSG00000259032","14",82692704,82693055,351
"38095","ENSG00000259033","14",70255629,70343388,87759
"38096","ENSG00000259035","14",81741002,82030349,289347
"38097","ENSG00000259036","14",96233431,96234101,670
"38098","ENSG00000259038","14",68627166,68628445,1279
"38099","ENSG00000259039","14",57578409,57600404,21995
"38100","ENSG00000259040","6",7881522,8064364,182842
"38101","ENSG00000259042","14",22415362,22418657,3295
"38102","ENSG00000259043","14",23749236,23751150,1914
"38103","ENSG00000259044","14",85202849,85239474,36625
"38104","ENSG00000259045","14",32484098,32484800,702
"38105","ENSG00000259046","14",44888556,44889041,485
"38106","ENSG00000259047","14",42989201,42989483,282
"38107","ENSG00000259048","14",38034287,38194281,159994
"38108","ENSG00000259050","14",89736965,89738391,1426
"38109","ENSG00000259051","14",43300263,43300595,332
"38110","ENSG00000259052","14",100279959,100291456,11497
"38111","ENSG00000259054","14",22556311,22557062,751
"38112","ENSG00000259055","14",51088957,51091288,2331
"38113","ENSG00000259056","2",84750769,84751231,462
"38114","ENSG00000259058","14",76921840,76924649,2809
"38115","ENSG00000259059","14",96423700,96424209,509
"38116","ENSG00000259060","14",20582892,20609795,26903
"38117","ENSG00000259061","14",86936640,86989125,52485
"38118","ENSG00000259062","14",68979682,68987463,7781
"38119","ENSG00000259064","15",92627073,92627414,341
"38120","ENSG00000259065","14",73787355,73803300,15945
"38121","ENSG00000259066","14",93184973,93218586,33613
"38122","ENSG00000259067","14",104904342,104905204,862
"38123","ENSG00000259069","14",19677644,19679016,1372
"38124","ENSG00000259070","14",38738155,38948273,210118
"38125","ENSG00000259072","14",38256202,38371338,115136
"38126","ENSG00000259073","14",89576216,89577477,1261
"38127","ENSG00000259075","12",89519408,89526262,6854
"38128","ENSG00000259076","14",64552694,64596536,43842
"38129","ENSG00000259077","14",87810982,87838339,27357
"38130","ENSG00000259078","14",65279267,65281166,1899
"38131","ENSG00000259079","14",71330342,71330738,396
"38132","ENSG00000259080","2",27583046,27635174,52128
"38133","ENSG00000259081","14",76774284,76781518,7234
"38134","ENSG00000259082","14",101442076,101444315,2239
"38135","ENSG00000259083","14",39174885,39175880,995
"38136","ENSG00000259084","14",95663256,95692630,29374
"38137","ENSG00000259086","14",32271857,32272301,444
"38138","ENSG00000259087","14",37556158,37567095,10937
"38139","ENSG00000259088","14",101796555,101810321,13766
"38140","ENSG00000259090","14",35157904,35159099,1195
"38141","ENSG00000259091","14",37896060,37902372,6312
"38142","ENSG00000259092","14",22168429,22168988,559
"38143","ENSG00000259093","14",63122888,63178190,55302
"38144","ENSG00000259094","2",118949306,118952983,3677
"38145","ENSG00000259096","14",87952527,87955203,2676
"38146","ENSG00000259097","14",98068161,98205143,136982
"38147","ENSG00000259098","15",22258138,22258848,710
"38148","ENSG00000259099","12",56380361,56382711,2350
"38149","ENSG00000259100","14",39385404,39387102,1698
"38150","ENSG00000259102","14",21162513,21163743,1230
"38151","ENSG00000259103","14",75814502,75847698,33196
"38152","ENSG00000259104","14",36136108,36176468,40360
"38153","ENSG00000259105","14",35468272,35469330,1058
"38154","ENSG00000259106","14",79611418,79633311,21893
"38155","ENSG00000259107","14",85393828,85420550,26722
"38156","ENSG00000259108","19",47863409,47865459,2050
"38157","ENSG00000259109","14",73189763,73190004,241
"38158","ENSG00000259110","14",97154857,97158736,3879
"38159","ENSG00000259111","14",51750560,51763114,12554
"38160","ENSG00000259113","14",50448807,50456742,7935
"38161","ENSG00000259115","14",70593314,70641204,47890
"38162","ENSG00000259116","14",64513952,64540368,26416
"38163","ENSG00000259118","14",65082034,65094212,12178
"38164","ENSG00000259119","14",98925137,98927805,2668
"38165","ENSG00000259120","17",75646243,75647975,1732
"38166","ENSG00000259121","14",39090901,39091101,200
"38167","ENSG00000259122","15",26964917,26970385,5468
"38168","ENSG00000259123","15",93837611,93852981,15370
"38169","ENSG00000259124","14",76495363,76726712,231349
"38170","ENSG00000259125","12",57144620,57147619,2999
"38171","ENSG00000259126","14",44392531,44393716,1185
"38172","ENSG00000259129","14",47764954,47795302,30348
"38173","ENSG00000259130","14",20870278,20873848,3570
"38174","ENSG00000259133","14",56648965,56730535,81570
"38175","ENSG00000259134","15",95326528,95507865,181337
"38176","ENSG00000259137","14",44120210,44120761,551
"38177","ENSG00000259138","14",75127153,75136930,9777
"38178","ENSG00000259142","14",62134149,62139973,5824
"38179","ENSG00000259144","14",20720742,20723127,2385
"38180","ENSG00000259146","14",71292729,71321882,29153
"38181","ENSG00000259149","14",42259731,42268586,8855
"38182","ENSG00000259150","15",26115726,26134001,18275
"38183","ENSG00000259151","14",89290205,89291594,1389
"38184","ENSG00000259152","15",27422381,27428338,5957
"38185","ENSG00000259153","14",70809841,70815994,6153
"38186","ENSG00000259155","14",49677369,49677893,524
"38187","ENSG00000259156","15",20282744,20291586,8842
"38188","ENSG00000259158","14",70453541,70483775,30234
"38189","ENSG00000259160","14",64535702,64535879,177
"38190","ENSG00000259161","14",101843394,101844122,728
"38191","ENSG00000259162","14",20437982,20441268,3286
"38192","ENSG00000259163","14",90642638,90648894,6256
"38193","ENSG00000259165","14",69083398,69085389,1991
"38194","ENSG00000259166","14",101447642,101457117,9475
"38195","ENSG00000259167","14",81032529,81033404,875
"38196","ENSG00000259169","14",60398934,60400013,1079
"38197","ENSG00000259170","15",92470233,92471546,1313
"38198","ENSG00000259171","14",20684587,20700576,15989
"38199","ENSG00000259172","15",101295419,101305737,10318
"38200","ENSG00000259175","15",80554609,80562944,8335
"38201","ENSG00000259177","15",90393490,90397881,4391
"38202","ENSG00000259178","15",52082302,52086574,4272
"38203","ENSG00000259179","15",31420128,31420662,534
"38204","ENSG00000259180","15",55680385,55681463,1078
"38205","ENSG00000259181","15",34993646,35003221,9575
"38206","ENSG00000259182","15",101168530,101170821,2291
"38207","ENSG00000259183","15",88143935,88144165,230
"38208","ENSG00000259186","15",73483196,73483943,747
"38209","ENSG00000259188","15",49877299,49883525,6226
"38210","ENSG00000259191","15",69434466,69435120,654
"38211","ENSG00000259192","15",38458760,38459540,780
"38212","ENSG00000259194","15",51367377,51369110,1733
"38213","ENSG00000259195","15",85770990,85771163,173
"38214","ENSG00000259196","8",28949676,28955955,6279
"38215","ENSG00000259198","15",40312615,40316634,4019
"38216","ENSG00000259200","15",45705078,45931069,225991
"38217","ENSG00000259201","15",51887560,51901123,13563
"38218","ENSG00000259202","15",67142734,67146939,4205
"38219","ENSG00000259203","15",52800168,52805972,5804
"38220","ENSG00000259204","15",51064609,51069586,4977
"38221","ENSG00000259205","15",100553529,100558954,5425
"38222","ENSG00000259207","17",47253846,47311816,57970
"38223","ENSG00000259209","16",72805998,72809872,3874
"38224","ENSG00000259211","15",40464193,40466726,2533
"38225","ENSG00000259212","15",90595840,90596447,607
"38226","ENSG00000259213","15",77787193,77788674,1481
"38227","ENSG00000259214","15",20826454,20826640,186
"38228","ENSG00000259215","15",69458522,69461806,3284
"38229","ENSG00000259216","15",48725338,48725827,489
"38230","ENSG00000259218","15",89504909,89524049,19140
"38231","ENSG00000259219","15",99976481,99980774,4293
"38232","ENSG00000259221","15",47359430,47396732,37302
"38233","ENSG00000259222","15",69080879,69099987,19108
"38234","ENSG00000259223","15",60073554,60118320,44766
"38235","ENSG00000259224","17",7481332,7483496,2164
"38236","ENSG00000259225","15",37980676,38062340,81664
"38237","ENSG00000259227","15",70602124,70602516,392
"38238","ENSG00000259228","15",99284625,99285576,951
"38239","ENSG00000259230","14",102545254,102555826,10572
"38240","ENSG00000259232","15",65475318,65475614,296
"38241","ENSG00000259234","15",79141939,79283949,142010
"38242","ENSG00000259235","15",48187121,48191691,4570
"38243","ENSG00000259236","15",101771758,101781989,10231
"38244","ENSG00000259237","15",53116365,53129698,13333
"38245","ENSG00000259238","15",59688517,59689418,901
"38246","ENSG00000259239","15",40133768,40135214,1446
"38247","ENSG00000259240","15",51037488,51293912,256424
"38248","ENSG00000259241","15",51693216,51695765,2549
"38249","ENSG00000259242","19",19606350,19608660,2310
"38250","ENSG00000259244","15",84513241,84526949,13708
"38251","ENSG00000259245","15",35919892,36049537,129645
"38252","ENSG00000259246","15",67000814,67001085,271
"38253","ENSG00000259247","Y",22330452,22332500,2048
"38254","ENSG00000259248","15",63544247,63601589,57342
"38255","ENSG00000259250","15",58587507,58591676,4169
"38256","ENSG00000259251","15",62060503,62062434,1931
"38257","ENSG00000259254","15",40642933,40646857,3924
"38258","ENSG00000259255","15",46693288,46804844,111556
"38259","ENSG00000259256","18",3347696,3383532,35836
"38260","ENSG00000259257","15",99337857,99338481,624
"38261","ENSG00000259258","15",65105534,65105800,266
"38262","ENSG00000259259","15",72899399,72900260,861
"38263","ENSG00000259261","15",22184967,22185402,435
"38264","ENSG00000259262","15",90385814,90386063,249
"38265","ENSG00000259265","15",69037549,69043565,6016
"38266","ENSG00000259267","10",70939036,70955947,16911
"38267","ENSG00000259268","15",63456294,63469356,13062
"38268","ENSG00000259269","15",39472703,39497074,24371
"38269","ENSG00000259271","22",16671090,16679493,8403
"38270","ENSG00000259273","15",89936492,89937005,513
"38271","ENSG00000259274","15",60529973,60545159,15186
"38272","ENSG00000259275","15",96354237,96405235,50998
"38273","ENSG00000259276","15",85621264,85627689,6425
"38274","ENSG00000259277","15",28970196,28977464,7268
"38275","ENSG00000259278","15",39019193,39026521,7328
"38276","ENSG00000259280","15",36876379,36887035,10656
"38277","ENSG00000259281","15",77660052,77668074,8022
"38278","ENSG00000259282","15",96772005,96783312,11307
"38279","ENSG00000259283","16",55259969,55333588,73619
"38280","ENSG00000259284","15",61729765,61731389,1624
"38281","ENSG00000259285","15",58065225,58071043,5818
"38282","ENSG00000259286","15",68833830,68834749,919
"38283","ENSG00000259287","15",33858602,33864825,6223
"38284","ENSG00000259288","15",40218500,40264890,46390
"38285","ENSG00000259289","15",66931537,66956518,24981
"38286","ENSG00000259290","11",125188115,125191404,3289
"38287","ENSG00000259291","15",90074512,90082207,7695
"38288","ENSG00000259293","15",58434890,58498735,63845
"38289","ENSG00000259294","7",101822247,101824729,2482
"38290","ENSG00000259295","15",85191438,85213905,22467
"38291","ENSG00000259296","15",51707995,51715220,7225
"38292","ENSG00000259298","15",50497195,50498744,1549
"38293","ENSG00000259299","15",29233673,29235137,1464
"38294","ENSG00000259300","15",29612570,29614274,1704
"38295","ENSG00000259303","16",32847713,32848156,443
"38296","ENSG00000259305","8",123226189,123274284,48095
"38297","ENSG00000259306","15",51315841,51321996,6155
"38298","ENSG00000259307","15",40300670,40301820,1150
"38299","ENSG00000259308","15",83044368,83044771,403
"38300","ENSG00000259309","15",69820756,69835111,14355
"38301","ENSG00000259312","15",96438570,96444266,5696
"38302","ENSG00000259314","15",90604225,90614558,10333
"38303","ENSG00000259315","15",82725873,82738904,13031
"38304","ENSG00000259316","15",64181180,64381440,200260
"38305","ENSG00000259317","15",85272527,85272974,447
"38306","ENSG00000259318","14",55394940,55395233,293
"38307","ENSG00000259319","14",75423683,75427741,4058
"38308","ENSG00000259320","15",98111729,98131707,19978
"38309","ENSG00000259321","14",24139445,24140444,999
"38310","ENSG00000259322","15",78293286,78296049,2763
"38311","ENSG00000259324","15",21595684,21596526,842
"38312","ENSG00000259326","15",38502853,38504981,2128
"38313","ENSG00000259330","15",40323664,40326715,3051
"38314","ENSG00000259331","15",94600014,94600821,807
"38315","ENSG00000259332","15",79845150,79923754,78604
"38316","ENSG00000259334","14",23922247,23934568,12321
"38317","ENSG00000259335","15",44447577,44449344,1767
"38318","ENSG00000259336","15",35099022,35169698,70676
"38319","ENSG00000259337","15",19972782,19973218,436
"38320","ENSG00000259338","15",45215547,45215943,396
"38321","ENSG00000259339","19",46136746,46137547,801
"38322","ENSG00000259341","15",99423769,99435160,11391
"38323","ENSG00000259342","15",45430652,45441808,11156
"38324","ENSG00000259343","15",81324338,81518200,193862
"38325","ENSG00000259345","15",38865322,39427195,561873
"38326","ENSG00000259347","15",66984103,67065268,81165
"38327","ENSG00000259349","17",60526293,60550798,24505
"38328","ENSG00000259351","15",63928274,63935953,7679
"38329","ENSG00000259353","15",58856831,58865063,8232
"38330","ENSG00000259354","15",45448427,45513767,65340
"38331","ENSG00000259356","15",100126106,100129743,3637
"38332","ENSG00000259358","15",31765743,31768201,2458
"38333","ENSG00000259359","15",96171575,96174339,2764
"38334","ENSG00000259361","15",80263068,80341805,78737
"38335","ENSG00000259362","15",77525540,77534110,8570
"38336","ENSG00000259363","15",99805793,99916818,111025
"38337","ENSG00000259364","15",40453444,40454639,1195
"38338","ENSG00000259365","15",101116603,101117546,943
"38339","ENSG00000259366","8",29055935,29056685,750
"38340","ENSG00000259367","15",85619623,85670948,51325
"38341","ENSG00000259369","15",55746639,55746767,128
"38342","ENSG00000259370","15",62827675,62884034,56359
"38343","ENSG00000259371","14",24120956,24131829,10873
"38344","ENSG00000259374","14",103139675,103141959,2284
"38345","ENSG00000259376","15",101043716,101049456,5740
"38346","ENSG00000259377","15",51752485,51756475,3990
"38347","ENSG00000259378","15",50944663,50945996,1333
"38348","ENSG00000259379","15",58152606,58154407,1801
"38349","ENSG00000259380","15",38139595,38226897,87302
"38350","ENSG00000259381","15",100645434,100646655,1221
"38351","ENSG00000259384","17",63917200,63918839,1639
"38352","ENSG00000259385","15",48192191,48201684,9493
"38353","ENSG00000259388","15",49794246,49796097,1851
"38354","ENSG00000259390","15",39512335,39519954,7619
"38355","ENSG00000259392","15",32836983,32837326,343
"38356","ENSG00000259393","15",58967046,58967808,762
"38357","ENSG00000259394","15",62953173,62954124,951
"38358","ENSG00000259395","15",36341739,36344166,2427
"38359","ENSG00000259396","15",41343080,41344225,1145
"38360","ENSG00000259397","15",35092481,35093210,729
"38361","ENSG00000259398","15",52033707,52035625,1918
"38362","ENSG00000259399","20",36574553,36612384,37831
"38363","ENSG00000259402","15",58815272,58817728,2456
"38364","ENSG00000259403","15",97272020,97319321,47301
"38365","ENSG00000259404","15",84080168,84126604,46436
"38366","ENSG00000259405","15",40948736,40948869,133
"38367","ENSG00000259407","15",85744109,85750281,6172
"38368","ENSG00000259408","15",33851785,33856809,5024
"38369","ENSG00000259410","15",67832725,67873866,41141
"38370","ENSG00000259411","15",35400691,35401768,1077
"38371","ENSG00000259415","15",84753122,84754502,1380
"38372","ENSG00000259416","15",85754941,85756237,1296
"38373","ENSG00000259417","15",80195481,80252213,56732
"38374","ENSG00000259418","15",45041716,45058707,16991
"38375","ENSG00000259419","15",79236332,79237206,874
"38376","ENSG00000259420","15",77568970,77608888,39918
"38377","ENSG00000259421","22",39070414,39070671,257
"38378","ENSG00000259422","15",76174891,76181486,6595
"38379","ENSG00000259423","15",39167676,39180048,12372
"38380","ENSG00000259424","15",98646951,98647371,420
"38381","ENSG00000259425","15",22770523,22776199,5676
"38382","ENSG00000259426","15",69396904,69415029,18125
"38383","ENSG00000259427","15",45566776,45567074,298
"38384","ENSG00000259428","14",103364239,103364820,581
"38385","ENSG00000259429","15",82355142,82420075,64933
"38386","ENSG00000259430","15",100372936,100437914,64978
"38387","ENSG00000259431","14",23555988,23560271,4283
"38388","ENSG00000259432","15",39813223,39815429,2206
"38389","ENSG00000259433","15",45330209,45332634,2425
"38390","ENSG00000259434","15",37364020,37490864,126844
"38391","ENSG00000259435","15",22125511,22126434,923
"38392","ENSG00000259436","19",42152569,42157523,4954
"38393","ENSG00000259437","15",66919811,66931755,11944
"38394","ENSG00000259438","15",52010999,52019095,8096
"38395","ENSG00000259439","2",44921077,44939199,18122
"38396","ENSG00000259440","15",73161779,73162928,1149
"38397","ENSG00000259441","15",89752296,89753493,1197
"38398","ENSG00000259442","15",82744223,82750289,6066
"38399","ENSG00000259444","14",103094723,103098885,4162
"38400","ENSG00000259446","15",33293568,33310659,17091
"38401","ENSG00000259447","15",39300418,39310782,10364
"38402","ENSG00000259448","15",31215622,31224445,8823
"38403","ENSG00000259449","15",85181210,85182083,873
"38404","ENSG00000259453","15",85701109,85702771,1662
"38405","ENSG00000259456","20",50930984,50945148,14164
"38406","ENSG00000259457","15",69564724,69565790,1066
"38407","ENSG00000259458","15",62637172,62645291,8119
"38408","ENSG00000259459","15",63390136,63438320,48184
"38409","ENSG00000259460","15",37099339,37100173,834
"38410","ENSG00000259461","15",81117635,81118340,705
"38411","ENSG00000259462","15",82647770,82692820,45050
"38412","ENSG00000259463","15",41011597,41013300,1703
"38413","ENSG00000259465","15",50417385,50418692,1307
"38414","ENSG00000259466","15",62082450,62083305,855
"38415","ENSG00000259467","15",49156329,49156847,518
"38416","ENSG00000259468","15",34255286,34257832,2546
"38417","ENSG00000259469","15",48729080,48729844,764
"38418","ENSG00000259470","15",70858714,70860162,1448
"38419","ENSG00000259471","15",66582190,66685794,103604
"38420","ENSG00000259473","15",70503907,70505928,2021
"38421","ENSG00000259474","15",78480057,78481820,1763
"38422","ENSG00000259475","15",98954149,99105824,151675
"38423","ENSG00000259476","15",58521311,58523371,2060
"38424","ENSG00000259478","15",97982509,97991142,8633
"38425","ENSG00000259479","15",44825747,44884694,58947
"38426","ENSG00000259481","15",61181249,61195938,14689
"38427","ENSG00000259482","15",60681564,60687248,5684
"38428","ENSG00000259483","14",56303490,56310761,7271
"38429","ENSG00000259485","15",97215812,97432094,216282
"38430","ENSG00000259488","15",48312353,48331856,19503
"38431","ENSG00000259490","15",19987656,19988117,461
"38432","ENSG00000259493","15",79559256,79560304,1048
"38433","ENSG00000259494","15",88459477,88467390,7913
"38434","ENSG00000259495","15",80344853,80404214,59361
"38435","ENSG00000259496","15",69803316,69804046,730
"38436","ENSG00000259498","15",63046034,63049387,3353
"38437","ENSG00000259499","15",44387320,44390451,3131
"38438","ENSG00000259502","14",67610986,67613864,2878
"38439","ENSG00000259503","15",70321576,70326742,5166
"38440","ENSG00000259504","15",69278675,69295322,16647
"38441","ENSG00000259505","15",33990686,33992048,1362
"38442","ENSG00000259508","14",102770040,102774791,4751
"38443","ENSG00000259511","15",84172490,84182234,9744
"38444","ENSG00000259512","15",67627852,67629135,1283
"38445","ENSG00000259513","15",60558080,60558401,321
"38446","ENSG00000259514","15",76339609,76342063,2454
"38447","ENSG00000259515","14",102933574,102937177,3603
"38448","ENSG00000259516","15",35181799,35238197,56398
"38449","ENSG00000259517","16",54245544,54270879,25335
"38450","ENSG00000259518","15",82088569,82097694,9125
"38451","ENSG00000259519","15",45170344,45199958,29614
"38452","ENSG00000259520","15",45235930,45279251,43321
"38453","ENSG00000259521","15",41016807,41027893,11086
"38454","ENSG00000259522","14",24180395,24190416,10021
"38455","ENSG00000259523","15",29822631,29824081,1450
"38456","ENSG00000259525","14",103184204,103185039,835
"38457","ENSG00000259527","15",87576929,87579866,2937
"38458","ENSG00000259528","15",73255334,73256109,775
"38459","ENSG00000259529","14",24147548,24166452,18904
"38460","ENSG00000259530","15",61598514,61605241,6727
"38461","ENSG00000259531","15",49365124,49366685,1561
"38462","ENSG00000259532","15",70748932,70754177,5245
"38463","ENSG00000259533","17",63885810,63886411,601
"38464","ENSG00000259534","15",96448842,96449749,907
"38465","ENSG00000259536","15",40488041,40558019,69978
"38466","ENSG00000259538","15",84412773,84421837,9064
"38467","ENSG00000259539","15",45152664,45167526,14862
"38468","ENSG00000259540","15",100558677,100559798,1121
"38469","ENSG00000259541","11",120249759,120265932,16173
"38470","ENSG00000259542","15",96393146,96405189,12043
"38471","ENSG00000259543","15",81427448,81755217,327769
"38472","ENSG00000259544","15",85726115,85727227,1112
"38473","ENSG00000259545","15",49177610,49178741,1131
"38474","ENSG00000259546","15",80896190,80948867,52677
"38475","ENSG00000259547","15",41108878,41109178,300
"38476","ENSG00000259548","15",79832466,79833554,1088
"38477","ENSG00000259553","15",101959539,101961408,1869
"38478","ENSG00000259554","15",47274183,47275164,981
"38479","ENSG00000259555","15",78625895,78628193,2298
"38480","ENSG00000259556","15",51919073,51930627,11554
"38481","ENSG00000259557","15",62362029,62362331,302
"38482","ENSG00000259560","15",87325829,87703852,378023
"38483","ENSG00000259561","15",89704665,89705415,750
"38484","ENSG00000259562","15",78290527,78291221,694
"38485","ENSG00000259563","15",44516650,44517483,833
"38486","ENSG00000259564","15",61834682,61935738,101056
"38487","ENSG00000259565","15",76979245,76980451,1206
"38488","ENSG00000259570","15",84394512,84395514,1002
"38489","ENSG00000259571","11",122115354,122116215,861
"38490","ENSG00000259572","15",47774219,47846266,72047
"38491","ENSG00000259575","15",61211913,61214231,2318
"38492","ENSG00000259577","15",52179999,52206915,26916
"38493","ENSG00000259579","15",100716249,100828497,112248
"38494","ENSG00000259581","15",76258986,76261690,2704
"38495","ENSG00000259582","15",97540597,97560702,20105
"38496","ENSG00000259583","15",100892343,100919391,27048
"38497","ENSG00000259584","15",40075204,40078704,3500
"38498","ENSG00000259585","15",35298249,35299440,1191
"38499","ENSG00000259587","15",35007844,35011191,3347
"38500","ENSG00000259588","15",47603880,47606352,2472
"38501","ENSG00000259589","15",63675146,63713758,38612
"38502","ENSG00000259590","15",99395179,99396593,1414
"38503","ENSG00000259591","15",60763593,60765625,2032
"38504","ENSG00000259592","15",35121573,35122084,511
"38505","ENSG00000259594","15",81554003,81696780,142777
"38506","ENSG00000259595","15",44402685,44427144,24459
"38507","ENSG00000259598","15",38524070,38534655,10585
"38508","ENSG00000259600","15",58151033,58152513,1480
"38509","ENSG00000259602","15",48938236,48948031,9795
"38510","ENSG00000259604","15",100861843,100874369,12526
"38511","ENSG00000259605","19",45764785,45769806,5021
"38512","ENSG00000259609","15",84053113,84080097,26984
"38513","ENSG00000259611","15",98081993,98103761,21768
"38514","ENSG00000259612","15",52937139,52938518,1379
"38515","ENSG00000259614","15",96388214,96389056,842
"38516","ENSG00000259615","15",89579765,89582297,2532
"38517","ENSG00000259616","15",61298791,61635449,336658
"38518","ENSG00000259617","15",40999274,41004865,5591
"38519","ENSG00000259618","15",50494018,50497080,3062
"38520","ENSG00000259619","15",54048588,54050876,2288
"38521","ENSG00000259620","15",86938797,86988426,49629
"38522","ENSG00000259621","15",98880659,98893535,12876
"38523","ENSG00000259622","15",82010212,82010607,395
"38524","ENSG00000259623","17",41848518,41851447,2929
"38525","ENSG00000259624","15",70768011,70778868,10857
"38526","ENSG00000259626","15",58150635,58150962,327
"38527","ENSG00000259628","7",77043721,77198626,154905
"38528","ENSG00000259630","15",85415228,85415633,405
"38529","ENSG00000259631","8",122977026,122985629,8603
"38530","ENSG00000259632","15",51859185,51861293,2108
"38531","ENSG00000259635","15",64701248,64719602,18354
"38532","ENSG00000259636","15",86932880,86946331,13451
"38533","ENSG00000259637","15",82531653,82534139,2486
"38534","ENSG00000259639","15",35939167,36252257,313090
"38535","ENSG00000259642","15",79922771,79926993,4222
"38536","ENSG00000259644","15",29728186,29729531,1345
"38537","ENSG00000259645","15",69391192,69392149,957
"38538","ENSG00000259646","15",101903154,101903204,50
"38539","ENSG00000259647","15",30005443,30045848,40405
"38540","ENSG00000259648","14",67614929,67616626,1697
"38541","ENSG00000259649","15",80896191,80909777,13586
"38542","ENSG00000259650","15",73335260,73342387,7127
"38543","ENSG00000259651","15",58150275,58150563,288
"38544","ENSG00000259654","15",84685884,84686946,1062
"38545","ENSG00000259656","15",49101791,49103264,1473
"38546","ENSG00000259657","15",59676757,59677321,564
"38547","ENSG00000259658","15",101732201,101746870,14669
"38548","ENSG00000259659","15",44557829,44559188,1359
"38549","ENSG00000259660","15",101751032,101794302,43270
"38550","ENSG00000259663","5",51372736,51383332,10596
"38551","ENSG00000259664","15",97339693,97523442,183749
"38552","ENSG00000259665","15",35081144,35081513,369
"38553","ENSG00000259666","15",77641764,77652292,10528
"38554","ENSG00000259668","15",51455268,51460582,5314
"38555","ENSG00000259669","15",53946709,53984010,37301
"38556","ENSG00000259670","15",48783190,48784121,931
"38557","ENSG00000259671","15",58154960,58156061,1101
"38558","ENSG00000259672","15",63091085,63110589,19504
"38559","ENSG00000259673","15",67290636,67521844,231208
"38560","ENSG00000259674","15",59406963,59408154,1191
"38561","ENSG00000259675","15",61638928,61715171,76243
"38562","ENSG00000259676","15",88797413,88798734,1321
"38563","ENSG00000259677","15",89876540,89877285,745
"38564","ENSG00000259678","15",51414097,51498833,84736
"38565","ENSG00000259680","16",33844784,33845229,445
"38566","ENSG00000259681","15",45558598,45562877,4279
"38567","ENSG00000259682","15",64470253,64471364,1111
"38568","ENSG00000259683","15",84389729,84395903,6174
"38569","ENSG00000259685","15",90102649,90138016,35367
"38570","ENSG00000259686","15",33012119,33013068,949
"38571","ENSG00000259687","14",75294404,75298109,3705
"38572","ENSG00000259688","15",35396221,35396444,223
"38573","ENSG00000259690","15",29373602,29376956,3354
"38574","ENSG00000259691","15",73143236,73143518,282
"38575","ENSG00000259692","15",81633426,82013579,380153
"38576","ENSG00000259694","15",84171178,84173194,2016
"38577","ENSG00000259696","15",31453201,31454139,938
"38578","ENSG00000259697","15",62196066,62222911,26845
"38579","ENSG00000259699","15",89135547,89136495,948
"38580","ENSG00000259700","15",48810701,48811909,1208
"38581","ENSG00000259701","15",51278927,51280015,1088
"38582","ENSG00000259702","15",96045341,96064357,19016
"38583","ENSG00000259704","15",90839641,90853608,13967
"38584","ENSG00000259705","15",48645951,48652016,6065
"38585","ENSG00000259706","15",99257632,99260015,2383
"38586","ENSG00000259707","15",82691723,82692358,635
"38587","ENSG00000259708","15",78250502,78264156,13654
"38588","ENSG00000259709","15",52124561,52140246,15685
"38589","ENSG00000259710","15",35282596,35282980,384
"38590","ENSG00000259711","16",54934913,54954665,19752
"38591","ENSG00000259712","15",52056675,52100523,43848
"38592","ENSG00000259713","15",89518523,89591956,73433
"38593","ENSG00000259717","14",103120847,103123007,2160
"38594","ENSG00000259719","14",56310880,56427032,116152
"38595","ENSG00000259720","15",30992171,31042302,50131
"38596","ENSG00000259721","15",32717270,32719007,1737
"38597","ENSG00000259722","15",77204578,77205100,522
"38598","ENSG00000259723","20",53453058,53504314,51256
"38599","ENSG00000259724","15",93905405,94107938,202533
"38600","ENSG00000259725","16",54937786,54938671,885
"38601","ENSG00000259726","15",84186752,84197384,10632
"38602","ENSG00000259727","15",62895812,62899543,3731
"38603","ENSG00000259728","15",84570649,84580175,9526
"38604","ENSG00000259730","15",47944044,47949509,5465
"38605","ENSG00000259731","15",38756552,38759413,2861
"38606","ENSG00000259732","15",59121034,59133250,12216
"38607","ENSG00000259734","15",86630266,86631136,870
"38608","ENSG00000259735","15",59348648,59359889,11241
"38609","ENSG00000259736","15",90620007,90717141,97134
"38610","ENSG00000259737","15",36438972,36471016,32044
"38611","ENSG00000259738","15",58865006,58865303,297
"38612","ENSG00000259740","15",47525169,47527756,2587
"38613","ENSG00000259742","15",44914802,44930622,15820
"38614","ENSG00000259744","15",70848883,70849770,887
"38615","ENSG00000259746","15",90634725,90635033,308
"38616","ENSG00000259749","15",30005205,30006430,1225
"38617","ENSG00000259750","15",59401221,59402004,783
"38618","ENSG00000259751","15",34849137,34850395,1258
"38619","ENSG00000259753","17",47253897,47344292,90395
"38620","ENSG00000259754","15",47812729,48050507,237778
"38621","ENSG00000259755","15",101050732,101086066,35334
"38622","ENSG00000259756","15",62682916,62690448,7532
"38623","ENSG00000259757","5",2736662,2737759,1097
"38624","ENSG00000259760","15",99396613,99401315,4702
"38625","ENSG00000259761","15",87038717,87047303,8586
"38626","ENSG00000259762","15",85750336,85752901,2565
"38627","ENSG00000259763","15",96235785,96237010,1225
"38628","ENSG00000259764","15",101334437,101337428,2991
"38629","ENSG00000259767","15",83022236,83024336,2100
"38630","ENSG00000259768","16",72665123,72822781,157658
"38631","ENSG00000259769","15",20046296,20047994,1698
"38632","ENSG00000259770","15",79944498,79945578,1080
"38633","ENSG00000259771","15",59266720,59271162,4442
"38634","ENSG00000259772","15",31221999,31230838,8839
"38635","ENSG00000259773","15",50746709,50749829,3120
"38636","ENSG00000259774","15",84422618,84425882,3264
"38637","ENSG00000259775","14",103331674,103332367,693
"38638","ENSG00000259776","1",239247808,239250818,3010
"38639","ENSG00000259779","18",74409415,74413209,3794
"38640","ENSG00000259780","16",2235689,2236913,1224
"38641","ENSG00000259781","15",71164770,71165415,645
"38642","ENSG00000259782","16",23446446,23447282,836
"38643","ENSG00000259783","15",72608481,72636962,28481
"38644","ENSG00000259784","16",2513965,2527955,13990
"38645","ENSG00000259786","5",28809331,29217115,407784
"38646","ENSG00000259788","1",162560227,162561308,1081
"38647","ENSG00000259789","14",90489010,90491637,2627
"38648","ENSG00000259790","15",75321397,75322693,1296
"38649","ENSG00000259791","16",35640029,35640582,553
"38650","ENSG00000259792","15",77993405,77995289,1884
"38651","ENSG00000259793","2",233351132,233353416,2284
"38652","ENSG00000259797","16",68316801,68319036,2235
"38653","ENSG00000259798","16",71113352,71114000,648
"38654","ENSG00000259802","5",10352701,10353601,900
"38655","ENSG00000259803","16",89195761,89201651,5890
"38656","ENSG00000259804","16",67561411,67562309,898
"38657","ENSG00000259805","15",82925884,83103443,177559
"38658","ENSG00000259807","16",29215385,29221040,5655
"38659","ENSG00000259810","16",31788202,31790993,2791
"38660","ENSG00000259813","16",88696501,88698610,2109
"38661","ENSG00000259814","15",29609676,29611212,1536
"38662","ENSG00000259815","1",208626741,208628085,1344
"38663","ENSG00000259817","16",73812560,73816054,3494
"38664","ENSG00000259818","1",53220663,53224253,3590
"38665","ENSG00000259820","8",134792020,134798272,6252
"38666","ENSG00000259821","16",47004513,47035385,30872
"38667","ENSG00000259823","1",248739415,248755759,16344
"38668","ENSG00000259826","7",39947522,39949755,2233
"38669","ENSG00000259828","6",141447011,141451006,3995
"38670","ENSG00000259831","13",110809676,110813084,3408
"38671","ENSG00000259832","1",46967679,46967874,195
"38672","ENSG00000259833","16",71080866,71093667,12801
"38673","ENSG00000259834","1",110653560,110657040,3480
"38674","ENSG00000259836","16",35489237,35490212,975
"38675","ENSG00000259838","15",41557027,41557435,408
"38676","ENSG00000259840","16",710746,711277,531
"38677","ENSG00000259841","16",35363412,35390584,27172
"38678","ENSG00000259842","16",33949976,33950420,444
"38679","ENSG00000259843","16",50046429,50066224,19795
"38680","ENSG00000259845","15",30815271,30844153,28882
"38681","ENSG00000259846","16",64364781,64600247,235466
"38682","ENSG00000259847","16",65141751,65176713,34962
"38683","ENSG00000259848","2",94867486,94947341,79855
"38684","ENSG00000259849","X",26558337,26561052,2715
"38685","ENSG00000259852","16",32978461,32978891,430
"38686","ENSG00000259855","2",216995906,216996490,584
"38687","ENSG00000259856","16",46626404,46626992,588
"38688","ENSG00000259862","12",130249679,130266725,17046
"38689","ENSG00000259863","2",109127327,109128930,1603
"38690","ENSG00000259865","1",247187281,247188526,1245
"38691","ENSG00000259866","16",47561307,47562480,1173
"38692","ENSG00000259867","16",80154979,80563354,408375
"38693","ENSG00000259868","14",55896443,55962970,66527
"38694","ENSG00000259869","10",42751178,42754297,3119
"38695","ENSG00000259870","15",97876289,97878386,2097
"38696","ENSG00000259871","16",19315164,19316526,1362
"38697","ENSG00000259873","16",82434828,82435381,553
"38698","ENSG00000259876","16",12556353,12557694,1341
"38699","ENSG00000259877","16",89215211,89217653,2442
"38700","ENSG00000259878","15",62230384,62231895,1511
"38701","ENSG00000259881","16",88881038,88887136,6098
"38702","ENSG00000259882","16",33577502,33622547,45045
"38703","ENSG00000259883","15",41921417,41929286,7869
"38704","ENSG00000259884","12",52058459,52059503,1044
"38705","ENSG00000259887","12",51848223,51852729,4506
"38706","ENSG00000259891","8",140505813,140508043,2230
"38707","ENSG00000259895","16",2464950,2468213,3263
"38708","ENSG00000259897","16",35245916,35247534,1618
"38709","ENSG00000259899","16",12560756,12611044,50288
"38710","ENSG00000259904","15",34373541,34374603,1062
"38711","ENSG00000259905","15",24101827,24823365,721538
"38712","ENSG00000259906","15",30170563,30179943,9380
"38713","ENSG00000259907","14",71181456,71182106,650
"38714","ENSG00000259910","16",1159548,1160176,628
"38715","ENSG00000259912","16",48620319,48622033,1714
"38716","ENSG00000259914","16",83725676,83726377,701
"38717","ENSG00000259915","2",186354570,186356773,2203
"38718","ENSG00000259916","2",94588522,94604573,16051
"38719","ENSG00000259917","15",34489002,34490571,1569
"38720","ENSG00000259918","16",47598654,47598996,342
"38721","ENSG00000259920","7",130481491,130484392,2901
"38722","ENSG00000259921","15",99157231,99161140,3909
"38723","ENSG00000259922","16",57013071,57014100,1029
"38724","ENSG00000259923","16",56648881,56652636,3755
"38725","ENSG00000259924","15",65771176,65772139,963
"38726","ENSG00000259925","16",19343647,19401693,58046
"38727","ENSG00000259926","16",53448748,53449590,842
"38728","ENSG00000259928","17",30564057,30565576,1519
"38729","ENSG00000259929","16",17933189,18151595,218406
"38730","ENSG00000259931","15",75512770,75513040,270
"38731","ENSG00000259932","15",45198517,45199139,622
"38732","ENSG00000259933","16",2091436,2095433,3997
"38733","ENSG00000259934","16",32845964,32846180,216
"38734","ENSG00000259935","15",52648634,52649866,1232
"38735","ENSG00000259937","12",33404872,33405896,1024
"38736","ENSG00000259940","16",27213308,27214993,1685
"38737","ENSG00000259941","15",56394321,56396785,2464
"38738","ENSG00000259943","1",40256427,40257967,1540
"38739","ENSG00000259946","1",97967005,97968814,1809
"38740","ENSG00000259947","16",1889114,1890434,1320
"38741","ENSG00000259950","16",31894542,31894983,441
"38742","ENSG00000259952","16",29806496,29807732,1236
"38743","ENSG00000259953","9",112028570,112039143,10573
"38744","ENSG00000259954","16",27447669,27453393,5724
"38745","ENSG00000259956","3",51391285,51397908,6623
"38746","ENSG00000259959","4",47840122,47844339,4217
"38747","ENSG00000259961","1",13513220,13516270,3050
"38748","ENSG00000259963","16",6721786,6721960,174
"38749","ENSG00000259964","15",71147650,71189064,41414
"38750","ENSG00000259966","16",32600299,32615639,15340
"38751","ENSG00000259967","15",80165923,80166980,1057
"38752","ENSG00000259968","5",73952940,73954014,1074
"38753","ENSG00000259969","14",57993545,57994525,980
"38754","ENSG00000259970","3",49684480,49684983,503
"38755","ENSG00000259972","16",74305127,74335346,30219
"38756","ENSG00000259974","20",22547671,22578642,30971
"38757","ENSG00000259976","3",114314501,114329714,15213
"38758","ENSG00000259977","X",37906147,37949405,43258
"38759","ENSG00000259978","16",49764454,49764688,234
"38760","ENSG00000259979","16",35118238,35118956,718
"38761","ENSG00000259982","16",28700294,28701540,1246
"38762","ENSG00000259984","1",25336429,25337465,1036
"38763","ENSG00000259985","18",31685655,31686823,1168
"38764","ENSG00000259986","15",83179182,83439445,260263
"38765","ENSG00000259987","16",34141256,34142006,750
"38766","ENSG00000259989","16",88984032,88995369,11337
"38767","ENSG00000259993","15",30223017,30225564,2547
"38768","ENSG00000259994","10",30302826,30306066,3240
"38769","ENSG00000259995","16",76736342,76928169,191827
"38770","ENSG00000259997","16",33002333,33002621,288
"38771","ENSG00000259998","14",88158240,88160591,2351
"38772","ENSG00000259999","16",75321890,75325048,3158
"38773","ENSG00000260000","6",100881471,100882987,1516
"38774","ENSG00000260001","19",7916145,7919097,2952
"38775","ENSG00000260003","16",8276263,8295700,19437
"38776","ENSG00000260004","16",65601101,65601698,597
"38777","ENSG00000260005","17",81228707,81233983,5276
"38778","ENSG00000260007","15",68184032,68229718,45686
"38779","ENSG00000260008","11",102107886,102109842,1956
"38780","ENSG00000260009","16",14363109,14370266,7157
"38781","ENSG00000260011","17",82381110,82382690,1580
"38782","ENSG00000260012","16",47262741,47263500,759
"38783","ENSG00000260015","16",71539834,71541825,1991
"38784","ENSG00000260017","16",18803083,18812181,9098
"38785","ENSG00000260018","16",84117051,84117571,520
"38786","ENSG00000260019","17",27928924,27991787,62863
"38787","ENSG00000260021","1",202810238,202810829,591
"38788","ENSG00000260022","16",883780,885090,1310
"38789","ENSG00000260024","16",49708006,49708243,237
"38790","ENSG00000260025","2",36354749,36355114,365
"38791","ENSG00000260026","16",86720575,86722042,1467
"38792","ENSG00000260027","17",48607227,48633572,26345
"38793","ENSG00000260029","16",50551824,50553940,2116
"38794","ENSG00000260030","12",53754358,53762104,7746
"38795","ENSG00000260031","16",50151280,50151577,297
"38796","ENSG00000260032","20",36045618,36051018,5400
"38797","ENSG00000260033","16",48600176,48600644,468
"38798","ENSG00000260034","16",25140577,25149032,8455
"38799","ENSG00000260035","15",45200325,45200632,307
"38800","ENSG00000260036","15",55442635,55443357,722
"38801","ENSG00000260037","15",71818396,71823384,4988
"38802","ENSG00000260038","16",57247350,57248492,1142
"38803","ENSG00000260041","16",56109537,56137000,27463
"38804","ENSG00000260042","16",50856614,50879278,22664
"38805","ENSG00000260046","14",45369215,45370839,1624
"38806","ENSG00000260047","16",32869985,32873128,3143
"38807","ENSG00000260048","16",32059084,32059372,288
"38808","ENSG00000260051","16",1451760,1452653,893
"38809","ENSG00000260052","16",48637143,48638719,1576
"38810","ENSG00000260053","15",28506625,28508808,2183
"38811","ENSG00000260057","16",51755325,51788208,32883
"38812","ENSG00000260058","16",8309962,8357860,47898
"38813","ENSG00000260059","2",138599663,138602426,2763
"38814","ENSG00000260060","16",31196131,31196963,832
"38815","ENSG00000260062","15",62253730,62270680,16950
"38816","ENSG00000260063","1",26692132,26694131,1999
"38817","ENSG00000260064","16",80627551,80628379,828
"38818","ENSG00000260066","5",1725149,1728172,3023
"38819","ENSG00000260070","7",36319775,36320479,704
"38820","ENSG00000260071","16",9365540,9518325,152785
"38821","ENSG00000260072","16",24472798,24495177,22379
"38822","ENSG00000260073","16",35192687,35195661,2974
"38823","ENSG00000260075","17",46372855,46487141,114286
"38824","ENSG00000260077","2",10039092,10040663,1571
"38825","ENSG00000260078","16",53364982,53373083,8101
"38826","ENSG00000260081","X",153599315,153613937,14622
"38827","ENSG00000260082","16",30821068,30822110,1042
"38828","ENSG00000260083","16",30875222,30895220,19998
"38829","ENSG00000260084","16",68573782,68589512,15730
"38830","ENSG00000260086","16",48623422,48746318,122896
"38831","ENSG00000260088","1",200669507,200694250,24743
"38832","ENSG00000260089","16",49517762,49518601,839
"38833","ENSG00000260091","4",119409333,119410233,900
"38834","ENSG00000260092","16",75528532,75545428,16896
"38835","ENSG00000260093","8",10050485,10054254,3769
"38836","ENSG00000260094","13",81225865,81226983,1118
"38837","ENSG00000260095","16",2452581,2452977,396
"38838","ENSG00000260096","15",74062780,74063785,1005
"38839","ENSG00000260097","7",102347206,102356444,9238
"38840","ENSG00000260100","9",37078813,37079776,963
"38841","ENSG00000260101","2",64522187,64524093,1906
"38842","ENSG00000260102","13",112197350,112201000,3650
"38843","ENSG00000260103","15",74478070,74490286,12216
"38844","ENSG00000260104","15",75249232,75249407,175
"38845","ENSG00000260105","17",42865922,42874369,8447
"38846","ENSG00000260112","19",9518150,9519341,1191
"38847","ENSG00000260115","16",61918321,61940697,22376
"38848","ENSG00000260118","X",68013470,68014901,1431
"38849","ENSG00000260120","4",52680609,52692999,12390
"38850","ENSG00000260121","16",88718615,88720459,1844
"38851","ENSG00000260123","15",89041223,89082819,41596
"38852","ENSG00000260125","15",86295649,86317173,21524
"38853","ENSG00000260126","16",16499533,16664135,164602
"38854","ENSG00000260128","15",30572738,30600647,27909
"38855","ENSG00000260131","13",20181531,20181942,411
"38856","ENSG00000260132","16",1408834,1412248,3414
"38857","ENSG00000260133","16",29618785,29636328,17543
"38858","ENSG00000260135","16",55426797,55462297,35500
"38859","ENSG00000260136","16",23452758,23457606,4848
"38860","ENSG00000260137","10",37791580,37791937,357
"38861","ENSG00000260139","15",77894684,77904674,9990
"38862","ENSG00000260141","16",33043609,33095431,51822
"38863","ENSG00000260144","15",72605183,72612326,7143
"38864","ENSG00000260145","16",57052505,57058497,5992
"38865","ENSG00000260146","16",66450998,66451351,353
"38866","ENSG00000260148","16",57091213,57092303,1090
"38867","ENSG00000260151","10",27343436,27344917,1481
"38868","ENSG00000260152","15",75114261,75114868,607
"38869","ENSG00000260156","16",70747057,70747926,869
"38870","ENSG00000260157","17",21614487,21641536,27049
"38871","ENSG00000260158","16",32809556,32824645,15089
"38872","ENSG00000260159","15",28454660,28457783,3123
"38873","ENSG00000260160","19",52058490,52063703,5213
"38874","ENSG00000260161","16",82120638,82121769,1131
"38875","ENSG00000260162","16",88177289,88178646,1357
"38876","ENSG00000260163","2",127025211,127029686,4475
"38877","ENSG00000260166","16",88087241,88089970,2729
"38878","ENSG00000260167","16",30585907,30608593,22686
"38879","ENSG00000260170","15",45587351,45676314,88963
"38880","ENSG00000260171","2",206821190,206822294,1104
"38881","ENSG00000260172","15",57319138,57325039,5901
"38882","ENSG00000260173","15",72140504,72155459,14955
"38883","ENSG00000260174","15",30044455,30045296,841
"38884","ENSG00000260176","16",2644084,2645214,1130
"38885","ENSG00000260177","16",87780134,87806476,26342
"38886","ENSG00000260179","1",1249777,1251334,1557
"38887","ENSG00000260182","16",1257339,1258074,735
"38888","ENSG00000260183","16",80547842,80552514,4672
"38889","ENSG00000260185","16",71655027,71664212,9185
"38890","ENSG00000260186","16",58421326,58462470,41144
"38891","ENSG00000260187","16",64735925,64737283,1358
"38892","ENSG00000260188","6",110477907,110479436,1529
"38893","ENSG00000260190","9",136937169,136937988,819
"38894","ENSG00000260192","5",124808981,125602227,793246
"38895","ENSG00000260193","9",136107808,136109424,1616
"38896","ENSG00000260194","16",53998313,53999969,1656
"38897","ENSG00000260196","11",17380649,17383531,2882
"38898","ENSG00000260197","Y",19691941,19694606,2665
"38899","ENSG00000260198","16",56300616,56302904,2288
"38900","ENSG00000260201","16",20580999,20586640,5641
"38901","ENSG00000260202","20",23481645,23519054,37409
"38902","ENSG00000260205","10",22218074,22221168,3094
"38903","ENSG00000260206","15",75636139,75639239,3100
"38904","ENSG00000260209","11",125873031,125874528,1497
"38905","ENSG00000260212","6",127659424,127660338,914
"38906","ENSG00000260213","16",81016792,81035759,18967
"38907","ENSG00000260217","3",175938929,175941037,2108
"38908","ENSG00000260219","16",30355441,30357104,1663
"38909","ENSG00000260220","9",136249971,136306901,56930
"38910","ENSG00000260223","16",76107283,76147806,40523
"38911","ENSG00000260224","16",11968508,11968743,235
"38912","ENSG00000260228","16",83789967,83807834,17867
"38913","ENSG00000260229","16",81476023,81476519,496
"38914","ENSG00000260230","9",109130293,109167295,37002
"38915","ENSG00000260231","7",140177184,140179640,2456
"38916","ENSG00000260232","15",23912411,24090821,178410
"38917","ENSG00000260233","11",65568482,65570423,1941
"38918","ENSG00000260234","3",150882997,150941743,58746
"38919","ENSG00000260235","15",75624793,75625690,897
"38920","ENSG00000260236","3",47379089,47380999,1910
"38921","ENSG00000260238","1",156212982,156243332,30350
"38922","ENSG00000260239","6",4491807,4495769,3962
"38923","ENSG00000260240","16",59709993,59755026,45033
"38924","ENSG00000260242","16",18002806,18173063,170257
"38925","ENSG00000260244","4",155734448,155737062,2614
"38926","ENSG00000260246","1",109693117,109693742,625
"38927","ENSG00000260247","16",23537061,23537556,495
"38928","ENSG00000260249","16",50664903,50671639,6736
"38929","ENSG00000260252","16",72084857,72087443,2586
"38930","ENSG00000260253","8",29352420,29353170,750
"38931","ENSG00000260256","21",44347767,44348295,528
"38932","ENSG00000260257","20",32856621,32858751,2130
"38933","ENSG00000260258","16",52942139,52943464,1325
"38934","ENSG00000260259","16",89682620,89686569,3949
"38935","ENSG00000260260","16",2154797,2155358,561
"38936","ENSG00000260261","3",195913078,195954485,41407
"38937","ENSG00000260262","4",836512,837224,712
"38938","ENSG00000260264","16",24236104,24252863,16759
"38939","ENSG00000260265","4",75081702,75084717,3015
"38940","ENSG00000260266","15",74350768,74364620,13852
"38941","ENSG00000260267","16",31456711,31459736,3025
"38942","ENSG00000260268","16",52083064,52085109,2045
"38943","ENSG00000260269","15",75527150,75601205,74055
"38944","ENSG00000260271","6",90295507,90363912,68405
"38945","ENSG00000260272","16",2496032,2520218,24186
"38946","ENSG00000260273","6",109382795,109383666,871
"38947","ENSG00000260274","15",75368155,75369584,1429
"38948","ENSG00000260276","16",8848105,8860456,12351
"38949","ENSG00000260277","16",22083256,22092485,9229
"38950","ENSG00000260278","4",78773654,78775973,2319
"38951","ENSG00000260279","16",89296128,89298317,2189
"38952","ENSG00000260280","16",29455105,29464963,9858
"38953","ENSG00000260281","16",47144323,47162749,18426
"38954","ENSG00000260282","15",42581156,42581488,332
"38955","ENSG00000260284","16",1286351,1288837,2486
"38956","ENSG00000260285","14",103525010,103529072,4062
"38957","ENSG00000260286","6",24797321,24798889,1568
"38958","ENSG00000260288","15",75737820,75763322,25502
"38959","ENSG00000260289","16",7878799,8112756,233957
"38960","ENSG00000260290","16",69756536,69757937,1401
"38961","ENSG00000260291","16",35384144,35385086,942
"38962","ENSG00000260293","16",2476558,2482173,5615
"38963","ENSG00000260296","4",40166675,40167831,1156
"38964","ENSG00000260298","16",50058150,50059231,1081
"38965","ENSG00000260300","16",83908132,83951445,43313
"38966","ENSG00000260302","18",12739490,12776140,36650
"38967","ENSG00000260303","4",146052604,146056762,4158
"38968","ENSG00000260304","16",31182511,31183285,774
"38969","ENSG00000260305","15",88252730,88271066,18336
"38970","ENSG00000260306","16",21794095,21795759,1664
"38971","ENSG00000260307","16",32439069,32441159,2090
"38972","ENSG00000260308","16",33771035,33771248,213
"38973","ENSG00000260310","16",10576499,10578183,1684
"38974","ENSG00000260314","10",17809348,17911164,101816
"38975","ENSG00000260316","16",898967,905224,6257
"38976","ENSG00000260317","8",80541300,80543104,1804
"38977","ENSG00000260318","16",11903923,11904137,214
"38978","ENSG00000260322","1",80114943,80116918,1975
"38979","ENSG00000260325","17",42121431,42123352,1921
"38980","ENSG00000260326","16",52934813,52935635,822
"38981","ENSG00000260327","16",32379071,32380049,978
"38982","ENSG00000260328","17",17011914,17014990,3076
"38983","ENSG00000260329","12",106954029,106955497,1468
"38984","ENSG00000260331","2",18547386,18548204,818
"38985","ENSG00000260332","16",62808222,62808706,484
"38986","ENSG00000260335","16",29449191,29449625,434
"38987","ENSG00000260337","15",92592574,92596462,3888
"38988","ENSG00000260338","16",5596856,5616373,19517
"38989","ENSG00000260339","15",72376113,72378788,2675
"38990","ENSG00000260340","16",84928353,84939603,11250
"38991","ENSG00000260341","16",35492324,35493446,1122
"38992","ENSG00000260342","16",18788063,18801519,13456
"38993","ENSG00000260343","13",112313467,112321758,8291
"38994","ENSG00000260345","16",57461055,57462737,1682
"38995","ENSG00000260347","16",48496990,48498601,1611
"38996","ENSG00000260350","16",8847650,8848724,1074
"38997","ENSG00000260351","15",83022571,83090782,68211
"38998","ENSG00000260352","16",18926863,18937043,10180
"38999","ENSG00000260357","15",75299953,75302965,3012
"39000","ENSG00000260360","1",179953184,179954440,1256
"39001","ENSG00000260361","15",92779757,92781492,1735
"39002","ENSG00000260362","16",9666885,9676843,9958
"39003","ENSG00000260366","19",48926171,48926444,273
"39004","ENSG00000260367","16",28973962,28978824,4862
"39005","ENSG00000260368","8",100913247,100914388,1141
"39006","ENSG00000260369","17",80453735,80454729,994
"39007","ENSG00000260372","18",26655737,27190698,534961
"39008","ENSG00000260375","15",62255686,62256421,735
"39009","ENSG00000260377","3",182739669,182740848,1179
"39010","ENSG00000260378","16",12745873,12757835,11962
"39011","ENSG00000260381","16",50100339,50121943,21604
"39012","ENSG00000260382","15",30882267,30883231,964
"39013","ENSG00000260385","13",112083549,112085471,1922
"39014","ENSG00000260386","1",31500085,31509648,9563
"39015","ENSG00000260388","13",47930153,47932622,2469
"39016","ENSG00000260389","18",32511663,32514634,2971
"39017","ENSG00000260390","9",27829276,27844481,15205
"39018","ENSG00000260392","15",56542952,56629592,86640
"39019","ENSG00000260393","16",52607762,52608158,396
"39020","ENSG00000260394","16",678504,679777,1273
"39021","ENSG00000260395","16",21998310,21999656,1346
"39022","ENSG00000260398","8",78605952,78609705,3753
"39023","ENSG00000260400","10",68698500,68700794,2294
"39024","ENSG00000260401","11",73238975,73242335,3360
"39025","ENSG00000260402","16",32262827,32265514,2687
"39026","ENSG00000260403","16",1156976,1157974,998
"39027","ENSG00000260404","4",118591773,118633729,41956
"39028","ENSG00000260409","15",20729747,20756183,26436
"39029","ENSG00000260410","16",84119293,84121153,1860
"39030","ENSG00000260412","9",27937617,27944497,6880
"39031","ENSG00000260413","16",29312350,29331277,18927
"39032","ENSG00000260416","20",63127495,63129459,1964
"39033","ENSG00000260417","16",85592266,85595720,3454
"39034","ENSG00000260418","6",136335714,136336087,373
"39035","ENSG00000260420","16",88186605,88195217,8612
"39036","ENSG00000260422","6",164084023,164085661,1638
"39037","ENSG00000260423","12",9347056,9400387,53331
"39038","ENSG00000260425","16",1358900,1361405,2505
"39039","ENSG00000260426","7",155399922,155401782,1860
"39040","ENSG00000260428","8",144266453,144268481,2028
"39041","ENSG00000260430","16",19086831,19098332,11501
"39042","ENSG00000260433","18",53480825,53581107,100282
"39043","ENSG00000260436","16",2571570,2572353,783
"39044","ENSG00000260438","16",57713782,57714957,1175
"39045","ENSG00000260439","16",921033,934495,13462
"39046","ENSG00000260440","18",61748082,61758464,10382
"39047","ENSG00000260441","16",68256162,68260443,4281
"39048","ENSG00000260442","16",28878957,28879920,963
"39049","ENSG00000260443","16",87945058,87945202,144
"39050","ENSG00000260444","15",28564986,28565152,166
"39051","ENSG00000260447","16",2119207,2120248,1041
"39052","ENSG00000260448","16",25085168,25111555,26387
"39053","ENSG00000260450","16",47965620,47971693,6073
"39054","ENSG00000260451","16",58776540,58777563,1023
"39055","ENSG00000260452","16",28111173,28111647,474
"39056","ENSG00000260454","9",90996949,91001901,4952
"39057","ENSG00000260455","6",22133205,22147193,13988
"39058","ENSG00000260456","16",87083562,87317420,233858
"39059","ENSG00000260457","18",71837039,71870788,33749
"39060","ENSG00000260458","17",21692523,21704612,12089
"39061","ENSG00000260459","16",68822587,68823070,483
"39062","ENSG00000260460","1",156509854,156511681,1827
"39063","ENSG00000260461","10",103877374,103879761,2387
"39064","ENSG00000260464","1",93847174,93848939,1765
"39065","ENSG00000260466","16",87836532,87837663,1131
"39066","ENSG00000260467","16",57681124,57701730,20606
"39067","ENSG00000260468","16",10514842,10528202,13360
"39068","ENSG00000260469","15",73752317,73770613,18296
"39069","ENSG00000260470","12",54145069,54147225,2156
"39070","ENSG00000260471","16",74220929,74221427,498
"39071","ENSG00000260473","12",51815043,51842106,27063
"39072","ENSG00000260475","10",99621055,99621918,863
"39073","ENSG00000260476","2",10021578,10022825,1247
"39074","ENSG00000260477","15",86078809,86116747,37938
"39075","ENSG00000260478","16",52238081,52269574,31493
"39076","ENSG00000260479","16",79090050,79101754,11704
"39077","ENSG00000260483","15",75022980,75023256,276
"39078","ENSG00000260484","8",53388701,53390872,2171
"39079","ENSG00000260487","16",30480588,30481346,758
"39080","ENSG00000260488","16",11976851,11977850,999
"39081","ENSG00000260490","15",42571927,42572433,506
"39082","ENSG00000260492","12",53746337,53757227,10890
"39083","ENSG00000260493","8",85172077,85177062,4985
"39084","ENSG00000260494","16",30537202,30538231,1029
"39085","ENSG00000260495","16",81310731,81313423,2692
"39086","ENSG00000260496","16",991151,1000926,9775
"39087","ENSG00000260497","16",47760780,47760921,141
"39088","ENSG00000260498","16",87773304,87779374,6070
"39089","ENSG00000260500","19",7918652,7919157,505
"39090","ENSG00000260504","16",84342464,84343407,943
"39091","ENSG00000260505","1",220401122,220404033,2911
"39092","ENSG00000260507","16",90105095,90106316,1221
"39093","ENSG00000260509","13",25300124,25301438,1314
"39094","ENSG00000260510","16",20743663,20766620,22957
"39095","ENSG00000260511","16",79105957,79110882,4925
"39096","ENSG00000260514","16",29624517,29624825,308
"39097","ENSG00000260515","5",10195121,10197628,2507
"39098","ENSG00000260516","16",32356981,32363695,6714
"39099","ENSG00000260517","16",29139661,29216706,77045
"39100","ENSG00000260518","16",33687025,33707213,20188
"39101","ENSG00000260519","4",42657496,42657928,432
"39102","ENSG00000260520","16",71513863,71517849,3986
"39103","ENSG00000260526","4",112229561,112231596,2035
"39104","ENSG00000260528","16",90102271,90178344,76073
"39105","ENSG00000260530","16",84295498,84296985,1487
"39106","ENSG00000260532","16",1111627,1113399,1772
"39107","ENSG00000260536","20",32843128,32854257,11129
"39108","ENSG00000260537","16",70299194,70372582,73388
"39109","ENSG00000260541","16",1841020,1843547,2527
"39110","ENSG00000260542","20",62513909,62516096,2187
"39111","ENSG00000260545","16",58116885,58119353,2468
"39112","ENSG00000260548","X",108722070,108732687,10617
"39113","ENSG00000260549","16",56617476,56618818,1342
"39114","ENSG00000260550","16",18570448,18571683,1235
"39115","ENSG00000260551","15",24162754,24169948,7194
"39116","ENSG00000260552","18",36179996,36187448,7452
"39117","ENSG00000260555","7",150000752,150005124,4372
"39118","ENSG00000260558","16",66738238,66739722,1484
"39119","ENSG00000260563","17",82293716,82294910,1194
"39120","ENSG00000260564","9",79889001,79892007,3006
"39121","ENSG00000260565","16",2660348,2682379,22031
"39122","ENSG00000260568","16",31699676,31700465,789
"39123","ENSG00000260569","18",74211391,74240555,29164
"39124","ENSG00000260571","15",42313687,42314386,699
"39125","ENSG00000260572","3",160753428,160755142,1714
"39126","ENSG00000260573","16",50407184,50546347,139163
"39127","ENSG00000260576","15",72041194,72041653,459
"39128","ENSG00000260577","16",68644248,68646168,1920
"39129","ENSG00000260578","18",67481791,67484966,3175
"39130","ENSG00000260580","16",26721874,26729126,7252
"39131","ENSG00000260581","5",151652275,151655449,3174
"39132","ENSG00000260582","15",36626674,36627775,1101
"39133","ENSG00000260583","21",25582770,25583326,556
"39134","ENSG00000260584","16",32116700,32116997,297
"39135","ENSG00000260585","X",121871869,121876865,4996
"39136","ENSG00000260586","15",71332120,71352460,20340
"39137","ENSG00000260588","8",41828165,41829934,1769
"39138","ENSG00000260589","10",17641284,17643878,2594
"39139","ENSG00000260592","16",19476916,19487899,10983
"39140","ENSG00000260593","16",71623708,71626816,3108
"39141","ENSG00000260594","16",80736360,80742305,5945
"39142","ENSG00000260596","4",190173774,190185942,12168
"39143","ENSG00000260597","12",54019910,54022589,2679
"39144","ENSG00000260598","16",35405747,35407349,1602
"39145","ENSG00000260599","19",22520995,22527949,6954
"39146","ENSG00000260601","16",12545482,12546684,1202
"39147","ENSG00000260602","15",68254549,68254939,390
"39148","ENSG00000260604","6",3904920,3911979,7059
"39149","ENSG00000260605","16",51035118,51038764,3646
"39150","ENSG00000260608","15",83012661,83061845,49184
"39151","ENSG00000260610","16",32931768,32932569,801
"39152","ENSG00000260611","16",35785569,35786887,1318
"39153","ENSG00000260612","16",71726975,71727992,1017
"39154","ENSG00000260613","22",49832449,49838901,6452
"39155","ENSG00000260615","13",114346167,114346637,470
"39156","ENSG00000260616","16",50783859,50803338,19479
"39157","ENSG00000260617","16",88741631,88742367,736
"39158","ENSG00000260618","15",52577842,52598709,20867
"39159","ENSG00000260619","15",80990804,80993258,2454
"39160","ENSG00000260620","16",51054728,51056399,1671
"39161","ENSG00000260621","16",56409320,56411683,2363
"39162","ENSG00000260624","15",73870949,73873540,2591
"39163","ENSG00000260625","16",31508464,31509560,1096
"39164","ENSG00000260626","16",33533816,33534976,1160
"39165","ENSG00000260628","16",31975803,32003728,27925
"39166","ENSG00000260630","16",88663298,88687278,23980
"39167","ENSG00000260631","16",31680847,31682101,1254
"39168","ENSG00000260633","3",134347288,134349233,1945
"39169","ENSG00000260634","2",127024252,127025723,1471
"39170","ENSG00000260635","16",22365121,22369047,3926
"39171","ENSG00000260639","15",34394594,34394931,337
"39172","ENSG00000260640","8",97241742,97242204,462
"39173","ENSG00000260641","4",98658904,98664550,5646
"39174","ENSG00000260643","16",81053587,81096296,42709
"39175","ENSG00000260644","16",32741314,32776196,34882
"39176","ENSG00000260645","6",80466958,80469080,2122
"39177","ENSG00000260646","16",1512979,1514675,1696
"39178","ENSG00000260647","17",18268080,18268828,748
"39179","ENSG00000260648","15",40232082,40236109,4027
"39180","ENSG00000260650","16",66579983,66580716,733
"39181","ENSG00000260651","4",102500841,102501319,478
"39182","ENSG00000260653","7",57404172,57419535,15363
"39183","ENSG00000260657","15",68267792,68277994,10202
"39184","ENSG00000260658","16",63314264,63618046,303782
"39185","ENSG00000260660","15",75226401,75234834,8433
"39186","ENSG00000260661","15",92148752,92331037,182285
"39187","ENSG00000260664","16",72425948,72533892,107944
"39188","ENSG00000260668","16",64260570,64261239,669
"39189","ENSG00000260669","14",24209646,24215987,6341
"39190","ENSG00000260670","3",72321051,72324027,2976
"39191","ENSG00000260671","16",87739771,87747706,7935
"39192","ENSG00000260672","15",72615810,72618250,2440
"39193","ENSG00000260673","6",4599287,4602420,3133
"39194","ENSG00000260674","15",79743311,79743468,157
"39195","ENSG00000260675","16",17094351,17094927,576
"39196","ENSG00000260676","18",71519962,71578956,58994
"39197","ENSG00000260677","9",97743208,97744935,1727
"39198","ENSG00000260678","16",30615256,30615679,423
"39199","ENSG00000260679","11",69921638,69926813,5175
"39200","ENSG00000260680","16",35420291,35421209,918
"39201","ENSG00000260683","X",127660631,127662530,1899
"39202","ENSG00000260685","15",75950464,75951144,680
"39203","ENSG00000260686","5",122832356,122834533,2177
"39204","ENSG00000260688","16",48470953,48471133,180
"39205","ENSG00000260689","15",57246960,57247893,933
"39206","ENSG00000260691","9",67832765,67920552,87787
"39207","ENSG00000260693","15",30540093,30545969,5876
"39208","ENSG00000260694","16",79077376,79078234,858
"39209","ENSG00000260695","16",65861112,65863784,2672
"39210","ENSG00000260698","1",246682108,246685075,2967
"39211","ENSG00000260701","16",77433382,77446798,13416
"39212","ENSG00000260702","16",1101260,1105461,4201
"39213","ENSG00000260704","13",27953526,27955370,1844
"39214","ENSG00000260706","16",80065836,80167577,101741
"39215","ENSG00000260708","22",46761894,46762563,669
"39216","ENSG00000260710","16",1294551,1299166,4615
"39217","ENSG00000260711","14",91752856,91759798,6942
"39218","ENSG00000260714","16",25015978,25021023,5045
"39219","ENSG00000260715","16",64155169,64156574,1405
"39220","ENSG00000260719","16",29745247,29748299,3052
"39221","ENSG00000260720","9",31371611,31381490,9879
"39222","ENSG00000260721","8",1368642,1369833,1191
"39223","ENSG00000260722","16",31801585,31802497,912
"39224","ENSG00000260723","16",12372812,12373899,1087
"39225","ENSG00000260725","19",28418483,28429490,11007
"39226","ENSG00000260727","16",29613104,29613640,536
"39227","ENSG00000260729","15",72284727,72375981,91254
"39228","ENSG00000260731","16",78048483,78049897,1414
"39229","ENSG00000260733","16",78495926,78506568,10642
"39230","ENSG00000260734","16",71430262,71442060,11798
"39231","ENSG00000260735","16",15094411,15109197,14786
"39232","ENSG00000260737","16",80553256,80572808,19552
"39233","ENSG00000260738","13",99994899,99997909,3010
"39234","ENSG00000260740","16",31487370,31488492,1122
"39235","ENSG00000260741","16",23194878,23213104,18226
"39236","ENSG00000260742","2",181887851,181891663,3812
"39237","ENSG00000260743","3",179340322,179341887,1565
"39238","ENSG00000260744","16",47196311,47202429,6118
"39239","ENSG00000260746","16",35636687,35645180,8493
"39240","ENSG00000260747","18",68277802,68278243,441
"39241","ENSG00000260750","16",87492555,87600337,107782
"39242","ENSG00000260751","16",23568673,23569696,1023
"39243","ENSG00000260756","16",10351440,10352752,1312
"39244","ENSG00000260757","16",31402565,31404699,2134
"39245","ENSG00000260759","18",11666456,11670165,3709
"39246","ENSG00000260761","5",25319834,25321346,1512
"39247","ENSG00000260762","16",20586550,20607107,20557
"39248","ENSG00000260763","5",4436850,4440259,3409
"39249","ENSG00000260764","16",8731416,8731559,143
"39250","ENSG00000260765","16",55728115,55750111,21996
"39251","ENSG00000260771","6",168374697,168375355,658
"39252","ENSG00000260773","15",66314914,66331703,16789
"39253","ENSG00000260774","5",213898,217279,3381
"39254","ENSG00000260776","15",77914217,77926846,12629
"39255","ENSG00000260777","17",28263634,28266369,2735
"39256","ENSG00000260778","16",2268155,2273418,5263
"39257","ENSG00000260779","18",10661933,10666887,4954
"39258","ENSG00000260780","15",24206784,24225854,19070
"39259","ENSG00000260781","16",33907419,33937167,29748
"39260","ENSG00000260782","16",46789898,46792040,2142
"39261","ENSG00000260784","15",30516079,30517867,1788
"39262","ENSG00000260785","17",71097774,71202203,104429
"39263","ENSG00000260786","5",42188266,42191523,3257
"39264","ENSG00000260788","16",83720402,83772974,52572
"39265","ENSG00000260790","16",22374859,22378180,3321
"39266","ENSG00000260792","14",104661120,104665558,4438
"39267","ENSG00000260793","17",44221401,44223710,2309
"39268","ENSG00000260796","16",28820570,28822033,1463
"39269","ENSG00000260797","16",76878274,76878936,662
"39270","ENSG00000260798","16",68814330,68823526,9196
"39271","ENSG00000260799","15",42800968,42802405,1437
"39272","ENSG00000260802","X",111511662,111522399,10737
"39273","ENSG00000260803","16",17514,35195,17681
"39274","ENSG00000260804","2",216217045,216220192,3147
"39275","ENSG00000260805","1",212557833,212559731,1898
"39276","ENSG00000260806","14",96500810,96502321,1511
"39277","ENSG00000260807","16",975761,981596,5835
"39278","ENSG00000260808","11",68612899,68616711,3812
"39279","ENSG00000260809","16",35090501,35104834,14333
"39280","ENSG00000260810","14",91258299,91259003,704
"39281","ENSG00000260815","15",75746769,75747263,494
"39282","ENSG00000260816","16",78895361,78899644,4283
"39283","ENSG00000260817","16",5260686,5261043,357
"39284","ENSG00000260818","16",51277852,51279112,1260
"39285","ENSG00000260823","16",56609501,56611375,1874
"39286","ENSG00000260828","16",57603137,57603697,560
"39287","ENSG00000260830","14",21384292,21384920,628
"39288","ENSG00000260832","16",82953230,82990298,37068
"39289","ENSG00000260834","16",65190973,65234914,43941
"39290","ENSG00000260835","16",6573767,6577359,3592
"39291","ENSG00000260836","15",82536788,82573194,36406
"39292","ENSG00000260838","8",72947150,72950445,3295
"39293","ENSG00000260840","2",85061213,85067347,6134
"39294","ENSG00000260844","15",28763440,28764151,711
"39295","ENSG00000260846","16",35335277,35336889,1612
"39296","ENSG00000260848","16",73543927,73569309,25382
"39297","ENSG00000260850","16",51354456,51525157,170701
"39298","ENSG00000260851","16",66469812,66517312,47500
"39299","ENSG00000260852","16",30919319,30923269,3950
"39300","ENSG00000260853","16",28952816,28966883,14067
"39301","ENSG00000260854","16",34978744,34979844,1100
"39302","ENSG00000260855","1",246772301,246775772,3471
"39303","ENSG00000260857","16",35504370,35506567,2197
"39304","ENSG00000260858","16",84255270,84261049,5779
"39305","ENSG00000260859","16",84828263,84829242,979
"39306","ENSG00000260860","16",68651056,68651948,892
"39307","ENSG00000260861","20",1540144,1620009,79865
"39308","ENSG00000260862","16",82773319,82829638,56319
"39309","ENSG00000260863","10",95009674,95009812,138
"39310","ENSG00000260865","16",58597589,58597945,356
"39311","ENSG00000260866","16",32388135,32436203,48068
"39312","ENSG00000260867","16",58197112,58217805,20693
"39313","ENSG00000260868","2",174025280,174027163,1883
"39314","ENSG00000260870","15",57325472,57326447,975
"39315","ENSG00000260871","5",90388468,90389363,895
"39316","ENSG00000260874","16",2456252,2459979,3727
"39317","ENSG00000260876","16",79676048,79809716,133668
"39318","ENSG00000260877","11",69371463,69372512,1049
"39319","ENSG00000260878","4",46243548,46244215,667
"39320","ENSG00000260880","16",73092349,73099337,6988
"39321","ENSG00000260882","16",5078168,5078605,437
"39322","ENSG00000260884","16",74313337,74315634,2297
"39323","ENSG00000260886","16",71564952,71578187,13235
"39324","ENSG00000260887","16",52258564,52280638,22074
"39325","ENSG00000260891","16",68212401,68221671,9270
"39326","ENSG00000260895","11",69103493,69109094,5601
"39327","ENSG00000260896","16",80826074,80892682,66608
"39328","ENSG00000260898","15",72782835,72798199,15364
"39329","ENSG00000260899","16",30740667,30751381,10714
"39330","ENSG00000260902","3",14799331,14811414,12083
"39331","ENSG00000260903","20",31968151,32003387,35236
"39332","ENSG00000260905","16",22612543,22613483,940
"39333","ENSG00000260907","17",20530042,20530881,839
"39334","ENSG00000260908","16",29053732,29108108,54376
"39335","ENSG00000260909","16",46649126,46649849,723
"39336","ENSG00000260910","13",113926514,113928844,2330
"39337","ENSG00000260911","16",31043150,31049868,6718
"39338","ENSG00000260912","9",19453209,19455173,1964
"39339","ENSG00000260913","18",10405133,10414515,9382
"39340","ENSG00000260914","16",69299682,69322700,23018
"39341","ENSG00000260916","15",55340032,55408510,68478
"39342","ENSG00000260917","10",112823490,112827726,4236
"39343","ENSG00000260918","4",47431960,47438959,6999
"39344","ENSG00000260919","15",74613194,74615596,2402
"39345","ENSG00000260920","1",40464319,40466767,2448
"39346","ENSG00000260921","16",32995537,32996770,1233
"39347","ENSG00000260922","16",77234877,77299950,65073
"39348","ENSG00000260923","16",90173217,90222851,49634
"39349","ENSG00000260924","22",19171395,19172839,1444
"39350","ENSG00000260926","15",41609457,41630908,21451
"39351","ENSG00000260927","16",58129519,58163246,33727
"39352","ENSG00000260928","15",43131008,43131686,678
"39353","ENSG00000260932","16",83929796,83931223,1427
"39354","ENSG00000260937","15",55056723,55092177,35454
"39355","ENSG00000260939","16",53010395,53011286,891
"39356","ENSG00000260941","1",119597702,119599271,1569
"39357","ENSG00000260942","2",240582700,240586699,3999
"39358","ENSG00000260943","12",40140926,40142876,1950
"39359","ENSG00000260944","16",86565145,86567761,2616
"39360","ENSG00000260945","16",17540331,17540985,654
"39361","ENSG00000260947","9",33697459,33700986,3527
"39362","ENSG00000260948","1",111431046,111433068,2022
"39363","ENSG00000260949","8",38062881,38063791,910
"39364","ENSG00000260951","7",25358235,25432202,73967
"39365","ENSG00000260953","16",29262273,29264479,2206
"39366","ENSG00000260954","16",1579242,1580308,1066
"39367","ENSG00000260955","8",54042989,54045629,2640
"39368","ENSG00000260957","15",62284190,62285006,816
"39369","ENSG00000260958","16",35207884,35284146,76262
"39370","ENSG00000260959","15",24238145,24240192,2047
"39371","ENSG00000260962","13",94960041,94961319,1278
"39372","ENSG00000260963","16",52607006,52614640,7634
"39373","ENSG00000260965","16",57321352,57322117,765
"39374","ENSG00000260966","11",103050687,103055799,5112
"39375","ENSG00000260969","16",78234652,78241989,7337
"39376","ENSG00000260970","9",119495375,119524125,28750
"39377","ENSG00000260971","1",56154545,56477687,323142
"39378","ENSG00000260972","1",5492978,5494674,1696
"39379","ENSG00000260973","16",22610531,22612196,1665
"39380","ENSG00000260975","16",52198012,52227956,29944
"39381","ENSG00000260976","1",184999710,185008789,9079
"39382","ENSG00000260978","15",23567264,23569657,2393
"39383","ENSG00000260979","16",8962706,8966990,4284
"39384","ENSG00000260981","5",8785042,8785468,426
"39385","ENSG00000260983","16",76228379,76262365,33986
"39386","ENSG00000260984","16",35232412,35235984,3572
"39387","ENSG00000260986","15",21127698,21130095,2397
"39388","ENSG00000260988","15",78141243,78143173,1930
"39389","ENSG00000260989","16",1580527,1610328,29801
"39390","ENSG00000260990","1",175307218,175335459,28241
"39391","ENSG00000260992","13",99087819,99088625,806
"39392","ENSG00000260994","16",35547917,35548829,912
"39393","ENSG00000260995","9",79135374,79198314,62940
"39394","ENSG00000260996","9",137293868,137295721,1853
"39395","ENSG00000260997","7",44958999,44960909,1910
"39396","ENSG00000261000","1",206503948,206504456,508
"39397","ENSG00000261002","15",42208413,42226990,18577
"39398","ENSG00000261003","6",170414139,170419325,5186
"39399","ENSG00000261007","16",5365797,5366688,891
"39400","ENSG00000261008","16",72236281,72665014,428733
"39401","ENSG00000261010","16",35255192,35255633,441
"39402","ENSG00000261012","2",20999313,21000917,1604
"39403","ENSG00000261014","16",63730205,63755884,25679
"39404","ENSG00000261017","16",48059671,48059995,324
"39405","ENSG00000261019","7",42901272,42902639,1367
"39406","ENSG00000261020","17",22420022,22424731,4709
"39407","ENSG00000261024","1",185321157,185335039,13882
"39408","ENSG00000261026","8",22679013,22684009,4996
"39409","ENSG00000261028","16",64242608,64343909,101301
"39410","ENSG00000261029","16",82170296,82175803,5507
"39411","ENSG00000261030","X",13093660,13094573,913
"39412","ENSG00000261033","17",20008051,20009234,1183
"39413","ENSG00000261036","5",120345907,120410969,65062
"39414","ENSG00000261037","5",6019029,6022283,3254
"39415","ENSG00000261038","6",92387841,92388827,986
"39416","ENSG00000261039","6",169175277,169182841,7564
"39417","ENSG00000261040","17",60083566,60091885,8319
"39418","ENSG00000261043","15",75759501,75762405,2904
"39419","ENSG00000261044","8",142620373,142621064,691
"39420","ENSG00000261045","16",27158451,27176587,18136
"39421","ENSG00000261046","16",35552909,35554001,1092
"39422","ENSG00000261048","15",20890206,20890606,400
"39423","ENSG00000261049","16",54033997,54054583,20586
"39424","ENSG00000261051","3",146059585,146061679,2094
"39425","ENSG00000261052","16",30199228,30204310,5082
"39426","ENSG00000261054","15",99128832,99131806,2974
"39427","ENSG00000261055","1",109895973,109897861,1888
"39428","ENSG00000261056","16",53298224,53299792,1568
"39429","ENSG00000261057","13",102589372,102589813,441
"39430","ENSG00000261058","16",75119558,75144200,24642
"39431","ENSG00000261060","1",179590372,179591305,933
"39432","ENSG00000261061","16",81030770,81031485,715
"39433","ENSG00000261063","16",77201474,77249957,48483
"39434","ENSG00000261064","15",32536047,32587613,51566
"39435","ENSG00000261066","16",8526549,8532013,5464
"39436","ENSG00000261067","16",28974804,28990775,15971
"39437","ENSG00000261068","6",42092233,42094259,2026
"39438","ENSG00000261069","15",25087661,25088896,1235
"39439","ENSG00000261070","11",69147228,69171564,24336
"39440","ENSG00000261072","15",56192353,56193262,909
"39441","ENSG00000261075","16",9446010,9455505,9495
"39442","ENSG00000261076","10",58325614,58327030,1416
"39443","ENSG00000261078","16",58382989,58383798,809
"39444","ENSG00000261079","16",74367462,74369826,2364
"39445","ENSG00000261080","6",45573346,45576770,3424
"39446","ENSG00000261081","15",34409625,34410594,969
"39447","ENSG00000261082","16",79798050,79827150,29100
"39448","ENSG00000261083","4",124499940,124558445,58505
"39449","ENSG00000261087","8",101166805,101169629,2824
"39450","ENSG00000261089","16",28413703,28415018,1315
"39451","ENSG00000261090","16",23017723,23026285,8562
"39452","ENSG00000261092","16",50390916,50395133,4217
"39453","ENSG00000261094","9",122937623,122940333,2710
"39454","ENSG00000261095","16",87212122,87226430,14308
"39455","ENSG00000261096","2",231809846,231812352,2506
"39456","ENSG00000261097","13",46296445,46297844,1399
"39457","ENSG00000261098","11",107312132,107316271,4139
"39458","ENSG00000261101","X",101627868,101628523,655
"39459","ENSG00000261102","15",66414933,66415198,265
"39460","ENSG00000261103","16",83687779,83717898,30119
"39461","ENSG00000261104","2",9106593,9109865,3272
"39462","ENSG00000261105","13",75604700,75635994,31294
"39463","ENSG00000261111","16",32635673,32636045,372
"39464","ENSG00000261113","16",22286708,22288738,2030
"39465","ENSG00000261114","16",56941028,56941726,698
"39466","ENSG00000261115","7",141074064,141480380,406316
"39467","ENSG00000261116","6",54943167,54945099,1932
"39468","ENSG00000261117","2",12715415,12716227,812
"39469","ENSG00000261118","16",89492017,89504460,12443
"39470","ENSG00000261120","14",59919423,59920339,916
"39471","ENSG00000261121","4",24659856,24671568,11712
"39472","ENSG00000261122","16",35743268,35756515,13247
"39473","ENSG00000261123","16",2094830,2097026,2196
"39474","ENSG00000261124","16",31065495,31069246,3751
"39475","ENSG00000261126","18",80046900,80095482,48582
"39476","ENSG00000261127","16",32289547,32310555,21008
"39477","ENSG00000261131","16",46660696,46661591,895
"39478","ENSG00000261135","1",16514645,16515754,1109
"39479","ENSG00000261136","15",39782571,39785617,3046
"39480","ENSG00000261140","16",2569043,2571936,2893
"39481","ENSG00000261141","16",81055301,81056426,1125
"39482","ENSG00000261143","15",77976042,77993057,17015
"39483","ENSG00000261146","3",137791973,137796678,4705
"39484","ENSG00000261147","15",90249556,90272208,22652
"39485","ENSG00000261150","8",143857324,143878464,21140
"39486","ENSG00000261153","16",33808778,33810767,1989
"39487","ENSG00000261154","16",77590806,77610681,19875
"39488","ENSG00000261156","17",34169372,34195937,26565
"39489","ENSG00000261158","16",12759282,12761162,1880
"39490","ENSG00000261159","3",128859716,128860526,810
"39491","ENSG00000261161","16",86646301,86668923,22622
"39492","ENSG00000261166","4",136097797,136099240,1443
"39493","ENSG00000261167","3",131455126,131458598,3472
"39494","ENSG00000261168","1",151130075,151131610,1535
"39495","ENSG00000261170","16",74422120,74441937,19817
"39496","ENSG00000261172","16",90110574,90168225,57651
"39497","ENSG00000261173","16",46973989,46978983,4994
"39498","ENSG00000261174","15",56323193,56323719,526
"39499","ENSG00000261175","16",86710122,86742083,31961
"39500","ENSG00000261177","16",86081409,86089526,8117
"39501","ENSG00000261178","16",60925733,60928541,2808
"39502","ENSG00000261183","15",40835808,40844387,8579
"39503","ENSG00000261184","7",36095255,36100660,5405
"39504","ENSG00000261186","2",242087351,242088457,1106
"39505","ENSG00000261187","15",72465128,72466262,1134
"39506","ENSG00000261188","22",26512537,26514568,2031
"39507","ENSG00000261189","6",7540451,7541338,887
"39508","ENSG00000261190","16",52005487,52078474,72987
"39509","ENSG00000261191","15",36641186,36669097,27911
"39510","ENSG00000261192","17",57045478,57046797,1319
"39511","ENSG00000261193","16",88079161,88087383,8222
"39512","ENSG00000261194","18",75696044,75712851,16807
"39513","ENSG00000261195","16",19761172,19766099,4927
"39514","ENSG00000261196","1",46994382,46994502,120
"39515","ENSG00000261198","16",7614230,7614992,762
"39516","ENSG00000261199","16",63180610,63181071,461
"39517","ENSG00000261200","16",33541842,33545812,3970
"39518","ENSG00000261202","22",40043068,40044530,1462
"39519","ENSG00000261204","19",637105,637537,432
"39520","ENSG00000261205","15",75251743,75252934,1191
"39521","ENSG00000261207","16",1751559,1752262,703
"39522","ENSG00000261208","14",52286797,52289268,2471
"39523","ENSG00000261209","2",108317725,108318611,886
"39524","ENSG00000261210","16",19285739,19322145,36406
"39525","ENSG00000261211","6",6680309,6683633,3324
"39526","ENSG00000261213","1",75122518,75123927,1409
"39527","ENSG00000261215","9",34661903,34666029,4126
"39528","ENSG00000261216","16",11908208,11908916,708
"39529","ENSG00000261217","16",33988406,33991551,3145
"39530","ENSG00000261218","16",81738248,81767868,29620
"39531","ENSG00000261219","15",57720295,57720928,633
"39532","ENSG00000261220","8",133573183,133573861,678
"39533","ENSG00000261221","19",55605405,55617269,11864
"39534","ENSG00000261222","17",74599840,74607229,7389
"39535","ENSG00000261226","16",88936779,88939651,2872
"39536","ENSG00000261227","16",73232055,73233970,1915
"39537","ENSG00000261229","15",79843547,79844304,757
"39538","ENSG00000261231","16",47724568,47908431,183863
"39539","ENSG00000261232","15",76472099,76472365,266
"39540","ENSG00000261233","16",32475051,32478250,3199
"39541","ENSG00000261235","16",82044336,82139631,95295
"39542","ENSG00000261236","8",144262045,144291438,29393
"39543","ENSG00000261238","16",51149239,51149819,580
"39544","ENSG00000261239","16",46469341,46569097,99756
"39545","ENSG00000261240","16",2112335,2113342,1007
"39546","ENSG00000261241","16",50840017,50901063,61046
"39547","ENSG00000261242","14",63543569,63544664,1095
"39548","ENSG00000261243","16",84495599,84497495,1896
"39549","ENSG00000261244","15",77916522,77922019,5497
"39550","ENSG00000261245","16",31361278,31361695,417
"39551","ENSG00000261247","15",30135149,30145567,10418
"39552","ENSG00000261248","16",74282415,74287519,5104
"39553","ENSG00000261250","1",179543201,179548922,5721
"39554","ENSG00000261251","22",43812456,43817394,4938
"39555","ENSG00000261253","16",89321133,89325110,3977
"39556","ENSG00000261257","11",126100505,126102413,1908
"39557","ENSG00000261259","16",32951993,33028037,76044
"39558","ENSG00000261260","16",71288775,71309963,21188
"39559","ENSG00000261261","16",52622115,52677747,55632
"39560","ENSG00000261263","16",32650195,32650910,715
"39561","ENSG00000261265","15",57527187,57529009,1822
"39562","ENSG00000261266","16",23687049,23687689,640
"39563","ENSG00000261267","16",48559661,48587403,27742
"39564","ENSG00000261269","5",72439903,72442387,2484
"39565","ENSG00000261270","16",56940278,56941342,1064
"39566","ENSG00000261272","6",31010474,31035402,24928
"39567","ENSG00000261273","16",88234785,88302511,67726
"39568","ENSG00000261274","16",35207903,35208236,333
"39569","ENSG00000261275","7",56493124,56497285,4161
"39570","ENSG00000261276","11",69004394,69005100,706
"39571","ENSG00000261278","16",60024578,60025141,563
"39572","ENSG00000261279","15",32406597,32434992,28395
"39573","ENSG00000261281","15",72682266,72682904,638
"39574","ENSG00000261282","16",51107571,51108021,450
"39575","ENSG00000261284","16",31863633,31864876,1243
"39576","ENSG00000261285","16",82491738,82575518,83780
"39577","ENSG00000261286","16",84459259,84467361,8102
"39578","ENSG00000261288","16",2554975,2556105,1130
"39579","ENSG00000261289","16",31952160,31952473,313
"39580","ENSG00000261291","16",53168522,53169450,928
"39581","ENSG00000261292","3",97759523,97761532,2009
"39582","ENSG00000261293","16",12093627,12095307,1680
"39583","ENSG00000261294","16",1206560,1207124,564
"39584","ENSG00000261296","15",62274163,62278365,4202
"39585","ENSG00000261298","2",234222838,234224514,1676
"39586","ENSG00000261302","16",56708450,56730010,21560
"39587","ENSG00000261303","15",78660644,78736684,76040
"39588","ENSG00000261304","15",34651135,34671095,19960
"39589","ENSG00000261305","7",150337483,150343346,5863
"39590","ENSG00000261308","12",51817840,51848766,30926
"39591","ENSG00000261310","16",60486819,60523250,36431
"39592","ENSG00000261312","16",19706351,19715383,9032
"39593","ENSG00000261313","16",75838576,75860869,22293
"39594","ENSG00000261314","1",211583015,211583725,710
"39595","ENSG00000261315","15",36617089,36619265,2176
"39596","ENSG00000261318","15",66278498,66293357,14859
"39597","ENSG00000261319","16",8298492,8299772,1280
"39598","ENSG00000261320","16",67430667,67431464,797
"39599","ENSG00000261324","12",14762504,14767931,5427
"39600","ENSG00000261325","16",47849314,47887130,37816
"39601","ENSG00000261326","1",23281307,23287488,6181
"39602","ENSG00000261327","16",88177298,88186929,9631
"39603","ENSG00000261329","16",27678940,27718806,39866
"39604","ENSG00000261330","16",77892422,77892915,493
"39605","ENSG00000261332","16",30498766,30499554,788
"39606","ENSG00000261334","9",129480605,129482538,1933
"39607","ENSG00000261335","17",76671942,76673658,1716
"39608","ENSG00000261336","16",47565090,47566884,1794
"39609","ENSG00000261338","2",218255319,218257366,2047
"39610","ENSG00000261340","11",29980113,29982392,2279
"39611","ENSG00000261341","19",50776141,50793142,17001
"39612","ENSG00000261342","19",2727743,2729327,1584
"39613","ENSG00000261346","16",30477180,30489353,12173
"39614","ENSG00000261347","11",69467598,69469705,2107
"39615","ENSG00000261348","16",71366933,71426464,59531
"39616","ENSG00000261349","1",25266102,25267136,1034
"39617","ENSG00000261350","16",35491174,35492395,1221
"39618","ENSG00000261351","15",66488658,66492109,3451
"39619","ENSG00000261356","16",46571537,46572136,599
"39620","ENSG00000261357","16",19065991,19066694,703
"39621","ENSG00000261359","16",31201885,31203452,1567
"39622","ENSG00000261360","5",14661808,14664604,2796
"39623","ENSG00000261363","16",87066705,87069752,3047
"39624","ENSG00000261364","3",109176438,109177365,927
"39625","ENSG00000261365","15",28473322,28473448,126
"39626","ENSG00000261366","6",95575183,95577450,2267
"39627","ENSG00000261367","16",30107675,30110541,2866
"39628","ENSG00000261368","10",50964270,50965220,950
"39629","ENSG00000261369","16",47299447,47317814,18367
"39630","ENSG00000261371","17",64319415,64413776,94361
"39631","ENSG00000261373","16",89711856,89718165,6309
"39632","ENSG00000261375","15",32489267,32491586,2319
"39633","ENSG00000261376","16",80179129,80180682,1553
"39634","ENSG00000261377","15",28789664,28859007,69343
"39635","ENSG00000261379","2",226804036,226805061,1025
"39636","ENSG00000261382","5",153901459,153903223,1764
"39637","ENSG00000261386","16",67549214,67563958,14744
"39638","ENSG00000261390","16",79715220,79770651,55431
"39639","ENSG00000261392","16",9068554,9072412,3858
"39640","ENSG00000261393","16",50368580,50371480,2900
"39641","ENSG00000261394","16",12366982,12372582,5600
"39642","ENSG00000261395","16",68686399,68686670,271
"39643","ENSG00000261396","16",67538557,67540106,1549
"39644","ENSG00000261397","16",9441294,9444985,3691
"39645","ENSG00000261398","16",35195779,35197544,1765
"39646","ENSG00000261399","16",1713527,1714208,681
"39647","ENSG00000261400","19",31588040,31595720,7680
"39648","ENSG00000261402","9",19926094,19929937,3843
"39649","ENSG00000261403","15",77954075,77963654,9579
"39650","ENSG00000261404","16",73943078,74296762,353684
"39651","ENSG00000261405","16",33562649,33570935,8286
"39652","ENSG00000261407","15",89087078,89088377,1299
"39653","ENSG00000261408","17",75979231,76005999,26768
"39654","ENSG00000261409","X",108719949,108724944,4995
"39655","ENSG00000261410","16",83383007,83398170,15163
"39656","ENSG00000261411","20",11685144,11687323,2179
"39657","ENSG00000261416","16",30183505,30184957,1452
"39658","ENSG00000261418","15",23430839,23435212,4373
"39659","ENSG00000261419","16",28659696,28740781,81085
"39660","ENSG00000261420","6",166383189,166384824,1635
"39661","ENSG00000261423","15",72407778,72475168,67390
"39662","ENSG00000261424","16",75709056,75709815,759
"39663","ENSG00000261426","15",27362310,27366398,4088
"39664","ENSG00000261427","16",19114002,19173578,59576
"39665","ENSG00000261429","16",56686851,56688052,1201
"39666","ENSG00000261430","16",1467673,1472684,5011
"39667","ENSG00000261431","20",38961925,38962111,186
"39668","ENSG00000261433","17",10658542,10659082,540
"39669","ENSG00000261434","5",195778,196341,563
"39670","ENSG00000261435","X",39837536,39848358,10822
"39671","ENSG00000261436","16",60346478,60499364,152886
"39672","ENSG00000261437","8",94637285,94639467,2182
"39673","ENSG00000261438","10",89015836,89017059,1223
"39674","ENSG00000261439","16",56192614,56194518,1904
"39675","ENSG00000261441","15",89335053,89336161,1108
"39676","ENSG00000261442","16",4634329,4640623,6294
"39677","ENSG00000261444","16",30214409,30214699,290
"39678","ENSG00000261445","16",35493754,35496457,2703
"39679","ENSG00000261446","13",90060247,90119719,59472
"39680","ENSG00000261447","9",69672749,69673713,964
"39681","ENSG00000261448","16",17134504,17138736,4232
"39682","ENSG00000261449","8",42151772,42152763,991
"39683","ENSG00000261451","8",10433672,10438312,4640
"39684","ENSG00000261453","1",208606564,208614295,7731
"39685","ENSG00000261455","7",152463786,152465549,1763
"39686","ENSG00000261456","10",46892,74163,27271
"39687","ENSG00000261457","16",31802947,31807973,5026
"39688","ENSG00000261458","16",74842587,74843883,1296
"39689","ENSG00000261459","16",30525923,30534852,8929
"39690","ENSG00000261460","15",72278867,72351794,72927
"39691","ENSG00000261461","16",35169692,35170241,549
"39692","ENSG00000261462","7",87109539,87111282,1743
"39693","ENSG00000261465","16",19062144,19067691,5547
"39694","ENSG00000261466","16",33548297,33554408,6111
"39695","ENSG00000261467","7",73985992,73988767,2775
"39696","ENSG00000261468","3",30697661,30699576,1915
"39697","ENSG00000261469","16",68236845,68237667,822
"39698","ENSG00000261470","16",52078622,52080489,1867
"39699","ENSG00000261471","16",84594393,84596826,2433
"39700","ENSG00000261472","16",79505603,79516293,10690
"39701","ENSG00000261474","16",31449535,31453493,3958
"39702","ENSG00000261475","16",31542748,31553604,10856
"39703","ENSG00000261476","16",75458252,75460017,1765
"39704","ENSG00000261478","15",89508961,89510416,1455
"39705","ENSG00000261480","15",28719377,28738431,19054
"39706","ENSG00000261481","16",8869251,8870032,781
"39707","ENSG00000261485","13",28136843,28138193,1350
"39708","ENSG00000261486","16",35344091,35344559,468
"39709","ENSG00000261487","16",30948386,30956511,8125
"39710","ENSG00000261488","3",112133423,112135359,1936
"39711","ENSG00000261489","15",57477484,57478329,845
"39712","ENSG00000261490","4",10068089,10073019,4930
"39713","ENSG00000261491","15",32384937,32387484,2547
"39714","ENSG00000261498","13",24331450,24337121,5671
"39715","ENSG00000261499","17",36274191,36320547,46356
"39716","ENSG00000261501","4",121870583,121872848,2265
"39717","ENSG00000261502","16",63056786,63129654,72868
"39718","ENSG00000261504","1",182615254,182616629,1375
"39719","ENSG00000261505","16",1317891,1322845,4954
"39720","ENSG00000261512","16",46622861,46624451,1590
"39721","ENSG00000261513","16",71723180,71724230,1050
"39722","ENSG00000261514","17",43938363,43938959,596
"39723","ENSG00000261519","16",66549280,66551189,1909
"39724","ENSG00000261520","18",4264602,4295405,30803
"39725","ENSG00000261522","2",94575976,94587183,11207
"39726","ENSG00000261523","16",14695567,14707055,11488
"39727","ENSG00000261524","15",28402868,28405033,2165
"39728","ENSG00000261526","19",1874871,1876169,1298
"39729","ENSG00000261527","16",69443240,69444290,1050
"39730","ENSG00000261528","16",23500905,23501630,725
"39731","ENSG00000261529","15",25345633,25347235,1602
"39732","ENSG00000261534","9",121815674,121819452,3778
"39733","ENSG00000261535","7",102153355,102154463,1108
"39734","ENSG00000261537","16",78994345,79004730,10385
"39735","ENSG00000261538","16",48164952,48167238,2286
"39736","ENSG00000261541","16",32454612,32458758,4146
"39737","ENSG00000261542","8",63215981,63218034,2053
"39738","ENSG00000261543","15",74152800,74179226,26426
"39739","ENSG00000261544","15",65766460,65767398,938
"39740","ENSG00000261546","16",89113175,89115279,2104
"39741","ENSG00000261548","6",29800415,29802425,2010
"39742","ENSG00000261549","15",88989519,88990245,726
"39743","ENSG00000261553","13",75549773,75807120,257347
"39744","ENSG00000261554","15",20893383,20893980,597
"39745","ENSG00000261555","16",17825252,17826906,1654
"39746","ENSG00000261556","16",70219574,70246612,27038
"39747","ENSG00000261557","16",27133483,27135179,1696
"39748","ENSG00000261558","19",23015059,23031818,16759
"39749","ENSG00000261559","15",34494420,34495900,1480
"39750","ENSG00000261560","16",11881075,11882569,1494
"39751","ENSG00000261561","15",28346490,28346647,157
"39752","ENSG00000261569","16",32649193,32663956,14763
"39753","ENSG00000261570","7",141500079,141551304,51225
"39754","ENSG00000261572","3",32236688,32238578,1890
"39755","ENSG00000261573","1",198657553,198667061,9508
"39756","ENSG00000261575","17",46267037,46268694,1657
"39757","ENSG00000261578","11",76800364,76804555,4191
"39758","ENSG00000261581","15",28575019,28579400,4381
"39759","ENSG00000261582","20",35267885,35280043,12158
"39760","ENSG00000261584","6",26686241,26687964,1723
"39761","ENSG00000261586","12",51817899,51820150,2251
"39762","ENSG00000261587","8",144352219,144354914,2695
"39763","ENSG00000261588","16",30587662,30587920,258
"39764","ENSG00000261590","16",60357214,60357474,260
"39765","ENSG00000261592","16",87396704,87400295,3591
"39766","ENSG00000261594","11",75240905,75243697,2792
"39767","ENSG00000261595","1",112715672,112717796,2124
"39768","ENSG00000261596","16",21626742,21627569,827
"39769","ENSG00000261599","16",33094204,33129090,34886
"39770","ENSG00000261600","2",91580336,91580863,527
"39771","ENSG00000261603","3",46719583,46736429,16846
"39772","ENSG00000261604","5",43287601,43290839,3238
"39773","ENSG00000261606","15",74816223,74831795,15572
"39774","ENSG00000261608","16",35173316,35174093,777
"39775","ENSG00000261609","16",81314966,81380198,65232
"39776","ENSG00000261610","21",32259804,32261585,1781
"39777","ENSG00000261611","16",71447600,71489311,41711
"39778","ENSG00000261613","16",2554060,2556060,2000
"39779","ENSG00000261614","16",31568386,31569475,1089
"39780","ENSG00000261615","19",23046958,23063705,16747
"39781","ENSG00000261616","15",99139317,99145370,6053
"39782","ENSG00000261617","16",9355588,9408093,52505
"39783","ENSG00000261618","8",78835307,78840525,5218
"39784","ENSG00000261620","16",35802869,35803280,411
"39785","ENSG00000261623","16",49466106,49469875,3769
"39786","ENSG00000261624","7",141351977,141352768,791
"39787","ENSG00000261625","11",69000765,69002048,1283
"39788","ENSG00000261627","18",6641971,6642478,507
"39789","ENSG00000261628","15",30899480,30900327,847
"39790","ENSG00000261629","7",141429711,141431268,1557
"39791","ENSG00000261630","16",53981229,53981912,683
"39792","ENSG00000261632","15",71972206,72040265,68059
"39793","ENSG00000261633","16",57622034,57631647,9613
"39794","ENSG00000261634","15",69278328,69298795,20467
"39795","ENSG00000261635","15",36613474,36614198,724
"39796","ENSG00000261636","16",25419812,25433686,13874
"39797","ENSG00000261637","16",51017544,51035784,18240
"39798","ENSG00000261638","16",58847715,58880351,32636
"39799","ENSG00000261642","1",191151510,191154634,3124
"39800","ENSG00000261644","16",50727417,50742815,15398
"39801","ENSG00000261645","11",90251204,90915052,663848
"39802","ENSG00000261646","4",173467833,173470041,2208
"39803","ENSG00000261648","16",31546698,31547237,539
"39804","ENSG00000261649","15",28841833,28848675,6842
"39805","ENSG00000261650","12",130024493,130044956,20463
"39806","ENSG00000261651","16",87215915,87216452,537
"39807","ENSG00000261652","15",55408548,55418764,10216
"39808","ENSG00000261653","16",63935778,63936906,1128
"39809","ENSG00000261654","1",110936369,110942353,5984
"39810","ENSG00000261655","8",141353403,141355365,1962
"39811","ENSG00000261656","16",66469796,66481230,11434
"39812","ENSG00000261659","16",689001,692554,3553
"39813","ENSG00000261663","16",2240487,2241818,1331
"39814","ENSG00000261664","1",51329654,51335324,5670
"39815","ENSG00000261666","13",88626853,88630397,3544
"39816","ENSG00000261667","8",143080457,143083001,2544
"39817","ENSG00000261668","4",127840198,127844040,3842
"39818","ENSG00000261669","16",24803451,24819739,16288
"39819","ENSG00000261670","8",103464389,103468985,4596
"39820","ENSG00000261671","10",22257786,22258548,762
"39821","ENSG00000261673","16",72224565,72225144,579
"39822","ENSG00000261675","22",36560870,36562915,2045
"39823","ENSG00000261678","8",144330565,144336482,5917
"39824","ENSG00000261679","15",43267904,43268388,484
"39825","ENSG00000261683","10",33759713,33772702,12989
"39826","ENSG00000261687","15",43184079,43185141,1062
"39827","ENSG00000261692","16",89420075,89422226,2151
"39828","ENSG00000261693","8",142403652,142407028,3376
"39829","ENSG00000261695","16",14734685,14746177,11492
"39830","ENSG00000261696","9",21394888,21396346,1458
"39831","ENSG00000261697","16",87262759,87292438,29679
"39832","ENSG00000261701","16",72063148,72077246,14098
"39833","ENSG00000261703","16",50806668,50807629,961
"39834","ENSG00000261704","16",32034853,32035326,473
"39835","ENSG00000261706","21",44994362,44995185,823
"39836","ENSG00000261707","16",77741468,77743000,1532
"39837","ENSG00000261708","15",32436503,32439767,3264
"39838","ENSG00000261710","8",142089827,142091619,1792
"39839","ENSG00000261711","16",35477414,35480481,3067
"39840","ENSG00000261713","16",1064093,1078731,14638
"39841","ENSG00000261714","15",75415249,75416020,771
"39842","ENSG00000261715","18",40066286,40099233,32947
"39843","ENSG00000261716","1",149844498,149850937,6439
"39844","ENSG00000261717","16",75412684,75464706,52022
"39845","ENSG00000261722","16",79212711,79229453,16742
"39846","ENSG00000261723","16",23605841,23624107,18266
"39847","ENSG00000261727","16",32008438,32084785,76347
"39848","ENSG00000261728","13",34925834,34928076,2242
"39849","ENSG00000261729","1",185646463,185657168,10705
"39850","ENSG00000261730","6",1383790,1385066,1276
"39851","ENSG00000261732","16",1632259,1686715,54456
"39852","ENSG00000261734","3",20388249,20390562,2313
"39853","ENSG00000261736","16",27643199,27644663,1464
"39854","ENSG00000261737","1",86703502,86704462,960
"39855","ENSG00000261738","18",5721812,5876328,154516
"39856","ENSG00000261739","15",23354748,23367231,12483
"39857","ENSG00000261740","16",29443230,29454651,11421
"39858","ENSG00000261741","16",31563082,31567716,4634
"39859","ENSG00000261742","16",65284496,65576345,291849
"39860","ENSG00000261743","16",63368844,63369456,612
"39861","ENSG00000261744","16",88512960,88531053,18093
"39862","ENSG00000261745","6",53125644,53126146,502
"39863","ENSG00000261749","16",52085210,52099120,13910
"39864","ENSG00000261751","16",49920730,49924154,3424
"39865","ENSG00000261752","16",35258630,35259629,999
"39866","ENSG00000261754","19",34811589,34814345,2756
"39867","ENSG00000261757","5",142703782,142705421,1639
"39868","ENSG00000261758","3",136752630,136755780,3150
"39869","ENSG00000261760","2",110231106,110272050,40944
"39870","ENSG00000261761","4",37001772,37023499,21727
"39871","ENSG00000261762","15",78589123,78591276,2153
"39872","ENSG00000261763","3",139678620,139682564,3944
"39873","ENSG00000261765","16",71881553,71882273,720
"39874","ENSG00000261766","16",28862166,28863340,1174
"39875","ENSG00000261770","19",27757184,27760849,3665
"39876","ENSG00000261771","15",55355248,55498360,143112
"39877","ENSG00000261773","X",154517840,154518631,791
"39878","ENSG00000261774","16",72278268,72278568,300
"39879","ENSG00000261775","15",74489602,74516959,27357
"39880","ENSG00000261776","16",78055824,78056927,1103
"39881","ENSG00000261777","16",70315442,70346806,31364
"39882","ENSG00000261780","18",73324941,73349879,24938
"39883","ENSG00000261781","1",18065657,18074412,8755
"39884","ENSG00000261783","16",75379818,75381260,1442
"39885","ENSG00000261786","3",44117299,44122365,5066
"39886","ENSG00000261787","8",66946501,66962591,16090
"39887","ENSG00000261789","16",4560001,4561662,1661
"39888","ENSG00000261792","15",30098826,30102093,3267
"39889","ENSG00000261793","9",137168854,137171984,3130
"39890","ENSG00000261794","15",30604126,30614561,10435
"39891","ENSG00000261795","7",161765,164972,3207
"39892","ENSG00000261796","3",129087575,129161036,73461
"39893","ENSG00000261797","7",141512698,141513183,485
"39894","ENSG00000261798","1",39788976,39790171,1195
"39895","ENSG00000261799","12",273954,277123,3169
"39896","ENSG00000261800","16",35143722,35146129,2407
"39897","ENSG00000261801","15",73908071,73928248,20177
"39898","ENSG00000261803","16",54365996,54370794,4798
"39899","ENSG00000261804","16",53373479,53385019,11540
"39900","ENSG00000261807","16",59855353,60053973,198620
"39901","ENSG00000261809","7",4511959,4512033,74
"39902","ENSG00000261810","16",10033684,10037297,3613
"39903","ENSG00000261811","16",5215243,5220843,5600
"39904","ENSG00000261812","16",90093154,90096354,3200
"39905","ENSG00000261813","15",74976240,74976573,333
"39906","ENSG00000261816","16",88191486,88193667,2181
"39907","ENSG00000261817","1",180117140,180123890,6750
"39908","ENSG00000261818","16",65580668,65646947,66279
"39909","ENSG00000261819","16",14988259,14990160,1901
"39910","ENSG00000261820","15",75791470,75792683,1213
"39911","ENSG00000261821","15",74365435,74371211,5776
"39912","ENSG00000261823","15",56408483,56410186,1703
"39913","ENSG00000261824","19",27681072,27794005,112933
"39914","ENSG00000261826","3",140865075,140867783,2708
"39915","ENSG00000261829","2",231052040,231052637,597
"39916","ENSG00000261831","1",179926641,179941796,15155
"39917","ENSG00000261832","16",28456371,28492098,35727
"39918","ENSG00000261834","16",32903442,32903894,452
"39919","ENSG00000261835","16",50046496,50047798,1302
"39920","ENSG00000261837","16",78534374,78535648,1274
"39921","ENSG00000261838","16",81069854,81076598,6744
"39922","ENSG00000261839","6",28136849,28139678,2829
"39923","ENSG00000261840","16",30697707,30699058,1351
"39924","ENSG00000261842","7",149422675,149424890,2215
"39925","ENSG00000261848","17",3134969,3177031,42062
"39926","ENSG00000261856","16",14018880,14021077,2197
"39927","ENSG00000261857","19",40771648,40777490,5842
"39928","ENSG00000261863","17",4610449,4617650,7201
"39929","ENSG00000261864","16",68077340,68122271,44931
"39930","ENSG00000261866","19",8676844,8677584,740
"39931","ENSG00000261868","17",4301372,4302698,1326
"39932","ENSG00000261872","17",47169826,47171049,1223
"39933","ENSG00000261873","17",55448433,55511444,63011
"39934","ENSG00000261879","17",5192027,5248182,56155
"39935","ENSG00000261884","16",67929614,67936017,6403
"39936","ENSG00000261886","17",46916770,46923034,6264
"39937","ENSG00000261888","17",83104255,83106910,2655
"39938","ENSG00000261889","16",3156736,3157483,747
"39939","ENSG00000261898","17",4731756,4732371,615
"39940","ENSG00000261904","16",10720015,10721464,1449
"39941","ENSG00000261915","17",7312661,7319174,6513
"39942","ENSG00000261916","17",3601761,3602272,511
"39943","ENSG00000261924","17",80966239,80971213,4974
"39944","ENSG00000261934","5",141402932,141512979,110047
"39945","ENSG00000261939","16",19819504,19819628,124
"39946","ENSG00000261949","19",49423749,49428818,5069
"39947","ENSG00000261959","17",50163523,50165316,1793
"39948","ENSG00000261963","17",2724411,2749504,25093
"39949","ENSG00000261965","17",54477796,54478168,372
"39950","ENSG00000261970","6",79552794,79553160,366
"39951","ENSG00000261971","16",3037400,3059370,21970
"39952","ENSG00000261978","17",80023894,80026107,2213
"39953","ENSG00000261987","17",19166896,19169668,2772
"39954","ENSG00000261996","17",6653464,6655009,1545
"39955","ENSG00000261997","16",55538200,55542027,3827
"39956","ENSG00000262001","18",3603000,3608336,5336
"39957","ENSG00000262003","17",909632,911212,1580
"39958","ENSG00000262006","17",50909637,50910232,595
"39959","ENSG00000262008","16",71443055,71443856,801
"39960","ENSG00000262020","16",11066496,11071102,4606
"39961","ENSG00000262031","17",46909742,46911512,1770
"39962","ENSG00000262038","16",47529190,47529916,726
"39963","ENSG00000262039","17",49370740,49476988,106248
"39964","ENSG00000262049","17",81701324,81703300,1976
"39965","ENSG00000262050","17",2712309,2712833,524
"39966","ENSG00000262052","17",55842677,55872939,30262
"39967","ENSG00000262061","17",331205,333488,2283
"39968","ENSG00000262074","17",19063346,19064136,790
"39969","ENSG00000262075","9",136322303,136327323,5020
"39970","ENSG00000262079","17",55325757,55327791,2034
"39971","ENSG00000262085","17",3153889,3154882,993
"39972","ENSG00000262089","17",6994642,6995189,547
"39973","ENSG00000262094","17",83220527,83227721,7194
"39974","ENSG00000262096","5",141239923,141243034,3111
"39975","ENSG00000262097","16",14001320,14016056,14736
"39976","ENSG00000262098","17",81023545,81025503,1958
"39977","ENSG00000262099","17",5469092,5470360,1268
"39978","ENSG00000262115","17",81197393,81200288,2895
"39979","ENSG00000262116","16",13197606,13204907,7301
"39980","ENSG00000262117","16",11819829,11828845,9016
"39981","ENSG00000262118","16",3367719,3369246,1527
"39982","ENSG00000262119","14",26592747,26594517,1770
"39983","ENSG00000262120","16",71420483,71421518,1035
"39984","ENSG00000262133","17",877902,880093,2191
"39985","ENSG00000262135","17",55550931,55551649,718
"39986","ENSG00000262136","16",69727013,69742563,15550
"39987","ENSG00000262140","16",71833787,71835932,2145
"39988","ENSG00000262141","16",67855955,67856111,156
"39989","ENSG00000262147","17",82587313,82588411,1098
"39990","ENSG00000262151","16",10864914,10888752,23838
"39991","ENSG00000262152","16",2988256,3002016,13760
"39992","ENSG00000262154","16",2822659,2822993,334
"39993","ENSG00000262155","16",25066937,25088618,21681
"39994","ENSG00000262158","16",10723836,10724617,781
"39995","ENSG00000262165","17",4801159,4807013,5854
"39996","ENSG00000262171","16",15885029,15886158,1129
"39997","ENSG00000262172","17",79991944,79992841,897
"39998","ENSG00000262179","6",44216939,44218236,1297
"39999","ENSG00000262180","1",186401046,186401180,134
"40000","ENSG00000262181","18",45034,46047,1013
"40001","ENSG00000262185","16",3930806,3950586,19780
"40002","ENSG00000262187","16",32618733,32622184,3451
"40003","ENSG00000262188","17",79919357,79925999,6642
"40004","ENSG00000262198","13",22918591,22924602,6011
"40005","ENSG00000262202","17",19112000,19112636,636
"40006","ENSG00000262209","5",141370242,141512975,142733
"40007","ENSG00000262213","17",1241939,1254000,12061
"40008","ENSG00000262223","17",81375144,81385464,10320
"40009","ENSG00000262227","17",4987706,4988446,740
"40010","ENSG00000262228","17",763565,765319,1754
"40011","ENSG00000262231","17",6163893,6190541,26648
"40012","ENSG00000262235","16",13458326,13458698,372
"40013","ENSG00000262246","16",4354542,4425705,71163
"40014","ENSG00000262248","17",3619256,3619913,657
"40015","ENSG00000262262","17",18638019,18638370,351
"40016","ENSG00000262265","17",47160398,47167723,7325
"40017","ENSG00000262267","16",13728654,13779760,51106
"40018","ENSG00000262292","17",19160789,19162274,1485
"40019","ENSG00000262294","17",352638,357581,4943
"40020","ENSG00000262296","17",9647020,9647660,640
"40021","ENSG00000262298","17",56939932,56941275,1343
"40022","ENSG00000262302","17",7246829,7262089,15260
"40023","ENSG00000262304","17",3585149,3636249,51100
"40024","ENSG00000262312","16",3542739,3545785,3046
"40025","ENSG00000262313","17",80940418,80942033,1615
"40026","ENSG00000262316","16",3323192,3323925,733
"40027","ENSG00000262319","17",19141017,19143689,2672
"40028","ENSG00000262322","16",10721698,10723068,1370
"40029","ENSG00000262332","16",16223027,16224261,1234
"40030","ENSG00000262333","17",2306761,2307715,954
"40031","ENSG00000262339","17",82978525,82981738,3213
"40032","ENSG00000262343","17",79848058,79850110,2052
"40033","ENSG00000262352","18",11103,16352,5249
"40034","ENSG00000262358","17",3729361,3730493,1132
"40035","ENSG00000262362","16",3003431,3005101,1670
"40036","ENSG00000262366","16",31174573,31174822,249
"40037","ENSG00000262370","16",3076911,3087111,10200
"40038","ENSG00000262372","17",46035313,46035770,457
"40039","ENSG00000262380","16",15683290,15684570,1280
"40040","ENSG00000262381","16",10724620,10725296,676
"40041","ENSG00000262402","17",2127430,2127904,474
"40042","ENSG00000262406","11",102862736,102875034,12298
"40043","ENSG00000262408","17",56884639,56884819,180
"40044","ENSG00000262410","17",82745068,82745709,641
"40045","ENSG00000262412","10",27243130,27250804,7674
"40046","ENSG00000262420","16",11741910,11744506,2596
"40047","ENSG00000262429","17",4967995,4968822,827
"40048","ENSG00000262434","17",789744,790525,781
"40049","ENSG00000262445","17",1995614,2003671,8057
"40050","ENSG00000262454","16",14301389,14331067,29678
"40051","ENSG00000262461","7",73076165,73086038,9873
"40052","ENSG00000262468","16",4243943,4253817,9874
"40053","ENSG00000262470","16",14200357,14200979,622
"40054","ENSG00000262477","18",32412182,32413236,1054
"40055","ENSG00000262480","17",2613284,2613944,660
"40056","ENSG00000262481","17",7389734,7404097,14363
"40057","ENSG00000262482","16",2939714,2954276,14562
"40058","ENSG00000262484","19",38908980,38912158,3178
"40059","ENSG00000262488","16",10840384,10841544,1160
"40060","ENSG00000262492","17",7954868,7955622,754
"40061","ENSG00000262495","17",5060356,5062123,1767
"40062","ENSG00000262497","19",35232291,35233003,712
"40063","ENSG00000262500","17",46243606,46245044,1438
"40064","ENSG00000262503","17",6927472,6928191,719
"40065","ENSG00000262516","16",3840528,3841010,482
"40066","ENSG00000262519","17",4572206,4572515,309
"40067","ENSG00000262526","17",7240427,7244635,4208
"40068","ENSG00000262528","16",654611,656194,1583
"40069","ENSG00000262529","16",14191820,14200277,8457
"40070","ENSG00000262539","17",46259551,46260606,1055
"40071","ENSG00000262543","6",138377905,138383075,5170
"40072","ENSG00000262558","17",354737,356882,2145
"40073","ENSG00000262560","15",43772617,43799133,26516
"40074","ENSG00000262576","5",141355021,141512975,157954
"40075","ENSG00000262580","17",80200673,80205949,5276
"40076","ENSG00000262583","16",75499788,75516280,16492
"40077","ENSG00000262585","17",79915252,79926725,11473
"40078","ENSG00000262587","16",25031744,25058109,26365
"40079","ENSG00000262609","17",6322413,6323228,815
"40080","ENSG00000262619","13",22859050,22916369,57319
"40081","ENSG00000262621","16",3382113,3397745,15632
"40082","ENSG00000262623","17",56951664,56952404,740
"40083","ENSG00000262633","17",46923133,47049932,126799
"40084","ENSG00000262636","16",11380859,11381118,259
"40085","ENSG00000262652","17",82578023,82578616,593
"40086","ENSG00000262655","11",13962723,14268133,305410
"40087","ENSG00000262660","17",81703371,81720539,17168
"40088","ENSG00000262662","17",80960766,80961713,947
"40089","ENSG00000262663","17",82918282,82918785,503
"40090","ENSG00000262668","16",3188204,3224779,36575
"40091","ENSG00000262678","17",4986466,4987324,858
"40092","ENSG00000262681","17",19719059,19722428,3369
"40093","ENSG00000262686","16",4324667,4328340,3673
"40094","ENSG00000262691","16",67261108,67263784,2676
"40095","ENSG00000262692","17",3721628,3722488,860
"40096","ENSG00000262693","17",5075678,5078113,2435
"40097","ENSG00000262700","16",25093387,25095255,1868
"40098","ENSG00000262703","16",11348143,11349321,1178
"40099","ENSG00000262708","17",616002,616595,593
"40100","ENSG00000262712","16",4335870,4337818,1948
"40101","ENSG00000262714","16",53386944,53389085,2141
"40102","ENSG00000262728","15",32585524,32615158,29634
"40103","ENSG00000262730","17",7925931,7930622,4691
"40104","ENSG00000262732","16",13930677,13935635,4958
"40105","ENSG00000262759","17",50450179,50450725,546
"40106","ENSG00000262766","16",31118078,31118747,669
"40107","ENSG00000262768","17",79800598,79802529,1931
"40108","ENSG00000262769","17",19560111,19597922,37811
"40109","ENSG00000262772","17",79819083,79827704,8621
"40110","ENSG00000262777","17",1424473,1426484,2011
"40111","ENSG00000262801","16",13246232,13563388,317156
"40112","ENSG00000262803","6",70693839,70694619,780
"40113","ENSG00000262810","17",2089681,2101560,11879
"40114","ENSG00000262814","17",81703367,81707517,4150
"40115","ENSG00000262815","17",9464742,9467422,2680
"40116","ENSG00000262823","17",4481966,4486353,4387
"40117","ENSG00000262833","17",80801640,80805632,3992
"40118","ENSG00000262837","17",49834239,49836454,2215
"40119","ENSG00000262848","16",16290135,16292242,2107
"40120","ENSG00000262855","17",5126740,5127010,270
"40121","ENSG00000262869","17",2019952,2023664,3712
"40122","ENSG00000262870","17",77198950,77199543,593
"40123","ENSG00000262873","17",81017969,81028079,10110
"40124","ENSG00000262874","19",51388289,51390591,2302
"40125","ENSG00000262877","17",81388126,81390319,2193
"40126","ENSG00000262879","17",46983287,47100323,117036
"40127","ENSG00000262881","17",45907670,45910779,3109
"40128","ENSG00000262884","17",2962248,2965895,3647
"40129","ENSG00000262890","16",70802083,70802840,757
"40130","ENSG00000262898","17",83135734,83221442,85708
"40131","ENSG00000262902","17",53105734,53106358,624
"40132","ENSG00000262903","17",3655621,3658092,2471
"40133","ENSG00000262904","16",74667506,74668706,1200
"40134","ENSG00000262905","17",552566,553417,851
"40135","ENSG00000262919","X",153587925,153600045,12120
"40136","ENSG00000262920","17",321392,322453,1061
"40137","ENSG00000262943","17",6853861,6954107,100246
"40138","ENSG00000262950","16",49442910,49454109,11199
"40139","ENSG00000262953","17",2586330,2587866,1536
"40140","ENSG00000262959","16",2922662,2923202,540
"40141","ENSG00000262962","16",68002432,68004952,2520
"40142","ENSG00000262966","17",9171068,9179118,8050
"40143","ENSG00000262974","16",18533418,18533817,399
"40144","ENSG00000262979","17",80315651,80316633,982
"40145","ENSG00000262980","11",6057316,6058275,959
"40146","ENSG00000262983","16",21194847,21205977,11130
"40147","ENSG00000262995","16",20440266,20447000,6734
"40148","ENSG00000262999","16",11465260,11473174,7914
"40149","ENSG00000263001","7",74650231,74760692,110461
"40150","ENSG00000263002","19",44141554,44160313,18759
"40151","ENSG00000263004","17",57071814,57085024,13210
"40152","ENSG00000263006","18",109065,122219,13154
"40153","ENSG00000263011","16",3106764,3109576,2812
"40154","ENSG00000263015","17",503171,511347,8176
"40155","ENSG00000263017","17",959034,959366,332
"40156","ENSG00000263020","6",31666102,31673546,7444
"40157","ENSG00000263029","16",16260866,16261235,369
"40158","ENSG00000263033","16",11196177,11224969,28792
"40159","ENSG00000263041","10",117825894,117831244,5350
"40160","ENSG00000263045","17",18986148,18986334,186
"40161","ENSG00000263050","17",2043475,2044968,1493
"40162","ENSG00000263051","17",9547298,9548541,1243
"40163","ENSG00000263063","17",82713908,82716255,2347
"40164","ENSG00000263065","16",15741151,15741791,640
"40165","ENSG00000263069","17",80351828,80415168,63340
"40166","ENSG00000263072","16",3110460,3134882,24422
"40167","ENSG00000263080","16",11341809,11345211,3402
"40168","ENSG00000263081","7",75232928,75233924,996
"40169","ENSG00000263089","17",57092145,57096425,4280
"40170","ENSG00000263096","17",55271504,55273653,2149
"40171","ENSG00000263098","17",82795486,82796095,609
"40172","ENSG00000263105","16",4180117,4183515,3398
"40173","ENSG00000263107","17",19582116,19582275,159
"40174","ENSG00000263110","16",49454229,49457269,3040
"40175","ENSG00000263120","17",56982749,56985104,2355
"40176","ENSG00000263125","17",54754165,54754649,484
"40177","ENSG00000263126","16",67882461,67886367,3906
"40178","ENSG00000263142","17",46978481,47054569,76088
"40179","ENSG00000263146","18",78976555,78979074,2519
"40180","ENSG00000263154","17",81362272,81374214,11942
"40181","ENSG00000263155","15",57591904,57685364,93460
"40182","ENSG00000263159","16",4032012,4032936,924
"40183","ENSG00000263164","17",5240508,5241543,1035
"40184","ENSG00000263167","17",81135771,81136256,485
"40185","ENSG00000263176","17",50212933,50215357,2424
"40186","ENSG00000263177","16",3369957,3370906,949
"40187","ENSG00000263179","16",11242653,11243552,899
"40188","ENSG00000263189","17",53952936,53955324,2388
"40189","ENSG00000263201","16",68013436,68015911,2475
"40190","ENSG00000263206","17",19208584,19211359,2775
"40191","ENSG00000263207","16",55332355,55332967,612
"40192","ENSG00000263212","16",3458071,3515564,57493
"40193","ENSG00000263219","17",4222091,4223828,1737
"40194","ENSG00000263220","17",5364315,5371626,7311
"40195","ENSG00000263232","16",72005037,72006543,1506
"40196","ENSG00000263234","16",13953155,13954825,1670
"40197","ENSG00000263235","16",3650636,3651703,1067
"40198","ENSG00000263237","16",20385957,20391164,5207
"40199","ENSG00000263241","16",10718633,10719762,1129
"40200","ENSG00000263253","16",20208925,20209525,600
"40201","ENSG00000263257","16",14407668,14418908,11240
"40202","ENSG00000263264","19",7348943,7383385,34442
"40203","ENSG00000263266","17",28467822,28468406,584
"40204","ENSG00000263272","17",5425139,5432876,7737
"40205","ENSG00000263276","16",68224713,68227734,3021
"40206","ENSG00000263278","17",79598032,79603921,5889
"40207","ENSG00000263279","16",10691273,10692973,1700
"40208","ENSG00000263280","16",2866325,2868251,1926
"40209","ENSG00000263293","17",47303460,47323613,20153
"40210","ENSG00000263300","17",523140,540576,17436
"40211","ENSG00000263305","18",14195,16898,2703
"40212","ENSG00000263307","16",11851649,11895611,43962
"40213","ENSG00000263311","16",72004239,72004803,564
"40214","ENSG00000263312","17",3977103,3981899,4796
"40215","ENSG00000263316","17",6954098,6978960,24862
"40216","ENSG00000263317","17",52390515,52535701,145186
"40217","ENSG00000263321","17",82729164,82734143,4979
"40218","ENSG00000263325","16",2857898,2859726,1828
"40219","ENSG00000263326","16",25071490,25072727,1237
"40220","ENSG00000263327","4",16226685,16320140,93455
"40221","ENSG00000263331","16",21120758,21130108,9350
"40222","ENSG00000263335","16",15726674,15732993,6319
"40223","ENSG00000263338","17",3577955,3578853,898
"40224","ENSG00000263342","17",7282947,7284071,1124
"40225","ENSG00000263343","16",31165648,31165927,279
"40226","ENSG00000263345","17",2375061,2379306,4245
"40227","ENSG00000263353","1",120889746,120890405,659
"40228","ENSG00000263355","18",68455951,68456877,926
"40229","ENSG00000263360","16",82844455,82844757,302
"40230","ENSG00000263361","5",154829458,154829540,82
"40231","ENSG00000263363","2",226658710,226658793,83
"40232","ENSG00000263366","22",22114844,22118005,3161
"40233","ENSG00000263368","17",27526386,27527223,837
"40234","ENSG00000263369","17",32106330,32114125,7795
"40235","ENSG00000263370","17",29639627,29640825,1198
"40236","ENSG00000263372","8",41271048,41271143,95
"40237","ENSG00000263381","1",44545493,44545552,59
"40238","ENSG00000263382","18",26822341,26825171,2830
"40239","ENSG00000263388","17",10680734,10683988,3254
"40240","ENSG00000263389","11",36010098,36010204,106
"40241","ENSG00000263393","18",32122400,32124478,2078
"40242","ENSG00000263394","17",19091069,19091825,756
"40243","ENSG00000263396","18",1357651,1357942,291
"40244","ENSG00000263399","13",98208524,98208600,76
"40245","ENSG00000263400","17",10729777,10815164,85387
"40246","ENSG00000263403","9",136519568,136519626,58
"40247","ENSG00000263407","8",9048445,9048518,73
"40248","ENSG00000263409","19",4932687,4932740,53
"40249","ENSG00000263410","X",77885377,77885634,257
"40250","ENSG00000263412","17",48045141,48048073,2932
"40251","ENSG00000263413","14",105858165,105858242,77
"40252","ENSG00000263417","18",70630534,70650744,20210
"40253","ENSG00000263426","6",28977475,28977773,298
"40254","ENSG00000263427","17",8056225,8057621,1396
"40255","ENSG00000263429","17",10794913,10804099,9186
"40256","ENSG00000263432","5",123022487,123022783,296
"40257","ENSG00000263435","17",33976531,33980851,4320
"40258","ENSG00000263436","10",101601417,101601497,80
"40259","ENSG00000263438","18",53568439,53629990,61551
"40260","ENSG00000263439","1",235190034,235190116,82
"40261","ENSG00000263443","8",122700269,122703423,3154
"40262","ENSG00000263445","4",76573568,76573632,64
"40263","ENSG00000263450","18",32954075,32957998,3923
"40264","ENSG00000263460","18",3415145,3415580,435
"40265","ENSG00000263464","1",149583865,149584464,599
"40266","ENSG00000263465","11",95067197,95071224,4027
"40267","ENSG00000263466","17",38903704,38904600,896
"40268","ENSG00000263468","2",206783234,206783308,74
"40269","ENSG00000263477","17",29863402,29866092,2690
"40270","ENSG00000263482","10",46233885,46273557,39672
"40271","ENSG00000263485","17",34080882,34082224,1342
"40272","ENSG00000263489","17",63972920,63989422,16502
"40273","ENSG00000263490","19",18631646,18631908,262
"40274","ENSG00000263494","17",20185082,20322973,137891
"40275","ENSG00000263499","17",57600856,57608412,7556
"40276","ENSG00000263501","17",63305262,63313521,8259
"40277","ENSG00000263503","17",45600869,45602340,1471
"40278","ENSG00000263508","17",10844674,10880895,36221
"40279","ENSG00000263511","10",641689,641778,89
"40280","ENSG00000263512","15",66040233,66040332,99
"40281","ENSG00000263513","1",143955364,143971965,16601
"40282","ENSG00000263514","6",140205252,140205326,74
"40283","ENSG00000263515","X",106639814,106639896,82
"40284","ENSG00000263526","1",94745860,94745900,40
"40285","ENSG00000263528","1",206470476,206496889,26413
"40286","ENSG00000263529","1",32457835,32458135,300
"40287","ENSG00000263531","17",30863921,30864940,1019
"40288","ENSG00000263535","17",31345519,31346190,671
"40289","ENSG00000263537","12",110625645,110625917,272
"40290","ENSG00000263540","11",46753125,46753192,67
"40291","ENSG00000263547","18",76122968,76145259,22291
"40292","ENSG00000263551","18",976589,1310018,333429
"40293","ENSG00000263556","5",44716193,44716486,293
"40294","ENSG00000263558","17",59059226,59059493,267
"40295","ENSG00000263563","17",22090743,22205154,114411
"40296","ENSG00000263567","17",31762440,31769048,6608
"40297","ENSG00000263571","17",34155566,34165736,10170
"40298","ENSG00000263573","3",15496239,15496308,69
"40299","ENSG00000263574","17",73737854,73756932,19078
"40300","ENSG00000263575","9",6007826,6007904,78
"40301","ENSG00000263581","13",65966330,65966429,99
"40302","ENSG00000263584","10",12578753,12578823,70
"40303","ENSG00000263586","17",74970704,74975728,5024
"40304","ENSG00000263588","18",22088060,22098780,10720
"40305","ENSG00000263590","1",143790010,143797108,7098
"40306","ENSG00000263594","18",67672221,67767051,94830
"40307","ENSG00000263595","19",16910490,16910784,294
"40308","ENSG00000263597","5",132365490,132365599,109
"40309","ENSG00000263603","17",30729469,30731202,1733
"40310","ENSG00000263606","18",2945550,2946890,1340
"40311","ENSG00000263608","6",30751038,30751289,251
"40312","ENSG00000263609","17",22233926,22266392,32466
"40313","ENSG00000263611","18",27375310,27401910,26600
"40314","ENSG00000263612","8",144713899,144714845,946
"40315","ENSG00000263613","17",29009799,29011009,1210
"40316","ENSG00000263618","18",14903580,14915628,12048
"40317","ENSG00000263624","17",17167946,17185554,17608
"40318","ENSG00000263627","18",9615264,9619363,4099
"40319","ENSG00000263628","10",6152196,6152277,81
"40320","ENSG00000263631","4",5923275,5923328,53
"40321","ENSG00000263635","18",15075445,15122767,47322
"40322","ENSG00000263637","18",68753179,68754583,1404
"40323","ENSG00000263639","10",46033307,46048180,14873
"40324","ENSG00000263641","2",231362708,231362793,85
"40325","ENSG00000263642","4",40502040,40502119,79
"40326","ENSG00000263643","15",83067335,83067415,80
"40327","ENSG00000263644","17",63391191,63431089,39898
"40328","ENSG00000263647","17",64761912,64762710,798
"40329","ENSG00000263648","17",12115547,12115885,338
"40330","ENSG00000263655","18",73914405,74034161,119756
"40331","ENSG00000263657","17",29761103,29787836,26733
"40332","ENSG00000263666","16",71698567,71698701,134
"40333","ENSG00000263667","6",181466,205519,24053
"40334","ENSG00000263669","2",70075014,70075272,258
"40335","ENSG00000263672","7",100821027,100821264,237
"40336","ENSG00000263674","17",32280387,32280953,566
"40337","ENSG00000263675","1",37500935,37500994,59
"40338","ENSG00000263676","1",12191713,12191773,60
"40339","ENSG00000263680","17",72425939,72428852,2913
"40340","ENSG00000263681","21",41167557,41167629,72
"40341","ENSG00000263684","17",11874727,11881670,6943
"40342","ENSG00000263688","18",32581528,32582828,1300
"40343","ENSG00000263693","11",48096782,48096858,76
"40344","ENSG00000263698","18",31131456,31132494,1038
"40345","ENSG00000263708","17",9283174,9305651,22477
"40346","ENSG00000263709","17",29140483,29155489,15006
"40347","ENSG00000263711","18",73151241,73264480,113239
"40348","ENSG00000263712","6",16141556,16141624,68
"40349","ENSG00000263715","17",45620344,45835826,215482
"40350","ENSG00000263717","17",32512869,32519350,6481
"40351","ENSG00000263718","17",77257737,77281897,24160
"40352","ENSG00000263723","2",237869904,237869982,78
"40353","ENSG00000263724","18",3878058,3897069,19011
"40354","ENSG00000263727","18",653985,657259,3274
"40355","ENSG00000263731","17",81878425,81881106,2681
"40356","ENSG00000263740","3",15738515,15738809,294
"40357","ENSG00000263742","11",72072228,72072302,74
"40358","ENSG00000263745","18",1883524,2489426,605902
"40359","ENSG00000263746","5",1708785,1708868,83
"40360","ENSG00000263748","18",21182503,21183499,996
"40361","ENSG00000263752","2",241477905,241477982,77
"40362","ENSG00000263753","18",5237826,5290608,52782
"40363","ENSG00000263755","20",6001733,6002030,297
"40364","ENSG00000263761","10",47322490,47326270,3780
"40365","ENSG00000263762","8",10666978,10667070,92
"40366","ENSG00000263765","18",32833454,32938316,104862
"40367","ENSG00000263766","17",47603860,47649420,45560
"40368","ENSG00000263781","17",29021325,29021640,315
"40369","ENSG00000263783","2",134857820,134857873,53
"40370","ENSG00000263786","17",75145261,75146546,1285
"40371","ENSG00000263787","17",48185938,48204529,18591
"40372","ENSG00000263793","1",23044305,23044372,67
"40373","ENSG00000263794","8",33715784,33716070,286
"40374","ENSG00000263797","18",6873399,6875024,1625
"40375","ENSG00000263800","19",12787128,12787192,64
"40376","ENSG00000263809","17",8368638,8383187,14549
"40377","ENSG00000263815","17",21229334,21229628,294
"40378","ENSG00000263816","9",132945707,132945771,64
"40379","ENSG00000263818","17",39057019,39113190,56171
"40380","ENSG00000263821","18",14978739,14979839,1100
"40381","ENSG00000263823","18",31942575,31944156,1581
"40382","ENSG00000263826","3",186781780,186784179,2399
"40383","ENSG00000263829","18",26255698,26256355,657
"40384","ENSG00000263831","5",170028488,170028566,78
"40385","ENSG00000263834","5",1062896,1062974,78
"40386","ENSG00000263838","12",47187812,47187891,79
"40387","ENSG00000263841","1",153500463,153500764,301
"40388","ENSG00000263843","17",75271369,75273895,2526
"40389","ENSG00000263846","18",26599408,26600338,930
"40390","ENSG00000263847","18",9112404,9115877,3473
"40391","ENSG00000263857","17",59366083,59366154,71
"40392","ENSG00000263858","X",47587429,47587505,76
"40393","ENSG00000263860","17",30550493,30551189,696
"40394","ENSG00000263862","18",26421139,26438041,16902
"40395","ENSG00000263874","17",38925168,38929384,4216
"40396","ENSG00000263878","18",3962353,4024150,61797
"40397","ENSG00000263882","17",4364164,4364453,289
"40398","ENSG00000263883","17",63636601,63637113,512
"40399","ENSG00000263884","18",268148,270278,2130
"40400","ENSG00000263885","11",101519820,101519905,85
"40401","ENSG00000263893","17",72642731,72644490,1759
"40402","ENSG00000263895","18",49431744,49447420,15676
"40403","ENSG00000263897","9",134379411,134379472,61
"40404","ENSG00000263904","18",32245946,32249032,3086
"40405","ENSG00000263905","20",3094171,3094509,338
"40406","ENSG00000263908","1",62078786,62078859,73
"40407","ENSG00000263909","2",75090812,75090914,102
"40408","ENSG00000263914","17",22525899,22526937,1038
"40409","ENSG00000263916","18",49484536,49486149,1613
"40410","ENSG00000263923","4",98928897,98994994,66097
"40411","ENSG00000263924","18",31844388,31845178,790
"40412","ENSG00000263934","17",19188016,19188714,698
"40413","ENSG00000263935","18",8688022,8688410,388
"40414","ENSG00000263938","17",58965952,58966727,775
"40415","ENSG00000263940","4",110117736,110118070,334
"40416","ENSG00000263941","2",233205199,233205479,280
"40417","ENSG00000263944","11",59291052,59291333,281
"40418","ENSG00000263946","17",20554971,20559410,4439
"40419","ENSG00000263952","18",10893617,10908783,15166
"40420","ENSG00000263955","16",4633591,4633881,290
"40421","ENSG00000263956","1",148102046,148152322,50276
"40422","ENSG00000263958","18",72868388,72881399,13011
"40423","ENSG00000263961","1",206053173,206102449,49276
"40424","ENSG00000263968","16",85659378,85659675,297
"40425","ENSG00000263969","21",37215605,37215903,298
"40426","ENSG00000263970","18",8406761,8406953,192
"40427","ENSG00000263974","19",2595019,2595291,272
"40428","ENSG00000263976","17",20491323,20491443,120
"40429","ENSG00000263978","13",20433778,20433846,68
"40430","ENSG00000263979","9",127869415,127869495,80
"40431","ENSG00000263982","18",76372717,76378275,5558
"40432","ENSG00000263987","1",154104521,154104592,71
"40433","ENSG00000263988","3",11952788,11953085,297
"40434","ENSG00000263989","20",41290280,41290577,297
"40435","ENSG00000263990","17",31873926,31886666,12740
"40436","ENSG00000263993","11",75742129,75742426,297
"40437","ENSG00000263999","11",59214406,59214699,293
"40438","ENSG00000264000","18",5567130,5570942,3812
"40439","ENSG00000264006","10",5154140,5185187,31047
"40440","ENSG00000264007","17",29621617,29622254,637
"40441","ENSG00000264010","2",11540605,11540677,72
"40442","ENSG00000264012","18",22175465,22176662,1197
"40443","ENSG00000264013","3",55852492,55852594,102
"40444","ENSG00000264014","1",22863159,22863226,67
"40445","ENSG00000264015","18",77421619,77561044,139425
"40446","ENSG00000264016","17",10741257,10769089,27832
"40447","ENSG00000264017","6",89090946,89091242,296
"40448","ENSG00000264024","14",105858124,105858175,51
"40449","ENSG00000264026","17",72342692,72355136,12444
"40450","ENSG00000264028","12",54344610,54344876,266
"40451","ENSG00000264029","17",28274657,28275716,1059
"40452","ENSG00000264030","2",10280628,10280891,263
"40453","ENSG00000264031","17",29560547,29707090,146543
"40454","ENSG00000264036","10",12328132,12328389,257
"40455","ENSG00000264041","2",203259604,203259897,293
"40456","ENSG00000264044","17",28633206,28635950,2744
"40457","ENSG00000264047","2",43904412,43904693,281
"40458","ENSG00000264049","17",60043025,60043105,80
"40459","ENSG00000264050","17",29197071,29197785,714
"40460","ENSG00000264056","6",53276993,53277071,78
"40461","ENSG00000264057","17",64927634,64934203,6569
"40462","ENSG00000264058","17",40627356,40665141,37785
"40463","ENSG00000264066","17",28861072,28861966,894
"40464","ENSG00000264067","17",10320392,10341458,21066
"40465","ENSG00000264069","7",43150895,43150994,99
"40466","ENSG00000264070","17",45585871,45586929,1058
"40467","ENSG00000264071","2",43492032,43492313,281
"40468","ENSG00000264072","18",10627646,10628846,1200
"40469","ENSG00000264078","1",31644694,31649371,4677
"40470","ENSG00000264080","18",1780329,1782064,1735
"40471","ENSG00000264083","17",32430967,32432841,1874
"40472","ENSG00000264092","8",16863196,16863496,300
"40473","ENSG00000264093","17",67276118,67276351,233
"40474","ENSG00000264099","5",72169467,72169540,73
"40475","ENSG00000264101","1",5862672,5862741,69
"40476","ENSG00000264105","4",159128802,159128894,92
"40477","ENSG00000264107","17",31090787,31095450,4663
"40478","ENSG00000264112","17",57989039,57994850,5811
"40479","ENSG00000264113","17",4882975,4883316,341
"40480","ENSG00000264116","18",75407012,75426607,19595
"40481","ENSG00000264125","17",30204318,30206468,2150
"40482","ENSG00000264127","18",6926944,6928210,1266
"40483","ENSG00000264138","17",28848860,28849592,732
"40484","ENSG00000264141","22",31160062,31160119,57
"40485","ENSG00000264145","1",143449571,143450245,674
"40486","ENSG00000264148","17",31008154,31008319,165
"40487","ENSG00000264149","18",21871446,21893996,22550
"40488","ENSG00000264151","18",27335968,27595164,259196
"40489","ENSG00000264157","2",96798278,96798353,75
"40490","ENSG00000264158","9",92527984,92528058,74
"40491","ENSG00000264160","22",45760524,45760598,74
"40492","ENSG00000264163","9",134850125,134850272,147
"40493","ENSG00000264164","17",32083179,32097065,13886
"40494","ENSG00000264169","9",130400266,130400565,299
"40495","ENSG00000264174","17",34725509,34726170,661
"40496","ENSG00000264175","19",18386562,18386634,72
"40497","ENSG00000264176","17",10716002,10716511,509
"40498","ENSG00000264177","17",18379855,18388984,9129
"40499","ENSG00000264179","18",856526,857045,519
"40500","ENSG00000264186","18",2990652,2991078,426
"40501","ENSG00000264187","17",17202649,17237185,34536
"40502","ENSG00000264188","18",21661787,21662395,608
"40503","ENSG00000264196","17",72839039,72839718,679
"40504","ENSG00000264201","12",48771975,48772037,62
"40505","ENSG00000264204","10",46109621,46131358,21737
"40506","ENSG00000264207","1",149861271,149862504,1233
"40507","ENSG00000264210","15",49169070,49169153,83
"40508","ENSG00000264212","18",76256891,76258337,1446
"40509","ENSG00000264215","17",20788071,20789584,1513
"40510","ENSG00000264217","10",45940522,45940851,329
"40511","ENSG00000264226","13",41101019,41101100,81
"40512","ENSG00000264229","2",121530881,121531007,126
"40513","ENSG00000264230","10",46375627,46391784,16157
"40514","ENSG00000264232","18",65423958,65448167,24209
"40515","ENSG00000264235","18",3255436,3261850,6414
"40516","ENSG00000264236","18",68992718,68993375,657
"40517","ENSG00000264243","17",47863342,47865190,1848
"40518","ENSG00000264247","18",74590317,74598885,8568
"40519","ENSG00000264249","5",171386656,171386760,104
"40520","ENSG00000264250","19",16907462,16907723,261
"40521","ENSG00000264251","17",44718861,44719130,269
"40522","ENSG00000264254","18",5310396,5317664,7268
"40523","ENSG00000264260","18",76209422,76221718,12296
"40524","ENSG00000264262","17",22676695,22692618,15923
"40525","ENSG00000264265","18",508568,515294,6726
"40526","ENSG00000264266","19",10230413,10230485,72
"40527","ENSG00000264268","X",7147860,7147937,77
"40528","ENSG00000264269","18",49023703,49048474,24771
"40529","ENSG00000264270","17",75683543,75684799,1256
"40530","ENSG00000264271","1",63529613,63529898,285
"40531","ENSG00000264272","17",74256896,74262020,5124
"40532","ENSG00000264273","17",18859354,18861466,2112
"40533","ENSG00000264274","4",147782595,147782668,73
"40534","ENSG00000264275","2",202333439,202333728,289
"40535","ENSG00000264278","18",76794732,76822295,27563
"40536","ENSG00000264279","2",239943015,239943094,79
"40537","ENSG00000264281","5",55944656,55944733,77
"40538","ENSG00000264290","17",29569580,29570519,939
"40539","ENSG00000264292","2",239351724,239351804,80
"40540","ENSG00000264295","12",104591633,104591716,83
"40541","ENSG00000264296","18",54142133,54142577,444
"40542","ENSG00000264297","2",64340747,64340848,101
"40543","ENSG00000264300","17",32003110,32006688,3578
"40544","ENSG00000264301","18",14969001,14970468,1467
"40545","ENSG00000264304","17",28892469,28893342,873
"40546","ENSG00000264309","11",19760004,19760083,79
"40547","ENSG00000264311","18",10623876,10624305,429
"40548","ENSG00000264313","10",92659044,92659302,258
"40549","ENSG00000264314","17",42494773,42494830,57
"40550","ENSG00000264316","17",22530612,22531392,780
"40551","ENSG00000264317","19",34421988,34422311,323
"40552","ENSG00000264319","4",37241910,37241991,81
"40553","ENSG00000264322","17",60899891,60900185,294
"40554","ENSG00000264324","2",74211604,74363377,151773
"40555","ENSG00000264334","18",77983020,77986610,3590
"40556","ENSG00000264340","18",74561381,74562100,719
"40557","ENSG00000264343","1",146146203,146229026,82823
"40558","ENSG00000264345","18",24932771,24987919,55148
"40559","ENSG00000264349","1",154975693,154975783,90
"40560","ENSG00000264350","18",54406889,54407114,225
"40561","ENSG00000264352","2",34809233,34809556,323
"40562","ENSG00000264354","3",15697298,15697371,73
"40563","ENSG00000264357","7",2527074,2527145,71
"40564","ENSG00000264358","1",212077613,212077685,72
"40565","ENSG00000264359","17",16666107,16667118,1011
"40566","ENSG00000264364","17",58083419,58095542,12123
"40567","ENSG00000264365","18",24364787,24367984,3197
"40568","ENSG00000264370","2",12737367,12737444,77
"40569","ENSG00000264371","1",25023503,25023586,83
"40570","ENSG00000264373","17",32434939,32435028,89
"40571","ENSG00000264384","1",154166245,154166549,304
"40572","ENSG00000264386","15",74788672,74788757,85
"40573","ENSG00000264388","18",71588537,71588884,347
"40574","ENSG00000264391","5",76836900,76837195,295
"40575","ENSG00000264395","20",31607186,31607240,54
"40576","ENSG00000264397","16",2135977,2136129,152
"40577","ENSG00000264400","19",35414881,35415149,268
"40578","ENSG00000264404","10",47588681,47619480,30799
"40579","ENSG00000264421","17",67224303,67225541,1238
"40580","ENSG00000264422","17",20576667,20578748,2081
"40581","ENSG00000264423","19",41190927,41191229,302
"40582","ENSG00000264424","17",10443290,10469559,26269
"40583","ENSG00000264425","7",101159473,101159555,82
"40584","ENSG00000264429","17",1022476,1022559,83
"40585","ENSG00000264434","18",25302126,25302960,834
"40586","ENSG00000264438","9",128709780,128710043,263
"40587","ENSG00000264443","1",24538802,24556024,17222
"40588","ENSG00000264444","18",68866517,68867028,511
"40589","ENSG00000264448","8",93915734,93916682,948
"40590","ENSG00000264449","18",5887487,5989369,101882
"40591","ENSG00000264451","17",48460370,48466040,5670
"40592","ENSG00000264456","17",30971652,30973312,1660
"40593","ENSG00000264458","17",32627739,32686484,58745
"40594","ENSG00000264464","18",49499390,49501860,2470
"40595","ENSG00000264468","17",6655440,6655509,69
"40596","ENSG00000264472","18",68899781,68902255,2474
"40597","ENSG00000264475","18",7076817,7080123,3306
"40598","ENSG00000264480","15",98784426,98784502,76
"40599","ENSG00000264483","1",227941590,227941683,93
"40600","ENSG00000264484","X",154495815,154496113,298
"40601","ENSG00000264486","17",28256438,28265551,9113
"40602","ENSG00000264488","17",40803744,40809296,5552
"40603","ENSG00000264490","20",62575590,62577507,1917
"40604","ENSG00000264491","17",67019934,67021743,1809
"40605","ENSG00000264493","11",1859464,1859536,72
"40606","ENSG00000264494","7",72697903,72697978,75
"40607","ENSG00000264513","17",63117019,63130947,13928
"40608","ENSG00000264514","18",316737,319165,2428
"40609","ENSG00000264515","19",29287011,29525752,238741
"40610","ENSG00000264519","11",63797784,63798071,287
"40611","ENSG00000264520","7",30525731,30533613,7882
"40612","ENSG00000264522","1",149937812,150010726,72914
"40613","ENSG00000264525","2",66358249,66358328,79
"40614","ENSG00000264529","17",63182166,63182817,651
"40615","ENSG00000264530","9",6542094,6542353,259
"40616","ENSG00000264534","3",10330229,10330285,56
"40617","ENSG00000264536","5",119154637,119154716,79
"40618","ENSG00000264538","17",30709299,30790908,81609
"40619","ENSG00000264539","13",114244505,114244561,56
"40620","ENSG00000264540","17",44883986,44884274,288
"40621","ENSG00000264545","9",21802636,22029594,226958
"40622","ENSG00000264546","17",62549726,62552121,2395
"40623","ENSG00000264548","17",82214227,82217352,3125
"40624","ENSG00000264563","5",129097688,129097766,78
"40625","ENSG00000264564","18",54525434,54525563,129
"40626","ENSG00000264566","X",20017088,20017187,99
"40627","ENSG00000264569","17",82037905,82039380,1475
"40628","ENSG00000264570","18",14629832,14632806,2974
"40629","ENSG00000264571","18",55479221,55479298,77
"40630","ENSG00000264572","10",125032783,125032870,87
"40631","ENSG00000264573","X",41345576,41345876,300
"40632","ENSG00000264575","18",5236724,5238598,1874
"40633","ENSG00000264577","17",28721487,28722877,1390
"40634","ENSG00000264580","21",42950928,42951014,86
"40635","ENSG00000264582","1",40804846,40805141,295
"40636","ENSG00000264583","11",47400970,47401042,72
"40637","ENSG00000264585","4",52712682,52712747,65
"40638","ENSG00000264587","18",29518259,29548241,29982
"40639","ENSG00000264589","17",45799390,45895680,96290
"40640","ENSG00000264592","1",36191915,36192170,255
"40641","ENSG00000264595","18",76227990,76233387,5397
"40642","ENSG00000264596","18",7814118,7815730,1612
"40643","ENSG00000264603","11",18387787,18387860,73
"40644","ENSG00000264608","17",28601827,28602284,457
"40645","ENSG00000264610","10",98431292,98431360,68
"40646","ENSG00000264613","1",51995740,51996039,299
"40647","ENSG00000264615","9",2228961,2229241,280
"40648","ENSG00000264616","20",34049119,34049190,71
"40649","ENSG00000264617","17",21655843,21657633,1790
"40650","ENSG00000264618","X",39786524,39786823,299
"40651","ENSG00000264622","17",34837871,34859046,21175
"40652","ENSG00000264623","3",114743445,114743525,80
"40653","ENSG00000264630","17",66398069,66416854,18785
"40654","ENSG00000264634","18",67940949,67956426,15477
"40655","ENSG00000264635","18",738058,739662,1604
"40656","ENSG00000264638","9",18573306,18573379,73
"40657","ENSG00000264647","17",29591703,29592241,538
"40658","ENSG00000264653","8",130008334,130008453,119
"40659","ENSG00000264655","17",40367952,40368438,486
"40660","ENSG00000264659","17",74670077,74677624,7547
"40661","ENSG00000264660","17",20963722,20980238,16516
"40662","ENSG00000264663","17",39835037,39836080,1043
"40663","ENSG00000264666","17",17591428,17610485,19057
"40664","ENSG00000264668","8",143247110,143276403,29293
"40665","ENSG00000264672","17",58519837,58557799,37962
"40666","ENSG00000264673","17",16788248,16789234,986
"40667","ENSG00000264675","7",102293103,102293187,84
"40668","ENSG00000264676","2",236072295,236072556,261
"40669","ENSG00000264678","4",152489327,152489416,89
"40670","ENSG00000264685","18",66068750,66069647,897
"40671","ENSG00000264695","18",24489375,24491080,1705
"40672","ENSG00000264699","18",68258080,68264827,6747
"40673","ENSG00000264701","17",47980398,47996196,15798
"40674","ENSG00000264705","18",69212277,69214350,2073
"40675","ENSG00000264706","3",49863375,49863660,285
"40676","ENSG00000264707","18",6256747,6260934,4187
"40677","ENSG00000264712","14",50299855,50299946,91
"40678","ENSG00000264714","18",10724619,10728539,3920
"40679","ENSG00000264717","10",47918739,47923524,4785
"40680","ENSG00000264720","1",66628440,66628517,77
"40681","ENSG00000264727","17",11288205,11290811,2606
"40682","ENSG00000264729","17",16804627,16805707,1080
"40683","ENSG00000264733","16",12720321,12720371,50
"40684","ENSG00000264734","17",26989189,26999941,10752
"40685","ENSG00000264735","17",81965632,81966589,957
"40686","ENSG00000264736","18",77435253,77437242,1989
"40687","ENSG00000264737","15",65719246,65719332,86
"40688","ENSG00000264739","17",16414524,16416689,2165
"40689","ENSG00000264743","17",30975387,30975954,567
"40690","ENSG00000264745","18",23994213,24015339,21126
"40691","ENSG00000264750","17",73641026,73643106,2080
"40692","ENSG00000264754","17",67524481,67525422,941
"40693","ENSG00000264755","2",219058688,219058750,62
"40694","ENSG00000264763","10",112634170,112634254,84
"40695","ENSG00000264764","2",102432289,102432366,77
"40696","ENSG00000264765","17",16653904,16654787,883
"40697","ENSG00000264767","20",38098414,38098700,286
"40698","ENSG00000264769","17",81922899,81924511,1612
"40699","ENSG00000264772","17",7572826,7582024,9198
"40700","ENSG00000264773","1",30739156,30739232,76
"40701","ENSG00000264775","18",5002759,5003254,495
"40702","ENSG00000264781","14",105859484,105859553,69
"40703","ENSG00000264785","17",19737682,19738542,860
"40704","ENSG00000264790","18",27343252,27346110,2858
"40705","ENSG00000264792","5",14825929,14826012,83
"40706","ENSG00000264796","15",89883931,89884030,99
"40707","ENSG00000264800","10",48985512,48985587,75
"40708","ENSG00000264801","9",21929457,21931073,1616
"40709","ENSG00000264802","1",201719508,201719627,119
"40710","ENSG00000264808","17",29369717,29390777,21060
"40711","ENSG00000264809","1",178484408,178484682,274
"40712","ENSG00000264810","2",239085827,239085926,99
"40713","ENSG00000264812","17",82400703,82401382,679
"40714","ENSG00000264813","17",63484823,63521848,37025
"40715","ENSG00000264814","6",154853360,154853436,76
"40716","ENSG00000264825","18",22213778,22228029,14251
"40717","ENSG00000264829","17",75679474,75679967,493
"40718","ENSG00000264833","2",119169822,119170115,293
"40719","ENSG00000264834","1",52928674,52928772,98
"40720","ENSG00000264837","17",27057399,27058221,822
"40721","ENSG00000264840","17",64871504,64871784,280
"40722","ENSG00000264843","18",10704297,10709599,5302
"40723","ENSG00000264845","18",69469517,69471736,2219
"40724","ENSG00000264853","17",75370947,75373736,2789
"40725","ENSG00000264857","2",101309450,101309534,84
"40726","ENSG00000264859","18",31542146,31556948,14802
"40727","ENSG00000264860","17",73164977,73196593,31616
"40728","ENSG00000264862","17",31518432,31518729,297
"40729","ENSG00000264864","13",49996415,49996501,86
"40730","ENSG00000264869","18",68102087,68114878,12791
"40731","ENSG00000264876","18",10321380,10372387,51007
"40732","ENSG00000264879","20",20316755,20316994,239
"40733","ENSG00000264880","18",15159724,15164467,4743
"40734","ENSG00000264881","1",10227718,10227803,85
"40735","ENSG00000264895","17",51249579,51251748,2169
"40736","ENSG00000264901","20",47166967,47167058,91
"40737","ENSG00000264907","17",62841101,62841645,544
"40738","ENSG00000264910","19",58543299,58543578,279
"40739","ENSG00000264911","18",26348347,26349004,657
"40740","ENSG00000264914","17",57912333,57922581,10248
"40741","ENSG00000264916","1",179900262,179900564,302
"40742","ENSG00000264920","17",47891229,47895812,4583
"40743","ENSG00000264922","9",36864254,36864308,54
"40744","ENSG00000264924","18",24113637,24121003,7366
"40745","ENSG00000264932","17",19649373,19649935,562
"40746","ENSG00000264933","X",123811331,123811587,256
"40747","ENSG00000264934","2",109141490,109141588,98
"40748","ENSG00000264937","15",64696622,64696861,239
"40749","ENSG00000264941","9",20502265,20502342,77
"40750","ENSG00000264943","17",30624413,30625494,1081
"40751","ENSG00000264947","16",50742305,50742377,72
"40752","ENSG00000264954","17",63995418,63999899,4481
"40753","ENSG00000264956","17",22266395,22288301,21906
"40754","ENSG00000264958","17",30529688,30542416,12728
"40755","ENSG00000264961","17",80419418,80419493,75
"40756","ENSG00000264963","1",94150738,94151080,342
"40757","ENSG00000264964","18",9310522,9334445,23923
"40758","ENSG00000264966","15",89850637,89850721,84
"40759","ENSG00000264968","17",39927742,39939601,11859
"40760","ENSG00000264970","17",22671433,22706703,35270
"40761","ENSG00000264971","18",49469803,49470223,420
"40762","ENSG00000264978","12",93831076,93831372,296
"40763","ENSG00000264984","11",9090312,9090379,67
"40764","ENSG00000264985","17",73513469,73521407,7938
"40765","ENSG00000264990","17",34176538,34178166,1628
"40766","ENSG00000264994","2",28913664,28913748,84
"40767","ENSG00000264999","17",46973017,46973100,83
"40768","ENSG00000265000","17",62808500,62836371,27871
"40769","ENSG00000265008","18",32091295,32092119,824
"40770","ENSG00000265010","17",73243093,73244706,1613
"40771","ENSG00000265015","18",15196999,15197775,776
"40772","ENSG00000265018","10",48009873,48031640,21767
"40773","ENSG00000265031","17",64425069,64425170,101
"40774","ENSG00000265033","X",49152651,49152944,293
"40775","ENSG00000265041","17",27666749,27672803,6054
"40776","ENSG00000265043","17",21456513,21460215,3702
"40777","ENSG00000265046","17",31830731,31831750,1019
"40778","ENSG00000265052","17",67977698,67977972,274
"40779","ENSG00000265055","17",68096046,68101496,5450
"40780","ENSG00000265073","17",28732963,28743102,10139
"40781","ENSG00000265078","3",48094801,48095105,304
"40782","ENSG00000265083","6",5148233,5148322,89
"40783","ENSG00000265091","18",5232876,5238526,5650
"40784","ENSG00000265092","10",125819740,125819822,82
"40785","ENSG00000265093","12",45874035,45874330,295
"40786","ENSG00000265094","18",24435364,24439638,4274
"40787","ENSG00000265095","17",16391434,16391882,448
"40788","ENSG00000265096","17",79018131,79027673,9542
"40789","ENSG00000265099","17",20938023,20938344,321
"40790","ENSG00000265100","17",68246629,68247938,1309
"40791","ENSG00000265101","18",78925064,78927441,2377
"40792","ENSG00000265102","15",35372256,35372364,108
"40793","ENSG00000265107","1",147756199,147773362,17163
"40794","ENSG00000265110","17",15251627,15251696,69
"40795","ENSG00000265112","9",89312225,89312306,81
"40796","ENSG00000265113","16",69240549,69241929,1380
"40797","ENSG00000265115","17",33627027,33635057,8030
"40798","ENSG00000265118","17",31305213,31318831,13618
"40799","ENSG00000265121","17",77264180,77264776,596
"40800","ENSG00000265123","6",34685355,34685642,287
"40801","ENSG00000265125","17",33565764,33624122,58358
"40802","ENSG00000265126","17",19411786,19413118,1332
"40803","ENSG00000265128","18",49116301,49126479,10178
"40804","ENSG00000265135","5",55508850,55508926,76
"40805","ENSG00000265136","17",82576616,82577391,775
"40806","ENSG00000265137","20",18470615,18470691,76
"40807","ENSG00000265139","17",32328441,32329395,954
"40808","ENSG00000265141","1",8979576,8979874,298
"40809","ENSG00000265142","18",21825487,21831539,6052
"40810","ENSG00000265144","X",16627012,16627085,73
"40811","ENSG00000265145","2",28927067,28927144,77
"40812","ENSG00000265148","17",58324472,58415766,91294
"40813","ENSG00000265154","14",100109419,100109514,95
"40814","ENSG00000265158","18",31724198,31726956,2758
"40815","ENSG00000265160","5",172662165,172662263,98
"40816","ENSG00000265163","17",15105237,15106187,950
"40817","ENSG00000265168","17",28573117,28574243,1126
"40818","ENSG00000265170","X",153403844,153404141,297
"40819","ENSG00000265172","2",11836933,11836986,53
"40820","ENSG00000265174","18",6557822,6558654,832
"40821","ENSG00000265176","X",153981097,153981177,80
"40822","ENSG00000265178","17",39726495,39726561,66
"40823","ENSG00000265179","18",902766,906667,3901
"40824","ENSG00000265182","18",49495147,49496896,1749
"40825","ENSG00000265185","17",19061912,19062669,757
"40826","ENSG00000265190","10",47460162,47484158,23996
"40827","ENSG00000265194","9",21858910,21861926,3016
"40828","ENSG00000265195","15",68801850,68801925,75
"40829","ENSG00000265201","1",243346176,243346255,79
"40830","ENSG00000265203","10",47348371,47357875,9504
"40831","ENSG00000265204","18",24076794,24099320,22526
"40832","ENSG00000265205","17",28670054,28672804,2750
"40833","ENSG00000265206","17",58330884,58332508,1624
"40834","ENSG00000265213","4",98997387,98997460,73
"40835","ENSG00000265215","2",239305462,239305545,83
"40836","ENSG00000265217","18",65606079,65652053,45974
"40837","ENSG00000265218","17",64892729,64910180,17451
"40838","ENSG00000265222","17",32509954,32523424,13470
"40839","ENSG00000265227","12",81158388,81158461,73
"40840","ENSG00000265233","17",22056587,22056755,168
"40841","ENSG00000265241","1",145917714,145927678,9964
"40842","ENSG00000265243","18",3394889,3395312,423
"40843","ENSG00000265246","17",27237859,27241661,3802
"40844","ENSG00000265252","2",219549073,219549147,74
"40845","ENSG00000265253","3",113594876,113594942,66
"40846","ENSG00000265254","17",28405240,28406796,1556
"40847","ENSG00000265257","18",9102736,9254346,151610
"40848","ENSG00000265258","11",2173063,2173138,75
"40849","ENSG00000265260","X",97341046,97341344,298
"40850","ENSG00000265261","18",76884935,76888724,3789
"40851","ENSG00000265262","17",62950831,62951188,357
"40852","ENSG00000265265","17",21519514,21521269,1755
"40853","ENSG00000265272","19",58490797,58491075,278
"40854","ENSG00000265273","18",31962178,31963618,1440
"40855","ENSG00000265279","18",32196026,32196966,940
"40856","ENSG00000265281","16",56245520,56245623,103
"40857","ENSG00000265282","17",63430468,63432211,1743
"40858","ENSG00000265287","17",28607963,28609730,1767
"40859","ENSG00000265289","17",30059339,30065677,6338
"40860","ENSG00000265291","14",104677694,104677749,55
"40861","ENSG00000265293","17",32150433,32151504,1071
"40862","ENSG00000265296","18",14391913,14393909,1996
"40863","ENSG00000265298","17",64750420,64751311,891
"40864","ENSG00000265303","17",59197566,59215226,17660
"40865","ENSG00000265313","17",59422088,59526946,104858
"40866","ENSG00000265316","18",5463627,5480975,17348
"40867","ENSG00000265319","10",33034655,33034924,269
"40868","ENSG00000265321","2",27996367,27996449,82
"40869","ENSG00000265327","3",40209005,40209304,299
"40870","ENSG00000265331","17",69099542,69099656,114
"40871","ENSG00000265334","17",30834325,30863028,28703
"40872","ENSG00000265337","17",32529008,32530049,1041
"40873","ENSG00000265342","17",75394123,75394963,840
"40874","ENSG00000265345","12",124915547,124915659,112
"40875","ENSG00000265349","17",9638768,9645325,6557
"40876","ENSG00000265352","18",71732615,71788128,55513
"40877","ENSG00000265354","10",45972489,46003742,31253
"40878","ENSG00000265356","17",33935437,34156000,220563
"40879","ENSG00000265359","17",40850800,40863282,12482
"40880","ENSG00000265366","10",46759019,46786770,27751
"40881","ENSG00000265369","18",26687621,26703638,16017
"40882","ENSG00000265370","10",119958513,119958592,79
"40883","ENSG00000265372","10",20551970,20552046,76
"40884","ENSG00000265374","18",27225742,27247188,21446
"40885","ENSG00000265380","18",73711329,73715490,4161
"40886","ENSG00000265386","16",2013181,2013476,295
"40887","ENSG00000265388","12",6344554,6344837,283
"40888","ENSG00000265390","19",8389290,8389380,90
"40889","ENSG00000265392","1",6429834,6429896,62
"40890","ENSG00000265393","8",144512567,144513672,1105
"40891","ENSG00000265394","17",30090366,30117497,27131
"40892","ENSG00000265395","10",133371556,133371663,107
"40893","ENSG00000265396","2",177255945,177256010,65
"40894","ENSG00000265399","18",3190397,3247277,56880
"40895","ENSG00000265400","17",12201600,12215267,13667
"40896","ENSG00000265402","18",51612639,51613110,471
"40897","ENSG00000265407","19",49308797,49308868,71
"40898","ENSG00000265408","16",66942712,66963256,20544
"40899","ENSG00000265413","18",8402847,8405161,2314
"40900","ENSG00000265415","17",59202677,59203829,1152
"40901","ENSG00000265417","18",1362445,1363873,1428
"40902","ENSG00000265421","5",54075518,54075583,65
"40903","ENSG00000265429","2",113721290,113721368,78
"40904","ENSG00000265433","3",116850277,116850367,90
"40905","ENSG00000265437","18",14361434,14361943,509
"40906","ENSG00000265439","6",44209766,44210063,297
"40907","ENSG00000265442","10",122416965,122417067,102
"40908","ENSG00000265443","17",30726305,30727564,1259
"40909","ENSG00000265445","17",15261015,15265707,4692
"40910","ENSG00000265450","13",114273828,114273908,80
"40911","ENSG00000265451","2",121530422,121532705,2283
"40912","ENSG00000265452","2",53849122,53849205,83
"40913","ENSG00000265458","17",82454140,82458521,4381
"40914","ENSG00000265460","17",39238466,39250818,12352
"40915","ENSG00000265462","16",21506049,21506135,86
"40916","ENSG00000265465","X",17425881,17425954,73
"40917","ENSG00000265470","3",185767847,185767904,57
"40918","ENSG00000265472","18",67707929,67708246,317
"40919","ENSG00000265474","17",28745569,28747652,2083
"40920","ENSG00000265477","18",423744,424416,672
"40921","ENSG00000265478","17",18809956,18810940,984
"40922","ENSG00000265479","7",76959835,77043775,83940
"40923","ENSG00000265480","17",28275986,28317783,41797
"40924","ENSG00000265484","18",71215618,71237158,21540
"40925","ENSG00000265485","18",24534551,24708542,173991
"40926","ENSG00000265487","18",5956101,5960785,4684
"40927","ENSG00000265489","17",12760140,12790242,30102
"40928","ENSG00000265490","18",706523,707648,1125
"40929","ENSG00000265491","1",145738868,145824095,85227
"40930","ENSG00000265494","17",13909231,13911212,1981
"40931","ENSG00000265496","18",49487339,49491878,4539
"40932","ENSG00000265503","17",12917268,12917342,74
"40933","ENSG00000265510","2",88812370,88812454,84
"40934","ENSG00000265511","17",17507351,17508308,957
"40935","ENSG00000265514","18",5081171,5098780,17609
"40936","ENSG00000265519","17",15787787,15788205,418
"40937","ENSG00000265520","8",17681578,17681657,79
"40938","ENSG00000265521","1",9967381,9967458,77
"40939","ENSG00000265527","6",35664717,35664789,72
"40940","ENSG00000265531","1",143874793,143883575,8782
"40941","ENSG00000265533","18",67516546,67899619,383073
"40942","ENSG00000265535","1",59974757,59975054,297
"40943","ENSG00000265539","11",69083176,69083258,82
"40944","ENSG00000265542","17",57771946,57834749,62803
"40945","ENSG00000265544","17",33529787,33533760,3973
"40946","ENSG00000265545","18",4459230,4459458,228
"40947","ENSG00000265547","17",45731703,45732977,1274
"40948","ENSG00000265554","18",10124588,10144406,19818
"40949","ENSG00000265555","18",67808505,67814822,6317
"40950","ENSG00000265559","11",47557534,47557833,299
"40951","ENSG00000265565","6",27147626,27147688,62
"40952","ENSG00000265566","11",57528085,57528365,280
"40953","ENSG00000265574","17",32111562,32112590,1028
"40954","ENSG00000265579","18",72743756,72745961,2205
"40955","ENSG00000265584","X",110082118,110082218,100
"40956","ENSG00000265590","21",32578822,32612281,33459
"40957","ENSG00000265593","17",9852748,9853306,558
"40958","ENSG00000265598","7",158591616,158591696,80
"40959","ENSG00000265606","1",18883202,18883275,73
"40960","ENSG00000265612","14",105857513,105857572,59
"40961","ENSG00000265617","20",60564562,60564625,63
"40962","ENSG00000265623","4",143343460,143343535,75
"40963","ENSG00000265625","17",29644796,29645847,1051
"40964","ENSG00000265626","18",76759685,76759866,181
"40965","ENSG00000265630","10",47563604,47569697,6093
"40966","ENSG00000265639","18",71028770,71033056,4286
"40967","ENSG00000265643","18",69483627,69618694,135067
"40968","ENSG00000265644","18",78480549,78484867,4318
"40969","ENSG00000265646","17",27082690,27084036,1346
"40970","ENSG00000265648","16",70276069,70276352,283
"40971","ENSG00000265653","10",12130760,12130816,56
"40972","ENSG00000265656","18",21673628,21682561,8933
"40973","ENSG00000265657","8",103154614,103154689,75
"40974","ENSG00000265658","X",1293918,1293992,74
"40975","ENSG00000265660","8",143733083,143733153,70
"40976","ENSG00000265666","17",40340867,40343136,2269
"40977","ENSG00000265669","6",132115192,132115263,71
"40978","ENSG00000265671","18",894435,907680,13245
"40979","ENSG00000265675","19",49081332,49081630,298
"40980","ENSG00000265678","17",82153430,82154815,1385
"40981","ENSG00000265681","18",49488453,49492523,4070
"40982","ENSG00000265683","17",27351858,27352584,726
"40983","ENSG00000265684","5",82078427,82078724,297
"40984","ENSG00000265688","17",81927829,81930753,2924
"40985","ENSG00000265689","17",33688803,33689174,371
"40986","ENSG00000265692","17",82290046,82292814,2768
"40987","ENSG00000265697","17",33534110,33541339,7229
"40988","ENSG00000265698","18",70412055,70412391,336
"40989","ENSG00000265699","5",58530043,58530109,66
"40990","ENSG00000265702","17",62699244,62754973,55729
"40991","ENSG00000265706","2",28927983,28928060,77
"40992","ENSG00000265713","17",29775747,29776701,954
"40993","ENSG00000265717","18",76254292,76255214,922
"40994","ENSG00000265719","10",119377972,119378043,71
"40995","ENSG00000265724","7",73711317,73711397,80
"40996","ENSG00000265727","X",74242608,74242908,300
"40997","ENSG00000265728","18",10594590,10604798,10208
"40998","ENSG00000265733","10",45984610,45984810,200
"40999","ENSG00000265735","9",9442060,9442380,320
"41000","ENSG00000265737","18",14816151,14825249,9098
"41001","ENSG00000265739","17",30122429,30126118,3689
"41002","ENSG00000265740","5",171359117,171359412,295
"41003","ENSG00000265743","17",30964935,30965500,565
"41004","ENSG00000265744","1",233624152,233624219,67
"41005","ENSG00000265745","13",60034465,60034762,297
"41006","ENSG00000265749","17",8365563,8381328,15765
"41007","ENSG00000265750","18",24159509,24162211,2702
"41008","ENSG00000265751","18",21380286,21451017,70731
"41009","ENSG00000265752","18",23957754,23982556,24802
"41010","ENSG00000265753","1",151300665,151300964,299
"41011","ENSG00000265758","18",21981121,22051159,70038
"41012","ENSG00000265763","10",47365496,47384293,18797
"41013","ENSG00000265766","18",14477955,14499278,21323
"41014","ENSG00000265768","14",93948226,93948302,76
"41015","ENSG00000265775","17",34118347,34118882,535
"41016","ENSG00000265777","17",2199762,2200039,277
"41017","ENSG00000265778","18",76491629,76493918,2289
"41018","ENSG00000265781","18",71000477,71011490,11013
"41019","ENSG00000265786","18",14877611,14884052,6441
"41020","ENSG00000265787","18",14337423,14342524,5101
"41021","ENSG00000265788","17",27651334,27665712,14378
"41022","ENSG00000265790","17",20901939,20902680,741
"41023","ENSG00000265791","17",30781493,30782221,728
"41024","ENSG00000265798","17",31038575,31059121,20546
"41025","ENSG00000265799","17",40012226,40014705,2479
"41026","ENSG00000265800","17",75138416,75141350,2934
"41027","ENSG00000265801","17",27465112,27465541,429
"41028","ENSG00000265802","13",45002150,45002447,297
"41029","ENSG00000265806","9",136830957,136831023,66
"41030","ENSG00000265808","1",120150898,120176515,25617
"41031","ENSG00000265810","7",151433489,151433639,150
"41032","ENSG00000265813","3",153199700,153200017,317
"41033","ENSG00000265814","15",40615665,40615928,263
"41034","ENSG00000265815","1",52940314,52940413,99
"41035","ENSG00000265818","6",8015726,8102530,86804
"41036","ENSG00000265820","16",1734985,1735066,81
"41037","ENSG00000265828","6",166997807,166997912,105
"41038","ENSG00000265836","18",76751305,76751841,536
"41039","ENSG00000265843","18",77970637,77993731,23094
"41040","ENSG00000265844","18",77180106,77235430,55324
"41041","ENSG00000265845","17",28926275,28944749,18474
"41042","ENSG00000265855","15",80997417,80997473,56
"41043","ENSG00000265859","3",131985855,131985931,76
"41044","ENSG00000265863","17",31759795,31761385,1590
"41045","ENSG00000265867","16",2133119,2133204,85
"41046","ENSG00000265871","15",90006755,90006841,86
"41047","ENSG00000265874","11",65649192,65649253,61
"41048","ENSG00000265879","19",10780254,10780335,81
"41049","ENSG00000265881","17",21444833,21445439,606
"41050","ENSG00000265882","3",195553792,195554043,251
"41051","ENSG00000265883","17",65185319,65185482,163
"41052","ENSG00000265885","13",110097851,110098151,300
"41053","ENSG00000265888","18",31101583,31162789,61206
"41054","ENSG00000265892","4",139185441,139185746,305
"41055","ENSG00000265894","4",56805834,56806131,297
"41056","ENSG00000265905","2",38936876,38937158,282
"41057","ENSG00000265907","18",2948238,2960756,12518
"41058","ENSG00000265908","17",28944796,28945394,598
"41059","ENSG00000265912","17",64943262,64951054,7792
"41060","ENSG00000265916","17",20532248,20532881,633
"41061","ENSG00000265917","12",95309923,95309984,61
"41062","ENSG00000265918","16",67019519,67019817,298
"41063","ENSG00000265927","17",73831572,73836019,4447
"41064","ENSG00000265929","14",106850885,106850999,114
"41065","ENSG00000265932","7",19705358,19705436,78
"41066","ENSG00000265933","18",6919496,6929966,10470
"41067","ENSG00000265935","17",73662568,73663848,1280
"41068","ENSG00000265936","18",67375133,67375305,172
"41069","ENSG00000265939","18",22900486,22900995,509
"41070","ENSG00000265942","15",49042341,49042643,302
"41071","ENSG00000265943","18",22699481,22933764,234283
"41072","ENSG00000265944","18",6511416,6590653,79237
"41073","ENSG00000265948","18",21316878,21317795,917
"41074","ENSG00000265957","18",44970082,44970166,84
"41075","ENSG00000265962","18",8695856,8707621,11765
"41076","ENSG00000265964","17",45733353,45734669,1316
"41077","ENSG00000265971","17",63454993,63455817,824
"41078","ENSG00000265972","1",145992435,145996600,4165
"41079","ENSG00000265973","11",49843488,49846533,3045
"41080","ENSG00000265975","17",8967523,8976995,9472
"41081","ENSG00000265976","17",31575269,31575358,89
"41082","ENSG00000265980","18",29278509,29361963,83454
"41083","ENSG00000265981","3",124732439,124732516,77
"41084","ENSG00000265982","17",64778842,64778937,95
"41085","ENSG00000265984","18",21240675,21241371,696
"41086","ENSG00000265992","3",54632122,54639857,7735
"41087","ENSG00000265994","18",28638714,28789580,150866
"41088","ENSG00000265995","18",71890409,71944577,54168
"41089","ENSG00000265996","1",65057755,65057842,87
"41090","ENSG00000266003","18",51433437,51434783,1346
"41091","ENSG00000266010","18",22164886,22169878,4992
"41092","ENSG00000266013","17",39026715,39027110,395
"41093","ENSG00000266014","18",76232927,76252044,19117
"41094","ENSG00000266016","12",64622509,64622605,96
"41095","ENSG00000266017","9",63819574,63819654,80
"41096","ENSG00000266019","7",98881650,98881729,79
"41097","ENSG00000266028","1",206203345,206464443,261098
"41098","ENSG00000266036","17",74747319,74748912,1593
"41099","ENSG00000266038","8",6745164,6745244,80
"41100","ENSG00000266041","11",65636310,65636369,59
"41101","ENSG00000266043","12",1660315,1660380,65
"41102","ENSG00000266049","18",2688564,2833065,144501
"41103","ENSG00000266050","17",21573536,21573746,210
"41104","ENSG00000266053","18",9121265,9136645,15380
"41105","ENSG00000266059","2",20175346,20175639,293
"41106","ENSG00000266063","2",111771061,111771134,73
"41107","ENSG00000266065","18",6493420,6495668,2248
"41108","ENSG00000266066","17",62136972,62140639,3667
"41109","ENSG00000266071","20",45705102,45705180,78
"41110","ENSG00000266074","17",81395475,81466332,70857
"41111","ENSG00000266075","1",3782815,3783111,296
"41112","ENSG00000266076","17",65538102,65641033,102931
"41113","ENSG00000266079","17",19557211,19557911,700
"41114","ENSG00000266086","17",57989038,58007246,18208
"41115","ENSG00000266088","17",40516892,40527002,10110
"41116","ENSG00000266094","1",206507530,206589448,81918
"41117","ENSG00000266097","2",62205826,62205917,91
"41118","ENSG00000266100","17",57522248,57523597,1349
"41119","ENSG00000266101","17",39173290,39177503,4213
"41120","ENSG00000266104","20",63286808,63286866,58
"41121","ENSG00000266105","18",31966960,31967545,585
"41122","ENSG00000266106","17",74307210,74309790,2580
"41123","ENSG00000266107","17",82668233,82668307,74
"41124","ENSG00000266111","17",29352069,29404105,52036
"41125","ENSG00000266114","17",10792059,10794985,2926
"41126","ENSG00000266117","17",68095068,68095757,689
"41127","ENSG00000266120","17",30238741,30252237,13496
"41128","ENSG00000266124","16",535316,535368,52
"41129","ENSG00000266126","17",19929372,19929737,365
"41130","ENSG00000266127","18",9785108,9787805,2697
"41131","ENSG00000266133","21",26953961,26954043,82
"41132","ENSG00000266139","2",111321013,111321086,73
"41133","ENSG00000266144","1",162157107,162157182,75
"41134","ENSG00000266145","18",14222008,14222331,323
"41135","ENSG00000266146","18",13459947,13460026,79
"41136","ENSG00000266148","18",39676721,39676779,58
"41137","ENSG00000266149","18",8360820,8367034,6214
"41138","ENSG00000266151","20",44408120,44408203,83
"41139","ENSG00000266153","18",5159332,5171026,11694
"41140","ENSG00000266155","17",64936485,64940229,3744
"41141","ENSG00000266158","X",47280811,47281063,252
"41142","ENSG00000266160","1",156985755,156986049,294
"41143","ENSG00000266166","16",25185253,25185538,285
"41144","ENSG00000266171","18",735746,737459,1713
"41145","ENSG00000266173","17",63682336,63741986,59650
"41146","ENSG00000266174","1",228462074,228462152,78
"41147","ENSG00000266179","17",19600860,19601345,485
"41148","ENSG00000266181","18",24522273,24522919,646
"41149","ENSG00000266184","18",26831520,26832432,912
"41150","ENSG00000266185","12",69400903,69401200,297
"41151","ENSG00000266187","1",150211632,150211925,293
"41152","ENSG00000266188","1",52934930,52935017,87
"41153","ENSG00000266189","17",81451104,81451188,84
"41154","ENSG00000266190","17",28021668,28022265,597
"41155","ENSG00000266195","21",17506453,17506728,275
"41156","ENSG00000266200","10",116620953,116645143,24190
"41157","ENSG00000266202","17",27798806,27893365,94559
"41158","ENSG00000266203","1",32086949,32087007,58
"41159","ENSG00000266206","8",12727232,12727304,72
"41160","ENSG00000266208","17",40360655,40364693,4038
"41161","ENSG00000266210","1",30918469,30918735,266
"41162","ENSG00000266213","18",78137223,78140887,3664
"41163","ENSG00000266217","10",47581211,47582321,1110
"41164","ENSG00000266222","17",48377262,48380370,3108
"41165","ENSG00000266232","16",2531922,2532005,83
"41166","ENSG00000266235","16",543277,543366,89
"41167","ENSG00000266236","17",82482098,82483388,1290
"41168","ENSG00000266237","18",26266009,26267409,1400
"41169","ENSG00000266240","4",13627865,13627957,92
"41170","ENSG00000266242","18",14485806,14487501,1695
"41171","ENSG00000266245","6",170330761,170330844,83
"41172","ENSG00000266248","19",29489775,29526948,37173
"41173","ENSG00000266256","18",76528652,76670111,141459
"41174","ENSG00000266258","18",70335439,70352459,17020
"41175","ENSG00000266261","17",15651590,15654489,2899
"41176","ENSG00000266262","1",237471119,237471191,72
"41177","ENSG00000266265","7",130731235,130734176,2941
"41178","ENSG00000266268","18",4775054,5004537,229483
"41179","ENSG00000266273","18",78795612,78796672,1060
"41180","ENSG00000266274","17",30959564,30959850,286
"41181","ENSG00000266278","18",70380140,70384591,4451
"41182","ENSG00000266279","17",8337697,8338758,1061
"41183","ENSG00000266282","17",32227890,32228108,218
"41184","ENSG00000266283","18",22200619,22205229,4610
"41185","ENSG00000266288","18",5381641,5385330,3689
"41186","ENSG00000266289","8",103383078,103383854,776
"41187","ENSG00000266290","17",58076891,58083204,6313
"41188","ENSG00000266296","18",28651732,28653208,1476
"41189","ENSG00000266297","17",12081899,12081996,97
"41190","ENSG00000266302","17",16690261,16804453,114192
"41191","ENSG00000266304","18",70335929,70337310,1381
"41192","ENSG00000266305","16",30503919,30504001,82
"41193","ENSG00000266306","17",28269203,28272365,3162
"41194","ENSG00000266307","16",85306226,85306325,99
"41195","ENSG00000266308","15",75895040,75895302,262
"41196","ENSG00000266311","17",19164209,19174436,10227
"41197","ENSG00000266312","18",76622136,76639030,16894
"41198","ENSG00000266313","17",27333241,27352828,19587
"41199","ENSG00000266315","9",111932100,111932169,69
"41200","ENSG00000266317","3",181813401,181813702,301
"41201","ENSG00000266318","7",97963658,97963726,68
"41202","ENSG00000266320","22",35335640,35335758,118
"41203","ENSG00000266329","5",176629439,176629500,61
"41204","ENSG00000266338","1",144421386,144461674,40288
"41205","ENSG00000266340","17",30978610,30980250,1640
"41206","ENSG00000266354","2",212926257,212926336,79
"41207","ENSG00000266356","17",27411438,27412806,1368
"41208","ENSG00000266357","17",74043452,74154212,110760
"41209","ENSG00000266365","17",62231470,62247153,15683
"41210","ENSG00000266368","17",11953889,11977594,23705
"41211","ENSG00000266369","17",20855946,20857317,1371
"41212","ENSG00000266370","12",112037599,112037715,116
"41213","ENSG00000266371","17",31133182,31138518,5336
"41214","ENSG00000266373","18",3580169,3580754,585
"41215","ENSG00000266378","17",14327335,14329474,2139
"41216","ENSG00000266379","17",32088160,32094933,6773
"41217","ENSG00000266383","3",124132929,124133025,96
"41218","ENSG00000266385","17",32411217,32412420,1203
"41219","ENSG00000266389","17",8965896,8967070,1174
"41220","ENSG00000266392","17",81400716,81400778,62
"41221","ENSG00000266397","18",2967018,2985410,18392
"41222","ENSG00000266401","18",3653030,3656282,3252
"41223","ENSG00000266402","17",64145970,64146476,506
"41224","ENSG00000266405","18",2652170,2655395,3225
"41225","ENSG00000266407","10",96064315,96064399,84
"41226","ENSG00000266412","10",46005088,46030714,25626
"41227","ENSG00000266417","1",178677749,178677834,85
"41228","ENSG00000266420","X",119434519,119434820,301
"41229","ENSG00000266421","4",85722468,85722533,65
"41230","ENSG00000266423","11",66934434,66934506,72
"41231","ENSG00000266433","17",27417690,27431623,13933
"41232","ENSG00000266439","16",10221775,10222073,298
"41233","ENSG00000266441","18",6728821,6729862,1041
"41234","ENSG00000266445","17",82476597,82477924,1327
"41235","ENSG00000266446","9",21995482,21996013,531
"41236","ENSG00000266448","17",31709568,31709859,291
"41237","ENSG00000266456","18",650229,652843,2614
"41238","ENSG00000266458","1",159899979,159900079,100
"41239","ENSG00000266466","17",21532974,21542786,9812
"41240","ENSG00000266467","10",68007718,68008017,299
"41241","ENSG00000266469","17",39401793,39406233,4440
"41242","ENSG00000266470","18",10632238,10632396,158
"41243","ENSG00000266472","1",150293720,150308979,15259
"41244","ENSG00000266473","17",67244837,67245806,969
"41245","ENSG00000266478","5",143679860,143679971,111
"41246","ENSG00000266479","18",29256817,29257060,243
"41247","ENSG00000266489","18",24516699,24544154,27455
"41248","ENSG00000266490","17",30792372,30792833,461
"41249","ENSG00000266494","6",41598723,41598788,65
"41250","ENSG00000266495","18",23257164,23260354,3190
"41251","ENSG00000266498","17",17235433,17236118,685
"41252","ENSG00000266501","17",73067870,73068288,418
"41253","ENSG00000266503","22",28642979,28643270,291
"41254","ENSG00000266505","13",30022021,30023800,1779
"41255","ENSG00000266507","9",136886733,136886803,70
"41256","ENSG00000266513","18",3770017,3771430,1413
"41257","ENSG00000266515","4",86542482,86542552,70
"41258","ENSG00000266520","18",24685772,24686351,579
"41259","ENSG00000266521","18",31496645,31497195,550
"41260","ENSG00000266522","18",15003975,15006352,2377
"41261","ENSG00000266524","10",47300197,47313577,13380
"41262","ENSG00000266527","17",27874645,27881237,6592
"41263","ENSG00000266530","18",37657135,37657215,80
"41264","ENSG00000266531","14",65044688,65044769,81
"41265","ENSG00000266533","22",46091044,46091126,82
"41266","ENSG00000266535","17",33111858,33131743,19885
"41267","ENSG00000266537","17",59174983,59181787,6804
"41268","ENSG00000266538","17",15530773,15531089,316
"41269","ENSG00000266541","18",9587386,9590182,2796
"41270","ENSG00000266549","18",26952201,26952558,357
"41271","ENSG00000266553","14",76967518,76967765,247
"41272","ENSG00000266554","18",14946267,14974215,27948
"41273","ENSG00000266555","6",138435213,138435294,81
"41274","ENSG00000266559","19",39409623,39409678,55
"41275","ENSG00000266560","X",152114994,152138556,23562
"41276","ENSG00000266563","17",21259968,21260501,533
"41277","ENSG00000266569","7",72822894,72823171,277
"41278","ENSG00000266570","11",79422169,79422226,57
"41279","ENSG00000266573","18",24725762,24986980,261218
"41280","ENSG00000266575","18",832238,832469,231
"41281","ENSG00000266578","18",3284120,3330984,46864
"41282","ENSG00000266579","6",57493855,57497691,3836
"41283","ENSG00000266580","1",31758660,31758735,75
"41284","ENSG00000266588","17",39003248,39013032,9784
"41285","ENSG00000266589","15",66496958,66497034,76
"41286","ENSG00000266594","22",40813883,40813958,75
"41287","ENSG00000266598","17",65051909,65053308,1399
"41288","ENSG00000266599","17",32518953,32531492,12539
"41289","ENSG00000266601","17",47929682,47933106,3424
"41290","ENSG00000266602","18",1509022,2049510,540488
"41291","ENSG00000266604","18",10612304,10626353,14049
"41292","ENSG00000266611","13",51552589,51552667,78
"41293","ENSG00000266613","18",8412129,8414304,2175
"41294","ENSG00000266614","18",76259166,76260114,948
"41295","ENSG00000266617","6",157529132,157529200,68
"41296","ENSG00000266618","1",224398227,224398311,84
"41297","ENSG00000266627","19",3920245,3920506,261
"41298","ENSG00000266634","1",17277889,17277975,86
"41299","ENSG00000266640","19",58386770,58386858,88
"41300","ENSG00000266642","17",28897738,28899402,1664
"41301","ENSG00000266643","16",2270713,2270772,59
"41302","ENSG00000266644","17",64899766,64900716,950
"41303","ENSG00000266647","17",62260634,62261936,1302
"41304","ENSG00000266648","17",58476138,58476950,812
"41305","ENSG00000266649","2",69103682,69103755,73
"41306","ENSG00000266651","17",16440479,16440952,473
"41307","ENSG00000266654","17",82160056,82160452,396
"41308","ENSG00000266655","12",123536409,123536534,125
"41309","ENSG00000266664","17",19150279,19151286,1007
"41310","ENSG00000266667","17",15379864,15417878,38014
"41311","ENSG00000266668","7",97964405,97964481,76
"41312","ENSG00000266673","17",21552509,21552711,202
"41313","ENSG00000266676","10",129843299,129843374,75
"41314","ENSG00000266677","17",18172625,18184753,12128
"41315","ENSG00000266680","6",63571005,63572408,1403
"41316","ENSG00000266696","18",49205912,49208781,2869
"41317","ENSG00000266698","4",184851013,184851110,97
"41318","ENSG00000266707","17",66197693,66198238,545
"41319","ENSG00000266708","18",8635179,8636347,1168
"41320","ENSG00000266709","17",14303854,14305505,1651
"41321","ENSG00000266710","X",18915243,18915535,292
"41322","ENSG00000266712","8",76966768,76966850,82
"41323","ENSG00000266714","17",75588058,75626849,38791
"41324","ENSG00000266717","17",67950885,67951746,861
"41325","ENSG00000266718","17",32495536,32500910,5374
"41326","ENSG00000266719","10",72721029,72721100,71
"41327","ENSG00000266720","20",18258554,18258851,297
"41328","ENSG00000266721","19",12920320,12920404,84
"41329","ENSG00000266728","17",27623364,27640777,17413
"41330","ENSG00000266729","18",31343368,31426988,83620
"41331","ENSG00000266733","17",30553502,30563493,9991
"41332","ENSG00000266738","2",19348429,19348505,76
"41333","ENSG00000266743","18",76173304,76177738,4434
"41334","ENSG00000266744","17",13957748,13966952,9204
"41335","ENSG00000266745","3",20137565,20137641,76
"41336","ENSG00000266750","6",2854031,2854107,76
"41337","ENSG00000266751","5",134225757,134225852,95
"41338","ENSG00000266754","10",103974515,103974814,299
"41339","ENSG00000266758","16",29599179,29599265,86
"41340","ENSG00000266767","18",7741310,7754831,13521
"41341","ENSG00000266770","19",13815062,13815319,257
"41342","ENSG00000266774","18",75432703,75436957,4254
"41343","ENSG00000266776","6",31701029,31701091,62
"41344","ENSG00000266777","17",32039974,32042828,2854
"41345","ENSG00000266780","3",75214476,75214549,73
"41346","ENSG00000266782","10",117167678,117167774,96
"41347","ENSG00000266783","18",2561172,2562220,1048
"41348","ENSG00000266801","16",68933820,68937725,3905
"41349","ENSG00000266802","1",23057858,23057934,76
"41350","ENSG00000266803","17",16557985,16559269,1284
"41351","ENSG00000266805","18",9506242,9509726,3484
"41352","ENSG00000266806","17",22331597,22332410,813
"41353","ENSG00000266818","18",15254418,15271744,17326
"41354","ENSG00000266821","17",47879472,47882398,2926
"41355","ENSG00000266824","17",8176812,8182812,6000
"41356","ENSG00000266826","17",58660424,58692018,31594
"41357","ENSG00000266828","X",115992466,115992773,307
"41358","ENSG00000266830","17",28246454,28248006,1552
"41359","ENSG00000266835","18",3466250,3478978,12728
"41360","ENSG00000266840","18",69704978,69724975,19997
"41361","ENSG00000266844","18",76974690,76984162,9472
"41362","ENSG00000266846","18",5895745,6108382,212637
"41363","ENSG00000266850","18",22723491,22907721,184230
"41364","ENSG00000266852","10",104268336,104268405,69
"41365","ENSG00000266853","17",27612588,27613251,663
"41366","ENSG00000266858","17",67774591,67777324,2733
"41367","ENSG00000266863","9",6661651,6661942,291
"41368","ENSG00000266865","17",31008497,31093127,84630
"41369","ENSG00000266869","14",71848606,71928596,79990
"41370","ENSG00000266875","6",134133573,134133868,295
"41371","ENSG00000266876","17",30068632,30069631,999
"41372","ENSG00000266877","17",31583162,31637543,54381
"41373","ENSG00000266885","17",22435390,22439033,3643
"41374","ENSG00000266891","18",9734882,9735602,720
"41375","ENSG00000266896","6",169770413,169772042,1629
"41376","ENSG00000266897","19",13131571,13132410,839
"41377","ENSG00000266899","19",33360497,33361448,951
"41378","ENSG00000266900","18",62245810,62247412,1602
"41379","ENSG00000266901","18",79702721,79703651,930
"41380","ENSG00000266903","19",44631573,44725217,93644
"41381","ENSG00000266904","19",19757366,19776423,19057
"41382","ENSG00000266905","18",48962951,48963941,990
"41383","ENSG00000266907","19",56319790,56322310,2520
"41384","ENSG00000266908","20",5318268,5503189,184921
"41385","ENSG00000266909","18",80077707,80078259,552
"41386","ENSG00000266910","19",30037423,30038181,758
"41387","ENSG00000266913","19",14305458,14370196,64738
"41388","ENSG00000266916","19",37497159,37507122,9963
"41389","ENSG00000266918","17",45531577,45533838,2261
"41390","ENSG00000266920","18",62442028,62443126,1098
"41391","ENSG00000266921","19",43996896,44003298,6402
"41392","ENSG00000266922","19",11725961,11730783,4822
"41393","ENSG00000266924","18",79787121,79791432,4311
"41394","ENSG00000266925","17",20507413,20508931,1518
"41395","ENSG00000266932","19",56342432,56343419,987
"41396","ENSG00000266933","19",490046,507833,17787
"41397","ENSG00000266934","17",61382785,61384680,1895
"41398","ENSG00000266936","19",11010917,11016011,5094
"41399","ENSG00000266938","19",2896625,2897222,597
"41400","ENSG00000266941","19",5899895,5901511,1616
"41401","ENSG00000266944","19",3130717,3131398,681
"41402","ENSG00000266946","18",58690356,58692153,1797
"41403","ENSG00000266947","17",35231450,35242963,11513
"41404","ENSG00000266950","19",9793621,9802301,8680
"41405","ENSG00000266951","19",15613247,15614553,1306
"41406","ENSG00000266953","19",34396315,34409364,13049
"41407","ENSG00000266954","18",13644815,13645685,870
"41408","ENSG00000266955","18",11993988,11994938,950
"41409","ENSG00000266957","18",47077361,47091280,13919
"41410","ENSG00000266959","19",3568120,3568273,153
"41411","ENSG00000266961","18",12738965,12750068,11103
"41412","ENSG00000266962","17",42552436,42554748,2312
"41413","ENSG00000266963","19",38361795,38362484,689
"41414","ENSG00000266964","19",35138808,35143109,4301
"41415","ENSG00000266965","18",35595901,35597599,1698
"41416","ENSG00000266967","17",42950526,42964498,13972
"41417","ENSG00000266968","18",45646153,45647937,1784
"41418","ENSG00000266969","18",12984694,12991173,6479
"41419","ENSG00000266970","17",78360453,78373911,13458
"41420","ENSG00000266973","19",36378028,36378832,804
"41421","ENSG00000266975","19",12930522,12933296,2774
"41422","ENSG00000266976","19",28606688,28615229,8541
"41423","ENSG00000266977","19",27849635,27889222,39587
"41424","ENSG00000266978","19",10252268,10285108,32840
"41425","ENSG00000266979","17",44646364,44650349,3985
"41426","ENSG00000266980","17",75818815,75820055,1240
"41427","ENSG00000266981","17",35188522,35191343,2821
"41428","ENSG00000266983","19",5978403,6020363,41960
"41429","ENSG00000266984","18",48478561,48479228,667
"41430","ENSG00000266985","19",33555568,33557470,1902
"41431","ENSG00000266987","17",30144062,30144790,728
"41432","ENSG00000266988","18",45483343,45529855,46512
"41433","ENSG00000266989","19",3870991,3872107,1116
"41434","ENSG00000266990","19",999796,1002757,2961
"41435","ENSG00000266992","17",59976009,60002384,26375
"41436","ENSG00000266993","1",51793934,51799154,5220
"41437","ENSG00000266994","16",4730115,4752565,22450
"41438","ENSG00000266995","18",12040101,12040300,199
"41439","ENSG00000266997","18",49795793,49837623,41830
"41440","ENSG00000266998","17",77373818,77377236,3418
"41441","ENSG00000267000","18",59459072,59465682,6610
"41442","ENSG00000267002","17",43148368,43171037,22669
"41443","ENSG00000267004","19",12725517,12725886,369
"41444","ENSG00000267005","19",36173406,36173853,447
"41445","ENSG00000267006","19",30028741,30029916,1175
"41446","ENSG00000267009","17",68413623,68524949,111326
"41447","ENSG00000267011","19",4457962,4471493,13531
"41448","ENSG00000267013","18",55105904,55124306,18402
"41449","ENSG00000267014","19",29002319,29015160,12841
"41450","ENSG00000267015","18",79340258,79343972,3714
"41451","ENSG00000267016","17",77469162,77472770,3608
"41452","ENSG00000267022","19",44025354,44087318,61964
"41453","ENSG00000267023","17",68125777,68152468,26691
"41454","ENSG00000267024","19",34426112,34428273,2161
"41455","ENSG00000267026","9",98847172,98872415,25243
"41456","ENSG00000267028","18",55452533,55482940,30407
"41457","ENSG00000267032","18",13151637,13152689,1052
"41458","ENSG00000267033","19",16186276,16189458,3182
"41459","ENSG00000267034","2",222317242,222318653,1411
"41460","ENSG00000267035","17",35540039,35540797,758
"41461","ENSG00000267038","18",61681653,61682695,1042
"41462","ENSG00000267039","18",36901946,36923814,21868
"41463","ENSG00000267040","18",57630302,57669296,38994
"41464","ENSG00000267041","19",36714383,36772825,58442
"41465","ENSG00000267042","17",42679963,42682020,2057
"41466","ENSG00000267044","19",45135993,45136977,984
"41467","ENSG00000267046","17",35490009,35491238,1229
"41468","ENSG00000267047","17",6985494,7019414,33920
"41469","ENSG00000267048","16",89906157,89918233,12076
"41470","ENSG00000267049","19",35769144,35771028,1884
"41471","ENSG00000267051","18",11366913,11378409,11496
"41472","ENSG00000267052","7",106569876,106598908,29032
"41473","ENSG00000267053","19",36304564,36321274,16710
"41474","ENSG00000267054","19",33178056,33178651,595
"41475","ENSG00000267055","7",20096137,20130475,34338
"41476","ENSG00000267056","19",15910582,15911824,1242
"41477","ENSG00000267057","18",56031830,56135295,103465
"41478","ENSG00000267058","19",43891804,43901805,10001
"41479","ENSG00000267060","17",42968088,42980433,12345
"41480","ENSG00000267061","18",59563709,59568615,4906
"41481","ENSG00000267063","19",2847227,2858716,11489
"41482","ENSG00000267064","X",47658833,47692326,33493
"41483","ENSG00000267065","17",76799044,76807102,8058
"41484","ENSG00000267069","18",12288308,12291488,3180
"41485","ENSG00000267070","16",5098739,5142595,43856
"41486","ENSG00000267072","16",5010909,5043999,33090
"41487","ENSG00000267073","19",1748056,1748745,689
"41488","ENSG00000267074","17",35499690,35510270,10580
"41489","ENSG00000267075","17",20545371,20549952,4581
"41490","ENSG00000267076","18",12211378,12211807,429
"41491","ENSG00000267077","16",4795265,4796532,1267
"41492","ENSG00000267078","17",76569792,76571240,1448
"41493","ENSG00000267079","18",11910634,11914344,3710
"41494","ENSG00000267080","17",44175968,44186723,10755
"41495","ENSG00000267082","19",11203628,11216168,12540
"41496","ENSG00000267083","17",60810165,60811462,1297
"41497","ENSG00000267085","9",65222522,65222777,255
"41498","ENSG00000267088","18",42089312,42089752,440
"41499","ENSG00000267089","19",11841241,11842439,1198
"41500","ENSG00000267091","19",36496916,36498159,1243
"41501","ENSG00000267092","19",1508375,1508963,588
"41502","ENSG00000267095","17",60135762,60140081,4319
"41503","ENSG00000267096","19",55670632,55672069,1437
"41504","ENSG00000267097","18",45423764,45483218,59454
"41505","ENSG00000267098","18",60628963,60902726,273763
"41506","ENSG00000267100","19",10651862,10653844,1982
"41507","ENSG00000267101","18",45104361,45181382,77021
"41508","ENSG00000267102","17",35409602,35410228,626
"41509","ENSG00000267105","19",10259109,10260045,936
"41510","ENSG00000267106","19",9621249,9647203,25954
"41511","ENSG00000267107","19",41449520,41501223,51703
"41512","ENSG00000267108","18",12432897,12437635,4738
"41513","ENSG00000267109","17",70312831,70368916,56085
"41514","ENSG00000267110","19",55154757,55160671,5914
"41515","ENSG00000267112","18",54885866,54898083,12217
"41516","ENSG00000267114","19",44950044,44954007,3963
"41517","ENSG00000267115","19",37503906,37504465,559
"41518","ENSG00000267116","18",12192203,12192934,731
"41519","ENSG00000267117","19",55694118,55694558,440
"41520","ENSG00000267119","19",9820141,9820455,314
"41521","ENSG00000267120","19",35739252,35745432,6180
"41522","ENSG00000267121","17",45190931,45222222,31291
"41523","ENSG00000267122","19",2212029,2215565,3536
"41524","ENSG00000267123","17",78605233,78632155,26922
"41525","ENSG00000267125","19",1852382,1853622,1240
"41526","ENSG00000267127","18",80034346,80097088,62742
"41527","ENSG00000267128","17",76138432,76154650,16218
"41528","ENSG00000267129","17",3377527,3377602,75
"41529","ENSG00000267130","19",33305036,33309387,4351
"41530","ENSG00000267131","17",61361668,61400243,38575
"41531","ENSG00000267134","18",64041555,64423601,382046
"41532","ENSG00000267136","18",13514520,13522888,8368
"41533","ENSG00000267137","17",61460224,61463384,3160
"41534","ENSG00000267138","19",3754620,3756659,2039
"41535","ENSG00000267140","18",35443871,35497940,54069
"41536","ENSG00000267141","19",1860250,1862019,1769
"41537","ENSG00000267142","19",36421536,36422534,998
"41538","ENSG00000267143","18",11620717,11621158,441
"41539","ENSG00000267144","19",44023118,44025262,2144
"41540","ENSG00000267145","19",56338288,56338648,360
"41541","ENSG00000267146","18",56872668,56873970,1302
"41542","ENSG00000267147","19",14333743,14343916,10173
"41543","ENSG00000267149","19",55027593,55053928,26335
"41544","ENSG00000267150","18",14089935,14091019,1084
"41545","ENSG00000267151","17",43444707,43451200,6493
"41546","ENSG00000267152","19",37728586,37730643,2057
"41547","ENSG00000267156","18",47630112,47630848,736
"41548","ENSG00000267157","19",5784005,5785619,1614
"41549","ENSG00000267159","19",928259,928817,558
"41550","ENSG00000267160","17",44673689,44676257,2568
"41551","ENSG00000267162","18",12101997,12102470,473
"41552","ENSG00000267166","17",43922775,43927388,4613
"41553","ENSG00000267169","19",14137146,14171267,34121
"41554","ENSG00000267172","18",55817167,55819759,2592
"41555","ENSG00000267174","19",11300777,11324441,23664
"41556","ENSG00000267175","18",61592375,61748832,156457
"41557","ENSG00000267177","18",13234945,13236470,1525
"41558","ENSG00000267178","19",19588091,19588415,324
"41559","ENSG00000267179","19",11925075,11979290,54215
"41560","ENSG00000267185","17",42533532,42534009,477
"41561","ENSG00000267188","19",44392439,44448452,56013
"41562","ENSG00000267191","19",43901909,43927767,25858
"41563","ENSG00000267192","19",56387412,56388424,1012
"41564","ENSG00000267193","18",45573084,45747215,174131
"41565","ENSG00000267196","18",49969721,49970957,1236
"41566","ENSG00000267197","19",10490339,10491000,661
"41567","ENSG00000267198","17",45545804,45563230,17426
"41568","ENSG00000267199","18",12438890,12448205,9315
"41569","ENSG00000267201","19",2458935,2462185,3250
"41570","ENSG00000267202","18",37273706,37276572,2866
"41571","ENSG00000267203","17",69318733,69318961,228
"41572","ENSG00000267204","19",32102088,32105916,3828
"41573","ENSG00000267205","19",3753840,3756517,2677
"41574","ENSG00000267206","9",136744017,136748525,4508
"41575","ENSG00000267207","17",61034636,61070122,35486
"41576","ENSG00000267211","17",44328613,44331462,2849
"41577","ENSG00000267212","19",12784539,12785101,562
"41578","ENSG00000267213","19",32390050,32405560,15510
"41579","ENSG00000267214","19",2631954,2632849,895
"41580","ENSG00000267215","18",59081911,59085920,4009
"41581","ENSG00000267216","19",58278966,58315197,36231
"41582","ENSG00000267218","19",15902300,15903238,938
"41583","ENSG00000267219","19",34348356,34359412,11056
"41584","ENSG00000267220","19",20131894,20151908,20014
"41585","ENSG00000267221","17",42038232,42050614,12382
"41586","ENSG00000267222","17",42495867,42496550,683
"41587","ENSG00000267224","19",56535299,56535763,464
"41588","ENSG00000267225","18",57027832,57038845,11013
"41589","ENSG00000267226","18",58670009,58671877,1868
"41590","ENSG00000267227","17",15748703,15749315,612
"41591","ENSG00000267231","19",3558015,3558486,471
"41592","ENSG00000267233","18",50814392,50815730,1338
"41593","ENSG00000267234","19",19401979,19402603,624
"41594","ENSG00000267235","19",15821796,15823797,2001
"41595","ENSG00000267239","18",13203774,13216367,12593
"41596","ENSG00000267240","19",28960506,28964943,4437
"41597","ENSG00000267243","19",28437060,28535277,98217
"41598","ENSG00000267244","19",1822089,1824542,2453
"41599","ENSG00000267245","19",32824142,32824505,363
"41600","ENSG00000267246","17",45549781,45558738,8957
"41601","ENSG00000267247","18",12230411,12231573,1162
"41602","ENSG00000267248","17",60122642,60135743,13101
"41603","ENSG00000267249","18",12670426,12671145,719
"41604","ENSG00000267250","17",68793549,68797822,4273
"41605","ENSG00000267251","18",80183680,80202992,19312
"41606","ENSG00000267252","18",11486205,11523087,36882
"41607","ENSG00000267253","17",43718314,43720436,2122
"41608","ENSG00000267254","19",36797502,36831596,34094
"41609","ENSG00000267255","19",4429689,4430934,1245
"41610","ENSG00000267257","18",58535415,58538552,3137
"41611","ENSG00000267258","19",29921182,29921653,471
"41612","ENSG00000267259","17",28232590,28235281,2691
"41613","ENSG00000267260","19",36773112,36777078,3966
"41614","ENSG00000267261","17",42119674,42154916,35242
"41615","ENSG00000267262","19",6067953,6077119,9166
"41616","ENSG00000267263","17",77469068,77471045,1977
"41617","ENSG00000267264","19",27803538,27804060,522
"41618","ENSG00000267265","19",55006193,55048086,41893
"41619","ENSG00000267269","18",59685820,59688400,2580
"41620","ENSG00000267270","18",80147924,80179839,31915
"41621","ENSG00000267271","17",35344231,35344564,333
"41622","ENSG00000267272","1",87129765,87169198,39433
"41623","ENSG00000267273","19",9498678,9510079,11401
"41624","ENSG00000267274","19",11939959,11953381,13422
"41625","ENSG00000267275","19",16283359,16324514,41155
"41626","ENSG00000267277","19",11368123,11374935,6812
"41627","ENSG00000267278","17",45247916,45269824,21908
"41628","ENSG00000267279","18",61585746,61607006,21260
"41629","ENSG00000267280","17",61393456,61411555,18099
"41630","ENSG00000267281","12",53506688,53625979,119291
"41631","ENSG00000267282","19",44882027,44890876,8849
"41632","ENSG00000267283","19",1989401,1990370,969
"41633","ENSG00000267284","18",55589904,55839184,249280
"41634","ENSG00000267285","12",1385833,1386987,1154
"41635","ENSG00000267286","18",13183402,13185617,2215
"41636","ENSG00000267287","18",79576460,79589010,12550
"41637","ENSG00000267288","17",45168800,45171584,2784
"41638","ENSG00000267289","19",9834079,9835013,934
"41639","ENSG00000267291","19",38596346,38601694,5348
"41640","ENSG00000267293","18",46028306,46029829,1523
"41641","ENSG00000267295","17",60113793,60120687,6894
"41642","ENSG00000267296","19",33302857,33305054,2197
"41643","ENSG00000267298","19",56311928,56312486,558
"41644","ENSG00000267299","19",6109322,6125797,16475
"41645","ENSG00000267301","18",23709825,23710287,462
"41646","ENSG00000267302","17",59964832,59996972,32140
"41647","ENSG00000267304","19",3672582,3674295,1713
"41648","ENSG00000267305","1",222510169,222519732,9563
"41649","ENSG00000267308","19",15827040,15835853,8813
"41650","ENSG00000267309","19",36489649,36491040,1391
"41651","ENSG00000267311","18",54879457,54880809,1352
"41652","ENSG00000267312","17",35459481,35460550,1069
"41653","ENSG00000267313","18",41465783,41632185,166402
"41654","ENSG00000267314","19",5904841,5914707,9866
"41655","ENSG00000267315","17",35377416,35377678,262
"41656","ENSG00000267316","18",61571342,61579456,8114
"41657","ENSG00000267317","19",1457670,1458580,910
"41658","ENSG00000267318","17",59940908,59973101,32193
"41659","ENSG00000267319","19",37693280,37693564,284
"41660","ENSG00000267320","19",28316705,28386204,69499
"41661","ENSG00000267321","17",35568076,35574900,6824
"41662","ENSG00000267322","18",49814023,49851059,37036
"41663","ENSG00000267323","19",27805423,27806205,782
"41664","ENSG00000267324","18",14143596,14151139,7543
"41665","ENSG00000267325","18",55776727,55781722,4995
"41666","ENSG00000267327","18",55893038,56026082,133044
"41667","ENSG00000267328","19",35754566,35755490,924
"41668","ENSG00000267333","18",11745626,11747581,1955
"41669","ENSG00000267334","17",44947912,44948939,1027
"41670","ENSG00000267336","18",12912844,12913906,1062
"41671","ENSG00000267337","18",44280768,44579953,299185
"41672","ENSG00000267338","22",16616170,16617114,944
"41673","ENSG00000267339","19",28883430,28970874,87444
"41674","ENSG00000267340","17",43169880,43170077,197
"41675","ENSG00000267341","18",62372894,62378130,5236
"41676","ENSG00000267342","17",75897060,75900148,3088
"41677","ENSG00000267343","19",11680944,11686259,5315
"41678","ENSG00000267344","17",45396932,45397477,545
"41679","ENSG00000267345","19",37075113,37078605,3492
"41680","ENSG00000267346","19",45128569,45129030,461
"41681","ENSG00000267348","19",45076510,45092635,16125
"41682","ENSG00000267349","17",35477994,35478444,450
"41683","ENSG00000267353","19",36773712,36775908,2196
"41684","ENSG00000267354","18",45507202,45550183,42981
"41685","ENSG00000267355","17",78845953,78846868,915
"41686","ENSG00000267359","17",35553205,35554767,1562
"41687","ENSG00000267360","19",37093019,37210512,117493
"41688","ENSG00000267361","17",69094289,69095499,1210
"41689","ENSG00000267363","19",36379351,36380912,1561
"41690","ENSG00000267364","17",35313479,35325449,11970
"41691","ENSG00000267365","17",70166961,70169402,2441
"41692","ENSG00000267366","18",13500641,13501289,648
"41693","ENSG00000267368","7",102637025,102642791,5766
"41694","ENSG00000267369","17",35498218,35499175,957
"41695","ENSG00000267370","19",9756152,9756863,711
"41696","ENSG00000267372","19",1321225,1322846,1621
"41697","ENSG00000267373","19",16103761,16104254,493
"41698","ENSG00000267374","18",39206917,39800322,593405
"41699","ENSG00000267375","19",38683873,38693606,9733
"41700","ENSG00000267376","17",76202644,76202796,152
"41701","ENSG00000267382","18",60611773,60654623,42850
"41702","ENSG00000267383","19",20122569,20321305,198736
"41703","ENSG00000267384","17",44645411,44645587,176
"41704","ENSG00000267385","19",4528427,4540067,11640
"41705","ENSG00000267387","19",10089032,10090377,1345
"41706","ENSG00000267388","19",35960512,35964063,3551
"41707","ENSG00000267389","19",27892495,27898927,6432
"41708","ENSG00000267390","18",63367328,63381629,14301
"41709","ENSG00000267391","18",58445788,58453766,7978
"41710","ENSG00000267393","18",13362203,13366243,4040
"41711","ENSG00000267394","17",44198882,44216565,17683
"41712","ENSG00000267395","19",45767796,45772504,4708
"41713","ENSG00000267397","18",35716370,35717978,1608
"41714","ENSG00000267399","18",56061109,56063078,1969
"41715","ENSG00000267400","18",60495868,60496336,468
"41716","ENSG00000267401","18",60294136,60301317,7181
"41717","ENSG00000267402","18",55492175,55496392,4217
"41718","ENSG00000267404","18",36273574,36274599,1025
"41719","ENSG00000267405","17",44794747,44797783,3036
"41720","ENSG00000267406","19",14267807,14269377,1570
"41721","ENSG00000267407","19",31520155,31554803,34648
"41722","ENSG00000267408","19",4621194,4622307,1113
"41723","ENSG00000267409","18",79610747,79612303,1556
"41724","ENSG00000267412","19",2610155,2611862,1707
"41725","ENSG00000267413","18",39841174,39924840,83666
"41726","ENSG00000267414","18",44676927,44679717,2790
"41727","ENSG00000267416","17",60079309,60088695,9386
"41728","ENSG00000267417","19",13013662,13014511,849
"41729","ENSG00000267418","19",9182369,9183048,679
"41730","ENSG00000267419","19",19776602,19836073,59471
"41731","ENSG00000267420","17",43927563,43932622,5059
"41732","ENSG00000267421","19",56536156,56538575,2419
"41733","ENSG00000267422","19",37779686,37792865,13179
"41734","ENSG00000267423","19",28509238,28518728,9490
"41735","ENSG00000267424","19",12825711,12832983,7272
"41736","ENSG00000267426","17",75898645,75930129,31484
"41737","ENSG00000267429","19",56347081,56348183,1102
"41738","ENSG00000267430","18",63415317,63416469,1152
"41739","ENSG00000267432","17",78484882,78503056,18174
"41740","ENSG00000267437","19",37128679,37141640,12961
"41741","ENSG00000267439","19",35747057,35753415,6358
"41742","ENSG00000267440","17",43679341,43706709,27368
"41743","ENSG00000267443","19",397589,399173,1584
"41744","ENSG00000267444","18",49650350,49651160,810
"41745","ENSG00000267446","17",45371402,45372057,655
"41746","ENSG00000267448","19",3296765,3306887,10122
"41747","ENSG00000267450","19",16051929,16052689,760
"41748","ENSG00000267452","17",51336646,51521401,184755
"41749","ENSG00000267453","19",15851993,15864904,12911
"41750","ENSG00000267454","19",56393656,56399172,5516
"41751","ENSG00000267455","18",11810406,11811484,1078
"41752","ENSG00000267456","18",36278735,36279119,384
"41753","ENSG00000267457","17",35073831,35074374,543
"41754","ENSG00000267461","17",68557516,68582577,25061
"41755","ENSG00000267462","18",60010281,60014258,3977
"41756","ENSG00000267463","17",78066258,78066761,503
"41757","ENSG00000267465","19",31588159,31593786,5627
"41758","ENSG00000267466","17",77563368,77568695,5327
"41759","ENSG00000267467","19",44942237,44945496,3259
"41760","ENSG00000267470","19",37548914,37587348,38434
"41761","ENSG00000267472","17",68198921,68199596,675
"41762","ENSG00000267474","19",14458401,14459366,965
"41763","ENSG00000267475","19",32687089,32691750,4661
"41764","ENSG00000267476","18",58672613,58752730,80117
"41765","ENSG00000267477","19",11466240,11505698,39458
"41766","ENSG00000267478","18",12091674,12093141,1467
"41767","ENSG00000267480","18",12031178,12032181,1003
"41768","ENSG00000267481","19",19788755,19790531,1776
"41769","ENSG00000267484","19",4838332,4838907,575
"41770","ENSG00000267486","18",59778572,59778989,417
"41771","ENSG00000267487","18",62418318,62418576,258
"41772","ENSG00000267489","19",31797666,32072113,274447
"41773","ENSG00000267490","19",9724008,9725086,1078
"41774","ENSG00000267491","17",78903263,78905024,1761
"41775","ENSG00000267492","17",18453574,18453739,165
"41776","ENSG00000267493","19",1267814,1270241,2427
"41777","ENSG00000267496","17",43917194,43917985,791
"41778","ENSG00000267497","18",59969438,59971396,1958
"41779","ENSG00000267498","19",29213235,29216604,3369
"41780","ENSG00000267500","19",11648364,11652877,4513
"41781","ENSG00000267501","18",58754859,58757842,2983
"41782","ENSG00000267503","18",13561399,13565035,3636
"41783","ENSG00000267504","18",58371566,58372666,1100
"41784","ENSG00000267505","17",44793199,44794474,1275
"41785","ENSG00000267506","17",77546940,77563243,16303
"41786","ENSG00000267507","19",55119250,55120383,1133
"41787","ENSG00000267508","19",44382298,44401608,19310
"41788","ENSG00000267510","19",9291515,9294482,2967
"41789","ENSG00000267511","18",50063795,50064440,645
"41790","ENSG00000267512","19",13139617,13141147,1530
"41791","ENSG00000267515","18",12450447,12451042,595
"41792","ENSG00000267517","19",16065737,16066312,575
"41793","ENSG00000267518","17",76345761,76346081,320
"41794","ENSG00000267519","19",13823880,13842928,19048
"41795","ENSG00000267521","17",76957023,76958222,1199
"41796","ENSG00000267522","19",56066684,56078801,12117
"41797","ENSG00000267523","19",55661901,55674715,12814
"41798","ENSG00000267524","18",54744750,54745581,831
"41799","ENSG00000267526","17",60063004,60064782,1778
"41800","ENSG00000267529","18",13471012,13472709,1697
"41801","ENSG00000267530","19",782755,786092,3337
"41802","ENSG00000267532","17",7015818,7019659,3841
"41803","ENSG00000267533","18",12067173,12068417,1244
"41804","ENSG00000267534","19",10221433,10231331,9898
"41805","ENSG00000267535","17",76849840,76861836,11996
"41806","ENSG00000267537","19",28602379,28648303,45924
"41807","ENSG00000267541","18",47853233,47853457,224
"41808","ENSG00000267543","17",76549951,76550826,875
"41809","ENSG00000267544","19",10841839,10842250,411
"41810","ENSG00000267546","17",76545668,76557683,12015
"41811","ENSG00000267547","17",35403837,35404373,536
"41812","ENSG00000267549","19",56314703,56365316,50613
"41813","ENSG00000267550","19",5178119,5178464,345
"41814","ENSG00000267551","19",3141576,3155175,13599
"41815","ENSG00000267552","19",37689865,37719188,29323
"41816","ENSG00000267554","17",35470069,35470628,559
"41817","ENSG00000267555","19",32831295,32833168,1873
"41818","ENSG00000267557","19",32666298,32673210,6912
"41819","ENSG00000267558","18",45788530,45788670,140
"41820","ENSG00000267559","9",81930226,81977089,46863
"41821","ENSG00000267560","18",62300036,62300998,962
"41822","ENSG00000267561","1",86993009,87169204,176195
"41823","ENSG00000267563","19",6259157,6259799,642
"41824","ENSG00000267564","18",11447756,11489369,41613
"41825","ENSG00000267565","19",19892433,19895847,3414
"41826","ENSG00000267567","19",32718298,32719595,1297
"41827","ENSG00000267568","17",76950317,76969156,18839
"41828","ENSG00000267570","18",12911186,12912023,837
"41829","ENSG00000267571","19",5911578,5913899,2321
"41830","ENSG00000267573","18",44320800,44322257,1457
"41831","ENSG00000267574","19",29448038,29448380,342
"41832","ENSG00000267575","19",27793431,27984984,191553
"41833","ENSG00000267577","19",55158939,55177540,18601
"41834","ENSG00000267579","18",58557070,58566677,9607
"41835","ENSG00000267581","19",19761038,19821716,60678
"41836","ENSG00000267582","19",13796574,13796933,359
"41837","ENSG00000267583","18",35443869,35467088,23219
"41838","ENSG00000267585","18",34573987,34574523,536
"41839","ENSG00000267586","18",42159283,42691422,532139
"41840","ENSG00000267587","18",46852632,46853882,1250
"41841","ENSG00000267589","19",6072823,6073527,704
"41842","ENSG00000267590","19",44297104,44297355,251
"41843","ENSG00000267591","18",50098742,50099162,420
"41844","ENSG00000267592","17",35596904,35597128,224
"41845","ENSG00000267593","18",58808468,58834364,25896
"41846","ENSG00000267594","19",15760241,15779909,19668
"41847","ENSG00000267595","17",43168170,43168249,79
"41848","ENSG00000267599","19",31465653,31466431,778
"41849","ENSG00000267603","17",70051277,70068095,16818
"41850","ENSG00000267604","17",43782804,43784682,1878
"41851","ENSG00000267605","19",37235507,37304395,68888
"41852","ENSG00000267606","19",56354493,56368053,13560
"41853","ENSG00000267607","19",10285801,10289019,3218
"41854","ENSG00000267609","19",16034776,16036537,1761
"41855","ENSG00000267610","19",13069792,13071374,1582
"41856","ENSG00000267611","19",33051515,33051701,186
"41857","ENSG00000267612","19",9730853,9731943,1090
"41858","ENSG00000267614","19",44536263,44536613,350
"41859","ENSG00000267617","19",28869507,28879176,9669
"41860","ENSG00000267618","17",35011349,35121493,110144
"41861","ENSG00000267620","18",60196555,60198172,1617
"41862","ENSG00000267623","19",27902595,27984743,82148
"41863","ENSG00000267624","17",78211618,78211908,290
"41864","ENSG00000267625","17",35561539,35562077,538
"41865","ENSG00000267626","19",35608285,35612666,4381
"41866","ENSG00000267627","18",35951803,35966118,14315
"41867","ENSG00000267629","19",19254748,19273369,18621
"41868","ENSG00000267630","19",27918943,27929370,10427
"41869","ENSG00000267631","19",49035610,49036895,1285
"41870","ENSG00000267632","17",42509784,42511519,1735
"41871","ENSG00000267633","19",13772118,13774118,2000
"41872","ENSG00000267634","17",44365014,44365751,737
"41873","ENSG00000267636","19",31421997,31427302,5305
"41874","ENSG00000267637","17",59784813,59785035,222
"41875","ENSG00000267638","17",44115912,44120595,4683
"41876","ENSG00000267640","19",37817359,37832160,14801
"41877","ENSG00000267641","19",20175013,20177063,2050
"41878","ENSG00000267642","18",33552123,33578187,26064
"41879","ENSG00000267644","17",28219285,28220005,720
"41880","ENSG00000267646","19",11796084,11798598,2514
"41881","ENSG00000267647","18",54954403,54954732,329
"41882","ENSG00000267648","17",35406948,35407818,870
"41883","ENSG00000267649","19",55216660,55221616,4956
"41884","ENSG00000267650","19",9995997,9997163,1166
"41885","ENSG00000267651","18",37234119,37236242,2123
"41886","ENSG00000267652","18",41789162,41789395,233
"41887","ENSG00000267653","17",69477139,69501755,24616
"41888","ENSG00000267655","18",79117207,79117920,713
"41889","ENSG00000267656","18",13139780,13140489,709
"41890","ENSG00000267658","17",42154600,42155972,1372
"41891","ENSG00000267659","17",68591796,68763882,172086
"41892","ENSG00000267661","18",11928838,11929476,638
"41893","ENSG00000267662","19",31348881,31417794,68913
"41894","ENSG00000267665","17",77516887,77536601,19714
"41895","ENSG00000267666","19",663482,669500,6018
"41896","ENSG00000267669","18",59821040,59825261,4221
"41897","ENSG00000267670","19",14030855,14031557,702
"41898","ENSG00000267672","19",37091341,37092564,1223
"41899","ENSG00000267673","19",10310045,10316015,5970
"41900","ENSG00000267674","18",49739823,49742063,2240
"41901","ENSG00000267675","18",58416765,58417628,863
"41902","ENSG00000267676","17",78248493,78254416,5923
"41903","ENSG00000267677","18",59360700,59386749,26049
"41904","ENSG00000267678","17",60562010,60562161,151
"41905","ENSG00000267679","17",78157403,78159135,1732
"41906","ENSG00000267680","19",44094339,44109886,15547
"41907","ENSG00000267681","17",43144956,43145255,299
"41908","ENSG00000267682","19",37337236,37337743,507
"41909","ENSG00000267683","19",28892931,28895949,3018
"41910","ENSG00000267686","18",60125033,60161195,36162
"41911","ENSG00000267690","18",13419421,13427480,8059
"41912","ENSG00000267691","17",44228760,44230228,1468
"41913","ENSG00000267692","19",30037285,30037411,126
"41914","ENSG00000267693","19",19768731,19768989,258
"41915","ENSG00000267694","18",13461020,13470823,9803
"41916","ENSG00000267695","18",50302190,50313595,11405
"41917","ENSG00000267696","19",27638483,27646483,8000
"41918","ENSG00000267698","19",36014508,36045972,31464
"41919","ENSG00000267699","18",50968019,51058144,90125
"41920","ENSG00000267702","18",13486462,13490676,4214
"41921","ENSG00000267703","19",16440946,16443584,2638
"41922","ENSG00000267706","19",55352301,55359516,7215
"41923","ENSG00000267707","18",37243776,37247506,3730
"41924","ENSG00000267708","17",68152776,68159043,6267
"41925","ENSG00000267709","19",5847467,5858239,10772
"41926","ENSG00000267710","19",56272748,56310454,37706
"41927","ENSG00000267711","17",35400878,35403006,2128
"41928","ENSG00000267712","18",56083356,56137536,54180
"41929","ENSG00000267713","18",50669510,50670215,705
"41930","ENSG00000267714","19",33217817,33222355,4538
"41931","ENSG00000267716","18",44039471,44040140,669
"41932","ENSG00000267717","18",51158282,51159383,1101
"41933","ENSG00000267719","17",79707266,79712317,5051
"41934","ENSG00000267723","19",14254189,14293205,39016
"41935","ENSG00000267724","18",47105946,47108062,2116
"41936","ENSG00000267729","17",28727258,28727739,481
"41937","ENSG00000267731","17",68189884,68192802,2918
"41938","ENSG00000267732","18",56137573,56150102,12529
"41939","ENSG00000267733","18",12201982,12223539,21557
"41940","ENSG00000267734","1",86932199,86934891,2692
"41941","ENSG00000267735","19",12880969,12884088,3119
"41942","ENSG00000267736","19",1203209,1203842,633
"41943","ENSG00000267737","17",78315729,78347798,32069
"41944","ENSG00000267740","19",5866171,5903787,37616
"41945","ENSG00000267741","19",9774497,9774960,463
"41946","ENSG00000267742","18",60016778,60017441,663
"41947","ENSG00000267743","18",58189834,58195696,5862
"41948","ENSG00000267744","17",35190961,35191702,741
"41949","ENSG00000267745","17",35406684,35409768,3084
"41950","ENSG00000267746","18",34222965,34224761,1796
"41951","ENSG00000267748","19",38289151,38304910,15759
"41952","ENSG00000267749","19",2641838,2643853,2015
"41953","ENSG00000267750","17",44299574,44315315,15741
"41954","ENSG00000267751","19",567210,572228,5018
"41955","ENSG00000267757","19",45641494,45642840,1346
"41956","ENSG00000267758","17",42268587,42269807,1220
"41957","ENSG00000267760","19",30665274,30668647,3373
"41958","ENSG00000267761","18",47285725,47594550,308825
"41959","ENSG00000267762","18",48673575,48688419,14844
"41960","ENSG00000267764","18",48826051,48834770,8719
"41961","ENSG00000267765","17",42683187,42699466,16279
"41962","ENSG00000267766","18",63151114,63151320,206
"41963","ENSG00000267767","19",34788527,34832869,44342
"41964","ENSG00000267768","19",27908356,27908554,198
"41965","ENSG00000267769","19",4454014,4455286,1272
"41966","ENSG00000267772","17",60564547,60586623,22076
"41967","ENSG00000267773","18",11644336,11644824,488
"41968","ENSG00000267774","18",59696459,59698111,1652
"41969","ENSG00000267776","19",56376704,56377284,580
"41970","ENSG00000267777","19",31167457,31225143,57686
"41971","ENSG00000267778","19",1238179,1239522,1343
"41972","ENSG00000267779","19",32025808,32073809,48001
"41973","ENSG00000267780","18",79792726,79816529,23803
"41974","ENSG00000267781","19",56386226,56386690,464
"41975","ENSG00000267782","17",35164243,35167012,2769
"41976","ENSG00000267783","19",14119106,14119537,431
"41977","ENSG00000267784","2",178723457,178727046,3589
"41978","ENSG00000267786","19",35947115,35959192,12077
"41979","ENSG00000267787","18",57639455,57738603,99148
"41980","ENSG00000267788","17",44982514,44982772,258
"41981","ENSG00000267789","18",57136322,57146998,10676
"41982","ENSG00000267790","17",77722872,77728559,5687
"41983","ENSG00000267793","Y",19598188,19598757,569
"41984","ENSG00000267795","16",4788397,4796491,8094
"41985","ENSG00000267796","19",35748361,35754519,6158
"41986","ENSG00000267799","19",28790812,28792871,2059
"41987","ENSG00000267800","18",47137018,47137290,272
"41988","ENSG00000267801","17",75876372,75879546,3174
"41989","ENSG00000267808","19",51599289,51600470,1181
"41990","ENSG00000267809","19",53223973,53224879,906
"41991","ENSG00000267811","11",62771120,62771606,486
"41992","ENSG00000267827","19",52130548,52171533,40985
"41993","ENSG00000267834","9",129004502,129004998,496
"41994","ENSG00000267838","19",54438665,54439544,879
"41995","ENSG00000267852","19",7390522,7395039,4517
"41996","ENSG00000267855","19",8308768,8321396,12628
"41997","ENSG00000267857","21",45100487,45101094,607
"41998","ENSG00000267858","19",58559129,58574797,15668
"41999","ENSG00000267868","13",112964835,112966131,1296
"42000","ENSG00000267871","19",57267211,57280334,13123
"42001","ENSG00000267872","19",22243254,22245347,2093
"42002","ENSG00000267879","19",50968193,51012129,43936
"42003","ENSG00000267882","20",47318502,47320754,2252
"42004","ENSG00000267886","19",23075201,23100361,25160
"42005","ENSG00000267890","19",50075123,50075902,779
"42006","ENSG00000267892","19",38738284,38739863,1579
"42007","ENSG00000267895","19",51143826,51144196,370
"42008","ENSG00000267898","19",48963975,48965158,1183
"42009","ENSG00000267904","19",16639967,16640668,701
"42010","ENSG00000267905","19",51340695,51344117,3422
"42011","ENSG00000267908","19",56244043,56247482,3439
"42012","ENSG00000267909","14",69569799,69574871,5072
"42013","ENSG00000267919","2",219645090,219645631,541
"42014","ENSG00000267920","19",23126569,23127792,1223
"42015","ENSG00000267922","19",46101122,46196218,95096
"42016","ENSG00000267924","19",23817599,23874701,57102
"42017","ENSG00000267927","19",52171158,52177002,5844
"42018","ENSG00000267934","19",23323968,23329101,5133
"42019","ENSG00000267938","19",4347780,4349061,1281
"42020","ENSG00000267939","19",8008729,8016025,7296
"42021","ENSG00000267940","11",6201901,6203253,1352
"42022","ENSG00000267943","19",53007512,53013180,5668
"42023","ENSG00000267952","19",7507052,7519622,12570
"42024","ENSG00000267959","19",18282077,18282161,84
"42025","ENSG00000267961","19",15141105,15142062,957
"42026","ENSG00000267968","19",50830530,50851089,20559
"42027","ENSG00000267978","X",149581653,149587453,5800
"42028","ENSG00000267980","19",4363789,4364640,851
"42029","ENSG00000267986","19",8581160,8582715,1555
"42030","ENSG00000267990","19",51137970,51138634,664
"42031","ENSG00000267992","19",39030436,39031323,887
"42032","ENSG00000268001","19",48255675,48258199,2524
"42033","ENSG00000268006","19",49838639,49851676,13037
"42034","ENSG00000268015","19",52222225,52231294,9069
"42035","ENSG00000268027","19",41545192,41555462,10270
"42036","ENSG00000268030","19",18557775,18561560,3785
"42037","ENSG00000268034","19",41506152,41506898,746
"42038","ENSG00000268038","19",22615552,22623971,8419
"42039","ENSG00000268041","19",41907705,41928516,20811
"42040","ENSG00000268043","1",146938744,146996202,57458
"42041","ENSG00000268047","19",49852887,49854967,2080
"42042","ENSG00000268049","19",58357999,58359603,1604
"42043","ENSG00000268051","19",37963853,37964790,937
"42044","ENSG00000268053","19",46111079,46113863,2784
"42045","ENSG00000268055","19",38535517,38537128,1611
"42046","ENSG00000268056","19",17152588,17168051,15463
"42047","ENSG00000268058","19",24098425,24098980,555
"42048","ENSG00000268061","19",47484282,47501597,17315
"42049","ENSG00000268066","X",147909431,147911817,2386
"42050","ENSG00000268067","19",56760933,56761215,282
"42051","ENSG00000268069","12",47784923,47786002,1079
"42052","ENSG00000268070","19",20033444,20034332,888
"42053","ENSG00000268078","16",86158206,86158798,592
"42054","ENSG00000268079","19",22203128,22204003,875
"42055","ENSG00000268080","8",93229659,93229916,257
"42056","ENSG00000268081","19",21554640,21569237,14597
"42057","ENSG00000268083","19",38817471,38840178,22707
"42058","ENSG00000268087","19",16610411,16636531,26120
"42059","ENSG00000268088","19",39693925,39696258,2333
"42060","ENSG00000268089","X",152637895,152657542,19647
"42061","ENSG00000268093","19",48619272,48624132,4860
"42062","ENSG00000268095","19",51888025,51900463,12438
"42063","ENSG00000268100","19",23492428,23512656,20228
"42064","ENSG00000268101","19",41050449,41062444,11995
"42065","ENSG00000268104","X",116436606,116461458,24852
"42066","ENSG00000268105","19",23125665,23128543,2878
"42067","ENSG00000268107","19",57487718,57517559,29841
"42068","ENSG00000268108","19",49060613,49061132,519
"42069","ENSG00000268117","19",21719801,21720035,234
"42070","ENSG00000268119","19",21444241,21463908,19667
"42071","ENSG00000268129","3",143000907,143001467,560
"42072","ENSG00000268140","19",22137931,22138981,1050
"42073","ENSG00000268144","19",51396755,51403526,6771
"42074","ENSG00000268148","19",23290849,23291017,168
"42075","ENSG00000268153","19",39638685,39642401,3716
"42076","ENSG00000268154","1",154950210,154950492,282
"42077","ENSG00000268157","19",49356152,49357769,1617
"42078","ENSG00000268163","19",57437970,57477536,39566
"42079","ENSG00000268170","7",143220468,143222267,1799
"42080","ENSG00000268174","19",20416514,20417069,555
"42081","ENSG00000268182","19",56643159,56657247,14088
"42082","ENSG00000268184","19",21768772,21793860,25088
"42083","ENSG00000268186","19",48262900,48271283,8383
"42084","ENSG00000268189","19",15379076,15381194,2118
"42085","ENSG00000268193","19",18907013,18934397,27384
"42086","ENSG00000268199","19",18441419,18443597,2178
"42087","ENSG00000268201","19",58266635,58267685,1050
"42088","ENSG00000268204","19",7633766,7636990,3224
"42089","ENSG00000268205","19",57304305,57308562,4257
"42090","ENSG00000268218","16",89268104,89273044,4940
"42091","ENSG00000268222","19",35382172,35384052,1880
"42092","ENSG00000268223","5",116032324,116060118,27794
"42093","ENSG00000268225","19",52861807,52864151,2344
"42094","ENSG00000268230","19",58346854,58362751,15897
"42095","ENSG00000268231","19",50555370,50557969,2599
"42096","ENSG00000268234","9",42384805,42386136,1331
"42097","ENSG00000268240","19",21587432,21594628,7196
"42098","ENSG00000268243","19",39644502,39644612,110
"42099","ENSG00000268257","6",160003291,160007664,4373
"42100","ENSG00000268262","19",39314651,39320858,6207
"42101","ENSG00000268266","19",57477649,57482996,5347
"42102","ENSG00000268267","19",51563797,51564910,1113
"42103","ENSG00000268272","19",20583084,20583647,563
"42104","ENSG00000268278","19",21637974,21656300,18326
"42105","ENSG00000268279","3",14135217,14148252,13035
"42106","ENSG00000268282","19",53004040,53005150,1110
"42107","ENSG00000268287","19",49064259,49064856,597
"42108","ENSG00000268288","1",151766486,151767000,514
"42109","ENSG00000268289","19",17051994,17055087,3093
"42110","ENSG00000268293","19",58136713,58137054,341
"42111","ENSG00000268295","14",91603173,91603433,260
"42112","ENSG00000268296","19",22902538,22914340,11802
"42113","ENSG00000268297","19",7787549,7790621,3072
"42114","ENSG00000268307","19",58400221,58400679,458
"42115","ENSG00000268316","19",51839771,51840945,1174
"42116","ENSG00000268318","19",51271266,51281234,9968
"42117","ENSG00000268320","17",137526,139067,1541
"42118","ENSG00000268322","19",21318161,21318719,558
"42119","ENSG00000268324","3",46557398,46559694,2296
"42120","ENSG00000268326","19",20972262,20983210,10948
"42121","ENSG00000268333","20",58833809,58836529,2720
"42122","ENSG00000268335","19",20443215,20443725,510
"42123","ENSG00000268336","19",51184905,51190809,5904
"42124","ENSG00000268350","X",52926402,52995472,69070
"42125","ENSG00000268355","19",41531206,41532174,968
"42126","ENSG00000268357","19",21123817,21124188,371
"42127","ENSG00000268362","19",24033401,24077377,43976
"42128","ENSG00000268364","9",70193997,70258866,64869
"42129","ENSG00000268366","19",40443436,40444087,651
"42130","ENSG00000268375","19",50792685,50793584,899
"42131","ENSG00000268379","19",57175233,57177921,2688
"42132","ENSG00000268388","16",86474529,86509099,34570
"42133","ENSG00000268390","19",51043806,51052077,8271
"42134","ENSG00000268392","19",57625032,57626950,1918
"42135","ENSG00000268400","19",7629796,7643048,13252
"42136","ENSG00000268401","19",46027648,46031667,4019
"42137","ENSG00000268403","11",9459556,9460702,1146
"42138","ENSG00000268407","19",56793048,56793249,201
"42139","ENSG00000268412","2",26028208,26028612,404
"42140","ENSG00000268416","19",20746923,20755250,8327
"42141","ENSG00000268423","19",46547056,46600861,53805
"42142","ENSG00000268433","19",21677550,21678221,671
"42143","ENSG00000268434","19",45779437,45785973,6536
"42144","ENSG00000268438","19",21826513,21827279,766
"42145","ENSG00000268442","19",24162370,24163425,1055
"42146","ENSG00000268447","X",52751132,52790305,39173
"42147","ENSG00000268455","19",23596122,23598159,2037
"42148","ENSG00000268458","19",52142626,52144156,1530
"42149","ENSG00000268460","19",46201552,46214838,13286
"42150","ENSG00000268461","19",20389658,20390689,1031
"42151","ENSG00000268465","19",48465837,48472431,6594
"42152","ENSG00000268471","4",152536264,152539263,2999
"42153","ENSG00000268472","11",112260265,112261396,1131
"42154","ENSG00000268480","19",8630638,8638649,8011
"42155","ENSG00000268486","13",18408806,18431605,22799
"42156","ENSG00000268496","19",54434183,54434665,482
"42157","ENSG00000268499","19",38199836,38200934,1098
"42158","ENSG00000268505","16",86192793,86198913,6120
"42159","ENSG00000268509","3",5187172,5188298,1126
"42160","ENSG00000268510","19",39236433,39237293,860
"42161","ENSG00000268516","19",58257270,58278808,21538
"42162","ENSG00000268520","19",51361712,51365544,3832
"42163","ENSG00000268521","19",21289554,21289998,444
"42164","ENSG00000268529","19",41134722,41137308,2586
"42165","ENSG00000268530","19",48465348,48469693,4345
"42166","ENSG00000268531","15",21368459,21370621,2162
"42167","ENSG00000268532","16",86286427,86293389,6962
"42168","ENSG00000268533","19",57394183,57438457,44274
"42169","ENSG00000268535","19",21709522,21710191,669
"42170","ENSG00000268536","19",4785120,4791207,6087
"42171","ENSG00000268541","19",22861303,22861594,291
"42172","ENSG00000268543","19",58418560,58419310,750
"42173","ENSG00000268545","19",57459912,57460120,208
"42174","ENSG00000268555","19",21569738,21587322,17584
"42175","ENSG00000268560","19",20611559,20615389,3830
"42176","ENSG00000268564","19",15124160,15126174,2014
"42177","ENSG00000268566","18",38655209,38688033,32824
"42178","ENSG00000268573","18",35280867,35290201,9334
"42179","ENSG00000268575","1",1702736,1737688,34952
"42180","ENSG00000268580","2",144877734,144882033,4299
"42181","ENSG00000268581","19",51119987,51122965,2978
"42182","ENSG00000268582","19",41652676,41652963,287
"42183","ENSG00000268583","19",48204071,48214751,10680
"42184","ENSG00000268584","10",73625996,73626790,794
"42185","ENSG00000268592","6",149863494,149919507,56013
"42186","ENSG00000268595","19",51251231,51271179,19948
"42187","ENSG00000268597","19",22259693,22261335,1642
"42188","ENSG00000268598","19",21063924,21064261,337
"42189","ENSG00000268601","19",43794309,43795658,1349
"42190","ENSG00000268603","2",219497611,219498246,635
"42191","ENSG00000268606","X",152749863,152753884,4021
"42192","ENSG00000268615","9",129328261,129328401,140
"42193","ENSG00000268618","19",8549506,8550139,633
"42194","ENSG00000268620","19",20249052,20250295,1243
"42195","ENSG00000268621","19",46189029,46203160,14131
"42196","ENSG00000268623","19",18040355,18041083,728
"42197","ENSG00000268628","20",19756390,19758037,1647
"42198","ENSG00000268629","X",105218929,105220674,1745
"42199","ENSG00000268635","11",77473371,77477030,3659
"42200","ENSG00000268643","19",42234583,42255132,20549
"42201","ENSG00000268649","20",58817132,58817725,593
"42202","ENSG00000268650","19",18204730,18220480,15750
"42203","ENSG00000268652","19",51194118,51195540,1422
"42204","ENSG00000268654","19",56840866,56848556,7690
"42205","ENSG00000268655","19",49017496,49020523,3027
"42206","ENSG00000268658","19",21483374,21503238,19864
"42207","ENSG00000268659","10",75642476,75643106,630
"42208","ENSG00000268660","19",58044592,58046769,2177
"42209","ENSG00000268663","1",674842,675265,423
"42210","ENSG00000268670","19",4061615,4062749,1134
"42211","ENSG00000268673","19",15760375,15770828,10453
"42212","ENSG00000268678","19",57350848,57352012,1164
"42213","ENSG00000268681","19",49502432,49502639,207
"42214","ENSG00000268683","19",34638122,34640689,2567
"42215","ENSG00000268685","19",22362589,22362825,236
"42216","ENSG00000268686","19",49368558,49388091,19533
"42217","ENSG00000268696","19",22832321,22858667,26346
"42218","ENSG00000268705","19",21521343,21521896,553
"42219","ENSG00000268707","9",129170434,129170940,506
"42220","ENSG00000268713","19",57261354,57262738,1384
"42221","ENSG00000268717","19",22457329,22458212,883
"42222","ENSG00000268723","19",57317208,57317562,354
"42223","ENSG00000268731","19",21381220,21381921,701
"42224","ENSG00000268734","19",54890673,54891420,747
"42225","ENSG00000268736","4",49246021,49246538,517
"42226","ENSG00000268738","X",149592512,149595314,2802
"42227","ENSG00000268743","19",16844025,16846473,2448
"42228","ENSG00000268744","19",12379189,12401274,22085
"42229","ENSG00000268746","19",47607524,47733098,125574
"42230","ENSG00000268747","19",21276023,21276332,309
"42231","ENSG00000268750","19",57819719,57858941,39222
"42232","ENSG00000268751","19",34576733,34577701,968
"42233","ENSG00000268754","16",86221420,86301303,79883
"42234","ENSG00000268756","19",38820166,38823223,3057
"42235","ENSG00000268758","19",6952500,6997872,45372
"42236","ENSG00000268764","19",38108500,38109533,1033
"42237","ENSG00000268785","19",6593329,6594055,726
"42238","ENSG00000268789","19",22742924,22743410,486
"42239","ENSG00000268790","19",16577642,16660115,82473
"42240","ENSG00000268794","19",23288620,23289345,725
"42241","ENSG00000268798","19",1440839,1441938,1099
"42242","ENSG00000268799","5",17491325,17491769,444
"42243","ENSG00000268804","16",85935281,85936223,942
"42244","ENSG00000268812","22",30246205,30246998,793
"42245","ENSG00000268818","22",35626988,35635134,8146
"42246","ENSG00000268823","19",22603269,22608501,5232
"42247","ENSG00000268830","19",22447934,22448777,843
"42248","ENSG00000268833","19",41757898,41786893,28995
"42249","ENSG00000268836","16",185748,186294,546
"42250","ENSG00000268845","19",6953211,6954904,1693
"42251","ENSG00000268847","19",56589495,56590281,786
"42252","ENSG00000268849","19",51211080,51212088,1008
"42253","ENSG00000268858","20",63861212,63864293,3081
"42254","ENSG00000268861","19",7382834,7470241,87407
"42255","ENSG00000268864","19",53599628,53608451,8823
"42256","ENSG00000268866","19",58224506,58225469,963
"42257","ENSG00000268869","1",16687339,16720157,32818
"42258","ENSG00000268870","19",12391949,12441082,49133
"42259","ENSG00000268873","18",34737795,34767663,29868
"42260","ENSG00000268879","19",46196238,46197323,1085
"42261","ENSG00000268883","X",153075769,153076968,1199
"42262","ENSG00000268884","19",8346517,8347687,1170
"42263","ENSG00000268886","19",52575883,52585561,9678
"42264","ENSG00000268889","19",51394488,51403650,9162
"42265","ENSG00000268892","19",21221645,21222746,1101
"42266","ENSG00000268894","10",94278681,94287478,8797
"42267","ENSG00000268895","19",58347718,58355455,7737
"42268","ENSG00000268896","2",219547211,219547658,447
"42269","ENSG00000268902","X",152708261,152714549,6288
"42270","ENSG00000268903","1",135141,135895,754
"42271","ENSG00000268906","19",51030076,51034335,4259
"42272","ENSG00000268912","19",58428632,58431148,2516
"42273","ENSG00000268916","X",152753921,152760222,6301
"42274","ENSG00000268926","9",95772323,95776282,3959
"42275","ENSG00000268931","19",8423355,8427827,4472
"42276","ENSG00000268938","19",18531613,18532632,1019
"42277","ENSG00000268940","X",135713453,135723539,10086
"42278","ENSG00000268941","20",58634772,58635738,966
"42279","ENSG00000268942","5",62512246,62512482,236
"42280","ENSG00000268945","19",12682693,12687279,4586
"42281","ENSG00000268947","19",35262846,35264804,1958
"42282","ENSG00000268949","1",44988705,44991834,3129
"42283","ENSG00000268955","8",8188535,8189195,660
"42284","ENSG00000268964","19",53044738,53051679,6941
"42285","ENSG00000268970","19",52597699,52598887,1188
"42286","ENSG00000268975","19",40771648,40796943,25295
"42287","ENSG00000268981","19",22665552,22716991,51439
"42288","ENSG00000268985","19",17009189,17013460,4271
"42289","ENSG00000268987","19",41399372,41400365,993
"42290","ENSG00000268988","X",143711955,143721423,9468
"42291","ENSG00000268992","19",23384530,23385293,763
"42292","ENSG00000268996","9",137084946,137086817,1871
"42293","ENSG00000269001","19",53197111,53214522,17411
"42294","ENSG00000269009","19",49255472,49256102,630
"42295","ENSG00000269012","19",20961057,20965140,4083
"42296","ENSG00000269014","19",46826895,46828440,1545
"42297","ENSG00000269019","19",18940235,18947452,7217
"42298","ENSG00000269021","19",51280862,51283022,2160
"42299","ENSG00000269025","19",22605739,22608211,2472
"42300","ENSG00000269026","19",57682045,57753575,71530
"42301","ENSG00000269028","3",96617188,96618236,1048
"42302","ENSG00000269037","19",34905315,34908188,2873
"42303","ENSG00000269038","11",64778954,64779405,451
"42304","ENSG00000269040","19",20784596,20785152,556
"42305","ENSG00000269043","19",20432552,20571095,138543
"42306","ENSG00000269044","19",16633797,16635269,1472
"42307","ENSG00000269050","19",38870159,38873763,3604
"42308","ENSG00000269054","19",58362583,58367593,5010
"42309","ENSG00000269055","19",20267817,20268391,574
"42310","ENSG00000269058","19",16479057,16496192,17135
"42311","ENSG00000269066","19",17095418,17099307,3889
"42312","ENSG00000269067","19",22975468,23003176,27708
"42313","ENSG00000269068","2",219559083,219559626,543
"42314","ENSG00000269069","19",40023384,40025502,2118
"42315","ENSG00000269072","19",51152923,51181966,29043
"42316","ENSG00000269082","19",52956041,52981654,25613
"42317","ENSG00000269086","19",34837889,34872479,34590
"42318","ENSG00000269091","19",50043196,50051062,7866
"42319","ENSG00000269096","X",135759846,135768191,8345
"42320","ENSG00000269097","19",57664280,57665039,759
"42321","ENSG00000269102","19",52284780,52297920,13140
"42322","ENSG00000269103","20",49932795,49933078,283
"42323","ENSG00000269107","19",23257255,23274232,16977
"42324","ENSG00000269110","19",20553792,20661583,107791
"42325","ENSG00000269113","1",47760528,47997385,236857
"42326","ENSG00000269118","19",53299051,53308644,9593
"42327","ENSG00000269119","19",41829692,41830938,1246
"42328","ENSG00000269124","19",46320197,46340004,19807
"42329","ENSG00000269125","13",113165002,113165183,181
"42330","ENSG00000269130","19",51560122,51560590,468
"42331","ENSG00000269136","19",21800480,21801266,786
"42332","ENSG00000269138","19",22463922,22473036,9114
"42333","ENSG00000269139","19",7926001,7926810,809
"42334","ENSG00000269148","19",45830164,45831108,944
"42335","ENSG00000269153","19",7879445,7880120,675
"42336","ENSG00000269154","19",20062755,20063320,565
"42337","ENSG00000269155","6",167795530,167798248,2718
"42338","ENSG00000269161","19",17518330,17520565,2235
"42339","ENSG00000269172","19",39134882,39136463,1581
"42340","ENSG00000269176","11",62786023,62786785,762
"42341","ENSG00000269177","19",43553445,43555494,2049
"42342","ENSG00000269181","19",51442379,51442650,271
"42343","ENSG00000269186","16",86195954,86199720,3766
"42344","ENSG00000269189","13",98233650,98234700,1050
"42345","ENSG00000269190","19",38941401,38975742,34341
"42346","ENSG00000269191","19",18532908,18536188,3280
"42347","ENSG00000269194","19",49808933,49809738,805
"42348","ENSG00000269210","2",38959287,38960342,1055
"42349","ENSG00000269220","22",17777322,17779481,2159
"42350","ENSG00000269226","X",104063871,104076212,12341
"42351","ENSG00000269228","19",7665717,7666476,759
"42352","ENSG00000269235","19",51949134,51981367,32233
"42353","ENSG00000269236","19",58166166,58167145,979
"42354","ENSG00000269242","19",12643831,12648397,4566
"42355","ENSG00000269243","19",16123661,16139892,16231
"42356","ENSG00000269244","19",8728735,8729204,469
"42357","ENSG00000269246","19",39341773,39341945,172
"42358","ENSG00000269253","19",51198855,51201449,2594
"42359","ENSG00000269256","10",76558350,76560994,2644
"42360","ENSG00000269274","19",20295089,20303794,8705
"42361","ENSG00000269275","19",55377579,55378125,546
"42362","ENSG00000269288","19",53240675,53241913,1238
"42363","ENSG00000269289","19",23919081,23958035,38954
"42364","ENSG00000269293","6",28015122,28137293,122171
"42365","ENSG00000269296","19",40090754,40094406,3652
"42366","ENSG00000269300","19",8821501,8824110,2609
"42367","ENSG00000269303","19",34998233,35000170,1937
"42368","ENSG00000269304","19",57826461,57826778,317
"42369","ENSG00000269313","X",49162564,49168483,5919
"42370","ENSG00000269316","19",22609606,22610601,995
"42371","ENSG00000269318","19",4356637,4358448,1811
"42372","ENSG00000269320","19",23602567,23603106,539
"42373","ENSG00000269321","19",48145908,48147413,1505
"42374","ENSG00000269332","19",22596257,22603550,7293
"42375","ENSG00000269335","X",154541199,154565046,23847
"42376","ENSG00000269343","19",57819721,57846238,26517
"42377","ENSG00000269345","19",22174766,22175191,425
"42378","ENSG00000269349","19",52511282,52512342,1060
"42379","ENSG00000269350","19",17360932,17362753,1821
"42380","ENSG00000269352","19",49856970,49859289,2319
"42381","ENSG00000269353","19",40946347,40947450,1103
"42382","ENSG00000269356","13",113008778,113009424,646
"42383","ENSG00000269364","19",22532626,22533494,868
"42384","ENSG00000269365","18",47878295,47882444,4149
"42385","ENSG00000269373","19",20838515,20847417,8902
"42386","ENSG00000269374","19",42485076,42485714,638
"42387","ENSG00000269376","13",113009671,113010319,648
"42388","ENSG00000269378","19",14621634,14622242,608
"42389","ENSG00000269386","19",8374373,8390685,16312
"42390","ENSG00000269387","6",41764292,41764460,168
"42391","ENSG00000269388","19",51594561,51606150,11589
"42392","ENSG00000269391","3",16524800,16531807,7007
"42393","ENSG00000269392","19",50365880,50369331,3451
"42394","ENSG00000269397","19",23927788,23929287,1499
"42395","ENSG00000269399","19",16542746,16544814,2068
"42396","ENSG00000269400","19",8833065,8833541,476
"42397","ENSG00000269403","19",51350373,51368099,17726
"42398","ENSG00000269404","19",50418938,50431314,12376
"42399","ENSG00000269405","X",102247161,102326719,79558
"42400","ENSG00000269416","19",23399233,23416075,16842
"42401","ENSG00000269420","19",48061371,48064945,3574
"42402","ENSG00000269421","19",23935220,23936173,953
"42403","ENSG00000269425","19",4339577,4343491,3914
"42404","ENSG00000269427","19",16630743,16643942,13199
"42405","ENSG00000269431","19",23380317,23380876,559
"42406","ENSG00000269437","X",102360396,102439932,79536
"42407","ENSG00000269439","19",17488990,17511889,22899
"42408","ENSG00000269444","19",6386762,6390400,3638
"42409","ENSG00000269445","19",38526954,38528555,1601
"42410","ENSG00000269446","7",157109980,157111072,1092
"42411","ENSG00000269460","19",39685244,39694577,9333
"42412","ENSG00000269463","11",62807682,62808063,381
"42413","ENSG00000269466","5",17654870,17655847,977
"42414","ENSG00000269471","19",23204010,23204556,546
"42415","ENSG00000269473","19",58440448,58445849,5401
"42416","ENSG00000269475","X",152682810,152683842,1032
"42417","ENSG00000269476","19",57876765,57916591,39826
"42418","ENSG00000269480","19",17207138,17208010,872
"42419","ENSG00000269481","19",17414257,17422324,8067
"42420","ENSG00000269482","16",90631,91102,471
"42421","ENSG00000269483","19",51842878,51843315,437
"42422","ENSG00000269486","19",38935297,38938632,3335
"42423","ENSG00000269487","19",46728603,46732700,4097
"42424","ENSG00000269489","1",151798054,151798602,548
"42425","ENSG00000269495","19",50950185,50963649,13464
"42426","ENSG00000269504","19",22017898,22052370,34472
"42427","ENSG00000269506","4",54059597,54061210,1613
"42428","ENSG00000269509","19",22773853,22774424,571
"42429","ENSG00000269514","12",48198357,48230275,31918
"42430","ENSG00000269516","19",15564074,15584709,20635
"42431","ENSG00000269524","19",54224523,54224881,358
"42432","ENSG00000269526","19",53013921,53016122,2201
"42433","ENSG00000269533","19",57389884,57419994,30110
"42434","ENSG00000269534","19",48118432,48127706,9274
"42435","ENSG00000269535","19",52300693,52345229,44536
"42436","ENSG00000269540","19",50058882,50060232,1350
"42437","ENSG00000269543","19",23068473,23071476,3003
"42438","ENSG00000269546","19",6562123,6563848,1725
"42439","ENSG00000269547","19",38915404,38949855,34451
"42440","ENSG00000269553","19",35330843,35331920,1077
"42441","ENSG00000269556","X",149596556,149631912,35356
"42442","ENSG00000269559","4",74156511,74158373,1862
"42443","ENSG00000269560","19",12529768,12532973,3205
"42444","ENSG00000269564","19",53788782,53789168,386
"42445","ENSG00000269565","19",50758382,50759192,810
"42446","ENSG00000269570","11",58611119,58612642,1523
"42447","ENSG00000269575","19",22140532,22141117,585
"42448","ENSG00000269583","19",43574638,43575618,980
"42449","ENSG00000269584","19",39534463,39535021,558
"42450","ENSG00000269586","X",135881063,135889086,8023
"42451","ENSG00000269588","19",39553034,39555356,2322
"42452","ENSG00000269600","19",58593134,58599355,6221
"42453","ENSG00000269608","19",53616802,53617254,452
"42454","ENSG00000269609","10",102449816,102461106,11290
"42455","ENSG00000269615","19",21940820,21941533,713
"42456","ENSG00000269621","1",151755541,151759911,4370
"42457","ENSG00000269622","16",35506592,35507170,578
"42458","ENSG00000269635","19",15221015,15222297,1282
"42459","ENSG00000269637","19",46219423,46219920,497
"42460","ENSG00000269646","19",52923382,52924075,693
"42461","ENSG00000269652","19",41221426,41222051,625
"42462","ENSG00000269653","19",38184376,38186265,1889
"42463","ENSG00000269656","19",47757036,47768840,11804
"42464","ENSG00000269662","19",23798924,23799477,553
"42465","ENSG00000269667","16",85981750,85984881,3131
"42466","ENSG00000269680","19",6748293,6751467,3174
"42467","ENSG00000269681","19",51155288,51155624,336
"42468","ENSG00000269688","19",38844729,38845499,770
"42469","ENSG00000269693","19",12525720,12580975,55255
"42470","ENSG00000269694","19",18881680,18883376,1696
"42471","ENSG00000269696","19",56545566,56567411,21845
"42472","ENSG00000269699","19",56774547,56840729,66182
"42473","ENSG00000269706","19",49050217,49050846,629
"42474","ENSG00000269707","2",104853285,104927722,74437
"42475","ENSG00000269711","19",7678501,7682854,4353
"42476","ENSG00000269713","1",149054027,149103561,49534
"42477","ENSG00000269720","19",17390509,17394158,3649
"42478","ENSG00000269729","19",46163893,46180647,16754
"42479","ENSG00000269736","19",17452211,17452969,758
"42480","ENSG00000269737","1",1671990,1674397,2407
"42481","ENSG00000269741","19",50996018,51009581,13563
"42482","ENSG00000269742","19",22065828,22066398,570
"42483","ENSG00000269743","X",104099214,104157009,57795
"42484","ENSG00000269745","19",46228964,46230388,1424
"42485","ENSG00000269749","19",40048757,40090925,42168
"42486","ENSG00000269752","19",17613722,17614430,708
"42487","ENSG00000269755","19",12433103,12484816,51713
"42488","ENSG00000269758","19",53267870,53270932,3062
"42489","ENSG00000269761","19",7005012,7006074,1062
"42490","ENSG00000269763","19",7813615,7814425,810
"42491","ENSG00000269776","19",52425863,52426202,339
"42492","ENSG00000269779","19",20691336,20697615,6279
"42493","ENSG00000269792","19",39532412,39534422,2010
"42494","ENSG00000269793","19",56595313,56799602,204289
"42495","ENSG00000269794","19",58319277,58320489,1212
"42496","ENSG00000269796","19",22422513,22426045,3532
"42497","ENSG00000269799","19",16801426,16801714,288
"42498","ENSG00000269800","19",41521043,41521989,946
"42499","ENSG00000269802","19",6343761,6362149,18388
"42500","ENSG00000269806","19",47615699,47626395,10696
"42501","ENSG00000269807","19",4347244,4354057,6813
"42502","ENSG00000269814","19",48513207,48513660,453
"42503","ENSG00000269815","19",17296196,17296695,499
"42504","ENSG00000269821","11",2608328,2699994,91666
"42505","ENSG00000269825","19",52650437,52653284,2847
"42506","ENSG00000269826","16",86347387,86349611,2224
"42507","ENSG00000269834","19",52388842,52397783,8941
"42508","ENSG00000269836","19",17177511,17178476,965
"42509","ENSG00000269837","19",23255053,23257939,2886
"42510","ENSG00000269839","19",21225098,21245241,20143
"42511","ENSG00000269842","19",53761961,53764199,2238
"42512","ENSG00000269843","19",40831221,40837210,5989
"42513","ENSG00000269845","19",21750747,21753438,2691
"42514","ENSG00000269846","20",37095785,37097178,1393
"42515","ENSG00000269855","19",58396090,58397079,989
"42516","ENSG00000269858","19",40798996,40808434,9438
"42517","ENSG00000269859","19",55475983,55476482,499
"42518","ENSG00000269867","19",57867038,57868172,1134
"42519","ENSG00000269873","19",54438010,54438346,336
"42520","ENSG00000269877","19",53787597,53788169,572
"42521","ENSG00000269883","14",77140683,77142996,2313
"42522","ENSG00000269886","3",9812762,9813097,335
"42523","ENSG00000269887","1",164680085,164680799,714
"42524","ENSG00000269888","3",161429112,161429613,501
"42525","ENSG00000269889","3",169769649,169772043,2394
"42526","ENSG00000269891","10",97153045,97292637,139592
"42527","ENSG00000269892","12",6742985,6743641,656
"42528","ENSG00000269893","4",118278709,118285316,6607
"42529","ENSG00000269894","3",9935706,9936258,552
"42530","ENSG00000269895","11",86833068,86837615,4547
"42531","ENSG00000269896","1",2350414,2352820,2406
"42532","ENSG00000269897","10",22316388,22329542,13154
"42533","ENSG00000269898","16",85743287,85744225,938
"42534","ENSG00000269899","8",11846154,11846391,237
"42535","ENSG00000269900","9",35657751,35658018,267
"42536","ENSG00000269901","16",87362536,87367476,4940
"42537","ENSG00000269902","X",45764772,45765299,527
"42538","ENSG00000269903","12",57814494,57814926,432
"42539","ENSG00000269904","X",73524275,73563085,38810
"42540","ENSG00000269906","14",50662511,50663178,667
"42541","ENSG00000269907","9",96910076,96910405,329
"42542","ENSG00000269910","14",103694516,103695050,534
"42543","ENSG00000269911","X",72777608,72779097,1489
"42544","ENSG00000269915","11",708564,727047,18483
"42545","ENSG00000269918","8",11104691,11106704,2013
"42546","ENSG00000269919","6",106100140,106100593,453
"42547","ENSG00000269921","4",56387625,56388153,528
"42548","ENSG00000269924","8",47527397,47528148,751
"42549","ENSG00000269925","1",7776383,7776775,392
"42550","ENSG00000269927","14",71141125,71143253,2128
"42551","ENSG00000269929","9",94166258,94200902,34644
"42552","ENSG00000269930","15",30616958,30617749,791
"42553","ENSG00000269931","20",12934877,12937097,2220
"42554","ENSG00000269933","1",71005854,71006502,648
"42555","ENSG00000269934","1",228238241,228276066,37825
"42556","ENSG00000269935","16",87600526,87602190,1664
"42557","ENSG00000269937","16",2561471,2565096,3625
"42558","ENSG00000269938","12",123968023,123968579,556
"42559","ENSG00000269940","14",103694560,103695170,610
"42560","ENSG00000269944","11",118415977,118416521,544
"42561","ENSG00000269945","14",71219100,71222724,3624
"42562","ENSG00000269947","17",8277763,8278436,673
"42563","ENSG00000269949","4",56960927,56961373,446
"42564","ENSG00000269950","21",16574718,16582637,7919
"42565","ENSG00000269951","15",77067654,77068325,671
"42566","ENSG00000269952","10",35210416,35210750,334
"42567","ENSG00000269954","8",11552488,11564694,12206
"42568","ENSG00000269955","7",139341360,139422599,81239
"42569","ENSG00000269956","1",46538611,46570255,31644
"42570","ENSG00000269957","9",24545938,24592104,46166
"42571","ENSG00000269958","14",103696353,103697163,810
"42572","ENSG00000269959","19",51685363,51693456,8093
"42573","ENSG00000269961","5",65924629,65925135,506
"42574","ENSG00000269964","6",77650274,77927028,276754
"42575","ENSG00000269966","6",71295173,71417436,122263
"42576","ENSG00000269967","1",31851913,31921841,69928
"42577","ENSG00000269970","9",122372605,122372825,220
"42578","ENSG00000269971","1",27773858,27774041,183
"42579","ENSG00000269973","2",9936360,9939590,3230
"42580","ENSG00000269976","2",20586248,20586686,438
"42581","ENSG00000269978","1",7700704,7700970,266
"42582","ENSG00000269980","12",123262060,123262402,342
"42583","ENSG00000269981","1",137682,137965,283
"42584","ENSG00000269982","3",9958717,9962539,3822
"42585","ENSG00000269983","5",70449636,70450353,717
"42586","ENSG00000269984","3",169777192,169780334,3142
"42587","ENSG00000269985","6",5451683,5458075,6392
"42588","ENSG00000269986","16",63066526,63066990,464
"42589","ENSG00000269993","X",151182386,151182855,469
"42590","ENSG00000269994","9",87008440,87042419,33979
"42591","ENSG00000269997","12",123966077,123966629,552
"42592","ENSG00000270000","14",74471930,74472360,430
"42593","ENSG00000270001","20",23631826,23632316,490
"42594","ENSG00000270002","10",85644073,85648066,3993
"42595","ENSG00000270006","16",87317509,87318043,534
"42596","ENSG00000270008","13",32425358,32432954,7596
"42597","ENSG00000270011","19",9324174,9382617,58443
"42598","ENSG00000270012","X",49273054,49275768,2714
"42599","ENSG00000270016","15",30607695,30608193,498
"42600","ENSG00000270017","15",94855586,94857011,1425
"42601","ENSG00000270019","2",113888203,113889750,1547
"42602","ENSG00000270020","16",86520383,86523897,3514
"42603","ENSG00000270021","5",135399280,135401296,2016
"42604","ENSG00000270022","22",42615244,42615907,663
"42605","ENSG00000270025","10",48050282,48060016,9734
"42606","ENSG00000270030","11",325703,326294,591
"42607","ENSG00000270031","1",27819983,27820341,358
"42608","ENSG00000270035","1",7698303,7698872,569
"42609","ENSG00000270036","15",76343642,76344365,723
"42610","ENSG00000270038","14",95644508,95645232,724
"42611","ENSG00000270039","12",57803838,57804415,577
"42612","ENSG00000270040","1",39206512,39206957,445
"42613","ENSG00000270048","12",123962555,123962817,262
"42614","ENSG00000270049","16",67481314,67505977,24663
"42615","ENSG00000270050","X",102599657,102659712,60055
"42616","ENSG00000270052","X",151497726,151498354,628
"42617","ENSG00000270055","15",30487963,30490313,2350
"42618","ENSG00000270059","3",65359268,65359717,449
"42619","ENSG00000270060","11",47168281,47169563,1282
"42620","ENSG00000270061","12",123969990,123970344,354
"42621","ENSG00000270062","14",50723777,50724272,495
"42622","ENSG00000270066","1",109100193,109100619,426
"42623","ENSG00000270068","12",6723233,6723687,454
"42624","ENSG00000270069","X",45745211,45770274,25063
"42625","ENSG00000270071","21",16291079,16310382,19303
"42626","ENSG00000270072","11",47513605,47514889,1284
"42627","ENSG00000270073","Y",9507596,9510175,2579
"42628","ENSG00000270074","8",12412827,12414373,1546
"42629","ENSG00000270076","8",11202965,11203671,706
"42630","ENSG00000270077","8",97144170,97144723,553
"42631","ENSG00000270083","22",42089630,42090028,398
"42632","ENSG00000270084","1",173862473,173863941,1468
"42633","ENSG00000270087","10",75279726,75401246,121520
"42634","ENSG00000270090","4",3544555,3548796,4241
"42635","ENSG00000270091","17",19896590,19897287,697
"42636","ENSG00000270095","12",123971457,123971714,257
"42637","ENSG00000270098","4",71434405,71437924,3519
"42638","ENSG00000270099","10",95860548,95924844,64296
"42639","ENSG00000270104","1",228384114,228385016,902
"42640","ENSG00000270105","11",322186,322727,541
"42641","ENSG00000270106","1",231528653,231819244,290591
"42642","ENSG00000270108","14",103687576,103688127,551
"42643","ENSG00000270110","1",228295549,228303002,7453
"42644","ENSG00000270111","10",10369809,10462361,92552
"42645","ENSG00000270112","18",46756487,46802449,45962
"42646","ENSG00000270114","7",154026287,154038604,12317
"42647","ENSG00000270115","1",33261212,33261680,468
"42648","ENSG00000270116","21",37100814,37101343,529
"42649","ENSG00000270118","16",28454141,28454511,370
"42650","ENSG00000270120","16",50712844,50713589,745
"42651","ENSG00000270123","5",136080470,136080597,127
"42652","ENSG00000270124","16",85580009,85583571,3562
"42653","ENSG00000270127","15",100547765,100550153,2388
"42654","ENSG00000270130","12",123960717,123961244,527
"42655","ENSG00000270131","8",96140572,96140944,372
"42656","ENSG00000270133","5",94611906,94618122,6216
"42657","ENSG00000270136","1",19597067,19656927,59860
"42658","ENSG00000270137","8",132826179,132826903,724
"42659","ENSG00000270139","21",16417139,16419080,1941
"42660","ENSG00000270140","14",73905267,73905636,369
"42661","ENSG00000270141","3",169764520,169765060,540
"42662","ENSG00000270147","4",56396312,56396871,559
"42663","ENSG00000270149","1",160997957,161038962,41005
"42664","ENSG00000270154","8",12476462,12477122,660
"42665","ENSG00000270157","7",141662922,141663846,924
"42666","ENSG00000270159","16",85792415,85792933,518
"42667","ENSG00000270164","19",41535183,41536904,1721
"42668","ENSG00000270165","16",67738588,67739922,1334
"42669","ENSG00000270166","9",84078584,84078857,273
"42670","ENSG00000270170","3",196942674,196943543,869
"42671","ENSG00000270171","1",7693124,7694844,1720
"42672","ENSG00000270174","6",5664985,5695272,30287
"42673","ENSG00000270175","12",53500162,53500936,774
"42674","ENSG00000270177","5",134226410,134227827,1417
"42675","ENSG00000270178","3",179804063,179804366,303
"42676","ENSG00000270179","11",113368478,113369117,639
"42677","ENSG00000270181","13",102799110,102875994,76884
"42678","ENSG00000270182","7",27158344,27158976,632
"42679","ENSG00000270184","16",85784382,85787617,3235
"42680","ENSG00000270188","1",237943724,237945275,1551
"42681","ENSG00000270190","2",111266868,111267473,605
"42682","ENSG00000270191","19",22298977,22299868,891
"42683","ENSG00000270194","3",37241789,37244177,2388
"42684","ENSG00000270195","4",1712821,1715945,3124
"42685","ENSG00000270196","7",29551521,29552151,630
"42686","ENSG00000270202","11",111107060,111107750,690
"42687","ENSG00000270204","11",114517864,114518371,507
"42688","ENSG00000270207","3",7606890,7790482,183592
"42689","ENSG00000270209","1",58552913,58553333,420
"42690","ENSG00000270210","2",28425945,28426719,774
"42691","ENSG00000270212","19",33283978,33285739,1761
"42692","ENSG00000270218","15",65026088,65026676,588
"42693","ENSG00000270225","5",100052859,100053539,680
"42694","ENSG00000270228","4",67718996,67724262,5266
"42695","ENSG00000270230","5",100046450,100046970,520
"42696","ENSG00000270231","1",120419850,120467739,47889
"42697","ENSG00000270232","5",100045928,100046374,446
"42698","ENSG00000270236","9",69107926,69108217,291
"42699","ENSG00000270240","17",35868967,35885863,16896
"42700","ENSG00000270244","4",76886029,76886370,341
"42701","ENSG00000270248","19",52110318,52110726,408
"42702","ENSG00000270249","7",102541501,102592444,50943
"42703","ENSG00000270252","2",97348899,97349179,280
"42704","ENSG00000270255","8",19001627,19001950,323
"42705","ENSG00000270257","4",67638177,67638359,182
"42706","ENSG00000270258","10",45055656,45056268,612
"42707","ENSG00000270259","9",137286112,137287236,1124
"42708","ENSG00000270264","17",59885015,59885552,537
"42709","ENSG00000270265","4",151333775,151353224,19449
"42710","ENSG00000270268","X",79369364,79370165,801
"42711","ENSG00000270269","11",63632233,63632720,487
"42712","ENSG00000270270","19",19870723,19871299,576
"42713","ENSG00000270276","1",149854045,149861210,7165
"42714","ENSG00000270277","2",178548884,178550681,1797
"42715","ENSG00000270279","20",58754351,58756838,2487
"42716","ENSG00000270281","19",34779412,34780021,609
"42717","ENSG00000270282","1",8512653,8513021,368
"42718","ENSG00000270285","3",48039267,48039490,223
"42719","ENSG00000270292","4",67725183,67726395,1212
"42720","ENSG00000270294","10",109680442,109681041,599
"42721","ENSG00000270296","12",12771351,12771705,354
"42722","ENSG00000270299","20",646626,675800,29174
"42723","ENSG00000270300","10",119793589,119816642,23053
"42724","ENSG00000270302","4",152308283,152309983,1700
"42725","ENSG00000270304","15",37253879,37254952,1073
"42726","ENSG00000270307","5",100051920,100052597,677
"42727","ENSG00000270313","16",85278820,85279035,215
"42728","ENSG00000270314","7",7735743,7736851,1108
"42729","ENSG00000270316","10",102854272,102901899,47627
"42730","ENSG00000270317","19",22501699,22501948,249
"42731","ENSG00000270318","16",33858896,33859352,456
"42732","ENSG00000270321","3",177952327,177959817,7490
"42733","ENSG00000270322","15",90281848,90282031,183
"42734","ENSG00000270325","19",19856975,19857527,552
"42735","ENSG00000270326","6",28319660,28319852,192
"42736","ENSG00000270330","1",7942372,7942726,354
"42737","ENSG00000270332","9",104080024,104093073,13049
"42738","ENSG00000270333","10",109661814,109662050,236
"42739","ENSG00000270335","2",62348948,62350739,1791
"42740","ENSG00000270339","1",146344131,146344790,659
"42741","ENSG00000270342","1",106544342,106544744,402
"42742","ENSG00000270343","14",81259565,81260239,674
"42743","ENSG00000270344","12",89524594,89548005,23411
"42744","ENSG00000270350","5",100050359,100050650,291
"42745","ENSG00000270352","10",63658074,63658521,447
"42746","ENSG00000270354","2",64208498,64208716,218
"42747","ENSG00000270361","1",154937370,154938059,689
"42748","ENSG00000270362","6",79233718,79236797,3079
"42749","ENSG00000270367","3",39285985,39287920,1935
"42750","ENSG00000270369","10",47484457,47484754,297
"42751","ENSG00000270371","14",105785505,105785831,326
"42752","ENSG00000270372","9",10948372,10948481,109
"42753","ENSG00000270377","3",32243847,32244018,171
"42754","ENSG00000270378","15",51351100,51351192,92
"42755","ENSG00000270379","17",35854946,35868891,13945
"42756","ENSG00000270381","13",45263690,45263915,225
"42757","ENSG00000270385","16",87892955,87893735,780
"42758","ENSG00000270387","4",147916529,147917386,857
"42759","ENSG00000270388","5",100051133,100051916,783
"42760","ENSG00000270390","2",142947300,142948086,786
"42761","ENSG00000270392","1",120432204,120434052,1848
"42762","ENSG00000270394","4",116298876,116300320,1444
"42763","ENSG00000270402","19",19708965,19710465,1500
"42764","ENSG00000270405","7",152366763,152367015,252
"42765","ENSG00000270409","3",15732252,15733470,1218
"42766","ENSG00000270411","20",58097267,58097591,324
"42767","ENSG00000270412","9",98943337,98943775,438
"42768","ENSG00000270413","X",114900359,114900574,215
"42769","ENSG00000270415","13",81114866,81115295,429
"42770","ENSG00000270419","6",163413065,163413960,895
"42771","ENSG00000270421","10",63358745,63359104,359
"42772","ENSG00000270422","2",31651381,31651862,481
"42773","ENSG00000270424","16",28749959,28750595,636
"42774","ENSG00000270426","4",184471924,184472609,685
"42775","ENSG00000270427","10",5776071,5776858,787
"42776","ENSG00000270429","12",45880950,45882266,1316
"42777","ENSG00000270431","X",115659713,115660022,309
"42778","ENSG00000270432","9",90751240,90752230,990
"42779","ENSG00000270433","14",23293852,23295798,1946
"42780","ENSG00000270434","10",45812648,45812944,296
"42781","ENSG00000270441","3",49140086,49160851,20765
"42782","ENSG00000270442","5",155491336,155493598,2262
"42783","ENSG00000270443","1",182433893,182434461,568
"42784","ENSG00000270445","12",123441517,123441852,335
"42785","ENSG00000270449","11",104682383,104682581,198
"42786","ENSG00000270457","1",59289303,59289640,337
"42787","ENSG00000270460","2",173811076,173811392,316
"42788","ENSG00000270462","2",75697583,75697996,413
"42789","ENSG00000270467","16",33802764,33803217,453
"42790","ENSG00000270469","18",14053951,14054761,810
"42791","ENSG00000270472","16",32066065,32066358,293
"42792","ENSG00000270474","14",106356145,106356591,446
"42793","ENSG00000270475","19",22708834,22709314,480
"42794","ENSG00000270477","6",3693923,3694075,152
"42795","ENSG00000270479","19",23123188,23124088,900
"42796","ENSG00000270480","4",82691737,82692468,731
"42797","ENSG00000270482","12",118375350,118376275,925
"42798","ENSG00000270487","6",156780327,156780455,128
"42799","ENSG00000270488","2",10874291,10874567,276
"42800","ENSG00000270490","15",66808404,66810560,2156
"42801","ENSG00000270491","11",34742906,34743199,293
"42802","ENSG00000270492","3",129334586,129335074,488
"42803","ENSG00000270495","5",28808538,28809255,717
"42804","ENSG00000270497","X",53065053,53065548,495
"42805","ENSG00000270499","X",46560928,46562749,1821
"42806","ENSG00000270503","14",39215065,39216335,1270
"42807","ENSG00000270504","6",3751111,3753871,2760
"42808","ENSG00000270510","11",87323709,87324359,650
"42809","ENSG00000270512","7",140282465,140282920,455
"42810","ENSG00000270513","5",42729138,42729519,381
"42811","ENSG00000270518","19",22770937,22771191,254
"42812","ENSG00000270521","6",66710242,66710827,585
"42813","ENSG00000270522","13",43787591,43787852,261
"42814","ENSG00000270528","2",28015777,28016482,705
"42815","ENSG00000270531","3",11529488,11529755,267
"42816","ENSG00000270532","2",85341281,85341838,557
"42817","ENSG00000270533","21",9975017,10119309,144292
"42818","ENSG00000270538","3",49252129,49252264,135
"42819","ENSG00000270540","2",236367560,236369102,1542
"42820","ENSG00000270541","10",55746551,55746908,357
"42821","ENSG00000270542","9",33449755,33449941,186
"42822","ENSG00000270547","9",13406380,13488125,81745
"42823","ENSG00000270549","1",62530636,62530873,237
"42824","ENSG00000270550","14",106335082,106335613,531
"42825","ENSG00000270552","10",42747544,42748687,1143
"42826","ENSG00000270553","17",60513190,60513550,360
"42827","ENSG00000270554","3",182843521,182844619,1098
"42828","ENSG00000270555","7",72768798,72769191,393
"42829","ENSG00000270557","2",157877683,157878565,882
"42830","ENSG00000270558","5",37286449,37286977,528
"42831","ENSG00000270560","5",156924119,156924710,591
"42832","ENSG00000270562","3",71584943,71587409,2466
"42833","ENSG00000270570","Y",11107719,11107887,168
"42834","ENSG00000270571","2",75154366,75189949,35583
"42835","ENSG00000270574","2",178578790,178580906,2116
"42836","ENSG00000270575","1",178194342,178194709,367
"42837","ENSG00000270577","7",40115685,40115943,258
"42838","ENSG00000270578","11",95145437,95146004,567
"42839","ENSG00000270580","16",15104723,15131601,26878
"42840","ENSG00000270585","1",220207618,220208282,664
"42841","ENSG00000270587","17",63610772,63611184,412
"42842","ENSG00000270589","10",110910596,110912244,1648
"42843","ENSG00000270591","14",103762803,103763277,474
"42844","ENSG00000270593","7",16849957,16850725,768
"42845","ENSG00000270598","1",226127178,226127346,168
"42846","ENSG00000270604","6",30234039,30326134,92095
"42847","ENSG00000270605","1",28239509,28241453,1944
"42848","ENSG00000270606","17",8560471,8560962,491
"42849","ENSG00000270607","11",19710934,19712619,1685
"42850","ENSG00000270610","14",70234495,70235095,600
"42851","ENSG00000270612","5",160326693,160326969,276
"42852","ENSG00000270614","19",9348106,9348703,597
"42853","ENSG00000270615","1",69606855,69608301,1446
"42854","ENSG00000270617","7",43866558,43906589,40031
"42855","ENSG00000270620","1",15917698,15917908,210
"42856","ENSG00000270623","10",100143065,100143995,930
"42857","ENSG00000270624","19",34866352,34866919,567
"42858","ENSG00000270629","1",148531385,148679742,148357
"42859","ENSG00000270638","6",145735570,145737218,1648
"42860","ENSG00000270639","9",4768617,4769895,1278
"42861","ENSG00000270640","2",28396815,28397110,295
"42862","ENSG00000270641","X",73792205,73829231,37026
"42863","ENSG00000270647","17",35713791,35864615,150824
"42864","ENSG00000270648","10",64762883,64763172,289
"42865","ENSG00000270652","21",36943267,36944125,858
"42866","ENSG00000270655","6",143386581,143387409,828
"42867","ENSG00000270659","2",213152970,213153659,689
"42868","ENSG00000270661","6",112217640,112219570,1930
"42869","ENSG00000270665","4",72807267,72808192,925
"42870","ENSG00000270666","6",27515039,27515274,235
"42871","ENSG00000270669","4",77216416,77216878,462
"42872","ENSG00000270672","7",142666272,142667718,1446
"42873","ENSG00000270673","8",63167725,63168442,717
"42874","ENSG00000270679","19",44290081,44290911,830
"42875","ENSG00000270680","13",29339566,29339869,303
"42876","ENSG00000270681","4",151139991,151141103,1112
"42877","ENSG00000270682","8",97788210,97788357,147
"42878","ENSG00000270685","15",20639464,20639890,426
"42879","ENSG00000270688","9",86228815,86228983,168
"42880","ENSG00000270689","11",95143637,95145125,1488
"42881","ENSG00000270690","15",65458574,65459534,960
"42882","ENSG00000270691","9",79850871,79851498,627
"42883","ENSG00000270696","2",75660462,75662208,1746
"42884","ENSG00000270697","5",137761546,137761936,390
"42885","ENSG00000270702","15",41718370,41718672,302
"42886","ENSG00000270705","14",103207748,103207789,41
"42887","ENSG00000270706","5",177265580,177266588,1008
"42888","ENSG00000270708","1",220220291,220220593,302
"42889","ENSG00000270710","1",235565761,235566937,1176
"42890","ENSG00000270711","1",180970837,180971247,410
"42891","ENSG00000270712","9",19957394,19958147,753
"42892","ENSG00000270713","14",38973399,38974085,686
"42893","ENSG00000270714","17",64747264,64747492,228
"42894","ENSG00000270716","19",20136933,20137233,300
"42895","ENSG00000270720","4",89119284,89119871,587
"42896","ENSG00000270722","1",145465617,145465780,163
"42897","ENSG00000270723","2",69873565,69873819,254
"42898","ENSG00000270726","X",156004218,156022236,18018
"42899","ENSG00000270728","1",19297080,19297903,823
"42900","ENSG00000270733","1",26263041,26263398,357
"42901","ENSG00000270734","16",14862380,14862749,369
"42902","ENSG00000270739","3",16275060,16276632,1572
"42903","ENSG00000270741","5",120658077,120658371,294
"42904","ENSG00000270747","X",48336899,48337169,270
"42905","ENSG00000270748","2",97046588,97046891,303
"42906","ENSG00000270751","4",152337655,152338098,443
"42907","ENSG00000270754","10",65054460,65055003,543
"42908","ENSG00000270755","9",130044713,130045081,368
"42909","ENSG00000270757","2",197500413,197550726,50313
"42910","ENSG00000270760","19",36144081,36148348,4267
"42911","ENSG00000270761","6",47477243,47477572,329
"42912","ENSG00000270762","10",42555440,42555724,284
"42913","ENSG00000270764","7",105189190,105189814,624
"42914","ENSG00000270765","17",35744511,35752878,8367
"42915","ENSG00000270772","3",57800056,57801448,1392
"42916","ENSG00000270773","3",129345411,129346164,753
"42917","ENSG00000270775","11",65025390,65026515,1125
"42918","ENSG00000270776","2",152539197,152539427,230
"42919","ENSG00000270777","20",11001304,11001763,459
"42920","ENSG00000270780","1",114001433,114002235,802
"42921","ENSG00000270781","17",48899131,48899748,617
"42922","ENSG00000270788","14",50050368,50051336,968
"42923","ENSG00000270791","X",40758483,40759050,567
"42924","ENSG00000270792","20",10672695,10994924,322229
"42925","ENSG00000270794","X",30209423,30210209,786
"42926","ENSG00000270797","7",39788967,39789304,337
"42927","ENSG00000270799","2",174171891,174172725,834
"42928","ENSG00000270800","6",34284887,34426071,141184
"42929","ENSG00000270802","19",15338948,15339237,289
"42930","ENSG00000270804","19",57867885,57868834,949
"42931","ENSG00000270806","17",35760887,35765079,4192
"42932","ENSG00000270808","10",73740538,73740823,285
"42933","ENSG00000270809","13",42181465,42181921,456
"42934","ENSG00000270811","10",7154120,7154236,116
"42935","ENSG00000270813","X",101337725,101338289,564
"42936","ENSG00000270814","15",25169337,25169676,339
"42937","ENSG00000270815","2",124778454,124778640,186
"42938","ENSG00000270816","14",106482435,106521073,38638
"42939","ENSG00000270820","2",61471188,61484130,12942
"42940","ENSG00000270822","7",5009164,5009328,164
"42941","ENSG00000270823","7",130495794,130498427,2633
"42942","ENSG00000270829","17",35808489,35808897,408
"42943","ENSG00000270832","16",89458870,89459437,567
"42944","ENSG00000270835","21",38204141,38206080,1939
"42945","ENSG00000270837","19",58049046,58049346,300
"42946","ENSG00000270839","5",175483595,175484192,597
"42947","ENSG00000270842","4",82775461,82776101,640
"42948","ENSG00000270846","2",27896116,27897195,1079
"42949","ENSG00000270850","1",32421979,32422319,340
"42950","ENSG00000270855","18",22418829,22419294,465
"42951","ENSG00000270857","12",12248991,12249427,436
"42952","ENSG00000270858","12",54802746,54803589,843
"42953","ENSG00000270863","12",11512723,11514136,1413
"42954","ENSG00000270864","16",32915074,32915536,462
"42955","ENSG00000270866","8",76403998,76405091,1093
"42956","ENSG00000270870","17",65654914,65655395,481
"42957","ENSG00000270871","17",35816717,35830293,13576
"42958","ENSG00000270872","1",143975087,144068350,93263
"42959","ENSG00000270874","10",86854696,86856236,1540
"42960","ENSG00000270876","19",34923299,34926812,3513
"42961","ENSG00000270878","14",63594031,63595291,1260
"42962","ENSG00000270880","3",113984037,113984655,618
"42963","ENSG00000270882","1",149832659,149839767,7108
"42964","ENSG00000270883","4",152317902,152318364,462
"42965","ENSG00000270885","17",35731649,35743521,11872
"42966","ENSG00000270889","7",35971147,35971567,420
"42967","ENSG00000270890","6",143858062,143858689,627
"42968","ENSG00000270893","2",159444117,159444913,796
"42969","ENSG00000270894","17",35818399,35823713,5314
"42970","ENSG00000270896","6",29763258,29763392,134
"42971","ENSG00000270900","6",44898711,44899295,584
"42972","ENSG00000270903","11",32591793,32592771,978
"42973","ENSG00000270904","5",151319422,151319776,354
"42974","ENSG00000270906","5",100048988,100050362,1374
"42975","ENSG00000270909","9",41979352,41983753,4401
"42976","ENSG00000270911","1",97855575,97856825,1250
"42977","ENSG00000270915","2",202505012,202505343,331
"42978","ENSG00000270917","9",120812475,120812845,370
"42979","ENSG00000270919","15",80580029,80580566,537
"42980","ENSG00000270923","7",141787815,141788640,825
"42981","ENSG00000270924","16",33848476,33848644,168
"42982","ENSG00000270926","12",31105105,31106830,1725
"42983","ENSG00000270927","1",29904865,29905357,492
"42984","ENSG00000270930","2",131646704,131648372,1668
"42985","ENSG00000270933","7",25948657,25949403,746
"42986","ENSG00000270935","6",27268113,27269229,1116
"42987","ENSG00000270937","6",1026494,1027225,731
"42988","ENSG00000270938","14",103279223,103279955,732
"42989","ENSG00000270941","3",52734735,52735013,278
"42990","ENSG00000270945","16",74612596,74613221,625
"42991","ENSG00000270947","19",22455988,22456459,471
"42992","ENSG00000270948","7",64942143,64942926,783
"42993","ENSG00000270951","20",58876592,58876981,389
"42994","ENSG00000270953","7",130507660,130508282,622
"42995","ENSG00000270954","9",74804473,74804773,300
"42996","ENSG00000270955","15",30282533,30288389,5856
"42997","ENSG00000270956","2",178541125,178541799,674
"42998","ENSG00000270959","3",188151206,188154057,2851
"42999","ENSG00000270960","4",164933086,164933506,420
"43000","ENSG00000270962","1",143784376,143784671,295
"43001","ENSG00000270964","15",67541072,67542604,1532
"43002","ENSG00000270965","10",115819842,115820487,645
"43003","ENSG00000270966","8",8933721,8934006,285
"43004","ENSG00000270972","11",333192,333688,496
"43005","ENSG00000270973","10",101181144,101181951,807
"43006","ENSG00000270975","14",68861762,68862525,763
"43007","ENSG00000270977","17",35893707,35911023,17316
"43008","ENSG00000270978","5",151848886,151850791,1905
"43009","ENSG00000270980","8",54191582,54192035,453
"43010","ENSG00000270981","3",157230320,157231208,888
"43011","ENSG00000270982","9",101449801,101449933,132
"43012","ENSG00000270983","6",142062717,142063053,336
"43013","ENSG00000270986","15",58672296,58672933,637
"43014","ENSG00000270987","6",100889603,100890338,735
"43015","ENSG00000270988","8",1974818,1975314,496
"43016","ENSG00000270989","5",176203314,176203710,396
"43017","ENSG00000270990","7",150676833,150677918,1085
"43018","ENSG00000270992","7",130255902,130262770,6868
"43019","ENSG00000270993","17",75060491,75060620,129
"43020","ENSG00000270994","1",183709305,183710240,935
"43021","ENSG00000270995","9",100120435,100120900,465
"43022","ENSG00000270996","2",75719120,75720018,898
"43023","ENSG00000270999","2",90315366,90315836,470
"43024","ENSG00000271002","17",8199123,8199437,314
"43025","ENSG00000271005","X",79177200,79177668,468
"43026","ENSG00000271009","16",73060245,73062316,2071
"43027","ENSG00000271010","19",10598001,10598965,964
"43028","ENSG00000271011","2",178577103,178577622,519
"43029","ENSG00000271013","17",35912635,35918010,5375
"43030","ENSG00000271014","2",85360798,85360925,127
"43031","ENSG00000271018","12",50756892,50757433,541
"43032","ENSG00000271021","X",115454733,115455194,461
"43033","ENSG00000271022","11",121426645,121427416,771
"43034","ENSG00000271024","3",90261414,90261708,294
"43035","ENSG00000271025","11",112036627,112036863,236
"43036","ENSG00000271029","17",8296505,8297216,711
"43037","ENSG00000271032","19",35014961,35025335,10374
"43038","ENSG00000271034","3",70125070,70126609,1539
"43039","ENSG00000271036","1",189035961,189036444,483
"43040","ENSG00000271040","6",157323964,157324477,513
"43041","ENSG00000271043","5",80650000,80650086,86
"43042","ENSG00000271044","15",84940504,84941133,629
"43043","ENSG00000271045","5",69349936,69350445,509
"43044","ENSG00000271046","10",11679675,11680514,839
"43045","ENSG00000271047","7",56603410,56603553,143
"43046","ENSG00000271049","19",34634844,34635717,873
"43047","ENSG00000271052","3",161222911,161223147,236
"43048","ENSG00000271056","X",87807549,87809883,2334
"43049","ENSG00000271057","4",9020857,9021161,304
"43050","ENSG00000271063","17",59281130,59281343,213
"43051","ENSG00000271064","7",66748838,66749077,239
"43052","ENSG00000271065","12",51421956,51424611,2655
"43053","ENSG00000271070","2",108367116,108367938,822
"43054","ENSG00000271071","6",26611903,26613109,1206
"43055","ENSG00000271072","15",72450657,72451474,817
"43056","ENSG00000271075","14",52871458,52872217,759
"43057","ENSG00000271077","7",9634270,9635703,1433
"43058","ENSG00000271079","7",143571801,143574387,2586
"43059","ENSG00000271081","8",30754236,30754539,303
"43060","ENSG00000271086","9",99355337,99377240,21903
"43061","ENSG00000271092","1",95117923,95247225,129302
"43062","ENSG00000271093","22",32356676,32356988,312
"43063","ENSG00000271095","19",21997648,21998840,1192
"43064","ENSG00000271096","7",24589115,24589407,292
"43065","ENSG00000271098","7",2287915,2288428,513
"43066","ENSG00000271099","6",104860449,104862123,1674
"43067","ENSG00000271100","11",63698596,63698764,168
"43068","ENSG00000271101","17",71011997,71013587,1590
"43069","ENSG00000271105","16",25069570,25070109,539
"43070","ENSG00000271109","19",34849046,34860747,11701
"43071","ENSG00000271119","5",1594626,1611467,16841
"43072","ENSG00000271122","7",35695214,35699413,4199
"43073","ENSG00000271127","22",15794901,15797909,3008
"43074","ENSG00000271128","5",134081914,134082040,126
"43075","ENSG00000271129","16",69025860,69026643,783
"43076","ENSG00000271130","16",33009175,33009620,445
"43077","ENSG00000271131","3",178493327,178493810,483
"43078","ENSG00000271133","7",20328299,20331747,3448
"43079","ENSG00000271134","2",60682873,60683244,371
"43080","ENSG00000271136","X",34516920,34517358,438
"43081","ENSG00000271137","3",52753526,52754690,1164
"43082","ENSG00000271138","22",25437306,25437823,517
"43083","ENSG00000271141","2",178616581,178617123,542
"43084","ENSG00000271142","12",76619386,76620043,657
"43085","ENSG00000271143","1",115916497,115916699,202
"43086","ENSG00000271146","2",61249780,61250621,841
"43087","ENSG00000271147","X",102599512,102714671,115159
"43088","ENSG00000271148","8",49906863,49907446,583
"43089","ENSG00000271149","19",22595479,22596163,684
"43090","ENSG00000271150","19",47794650,47794920,270
"43091","ENSG00000271151","2",173968351,173969418,1067
"43092","ENSG00000271155","9",95506235,95507636,1401
"43093","ENSG00000271156","8",88808318,88808908,590
"43094","ENSG00000271161","3",47499841,47500407,566
"43095","ENSG00000271163","7",2393847,2394131,284
"43096","ENSG00000271164","1",35873270,35873752,482
"43097","ENSG00000271166","9",71804283,71804826,543
"43098","ENSG00000271167","8",76404058,76407138,3080
"43099","ENSG00000271171","19",34891605,34905139,13534
"43100","ENSG00000271172","4",25220403,25220913,510
"43101","ENSG00000271173","10",43728217,43728728,511
"43102","ENSG00000271177","12",100525186,100525420,234
"43103","ENSG00000271178","16",33827214,33827661,447
"43104","ENSG00000271180","14",55240622,55241080,458
"43105","ENSG00000271181","22",25179309,25179554,245
"43106","ENSG00000271182","19",21634833,21635175,342
"43107","ENSG00000271185","7",10940423,10940735,312
"43108","ENSG00000271192","3",43996896,43997443,547
"43109","ENSG00000271196","5",138454540,138454732,192
"43110","ENSG00000271198","14",99964529,99965378,849
"43111","ENSG00000271199","X",73958059,73969485,11426
"43112","ENSG00000271200","1",61741998,61742424,426
"43113","ENSG00000271201","14",106206603,106208571,1968
"43114","ENSG00000271204","7",130930209,130932206,1997
"43115","ENSG00000271207","5",100053686,100055045,1359
"43116","ENSG00000271208","6",112234165,112234758,593
"43117","ENSG00000271209","X",96337236,96337912,676
"43118","ENSG00000271214","9",114491564,114491741,177
"43119","ENSG00000271215","12",12614359,12615907,1548
"43120","ENSG00000271216","13",42810366,42814897,4531
"43121","ENSG00000271218","6",53918974,53920788,1814
"43122","ENSG00000271220","10",28812899,28813139,240
"43123","ENSG00000271225","9",64810865,64811429,564
"43124","ENSG00000271228","2",32013061,32013368,307
"43125","ENSG00000271231","6",34189780,34191079,1299
"43126","ENSG00000271234","6",170297876,170298375,499
"43127","ENSG00000271236","15",40760597,40760874,277
"43128","ENSG00000271239","17",70778604,70779230,626
"43129","ENSG00000271245","6",11154929,11155150,221
"43130","ENSG00000271249","3",109701456,109702218,762
"43131","ENSG00000271252","1",95743096,95759470,16374
"43132","ENSG00000271253","7",12685637,12686033,396
"43133","ENSG00000271254","KI270711.1",4612,29626,25014
"43134","ENSG00000271257","5",58503295,58503700,405
"43135","ENSG00000271259","12",89371820,89372359,539
"43136","ENSG00000271264","1",9780822,9781240,418
"43137","ENSG00000271265","6",156774217,156774662,445
"43138","ENSG00000271266","3",72884234,72884679,445
"43139","ENSG00000271267","1",155566050,155566306,256
"43140","ENSG00000271268","17",35861093,35861566,473
"43141","ENSG00000271270","3",129893811,129918575,24764
"43142","ENSG00000271275","22",18997138,18997595,457
"43143","ENSG00000271278","4",39932454,39933561,1107
"43144","ENSG00000271283","19",19699203,19699409,206
"43145","ENSG00000271284","2",108423612,108423885,273
"43146","ENSG00000271286","X",21939461,21940160,699
"43147","ENSG00000271287","13",67790407,67790794,387
"43148","ENSG00000271302","4",121118299,121118734,435
"43149","ENSG00000271303","20",646615,653370,6755
"43150","ENSG00000271304","6",35989515,35991374,1859
"43151","ENSG00000271306","7",53779783,53780263,480
"43152","ENSG00000271314","9",95494924,95495379,455
"43153","ENSG00000271318","11",86821143,86821728,585
"43154","ENSG00000271320","2",157917712,157918371,659
"43155","ENSG00000271321","7",143755089,143757696,2607
"43156","ENSG00000271327","12",89367807,89369301,1494
"43157","ENSG00000271329","1",44187943,44189049,1106
"43158","ENSG00000271332","11",28144907,28145204,297
"43159","ENSG00000271334","5",39520398,39524726,4328
"43160","ENSG00000271335","10",35314552,35336401,21849
"43161","ENSG00000271337","13",36804198,36805302,1104
"43162","ENSG00000271338","6",53381519,53382203,684
"43163","ENSG00000271339","X",136788286,136788787,501
"43164","ENSG00000271344","7",128690451,128691717,1266
"43165","ENSG00000271350","11",47041027,47041945,918
"43166","ENSG00000271357","12",32100485,32100735,250
"43167","ENSG00000271360","10",11611305,11612227,922
"43168","ENSG00000271362","6",33883170,33883411,241
"43169","ENSG00000271364","15",79984151,79985724,1573
"43170","ENSG00000271366","19",35251440,35253639,2199
"43171","ENSG00000271367","6",53350158,53350705,547
"43172","ENSG00000271369","11",34709600,34710161,561
"43173","ENSG00000271370","12",12452103,12452481,378
"43174","ENSG00000271375","Y",11473727,11474237,510
"43175","ENSG00000271377","8",60906059,60906452,393
"43176","ENSG00000271378","5",37130430,37130700,270
"43177","ENSG00000271379","12",42069935,42070625,690
"43178","ENSG00000271380","1",154961825,154962623,798
"43179","ENSG00000271382","12",93945041,93947813,2772
"43180","ENSG00000271383","1",149475338,149556361,81023
"43181","ENSG00000271384","9",95406990,95407662,672
"43182","ENSG00000271387","1",184385753,184386704,951
"43183","ENSG00000271390","11",111089870,111090368,498
"43184","ENSG00000271392","17",35757199,35758325,1126
"43185","ENSG00000271394","17",35889558,35889804,246
"43186","ENSG00000271395","13",89402398,89818453,416055
"43187","ENSG00000271396","15",90284376,90285580,1204
"43188","ENSG00000271398","1",28247144,28247568,424
"43189","ENSG00000271399","1",228858010,228858556,546
"43190","ENSG00000271400","X",112381392,112382220,828
"43191","ENSG00000271401","2",178644717,178645179,462
"43192","ENSG00000271404","7",139228221,139228605,384
"43193","ENSG00000271410","5",55356308,55357523,1215
"43194","ENSG00000271412","11",117336256,117336631,375
"43195","ENSG00000271414","7",135650972,135651416,444
"43196","ENSG00000271415","1",100196816,100197051,235
"43197","ENSG00000271420","1",23378380,23379029,649
"43198","ENSG00000271424","14",39370279,39370756,477
"43199","ENSG00000271425","1",146064699,146229000,164301
"43200","ENSG00000271426","20",13073667,13074312,645
"43201","ENSG00000271427","1",117364899,117365473,574
"43202","ENSG00000271428","1",22068340,22068827,487
"43203","ENSG00000271429","13",40224625,40224862,237
"43204","ENSG00000271435","2",130313934,130314411,477
"43205","ENSG00000271437","13",98553243,98553780,537
"43206","ENSG00000271440","6",28633381,28633594,213
"43207","ENSG00000271443","2",38535258,38536249,991
"43208","ENSG00000271447","17",35756249,35795707,39458
"43209","ENSG00000271452","2",75669989,75670454,465
"43210","ENSG00000271454","9",39159071,39160319,1248
"43211","ENSG00000271455","5",50603229,50603511,282
"43212","ENSG00000271459","1",171755803,171756323,520
"43213","ENSG00000271461","20",1756756,1758940,2184
"43214","ENSG00000271466","7",63768257,63771047,2790
"43215","ENSG00000271474","4",95549129,95552457,3328
"43216","ENSG00000271475","1",228776312,228776865,553
"43217","ENSG00000271482","7",105204600,105204859,259
"43218","ENSG00000271483","3",194471923,194472085,162
"43219","ENSG00000271484","14",55546674,55548123,1449
"43220","ENSG00000271488","6",132764660,132765458,798
"43221","ENSG00000271490","12",50806335,50806437,102
"43222","ENSG00000271491","11",23370116,23377644,7528
"43223","ENSG00000271492","13",95394049,95394454,405
"43224","ENSG00000271495","16",28548331,28548658,327
"43225","ENSG00000271499","19",19750618,19752544,1926
"43226","ENSG00000271500","12",1695830,1698044,2214
"43227","ENSG00000271503","17",35871491,35880793,9302
"43228","ENSG00000271507","15",22202392,22202734,342
"43229","ENSG00000271509","8",127292233,127292440,207
"43230","ENSG00000271511","14",64361392,64361637,245
"43231","ENSG00000271519","X",35864858,35869631,4773
"43232","ENSG00000271522","7",130790208,130791724,1516
"43233","ENSG00000271524","19",20221869,20222463,594
"43234","ENSG00000271525","9",134078904,134079444,540
"43235","ENSG00000271532","2",101068378,101068656,278
"43236","ENSG00000271533","X",74209976,74213660,3684
"43237","ENSG00000271536","2",73877566,73878862,1296
"43238","ENSG00000271537","7",139198557,139199142,585
"43239","ENSG00000271538","4",184503271,184537626,34355
"43240","ENSG00000271543","11",47796169,47796379,210
"43241","ENSG00000271547","12",48800576,48801086,510
"43242","ENSG00000271550","7",64678954,64687393,8439
"43243","ENSG00000271551","6",156776360,156778422,2062
"43244","ENSG00000271553","7",128667043,128668156,1113
"43245","ENSG00000271554","1",35992109,36013630,21521
"43246","ENSG00000271555","8",52722903,52723141,238
"43247","ENSG00000271557","11",47841324,47841682,358
"43248","ENSG00000271558","1",187506838,187507119,281
"43249","ENSG00000271559","13",26229332,26229644,312
"43250","ENSG00000271563","10",25691537,25692323,786
"43251","ENSG00000271564","13",52334295,52341896,7601
"43252","ENSG00000271565","20",6219199,6219443,244
"43253","ENSG00000271567","1",144372875,144373659,784
"43254","ENSG00000271568","7",150603561,150604644,1083
"43255","ENSG00000271569","2",97355059,97355335,276
"43256","ENSG00000271573","10",87027184,87027477,293
"43257","ENSG00000271576","1",84076331,84077931,1600
"43258","ENSG00000271579","12",115299588,115300708,1120
"43259","ENSG00000271580","1",205091163,205091946,783
"43260","ENSG00000271581","6",31356647,31357637,990
"43261","ENSG00000271582","7",150484061,150485135,1074
"43262","ENSG00000271584","11",111091932,111179641,87709
"43263","ENSG00000271587","17",65644308,65644617,309
"43264","ENSG00000271590","2",111210995,111212476,1481
"43265","ENSG00000271596","12",50949117,50949384,267
"43266","ENSG00000271597","2",69251818,69252364,546
"43267","ENSG00000271598","19",21025915,21026041,126
"43268","ENSG00000271600","11",102308557,102308797,240
"43269","ENSG00000271601","1",145933423,145958017,24594
"43270","ENSG00000271605","17",64449037,64468643,19606
"43271","ENSG00000271607","6",110863860,110864451,591
"43272","ENSG00000271609","16",21538487,21538794,307
"43273","ENSG00000271612","8",102451763,102452483,720
"43274","ENSG00000271614","12",89708959,89712590,3631
"43275","ENSG00000271615","2",57755428,57766052,10624
"43276","ENSG00000271616","15",28830619,28831182,563
"43277","ENSG00000271618","1",71738173,71738354,181
"43278","ENSG00000271620","16",33938337,33938799,462
"43279","ENSG00000271623","16",28364700,28365333,633
"43280","ENSG00000271624","11",131770795,131771638,843
"43281","ENSG00000271625","13",97475742,97476459,717
"43282","ENSG00000271626","17",60315834,60316215,381
"43283","ENSG00000271627","2",91723023,91723605,582
"43284","ENSG00000271631","9",112885158,112885767,609
"43285","ENSG00000271632","14",19199763,19200279,516
"43286","ENSG00000271635","2",111558413,111559937,1524
"43287","ENSG00000271638","19",20323992,20324568,576
"43288","ENSG00000271639","2",233545482,233547032,1550
"43289","ENSG00000271642","12",46682071,46682713,642
"43290","ENSG00000271643","3",33793644,33798539,4895
"43291","ENSG00000271646","4",184474802,184477304,2502
"43292","ENSG00000271647","1",44103306,44104703,1397
"43293","ENSG00000271653","3",37216779,37217988,1209
"43294","ENSG00000271654","8",18387108,18387777,669
"43295","ENSG00000271655","19",22840432,22840921,489
"43296","ENSG00000271656","14",81003325,81003645,320
"43297","ENSG00000271657","2",62168862,62171163,2301
"43298","ENSG00000271659","9",95514045,95514520,475
"43299","ENSG00000271660","X",146964176,146964485,309
"43300","ENSG00000271661","19",22994968,22995847,879
"43301","ENSG00000271662","3",195650146,195651472,1326
"43302","ENSG00000271664","7",149275619,149277992,2373
"43303","ENSG00000271670","10",120879256,120880667,1411
"43304","ENSG00000271676","4",77112495,77113458,963
"43305","ENSG00000271680","1",206905928,206906393,465
"43306","ENSG00000271681","5",178344843,178345316,473
"43307","ENSG00000271682","3",183462851,183463201,350
"43308","ENSG00000271686","X",114389135,114389954,819
"43309","ENSG00000271687","5",100046977,100048785,1808
"43310","ENSG00000271696","7",57835309,57836251,942
"43311","ENSG00000271697","14",67735195,67735350,155
"43312","ENSG00000271698","8",144353228,144355609,2381
"43313","ENSG00000271699","16",29350746,29370272,19526
"43314","ENSG00000271704","19",20351502,20352079,577
"43315","ENSG00000271705","14",81001166,81001786,620
"43316","ENSG00000271707","2",60734895,60735715,820
"43317","ENSG00000271709","2",120866378,120867403,1025
"43318","ENSG00000271710","10",74641410,74641776,366
"43319","ENSG00000271711","3",150611262,150611877,615
"43320","ENSG00000271714","5",74865893,74867854,1961
"43321","ENSG00000271715","5",10269489,10269918,429
"43322","ENSG00000271716","3",11607184,11610748,3564
"43323","ENSG00000271717","19",8222153,8239648,17495
"43324","ENSG00000271723","1",54641786,54742308,100522
"43325","ENSG00000271724","5",146375591,146376219,628
"43326","ENSG00000271725","15",81303215,81309391,6176
"43327","ENSG00000271727","6",692530,796781,104251
"43328","ENSG00000271730","6",108998482,108999125,643
"43329","ENSG00000271732","1",16617391,16617729,338
"43330","ENSG00000271734","6",108030249,108030718,469
"43331","ENSG00000271736","1",157273760,157283968,10208
"43332","ENSG00000271737","5",134005147,134005562,415
"43333","ENSG00000271741","1",34981533,35031741,50208
"43334","ENSG00000271742","1",15682873,15683128,255
"43335","ENSG00000271743","8",6615604,6617198,1594
"43336","ENSG00000271749","17",63393355,63393586,231
"43337","ENSG00000271751","11",119065263,119065677,414
"43338","ENSG00000271752","5",50662859,50663266,407
"43339","ENSG00000271754","6",43519180,43519724,544
"43340","ENSG00000271755","6",27404010,27406964,2954
"43341","ENSG00000271761","6",57902609,57903148,539
"43342","ENSG00000271763","15",92602910,92620015,17105
"43343","ENSG00000271765","6",136545192,136545492,300
"43344","ENSG00000271766","5",127478295,127478737,442
"43345","ENSG00000271771","5",34158121,34158767,646
"43346","ENSG00000271774","20",53255979,53487274,231295
"43347","ENSG00000271776","13",78596129,78599619,3490
"43348","ENSG00000271778","3",158782547,158783124,577
"43349","ENSG00000271779","17",64572829,64573081,252
"43350","ENSG00000271780","14",101948347,101949425,1078
"43351","ENSG00000271781","5",675826,676616,790
"43352","ENSG00000271784","20",46689659,46690289,630
"43353","ENSG00000271787","2",10054421,10054866,445
"43354","ENSG00000271788","5",43006733,43007543,810
"43355","ENSG00000271789","6",111297126,111298510,1384
"43356","ENSG00000271792","5",139775305,139775472,167
"43357","ENSG00000271793","6",85557978,85615234,57256
"43358","ENSG00000271795","5",151509453,151512769,3316
"43359","ENSG00000271797","5",115262505,115263448,943
"43360","ENSG00000271798","20",2655067,2655198,131
"43361","ENSG00000271803","20",33674517,33675380,863
"43362","ENSG00000271806","1",2141084,2145279,4195
"43363","ENSG00000271810","1",112702614,112711433,8819
"43364","ENSG00000271811","1",170667381,170669425,2044
"43365","ENSG00000271814","X",12614003,12614197,194
"43366","ENSG00000271815","5",75363760,75364242,482
"43367","ENSG00000271816","10",73699151,73730487,31336
"43368","ENSG00000271817","4",158700691,158700909,218
"43369","ENSG00000271818","13",45123093,45123414,321
"43370","ENSG00000271819","15",50347423,50347529,106
"43371","ENSG00000271820","6",170266669,170276762,10093
"43372","ENSG00000271821","6",31200165,31201918,1753
"43373","ENSG00000271824","5",136191468,136193134,1666
"43374","ENSG00000271825","2",177300600,177302006,1406
"43375","ENSG00000271826","X",115518182,115562731,44549
"43376","ENSG00000271828","5",56927874,56929573,1699
"43377","ENSG00000271830","8",103481266,103481619,353
"43378","ENSG00000271833","9",127366770,127367397,627
"43379","ENSG00000271841","3",17664963,17665025,62
"43380","ENSG00000271843","3",64008082,64008692,610
"43381","ENSG00000271848","10",73653980,73675450,21470
"43382","ENSG00000271849","5",109687802,109688329,527
"43383","ENSG00000271850","13",34347986,34616216,268230
"43384","ENSG00000271851","17",9553323,9555696,2373
"43385","ENSG00000271855","2",9555899,9556775,876
"43386","ENSG00000271856","3",108125821,108138610,12789
"43387","ENSG00000271857","6",45421079,45422005,926
"43388","ENSG00000271858","3",50365334,50368197,2863
"43389","ENSG00000271860","6",97283303,98400869,1117566
"43390","ENSG00000271862","5",83049376,83050964,1588
"43391","ENSG00000271868","2",3496956,3497428,472
"43392","ENSG00000271869","8",30155830,30156232,402
"43393","ENSG00000271870","3",3152942,3153435,493
"43394","ENSG00000271871","5",141952419,141953375,956
"43395","ENSG00000271874","5",34651457,34651888,431
"43396","ENSG00000271880","10",86970741,87010126,39385
"43397","ENSG00000271882","8",101208148,101208558,410
"43398","ENSG00000271886","X",53556223,53556341,118
"43399","ENSG00000271888","6",15243923,15245000,1077
"43400","ENSG00000271889","2",61151433,61162105,10672
"43401","ENSG00000271892","5",17107360,17107789,429
"43402","ENSG00000271893","2",195451778,195515699,63921
"43403","ENSG00000271894","2",56147630,56386171,238541
"43404","ENSG00000271895","1",11029659,11030528,869
"43405","ENSG00000271897","6",11607552,11607981,429
"43406","ENSG00000271900","17",19601840,19602256,416
"43407","ENSG00000271901","13",34545929,34696612,150683
"43408","ENSG00000271904","5",88433892,88498697,64805
"43409","ENSG00000271907","X",115126316,115126444,128
"43410","ENSG00000271911","6",761675,780648,18973
"43411","ENSG00000271913","6",158988178,159088114,99936
"43412","ENSG00000271914","1",35929720,35930115,395
"43413","ENSG00000271916","3",53797764,53798019,255
"43414","ENSG00000271917","1",164828436,164829952,1516
"43415","ENSG00000271918","5",116083807,116085416,1609
"43416","ENSG00000271924","2",161409554,161409670,116
"43417","ENSG00000271926","5",72953635,72954274,639
"43418","ENSG00000271930","8",98943595,98944098,503
"43419","ENSG00000271931","6",89080164,89080667,503
"43420","ENSG00000271932","7",140884072,140884178,106
"43421","ENSG00000271933","10",84138420,84140582,2162
"43422","ENSG00000271936","2",24825610,24826717,1107
"43423","ENSG00000271937","3",44337941,44338552,611
"43424","ENSG00000271938","8",42139461,42139752,291
"43425","ENSG00000271943","3",27632976,27639111,6135
"43426","ENSG00000271945","6",76774972,77097788,322816
"43427","ENSG00000271947","2",6905724,6906301,577
"43428","ENSG00000271952","2",10844477,10885118,40641
"43429","ENSG00000271955","2",59218680,60100200,881520
"43430","ENSG00000271958","4",38618265,38619437,1172
"43431","ENSG00000271959","8",141434545,141437954,3409
"43432","ENSG00000271963","12",133115692,133122340,6648
"43433","ENSG00000271964","3",16314439,16314987,548
"43434","ENSG00000271966","8",67343975,67345087,1112
"43435","ENSG00000271967","6",70596438,70596980,542
"43436","ENSG00000271968","14",105969729,105972269,2540
"43437","ENSG00000271969","12",6964949,6965382,433
"43438","ENSG00000271971","8",93715378,93716113,735
"43439","ENSG00000271973","3",48672455,48672733,278
"43440","ENSG00000271974","17",64905883,64906018,135
"43441","ENSG00000271976","3",53858994,53861576,2582
"43442","ENSG00000271977","4",3915187,3924274,9087
"43443","ENSG00000271978","6",5031756,5054423,22667
"43444","ENSG00000271980","5",10264597,10267146,2549
"43445","ENSG00000271983","15",80693216,80693707,491
"43446","ENSG00000271984","20",45892694,45893419,725
"43447","ENSG00000271986","6",73487590,73487877,287
"43448","ENSG00000271989","1",10429881,10430677,796
"43449","ENSG00000271991","2",19902025,19902569,544
"43450","ENSG00000271992","1",70445071,70445536,465
"43451","ENSG00000271993","3",37182107,37182734,627
"43452","ENSG00000271996","2",177306373,177310572,4199
"43453","ENSG00000272002","2",7260871,7261504,633
"43454","ENSG00000272004","1",1659325,1662602,3277
"43455","ENSG00000272006","17",64951498,64951609,111
"43456","ENSG00000272008","6",87151159,87155285,4126
"43457","ENSG00000272009","6",28078792,28081130,2338
"43458","ENSG00000272010","8",65591850,65592472,622
"43459","ENSG00000272015","21",38894785,38894867,82
"43460","ENSG00000272020","3",126160283,126160445,162
"43461","ENSG00000272021","5",95849309,95849855,546
"43462","ENSG00000272023","5",132963770,132964164,394
"43463","ENSG00000272024","8",51950284,51950690,406
"43464","ENSG00000272027","2",34692290,34703606,11316
"43465","ENSG00000272028","12",51014134,51014241,107
"43466","ENSG00000272030","1",153631438,153634397,2959
"43467","ENSG00000272031","1",145959441,145964575,5134
"43468","ENSG00000272033","1",167379108,167381000,1892
"43469","ENSG00000272034","11",17074654,17074744,90
"43470","ENSG00000272037","8",102256392,102257821,1429
"43471","ENSG00000272040","5",75608817,75609983,1166
"43472","ENSG00000272043","8",122780760,122781071,311
"43473","ENSG00000272046","13",87807634,87811232,3598
"43474","ENSG00000272047","6",158168350,158199344,30994
"43475","ENSG00000272049","5",8444949,8445535,586
"43476","ENSG00000272050","20",62477870,62478594,724
"43477","ENSG00000272054","2",37208875,37212677,3802
"43478","ENSG00000272056","2",27053618,27054276,658
"43479","ENSG00000272057","5",14872332,14872713,381
"43480","ENSG00000272068","1",156637783,156641004,3221
"43481","ENSG00000272070","5",141326210,141329357,3147
"43482","ENSG00000272071","5",6779458,6779998,540
"43483","ENSG00000272072","7",107192559,107193300,741
"43484","ENSG00000272075","11",118067237,118067539,302
"43485","ENSG00000272076","8",51810110,51810681,571
"43486","ENSG00000272077","3",44667412,44669364,1952
"43487","ENSG00000272078","1",10639241,10654333,15092
"43488","ENSG00000272079","16",3006120,3007388,1268
"43489","ENSG00000272081","5",72955206,72955699,493
"43490","ENSG00000272084","1",19072110,19075511,3401
"43491","ENSG00000272085","5",158464465,158464678,213
"43492","ENSG00000272086","5",32174471,32175272,801
"43493","ENSG00000272087","3",158693120,158693768,648
"43494","ENSG00000272088","1",3487246,3487627,381
"43495","ENSG00000272092","8",38382364,38383461,1097
"43496","ENSG00000272094","1",90860550,90862920,2370
"43497","ENSG00000272096","3",155437538,155437823,285
"43498","ENSG00000272097","6",10743324,10747663,4339
"43499","ENSG00000272100","1",52353487,52353877,390
"43500","ENSG00000272103","5",36861736,36867238,5502
"43501","ENSG00000272104","3",50350892,50367923,17031
"43502","ENSG00000272106","1",1613758,1615795,2037
"43503","ENSG00000272108","5",141118680,141120765,2085
"43504","ENSG00000272109","5",96803688,96806105,2417
"43505","ENSG00000272112","5",151724831,151725356,525
"43506","ENSG00000272113","9",32820261,32820350,89
"43507","ENSG00000272115","8",144409492,144409976,484
"43508","ENSG00000272121","3",43998081,43999149,1068
"43509","ENSG00000272123","5",53089016,53089468,452
"43510","ENSG00000272128","8",38099471,38099931,460
"43511","ENSG00000272129","6",80355424,80356859,1435
"43512","ENSG00000272130","5",21569755,21570045,290
"43513","ENSG00000272134","17",64881091,64881181,90
"43514","ENSG00000272137","6",79561132,79561602,470
"43515","ENSG00000272138","8",79768110,79802842,34732
"43516","ENSG00000272139","5",122311297,122311673,376
"43517","ENSG00000272140","10",73703735,73713581,9846
"43518","ENSG00000272141","1",1169357,1170343,986
"43519","ENSG00000272142","6",5003774,5080946,77172
"43520","ENSG00000272143","13",102394630,102395703,1073
"43521","ENSG00000272144","5",43061395,43062441,1046
"43522","ENSG00000272145","1",40690380,40692066,1686
"43523","ENSG00000272146","3",57597531,57600927,3396
"43524","ENSG00000272148","2",27062428,27062907,479
"43525","ENSG00000272150","1",145572345,145607858,35513
"43526","ENSG00000272153","1",3785008,3785538,530
"43527","ENSG00000272154","5",141100242,141174391,74149
"43528","ENSG00000272155","8",65714334,65714778,444
"43529","ENSG00000272156","2",54082554,54085066,2512
"43530","ENSG00000272158","14",65003325,65003767,442
"43531","ENSG00000272159","8",38408048,38408742,694
"43532","ENSG00000272160","10",109869858,109869992,134
"43533","ENSG00000272161","1",2326201,2326693,492
"43534","ENSG00000272163","8",24912165,24914717,2552
"43535","ENSG00000272164","17",63004672,63005152,480
"43536","ENSG00000272167","1",214028891,214030901,2010
"43537","ENSG00000272168","6",21664185,22654455,990270
"43538","ENSG00000272170","6",43074331,43074739,408
"43539","ENSG00000272172","8",143290399,143290621,222
"43540","ENSG00000272173","12",6943508,6944604,1096
"43541","ENSG00000272175","1",51801028,51801307,279
"43542","ENSG00000272180","2",55952158,56181652,229494
"43543","ENSG00000272181","3",64019508,64019925,417
"43544","ENSG00000272182","3",58428255,58428815,560
"43545","ENSG00000272183","2",74501717,74502365,648
"43546","ENSG00000272186","11",119067374,119067698,324
"43547","ENSG00000272189","6",136550661,136552554,1893
"43548","ENSG00000272192","8",65842752,65843331,579
"43549","ENSG00000272195","1",244969350,244971088,1738
"43550","ENSG00000272196","1",149851061,149851624,563
"43551","ENSG00000272197","5",154718383,154718689,306
"43552","ENSG00000272202","3",57078943,57080101,1158
"43553","ENSG00000272203","5",132817248,132818000,752
"43554","ENSG00000272205","1",167219831,167220512,681
"43555","ENSG00000272209","6",13825432,13826574,1142
"43556","ENSG00000272211","2",196151263,196154881,3618
"43557","ENSG00000272215","12",111564821,111564883,62
"43558","ENSG00000272217","6",33246075,33246856,781
"43559","ENSG00000272218","4",186892552,186892983,431
"43560","ENSG00000272219","7",101960116,101961894,1778
"43561","ENSG00000272221","6",31394289,31395495,1206
"43562","ENSG00000272223","6",43033897,43034405,508
"43563","ENSG00000272226","1",58812808,58813342,534
"43564","ENSG00000272230","7",114653345,114653455,110
"43565","ENSG00000272232","9",70579163,70579461,298
"43566","ENSG00000272235","1",3306636,3310096,3460
"43567","ENSG00000272236","6",29751965,29752207,242
"43568","ENSG00000272239","5",147401760,147401996,236
"43569","ENSG00000272240","8",234347,234887,540
"43570","ENSG00000272243","6",74530248,74734319,204071
"43571","ENSG00000272247","3",158801257,158801935,678
"43572","ENSG00000272248","6",4018713,4019202,489
"43573","ENSG00000272249","8",97132835,97133379,544
"43574","ENSG00000272253","14",67657105,67657211,106
"43575","ENSG00000272254","8",73042910,73043346,436
"43576","ENSG00000272255","5",139644460,139645002,542
"43577","ENSG00000272256","8",30082758,30083467,709
"43578","ENSG00000272259","20",63009383,63085071,75688
"43579","ENSG00000272262","1",202410108,202410207,99
"43580","ENSG00000272263","3",12832219,12832728,509
"43581","ENSG00000272264","8",80032724,80033300,576
"43582","ENSG00000272265","5",116078110,116078570,460
"43583","ENSG00000272267","8",9555144,9556520,1376
"43584","ENSG00000272269","6",17706257,17707344,1087
"43585","ENSG00000272273","6",30742929,30743592,663
"43586","ENSG00000272274","13",106568261,106716679,148418
"43587","ENSG00000272275","2",10767875,10770058,2183
"43588","ENSG00000272277","6",3068045,3068894,849
"43589","ENSG00000272279","6",1528364,1528911,547
"43590","ENSG00000272281","13",52219344,52334277,114933
"43591","ENSG00000272282","3",27712910,27714005,1095
"43592","ENSG00000272288","6",34696317,34697470,1153
"43593","ENSG00000272293","8",450714,451343,629
"43594","ENSG00000272297","4",186426546,186555328,128782
"43595","ENSG00000272298","15",92699040,92724277,25237
"43596","ENSG00000272304","4",66003281,66016792,13511
"43597","ENSG00000272305","3",52969119,53099453,130334
"43598","ENSG00000272308","5",60866457,60866935,478
"43599","ENSG00000272311","19",39264382,39265817,1435
"43600","ENSG00000272312","6",27001208,27001648,440
"43601","ENSG00000272316","6",57908560,57913911,5351
"43602","ENSG00000272319","10",42579724,42579858,134
"43603","ENSG00000272320","6",3311662,3313650,1988
"43604","ENSG00000272321","8",98436669,98439290,2621
"43605","ENSG00000272323","5",34837549,34839278,1729
"43606","ENSG00000272324","5",10761065,10770294,9229
"43607","ENSG00000272325","6",34279679,34392669,112990
"43608","ENSG00000272328","7",8303741,8341343,37602
"43609","ENSG00000272329","13",96948018,96949584,1566
"43610","ENSG00000272330","16",73014319,73014476,157
"43611","ENSG00000272333","19",35718019,35738878,20859
"43612","ENSG00000272334","3",36973117,36973672,555
"43613","ENSG00000272335","5",44826076,44828592,2516
"43614","ENSG00000272337","15",51907200,51907305,105
"43615","ENSG00000272338","8",33360839,33361415,576
"43616","ENSG00000272341","6",16764346,16766883,2537
"43617","ENSG00000272342","2",739588,740164,576
"43618","ENSG00000272343","8",56222688,56223173,485
"43619","ENSG00000272344","14",100981975,100982046,71
"43620","ENSG00000272345","6",24700907,24701793,886
"43621","ENSG00000272347","5",1005039,1006623,1584
"43622","ENSG00000272351","X",69672479,69672597,118
"43623","ENSG00000272354","5",65020614,65020989,375
"43624","ENSG00000272356","6",111309203,111313517,4314
"43625","ENSG00000272359","3",196747192,196747324,132
"43626","ENSG00000272360","3",58490830,58491291,461
"43627","ENSG00000272361","7",16593626,16594224,598
"43628","ENSG00000272362","1",234644666,234647571,2905
"43629","ENSG00000272366","10",22340377,22340615,238
"43630","ENSG00000272368","12",50112197,50165618,53421
"43631","ENSG00000272369","12",46537502,46652550,115048
"43632","ENSG00000272370","5",65020038,65020551,513
"43633","ENSG00000272371","1",52554818,52555273,455
"43634","ENSG00000272372","16",56351886,56353524,1638
"43635","ENSG00000272374","6",35220370,35224630,4260
"43636","ENSG00000272375","8",30197404,30198048,644
"43637","ENSG00000272379","6",13290018,13290490,472
"43638","ENSG00000272381","10",31187715,31261910,74195
"43639","ENSG00000272382","5",43033716,43034635,919
"43640","ENSG00000272383","17",63088162,63089197,1035
"43641","ENSG00000272384","8",122779971,122780830,859
"43642","ENSG00000272386","17",76551352,76551750,398
"43643","ENSG00000272387","10",42583241,42583375,134
"43644","ENSG00000272391","7",75416786,75486299,69513
"43645","ENSG00000272395","19",39246314,39248856,2542
"43646","ENSG00000272396","19",43360685,43368970,8285
"43647","ENSG00000272397","6",146948528,146951159,2631
"43648","ENSG00000272398","6",106969831,106975627,5796
"43649","ENSG00000272400","17",64847386,64847728,342
"43650","ENSG00000272402","6",24706747,24707151,404
"43651","ENSG00000272405","1",156641666,156644887,3221
"43652","ENSG00000272406","5",93741640,93743500,1860
"43653","ENSG00000272407","20",41196647,41196938,291
"43654","ENSG00000272410","3",10249372,10285796,36424
"43655","ENSG00000272411","5",148970340,148970653,313
"43656","ENSG00000272412","11",130310180,130310476,296
"43657","ENSG00000272414","4",76251721,76311129,59408
"43658","ENSG00000272416","5",53880293,53881051,758
"43659","ENSG00000272417","5",10203600,10204040,440
"43660","ENSG00000272419","1",145164099,145216058,51959
"43661","ENSG00000272420","1",2363061,2363628,567
"43662","ENSG00000272425","8",81275399,81277570,2171
"43663","ENSG00000272426","1",16904339,16904776,437
"43664","ENSG00000272428","6",133540784,133541174,390
"43665","ENSG00000272430","10",46632387,46635472,3085
"43666","ENSG00000272431","5",178938677,178939223,546
"43667","ENSG00000272432","1",25247837,25248321,484
"43668","ENSG00000272434","3",49029316,49029706,390
"43669","ENSG00000272435","12",34205699,34205817,118
"43670","ENSG00000272438","1",904834,915976,11142
"43671","ENSG00000272439","14",99444306,99444412,106
"43672","ENSG00000272440","3",158695367,158695581,214
"43673","ENSG00000272442","6",44273194,44378957,105763
"43674","ENSG00000272443","1",147445579,147446133,554
"43675","ENSG00000272444","14",101952416,101953063,647
"43676","ENSG00000272446","6",139159157,139277181,118024
"43677","ENSG00000272447","10",79825902,79827602,1700
"43678","ENSG00000272449","1",2530064,2547460,17396
"43679","ENSG00000272455","1",1409096,1410618,1522
"43680","ENSG00000272456","8",134722947,134723949,1002
"43681","ENSG00000272457","8",53876150,53876649,499
"43682","ENSG00000272459","5",177554824,177555364,540
"43683","ENSG00000272461","18",962592,976883,14291
"43684","ENSG00000272462","6",25992641,26001775,9134
"43685","ENSG00000272463","6",708592,711405,2813
"43686","ENSG00000272465","6",2437549,2438249,700
"43687","ENSG00000272468","6",27122657,27123221,564
"43688","ENSG00000272469","8",73833773,73834042,269
"43689","ENSG00000272472","6",122643388,122644771,1383
"43690","ENSG00000272473","19",781002,781862,860
"43691","ENSG00000272476","6",107957413,107959986,2573
"43692","ENSG00000272477","3",18408680,18409635,955
"43693","ENSG00000272479","8",40519565,40520158,593
"43694","ENSG00000272480","1",147482238,147482628,390
"43695","ENSG00000272482","1",12618900,12619244,344
"43696","ENSG00000272483","3",11611602,11612197,595
"43697","ENSG00000272485","6",774747,780214,5467
"43698","ENSG00000272489","10",79663192,79664786,1594
"43699","ENSG00000272491","1",48227888,48229561,1673
"43700","ENSG00000272494","5",176006145,176007387,1242
"43701","ENSG00000272498","3",16339308,16339871,563
"43702","ENSG00000272501","6",31195200,31198037,2837
"43703","ENSG00000272502","8",120812219,120813359,1140
"43704","ENSG00000272505","8",10486807,10489666,2859
"43705","ENSG00000272506","1",65003470,65004087,617
"43706","ENSG00000272507","10",12116280,12116379,99
"43707","ENSG00000272508","10",86993432,87024732,31300
"43708","ENSG00000272509","8",94884609,94885070,461
"43709","ENSG00000272510","1",15565611,15565956,345
"43710","ENSG00000272512","1",995966,998051,2085
"43711","ENSG00000272514","6",87407972,87464465,56493
"43712","ENSG00000272515","13",87607907,87609234,1327
"43713","ENSG00000272516","10",22332404,22332987,583
"43714","ENSG00000272518","8",79956465,79957381,916
"43715","ENSG00000272519","2",213266995,213276152,9157
"43716","ENSG00000272523","5",108727825,108728260,435
"43717","ENSG00000272525","5",73497550,73498293,743
"43718","ENSG00000272529","3",16345126,16346440,1314
"43719","ENSG00000272533","14",103337849,103337974,125
"43720","ENSG00000272536","10",72582803,72583086,283
"43721","ENSG00000272537","7",16471184,16471373,189
"43722","ENSG00000272540","6",30723105,30723877,772
"43723","ENSG00000272541","6",57855891,57856468,577
"43724","ENSG00000272542","13",102888858,102889834,976
"43725","ENSG00000272543","3",50675080,50675163,83
"43726","ENSG00000272549","6",167666840,167679270,12430
"43727","ENSG00000272551","2",176611437,176612249,812
"43728","ENSG00000272555","2",218818690,218819144,454
"43729","ENSG00000272556","7",45769105,45815263,46158
"43730","ENSG00000272562","1",226045561,226061898,16337
"43731","ENSG00000272563","2",113432600,113436042,3442
"43732","ENSG00000272564","2",85904279,85904727,448
"43733","ENSG00000272566","4",189703881,189704490,609
"43734","ENSG00000272567","4",112272968,112273316,348
"43735","ENSG00000272568","7",28979967,29013367,33400
"43736","ENSG00000272572","10",100911103,100912739,1636
"43737","ENSG00000272573","3",52833114,52835019,1905
"43738","ENSG00000272574","1",162593103,162593754,651
"43739","ENSG00000272575","11",128208749,128241441,32692
"43740","ENSG00000272576","4",51918772,51919381,609
"43741","ENSG00000272578","22",23658094,23717356,59262
"43742","ENSG00000272583","1",121518366,121518829,463
"43743","ENSG00000272588","4",757022,757740,718
"43744","ENSG00000272589","10",73796514,73801399,4885
"43745","ENSG00000272592","10",61684892,61685388,496
"43746","ENSG00000272595","7",5103719,5120245,16526
"43747","ENSG00000272597","3",107329430,107329962,532
"43748","ENSG00000272599","10",73124573,73125532,959
"43749","ENSG00000272602","4",53286,88208,34922
"43750","ENSG00000272604","7",105571083,105573660,2577
"43751","ENSG00000272606","2",55617909,55618373,464
"43752","ENSG00000272609","3",138004649,138005122,473
"43753","ENSG00000272610","3",65872815,65954558,81743
"43754","ENSG00000272619","7",143363899,143364229,330
"43755","ENSG00000272620","4",7754090,7778928,24838
"43756","ENSG00000272622","2",226800146,226813741,13595
"43757","ENSG00000272625","18",2920966,2921685,719
"43758","ENSG00000272626","4",68901008,68906983,5975
"43759","ENSG00000272627","10",72766560,72767052,492
"43760","ENSG00000272630","10",73098044,73101297,3253
"43761","ENSG00000272631","10",86749754,86756298,6544
"43762","ENSG00000272632","4",141430831,141431284,453
"43763","ENSG00000272636","17",142789,181650,38861
"43764","ENSG00000272644","2",219069354,219069809,455
"43765","ENSG00000272645","1",223951394,223992594,41200
"43766","ENSG00000272646","4",182881777,182882203,426
"43767","ENSG00000272647","7",99558695,99607810,49115
"43768","ENSG00000272650","4",53997415,53997712,297
"43769","ENSG00000272654","1",153977743,153979160,1417
"43770","ENSG00000272655","7",44013562,44019170,5608
"43771","ENSG00000272656","3",139349024,139349371,347
"43772","ENSG00000272657","21",34073592,34360033,286441
"43773","ENSG00000272660","3",179584271,179584410,139
"43774","ENSG00000272662","3",119497678,119498181,503
"43775","ENSG00000272663","2",48440043,48440597,554
"43776","ENSG00000272666","22",50542305,50542906,601
"43777","ENSG00000272667","2",127886556,127887185,629
"43778","ENSG00000272668","1",159854870,159867685,12815
"43779","ENSG00000272669","22",38742625,38743115,490
"43780","ENSG00000272672","1",89939601,89940147,546
"43781","ENSG00000272674","5",141181399,141186399,5000
"43782","ENSG00000272676","11",57045091,57045390,299
"43783","ENSG00000272677","4",82374301,82384027,9726
"43784","ENSG00000272679","9",136800366,136829466,29100
"43785","ENSG00000272682","22",19124309,19128449,4140
"43786","ENSG00000272686","7",123749068,123751166,2098
"43787","ENSG00000272689","22",30421206,30421536,330
"43788","ENSG00000272690","3",75435232,75538029,102797
"43789","ENSG00000272691","1",85578500,85578742,242
"43790","ENSG00000272692","10",75409142,75411842,2700
"43791","ENSG00000272695","13",113864112,113866834,2722
"43792","ENSG00000272696","9",128316337,128316909,572
"43793","ENSG00000272699","3",179405448,179405944,496
"43794","ENSG00000272701","7",130486042,130491033,4991
"43795","ENSG00000272702","2",73113018,73115907,2889
"43796","ENSG00000272703","18",11857155,11857554,399
"43797","ENSG00000272707","3",194637505,194637664,159
"43798","ENSG00000272710","3",75540049,75580199,40150
"43799","ENSG00000272711","2",74832655,74833987,1332
"43800","ENSG00000272715","1",116909149,116909531,382
"43801","ENSG00000272716","2",32165046,32165757,711
"43802","ENSG00000272717","4",139556799,139557643,844
"43803","ENSG00000272719","7",5556731,5557245,514
"43804","ENSG00000272720","22",38090127,38091559,1432
"43805","ENSG00000272721","3",184134019,184135238,1219
"43806","ENSG00000272727","4",145335263,145343559,8296
"43807","ENSG00000272729","2",176164164,176165716,1552
"43808","ENSG00000272732","7",7550104,7552440,2336
"43809","ENSG00000272733","22",23580880,23583859,2979
"43810","ENSG00000272734","10",86965345,86971311,5966
"43811","ENSG00000272735","2",71067519,71068125,606
"43812","ENSG00000272736","17",10383132,10537862,154730
"43813","ENSG00000272741","3",196248230,196318222,69992
"43814","ENSG00000272744","4",183516894,183517527,633
"43815","ENSG00000272745","7",7619872,7620543,671
"43816","ENSG00000272746","18",13526078,13526688,610
"43817","ENSG00000272748","10",74821610,74822130,520
"43818","ENSG00000272750","1",222658867,222661512,2645
"43819","ENSG00000272752","7",100336104,100367831,31727
"43820","ENSG00000272754","2",32321638,32323002,1364
"43821","ENSG00000272755","1",149264252,149264816,564
"43822","ENSG00000272758","3",122416207,122443180,26973
"43823","ENSG00000272760","7",154951226,154952188,962
"43824","ENSG00000272762","3",51961212,51974031,12819
"43825","ENSG00000272763","17",48635923,48647023,11100
"43826","ENSG00000272764","10",5813985,5814441,456
"43827","ENSG00000272767","10",63465229,63466563,1334
"43828","ENSG00000272768","7",44884953,44886393,1440
"43829","ENSG00000272769","2",132345616,132347297,1681
"43830","ENSG00000272772","5",134167170,134226071,58901
"43831","ENSG00000272774","3",72178279,72178810,531
"43832","ENSG00000272777","4",99067256,99068125,869
"43833","ENSG00000272779","22",22303224,22310401,7177
"43834","ENSG00000272783","4",1550284,1550572,288
"43835","ENSG00000272784","4",183094423,183095056,633
"43836","ENSG00000272787","22",23969211,23969873,662
"43837","ENSG00000272788","18",8801656,8802305,649
"43838","ENSG00000272789","2",127625997,127626848,851
"43839","ENSG00000272791","10",73630556,73631490,934
"43840","ENSG00000272795","4",109815047,109815410,363
"43841","ENSG00000272797","3",168927475,168927919,444
"43842","ENSG00000272798","22",25436312,25436915,603
"43843","ENSG00000272799","18",9912316,9912849,533
"43844","ENSG00000272800","2",183178806,183215414,36608
"43845","ENSG00000272801","7",27147366,27152598,5232
"43846","ENSG00000272804","21",44600597,44602174,1577
"43847","ENSG00000272807","2",210028417,210029156,739
"43848","ENSG00000272808","15",100849831,100876836,27005
"43849","ENSG00000272810","6",26013241,26013757,516
"43850","ENSG00000272812","8",233119,233692,573
"43851","ENSG00000272814","2",46956615,46956888,273
"43852","ENSG00000272815","17",16788057,16816540,28483
"43853","ENSG00000272817","10",91908131,91909348,1217
"43854","ENSG00000272821","22",50523926,50524780,854
"43855","ENSG00000272822","12",48903503,48957365,53862
"43856","ENSG00000272823","1",220828676,220829211,535
"43857","ENSG00000272824","1",148358245,148358686,441
"43858","ENSG00000272825","21",44936303,44936954,651
"43859","ENSG00000272829","22",20981361,20981755,394
"43860","ENSG00000272831","7",66739829,66740385,556
"43861","ENSG00000272832","3",133543064,133543466,402
"43862","ENSG00000272834","22",40415003,40415445,442
"43863","ENSG00000272836","22",50205585,50206062,477
"43864","ENSG00000272837","12",55646195,55646663,468
"43865","ENSG00000272839","7",157868538,157869154,616
"43866","ENSG00000272840","3",125774714,125797953,23239
"43867","ENSG00000272841","6",160990318,160992342,2024
"43868","ENSG00000272842","9",19371386,19371945,559
"43869","ENSG00000272843","7",72924418,72925125,707
"43870","ENSG00000272844","3",112990447,112991153,706
"43871","ENSG00000272848","6",169426420,169452475,26055
"43872","ENSG00000272849","12",121797511,121801972,4461
"43873","ENSG00000272853","10",14877688,14878686,998
"43874","ENSG00000272854","7",107579557,107580057,500
"43875","ENSG00000272855","1",76636877,76637339,462
"43876","ENSG00000272856","4",87460807,87462280,1473
"43877","ENSG00000272858","22",28814914,28815662,748
"43878","ENSG00000272861","2",105249404,105249794,390
"43879","ENSG00000272862","4",41988741,41989237,496
"43880","ENSG00000272864","1",74698769,74699333,564
"43881","ENSG00000272865","1",242147230,242209129,61899
"43882","ENSG00000272866","9",5351796,5352410,614
"43883","ENSG00000272870","4",173349543,173370721,21178
"43884","ENSG00000272871","9",14588797,14590065,1268
"43885","ENSG00000272872","22",15823197,15823890,693
"43886","ENSG00000272874","20",267186,268857,1671
"43887","ENSG00000272880","1",181812705,181813261,556
"43888","ENSG00000272884","17",7439506,7445966,6460
"43889","ENSG00000272885","4",416118,416537,419
"43890","ENSG00000272886","3",53283429,53347586,64157
"43891","ENSG00000272888","15",92819540,92899701,80161
"43892","ENSG00000272892","10",67849525,67850746,1221
"43893","ENSG00000272894","7",7552462,7566996,14534
"43894","ENSG00000272895","2",117998745,117999480,735
"43895","ENSG00000272896","9",136791379,136800595,9216
"43896","ENSG00000272899","7",128866330,128872047,5717
"43897","ENSG00000272902","2",101151660,101155412,3752
"43898","ENSG00000272904","9",38542479,38568422,25943
"43899","ENSG00000272905","7",32845394,32846061,667
"43900","ENSG00000272906","1",179881607,179882595,988
"43901","ENSG00000272908","7",38326070,38329643,3573
"43902","ENSG00000272909","14",64440369,64442238,1869
"43903","ENSG00000272910","3",179583262,179583762,500
"43904","ENSG00000272911","17",2688473,2688960,487
"43905","ENSG00000272912","10",102914585,102915404,819
"43906","ENSG00000272913","2",95525109,95526702,1593
"43907","ENSG00000272914","10",30831828,30833387,1559
"43908","ENSG00000272915","7",128264526,128264889,363
"43909","ENSG00000272916","10",73796514,73811651,15137
"43910","ENSG00000272917","12",9642872,9657070,14198
"43911","ENSG00000272918","7",105102838,105105483,2645
"43912","ENSG00000272922","3",184742818,184743284,466
"43913","ENSG00000272927","4",661209,661945,736
"43914","ENSG00000272931","1",89820174,89820868,694
"43915","ENSG00000272933","10",102642792,102644140,1348
"43916","ENSG00000272940","22",50597152,50597599,447
"43917","ENSG00000272941","7",135168403,135169547,1144
"43918","ENSG00000272942","22",25434324,25435070,746
"43919","ENSG00000272944","2",221572506,221574454,1948
"43920","ENSG00000272945","20",34281632,34286466,4834
"43921","ENSG00000272948","21",37267784,37268497,713
"43922","ENSG00000272950","7",98322853,98323430,577
"43923","ENSG00000272953","7",5425770,5426401,631
"43924","ENSG00000272954","22",21661934,21662363,429
"43925","ENSG00000272958","21",34425508,34426017,509
"43926","ENSG00000272963","12",46592573,46593305,732
"43927","ENSG00000272966","2",202336739,202337200,461
"43928","ENSG00000272967","3",119579212,119579650,438
"43929","ENSG00000272968","7",4983718,5073221,89503
"43930","ENSG00000272969","4",55547112,55547889,777
"43931","ENSG00000272970","3",184712245,184780720,68475
"43932","ENSG00000272971","1",156614742,156615288,546
"43933","ENSG00000272973","22",23856427,23857039,612
"43934","ENSG00000272975","17",10383144,10623886,240742
"43935","ENSG00000272977","22",25476218,25479971,3753
"43936","ENSG00000272979","2",190454092,190454521,429
"43937","ENSG00000272980","6",166999405,167139141,139736
"43938","ENSG00000272983","10",38137337,38144399,7062
"43939","ENSG00000272984","7",36734004,36734535,531
"43940","ENSG00000272986","4",70703747,70704491,744
"43941","ENSG00000272988","10",72053294,72054037,743
"43942","ENSG00000272989","3",197505262,197506986,1724
"43943","ENSG00000272990","3",156523740,156524247,507
"43944","ENSG00000272994","2",105334027,105337475,3448
"43945","ENSG00000272995","4",20766808,20767372,564
"43946","ENSG00000273001","10",3065424,3066001,577
"43947","ENSG00000273002","1",155978799,155982986,4187
"43948","ENSG00000273003","11",65014182,65040570,26388
"43949","ENSG00000273004","1",185317779,185318530,751
"43950","ENSG00000273006","2",38193348,38193629,281
"43951","ENSG00000273007","4",122879778,122885805,6027
"43952","ENSG00000273008","10",43136824,43138334,1510
"43953","ENSG00000273010","1",110963302,110964649,1347
"43954","ENSG00000273011","7",149890739,149891416,677
"43955","ENSG00000273012","10",33341655,33341905,250
"43956","ENSG00000273013","3",196474801,196475394,593
"43957","ENSG00000273014","7",32758882,32759353,471
"43958","ENSG00000273015","12",45718046,45727775,9729
"43959","ENSG00000273017","21",29359002,29359453,451
"43960","ENSG00000273018","17",18511221,18551705,40484
"43961","ENSG00000273024","7",65647823,65718688,70865
"43962","ENSG00000273025","15",72266746,72319946,53200
"43963","ENSG00000273026","1",153966516,153966930,414
"43964","ENSG00000273027","21",44929653,44930112,459
"43965","ENSG00000273032","22",18970525,19031242,60717
"43966","ENSG00000273033","3",122886941,122892416,5475
"43967","ENSG00000273035","2",39323328,39323804,476
"43968","ENSG00000273036","9",38540567,38542792,2225
"43969","ENSG00000273038","10",32887255,32889311,2056
"43970","ENSG00000273041","X",154580926,154581998,1072
"43971","ENSG00000273044","22",35526932,35527415,483
"43972","ENSG00000273045","2",99141485,99151487,10002
"43973","ENSG00000273046","12",54017110,54035361,18251
"43974","ENSG00000273047","20",63738270,63740398,2128
"43975","ENSG00000273049","12",53985845,54034888,49043
"43976","ENSG00000273055","7",107942116,107942740,624
"43977","ENSG00000273056","9",7786105,7786688,583
"43978","ENSG00000273058","1",236536162,236536704,542
"43979","ENSG00000273059","1",148011799,148012228,429
"43980","ENSG00000273061","9",4676600,4679502,2902
"43981","ENSG00000273062","1",178724306,178726285,1979
"43982","ENSG00000273063","2",58241349,58241686,337
"43983","ENSG00000273064","2",68252870,68253848,978
"43984","ENSG00000273066","9",136799223,136810042,10819
"43985","ENSG00000273069","7",74606913,74607299,386
"43986","ENSG00000273073","2",131461821,131463615,1794
"43987","ENSG00000273076","22",38743495,38743910,415
"43988","ENSG00000273077","4",128552590,128553416,826
"43989","ENSG00000273079","12",13437942,13981957,544015
"43990","ENSG00000273080","2",86195590,86196049,459
"43991","ENSG00000273082","22",33922422,33922766,344
"43992","ENSG00000273084","7",5428731,5429672,941
"43993","ENSG00000273090","2",36513255,36513732,477
"43994","ENSG00000273091","21",31735732,31736407,675
"43995","ENSG00000273093","1",200315435,200315967,532
"43996","ENSG00000273096","22",38736610,38736792,182
"43997","ENSG00000273098","17",13095695,13100939,5244
"43998","ENSG00000273100","6",170178681,170179660,979
"43999","ENSG00000273102","21",33967101,33968573,1472
"44000","ENSG00000273104","21",34412200,34412587,387
"44001","ENSG00000273106","2",44167625,44168859,1234
"44002","ENSG00000273107","10",24953241,24953513,272
"44003","ENSG00000273108","10",103608619,103610050,1431
"44004","ENSG00000273111","19",41837074,41844697,7623
"44005","ENSG00000273112","1",161513176,161605099,91923
"44006","ENSG00000273113","2",241581922,241582726,804
"44007","ENSG00000273115","21",26459903,26460214,311
"44008","ENSG00000273117","7",155295918,155297541,1623
"44009","ENSG00000273118","2",212581357,213021545,440188
"44010","ENSG00000273119","18",11390033,11390729,696
"44011","ENSG00000273123","3",123715851,123716399,548
"44012","ENSG00000273124","10",90997480,90997713,233
"44013","ENSG00000273125","3",107430892,107463912,33020
"44014","ENSG00000273129","1",186680622,186681446,824
"44015","ENSG00000273132","6",149852462,149853192,730
"44016","ENSG00000273133","4",15563698,15564253,555
"44017","ENSG00000273136","1",120723949,120842110,118161
"44018","ENSG00000273137","22",50208461,50209542,1081
"44019","ENSG00000273138","7",95416108,95416462,354
"44020","ENSG00000273139","22",20320739,20321203,464
"44021","ENSG00000273142","7",66902857,66906297,3440
"44022","ENSG00000273143","10",110428840,110496590,67750
"44023","ENSG00000273145","22",46013606,46015498,1892
"44024","ENSG00000273148","20",18794529,18796067,1538
"44025","ENSG00000273151","7",879790,886547,6757
"44026","ENSG00000273153","10",17137336,17137585,249
"44027","ENSG00000273154","20",63708864,63739103,30239
"44028","ENSG00000273155","2",99154998,99195298,40300
"44029","ENSG00000273156","4",82344876,82346842,1966
"44030","ENSG00000273160","1",167457742,167459891,2149
"44031","ENSG00000273162","10",101060029,101061005,976
"44032","ENSG00000273164","22",19023056,19023550,494
"44033","ENSG00000273165","2",31852976,31853423,447
"44034","ENSG00000273167","13",23979700,24321031,341331
"44035","ENSG00000273171","17",28364288,28368012,3724
"44036","ENSG00000273172","17",183824,191587,7763
"44037","ENSG00000273173","15",24954986,24977850,22864
"44038","ENSG00000273174","3",129123439,129124003,564
"44039","ENSG00000273175","1",244864738,244865272,534
"44040","ENSG00000273176","22",35298838,35299541,703
"44041","ENSG00000273177","3",168928169,168928598,429
"44042","ENSG00000273179","4",1167778,1168174,396
"44043","ENSG00000273180","4",183075480,183076033,553
"44044","ENSG00000273181","3",184132942,184133561,619
"44045","ENSG00000273183","7",154956429,154957107,678
"44046","ENSG00000273184","7",128455840,128493859,38019
"44047","ENSG00000273186","9",128431598,128432006,408
"44048","ENSG00000273188","22",50191724,50192402,678
"44049","ENSG00000273189","19",49474586,49487637,13051
"44050","ENSG00000273192","22",49902228,49904576,2348
"44051","ENSG00000273196","2",85387074,85387146,72
"44052","ENSG00000273198","1",186521773,186522304,531
"44053","ENSG00000273199","21",36319792,36320670,878
"44054","ENSG00000273203","22",17067821,17070675,2854
"44055","ENSG00000273209","2",202032770,202033537,767
"44056","ENSG00000273210","21",37365477,37365932,455
"44057","ENSG00000273212","22",19456503,19456962,459
"44058","ENSG00000273213","1",143894544,143905966,11422
"44059","ENSG00000273214","22",38043230,38043920,690
"44060","ENSG00000273216","22",29316744,29317220,476
"44061","ENSG00000273218","19",15346068,15348417,2349
"44062","ENSG00000273225","10",46369113,46373563,4450
"44063","ENSG00000273226","9",19375451,19375996,545
"44064","ENSG00000273228","11",57029408,57029722,314
"44065","ENSG00000273230","7",1464497,1467522,3025
"44066","ENSG00000273232","18",22882825,22883357,532
"44067","ENSG00000273233","2",28810281,28810706,425
"44068","ENSG00000273234","7",144142009,144142938,929
"44069","ENSG00000273238","4",573880,576300,2420
"44070","ENSG00000273240","2",189763859,189764456,597
"44071","ENSG00000273243","22",45155539,45156011,472
"44072","ENSG00000273245","2",73750256,73750786,530
"44073","ENSG00000273247","4",139411927,139454034,42107
"44074","ENSG00000273248","10",75408973,75409326,353
"44075","ENSG00000273249","9",134132242,134135772,3530
"44076","ENSG00000273252","7",6835420,6835794,374
"44077","ENSG00000273253","22",50199090,50200837,1747
"44078","ENSG00000273254","21",29024255,29024890,635
"44079","ENSG00000273257","4",55387949,55388271,322
"44080","ENSG00000273258","2",174011856,174012975,1119
"44081","ENSG00000273259","14",94592058,94624646,32588
"44082","ENSG00000273261","3",182921240,182921938,698
"44083","ENSG00000273264","1",85467295,85467660,365
"44084","ENSG00000273265","2",96812239,96813657,1418
"44085","ENSG00000273267","4",8022665,8023126,461
"44086","ENSG00000273269","2",47065941,47176511,110570
"44087","ENSG00000273270","7",128524016,128531069,7053
"44088","ENSG00000273271","21",31666728,31667247,519
"44089","ENSG00000273272","22",50541108,50543011,1903
"44090","ENSG00000273274","1",32465072,32496686,31614
"44091","ENSG00000273284","18",9259388,9260390,1002
"44092","ENSG00000273287","22",45262273,45263585,1312
"44093","ENSG00000273289","22",46053093,46053560,467
"44094","ENSG00000273291","3",42809446,43055871,246425
"44095","ENSG00000273293","7",149881359,149881580,221
"44096","ENSG00000273294","5",33987174,34124528,137354
"44097","ENSG00000273295","22",23901432,23907068,5636
"44098","ENSG00000273297","7",134368737,134432534,63797
"44099","ENSG00000273301","2",225698514,225703654,5140
"44100","ENSG00000273302","2",61199979,61200769,790
"44101","ENSG00000273305","2",95537969,95538469,500
"44102","ENSG00000273306","2",99405218,99405843,625
"44103","ENSG00000273308","3",197645669,197646017,348
"44104","ENSG00000273311","22",19046162,19048375,2213
"44105","ENSG00000273312","10",35604485,35608153,3668
"44106","ENSG00000273313","7",5072125,5073223,1098
"44107","ENSG00000273314","7",148696467,148698664,2197
"44108","ENSG00000273319","7",130936464,130939661,3197
"44109","ENSG00000273320","7",106285480,106286326,846
"44110","ENSG00000273321","18",24402153,24402714,561
"44111","ENSG00000273325","22",32284683,32285131,448
"44112","ENSG00000273327","10",133430394,133431318,924
"44113","ENSG00000273328","3",42809414,42908105,98691
"44114","ENSG00000273329","7",129604548,129611630,7082
"44115","ENSG00000273331","3",196316082,196338373,22291
"44116","ENSG00000273333","6",32184733,32185882,1149
"44117","ENSG00000273335","18",9473421,9474006,585
"44118","ENSG00000273336","10",133481238,133481770,532
"44119","ENSG00000273338","1",78004346,78004554,208
"44120","ENSG00000273340","6",29741731,29748969,7238
"44121","ENSG00000273341","7",77416673,77425444,8771
"44122","ENSG00000273342","22",21640844,21641284,440
"44123","ENSG00000273343","22",20318119,20318749,630
"44124","ENSG00000273344","7",155003448,155005703,2255
"44125","ENSG00000273345","5",134205614,134371044,165430
"44126","ENSG00000273348","18",22347846,22348252,406
"44127","ENSG00000273350","22",30420512,30420912,400
"44128","ENSG00000273353","22",45178990,45179310,320
"44129","ENSG00000273355","18",813274,813756,482
"44130","ENSG00000273356","3",50669989,50672048,2059
"44131","ENSG00000273360","10",66079243,66118326,39083
"44132","ENSG00000273361","2",218398743,218399219,476
"44133","ENSG00000273362","22",16521059,16527237,6178
"44134","ENSG00000273363","10",44958917,44959458,541
"44135","ENSG00000273365","1",165706556,165707284,728
"44136","ENSG00000273367","1",234372186,234372811,625
"44137","ENSG00000273368","18",8154558,8155070,512
"44138","ENSG00000273369","4",44693946,44694386,440
"44139","ENSG00000273372","10",79968213,79973213,5000
"44140","ENSG00000273373","1",110370154,110373003,2849
"44141","ENSG00000273374","3",99802699,99806058,3359
"44142","ENSG00000273375","3",197789700,197790369,669
"44143","ENSG00000273381","9",91206175,91210299,4124
"44144","ENSG00000273382","1",109087971,109090858,2887
"44145","ENSG00000273384","1",178651706,178652282,576
"44146","ENSG00000273387","22",31082156,31083565,1409
"44147","ENSG00000273388","17",10291820,10317926,26106
"44148","ENSG00000273391","7",139359032,139359566,534
"44149","ENSG00000273394","3",113947005,113947570,565
"44150","ENSG00000273396","4",4844188,4850827,6639
"44151","ENSG00000273398","2",68131238,68261230,129992
"44152","ENSG00000273399","9",14586766,14587326,560
"44153","ENSG00000273402","8",237045,237669,624
"44154","ENSG00000273403","3",184741937,184742462,525
"44155","ENSG00000273406","1",120076616,120077091,475
"44156","ENSG00000273407","7",99766543,99766892,349
"44157","ENSG00000273409","11",127271029,127337033,66004
"44158","ENSG00000273415","11",128095758,128183671,87913
"44159","ENSG00000273416","1",235104180,235104609,429
"44160","ENSG00000273419","7",149858400,149862492,4092
"44161","ENSG00000273423","9",104629754,104631017,1263
"44162","ENSG00000273424","22",41430934,41431375,441
"44163","ENSG00000273428","22",30435544,30436247,703
"44164","ENSG00000273432","7",43951910,44019151,67241
"44165","ENSG00000273433","7",27128969,27152561,23592
"44166","ENSG00000273434","12",48417150,48417337,187
"44167","ENSG00000273437","3",129163606,129163940,334
"44168","ENSG00000273442","22",17080701,17081456,755
"44169","ENSG00000273443","1",1062208,1063288,1080
"44170","ENSG00000273444","7",40107288,40107454,166
"44171","ENSG00000273445","2",87477495,87478034,539
"44172","ENSG00000273447","4",109692004,109692703,699
"44173","ENSG00000273448","7",67333047,67334383,1336
"44174","ENSG00000273449","4",163529771,163530697,926
"44175","ENSG00000273450","10",94314907,94315327,420
"44176","ENSG00000273451","20",47348137,47349142,1005
"44177","ENSG00000273454","3",123277353,123277904,551
"44178","ENSG00000273455","3",136087475,136087913,438
"44179","ENSG00000273456","2",202374932,202375604,672
"44180","ENSG00000273461","3",72061061,72069933,8872
"44181","ENSG00000273464","21",29657406,29657831,425
"44182","ENSG00000273466","2",218633256,218634014,758
"44183","ENSG00000273471","2",110386411,110433673,47262
"44184","ENSG00000273472","4",140756528,140757921,1393
"44185","ENSG00000273473","9",134168769,134169340,571
"44186","ENSG00000273474","10",13675646,13675990,344
"44187","ENSG00000273476","10",100967688,100968135,447
"44188","ENSG00000273481","1",151327949,151328429,480
"44189","ENSG00000273483","1",112517799,112518441,642
"44190","ENSG00000273484","8",21797460,21797759,299
"44191","ENSG00000273485","10",103450196,103450852,656
"44192","ENSG00000273486","3",136837338,136839021,1683
"44193","ENSG00000273487","1",92189237,92190707,1470
"44194","ENSG00000273489","7",131493964,131497694,3730
"44195","ENSG00000273492","21",26170871,26217381,46510
"44196","ENSG00000273493","3",58329965,58330118,153
"44197","ENSG00000273500","17",49288346,49288454,108
"44198","ENSG00000273507","13",39053019,39223238,170219
"44199","ENSG00000273509","9",62924911,62934964,10053
"44200","ENSG00000273512","15",78749833,78750107,274
"44201","ENSG00000273514","9",41126430,41128463,2033
"44202","ENSG00000273516","1",121008362,121008507,145
"44203","ENSG00000273521","10",131980240,131981337,1097
"44204","ENSG00000273523","13",52128891,52132723,3832
"44205","ENSG00000273524","18",24179038,24179295,257
"44206","ENSG00000273540","15",86079973,87029052,949079
"44207","ENSG00000273542","6",27831216,27831527,311
"44208","ENSG00000273549","5",179629151,179629410,259
"44209","ENSG00000273550","13",63034668,63097797,63129
"44210","ENSG00000273551","16",1148224,1148754,530
"44211","ENSG00000273552","13",27667395,27680581,13186
"44212","ENSG00000273553","16",27687182,27687522,340
"44213","ENSG00000273554","KI270728.1",1139577,1147868,8291
"44214","ENSG00000273555","20",45425510,45425573,63
"44215","ENSG00000273557","5",141468465,141471528,3063
"44216","ENSG00000273558","14",19637225,19641306,4081
"44217","ENSG00000273559","17",38800441,38825355,24914
"44218","ENSG00000273565","14",75176929,75177418,489
"44219","ENSG00000273566","10",21455236,21455515,279
"44220","ENSG00000273568","12",131934642,131934928,286
"44221","ENSG00000273570","12",97495932,97496057,125
"44222","ENSG00000273573","1",181668749,181669028,279
"44223","ENSG00000273576","17",39566915,39567559,644
"44224","ENSG00000273580","7",35933888,35934569,681
"44225","ENSG00000273582","16",29225594,29226348,754
"44226","ENSG00000273584","18",68908048,68908599,551
"44227","ENSG00000273590","21",7744962,7777853,32891
"44228","ENSG00000273595","2",106207394,106208115,721
"44229","ENSG00000273597","9",35001342,35002994,1652
"44230","ENSG00000273598","7",75316048,75327765,11717
"44231","ENSG00000273599","10",124996064,125001491,5427
"44232","ENSG00000273600","11",95756959,95757442,483
"44233","ENSG00000273604","17",38671703,38675421,3718
"44234","ENSG00000273606","17",2692861,2692919,58
"44235","ENSG00000273610","1",21987481,21987777,296
"44236","ENSG00000273611","17",36486629,36499310,12681
"44237","ENSG00000273618","14",23530682,23532367,1685
"44238","ENSG00000273619","20",62386303,62386970,667
"44239","ENSG00000273627","17",38719691,38719748,57
"44240","ENSG00000273628","13",24933006,24936796,3790
"44241","ENSG00000273629","1",176217541,176217602,61
"44242","ENSG00000273637","1",38839333,38874494,35161
"44243","ENSG00000273639","14",19499737,19677923,178186
"44244","ENSG00000273644","7",37032,37477,445
"44245","ENSG00000273650","17",42751289,42751717,428
"44246","ENSG00000273654","19",18022403,18032099,9696
"44247","ENSG00000273657","19",7617439,7617505,66
"44248","ENSG00000273659","16",76582556,76583098,542
"44249","ENSG00000273664","18",59700523,59700946,423
"44250","ENSG00000273669","18",75073543,75074205,662
"44251","ENSG00000273674","15",50839875,50908603,68728
"44252","ENSG00000273675","14",50471769,50472592,823
"44253","ENSG00000273677","11",32436311,32436447,136
"44254","ENSG00000273679","15",22371736,22373570,1834
"44255","ENSG00000273680","12",29332733,29333383,650
"44256","ENSG00000273682","3",46918807,46918935,128
"44257","ENSG00000273687","17",35018660,35018991,331
"44258","ENSG00000273691","15",90024955,90026003,1048
"44259","ENSG00000273693","Y",11085476,11086061,585
"44260","ENSG00000273694","1",120571120,120571264,144
"44261","ENSG00000273702","17",59618553,59619714,1161
"44262","ENSG00000273703","6",27815044,27815424,380
"44263","ENSG00000273706","17",36936785,36944612,7827
"44264","ENSG00000273710","8",28915579,28915864,285
"44265","ENSG00000273712","6",28315613,28315883,270
"44266","ENSG00000273720","7",55743073,55743457,384
"44267","ENSG00000273721","15",60409234,60409420,186
"44268","ENSG00000273723","13",52651305,52652279,974
"44269","ENSG00000273724","16",30336400,30343336,6936
"44270","ENSG00000273725","11",9279532,9279816,284
"44271","ENSG00000273727","1",120354987,120355148,161
"44272","ENSG00000273729","14",77028086,77031572,3486
"44273","ENSG00000273733","19",11221083,11221573,490
"44274","ENSG00000273734","19",2269525,2341172,71647
"44275","ENSG00000273736","17",35963488,35965472,1984
"44276","ENSG00000273744","6",106271634,106271720,86
"44277","ENSG00000273745","20",10649636,10649695,59
"44278","ENSG00000273747","15",83020115,83020802,687
"44279","ENSG00000273748","GL000219.1",54224,83311,29087
"44280","ENSG00000273749","15",22867052,22981063,114011
"44281","ENSG00000273759","20",62928621,62929297,676
"44282","ENSG00000273760","10",47970043,47973496,3453
"44283","ENSG00000273763","2",65203502,65227605,24103
"44284","ENSG00000273765","12",48360920,48361377,457
"44285","ENSG00000273767","10",121949412,121949487,75
"44286","ENSG00000273768","1",146376807,146376970,163
"44287","ENSG00000273769","X",153880672,153888990,8318
"44288","ENSG00000273771","15",96080713,96084584,3871
"44289","ENSG00000273773","X",154620096,154620171,75
"44290","ENSG00000273777","19",44501677,44529788,28111
"44291","ENSG00000273783","14",81221218,81222460,1242
"44292","ENSG00000273784","13",52600042,52642542,42500
"44293","ENSG00000273786","15",40226386,40227069,683
"44294","ENSG00000273791","19",19908268,19909146,878
"44295","ENSG00000273792","15",60847757,60849068,1311
"44296","ENSG00000273796","21",45403809,45404369,560
"44297","ENSG00000273797","14",69617122,69617648,526
"44298","ENSG00000273802","6",26215159,26216692,1533
"44299","ENSG00000273805","12",57894232,57896846,2614
"44300","ENSG00000273806","9",83201957,83202065,108
"44301","ENSG00000273812","20",62596732,62603355,6623
"44302","ENSG00000273816","17",9244666,9244897,231
"44303","ENSG00000273818","15",30091662,30091898,236
"44304","ENSG00000273819","11",67812557,67873367,60810
"44305","ENSG00000273820","X",49879948,49882565,2617
"44306","ENSG00000273821","20",63218041,63218502,461
"44307","ENSG00000273824","12",68426331,68427737,1406
"44308","ENSG00000273825","1",144754572,144786606,32034
"44309","ENSG00000273828","20",46364551,46397994,33443
"44310","ENSG00000273829","16",50054143,50054430,287
"44311","ENSG00000273837","19",51639478,51639931,453
"44312","ENSG00000273838","20",23452623,23461207,8584
"44313","ENSG00000273841","5",69364743,69370013,5270
"44314","ENSG00000273843","KI270728.1",137798,139135,1337
"44315","ENSG00000273851","15",69022230,69024176,1946
"44316","ENSG00000273853","12",33432311,33432853,542
"44317","ENSG00000273855","15",40285468,40285909,441
"44318","ENSG00000273866","22",37578669,37578922,253
"44319","ENSG00000273870","6",35070871,35071049,178
"44320","ENSG00000273872","21",10612455,10613379,924
"44321","ENSG00000273876","8",5127919,5128233,314
"44322","ENSG00000273877","X",153225649,153230357,4708
"44323","ENSG00000273882","4",101240795,101240872,77
"44324","ENSG00000273885","11",93721797,93721866,69
"44325","ENSG00000273886","13",34910545,34910815,270
"44326","ENSG00000273888","14",51649516,51651744,2228
"44327","ENSG00000273890","12",56010091,56010574,483
"44328","ENSG00000273891","10",121965764,121967700,1936
"44329","ENSG00000273893","20",46681676,46682375,699
"44330","ENSG00000273894","14",106179554,106180519,965
"44331","ENSG00000273897","7",73037371,73049246,11875
"44332","ENSG00000273899","22",37681673,37693476,11803
"44333","ENSG00000273901","19",58500505,58501137,632
"44334","ENSG00000273904","10",114168156,114168280,124
"44335","ENSG00000273906","Y",6918682,6920791,2109
"44336","ENSG00000273912","11",28477481,28477548,67
"44337","ENSG00000273913","2",42511570,42511851,281
"44338","ENSG00000273919","13",53345211,53410880,65669
"44339","ENSG00000273920","15",81335577,81336119,542
"44340","ENSG00000273923","15",95225326,95225864,538
"44341","ENSG00000273925","15",48662531,48663056,525
"44342","ENSG00000273932","9",133051996,133052059,63
"44343","ENSG00000273933","1",159972548,159974064,1516
"44344","ENSG00000273946","10",87154041,87154369,328
"44345","ENSG00000273950","2",127856890,127857147,257
"44346","ENSG00000273951","20",41485571,41486225,654
"44347","ENSG00000273956","16",21526824,21531141,4317
"44348","ENSG00000273957","5",100388853,100389938,1085
"44349","ENSG00000273958","15",60593027,60593460,433
"44350","ENSG00000273962","2",89330110,89330429,319
"44351","ENSG00000273963","16",5110793,5148685,37892
"44352","ENSG00000273965","17",37407936,37408594,658
"44353","ENSG00000273971","16",75497948,75498289,341
"44354","ENSG00000273972","15",45702640,45703183,543
"44355","ENSG00000273973","12",55929170,55929729,559
"44356","ENSG00000273974","X",74280402,74280495,93
"44357","ENSG00000273975","2",201097744,201098091,347
"44358","ENSG00000273976","15",23128268,23136822,8554
"44359","ENSG00000273979","22",40917111,40917381,270
"44360","ENSG00000273980","10",133257144,133257551,407
"44361","ENSG00000273982","17",61354763,61355155,392
"44362","ENSG00000273983","6",26269405,26271815,2410
"44363","ENSG00000273986","20",36561237,36561530,293
"44364","ENSG00000273987","12",75333798,75334486,688
"44365","ENSG00000273989","12",28236227,28236828,601
"44366","ENSG00000273997","6",147406531,147406824,293
"44367","ENSG00000273998","20",16576068,16579615,3547
"44368","ENSG00000273999","9",67211663,67213067,1404
"44369","ENSG00000274001","13",43877715,43878163,448
"44370","ENSG00000274002","14",23619201,23620012,811
"44371","ENSG00000274004","11",83386988,83387102,114
"44372","ENSG00000274008","10",69098496,69098794,298
"44373","ENSG00000274010","2",127840606,127841763,1157
"44374","ENSG00000274011","9",98115885,98116135,250
"44375","ENSG00000274012","14",49862550,49862849,299
"44376","ENSG00000274015","14",63642035,63665593,23558
"44377","ENSG00000274017","12",49196784,49197062,278
"44378","ENSG00000274019","1",149111304,149121866,10562
"44379","ENSG00000274020","1",148290889,148519604,228715
"44380","ENSG00000274021","12",89351015,89353271,2256
"44381","ENSG00000274023","6",158282841,158428379,145538
"44382","ENSG00000274024","X",135297046,135298585,1539
"44383","ENSG00000274026","9",67717411,67719178,1767
"44384","ENSG00000274028","2",95588149,95589253,1104
"44385","ENSG00000274029","12",121190868,121191518,650
"44386","ENSG00000274031","16",56465642,56466162,520
"44387","ENSG00000274034","20",64076955,64077010,55
"44388","ENSG00000274038","16",11056556,11057034,478
"44389","ENSG00000274044","22",18361820,18391105,29285
"44390","ENSG00000274049","2",74455088,74460884,5796
"44391","ENSG00000274051","17",76721216,76721396,180
"44392","ENSG00000274052","13",63737511,63742804,5293
"44393","ENSG00000274064","8",140039756,140041037,1281
"44394","ENSG00000274066","11",62792702,62792771,69
"44395","ENSG00000274067","9",40481559,40497591,16032
"44396","ENSG00000274070","7",74964818,75024798,59980
"44397","ENSG00000274075","12",27824207,27824382,175
"44398","ENSG00000274079","15",96496180,96496462,282
"44399","ENSG00000274080","7",73609262,73611502,2240
"44400","ENSG00000274092","16",27313387,27314101,714
"44401","ENSG00000274093","16",69632141,69632571,430
"44402","ENSG00000274097","11",102057854,102057960,106
"44403","ENSG00000274099","15",23179869,23182049,2180
"44404","ENSG00000274104","19",34733298,34733837,539
"44405","ENSG00000274105","12",32728169,32729024,855
"44406","ENSG00000274111","17",17813480,17813545,65
"44407","ENSG00000274114","17",6657034,6693577,36543
"44408","ENSG00000274115","9",95065350,95065446,96
"44409","ENSG00000274116","8",83293925,83294271,346
"44410","ENSG00000274118","7",146311720,146311822,102
"44411","ENSG00000274121","1",231814982,231815186,204
"44412","ENSG00000274124","12",48152817,48153128,311
"44413","ENSG00000274128","15",83962176,83962583,407
"44414","ENSG00000274134","16",85918347,85918416,69
"44415","ENSG00000274135","7",66915063,66915334,271
"44416","ENSG00000274139","15",101495052,101495567,515
"44417","ENSG00000274150","11",56890613,56927885,37272
"44418","ENSG00000274156","12",50934942,50935464,522
"44419","ENSG00000274159","2",32548675,32549040,365
"44420","ENSG00000274162","Y",11178306,11178816,510
"44421","ENSG00000274167","10",42242721,42276842,34121
"44422","ENSG00000274168","13",94699223,94699502,279
"44423","ENSG00000274172","14",105621116,105621180,64
"44424","ENSG00000274173","20",24931840,24932983,1143
"44425","ENSG00000274180","17",21238870,21253410,14540
"44426","ENSG00000274183","X",154884972,154885558,586
"44427","ENSG00000274184","18",35268218,35270238,2020
"44428","ENSG00000274191","12",122634130,122634673,543
"44429","ENSG00000274197","11",130114251,130114335,84
"44430","ENSG00000274198","17",58747055,58747340,285
"44431","ENSG00000274204","13",106506046,106506713,667
"44432","ENSG00000274206","2",96938923,96939203,280
"44433","ENSG00000274209","10",46286345,46330207,43862
"44434","ENSG00000274210","1",148522601,148522765,164
"44435","ENSG00000274211","17",38351844,38405593,53749
"44436","ENSG00000274213","17",56914186,56914533,347
"44437","ENSG00000274214","18",14253548,14254075,527
"44438","ENSG00000274215","15",92808451,92809057,606
"44439","ENSG00000274216","15",37216617,37216898,281
"44440","ENSG00000274219","19",57111120,57112027,907
"44441","ENSG00000274220","16",75433836,75436392,2556
"44442","ENSG00000274225","21",44477850,44478493,643
"44443","ENSG00000274227","12",112018804,112019430,626
"44444","ENSG00000274230","12",97493178,97493286,108
"44445","ENSG00000274235","5",150950109,150952460,2351
"44446","ENSG00000274238","4",89743792,89744305,513
"44447","ENSG00000274244","17",37649133,37650894,1761
"44448","ENSG00000274248","21",45974489,45974953,464
"44449","ENSG00000274251","11",67353629,67354348,719
"44450","ENSG00000274252","22",18516344,18518161,1817
"44451","ENSG00000274253","15",22757841,22778741,20900
"44452","ENSG00000274256","6",41250851,41251097,246
"44453","ENSG00000274258","1",8866502,8866590,88
"44454","ENSG00000274259","6",33437363,33454453,17090
"44455","ENSG00000274261","20",48406777,48410716,3939
"44456","ENSG00000274265","1",149175748,149259987,84239
"44457","ENSG00000274269","20",1186092,1207036,20944
"44458","ENSG00000274270","13",50125816,50128463,2647
"44459","ENSG00000274272","7",100572232,100578700,6468
"44460","ENSG00000274274","X",49331616,49338952,7336
"44461","ENSG00000274275","18",32031035,32031359,324
"44462","ENSG00000274276","21",6444869,6468040,23171
"44463","ENSG00000274281","15",38851306,38853432,2126
"44464","ENSG00000274286","2",96112876,96116571,3695
"44465","ENSG00000274290","6",26172059,26184655,12596
"44466","ENSG00000274292","12",121800797,121803403,2606
"44467","ENSG00000274294","15",99416584,99417204,620
"44468","ENSG00000274295","8",53394215,53394795,580
"44469","ENSG00000274297","15",70758269,70758856,587
"44470","ENSG00000274299","7",57270839,57275197,4358
"44471","ENSG00000274300","17",4969702,4969771,69
"44472","ENSG00000274303","11",120365666,120365963,297
"44473","ENSG00000274307","15",25708470,25710869,2399
"44474","ENSG00000274308","17",37140611,37141424,813
"44475","ENSG00000274310","8",54467208,54470609,3401
"44476","ENSG00000274312","15",98319687,98320237,550
"44477","ENSG00000274315","12",29331434,29331936,502
"44478","ENSG00000274317","13",37934298,38066444,132146
"44479","ENSG00000274319","7",6365441,6365770,329
"44480","ENSG00000274321","1",88520000,88520170,170
"44481","ENSG00000274322","20",1317571,1393096,75525
"44482","ENSG00000274326","9",76779657,76779917,260
"44483","ENSG00000274328","7",35847038,35847426,388
"44484","ENSG00000274330","14",70230224,70232426,2202
"44485","ENSG00000274331","13",109984858,109986565,1707
"44486","ENSG00000274333","21",5553637,5614880,61243
"44487","ENSG00000274340","15",62387327,62388875,1548
"44488","ENSG00000274341","17",32408013,32408309,296
"44489","ENSG00000274342","22",27994474,27994654,180
"44490","ENSG00000274346","2",238454908,238457520,2612
"44491","ENSG00000274347","15",19955300,19955602,302
"44492","ENSG00000274349","9",66856426,66932141,75715
"44493","ENSG00000274351","13",49232874,49234399,1525
"44494","ENSG00000274353","2",131821987,131822920,933
"44495","ENSG00000274354","18",58511598,58512310,712
"44496","ENSG00000274355","9",66976520,66976991,471
"44497","ENSG00000274356","9",136728953,136729855,902
"44498","ENSG00000274363","17",4267691,4268430,739
"44499","ENSG00000274364","20",31535263,31535626,363
"44500","ENSG00000274367","16",2981175,2981591,416
"44501","ENSG00000274370","17",83098377,83098987,610
"44502","ENSG00000274372","1",148013203,148025934,12731
"44503","ENSG00000274373","12",132424504,132425208,704
"44504","ENSG00000274376","15",82298553,82334609,36056
"44505","ENSG00000274379","14",94918253,94918734,481
"44506","ENSG00000274380","19",52222020,52222098,78
"44507","ENSG00000274383","15",64950916,64951435,519
"44508","ENSG00000274386","1",42785007,42816619,31612
"44509","ENSG00000274387","3",71567863,71571112,3249
"44510","ENSG00000274391","21",10521553,10606140,84587
"44511","ENSG00000274397","14",70556206,70557478,1272
"44512","ENSG00000274400","18",35144942,35145417,475
"44513","ENSG00000274403","15",42726583,42727211,628
"44514","ENSG00000274414","20",25239007,25245229,6222
"44515","ENSG00000274419","17",38003976,38014902,10926
"44516","ENSG00000274420","3",47818005,47818128,123
"44517","ENSG00000274421","9",70310875,70312120,1245
"44518","ENSG00000274422","22",22283928,22287220,3292
"44519","ENSG00000274423","1",149345661,149357612,11951
"44520","ENSG00000274425","19",10333436,10336248,2812
"44521","ENSG00000274427","12",123515275,123515513,238
"44522","ENSG00000274428","1",146409903,146410062,159
"44523","ENSG00000274432","17",43245674,43245864,190
"44524","ENSG00000274441","5",36636019,36649347,13328
"44525","ENSG00000274443","8",73241329,73259502,18173
"44526","ENSG00000274444","15",37109587,37109984,397
"44527","ENSG00000274447","19",5294247,5294696,449
"44528","ENSG00000274451","6",155004835,155005318,483
"44529","ENSG00000274455","5",100062275,100067954,5679
"44530","ENSG00000274459","12",68575858,68576136,278
"44531","ENSG00000274460","16",21950218,21951708,1490
"44532","ENSG00000274461","10",120608580,120825317,216737
"44533","ENSG00000274466","16",24203116,24203231,115
"44534","ENSG00000274468","1",115479428,115481572,2144
"44535","ENSG00000274469","20",37571103,37591493,20390
"44536","ENSG00000274471","15",23309607,23314566,4959
"44537","ENSG00000274472","5",154705626,154705727,101
"44538","ENSG00000274475","14",21429508,21429806,298
"44539","ENSG00000274478","16",86698118,86698841,723
"44540","ENSG00000274486","11",95030549,95031245,696
"44541","ENSG00000274487","17",38195703,38257192,61489
"44542","ENSG00000274492","14",88819608,88822151,2543
"44543","ENSG00000274493","6",127909833,127910052,219
"44544","ENSG00000274494","6",31633787,31633858,71
"44545","ENSG00000274499","15",20803505,20826173,22668
"44546","ENSG00000274501","20",63730072,63730377,305
"44547","ENSG00000274505","16",11753666,11753948,282
"44548","ENSG00000274507","20",25251008,25251304,296
"44549","ENSG00000274508","16",55425574,55426130,556
"44550","ENSG00000274510","9",125417305,125417586,281
"44551","ENSG00000274512","17",37977972,37989048,11076
"44552","ENSG00000274514","3",12576961,12577237,276
"44553","ENSG00000274515","15",75645020,75645442,422
"44554","ENSG00000274516","9",60929774,60936746,6972
"44555","ENSG00000274520","2",44932320,44932406,86
"44556","ENSG00000274523","7",75027122,75074228,47106
"44557","ENSG00000274528","15",52017167,52018032,865
"44558","ENSG00000274529","17",28364268,28365244,976
"44559","ENSG00000274535","4",158909373,158909450,77
"44560","ENSG00000274536","X",66015461,66020422,4961
"44561","ENSG00000274541","6",11015586,11015888,302
"44562","ENSG00000274551","12",11516425,11521686,5261
"44563","ENSG00000274552","22",41252992,41253050,58
"44564","ENSG00000274554","12",116948738,116951422,2684
"44565","ENSG00000274560","12",101696002,101696450,448
"44566","ENSG00000274561","17",68131462,68131907,445
"44567","ENSG00000274565","17",62626437,62627590,1153
"44568","ENSG00000274569","12",56413647,56414045,398
"44569","ENSG00000274570","7",73104201,73111140,6939
"44570","ENSG00000274576","14",106770577,106771020,443
"44571","ENSG00000274578","18",28146233,28146703,470
"44572","ENSG00000274583","9",61205258,61212373,7115
"44573","ENSG00000274588","X",50365409,50470825,105416
"44574","ENSG00000274589","11",18538885,18539189,304
"44575","ENSG00000274591","12",46239106,46239473,367
"44576","ENSG00000274594","6",138464099,138464383,284
"44577","ENSG00000274598","12",108833721,108834384,663
"44578","ENSG00000274602","22",18533646,18577968,44322
"44579","ENSG00000274603","6",99526097,99526205,108
"44580","ENSG00000274605","13",100053074,100088950,35876
"44581","ENSG00000274607","17",38755279,38755400,121
"44582","ENSG00000274612","19",20087013,20087576,563
"44583","ENSG00000274614","13",111182111,111182692,581
"44584","ENSG00000274615","17",38078262,38124770,46508
"44585","ENSG00000274618","6",26240426,26240737,311
"44586","ENSG00000274620","17",37614931,37615039,108
"44587","ENSG00000274621","17",40193597,40193663,66
"44588","ENSG00000274624","12",22104491,22105320,829
"44589","ENSG00000274628","9",66047084,66055006,7922
"44590","ENSG00000274629","2",224464682,224474500,9818
"44591","ENSG00000274632","15",28703554,28703790,236
"44592","ENSG00000274641","6",27893463,27893843,380
"44593","ENSG00000274642","1",120197085,120319680,122595
"44594","ENSG00000274653","16",30359825,30360336,511
"44595","ENSG00000274654","15",48528980,48529728,748
"44596","ENSG00000274656","7",72841437,72841727,290
"44597","ENSG00000274658","17",36450146,36457535,7389
"44598","ENSG00000274659","12",2740064,2746662,6598
"44599","ENSG00000274660","10",100666695,100667009,314
"44600","ENSG00000274664","11",72562044,72562554,510
"44601","ENSG00000274666","14",68113706,68114144,438
"44602","ENSG00000274667","15",56729932,56730611,679
"44603","ENSG00000274670","12",132083540,132083779,239
"44604","ENSG00000274677","16",84085979,84086590,611
"44605","ENSG00000274678","16",30821338,30821884,546
"44606","ENSG00000274680","9",41292887,41294125,1238
"44607","ENSG00000274682","12",40978744,40979244,500
"44608","ENSG00000274685","10",133374736,133374869,133
"44609","ENSG00000274686","10",77966173,77966440,267
"44610","ENSG00000274688","9",41700480,41700696,216
"44611","ENSG00000274691","10",95173085,95173187,102
"44612","ENSG00000274693","4",3069977,3070151,174
"44613","ENSG00000274695","12",128826836,128827579,743
"44614","ENSG00000274697","12",111799834,111799905,71
"44615","ENSG00000274698","16",68450283,68452318,2035
"44616","ENSG00000274704","14",49913493,49913760,267
"44617","ENSG00000274705","8",41660441,41660508,67
"44618","ENSG00000274711","2",130517049,130517312,263
"44619","ENSG00000274712","17",68205489,68207493,2004
"44620","ENSG00000274713","19",11495544,11495622,78
"44621","ENSG00000274717","22",42791814,42794313,2499
"44622","ENSG00000274718","13",107870383,107873372,2989
"44623","ENSG00000274719","15",57990217,57990636,419
"44624","ENSG00000274723","12",46970504,46972155,1651
"44625","ENSG00000274727","20",64327418,64327972,554
"44626","ENSG00000274736","17",36013056,36017972,4916
"44627","ENSG00000274737","12",47817451,47817966,515
"44628","ENSG00000274740","11",2871437,2871498,61
"44629","ENSG00000274742","10",101912998,101913279,281
"44630","ENSG00000274748","17",21678086,21678418,332
"44631","ENSG00000274749","21",30829039,30829759,720
"44632","ENSG00000274750","6",26224199,26227473,3274
"44633","ENSG00000274751","16",1305547,1309413,3866
"44634","ENSG00000274752","7",142560423,142560931,508
"44635","ENSG00000274756","17",36574462,36575325,863
"44636","ENSG00000274759","4",67439992,67440118,126
"44637","ENSG00000274765","15",55343141,55343575,434
"44638","ENSG00000274766","13",113883667,113887149,3482
"44639","ENSG00000274767","17",36183235,36196471,13236
"44640","ENSG00000274769","2",61115787,61164825,49038
"44641","ENSG00000274772","8",144683169,144683464,295
"44642","ENSG00000274775","X",130445085,130524257,79172
"44643","ENSG00000274776","18",46786699,46789297,2598
"44644","ENSG00000274792","KI270727.1",386278,387620,1342
"44645","ENSG00000274797","12",50953924,50954356,432
"44646","ENSG00000274798","15",40874433,40874595,162
"44647","ENSG00000274799","5",148389748,148390029,281
"44648","ENSG00000274805","16",2463967,2464038,71
"44649","ENSG00000274808","17",36165681,36176636,10955
"44650","ENSG00000274810","3",132558142,132722459,164317
"44651","ENSG00000274813","5",178825382,178825571,189
"44652","ENSG00000274814","15",28494975,28495182,207
"44653","ENSG00000274816","16",57772289,57772352,63
"44654","ENSG00000274817","12",53968002,53968178,176
"44655","ENSG00000274818","14",70906657,70907111,454
"44656","ENSG00000274822","12",113291523,113291608,85
"44657","ENSG00000274824","10",71790747,71790800,53
"44658","ENSG00000274825","20",38955910,38956547,637
"44659","ENSG00000274827","14",19344578,19384587,40009
"44660","ENSG00000274828","18",79677287,79679358,2071
"44661","ENSG00000274833","17",81387415,81387766,351
"44662","ENSG00000274834","16",12614451,12614852,401
"44663","ENSG00000274835","15",22360639,22360918,279
"44664","ENSG00000274840","3",18013226,18041603,28377
"44665","ENSG00000274841","9",137638128,137638408,280
"44666","ENSG00000274847","GL000194.1",53594,115055,61461
"44667","ENSG00000274848","16",30816030,30816302,272
"44668","ENSG00000274849","18",36189824,36190272,448
"44669","ENSG00000274852","9",67175775,67176035,260
"44670","ENSG00000274855","6",3033183,3033288,105
"44671","ENSG00000274859","12",118066398,118066725,327
"44672","ENSG00000274860","17",6521131,6521412,281
"44673","ENSG00000274863","20",19000709,19056796,56087
"44674","ENSG00000274874","12",123973215,124088594,115379
"44675","ENSG00000274879","12",114929757,114929935,178
"44676","ENSG00000274883","17",45931806,45932083,277
"44677","ENSG00000274884","14",100826284,100826370,86
"44678","ENSG00000274885","12",22638464,22638943,479
"44679","ENSG00000274892","19",53512092,53512616,524
"44680","ENSG00000274893","9",66014525,66020816,6291
"44681","ENSG00000274895","1",213983793,213986419,2626
"44682","ENSG00000274897","11",797511,799185,1674
"44683","ENSG00000274898","13",77027944,77028482,538
"44684","ENSG00000274902","12",47731908,47732351,443
"44685","ENSG00000274903","6",160773988,160783214,9226
"44686","ENSG00000274918","18",35317396,35317848,452
"44687","ENSG00000274919","9",114774737,114775120,383
"44688","ENSG00000274922","13",112686769,112689815,3046
"44689","ENSG00000274923","X",7896514,7896722,208
"44690","ENSG00000274925","16",25257952,25261066,3114
"44691","ENSG00000274927","1",143461221,143498767,37546
"44692","ENSG00000274928","12",52341197,52354036,12839
"44693","ENSG00000274929","13",48532013,48532599,586
"44694","ENSG00000274930","18",50318420,50319024,604
"44695","ENSG00000274932","9",123485529,123485622,93
"44696","ENSG00000274933","17",36253456,36264553,11097
"44697","ENSG00000274937","15",74374678,74375511,833
"44698","ENSG00000274940","1",153689705,153689793,88
"44699","ENSG00000274943","12",42361267,42361703,436
"44700","ENSG00000274944","1",38864501,38881617,17116
"44701","ENSG00000274949","20",3811384,3823882,12498
"44702","ENSG00000274954","15",51833134,51833426,292
"44703","ENSG00000274956","8",62977861,62984900,7039
"44704","ENSG00000274963","1",150568971,150569269,298
"44705","ENSG00000274964","12",32339368,32340724,1356
"44706","ENSG00000274967","3",53290640,53290751,111
"44707","ENSG00000274973","20",25845497,25845862,365
"44708","ENSG00000274976","12",32820142,32820567,425
"44709","ENSG00000274978","1",28648600,28648733,133
"44710","ENSG00000274979","12",69326574,69331882,5308
"44711","ENSG00000274986","11",64898363,64898437,74
"44712","ENSG00000274987","12",25210652,25211233,581
"44713","ENSG00000274993","7",100963828,100968124,4296
"44714","ENSG00000274995","15",66740445,66741151,706
"44715","ENSG00000274996","17",38601049,38602701,1652
"44716","ENSG00000274997","6",27147129,27147515,386
"44717","ENSG00000275001","10",16767235,16767416,181
"44718","ENSG00000275004","22",22484421,22508742,24321
"44719","ENSG00000275005","10",129845328,129845895,567
"44720","ENSG00000275011","17",8063936,8072533,8597
"44721","ENSG00000275012","19",54948864,54948993,129
"44722","ENSG00000275014","13",19736975,19737254,279
"44723","ENSG00000275015","10",88259129,88259372,243
"44724","ENSG00000275016","15",95638316,95826499,188183
"44725","ENSG00000275017","9",88391362,88391832,470
"44726","ENSG00000275022","11",68044794,68044957,163
"44727","ENSG00000275023","17",38705542,38729803,24261
"44728","ENSG00000275024","10",114280725,114281258,533
"44729","ENSG00000275025","17",50098460,50098899,439
"44730","ENSG00000275026","9",66022661,66027719,5058
"44731","ENSG00000275029","17",37143607,37144463,856
"44732","ENSG00000275036","10",28289258,28289350,92
"44733","ENSG00000275040","16",79619469,79620110,641
"44734","ENSG00000275041","8",100897853,100898136,283
"44735","ENSG00000275046","6",58386799,58386961,162
"44736","ENSG00000275052","2",55547292,55618880,71588
"44737","ENSG00000275055","19",52049007,52049754,747
"44738","ENSG00000275056","16",4839244,4840334,1090
"44739","ENSG00000275063","KI270726.1",41444,41876,432
"44740","ENSG00000275064","1",145509047,145520594,11547
"44741","ENSG00000275066","17",37514807,37609472,94665
"44742","ENSG00000275068","9",64082429,64082534,105
"44743","ENSG00000275070","X",129796491,129796783,292
"44744","ENSG00000275074","8",22106874,22109419,2545
"44745","ENSG00000275084","17",2329016,2329237,221
"44746","ENSG00000275088","16",85142696,85146001,3305
"44747","ENSG00000275090","3",33103008,33103306,298
"44748","ENSG00000275091","19",14006422,14006773,351
"44749","ENSG00000275092","16",1707252,1707973,721
"44750","ENSG00000275097","12",31280422,31280895,473
"44751","ENSG00000275103","8",89826593,89833564,6971
"44752","ENSG00000275106","7",128952527,128953316,789
"44753","ENSG00000275107","17",44207771,44207839,68
"44754","ENSG00000275110","X",109054542,109054590,48
"44755","ENSG00000275111","2",95165432,95184317,18885
"44756","ENSG00000275113","X",49341192,49345922,4730
"44757","ENSG00000275115","8",27010486,27010746,260
"44758","ENSG00000275119","12",11212219,11251389,39170
"44759","ENSG00000275120","15",84597809,84633988,36179
"44760","ENSG00000275127","15",25089923,25090014,91
"44761","ENSG00000275130","9",11618496,11618621,125
"44762","ENSG00000275131","1",120489860,120701289,211429
"44763","ENSG00000275132","19",38200234,38200532,298
"44764","ENSG00000275139","21",45759804,45763758,3954
"44765","ENSG00000275140","1",148772640,148784594,11954
"44766","ENSG00000275144","9",42923277,42924144,867
"44767","ENSG00000275152","17",35976493,35981497,5004
"44768","ENSG00000275154","14",91714915,91715130,215
"44769","ENSG00000275155","16",49847018,49847632,614
"44770","ENSG00000275157","2",232368576,232368697,121
"44771","ENSG00000275158","7",142580917,142581427,510
"44772","ENSG00000275160","9",41479960,41480548,588
"44773","ENSG00000275162","19",956485,958149,1664
"44774","ENSG00000275163","3",178419123,178843300,424177
"44775","ENSG00000275167","21",45478266,45478326,60
"44776","ENSG00000275173","17",37798894,37802788,3894
"44777","ENSG00000275178","18",77093086,77093446,360
"44778","ENSG00000275180","12",62603909,62604399,490
"44779","ENSG00000275183","19",54461796,54463711,1915
"44780","ENSG00000275186","18",79470120,79470940,820
"44781","ENSG00000275191","16",53628256,53628816,560
"44782","ENSG00000275194","X",11221348,11225731,4383
"44783","ENSG00000275197","12",25225103,25225665,562
"44784","ENSG00000275198","14",90383365,90387973,4608
"44785","ENSG00000275202","13",48974967,48976867,1900
"44786","ENSG00000275206","17",18390153,18390323,170
"44787","ENSG00000275207","1",202003124,202003236,112
"44788","ENSG00000275208","11",47179611,47179737,126
"44789","ENSG00000275210","19",54308915,54337168,28253
"44790","ENSG00000275212","12",125983702,126043485,59783
"44791","ENSG00000275213","1",205684018,205684307,289
"44792","ENSG00000275216","13",109269634,109278512,8878
"44793","ENSG00000275222","20",8998849,8999100,251
"44794","ENSG00000275223","20",33655701,33656423,722
"44795","ENSG00000275226","13",37534940,37551536,16596
"44796","ENSG00000275227","3",25618132,25618312,180
"44797","ENSG00000275228","12",48327942,48328472,530
"44798","ENSG00000275229","1",149700151,149700296,145
"44799","ENSG00000275232","12",131447337,131455436,8099
"44800","ENSG00000275234","19",6469465,6470152,687
"44801","ENSG00000275236","16",74289593,74291052,1459
"44802","ENSG00000275239","9",41657708,41699072,41364
"44803","ENSG00000275243","7",142598016,142598469,453
"44804","ENSG00000275248","13",109805317,109805868,551
"44805","ENSG00000275263","16",30956872,30957199,327
"44806","ENSG00000275265","12",122501187,122501641,454
"44807","ENSG00000275273","17",42708084,42708151,67
"44808","ENSG00000275278","12",29156448,29156991,543
"44809","ENSG00000275285","20",38378825,38383179,4354
"44810","ENSG00000275286","12",44498616,44499158,542
"44811","ENSG00000275287","X",388100,388389,289
"44812","ENSG00000275291","1",144523860,144524021,161
"44813","ENSG00000275293","22",21555138,21555457,319
"44814","ENSG00000275294","13",27178263,27251288,73025
"44815","ENSG00000275295","7",45303620,45304362,742
"44816","ENSG00000275297","9",41760088,41764175,4087
"44817","ENSG00000275302","17",36103827,36105621,1794
"44818","ENSG00000275312","10",45180400,45180616,216
"44819","ENSG00000275314","X",36794500,36795460,960
"44820","ENSG00000275318","9",92840955,92841688,733
"44821","ENSG00000275319","22",18524620,18524935,315
"44822","ENSG00000275320","X",100815865,100817174,1309
"44823","ENSG00000275322","15",96342953,96345651,2698
"44824","ENSG00000275325","15",22727104,22744918,17814
"44825","ENSG00000275328","7",5031608,5037831,6223
"44826","ENSG00000275329","9",136122521,136124363,1842
"44827","ENSG00000275332","15",64943240,64943672,432
"44828","ENSG00000275337","20",39349094,39349392,298
"44829","ENSG00000275339","6",122454358,122454612,254
"44830","ENSG00000275340","3",13933056,13937477,4421
"44831","ENSG00000275342","8",8317736,8386498,68762
"44832","ENSG00000275343","15",56908312,56908635,323
"44833","ENSG00000275344","11",60209071,60209156,85
"44834","ENSG00000275345","15",90281858,90282270,412
"44835","ENSG00000275348","3",122482990,122483229,239
"44836","ENSG00000275355","18",76840838,76841102,264
"44837","ENSG00000275356","7",124777292,124790810,13518
"44838","ENSG00000275358","20",25062962,25063591,629
"44839","ENSG00000275361","22",22087924,22088085,161
"44840","ENSG00000275362","22",18615581,18615900,319
"44841","ENSG00000275363","15",22451209,22455154,3945
"44842","ENSG00000275367","12",8217758,8221115,3357
"44843","ENSG00000275371","16",30110895,30111955,1060
"44844","ENSG00000275373","11",12163683,12163767,84
"44845","ENSG00000275374","5",100375700,100381398,5698
"44846","ENSG00000275377","9",40929010,40929092,82
"44847","ENSG00000275379","6",27871905,27872315,410
"44848","ENSG00000275381","2",69844509,69844933,424
"44849","ENSG00000275383","16",68591382,68594424,3042
"44850","ENSG00000275385","17",36064280,36072032,7752
"44851","ENSG00000275389","12",124085761,124088598,2837
"44852","ENSG00000275390","9",40767870,40806344,38474
"44853","ENSG00000275392","1",207127010,207127486,476
"44854","ENSG00000275393","16",85697335,85697868,533
"44855","ENSG00000275395","19",39863323,39934626,71303
"44856","ENSG00000275400","7",66553805,66554199,394
"44857","ENSG00000275401","20",38418483,38419202,719
"44858","ENSG00000275405","KI270713.1",21861,22024,163
"44859","ENSG00000275406","1",226331999,226333655,1656
"44860","ENSG00000275409","12",118430147,118430699,552
"44861","ENSG00000275410","17",37686431,37745105,58674
"44862","ENSG00000275413","17",16023323,16023653,330
"44863","ENSG00000275417","15",56248787,56249127,340
"44864","ENSG00000275418","18",58659858,58660524,666
"44865","ENSG00000275423","2",47989625,47990526,901
"44866","ENSG00000275426","4",149738,150317,579
"44867","ENSG00000275427","8",1296034,1302607,6573
"44868","ENSG00000275431","17",35983656,35990270,6614
"44869","ENSG00000275432","19",14628599,14628801,202
"44870","ENSG00000275437","20",62402236,62405935,3699
"44871","ENSG00000275438","16",848525,849065,540
"44872","ENSG00000275441","16",28553709,28554140,431
"44873","ENSG00000275443","15",95990582,96300990,310408
"44874","ENSG00000275445","16",22007480,22008062,582
"44875","ENSG00000275450","9",41276280,41282846,6566
"44876","ENSG00000275451","15",62343029,62343138,109
"44877","ENSG00000275453","20",38516563,38516632,69
"44878","ENSG00000275454","15",75639760,75640976,1216
"44879","ENSG00000275457","20",21302731,21303704,973
"44880","ENSG00000275458","2",217900513,217900628,115
"44881","ENSG00000275464","21",5130871,5154734,23863
"44882","ENSG00000275465","9",96105741,96116411,10670
"44883","ENSG00000275468","19",2013728,2014656,928
"44884","ENSG00000275475","14",106601346,106601792,446
"44885","ENSG00000275476","12",29277397,29277882,485
"44886","ENSG00000275479","17",80149627,80149798,171
"44887","ENSG00000275480","17",22567423,22568713,1290
"44888","ENSG00000275481","12",46388856,46392126,3270
"44889","ENSG00000275484","11",67374416,67374932,516
"44890","ENSG00000275485","13",20768876,20769375,499
"44891","ENSG00000275488","12",53574632,53576103,1471
"44892","ENSG00000275489","17",38835088,38841455,6367
"44893","ENSG00000275491","20",3808357,3812434,4077
"44894","ENSG00000275493","9",67725914,67726255,341
"44895","ENSG00000275494","16",25106569,25107102,533
"44896","ENSG00000275496","21",6228966,6267317,38351
"44897","ENSG00000275497","2",95633850,95636106,2256
"44898","ENSG00000275504","16",68926894,68926957,63
"44899","ENSG00000275506","5",139612002,139612363,361
"44900","ENSG00000275512","18",35403996,35406528,2532
"44901","ENSG00000275515","16",4433202,4433387,185
"44902","ENSG00000275516","17",79952663,79952992,329
"44903","ENSG00000275519","19",55230885,55230952,67
"44904","ENSG00000275520","X",72938163,72938958,795
"44905","ENSG00000275523","21",39447010,39447069,59
"44906","ENSG00000275529","15",25059538,25059633,95
"44907","ENSG00000275532","17",38703480,38706261,2781
"44908","ENSG00000275538","1",120850819,120850985,166
"44909","ENSG00000275540","19",19740884,19750127,9243
"44910","ENSG00000275547","19",37024886,37025254,368
"44911","ENSG00000275549","9",137250219,137253497,3278
"44912","ENSG00000275550","6",37295584,37295742,158
"44913","ENSG00000275552","14",22595808,22598946,3138
"44914","ENSG00000275557","1",149607765,149612402,4637
"44915","ENSG00000275560","12",12718973,12719521,548
"44916","ENSG00000275562","17",60256720,60258411,1691
"44917","ENSG00000275567","12",21828360,21828564,204
"44918","ENSG00000275569","14",56305838,56306394,556
"44919","ENSG00000275572","7",2474844,2476894,2050
"44920","ENSG00000275576","20",32116171,32116629,458
"44921","ENSG00000275580","15",49343608,49344254,646
"44922","ENSG00000275582","20",3921279,3923400,2121
"44923","ENSG00000275585","1",120985692,121052167,66475
"44924","ENSG00000275586","7",148876018,148876286,268
"44925","ENSG00000275588","2",64817378,64817675,297
"44926","ENSG00000275591","8",6808517,6835644,27127
"44927","ENSG00000275597","2",87980714,87992858,12144
"44928","ENSG00000275598","11",63469376,63470944,1568
"44929","ENSG00000275601","15",43642389,43643023,634
"44930","ENSG00000275607","3",58379217,58379525,308
"44931","ENSG00000275609","22",23610329,23610538,209
"44932","ENSG00000275612","11",7698951,7699393,442
"44933","ENSG00000275613","17",36722443,36726346,3903
"44934","ENSG00000275620","20",63253978,63261615,7637
"44935","ENSG00000275630","14",70822004,70823984,1980
"44936","ENSG00000275632","20",6000418,6000941,523
"44937","ENSG00000275635","22",23137805,23137864,59
"44938","ENSG00000275636","15",40078892,40079347,455
"44939","ENSG00000275640","19",10828973,10829035,62
"44940","ENSG00000275642","19",1724115,1724395,280
"44941","ENSG00000275645","15",75346744,75347161,417
"44942","ENSG00000275647","4",128944628,128944956,328
"44943","ENSG00000275649","9",42231811,42354454,122643
"44944","ENSG00000275651","9",33467869,33467935,66
"44945","ENSG00000275655","2",97100587,97100874,287
"44946","ENSG00000275662","14",100897920,100897996,76
"44947","ENSG00000275665","17",38715328,38720272,4944
"44948","ENSG00000275667","7",64679064,64679176,112
"44949","ENSG00000275669","11",1256605,1256670,65
"44950","ENSG00000275670","3",113432118,113432200,82
"44951","ENSG00000275672","15",45378700,45380123,1423
"44952","ENSG00000275674","15",90266317,90314499,48182
"44953","ENSG00000275675","10",38068449,38068694,245
"44954","ENSG00000275676","9",61229913,61231863,1950
"44955","ENSG00000275678","1",67121605,67123956,2351
"44956","ENSG00000275680","17",58951185,58951513,328
"44957","ENSG00000275681","X",21841794,21841961,167
"44958","ENSG00000275688","17",35983656,36001621,17965
"44959","ENSG00000275689","13",21126271,21126396,125
"44960","ENSG00000275693","10",88992370,88992539,169
"44961","ENSG00000275695","15",82445719,82454837,9118
"44962","ENSG00000275696","3",186629936,186630211,275
"44963","ENSG00000275700","17",36948954,37056871,107917
"44964","ENSG00000275703","12",6899752,6900212,460
"44965","ENSG00000275709","15",45585757,45586304,547
"44966","ENSG00000275710","17",54964474,54964679,205
"44967","ENSG00000275713","6",26251651,26253710,2059
"44968","ENSG00000275714","6",26020490,26020900,410
"44969","ENSG00000275716","6",100093311,100093768,457
"44970","ENSG00000275718","17",35996440,36001553,5113
"44971","ENSG00000275719","19",46787815,46789043,1228
"44972","ENSG00000275720","17",36634069,36634698,629
"44973","ENSG00000275722","17",35934518,35943713,9195
"44974","ENSG00000275726","19",45436654,45436704,50
"44975","ENSG00000275728","20",16580258,16580622,364
"44976","ENSG00000275734","16",89671568,89685304,13736
"44977","ENSG00000275740","5",146203550,146339251,135701
"44978","ENSG00000275741","13",109785831,109808252,22421
"44979","ENSG00000275743","7",142587868,142588359,491
"44980","ENSG00000275747","14",106867660,106868092,432
"44981","ENSG00000275756","9",92104425,92105451,1026
"44982","ENSG00000275759","12",118428281,118428870,589
"44983","ENSG00000275763","18",76495521,76498088,2567
"44984","ENSG00000275764","12",27037100,27038960,1860
"44985","ENSG00000275765","5",151770242,151771508,1266
"44986","ENSG00000275767","1",144179777,144211729,31952
"44987","ENSG00000275769","12",31443792,31444208,416
"44988","ENSG00000275770","12",48132797,48132867,70
"44989","ENSG00000275772","22",22785643,22787268,1625
"44990","ENSG00000275773","6",60723148,60723898,750
"44991","ENSG00000275774","1",13115496,13116854,1358
"44992","ENSG00000275778","12",10845849,11171600,325751
"44993","ENSG00000275785","15",63890030,63890317,287
"44994","ENSG00000275788","13",30684029,30684278,249
"44995","ENSG00000275789","3",52846463,52846552,89
"44996","ENSG00000275791","7",142544212,142544685,473
"44997","ENSG00000275793","22",18605815,18611919,6104
"44998","ENSG00000275799","21",44244545,44244993,448
"44999","ENSG00000275801","1",160775954,160776608,654
"45000","ENSG00000275803","15",90293939,90294207,268
"45001","ENSG00000275805","18",26565723,26575626,9903
"45002","ENSG00000275807","16",28822431,28823969,1538
"45003","ENSG00000275808","16",59004213,59004494,281
"45004","ENSG00000275810","4",113152282,113152362,80
"45005","ENSG00000275811","12",1151810,1153059,1249
"45006","ENSG00000275812","20",63543411,63543738,327
"45007","ENSG00000275830","13",109988097,110129136,141039
"45008","ENSG00000275832","17",38419280,38512385,93105
"45009","ENSG00000275833","7",65764535,65768306,3771
"45010","ENSG00000275835","15",22983192,23039572,56380
"45011","ENSG00000275839","17",37454171,37454931,760
"45012","ENSG00000275846","6",26602733,26606661,3928
"45013","ENSG00000275850","12",3171657,3174056,2399
"45014","ENSG00000275852","20",58003904,58004648,744
"45015","ENSG00000275853","7",55731100,55731403,303
"45016","ENSG00000275854","12",32736930,32737660,730
"45017","ENSG00000275863","19",55123225,55123292,67
"45018","ENSG00000275869","KI270728.1",933862,936467,2605
"45019","ENSG00000275874","21",44999208,45004727,5519
"45020","ENSG00000275875","7",55741525,55741869,344
"45021","ENSG00000275878","7",66980120,66980410,290
"45022","ENSG00000275880","13",110613082,110616353,3271
"45023","ENSG00000275881","12",62393607,62393880,273
"45024","ENSG00000275882","X",154639978,154648275,8297
"45025","ENSG00000275888","17",82244770,82245591,821
"45026","ENSG00000275894","20",45345115,45345823,708
"45027","ENSG00000275895","21",6484623,6499261,14638
"45028","ENSG00000275896","7",142760398,142774564,14166
"45029","ENSG00000275897","17",50475819,50478391,2572
"45030","ENSG00000275898","12",116580974,116583672,2698
"45031","ENSG00000275901","19",16187313,16187566,253
"45032","ENSG00000275905","8",106980967,106981571,604
"45033","ENSG00000275906","6",30961403,30962396,993
"45034","ENSG00000275908","16",20823443,20823537,94
"45035","ENSG00000275909","16",48432927,48433208,281
"45036","ENSG00000275910","16",15015828,15016390,562
"45037","ENSG00000275919","13",98871742,98872005,263
"45038","ENSG00000275923","20",55504906,55505215,309
"45039","ENSG00000275924","19",58550285,58550376,91
"45040","ENSG00000275927","16",17445825,17446380,555
"45041","ENSG00000275929","15",91031246,91031691,445
"45042","ENSG00000275930","7",75381638,75381739,101
"45043","ENSG00000275936","12",120224744,120225421,677
"45044","ENSG00000275939","5",131440031,131440196,165
"45045","ENSG00000275940","3",47028855,47029030,175
"45046","ENSG00000275944","17",36001419,36011618,10199
"45047","ENSG00000275945","21",10330732,10331537,805
"45048","ENSG00000275953","6",126627484,126628570,1086
"45049","ENSG00000275954","17",36428618,36439566,10948
"45050","ENSG00000275956","3",52732547,52733867,1320
"45051","ENSG00000275961","2",96004563,96004850,287
"45052","ENSG00000275963","12",12648939,12649713,774
"45053","ENSG00000275964","13",19863858,19865048,1190
"45054","ENSG00000275965","15",92634305,92634665,360
"45055","ENSG00000275967","12",124337181,124337242,61
"45056","ENSG00000275969","9",66986304,66992583,6279
"45057","ENSG00000275975","X",71368666,71368968,302
"45058","ENSG00000275976","7",73048055,73053981,5926
"45059","ENSG00000275978","14",34659564,34659878,314
"45060","ENSG00000275980","9",21135598,21136350,752
"45061","ENSG00000275981","3",4750333,4750685,352
"45062","ENSG00000275987","KI270713.1",30437,30580,143
"45063","ENSG00000275993","21",6111134,6123739,12605
"45064","ENSG00000275995","15",81403026,81403570,544
"45065","ENSG00000275997","17",1155966,1156175,209
"45066","ENSG00000276002","19",50258443,50258722,279
"45067","ENSG00000276007","16",78123243,78124332,1089
"45068","ENSG00000276012","13",101717564,101723106,5542
"45069","ENSG00000276014","17",36110150,36110447,297
"45070","ENSG00000276017","KI270734.1",72411,74814,2403
"45071","ENSG00000276023","17",37489891,37513501,23610
"45072","ENSG00000276029","9",41233755,41233835,80
"45073","ENSG00000276030","19",24146701,24147081,380
"45074","ENSG00000276031","20",49721949,49722247,298
"45075","ENSG00000276036","17",38731802,38731920,118
"45076","ENSG00000276040","9",61190003,61196280,6277
"45077","ENSG00000276043","19",4903080,4962154,59074
"45078","ENSG00000276045","12",121626550,121642677,16127
"45079","ENSG00000276047","5",123070782,123071080,298
"45080","ENSG00000276054","17",37386886,37387926,1040
"45081","ENSG00000276058","12",31715342,31715781,439
"45082","ENSG00000276063","14",69154311,69154804,493
"45083","ENSG00000276067","7",135246113,135317752,71639
"45084","ENSG00000276070","17",36210924,36212878,1954
"45085","ENSG00000276071","19",36668102,36669404,1302
"45086","ENSG00000276075","16",67517862,67528675,10813
"45087","ENSG00000276076","21",6560714,6564489,3775
"45088","ENSG00000276083","3",127587111,127587176,65
"45089","ENSG00000276085","17",36194869,36196758,1889
"45090","ENSG00000276087","2",24124366,24190436,66070
"45091","ENSG00000276088","17",16710059,16710361,302
"45092","ENSG00000276092","18",68721082,68721560,478
"45093","ENSG00000276093","20",60083360,60083872,512
"45094","ENSG00000276095","22",18873543,18894407,20864
"45095","ENSG00000276096","16",4756338,4756633,295
"45096","ENSG00000276097","19",2700689,2701266,577
"45097","ENSG00000276102","11",62567011,62567071,60
"45098","ENSG00000276103","1",150608507,150608623,116
"45099","ENSG00000276107","15",39586561,39587293,732
"45100","ENSG00000276109","11",72551049,72551919,870
"45101","ENSG00000276110","1",150255095,150257286,2191
"45102","ENSG00000276115","12",32352349,32354144,1795
"45103","ENSG00000276116","14",65411170,65412690,1520
"45104","ENSG00000276119","9",104604671,104605627,956
"45105","ENSG00000276121","15",44778196,44778721,525
"45106","ENSG00000276122","12",130138693,130140768,2075
"45107","ENSG00000276124","9",129869605,129869671,66
"45108","ENSG00000276127","6",71251758,71252988,1230
"45109","ENSG00000276128","9",42974855,43045120,70265
"45110","ENSG00000276131","16",58392153,58392807,654
"45111","ENSG00000276136","12",32000375,32001222,847
"45112","ENSG00000276141","15",22664359,22686213,21854
"45113","ENSG00000276147","3",32506283,32506389,106
"45114","ENSG00000276148","12",32725248,32725660,412
"45115","ENSG00000276156","6",45097496,45097976,480
"45116","ENSG00000276160","22",18340145,18345899,5754
"45117","ENSG00000276162","22",28459869,28459948,79
"45118","ENSG00000276166","16",57759358,57760024,666
"45119","ENSG00000276169","20",41169023,41169078,55
"45120","ENSG00000276170","17",38450394,38452444,2050
"45121","ENSG00000276172","15",23083094,23121324,38230
"45122","ENSG00000276174","18",42052705,42053030,325
"45123","ENSG00000276178","7",72983360,72983461,101
"45124","ENSG00000276180","6",27138588,27139881,1293
"45125","ENSG00000276188","12",120709112,120709523,411
"45126","ENSG00000276193","8",133668420,133668701,281
"45127","ENSG00000276200","2",196289409,196289707,298
"45128","ENSG00000276202","17",77014880,77015138,258
"45129","ENSG00000276203","9",66106815,66179474,72659
"45130","ENSG00000276204","9",67328207,67329404,1197
"45131","ENSG00000276210","14",106287674,106288828,1154
"45132","ENSG00000276213","7",152025194,152025472,278
"45133","ENSG00000276214","5",59314110,59314800,690
"45134","ENSG00000276216","1",145281116,145281462,346
"45135","ENSG00000276221","18",26591467,26591535,68
"45136","ENSG00000276223","20",44746642,44747201,559
"45137","ENSG00000276231","17",8802723,8867677,64954
"45138","ENSG00000276234","17",37406886,37479725,72839
"45139","ENSG00000276241","17",36116177,36177510,61333
"45140","ENSG00000276248","13",113527260,113530621,3361
"45141","ENSG00000276250","17",30803654,30804077,423
"45142","ENSG00000276251","19",29220864,29221666,802
"45143","ENSG00000276255","1",228073909,228076550,2641
"45144","ENSG00000276256","GL000195.1",42939,49164,6225
"45145","ENSG00000276259","16",58522970,58523842,872
"45146","ENSG00000276261","12",27700066,27700574,508
"45147","ENSG00000276266","9",40611252,40622155,10903
"45148","ENSG00000276269","13",110031101,110031567,466
"45149","ENSG00000276272","12",56411944,56413190,1246
"45150","ENSG00000276277","9",42213841,42213918,77
"45151","ENSG00000276281","2",85567662,85567960,298
"45152","ENSG00000276282","18",31895745,31896410,665
"45153","ENSG00000276289","21",7816675,7829926,13251
"45154","ENSG00000276290","6",60873360,60874642,1282
"45155","ENSG00000276291","9",40992249,41218410,226161
"45156","ENSG00000276292","12",118037869,118038081,212
"45157","ENSG00000276293","17",38765689,38800126,34437
"45158","ENSG00000276294","19",20330121,20331517,1396
"45159","ENSG00000276298","X",103909126,103909449,323
"45160","ENSG00000276302","6",28267121,28281580,14459
"45161","ENSG00000276308","12",115318657,115320405,1748
"45162","ENSG00000276309","5",68970439,68970752,313
"45163","ENSG00000276316","11",124238420,124239486,1066
"45164","ENSG00000276317","20",62651272,62652186,914
"45165","ENSG00000276326","17",37033745,37033813,68
"45166","ENSG00000276332","5",38197432,38198148,716
"45167","ENSG00000276334","2",32521927,32523547,1620
"45168","ENSG00000276337","16",87470370,87474370,4000
"45169","ENSG00000276345","KI270721.1",2585,11802,9217
"45170","ENSG00000276348","9",66979132,66988373,9241
"45171","ENSG00000276350","X",154450320,154450386,66
"45172","ENSG00000276353","8",54130582,54130860,278
"45173","ENSG00000276359","1",164703026,164703309,283
"45174","ENSG00000276362","2",84850711,84851148,437
"45175","ENSG00000276368","6",27814354,27814740,386
"45176","ENSG00000276375","10",130282445,130286604,4159
"45177","ENSG00000276380","X",143884071,143885255,1184
"45178","ENSG00000276384","17",7557820,7558245,425
"45179","ENSG00000276385","20",8934984,8935481,497
"45180","ENSG00000276386","9",67059560,67293468,233908
"45181","ENSG00000276388","9",138129399,138129526,127
"45182","ENSG00000276390","12",47699401,47699917,516
"45183","ENSG00000276393","16",87467138,87467654,516
"45184","ENSG00000276396","4",139155153,139155444,291
"45185","ENSG00000276397","18",76686058,76693636,7578
"45186","ENSG00000276398","12",97560856,97561048,192
"45187","ENSG00000276399","17",22406019,22413744,7725
"45188","ENSG00000276403","18",58476191,58477484,1293
"45189","ENSG00000276404","6",34240673,34240736,63
"45190","ENSG00000276405","7",142535809,142536292,483
"45191","ENSG00000276406","17",19868568,19868689,121
"45192","ENSG00000276407","3",194070103,194086826,16723
"45193","ENSG00000276408","16",75556392,75557059,667
"45194","ENSG00000276409","17",35983288,35987004,3716
"45195","ENSG00000276410","6",26043277,26043657,380
"45196","ENSG00000276411","2",11673964,11676925,2961
"45197","ENSG00000276412","9",41651658,41654594,2936
"45198","ENSG00000276413","6",159555964,159556174,210
"45199","ENSG00000276417","12",8205984,8207397,1413
"45200","ENSG00000276418","8",79918860,80080775,161915
"45201","ENSG00000276422","9",60943311,60964196,20885
"45202","ENSG00000276427","22",20632619,20632751,132
"45203","ENSG00000276434","13",113339450,113339958,508
"45204","ENSG00000276436","13",49792886,49793307,421
"45205","ENSG00000276445","19",39812972,39813555,583
"45206","ENSG00000276449","19",57449689,57453011,3322
"45207","ENSG00000276454","12",47265665,47266108,443
"45208","ENSG00000276460","2",131398439,131401250,2811
"45209","ENSG00000276462","9",41100793,41119909,19116
"45210","ENSG00000276471","3",72080564,72084641,4077
"45211","ENSG00000276473","15",61239906,61240331,425
"45212","ENSG00000276474","X",52326166,52326762,596
"45213","ENSG00000276475","7",64590599,64591133,534
"45214","ENSG00000276476","13",22040972,22276526,235554
"45215","ENSG00000276478","9",87799501,87821803,22302
"45216","ENSG00000276486","18",31883288,31883728,440
"45217","ENSG00000276487","12",128187225,128191495,4270
"45218","ENSG00000276488","19",55612490,55613097,607
"45219","ENSG00000276490","10",94688154,94853073,164919
"45220","ENSG00000276493","1",32087523,32087813,290
"45221","ENSG00000276500","9",40505399,40566281,60882
"45222","ENSG00000276505","11",117297005,117297328,323
"45223","ENSG00000276507","4",29010619,29011021,402
"45224","ENSG00000276508","17",36684754,36685129,375
"45225","ENSG00000276509","1",146235806,146237807,2001
"45226","ENSG00000276514","5",94877599,94877777,178
"45227","ENSG00000276517","2",32526504,32529507,3003
"45228","ENSG00000276520","1",248708202,248708641,439
"45229","ENSG00000276521","11",102963460,102966628,3168
"45230","ENSG00000276523","16",75572185,75572685,500
"45231","ENSG00000276524","15",56887107,56888219,1112
"45232","ENSG00000276527","13",44684487,44715393,30906
"45233","ENSG00000276529","21",44978832,44979274,442
"45234","ENSG00000276531","10",72483245,72483812,567
"45235","ENSG00000276533","15",55288849,55289346,497
"45236","ENSG00000276535","9",88144851,88145850,999
"45237","ENSG00000276538","7",150047609,150047854,245
"45238","ENSG00000276542","4",89748283,89749154,871
"45239","ENSG00000276545","5",141439853,141442449,2596
"45240","ENSG00000276547","5",141397987,141512979,114992
"45241","ENSG00000276548","16",21401089,21401198,109
"45242","ENSG00000276550","15",22495570,22590815,95245
"45243","ENSG00000276556","21",10640028,10640338,310
"45244","ENSG00000276557","7",142615716,142616415,699
"45245","ENSG00000276563","1",178017127,178017343,216
"45246","ENSG00000276564","16",14150833,14153235,2402
"45247","ENSG00000276566","2",90154073,90154574,501
"45248","ENSG00000276568","19",6928345,6928629,284
"45249","ENSG00000276569","13",43179501,43181193,1692
"45250","ENSG00000276570","19",55227219,55230279,3060
"45251","ENSG00000276571","16",19694035,19694428,393
"45252","ENSG00000276573","13",97435946,97436168,222
"45253","ENSG00000276575","X",53195411,53195488,77
"45254","ENSG00000276576","6",57029521,57029988,467
"45255","ENSG00000276578","19",56485923,56494280,8357
"45256","ENSG00000276580","8",6622124,6622220,96
"45257","ENSG00000276588","19",47581023,47581321,298
"45258","ENSG00000276592","7",75203926,75204711,785
"45259","ENSG00000276593","15",49353485,49354034,549
"45260","ENSG00000276597","7",142554836,142555318,482
"45261","ENSG00000276600","1",205976740,206003461,26721
"45262","ENSG00000276601","17",58785323,58785608,285
"45263","ENSG00000276603","20",37526642,37527060,418
"45264","ENSG00000276605","8",54354168,54355118,950
"45265","ENSG00000276612","21",5116343,5133805,17462
"45266","ENSG00000276620","6",107192300,107192573,273
"45267","ENSG00000276623","4",165016887,165017433,546
"45268","ENSG00000276627","20",60755001,60767279,12278
"45269","ENSG00000276631","19",29222542,29223137,595
"45270","ENSG00000276633","21",45870854,45873345,2491
"45271","ENSG00000276641","16",4671318,4671390,72
"45272","ENSG00000276644","13",71437966,71867204,429238
"45273","ENSG00000276645","1",33029232,33029576,344
"45274","ENSG00000276647","21",44686358,44686629,271
"45275","ENSG00000276649","20",1888128,1894374,6246
"45276","ENSG00000276651","15",63500737,63503083,2346
"45277","ENSG00000276653","2",25058032,25058329,297
"45278","ENSG00000276662","10",147820,148751,931
"45279","ENSG00000276663","16",57245832,57246396,564
"45280","ENSG00000276668","11",7699562,7699988,426
"45281","ENSG00000276669","11",86216596,86216878,282
"45282","ENSG00000276672","13",33846190,33850825,4635
"45283","ENSG00000276673","8",76733302,76733476,174
"45284","ENSG00000276674","1",144085628,144086098,470
"45285","ENSG00000276678","3",10287413,10287482,69
"45286","ENSG00000276687","6",905445,909006,3561
"45287","ENSG00000276688","20",5407564,5407876,312
"45288","ENSG00000276691","12",47788426,47788971,545
"45289","ENSG00000276692","9",39873931,39874390,459
"45290","ENSG00000276693","12",132169823,132170043,220
"45291","ENSG00000276696","15",56634038,56634167,129
"45292","ENSG00000276698","14",24198433,24199090,657
"45293","ENSG00000276699","14",22505110,22505167,57
"45294","ENSG00000276700","KI270733.1",128877,129029,152
"45295","ENSG00000276702","15",33850538,33851178,640
"45296","ENSG00000276704","13",97437268,97437630,362
"45297","ENSG00000276707","17",36940049,36943456,3407
"45298","ENSG00000276710","15",82459472,82477258,17786
"45299","ENSG00000276712","6",35470508,35470579,71
"45300","ENSG00000276715","17",37828305,37884743,56438
"45301","ENSG00000276717","9",92177235,92188652,11417
"45302","ENSG00000276718","12",6466537,6467135,598
"45303","ENSG00000276721","16",21833516,21833621,105
"45304","ENSG00000276723","9",65573384,65573495,111
"45305","ENSG00000276724","15",32583612,32584312,700
"45306","ENSG00000276727","12",57229498,57230198,700
"45307","ENSG00000276728","17",45146730,45148470,1740
"45308","ENSG00000276729","19",50019019,50019320,301
"45309","ENSG00000276733","2",5974662,5974732,70
"45310","ENSG00000276735","1",193236794,193237107,313
"45311","ENSG00000276740","13",107465984,107466674,690
"45312","ENSG00000276742","10",121956782,121957098,316
"45313","ENSG00000276744","15",75452964,75453947,983
"45314","ENSG00000276746","6",33562880,33563130,250
"45315","ENSG00000276747","1",17372196,17401699,29503
"45316","ENSG00000276753","22",49962866,49962939,73
"45317","ENSG00000276754","16",3686998,3687380,382
"45318","ENSG00000276756","1",144276484,144305180,28696
"45319","ENSG00000276757","19",11011708,11012006,298
"45320","ENSG00000276758","19",54296194,54296252,58
"45321","ENSG00000276759","9",26066675,26118408,51733
"45322","ENSG00000276763","3",108574683,108575064,381
"45323","ENSG00000276764","5",18958147,18958413,266
"45324","ENSG00000276765","13",110340958,110341029,71
"45325","ENSG00000276768","20",5049857,5050321,464
"45326","ENSG00000276770","6",43434542,43434620,78
"45327","ENSG00000276772","15",57553955,57555680,1725
"45328","ENSG00000276775","14",106011922,106012420,498
"45329","ENSG00000276778","5",158320683,158409773,89090
"45330","ENSG00000276786","20",61369879,61370855,976
"45331","ENSG00000276790","17",47279526,47280047,521
"45332","ENSG00000276791","16",2777319,2780568,3249
"45333","ENSG00000276800","22",21463963,21464279,316
"45334","ENSG00000276805","10",38403189,38452153,48964
"45335","ENSG00000276807","15",73730048,73731711,1663
"45336","ENSG00000276809","13",95744726,95745765,1039
"45337","ENSG00000276810","17",37162616,37163139,523
"45338","ENSG00000276814","12",48039784,48040761,977
"45339","ENSG00000276819","7",142592928,142593473,545
"45340","ENSG00000276823","X",48524480,48524806,326
"45341","ENSG00000276824","6",33899135,33899200,65
"45342","ENSG00000276830","1",12578957,12579023,66
"45343","ENSG00000276831","19",55338945,55339283,338
"45344","ENSG00000276832","9",41340823,41355538,14715
"45345","ENSG00000276839","1",182576772,182577040,268
"45346","ENSG00000276840","7",75288120,75299795,11675
"45347","ENSG00000276842","12",25103124,25103869,745
"45348","ENSG00000276845","9",61944232,61945136,904
"45349","ENSG00000276846","19",37314868,37315620,752
"45350","ENSG00000276850","10",47908064,47991877,83813
"45351","ENSG00000276851","17",50094065,50094647,582
"45352","ENSG00000276853","12",65171262,65171917,655
"45353","ENSG00000276854","13",44196006,44197298,1292
"45354","ENSG00000276855","17",15789016,15789705,689
"45355","ENSG00000276863","17",80333841,80334366,525
"45356","ENSG00000276866","10",67403351,67403410,59
"45357","ENSG00000276867","16",31704728,31705260,532
"45358","ENSG00000276868","9",40883634,40883763,129
"45359","ENSG00000276878","12",66023620,66023726,106
"45360","ENSG00000276888","14",19420975,19425017,4042
"45361","ENSG00000276890","3",72926955,72927237,282
"45362","ENSG00000276900","12",31729117,31731204,2087
"45363","ENSG00000276903","6",27865355,27865747,392
"45364","ENSG00000276915","20",6220330,6220759,429
"45365","ENSG00000276916","13",113511747,113514473,2726
"45366","ENSG00000276918","11",66374138,66374435,297
"45367","ENSG00000276923","20",48073869,48074188,319
"45368","ENSG00000276925","3",47469777,47469987,210
"45369","ENSG00000276926","19",41869627,41869698,71
"45370","ENSG00000276929","X",55137930,55142433,4503
"45371","ENSG00000276931","16",968375,969012,637
"45372","ENSG00000276934","18",74504766,74505248,482
"45373","ENSG00000276945","5",61145846,61146376,530
"45374","ENSG00000276950","22",23998401,24005453,7052
"45375","ENSG00000276952","20",25284915,25285588,673
"45376","ENSG00000276953","7",142563740,142564245,505
"45377","ENSG00000276956","12",110360452,110360746,294
"45378","ENSG00000276957","13",102593338,102593873,535
"45379","ENSG00000276958","13",25017766,25017903,137
"45380","ENSG00000276960","6",160755398,160757518,2120
"45381","ENSG00000276961","8",133046481,133046581,100
"45382","ENSG00000276963","9",40755407,40767875,12468
"45383","ENSG00000276966","6",26204552,26206038,1486
"45384","ENSG00000276968","13",48041751,48042184,433
"45385","ENSG00000276972","12",115332146,115332566,420
"45386","ENSG00000276975","1",146472566,146914294,441728
"45387","ENSG00000276980","19",6716386,6717742,1356
"45388","ENSG00000276984","16",424243,424543,300
"45389","ENSG00000276988","7",128483907,128484158,251
"45390","ENSG00000276992","4",104996900,104997052,152
"45391","ENSG00000276993","18",75387056,75387596,540
"45392","ENSG00000276997","1",222477252,222504622,27370
"45393","ENSG00000277000","3",100221268,100223858,2590
"45394","ENSG00000277001","5",91314716,91314997,281
"45395","ENSG00000277007","1",219270774,219273387,2613
"45396","ENSG00000277010","16",1223639,1224143,504
"45397","ENSG00000277011","12",132282814,132284606,1792
"45398","ENSG00000277013","19",33906352,33908391,2039
"45399","ENSG00000277017","22",18486999,18491247,4248
"45400","ENSG00000277020","13",20564708,20567045,2337
"45401","ENSG00000277022","20",45435272,45448325,13053
"45402","ENSG00000277035","2",28134408,28134585,177
"45403","ENSG00000277039","5",154821943,154822258,315
"45404","ENSG00000277043","6",49358185,49360420,2235
"45405","ENSG00000277047","13",54938604,54986720,48116
"45406","ENSG00000277049","9",41237440,41237557,117
"45407","ENSG00000277050","14",51637348,51637947,599
"45408","ENSG00000277051","20",45847630,45847940,310
"45409","ENSG00000277053","7",75185385,75237696,52311
"45410","ENSG00000277056","10",66837457,66837704,247
"45411","ENSG00000277057","17",38914979,38915042,63
"45412","ENSG00000277058","1",13060869,13062229,1360
"45413","ENSG00000277062","12",96101951,96102249,298
"45414","ENSG00000277072","7",74843754,74890610,46856
"45415","ENSG00000277075","6",26216975,26217483,508
"45416","ENSG00000277083","7",142287251,142291597,4346
"45417","ENSG00000277087","20",5045761,5046276,515
"45418","ENSG00000277089","17",36072866,36090134,17268
"45419","ENSG00000277096","4",43388157,43388437,280
"45420","ENSG00000277103","9",97151894,97152694,800
"45421","ENSG00000277109","9",61581813,61582675,862
"45422","ENSG00000277112","20",30656033,30723932,67899
"45423","ENSG00000277117","21",5022493,5040666,18173
"45424","ENSG00000277118","3",186076306,186076591,285
"45425","ENSG00000277127","7",75057877,75058188,311
"45426","ENSG00000277128","14",19124807,19175530,50723
"45427","ENSG00000277129","12",53968351,53968501,150
"45428","ENSG00000277130","12",79818784,79819465,681
"45429","ENSG00000277135","15",96139472,96140452,980
"45430","ENSG00000277136","19",41442102,41442392,290
"45431","ENSG00000277141","1",117243212,117243508,296
"45432","ENSG00000277142","16",525155,527407,2252
"45433","ENSG00000277143","3",158336430,158336777,347
"45434","ENSG00000277144","15",59115547,59116089,542
"45435","ENSG00000277147","1",149606334,149705716,99382
"45436","ENSG00000277149","7",72558744,72828200,269456
"45437","ENSG00000277150","X",155456914,155458672,1758
"45438","ENSG00000277151","13",32782874,32788178,5304
"45439","ENSG00000277152","15",66860303,66867023,6720
"45440","ENSG00000277156","14",19267115,19268164,1049
"45441","ENSG00000277157","6",26188765,26189076,311
"45442","ENSG00000277159","13",112602828,112606417,3589
"45443","ENSG00000277161","17",36534987,36539310,4323
"45444","ENSG00000277168","1",37953508,37953780,272
"45445","ENSG00000277170","16",4426902,4427380,478
"45446","ENSG00000277171","2",79547151,79548128,977
"45447","ENSG00000277173","12",47768529,47769648,1119
"45448","ENSG00000277174","7",56685036,56687366,2330
"45449","ENSG00000277182","17",38749360,38751457,2097
"45450","ENSG00000277186","12",132593031,132593698,667
"45451","ENSG00000277196","KI270734.1",138082,161852,23770
"45452","ENSG00000277198","17",47041825,47042105,280
"45453","ENSG00000277199","1",144627192,144642372,15180
"45454","ENSG00000277200","17",2720801,2723947,3146
"45455","ENSG00000277203","X",154886349,154888061,1712
"45456","ENSG00000277210","15",101522597,101524739,2142
"45457","ENSG00000277214","16",79603572,79604177,605
"45458","ENSG00000277215","X",141177284,141649927,472643
"45459","ENSG00000277218","10",130104569,130104998,429
"45460","ENSG00000277223","12",71448405,71448850,445
"45461","ENSG00000277224","6",26199520,26200715,1195
"45462","ENSG00000277227","13",28778224,28778448,224
"45463","ENSG00000277229","15",58454327,58454982,655
"45464","ENSG00000277232","22",46295143,46296660,1517
"45465","ENSG00000277233","13",48429269,48429554,285
"45466","ENSG00000277235","20",36064243,36064563,320
"45467","ENSG00000277241","3",177700346,177701072,726
"45468","ENSG00000277245","15",56447120,56447697,577
"45469","ENSG00000277246","13",108267320,108267734,414
"45470","ENSG00000277247","12",70570969,70571440,471
"45471","ENSG00000277249","17",45114367,45114433,66
"45472","ENSG00000277250","3",128673681,128674021,340
"45473","ENSG00000277253","7",56805336,56808148,2812
"45474","ENSG00000277255","16",81533902,81533966,64
"45475","ENSG00000277258","17",38733898,38749817,15919
"45476","ENSG00000277260","9",42199000,42204988,5988
"45477","ENSG00000277264","6",32179816,32179876,60
"45478","ENSG00000277265","7",5871753,5872050,297
"45479","ENSG00000277268","17",36861674,36936670,74996
"45480","ENSG00000277270","20",61432868,61437630,4762
"45481","ENSG00000277282","21",10649400,10649835,435
"45482","ENSG00000277283","12",120116907,120119000,2093
"45483","ENSG00000277287","20",3239705,3245382,5677
"45484","ENSG00000277288","10",44292569,44294649,2080
"45485","ENSG00000277290","11",243099,243483,384
"45486","ENSG00000277297","9",66721158,66722760,1602
"45487","ENSG00000277299","12",109948389,109949029,640
"45488","ENSG00000277301","20",32509959,32520285,10326
"45489","ENSG00000277304","16",32916974,32946392,29418
"45490","ENSG00000277306","2",140234737,140234923,186
"45491","ENSG00000277310","18",50256036,50256461,425
"45492","ENSG00000277322","15",20531856,20541800,9944
"45493","ENSG00000277324","18",54268346,54270028,1682
"45494","ENSG00000277327","7",6715630,6720982,5352
"45495","ENSG00000277332","8",142638596,142640648,2052
"45496","ENSG00000277342","12",32109076,32109602,526
"45497","ENSG00000277344","1",16534081,16534224,143
"45498","ENSG00000277349","16",90174062,90175865,1803
"45499","ENSG00000277350","9",66942703,66952344,9641
"45500","ENSG00000277351","15",65049188,65049802,614
"45501","ENSG00000277352","21",44494874,44495519,645
"45502","ENSG00000277357","9",87825146,87825968,822
"45503","ENSG00000277358","13",45124015,45124143,128
"45504","ENSG00000277363","17",38530031,38605952,75921
"45505","ENSG00000277368","13",26222191,26222654,463
"45506","ENSG00000277369","16",11797468,11798275,807
"45507","ENSG00000277371","10",125869295,125869576,281
"45508","ENSG00000277373","20",17565501,17565851,350
"45509","ENSG00000277382","17",76709760,76710045,285
"45510","ENSG00000277383","19",47607873,47608454,581
"45511","ENSG00000277385","22",38281028,38281289,261
"45512","ENSG00000277386","13",33336216,33336716,500
"45513","ENSG00000277387","16",82688931,82689019,88
"45514","ENSG00000277388","4",47652669,47652743,74
"45515","ENSG00000277396","2",47383160,47383421,261
"45516","ENSG00000277397","1",53180921,53186900,5979
"45517","ENSG00000277399","17",38325530,38343847,18317
"45518","ENSG00000277400","GL000194.1",53590,115018,61428
"45519","ENSG00000277402","6",31355224,31355316,92
"45520","ENSG00000277406","1",146321214,146401647,80433
"45521","ENSG00000277411","6",15522195,15522300,105
"45522","ENSG00000277423","12",120703867,120704282,415
"45523","ENSG00000277425","20",5066082,5068154,2072
"45524","ENSG00000277426","17",39023394,39026742,3348
"45525","ENSG00000277435","15",22690454,22691158,704
"45526","ENSG00000277438","Y",20570222,20570519,297
"45527","ENSG00000277440","16",4430522,4431103,581
"45528","ENSG00000277443","6",113857345,113863475,6130
"45529","ENSG00000277447","18",3025069,3025387,318
"45530","ENSG00000277448","13",58165827,58209483,43656
"45531","ENSG00000277449","20",50184598,50191498,6900
"45532","ENSG00000277450","17",28373256,28373562,306
"45533","ENSG00000277452","1",150566562,150566860,298
"45534","ENSG00000277453","19",40426115,40426702,587
"45535","ENSG00000277455","5",24449351,24449615,264
"45536","ENSG00000277459","11",102109827,102110457,630
"45537","ENSG00000277462","1",247034637,247078811,44174
"45538","ENSG00000277463","17",62626031,62626453,422
"45539","ENSG00000277464","15",32602121,32602411,290
"45540","ENSG00000277465","9",99368447,99368566,119
"45541","ENSG00000277467","15",30612724,30612960,236
"45542","ENSG00000277475","KI270713.1",31698,32528,830
"45543","ENSG00000277476","17",68133201,68135935,2734
"45544","ENSG00000277478","17",49510817,49510900,83
"45545","ENSG00000277479","10",42578500,42578727,227
"45546","ENSG00000277481","16",71929538,71999978,70440
"45547","ENSG00000277483","3",48379834,48380132,298
"45548","ENSG00000277486","X",135637623,135642756,5133
"45549","ENSG00000277491","17",795306,795794,488
"45550","ENSG00000277493","19",23842549,23843230,681
"45551","ENSG00000277494","8",143213218,143217170,3952
"45552","ENSG00000277496","20",62648961,62650767,1806
"45553","ENSG00000277498","2",61858137,61860298,2161
"45554","ENSG00000277500","15",31787494,31787734,240
"45555","ENSG00000277501","17",37642947,37684252,41305
"45556","ENSG00000277504","16",87683945,87684477,532
"45557","ENSG00000277506","5",101581830,101582128,298
"45558","ENSG00000277509","3",44528955,44529391,436
"45559","ENSG00000277510","19",40450225,40450480,255
"45560","ENSG00000277511","17",32127595,32128454,859
"45561","ENSG00000277521","18",112256,112339,83
"45562","ENSG00000277526","8",2562813,2623382,60569
"45563","ENSG00000277527","2",102873183,102895780,22597
"45564","ENSG00000277531","19",46424697,46428951,4254
"45565","ENSG00000277534","18",26542971,26545791,2820
"45566","ENSG00000277535","X",119073226,119076373,3147
"45567","ENSG00000277541","X",48056310,48066583,10273
"45568","ENSG00000277542","17",48723692,48723772,80
"45569","ENSG00000277543","16",31428180,31428646,466
"45570","ENSG00000277544","7",65290429,65292776,2347
"45571","ENSG00000277545","13",112811566,112812158,592
"45572","ENSG00000277548","15",55346347,55346752,405
"45573","ENSG00000277550","20",38103524,38104961,1437
"45574","ENSG00000277556","9",104598457,104599413,956
"45575","ENSG00000277558","20",34476205,34476787,582
"45576","ENSG00000277559","16",54290965,54292422,1457
"45577","ENSG00000277561","15",22606022,22617854,11832
"45578","ENSG00000277562","19",52241765,52242440,675
"45579","ENSG00000277563","10",24255246,24255333,87
"45580","ENSG00000277566","12",113249466,113250042,576
"45581","ENSG00000277568","5",146510116,146510271,155
"45582","ENSG00000277572","21",14075950,14076038,88
"45583","ENSG00000277575","9",67203635,67208072,4437
"45584","ENSG00000277579","17",37034668,37043252,8584
"45585","ENSG00000277581","20",38962472,38962993,521
"45586","ENSG00000277586","8",24950955,24957110,6155
"45587","ENSG00000277587","19",9721903,9722410,507
"45588","ENSG00000277588","19",58334688,58334751,63
"45589","ENSG00000277589","17",36998598,37000034,1436
"45590","ENSG00000277590","2",207166400,207166498,98
"45591","ENSG00000277591","2",95003545,95003843,298
"45592","ENSG00000277592","3",59584169,59584445,276
"45593","ENSG00000277595","12",110032245,110032803,558
"45594","ENSG00000277597","17",1684726,1685151,425
"45595","ENSG00000277598","9",60546920,60547154,234
"45596","ENSG00000277602","16",1971655,1971896,241
"45597","ENSG00000277605","X",47476822,47477152,330
"45598","ENSG00000277608","9",23955760,23956444,684
"45599","ENSG00000277610","1",120942600,120942763,163
"45600","ENSG00000277617","1",32269338,32269597,259
"45601","ENSG00000277618","9",67797221,67797500,279
"45602","ENSG00000277619","5",135034521,135035894,1373
"45603","ENSG00000277621","17",12982613,12983002,389
"45604","ENSG00000277628","2",109124357,109124609,252
"45605","ENSG00000277630","GL000213.1",108007,139659,31652
"45606","ENSG00000277631","9",72670,89850,17180
"45607","ENSG00000277632","17",36088256,36090169,1913
"45608","ENSG00000277634","14",49839401,49839493,92
"45609","ENSG00000277635","3",109295239,109295498,259
"45610","ENSG00000277639","16",53035690,53052873,17183
"45611","ENSG00000277640","13",87765752,87765881,129
"45612","ENSG00000277646","9",29317833,29318952,1119
"45613","ENSG00000277651","14",65986967,65987447,480
"45614","ENSG00000277653","9",22117665,22117814,149
"45615","ENSG00000277654","15",94841059,95169864,328805
"45616","ENSG00000277655","1",146459449,146461859,2410
"45617","ENSG00000277661","6",29036021,29076524,40503
"45618","ENSG00000277662","13",41229180,41229676,496
"45619","ENSG00000277666","KI270727.1",100123,101141,1018
"45620","ENSG00000277672","12",49075039,49075802,763
"45621","ENSG00000277675","7",75225433,75234310,8877
"45622","ENSG00000277677","15",51858070,51858352,282
"45623","ENSG00000277678","1",145169519,145169664,145
"45624","ENSG00000277681","1",201863373,201863447,74
"45625","ENSG00000277684","13",48340797,48341330,533
"45626","ENSG00000277687","10",118692361,118693535,1174
"45627","ENSG00000277690","22",18527157,18527626,469
"45628","ENSG00000277692","20",32355053,32355734,681
"45629","ENSG00000277693","21",10328411,10342737,14326
"45630","ENSG00000277695","4",89747802,89755853,8051
"45631","ENSG00000277702","1",143419625,143420207,582
"45632","ENSG00000277705","12",11507162,11507408,246
"45633","ENSG00000277708","20",44841925,44842539,614
"45634","ENSG00000277713","9",130626297,130626363,66
"45635","ENSG00000277715","12",106250759,106252786,2027
"45636","ENSG00000277718","15",74379083,74390535,11452
"45637","ENSG00000277720","6",26219045,26219240,195
"45638","ENSG00000277721","X",46553522,46553775,253
"45639","ENSG00000277723","3",134367804,134367862,58
"45640","ENSG00000277726","1",11012662,11030528,17866
"45641","ENSG00000277728","17",73202968,73203431,463
"45642","ENSG00000277734","14",22547506,22552156,4650
"45643","ENSG00000277737","9",43109866,43125905,16039
"45644","ENSG00000277738","12",91634887,91635644,757
"45645","ENSG00000277740","8",69851148,69851436,288
"45646","ENSG00000277741","15",82519590,82526412,6822
"45647","ENSG00000277744","19",41373971,41374419,448
"45648","ENSG00000277745","X",155459415,155460005,590
"45649","ENSG00000277749","15",74311516,74319688,8172
"45650","ENSG00000277754","14",101145480,101145695,215
"45651","ENSG00000277757","10",45016080,45147221,131141
"45652","ENSG00000277758","10",47750864,47763592,12728
"45653","ENSG00000277759","19",39829716,39829802,86
"45654","ENSG00000277761","KI270728.1",1167457,1257196,89739
"45655","ENSG00000277763","14",56117316,56117990,674
"45656","ENSG00000277764","2",70900155,70900351,196
"45657","ENSG00000277766","19",16037009,16038455,1446
"45658","ENSG00000277767","13",110916004,110917827,1823
"45659","ENSG00000277769","6",45098021,45099260,1239
"45660","ENSG00000277771","22",49846456,49846720,264
"45661","ENSG00000277775","6",26250195,26250605,410
"45662","ENSG00000277778","9",41006999,41074617,67618
"45663","ENSG00000277782","15",80999593,80999981,388
"45664","ENSG00000277790","15",58456188,58456348,160
"45665","ENSG00000277791","17",38752741,38764225,11484
"45666","ENSG00000277794","13",40730981,40731253,272
"45667","ENSG00000277795","5",141259235,141261364,2129
"45668","ENSG00000277797","6",81551686,81554092,2406
"45669","ENSG00000277806","19",43976815,43977448,633
"45670","ENSG00000277809","2",44935585,44935908,323
"45671","ENSG00000277817","1",155951273,155951336,63
"45672","ENSG00000277825","19",16352462,16353182,720
"45673","ENSG00000277826","14",93637179,93637338,159
"45674","ENSG00000277829","20",38233251,38233799,548
"45675","ENSG00000277831","13",44369365,44369877,512
"45676","ENSG00000277836","KI270728.1",1270984,1271271,287
"45677","ENSG00000277837","18",57427133,57432112,4979
"45678","ENSG00000277840","12",117002463,117003152,689
"45679","ENSG00000277846","11",62853663,62853732,69
"45680","ENSG00000277851","12",92247697,92363832,116135
"45681","ENSG00000277852","2",89203509,89203906,397
"45682","ENSG00000277855","3",71581721,71628558,46837
"45683","ENSG00000277856","KI270726.1",26241,26534,293
"45684","ENSG00000277863","13",106903150,106904099,949
"45685","ENSG00000277865","15",22458903,22469230,10327
"45686","ENSG00000277866","5",150978419,150979175,756
"45687","ENSG00000277867","15",22714939,22715225,286
"45688","ENSG00000277869","9",64498517,64498745,228
"45689","ENSG00000277870","22",18422244,18500594,78350
"45690","ENSG00000277873","12",118024817,118025518,701
"45691","ENSG00000277876","X",30821815,30823407,1592
"45692","ENSG00000277879","10",117267116,117268668,1552
"45693","ENSG00000277882","1",161411597,161411802,205
"45694","ENSG00000277883","X",107974078,107985008,10930
"45695","ENSG00000277889","9",106600928,106601022,94
"45696","ENSG00000277892","11",61878216,61878278,62
"45697","ENSG00000277893","2",31522480,31580938,58458
"45698","ENSG00000277895","12",64451591,64452901,1310
"45699","ENSG00000277900","X",97081674,97081956,282
"45700","ENSG00000277901","20",23320958,23325352,4394
"45701","ENSG00000277911","17",36980167,36980422,255
"45702","ENSG00000277912","5",181043403,181043484,81
"45703","ENSG00000277914","13",86275493,86277262,1769
"45704","ENSG00000277916","1",29171285,29171453,168
"45705","ENSG00000277918","1",144560666,144560829,163
"45706","ENSG00000277930","Y",4993858,4999650,5792
"45707","ENSG00000277938","20",25229150,25231933,2783
"45708","ENSG00000277946","7",97998325,97998622,297
"45709","ENSG00000277948","2",175092401,175092587,186
"45710","ENSG00000277950","22",20070716,20070965,249
"45711","ENSG00000277952","12",8340182,8340397,215
"45712","ENSG00000277954","16",79202624,79206739,4115
"45713","ENSG00000277957","17",7563287,7578715,15428
"45714","ENSG00000277958","1",29041199,29041480,281
"45715","ENSG00000277959","10",131971202,131971533,331
"45716","ENSG00000277965","20",38711821,38712103,282
"45717","ENSG00000277966","7",27186892,27187124,232
"45718","ENSG00000277969","17",38702452,38704747,2295
"45719","ENSG00000277971","22",20429241,20446620,17379
"45720","ENSG00000277972","17",38730235,38735044,4809
"45721","ENSG00000277973","6",136206478,136206860,382
"45722","ENSG00000277977","19",52392659,52392755,96
"45723","ENSG00000277978","16",66565620,66566001,381
"45724","ENSG00000277981","10",77738246,77739015,769
"45725","ENSG00000277984","11",95057282,95057984,702
"45726","ENSG00000277987","15",98323902,98420998,97096
"45727","ENSG00000277988","15",20012741,20014208,1467
"45728","ENSG00000277991","21",7669397,7681742,12345
"45729","ENSG00000277997","2",307683,309424,1741
"45730","ENSG00000277998","2",164573741,164574054,313
"45731","ENSG00000277999","16",29272220,29272772,552
"45732","ENSG00000278000","18",80161752,80162413,661
"45733","ENSG00000278001","9",41700682,41701096,414
"45734","ENSG00000278002","14",49863072,49864379,1307
"45735","ENSG00000278007","19",4127492,4127732,240
"45736","ENSG00000278009","14",49601011,49601124,113
"45737","ENSG00000278011","12",88601862,88602195,333
"45738","ENSG00000278012","20",31970181,31970831,650
"45739","ENSG00000278013","15",82540870,82562374,21504
"45740","ENSG00000278017","18",62525919,62526325,406
"45741","ENSG00000278022","15",98660210,98660668,458
"45742","ENSG00000278023","17",35918066,35930773,12707
"45743","ENSG00000278026","3",181715185,181715293,108
"45744","ENSG00000278028","9",41672295,41672406,111
"45745","ENSG00000278030","7",142529290,142529762,472
"45746","ENSG00000278035","20",36233851,36234297,446
"45747","ENSG00000278038","14",49966399,49966511,112
"45748","ENSG00000278040","9",75016681,75016848,167
"45749","ENSG00000278041","20",21499261,21502934,3673
"45750","ENSG00000278044","22",18501794,18512187,10393
"45751","ENSG00000278048","17",43251829,43252019,190
"45752","ENSG00000278052","18",34225930,34226429,499
"45753","ENSG00000278053","17",37609739,37643446,33707
"45754","ENSG00000278054","9",41647825,41648035,210
"45755","ENSG00000278057","X",154271265,154295853,24588
"45756","ENSG00000278058","16",79605802,79606605,803
"45757","ENSG00000278060","2",72932974,72934355,1381
"45758","ENSG00000278071","14",103208100,103208876,776
"45759","ENSG00000278075","18",79900555,79900903,348
"45760","ENSG00000278077","9",41644771,41644981,210
"45761","ENSG00000278083","2",222945930,222946388,458
"45762","ENSG00000278084","12",121874193,121874337,144
"45763","ENSG00000278090","15",99014526,99031054,16528
"45764","ENSG00000278095","12",26273329,26273900,571
"45765","ENSG00000278097","17",36225246,36226807,1561
"45766","ENSG00000278100","10",14391875,14392196,321
"45767","ENSG00000278106","21",10397644,10397778,134
"45768","ENSG00000278107","18",76805151,76805736,585
"45769","ENSG00000278108","12",53056944,53057012,68
"45770","ENSG00000278109","17",43607436,43607723,287
"45771","ENSG00000278112","12",123519390,123519856,466
"45772","ENSG00000278122","9",40481558,40497592,16034
"45773","ENSG00000278124","1",22010650,22010946,296
"45774","ENSG00000278126","12",51201684,51202581,897
"45775","ENSG00000278128","6",23854444,23855457,1013
"45776","ENSG00000278129","19",58278955,58302791,23836
"45777","ENSG00000278130","9",138177426,138179774,2348
"45778","ENSG00000278131","2",91589494,91621421,31927
"45779","ENSG00000278133","16",31122235,31124064,1829
"45780","ENSG00000278135","4",25250545,25250639,94
"45781","ENSG00000278139","1",46043661,46176488,132827
"45782","ENSG00000278146","15",96230897,96231145,248
"45783","ENSG00000278147","14",45079849,45080189,340
"45784","ENSG00000278153","20",13368291,13368703,412
"45785","ENSG00000278156","13",44575893,44580432,4539
"45786","ENSG00000278158","21",44241847,44242081,234
"45787","ENSG00000278171","20",64278306,64278561,255
"45788","ENSG00000278172","13",29864372,29864629,257
"45789","ENSG00000278175","9",39748514,39810097,61583
"45790","ENSG00000278177","13",93226612,93227317,705
"45791","ENSG00000278184","14",19612191,19619490,7299
"45792","ENSG00000278192","20",6065966,6067897,1931
"45793","ENSG00000278193","8",72660584,72661470,886
"45794","ENSG00000278195","22",37204237,37212477,8240
"45795","ENSG00000278196","22",22822658,22823289,631
"45796","ENSG00000278200","17",81480523,81481570,1047
"45797","ENSG00000278202","15",82418651,82434235,15584
"45798","ENSG00000278205","7",56462536,56467771,5235
"45799","ENSG00000278206","6",143484979,143507327,22348
"45800","ENSG00000278212","Y",11153858,11215026,61168
"45801","ENSG00000278213","9",62559839,62569907,10068
"45802","ENSG00000278214","16",85137150,85149443,12293
"45803","ENSG00000278215","11",126376773,126376893,120
"45804","ENSG00000278218","X",11148584,11148769,185
"45805","ENSG00000278224","6",41780762,41787372,6610
"45806","ENSG00000278226","4",56810422,56810681,259
"45807","ENSG00000278231","20",48821688,48849458,27770
"45808","ENSG00000278234","3",150241777,150241860,83
"45809","ENSG00000278236","7",87184849,87185020,171
"45810","ENSG00000278238","13",52454775,52455331,556
"45811","ENSG00000278239","19",41833686,41835950,2264
"45812","ENSG00000278250","12",120018900,120019261,361
"45813","ENSG00000278254","7",9082557,9189857,107300
"45814","ENSG00000278255","12",2217462,2217920,458
"45815","ENSG00000278259","17",36495633,36543435,47802
"45816","ENSG00000278263","15",21742364,21742799,435
"45817","ENSG00000278264","19",55245186,55245250,64
"45818","ENSG00000278266","12",127147149,127150081,2932
"45819","ENSG00000278275","8",128009551,128011938,2387
"45820","ENSG00000278276","20",31580890,31581214,324
"45821","ENSG00000278278","22",20114686,20114751,65
"45822","ENSG00000278281","1",86357632,86357687,55
"45823","ENSG00000278283","X",55044749,55045121,372
"45824","ENSG00000278291","13",20699307,20703718,4411
"45825","ENSG00000278292","22",29432944,29435005,2061
"45826","ENSG00000278301","14",19371822,19373490,1668
"45827","ENSG00000278305","13",31419989,31437999,18010
"45828","ENSG00000278311","17",36544912,36589848,44936
"45829","ENSG00000278313","15",72604399,72605008,609
"45830","ENSG00000278318","19",44417519,44448578,31059
"45831","ENSG00000278328","19",55239912,55239976,64
"45832","ENSG00000278330","18",77112602,77115726,3124
"45833","ENSG00000278332","6",27510501,27510694,193
"45834","ENSG00000278333","10",85613017,85613186,169
"45835","ENSG00000278338","13",41955808,41981565,25757
"45836","ENSG00000278341","16",88708956,88710437,1481
"45837","ENSG00000278342","14",91554410,91554503,93
"45838","ENSG00000278344","12",120500735,120501090,355
"45839","ENSG00000278346","17",40380666,40381838,1172
"45840","ENSG00000278348","15",74162340,74162620,280
"45841","ENSG00000278351","12",45256473,45256726,253
"45842","ENSG00000278356","12",2885819,2886329,510
"45843","ENSG00000278367","20",35174355,35174919,564
"45844","ENSG00000278370","15",90650631,90651103,472
"45845","ENSG00000278374","8",123454981,123455107,126
"45846","ENSG00000278376","11",118791254,118793137,1883
"45847","ENSG00000278381","21",13654073,13654356,283
"45848","ENSG00000278383","20",25680781,25681246,465
"45849","ENSG00000278384","GL000218.1",51867,54893,3026
"45850","ENSG00000278385","12",47905122,47906865,1743
"45851","ENSG00000278388","7",93914987,93915108,121
"45852","ENSG00000278389","16",19111035,19111484,449
"45853","ENSG00000278390","13",41132939,41236686,103747
"45854","ENSG00000278395","17",36241701,36241806,105
"45855","ENSG00000278396","14",93334528,93335057,529
"45856","ENSG00000278399","12",56981211,56985960,4749
"45857","ENSG00000278400","12",56941174,56941482,308
"45858","ENSG00000278408","15",71547280,71549832,2552
"45859","ENSG00000278412","9",98229149,98229217,68
"45860","ENSG00000278413","13",26359529,26359702,173
"45861","ENSG00000278416","7",75344015,75359550,15535
"45862","ENSG00000278418","2",177313806,177313882,76
"45863","ENSG00000278419","10",3134566,3145166,10600
"45864","ENSG00000278420","22",36286847,36286907,60
"45865","ENSG00000278421","X",74274341,74274411,70
"45866","ENSG00000278424","7",110215891,110216380,489
"45867","ENSG00000278433","21",43609887,43609989,102
"45868","ENSG00000278434","16",4532216,4533670,1454
"45869","ENSG00000278438","4",146408583,146408688,105
"45870","ENSG00000278445","13",102903339,102904000,661
"45871","ENSG00000278446","7",9170948,9171273,325
"45872","ENSG00000278449","7",143382686,143382800,114
"45873","ENSG00000278455","1",243049782,243051619,1837
"45874","ENSG00000278456","15",100888472,100889106,634
"45875","ENSG00000278459","12",7856169,7856471,302
"45876","ENSG00000278462","13",46717423,46717688,265
"45877","ENSG00000278463","6",26033176,26033568,392
"45878","ENSG00000278464","18",34892013,34903504,11491
"45879","ENSG00000278467","1",223994262,223995196,934
"45880","ENSG00000278469","12",3124777,3125063,286
"45881","ENSG00000278472","15",33972059,33972515,456
"45882","ENSG00000278473","14",106443133,106443583,450
"45883","ENSG00000278475","12",45789189,45789657,468
"45884","ENSG00000278480","1",15226373,15227549,1176
"45885","ENSG00000278483","11",27514970,27515047,77
"45886","ENSG00000278484","10",120984966,120985596,630
"45887","ENSG00000278486","9",94432631,94433273,642
"45888","ENSG00000278487","5",43143362,43143514,152
"45889","ENSG00000278492","19",43978376,43978663,287
"45890","ENSG00000278493","15",41908204,41908714,510
"45891","ENSG00000278496","13",27077218,27077962,744
"45892","ENSG00000278498","10",103027336,103027498,162
"45893","ENSG00000278499","16",60358455,60359480,1025
"45894","ENSG00000278505","17",37375986,37392708,16722
"45895","ENSG00000278513","15",58732188,58733149,961
"45896","ENSG00000278514","15",91022766,91023200,434
"45897","ENSG00000278517","17",4970086,4970150,64
"45898","ENSG00000278518","10",133526259,133527513,1254
"45899","ENSG00000278520","12",42323700,42323859,159
"45900","ENSG00000278522","15",21408243,21440451,32208
"45901","ENSG00000278524","2",218341911,218341980,69
"45902","ENSG00000278525","20",20738433,20738731,298
"45903","ENSG00000278529","11",11783135,11783222,87
"45904","ENSG00000278530","X",80228489,80335364,106875
"45905","ENSG00000278531","10",45187292,45198323,11031
"45906","ENSG00000278532","18",69398726,69399249,523
"45907","ENSG00000278535","17",36591879,36600804,8925
"45908","ENSG00000278540","17",37084992,37406836,321844
"45909","ENSG00000278543","19",52473336,52475239,1903
"45910","ENSG00000278546","17",31560132,31560573,441
"45911","ENSG00000278549","1",145850587,145850645,58
"45912","ENSG00000278558","22",18527802,18530573,2771
"45913","ENSG00000278561","10",48064308,48119455,55147
"45914","ENSG00000278569","7",17205652,17205928,276
"45915","ENSG00000278570","15",71792638,71818259,25621
"45916","ENSG00000278572","1",26218581,26220476,1895
"45917","ENSG00000278576","14",88589231,88592408,3177
"45918","ENSG00000278586","7",102264706,102264979,273
"45919","ENSG00000278588","6",26272976,26273356,380
"45920","ENSG00000278590","2",85368282,85368580,298
"45921","ENSG00000278592","7",27187819,27188021,202
"45922","ENSG00000278594","14",19131842,19132890,1048
"45923","ENSG00000278595","20",4761300,4761696,396
"45924","ENSG00000278596","1",148388282,148388363,81
"45925","ENSG00000278599","17",38127951,38138862,10911
"45926","ENSG00000278600","15",79920195,79922455,2260
"45927","ENSG00000278601","10",110907483,110908182,699
"45928","ENSG00000278603","15",82472203,82472426,223
"45929","ENSG00000278607","18",75070197,75071091,894
"45930","ENSG00000278610","1",222815064,222994906,179842
"45931","ENSG00000278611","19",9538693,9539734,1041
"45932","ENSG00000278615","11",62662816,62665217,2401
"45933","ENSG00000278616","10",79682997,79685436,2439
"45934","ENSG00000278619","17",36601583,36608964,7381
"45935","ENSG00000278621","15",39588357,39588882,525
"45936","ENSG00000278626","15",20642799,20643448,649
"45937","ENSG00000278627","17",58202352,58203003,651
"45938","ENSG00000278631","2",94861362,94862667,1305
"45939","ENSG00000278633","KI270731.1",10598,13001,2403
"45940","ENSG00000278635","12",9415641,9416718,1077
"45941","ENSG00000278636","1",70430896,70431178,282
"45942","ENSG00000278637","6",26021679,26021990,311
"45943","ENSG00000278638","17",37045228,37052890,7662
"45944","ENSG00000278642","17",57955965,57956143,178
"45945","ENSG00000278643","19",11033727,11033912,185
"45946","ENSG00000278654","12",11500499,11501022,523
"45947","ENSG00000278655","22",23607041,23608407,1366
"45948","ENSG00000278657","22",22036344,22040065,3721
"45949","ENSG00000278658","3",129272146,129272243,97
"45950","ENSG00000278661","14",22503750,22503814,64
"45951","ENSG00000278662","15",82339998,82349475,9477
"45952","ENSG00000278665","16",28599241,28601881,2640
"45953","ENSG00000278668","17",32410159,32410746,587
"45954","ENSG00000278673","KI270727.1",20741,22392,1651
"45955","ENSG00000278677","6",27892757,27893149,392
"45956","ENSG00000278678","21",10576292,10576587,295
"45957","ENSG00000278681","16",35435303,35436341,1038
"45958","ENSG00000278683","7",101273322,101273715,393
"45959","ENSG00000278685","7",151190873,151205496,14623
"45960","ENSG00000278690","17",36012504,36012891,387
"45961","ENSG00000278698","13",106773623,106774279,656
"45962","ENSG00000278700","16",4658851,4659151,300
"45963","ENSG00000278701","17",20340743,20341045,302
"45964","ENSG00000278702","1",35399997,35400319,322
"45965","ENSG00000278703","18",57588611,57589091,480
"45966","ENSG00000278704","GL000009.2",56140,58376,2236
"45967","ENSG00000278705","6",26026815,26027252,437
"45968","ENSG00000278709","20",57710156,57712780,2624
"45969","ENSG00000278716","16",85489813,85490831,1018
"45970","ENSG00000278719","20",5990943,6005821,14878
"45971","ENSG00000278720","9",66042646,66043342,696
"45972","ENSG00000278724","X",151275509,151275789,280
"45973","ENSG00000278725","16",28602340,28604519,2179
"45974","ENSG00000278727","13",76887551,76891135,3584
"45975","ENSG00000278730","17",68126666,68129586,2920
"45976","ENSG00000278732","13",31975167,31975448,281
"45977","ENSG00000278733","12",28185625,28186190,565
"45978","ENSG00000278737","15",65083042,65083663,621
"45979","ENSG00000278740","17",68188547,68189165,618
"45980","ENSG00000278743","12",25385670,25386241,571
"45981","ENSG00000278744","6",134009033,134009218,185
"45982","ENSG00000278745","6",41252696,41252858,162
"45983","ENSG00000278746","14",32442341,32442639,298
"45984","ENSG00000278756","9",136746893,136746970,77
"45985","ENSG00000278757","1",516376,516479,103
"45986","ENSG00000278763","9",67725690,67725902,212
"45987","ENSG00000278764","2",46266690,46266971,281
"45988","ENSG00000278765","17",48066704,48067293,589
"45989","ENSG00000278766","2",97421075,97434847,13772
"45990","ENSG00000278768","11",117288453,117293571,5118
"45991","ENSG00000278770","17",45526466,45526746,280
"45992","ENSG00000278771","14",49853616,49853914,298
"45993","ENSG00000278782","KI270728.1",1157687,1240349,82662
"45994","ENSG00000278783","2",85783600,85783677,77
"45995","ENSG00000278784","14",24201612,24202811,1199
"45996","ENSG00000278794","17",1101007,1101273,266
"45997","ENSG00000278797","19",46533669,46534351,682
"45998","ENSG00000278799","3",48549961,48550021,60
"45999","ENSG00000278811","1",147258885,147517875,258990
"46000","ENSG00000278816","20",5061037,5061340,303
"46001","ENSG00000278817","KI270734.1",131494,137392,5898
"46002","ENSG00000278818","14",55285227,55285558,331
"46003","ENSG00000278819","7",92540268,92557877,17609
"46004","ENSG00000278824","5",71754378,71756301,1923
"46005","ENSG00000278828","6",27810064,27811300,1236
"46006","ENSG00000278829","17",42272069,42275571,3502
"46007","ENSG00000278830","10",27313723,27316587,2864
"46008","ENSG00000278831","10",124623353,124624079,726
"46009","ENSG00000278834","17",40648300,40649718,1418
"46010","ENSG00000278837","11",89954593,89954908,315
"46011","ENSG00000278838","X",46073651,46073935,284
"46012","ENSG00000278840","15",26557598,26557937,339
"46013","ENSG00000278842","12",50286244,50289231,2987
"46014","ENSG00000278845","17",38297023,38323217,26194
"46015","ENSG00000278847","Y",2934406,2934771,365
"46016","ENSG00000278857","2",90159840,90160335,495
"46017","ENSG00000278860","17",34614409,34614809,400
"46018","ENSG00000278861","12",123655528,123656128,600
"46019","ENSG00000278862","16",77657174,77660570,3396
"46020","ENSG00000278863","17",59362665,59363278,613
"46021","ENSG00000278864","17",17181504,17183257,1753
"46022","ENSG00000278865","5",10676096,10676423,327
"46023","ENSG00000278866","12",126675895,126676243,348
"46024","ENSG00000278867","17",32051030,32053208,2178
"46025","ENSG00000278869","22",49933198,49934074,876
"46026","ENSG00000278873","17",69232963,69235012,2049
"46027","ENSG00000278874","5",10070531,10070841,310
"46028","ENSG00000278875","19",31364297,31366098,1801
"46029","ENSG00000278876","17",81862778,81863102,324
"46030","ENSG00000278877","5",8754869,8755159,290
"46031","ENSG00000278878","21",6667304,6670667,3363
"46032","ENSG00000278879","11",74830574,74832510,1936
"46033","ENSG00000278880","4",156886645,156886862,217
"46034","ENSG00000278881","22",47115838,47117217,1379
"46035","ENSG00000278884","21",7020599,7025166,4567
"46036","ENSG00000278885","16",31566360,31567000,640
"46037","ENSG00000278886","8",18864681,18865247,566
"46038","ENSG00000278890","22",48052646,48058275,5629
"46039","ENSG00000278891","18",48147634,48150864,3230
"46040","ENSG00000278892","11",93071529,93072031,502
"46041","ENSG00000278893","16",64981123,64983227,2104
"46042","ENSG00000278894","7",113451072,113451402,330
"46043","ENSG00000278895","19",29915862,29917830,1968
"46044","ENSG00000278896","12",46404644,46407166,2522
"46045","ENSG00000278897","19",11856032,11858302,2270
"46046","ENSG00000278898","8",134764809,134767276,2467
"46047","ENSG00000278899","6",149717621,149718888,1267
"46048","ENSG00000278900","5",34105750,34106336,586
"46049","ENSG00000278901","5",140878073,140882642,4569
"46050","ENSG00000278902","18",73921939,73922631,692
"46051","ENSG00000278903","21",6318434,6360415,41981
"46052","ENSG00000278905","5",93600357,93603598,3241
"46053","ENSG00000278908","2",30677762,30679895,2133
"46054","ENSG00000278909","16",50555355,50558719,3364
"46055","ENSG00000278910","9",69296682,69311111,14429
"46056","ENSG00000278911","18",75103587,75106260,2673
"46057","ENSG00000278912","16",23696665,23697314,649
"46058","ENSG00000278913","5",6134303,6137171,2868
"46059","ENSG00000278914","8",98391401,98391514,113
"46060","ENSG00000278916","12",94460003,94462484,2481
"46061","ENSG00000278917","19",43891233,43895411,4178
"46062","ENSG00000278918","17",40348049,40350539,2490
"46063","ENSG00000278920","22",31051630,31068327,16697
"46064","ENSG00000278921","5",112419583,112420978,1395
"46065","ENSG00000278922","16",30526918,30528294,1376
"46066","ENSG00000278924","2",172423807,172424173,366
"46067","ENSG00000278925","5",141825708,141826325,617
"46068","ENSG00000278926","16",77800023,77801714,1691
"46069","ENSG00000278928","16",55704119,55706422,2303
"46070","ENSG00000278929","11",87565994,87566421,427
"46071","ENSG00000278931","21",8857260,8880976,23716
"46072","ENSG00000278932","21",9325013,9368775,43762
"46073","ENSG00000278933","18",43499173,43499836,663
"46074","ENSG00000278934","3",73624410,73627626,3216
"46075","ENSG00000278935","15",20141794,20146430,4636
"46076","ENSG00000278936","5",141183401,141201396,17995
"46077","ENSG00000278941","17",2235713,2236086,373
"46078","ENSG00000278943","4",145376909,145377957,1048
"46079","ENSG00000278948","22",37943050,37944898,1848
"46080","ENSG00000278949","12",132865855,132867958,2103
"46081","ENSG00000278950","16",32781883,32784138,2255
"46082","ENSG00000278952","11",65118310,65119111,801
"46083","ENSG00000278953","11",93592187,93592669,482
"46084","ENSG00000278954","17",41665566,41668031,2465
"46085","ENSG00000278955","21",6858539,6897263,38724
"46086","ENSG00000278959","7",93954044,93956519,2475
"46087","ENSG00000278960","22",25756318,25756669,351
"46088","ENSG00000278962","2",112188364,112190635,2271
"46089","ENSG00000278963","17",50722074,50724224,2150
"46090","ENSG00000278965","5",180078357,180081691,3334
"46091","ENSG00000278966","1",32973553,32974463,910
"46092","ENSG00000278967","1",62607766,62609584,1818
"46093","ENSG00000278969","12",24902309,24904681,2372
"46094","ENSG00000278970","5",180826871,180831605,4734
"46095","ENSG00000278971","18",70489630,70491205,1575
"46096","ENSG00000278972","17",69433084,69435533,2449
"46097","ENSG00000278973","12",124622290,124623069,779
"46098","ENSG00000278974","4",188740507,188741281,774
"46099","ENSG00000278975","16",6703883,6705558,1675
"46100","ENSG00000278979","16",12374355,12376032,1677
"46101","ENSG00000278981","4",154235980,154237598,1618
"46102","ENSG00000278982","10",7411599,7413467,1868
"46103","ENSG00000278983","18",48564795,48568342,3547
"46104","ENSG00000278985","16",80982319,80984094,1775
"46105","ENSG00000278986","18",35972151,35973916,1765
"46106","ENSG00000278987","16",1688355,1690536,2181
"46107","ENSG00000278989","11",86434924,86437282,2358
"46108","ENSG00000278991","15",77063397,77064910,1513
"46109","ENSG00000278992","10",76270206,76270800,594
"46110","ENSG00000278993","12",110501614,110503441,1827
"46111","ENSG00000278994","16",18201501,18201956,455
"46112","ENSG00000278995","16",74683,74961,278
"46113","ENSG00000278996","21",8197620,8227646,30026
"46114","ENSG00000278997","1",33141871,33143230,1359
"46115","ENSG00000278998","7",155222903,155223851,948
"46116","ENSG00000278999","19",47661657,47663895,2238
"46117","ENSG00000279001","12",121096027,121096429,402
"46118","ENSG00000279004","11",38013510,38014141,631
"46119","ENSG00000279006","22",25048967,25051966,2999
"46120","ENSG00000279013","4",91603275,91605292,2017
"46121","ENSG00000279014","15",45214448,45215044,596
"46122","ENSG00000279015","2",225761559,225762112,553
"46123","ENSG00000279016","4",148819351,148819956,605
"46124","ENSG00000279017","3",45749627,45750651,1024
"46125","ENSG00000279019","16",57140896,57144586,3690
"46126","ENSG00000279020","18",13239543,13242076,2533
"46127","ENSG00000279021","16",81463892,81464859,967
"46128","ENSG00000279022","6",80440730,80441172,442
"46129","ENSG00000279023","12",132360734,132361198,464
"46130","ENSG00000279024","2",136230753,136233245,2492
"46131","ENSG00000279025","13",38372856,38373935,1079
"46132","ENSG00000279026","14",73580694,73582918,2224
"46133","ENSG00000279028","5",140966212,140966490,278
"46134","ENSG00000279029","10",24481180,24483034,1854
"46135","ENSG00000279030","16",55486618,55488777,2159
"46136","ENSG00000279031","16",3292879,3293403,524
"46137","ENSG00000279032","14",30370108,30373115,3007
"46138","ENSG00000279035","17",75130883,75133043,2160
"46139","ENSG00000279036","17",49494223,49497800,3577
"46140","ENSG00000279039","19",20207192,20209789,2597
"46141","ENSG00000279040","17",2101542,2101667,125
"46142","ENSG00000279041","8",30552345,30553766,1421
"46143","ENSG00000279042","18",14990707,14993235,2528
"46144","ENSG00000279043","7",108900105,108905226,5121
"46145","ENSG00000279044","19",13081966,13082564,598
"46146","ENSG00000279046","11",134985683,134986799,1116
"46147","ENSG00000279047","5",141046260,141096402,50142
"46148","ENSG00000279048","7",17940503,17942922,2419
"46149","ENSG00000279050","15",25135642,25138055,2413
"46150","ENSG00000279057","16",2620222,2621794,1572
"46151","ENSG00000279058","10",46337224,46358714,21490
"46152","ENSG00000279059","17",54956760,54958426,1666
"46153","ENSG00000279061","1",172752586,172752924,338
"46154","ENSG00000279062","21",10136419,10137004,585
"46155","ENSG00000279063","19",55467438,55467934,496
"46156","ENSG00000279064","21",5707004,5709456,2452
"46157","ENSG00000279065","13",20194412,20196005,1593
"46158","ENSG00000279066","17",82425498,82427310,1812
"46159","ENSG00000279067","7",96118647,96119995,1348
"46160","ENSG00000279068","5",141182409,141188582,6173
"46161","ENSG00000279069","17",58006674,58008187,1513
"46162","ENSG00000279070","2",74196698,74198560,1862
"46163","ENSG00000279071","12",124537844,124539677,1833
"46164","ENSG00000279072","7",56809214,56848800,39586
"46165","ENSG00000279074","18",35483431,35483667,236
"46166","ENSG00000279075","5",8458842,8459183,341
"46167","ENSG00000279076","6",44551577,44553281,1704
"46168","ENSG00000279077","18",79352458,79354567,2109
"46169","ENSG00000279078","7",127997597,128000077,2480
"46170","ENSG00000279080","22",38130216,38150612,20396
"46171","ENSG00000279081","13",18206570,18207466,896
"46172","ENSG00000279082","20",21569976,21666621,96645
"46173","ENSG00000279083","9",35360540,35362054,1514
"46174","ENSG00000279085","22",25009685,25015072,5387
"46175","ENSG00000279086","7",116209234,116211511,2277
"46176","ENSG00000279088","10",73742995,73744230,1235
"46177","ENSG00000279089","17",51183191,51186403,3212
"46178","ENSG00000279090","11",132403360,132404060,700
"46179","ENSG00000279091","15",97533738,97541476,7738
"46180","ENSG00000279092","15",34415450,34420273,4823
"46181","ENSG00000279093","11",65561484,65561607,123
"46182","ENSG00000279094","21",5499151,5502542,3391
"46183","ENSG00000279095","19",44664131,44666158,2027
"46184","ENSG00000279096","1",48102068,48104736,2668
"46185","ENSG00000279098","4",99942081,99942522,441
"46186","ENSG00000279099","8",35254344,35256605,2261
"46187","ENSG00000279100","16",74150520,74151299,779
"46188","ENSG00000279103","19",44246478,44248374,1896
"46189","ENSG00000279104","7",49760897,49762764,1867
"46190","ENSG00000279106","16",29204633,29205855,1222
"46191","ENSG00000279107","5",21493436,21494596,1160
"46192","ENSG00000279108","19",40840159,40842039,1880
"46193","ENSG00000279110","22",25052122,25065241,13119
"46194","ENSG00000279113","12",132332005,132332432,427
"46195","ENSG00000279114","6",122471923,122484161,12238
"46196","ENSG00000279117","11",75260129,75262466,2337
"46197","ENSG00000279118","5",126496279,126498604,2325
"46198","ENSG00000279121","12",124555905,124556432,527
"46199","ENSG00000279123","16",70778433,70779145,712
"46200","ENSG00000279124","13",18279320,18309934,30614
"46201","ENSG00000279127","6",49721931,49724007,2076
"46202","ENSG00000279128","12",131022769,131024741,1972
"46203","ENSG00000279129","16",78550739,78553296,2557
"46204","ENSG00000279130","5",143406959,143407420,461
"46205","ENSG00000279133","17",62003700,62007518,3818
"46206","ENSG00000279134","12",58094914,58098013,3099
"46207","ENSG00000279135","13",20712431,20714146,1715
"46208","ENSG00000279137","9",126518840,126520773,1933
"46209","ENSG00000279138","8",104478539,104480783,2244
"46210","ENSG00000279139","4",158109500,158110153,653
"46211","ENSG00000279140","14",104815449,104815753,304
"46212","ENSG00000279141","9",136612024,136617181,5157
"46213","ENSG00000279142","16",86595189,86597639,2450
"46214","ENSG00000279143","17",83132647,83136150,3503
"46215","ENSG00000279144","3",52848085,52848553,468
"46216","ENSG00000279145","15",55171378,55176739,5361
"46217","ENSG00000279146","12",130465008,130466315,1307
"46218","ENSG00000279147","3",141936707,141938547,1840
"46219","ENSG00000279148","12",100026248,100027540,1292
"46220","ENSG00000279149","13",30344672,30347167,2495
"46221","ENSG00000279151","1",16701546,16705594,4048
"46222","ENSG00000279153","12",131645918,131646444,526
"46223","ENSG00000279154","9",88177695,88178578,883
"46224","ENSG00000279155","X",48939992,48940808,816
"46225","ENSG00000279159","22",29978950,30028236,49286
"46226","ENSG00000279160","2",176189919,176192538,2619
"46227","ENSG00000279161","19",46636810,46639161,2351
"46228","ENSG00000279162","16",2592514,2594563,2049
"46229","ENSG00000279163","11",89704164,89704658,494
"46230","ENSG00000279164","20",23148086,23149939,1853
"46231","ENSG00000279165","16",34941977,34943880,1903
"46232","ENSG00000279166","2",144494265,144496878,2613
"46233","ENSG00000279167","21",8701461,8701562,101
"46234","ENSG00000279168","7",102579104,102679295,100191
"46235","ENSG00000279170","6",99520693,99589899,69206
"46236","ENSG00000279171","12",126677262,126677806,544
"46237","ENSG00000279173","12",25423600,25424942,1342
"46238","ENSG00000279174","17",8013327,8016378,3051
"46239","ENSG00000279175","22",44102779,44116232,13453
"46240","ENSG00000279176","12",104552073,104553447,1374
"46241","ENSG00000279179","1",33162851,33166298,3447
"46242","ENSG00000279180","12",128288159,128289056,897
"46243","ENSG00000279181","2",73998337,73998548,211
"46244","ENSG00000279182","22",50316035,50317025,990
"46245","ENSG00000279187","17",81262920,81265401,2481
"46246","ENSG00000279189","11",133297189,133302634,5445
"46247","ENSG00000279190","12",97150081,97154627,4546
"46248","ENSG00000279191","2",111321433,111324812,3379
"46249","ENSG00000279192","15",24985053,24988232,3179
"46250","ENSG00000279193","12",130121925,130122974,1049
"46251","ENSG00000279196","16",30984630,30988270,3640
"46252","ENSG00000279197","5",133574829,133575298,469
"46253","ENSG00000279198","19",16074293,16077395,3102
"46254","ENSG00000279199","17",40113215,40115442,2227
"46255","ENSG00000279200","17",17616043,17617745,1702
"46256","ENSG00000279201","2",74191388,74192245,857
"46257","ENSG00000279202","16",24098239,24099971,1732
"46258","ENSG00000279203","19",15383202,15383832,630
"46259","ENSG00000279204","5",159106380,159108617,2237
"46260","ENSG00000279205","2",176822030,176823653,1623
"46261","ENSG00000279206","16",72772673,72773272,599
"46262","ENSG00000279207","17",58095672,58101479,5807
"46263","ENSG00000279208","21",9369285,9376645,7360
"46264","ENSG00000279209","11",91013787,91015299,1512
"46265","ENSG00000279211","21",9580024,9580415,391
"46266","ENSG00000279212","10",26695091,26697625,2534
"46267","ENSG00000279213","21",8801362,8801880,518
"46268","ENSG00000279214","1",48262230,48263179,949
"46269","ENSG00000279217","22",36071000,36085573,14573
"46270","ENSG00000279218","2",234082259,234084490,2231
"46271","ENSG00000279220","2",206203543,206265326,61783
"46272","ENSG00000279221","18",69659837,69663413,3576
"46273","ENSG00000279222","5",1858409,1859890,1481
"46274","ENSG00000279223","7",143224042,143224234,192
"46275","ENSG00000279225","16",63397707,63397946,239
"46276","ENSG00000279226","21",6520344,6520670,326
"46277","ENSG00000279227","2",118014174,118015673,1499
"46278","ENSG00000279232","5",98792861,98795766,2905
"46279","ENSG00000279233","12",125138245,125141711,3466
"46280","ENSG00000279235","15",78906127,78906809,682
"46281","ENSG00000279236","18",62551203,62552505,1302
"46282","ENSG00000279237","13",110265251,110266113,862
"46283","ENSG00000279240","5",136376348,136397042,20694
"46284","ENSG00000279243","11",65487241,65488714,1473
"46285","ENSG00000279246","11",61352244,61354477,2233
"46286","ENSG00000279248","11",89533645,89534043,398
"46287","ENSG00000279249","16",49282021,49350504,68483
"46288","ENSG00000279250","18",48755693,48756318,625
"46289","ENSG00000279251","17",19855747,19856164,417
"46290","ENSG00000279253","20",35262727,35264187,1460
"46291","ENSG00000279254","2",46668870,46670778,1908
"46292","ENSG00000279255","16",707650,709067,1417
"46293","ENSG00000279256","9",26642697,26644595,1898
"46294","ENSG00000279259","17",80147250,80148596,1346
"46295","ENSG00000279261","1",234757619,234760056,2437
"46296","ENSG00000279265","7",127349833,127350293,460
"46297","ENSG00000279266","11",20131730,20135465,3735
"46298","ENSG00000279267","2",113605867,113607908,2041
"46299","ENSG00000279268","15",65226472,65226697,225
"46300","ENSG00000279269","11",93206990,93207583,593
"46301","ENSG00000279271","8",17498647,17499238,591
"46302","ENSG00000279273","17",80463451,80465593,2142
"46303","ENSG00000279274","Y",24362335,24362409,74
"46304","ENSG00000279275","18",13279415,13280110,695
"46305","ENSG00000279276","16",23962951,23963351,400
"46306","ENSG00000279277","3",108032456,108039916,7460
"46307","ENSG00000279278","22",22264601,22273020,8419
"46308","ENSG00000279281","17",57448218,57450291,2073
"46309","ENSG00000279283","12",131896500,131898239,1739
"46310","ENSG00000279284","6",41381392,41381832,440
"46311","ENSG00000279285","18",12199345,12200089,744
"46312","ENSG00000279286","14",91572444,91575271,2827
"46313","ENSG00000279288","7",113075124,113077181,2057
"46314","ENSG00000279289","6",71386852,71390829,3977
"46315","ENSG00000279294","16",81618505,81620563,2058
"46316","ENSG00000279295","11",79966805,79968708,1903
"46317","ENSG00000279296","17",6772831,6776116,3285
"46318","ENSG00000279297","11",89297717,89298199,482
"46319","ENSG00000279298","22",25251523,25252602,1079
"46320","ENSG00000279300","19",17622447,17623338,891
"46321","ENSG00000279301","1",248623557,248635091,11534
"46322","ENSG00000279302","8",27701194,27703789,2595
"46323","ENSG00000279304","11",93133855,93134164,309
"46324","ENSG00000279305","3",154334809,154337047,2238
"46325","ENSG00000279306","1",228486188,228487120,932
"46326","ENSG00000279307","2",20529467,20529976,509
"46327","ENSG00000279310","12",67065018,67065278,260
"46328","ENSG00000279311","3",158869898,158871821,1923
"46329","ENSG00000279314","13",31960325,31961946,1621
"46330","ENSG00000279315","10",112831169,112832454,1285
"46331","ENSG00000279317","2",210171518,210233976,62458
"46332","ENSG00000279319","18",44986109,44989203,3094
"46333","ENSG00000279320","3",146504570,146506560,1990
"46334","ENSG00000279321","21",9913117,9914846,1729
"46335","ENSG00000279322","20",25226448,25226735,287
"46336","ENSG00000279324","1",49994318,49996218,1900
"46337","ENSG00000279325","13",53193667,53198540,4873
"46338","ENSG00000279326","7",80972516,80974724,2208
"46339","ENSG00000279328","3",126432796,126434569,1773
"46340","ENSG00000279329","19",34675717,34677581,1864
"46341","ENSG00000279330","16",3273609,3275807,2198
"46342","ENSG00000279331","8",93740121,93740773,652
"46343","ENSG00000279332","18",24135468,24135829,361
"46344","ENSG00000279334","12",124561869,124562283,414
"46345","ENSG00000279336","9",34201273,34201515,242
"46346","ENSG00000279337","17",30724982,30725181,199
"46347","ENSG00000279339","17",78897264,78900152,2888
"46348","ENSG00000279340","17",2122342,2122508,166
"46349","ENSG00000279341","11",87718667,87721233,2566
"46350","ENSG00000279342","11",124789240,124792818,3578
"46351","ENSG00000279343","12",130350996,130351707,711
"46352","ENSG00000279344","16",53478957,53481550,2593
"46353","ENSG00000279345","22",49805452,49807208,1756
"46354","ENSG00000279347","8",119838736,119840385,1649
"46355","ENSG00000279348","2",216211404,216213519,2115
"46356","ENSG00000279349","3",112525548,112528142,2594
"46357","ENSG00000279352","18",14010054,14010917,863
"46358","ENSG00000279353","11",74698231,74699658,1427
"46359","ENSG00000279354","18",46915021,46915623,602
"46360","ENSG00000279355","6",161160105,161161982,1877
"46361","ENSG00000279356","16",50072862,50074986,2124
"46362","ENSG00000279357","16",8666762,8667271,509
"46363","ENSG00000279358","11",126934886,126937150,2264
"46364","ENSG00000279359","10",80249710,80254121,4411
"46365","ENSG00000279360","12",110056916,110057275,359
"46366","ENSG00000279361","17",67637774,67638973,1199
"46367","ENSG00000279365","21",36485867,36487760,1893
"46368","ENSG00000279366","18",47912207,47912504,297
"46369","ENSG00000279368","6",6685148,6686984,1836
"46370","ENSG00000279369","17",63700847,63702670,1823
"46371","ENSG00000279370","5",131261321,131261607,286
"46372","ENSG00000279372","17",82035403,82035800,397
"46373","ENSG00000279373","15",78537681,78538946,1265
"46374","ENSG00000279375","5",141191599,141194088,2489
"46375","ENSG00000279376","4",147025914,147030072,4158
"46376","ENSG00000279377","19",21965708,21968529,2821
"46377","ENSG00000279378","16",79675685,79677715,2030
"46378","ENSG00000279379","4",19257951,19258337,386
"46379","ENSG00000279381","21",9088188,9088391,203
"46380","ENSG00000279382","17",76090308,76091669,1361
"46381","ENSG00000279384","4",168843988,168844735,747
"46382","ENSG00000279386","4",37866561,37867091,530
"46383","ENSG00000279387","19",29506966,29509041,2075
"46384","ENSG00000279388","12",131478844,131483034,4190
"46385","ENSG00000279390","21",15050189,15052379,2190
"46386","ENSG00000279391","11",8075573,8077781,2208
"46387","ENSG00000279392","14",55229217,55229681,464
"46388","ENSG00000279393","13",28495633,28497267,1634
"46389","ENSG00000279394","15",79875920,79878179,2259
"46390","ENSG00000279395","11",55811367,55812476,1109
"46391","ENSG00000279397","18",79515798,79516057,259
"46392","ENSG00000279398","6",108178871,108179317,446
"46393","ENSG00000279400","5",36667717,36669958,2241
"46394","ENSG00000279404","19",20926777,20928714,1937
"46395","ENSG00000279405","19",56480397,56483977,3580
"46396","ENSG00000279406","10",71364243,71366374,2131
"46397","ENSG00000279407","19",45714387,45717381,2994
"46398","ENSG00000279409","15",40258501,40260370,1869
"46399","ENSG00000279410","16",17192863,17194232,1369
"46400","ENSG00000279411","12",58103907,58105935,2028
"46401","ENSG00000279412","16",70713987,70716890,2903
"46402","ENSG00000279413","X",15702602,15703243,641
"46403","ENSG00000279414","21",9026821,9027329,508
"46404","ENSG00000279415","16",17227023,17228000,977
"46405","ENSG00000279416","18",79085134,79086435,1301
"46406","ENSG00000279417","15",30344307,30348236,3929
"46407","ENSG00000279418","7",156540491,156541103,612
"46408","ENSG00000279419","7",124742312,124745017,2705
"46409","ENSG00000279420","16",74053365,74053965,600
"46410","ENSG00000279421","15",78599892,78600013,121
"46411","ENSG00000279422","X",49165576,49165972,396
"46412","ENSG00000279425","19",24078481,24080669,2188
"46413","ENSG00000279427","16",52436772,52437474,702
"46414","ENSG00000279428","17",18107334,18110463,3129
"46415","ENSG00000279429","7",27412164,27412891,727
"46416","ENSG00000279430","1",159910094,159910554,460
"46417","ENSG00000279431","17",30551193,30551802,609
"46418","ENSG00000279432","17",2639297,2642418,3121
"46419","ENSG00000279433","18",77108284,77110537,2253
"46420","ENSG00000279434","14",35086035,35088059,2024
"46421","ENSG00000279437","X",83506023,83509214,3191
"46422","ENSG00000279438","11",91093875,91094260,385
"46423","ENSG00000279439","18",25200976,25202837,1861
"46424","ENSG00000279440","22",27019369,27024550,5181
"46425","ENSG00000279442","22",15298378,15304556,6178
"46426","ENSG00000279443","1",28544460,28546542,2082
"46427","ENSG00000279444","12",63151065,63154006,2941
"46428","ENSG00000279445","15",21683038,21683962,924
"46429","ENSG00000279446","5",127073587,127075604,2017
"46430","ENSG00000279447","20",23071547,23072722,1175
"46431","ENSG00000279452","19",2949035,2950644,1609
"46432","ENSG00000279453","6",122436789,122439223,2434
"46433","ENSG00000279454","11",93587703,93588559,856
"46434","ENSG00000279456","9",41061290,41062917,1627
"46435","ENSG00000279457","1",185217,195411,10194
"46436","ENSG00000279458","10",46370759,46382626,11867
"46437","ENSG00000279459","11",70603304,70604859,1555
"46438","ENSG00000279460","4",184984277,184988127,3850
"46439","ENSG00000279461","14",74003396,74003470,74
"46440","ENSG00000279462","12",125300936,125301917,981
"46441","ENSG00000279463","13",73844683,73845130,447
"46442","ENSG00000279464","4",67607856,67610313,2457
"46443","ENSG00000279465","3",15731877,15732536,659
"46444","ENSG00000279466","12",133073516,133073983,467
"46445","ENSG00000279467","22",23865248,23873277,8029
"46446","ENSG00000279469","5",134394360,134395008,648
"46447","ENSG00000279470","5",51963992,51964445,453
"46448","ENSG00000279474","18",79144752,79146918,2166
"46449","ENSG00000279475","12",127825938,127826286,348
"46450","ENSG00000279476","16",81517824,81520617,2793
"46451","ENSG00000279478","12",130383364,130383890,526
"46452","ENSG00000279479","18",6727053,6728981,1928
"46453","ENSG00000279480","12",132200436,132201287,851
"46454","ENSG00000279481","4",145830456,145832980,2524
"46455","ENSG00000279482","7",103161947,103162660,713
"46456","ENSG00000279483","7",137513859,137513933,74
"46457","ENSG00000279484","2",238152889,238155994,3105
"46458","ENSG00000279485","2",63517892,63519268,1376
"46459","ENSG00000279486","11",6783020,6791558,8538
"46460","ENSG00000279488","19",1372238,1374364,2126
"46461","ENSG00000279489","9",35001913,35003663,1750
"46462","ENSG00000279490","16",17082295,17085049,2754
"46463","ENSG00000279491","11",61967794,61969490,1696
"46464","ENSG00000279494","22",49851425,49853364,1939
"46465","ENSG00000279495","14",105370418,105372918,2500
"46466","ENSG00000279498","6",108359084,108359863,779
"46467","ENSG00000279499","13",30196443,30196881,438
"46468","ENSG00000279500","12",128813186,128814750,1564
"46469","ENSG00000279501","21",8996496,9018670,22174
"46470","ENSG00000279502","10",72756398,72757016,618
"46471","ENSG00000279503","9",90158028,90158646,618
"46472","ENSG00000279507","3",128914833,128915060,227
"46473","ENSG00000279509","16",47218026,47218768,742
"46474","ENSG00000279511","13",37142967,37146718,3751
"46475","ENSG00000279512","2",133117004,133119052,2048
"46476","ENSG00000279513","1",117493515,117495006,1491
"46477","ENSG00000279516","13",18195297,18232024,36727
"46478","ENSG00000279518","8",134783694,134785879,2185
"46479","ENSG00000279519","2",36839922,36842539,2617
"46480","ENSG00000279520","16",2516658,2517999,1341
"46481","ENSG00000279521","14",25820366,25822741,2375
"46482","ENSG00000279523","16",56108980,56109970,990
"46483","ENSG00000279525","7",95542145,95544542,2397
"46484","ENSG00000279526","2",23616499,23617987,1488
"46485","ENSG00000279527","12",124529722,124530228,506
"46486","ENSG00000279528","X",48580741,48581165,424
"46487","ENSG00000279529","19",16572624,16575340,2716
"46488","ENSG00000279530","12",70321542,70324274,2732
"46489","ENSG00000279532","17",28373673,28374301,628
"46490","ENSG00000279536","7",149881477,149882105,628
"46491","ENSG00000279537","15",40244925,40247366,2441
"46492","ENSG00000279539","19",42242775,42244973,2198
"46493","ENSG00000279541","19",57293083,57294469,1386
"46494","ENSG00000279542","17",10821901,10822243,342
"46495","ENSG00000279543","18",37473330,37473977,647
"46496","ENSG00000279544","2",32563328,32566436,3108
"46497","ENSG00000279548","22",25022594,25024652,2058
"46498","ENSG00000279549","11",61143380,61145464,2084
"46499","ENSG00000279550","13",25190063,25190317,254
"46500","ENSG00000279551","12",69660034,69661429,1395
"46501","ENSG00000279554","16",24208105,24208478,373
"46502","ENSG00000279555","17",57277920,57280017,2097
"46503","ENSG00000279557","5",43586367,43587543,1176
"46504","ENSG00000279558","5",141078076,141084481,6405
"46505","ENSG00000279561","9",41269916,41273997,4081
"46506","ENSG00000279562","17",2117626,2117772,146
"46507","ENSG00000279565","6",88172261,88175762,3501
"46508","ENSG00000279567","17",15365323,15365877,554
"46509","ENSG00000279568","16",2575628,2577373,1745
"46510","ENSG00000279569","16",70661667,70665836,4169
"46511","ENSG00000279570","17",78691266,78691979,713
"46512","ENSG00000279571","9",127690098,127690840,742
"46513","ENSG00000279572","17",77571418,77572516,1098
"46514","ENSG00000279573","17",67955314,67957291,1977
"46515","ENSG00000279575","10",10394670,10395737,1067
"46516","ENSG00000279578","7",48847766,48851625,3859
"46517","ENSG00000279579","21",8759077,8761335,2258
"46518","ENSG00000279581","12",130980667,130981367,700
"46519","ENSG00000279583","16",29595130,29596137,1007
"46520","ENSG00000279584","5",131797415,131797929,514
"46521","ENSG00000279586","11",117611101,117612017,916
"46522","ENSG00000279587","X",117894632,117895683,1051
"46523","ENSG00000279588","15",100782417,100786189,3772
"46524","ENSG00000279589","16",53310797,53311989,1192
"46525","ENSG00000279590","19",3567278,3567959,681
"46526","ENSG00000279591","16",73015047,73016016,969
"46527","ENSG00000279592","16",71859680,71860676,996
"46528","ENSG00000279593","14",93895762,93897759,1997
"46529","ENSG00000279594","14",75011269,75012851,1582
"46530","ENSG00000279595","15",21148334,21152970,4636
"46531","ENSG00000279597","22",49534062,49534926,864
"46532","ENSG00000279598","2",178554561,178558966,4405
"46533","ENSG00000279599","19",3371395,3371602,207
"46534","ENSG00000279600","17",78008421,78008855,434
"46535","ENSG00000279601","X",119693568,119696059,2491
"46536","ENSG00000279602","17",43360041,43361361,1320
"46537","ENSG00000279603","11",89300709,89301477,768
"46538","ENSG00000279604","16",86035627,86036419,792
"46539","ENSG00000279605","8",143578358,143583304,4946
"46540","ENSG00000279606","17",56471142,56473647,2505
"46541","ENSG00000279607","10",93071972,93073466,1494
"46542","ENSG00000279608","9",35038625,35044326,5701
"46543","ENSG00000279609","9",105656369,105657989,1620
"46544","ENSG00000279611","19",58350795,58351720,925
"46545","ENSG00000279613","17",82648849,82650657,1808
"46546","ENSG00000279616","6",87356831,87358605,1774
"46547","ENSG00000279617","19",17871273,17871705,432
"46548","ENSG00000279619","19",35137645,35139580,1935
"46549","ENSG00000279620","16",17249674,17251395,1721
"46550","ENSG00000279622","16",84917377,84924808,7431
"46551","ENSG00000279623","10",21865335,21865921,586
"46552","ENSG00000279625","1",22364630,22366482,1852
"46553","ENSG00000279628","15",20658900,20664970,6070
"46554","ENSG00000279629","18",48661840,48662635,795
"46555","ENSG00000279631","10",22252072,22254589,2517
"46556","ENSG00000279632","11",61426448,61427325,877
"46557","ENSG00000279633","14",61801713,61803634,1921
"46558","ENSG00000279636","14",58288033,58289158,1125
"46559","ENSG00000279637","18",79420836,79422780,1944
"46560","ENSG00000279638","5",54286194,54286331,137
"46561","ENSG00000279639","15",21574225,21575207,982
"46562","ENSG00000279640","12",132100013,132100820,807
"46563","ENSG00000279641","17",7242200,7243814,1614
"46564","ENSG00000279642","22",44486295,44486914,619
"46565","ENSG00000279645","15",96285068,96289265,4197
"46566","ENSG00000279648","21",17705408,17707455,2047
"46567","ENSG00000279649","16",68290087,68292790,2703
"46568","ENSG00000279650","12",130775694,130776546,852
"46569","ENSG00000279652","22",35992321,36000469,8148
"46570","ENSG00000279653","19",2002580,2003581,1001
"46571","ENSG00000279655","7",27380562,27381206,644
"46572","ENSG00000279656","14",23023083,23024217,1134
"46573","ENSG00000279658","3",97836986,97874691,37705
"46574","ENSG00000279659","6",79573877,79575530,1653
"46575","ENSG00000279660","17",15260513,15261841,1328
"46576","ENSG00000279662","16",10445309,10449747,4438
"46577","ENSG00000279663","2",16541690,16545695,4005
"46578","ENSG00000279665","15",50742702,50743276,574
"46579","ENSG00000279666","16",35903117,35904916,1799
"46580","ENSG00000279667","1",40473055,40474059,1004
"46581","ENSG00000279668","17",33827699,34079100,251401
"46582","ENSG00000279669","21",5232668,5243833,11165
"46583","ENSG00000279670","9",21892188,21893857,1669
"46584","ENSG00000279672","11",779617,780755,1138
"46585","ENSG00000279673","3",171460612,171462256,1644
"46586","ENSG00000279674","17",34000789,34006772,5983
"46587","ENSG00000279675","11",40107244,40112599,5355
"46588","ENSG00000279676","19",50962197,50962781,584
"46589","ENSG00000279677","13",51921251,51921587,336
"46590","ENSG00000279678","18",37305295,37306333,1038
"46591","ENSG00000279679","5",143375628,143375883,255
"46592","ENSG00000279681","16",81617038,81617543,505
"46593","ENSG00000279682","X",7489659,7491199,1540
"46594","ENSG00000279683","15",56795382,56795522,140
"46595","ENSG00000279684","11",93286629,93288903,2274
"46596","ENSG00000279685","17",45895783,45898798,3015
"46597","ENSG00000279686","5",139442316,139462707,20391
"46598","ENSG00000279687","21",5073458,5087867,14409
"46599","ENSG00000279688","9",65878766,65894790,16024
"46600","ENSG00000279689","10",73769264,73772862,3598
"46601","ENSG00000279690","21",32790673,32791504,831
"46602","ENSG00000279691","5",133052769,133052971,202
"46603","ENSG00000279692","17",81395609,81397144,1535
"46604","ENSG00000279693","16",68367325,68370262,2937
"46605","ENSG00000279694","15",78339208,78341757,2549
"46606","ENSG00000279696","11",93726654,93729805,3151
"46607","ENSG00000279697","11",89545128,89545744,616
"46608","ENSG00000279698","5",9498401,9498775,374
"46609","ENSG00000279699","22",30275215,30276951,1736
"46610","ENSG00000279700","12",132565071,132566425,1354
"46611","ENSG00000279701","11",87490144,87491110,966
"46612","ENSG00000279702","13",102299790,102300272,482
"46613","ENSG00000279705","15",80014157,80015707,1550
"46614","ENSG00000279706","9",68250469,68251656,1187
"46615","ENSG00000279707","18",47866839,47867367,528
"46616","ENSG00000279711","11",133064697,133068129,3432
"46617","ENSG00000279712","22",47916728,47926264,9536
"46618","ENSG00000279713","17",62679403,62681354,1951
"46619","ENSG00000279714","22",36091148,36093352,2204
"46620","ENSG00000279715","9",79913269,79915736,2467
"46621","ENSG00000279716","19",15398696,15400356,1660
"46622","ENSG00000279717","19",15904556,15907234,2678
"46623","ENSG00000279718","21",9364467,9365225,758
"46624","ENSG00000279720","21",9082601,9083101,500
"46625","ENSG00000279721","2",121688203,121689714,1511
"46626","ENSG00000279722","16",53487607,53489943,2336
"46627","ENSG00000279724","7",102188599,102188828,229
"46628","ENSG00000279725","10",127734562,127736996,2434
"46629","ENSG00000279726","5",140785698,140828549,42851
"46630","ENSG00000279727","3",36819276,36822498,3222
"46631","ENSG00000279730","13",18297554,18298733,1179
"46632","ENSG00000279732","16",78981722,78981843,121
"46633","ENSG00000279734","18",30780006,30780424,418
"46634","ENSG00000279735","15",25091960,25092377,417
"46635","ENSG00000279737","5",35895689,35896020,331
"46636","ENSG00000279738","22",37876148,37895563,19415
"46637","ENSG00000279739","5",168128856,168130422,1566
"46638","ENSG00000279741","16",53389886,53390563,677
"46639","ENSG00000279742","11",85852557,85854943,2386
"46640","ENSG00000279744","17",82462601,82464255,1654
"46641","ENSG00000279746","12",131295522,131298218,2696
"46642","ENSG00000279748","19",16586905,16589409,2504
"46643","ENSG00000279750","X",52053176,52055684,2508
"46644","ENSG00000279752","5",169012148,169013146,998
"46645","ENSG00000279756","16",23753689,23755939,2250
"46646","ENSG00000279757","16",72973374,72973832,458
"46647","ENSG00000279758","15",82738386,82739122,736
"46648","ENSG00000279759","19",40355842,40360606,4764
"46649","ENSG00000279762","17",32423971,32446038,22067
"46650","ENSG00000279764","16",56306845,56308335,1490
"46651","ENSG00000279765","15",92883413,92949230,65817
"46652","ENSG00000279766","8",140572142,140572812,670
"46653","ENSG00000279769","21",6034690,6036093,1403
"46654","ENSG00000279770","13",113748511,113751089,2578
"46655","ENSG00000279771","11",115659168,115661417,2249
"46656","ENSG00000279772","5",123508736,123509187,451
"46657","ENSG00000279773","21",13679300,13681138,1838
"46658","ENSG00000279774","1",244064330,244067909,3579
"46659","ENSG00000279775","17",40597113,40598585,1472
"46660","ENSG00000279778","1",87805286,87808372,3086
"46661","ENSG00000279780","16",32786394,32787379,985
"46662","ENSG00000279781","17",32518322,32518934,612
"46663","ENSG00000279783","21",9810501,9810848,347
"46664","ENSG00000279784","21",5705345,5707160,1815
"46665","ENSG00000279785","7",66474556,66475749,1193
"46666","ENSG00000279786","8",140820599,140822414,1815
"46667","ENSG00000279789","16",29913144,29915337,2193
"46668","ENSG00000279790","6",73971346,73973115,1769
"46669","ENSG00000279791","2",97094935,97097433,2498
"46670","ENSG00000279792","17",50362967,50365232,2265
"46671","ENSG00000279793","11",87816999,87817567,568
"46672","ENSG00000279794","19",56149817,56150490,673
"46673","ENSG00000279795","16",32787962,32788944,982
"46674","ENSG00000279796","10",114424445,114427398,2953
"46675","ENSG00000279797","13",61424689,61427946,3257
"46676","ENSG00000279798","12",97563257,97563971,714
"46677","ENSG00000279799","5",134905235,134905691,456
"46678","ENSG00000279800","16",34266041,34268649,2608
"46679","ENSG00000279801","17",77444704,77447167,2463
"46680","ENSG00000279803","16",57142652,57144936,2284
"46681","ENSG00000279804","1",13222705,13226106,3401
"46682","ENSG00000279805","22",36137430,36139350,1920
"46683","ENSG00000279806","17",40473554,40475289,1735
"46684","ENSG00000279807","19",11208195,11208702,507
"46685","ENSG00000279810","6",169033381,169034050,669
"46686","ENSG00000279811","18",77002849,77006846,3997
"46687","ENSG00000279812","17",7192295,7192448,153
"46688","ENSG00000279814","10",75450081,75451725,1644
"46689","ENSG00000279815","16",70768356,70768785,429
"46690","ENSG00000279817","12",133077762,133078392,630
"46691","ENSG00000279818","11",115731942,115734742,2800
"46692","ENSG00000279819","10",22693953,22694639,686
"46693","ENSG00000279821","5",177476631,177479656,3025
"46694","ENSG00000279822","10",48443836,48445820,1984
"46695","ENSG00000279825","17",19030857,19033529,2672
"46696","ENSG00000279827","19",8444570,8445597,1027
"46697","ENSG00000279829","18",46385707,46387083,1376
"46698","ENSG00000279833","22",39133090,39136760,3670
"46699","ENSG00000279834","15",81060953,81063488,2535
"46700","ENSG00000279836","11",87121058,87121596,538
"46701","ENSG00000279837","11",18601882,18602649,767
"46702","ENSG00000279838","1",185292384,185294372,1988
"46703","ENSG00000279839","1",3205988,3208664,2676
"46704","ENSG00000279840","12",47960497,47963469,2972
"46705","ENSG00000279841","16",81630193,81632038,1845
"46706","ENSG00000279844","2",160849313,160850676,1363
"46707","ENSG00000279845","4",146180851,146181316,465
"46708","ENSG00000279846","15",99497812,99498375,563
"46709","ENSG00000279847","8",93134095,93166850,32755
"46710","ENSG00000279848","22",27044001,27045315,1314
"46711","ENSG00000279851","21",10122273,10129029,6756
"46712","ENSG00000279852","8",486117,488512,2395
"46713","ENSG00000279853","7",44367140,44369292,2152
"46714","ENSG00000279856","16",77104260,77105297,1037
"46715","ENSG00000279858","8",19375128,19375622,494
"46716","ENSG00000279859","4",6691995,6692970,975
"46717","ENSG00000279861","19",47487638,47489519,1881
"46718","ENSG00000279862","3",172301654,172303052,1398
"46719","ENSG00000279863","10",50334538,50336123,1585
"46720","ENSG00000279864","21",9529934,9559268,29334
"46721","ENSG00000279865","12",8080381,8082163,1782
"46722","ENSG00000279872","17",2424179,2424412,233
"46723","ENSG00000279873","2",43227210,43228855,1645
"46724","ENSG00000279875","12",48189349,48191207,1858
"46725","ENSG00000279876","2",145874520,145874845,325
"46726","ENSG00000279878","11",61525708,61526602,894
"46727","ENSG00000279879","17",44689858,44693340,3482
"46728","ENSG00000279880","17",67973934,67976072,2138
"46729","ENSG00000279881","8",48428143,48431041,2898
"46730","ENSG00000279882","19",27639300,27639665,365
"46731","ENSG00000279883","5",55484403,55485086,683
"46732","ENSG00000279884","2",174545385,174546335,950
"46733","ENSG00000279885","18",6394847,6398020,3173
"46734","ENSG00000279886","17",78250346,78250932,586
"46735","ENSG00000279887","16",78525189,78526535,1346
"46736","ENSG00000279889","16",58705799,58706297,498
"46737","ENSG00000279891","3",188178543,188180812,2269
"46738","ENSG00000279894","X",103596608,103598904,2296
"46739","ENSG00000279895","21",7421442,7425839,4397
"46740","ENSG00000279897","2",32557273,32574818,17545
"46741","ENSG00000279900","11",83083687,83084138,451
"46742","ENSG00000279901","16",2683106,2684764,1658
"46743","ENSG00000279903","8",17500012,17500605,593
"46744","ENSG00000279904","2",104706612,104707506,894
"46745","ENSG00000279905","12",130425004,130430661,5657
"46746","ENSG00000279907","16",85859521,85862012,2491
"46747","ENSG00000279908","5",1383159,1386409,3250
"46748","ENSG00000279910","10",85526880,85531115,4235
"46749","ENSG00000279912","15",32182551,32186475,3924
"46750","ENSG00000279913","4",99844138,99844696,558
"46751","ENSG00000279914","22",27040197,27041494,1297
"46752","ENSG00000279917","17",67611277,67613822,2545
"46753","ENSG00000279919","8",19277284,19277573,289
"46754","ENSG00000279920","22",21354563,21358067,3504
"46755","ENSG00000279923","5",31558573,31559875,1302
"46756","ENSG00000279924","13",18174010,18178465,4455
"46757","ENSG00000279925","12",110744549,110746206,1657
"46758","ENSG00000279926","6",3982673,3984130,1457
"46759","ENSG00000279927","22",36066533,36070110,3577
"46760","ENSG00000279928","1",182696,184174,1478
"46761","ENSG00000279929","9",134298463,134300413,1950
"46762","ENSG00000279930","16",1437154,1439315,2161
"46763","ENSG00000279931","12",124725524,124725934,410
"46764","ENSG00000279932","8",17510613,17511300,687
"46765","ENSG00000279933","22",44183031,44187739,4708
"46766","ENSG00000279935","9",134992958,134995854,2896
"46767","ENSG00000279936","19",37401404,37403846,2442
"46768","ENSG00000279940","12",130956384,130958031,1647
"46769","ENSG00000279942","6",37567716,37571460,3744
"46770","ENSG00000279943","4",186189032,186191490,2458
"46771","ENSG00000279945","15",88477871,88478387,516
"46772","ENSG00000279946","1",206541758,206544892,3134
"46773","ENSG00000279948","19",46946535,46949156,2621
"46774","ENSG00000279949","8",9158063,9158621,558
"46775","ENSG00000279951","13",20092632,20094144,1512
"46776","ENSG00000279952","12",127462507,127463197,690
"46777","ENSG00000279953","12",123649068,123650485,1417
"46778","ENSG00000279954","22",45875932,45879247,3315
"46779","ENSG00000279956","2",48632291,48755724,123433
"46780","ENSG00000279957","2",113904086,113905258,1172
"46781","ENSG00000279958","15",33105758,33106236,478
"46782","ENSG00000279959","19",56127236,56127466,230
"46783","ENSG00000279960","6",132891924,132893819,1895
"46784","ENSG00000279962","18",13710249,13710484,235
"46785","ENSG00000279964","2",230410700,230412529,1829
"46786","ENSG00000279965","13",110123208,110125234,2026
"46787","ENSG00000279966","19",22770375,22770622,247
"46788","ENSG00000279968","6",138725211,138773652,48441
"46789","ENSG00000279970","15",101299656,101301648,1992
"46790","ENSG00000279971","19",34645380,34646838,1458
"46791","ENSG00000279972","14",41514972,41515350,378
"46792","ENSG00000279976","12",130962175,130963028,853
"46793","ENSG00000279977","19",16610374,16612203,1829
"46794","ENSG00000279979","5",10675317,10675575,258
"46795","ENSG00000279980","15",90347587,90349437,1850
"46796","ENSG00000279981","18",79496058,79498348,2290
"46797","ENSG00000279982","10",131996738,131999846,3108
"46798","ENSG00000279983","5",141223372,141245861,22489
"46799","ENSG00000279985","5",61114432,61116753,2321
"46800","ENSG00000279987","22",18883502,18884682,1180
"46801","ENSG00000279989","18",35257040,35257512,472
"46802","ENSG00000279991","16",78166717,78168514,1797
"46803","ENSG00000279993","12",131025561,131028060,2499
"46804","ENSG00000279994","4",157945817,157946642,825
"46805","ENSG00000279995","5",34124162,34124385,223
"46806","ENSG00000279996","7",75625089,75626970,1881
"46807","ENSG00000279997","16",32185624,32186311,687
"46808","ENSG00000279998","21",6789592,6812297,22705
"46809","ENSG00000280000","16",6037210,6038977,1767
"46810","ENSG00000280002","12",130988312,130990028,1716
"46811","ENSG00000280003","3",52217016,52219012,1996
"46812","ENSG00000280004","7",102186819,102187039,220
"46813","ENSG00000280005","4",154261735,154262193,458
"46814","ENSG00000280007","22",18110759,18131154,20395
"46815","ENSG00000280009","5",86305233,86306149,916
"46816","ENSG00000280010","11",58627435,58628528,1093
"46817","ENSG00000280011","22",44210442,44229512,19070
"46818","ENSG00000280012","10",46063250,46063715,465
"46819","ENSG00000280014","19",41551568,41552274,706
"46820","ENSG00000280015","4",38390754,38391675,921
"46821","ENSG00000280016","5",10082571,10082772,201
"46822","ENSG00000280017","5",10541454,10543192,1738
"46823","ENSG00000280018","21",6986450,6997765,11315
"46824","ENSG00000280019","21",6272135,6276532,4397
"46825","ENSG00000280020","17",32178946,32180074,1128
"46826","ENSG00000280022","17",45592621,45593369,748
"46827","ENSG00000280023","19",36070239,36071070,831
"46828","ENSG00000280025","22",27102766,27107019,4253
"46829","ENSG00000280027","16",53391089,53392473,1384
"46830","ENSG00000280028","17",57531769,57532355,586
"46831","ENSG00000280029","5",141136683,141245380,108697
"46832","ENSG00000280032","11",118264593,118266817,2224
"46833","ENSG00000280033","17",32159311,32160371,1060
"46834","ENSG00000280035","8",141224288,141226947,2659
"46835","ENSG00000280036","15",41016990,41018843,1853
"46836","ENSG00000280037","2",73761269,73761781,512
"46837","ENSG00000280038","15",84166547,84169896,3349
"46838","ENSG00000280039","16",23412380,23416680,4300
"46839","ENSG00000280040","1",98660388,98661059,671
"46840","ENSG00000280042","3",124791119,124793104,1985
"46841","ENSG00000280043","4",49229573,49231284,1711
"46842","ENSG00000280044","16",82727474,82727694,220
"46843","ENSG00000280046","17",7858943,7866083,7140
"46844","ENSG00000280047","5",142165767,142168387,2620
"46845","ENSG00000280048","15",96112628,96116051,3423
"46846","ENSG00000280049","12",87041916,87042423,507
"46847","ENSG00000280053","3",126973065,126976426,3361
"46848","ENSG00000280054","12",47728151,47730598,2447
"46849","ENSG00000280055","8",127946559,127948723,2164
"46850","ENSG00000280057","6",166388136,166389920,1784
"46851","ENSG00000280058","6",131910191,131911527,1336
"46852","ENSG00000280060","13",43894725,43895182,457
"46853","ENSG00000280061","19",30553956,30558058,4102
"46854","ENSG00000280062","16",1530715,1533301,2586
"46855","ENSG00000280063","16",4346694,4348648,1954
"46856","ENSG00000280067","16",48343755,48346058,2303
"46857","ENSG00000280068","5",175903874,175904371,497
"46858","ENSG00000280069","17",30738182,30740275,2093
"46859","ENSG00000280070","14",96992864,96996601,3737
"46860","ENSG00000280071","21",5079294,5128425,49131
"46861","ENSG00000280073","14",69357010,69359308,2298
"46862","ENSG00000280076","15",93206066,93208048,1982
"46863","ENSG00000280077","9",41012231,41014133,1902
"46864","ENSG00000280078","14",76279173,76283103,3930
"46865","ENSG00000280079","19",20220597,20222186,1589
"46866","ENSG00000280080","22",46914092,46916042,1950
"46867","ENSG00000280081","21",9781910,9838011,56101
"46868","ENSG00000280083","2",191154118,191156070,1952
"46869","ENSG00000280086","10",11395808,11398792,2984
"46870","ENSG00000280087","19",44909375,44914968,5593
"46871","ENSG00000280088","12",100032325,100034074,1749
"46872","ENSG00000280089","11",70705605,70706068,463
"46873","ENSG00000280091","19",6894994,6896832,1838
"46874","ENSG00000280092","16",73005601,73006141,540
"46875","ENSG00000280094","9",122628579,122629573,994
"46876","ENSG00000280095","21",6081193,6082585,1392
"46877","ENSG00000280096","18",35082009,35082242,233
"46878","ENSG00000280097","12",124593181,124593691,510
"46879","ENSG00000280099","1",85152487,85154203,1716
"46880","ENSG00000280103","19",3355554,3355955,401
"46881","ENSG00000280105","2",161433874,161437458,3584
"46882","ENSG00000280106","19",34949038,34951205,2167
"46883","ENSG00000280107","6",28170845,28172521,1676
"46884","ENSG00000280109","21",41175231,41186788,11557
"46885","ENSG00000280113","1",9826289,9828271,1982
"46886","ENSG00000280114","1",16681097,16688749,7652
"46887","ENSG00000280115","16",78872739,78873505,766
"46888","ENSG00000280116","X",49155242,49157351,2109
"46889","ENSG00000280117","12",125160525,125164918,4393
"46890","ENSG00000280118","15",24848355,24852253,3898
"46891","ENSG00000280119","2",242001209,242006013,4804
"46892","ENSG00000280120","12",123152324,123153377,1053
"46893","ENSG00000280121","19",18448275,18448805,530
"46894","ENSG00000280122","17",76966285,76969530,3245
"46895","ENSG00000280124","11",91184934,91185543,609
"46896","ENSG00000280126","10",17602910,17603127,217
"46897","ENSG00000280128","6",30282349,30286054,3705
"46898","ENSG00000280129","14",23005499,23007123,1624
"46899","ENSG00000280131","16",49711273,49711914,641
"46900","ENSG00000280132","16",31470204,31472108,1904
"46901","ENSG00000280134","10",85555484,85557436,1952
"46902","ENSG00000280135","6",107697299,107700218,2919
"46903","ENSG00000280136","17",88641,118578,29937
"46904","ENSG00000280137","16",30379763,30380110,347
"46905","ENSG00000280138","12",122870059,122888720,18661
"46906","ENSG00000280140","4",158111361,158111931,570
"46907","ENSG00000280142","X",122242008,122242616,608
"46908","ENSG00000280143","11",117204967,117210292,5325
"46909","ENSG00000280145","21",6630182,6670695,40513
"46910","ENSG00000280147","8",29587001,29588426,1425
"46911","ENSG00000280149","7",149851572,149852170,598
"46912","ENSG00000280150","12",132362810,132363348,538
"46913","ENSG00000280152","16",75245994,75250077,4083
"46914","ENSG00000280153","16",10933903,10936280,2377
"46915","ENSG00000280154","2",30408170,30408346,176
"46916","ENSG00000280155","6",132130252,132131795,1543
"46917","ENSG00000280157","1",228121523,228123771,2248
"46918","ENSG00000280159","5",54643557,54645987,2430
"46919","ENSG00000280160","16",31093727,31095944,2217
"46920","ENSG00000280161","5",180810401,180811384,983
"46921","ENSG00000280162","20",1320710,1324367,3657
"46922","ENSG00000280163","16",67205175,67206849,1674
"46923","ENSG00000280164","21",6721812,6725209,3397
"46924","ENSG00000280165","13",61409685,61415522,5837
"46925","ENSG00000280166","10",72730557,72731175,618
"46926","ENSG00000280167","11",94559018,94559374,356
"46927","ENSG00000280168","17",12973033,12973834,801
"46928","ENSG00000280169","13",100537365,100539567,2202
"46929","ENSG00000280171","19",20674923,20696533,21610
"46930","ENSG00000280172","21",6897291,6899280,1989
"46931","ENSG00000280173","3",47346950,47349073,2123
"46932","ENSG00000280176","2",196831975,196832190,215
"46933","ENSG00000280177","17",39165073,39167849,2776
"46934","ENSG00000280180","16",35148636,35154366,5730
"46935","ENSG00000280181","12",64709458,64710513,1055
"46936","ENSG00000280182","16",81261924,81264091,2167
"46937","ENSG00000280183","17",42598643,42599177,534
"46938","ENSG00000280184","6",145789270,145791973,2703
"46939","ENSG00000280185","5",8793875,8794197,322
"46940","ENSG00000280186","1",108200413,108202743,2330
"46941","ENSG00000280187","5",69186359,69189452,3093
"46942","ENSG00000280189","16",49297143,49299762,2619
"46943","ENSG00000280190","16",78890231,78892302,2071
"46944","ENSG00000280191","21",6060340,6076305,15965
"46945","ENSG00000280193","8",81696368,81698694,2326
"46946","ENSG00000280194","19",35901561,35903855,2294
"46947","ENSG00000280195","X",154396878,154398816,1938
"46948","ENSG00000280196","12",129839928,129840522,594
"46949","ENSG00000280197","18",48252301,48252837,536
"46950","ENSG00000280198","17",18026072,18026771,699
"46951","ENSG00000280200","12",130976786,130978812,2026
"46952","ENSG00000280202","12",3610307,3612003,1696
"46953","ENSG00000280205","18",76385642,76389406,3764
"46954","ENSG00000280206","16",15701237,15702118,881
"46955","ENSG00000280207","5",177967004,177967457,453
"46956","ENSG00000280208","13",18253526,18270822,17296
"46957","ENSG00000280211","16",30773532,30776033,2501
"46958","ENSG00000280212","18",47076117,47076594,477
"46959","ENSG00000280213","20",63953384,63956985,3601
"46960","ENSG00000280214","16",67550815,67552935,2120
"46961","ENSG00000280216","22",39379610,39380015,405
"46962","ENSG00000280217","12",131235511,131237523,2012
"46963","ENSG00000280219","4",147487971,147496062,8091
"46964","ENSG00000280220","20",57161822,57163775,1953
"46965","ENSG00000280222","1",18109389,18115861,6472
"46966","ENSG00000280223","X",126004446,126006118,1672
"46967","ENSG00000280224","22",49500568,49501585,1017
"46968","ENSG00000280225","7",57402181,57404717,2536
"46969","ENSG00000280227","16",53227146,53227694,548
"46970","ENSG00000280228","2",112840328,112844195,3867
"46971","ENSG00000280229","20",20363691,20365657,1966
"46972","ENSG00000280231","16",1553655,1554130,475
"46973","ENSG00000280232","6",85498441,85499058,617
"46974","ENSG00000280233","17",57988180,57988760,580
"46975","ENSG00000280234","15",25255579,25257027,1448
"46976","ENSG00000280237","11",133896438,133901601,5163
"46977","ENSG00000280238","10",73791218,73791490,272
"46978","ENSG00000280239","19",4448810,4450836,2026
"46979","ENSG00000280241","4",153948718,154300500,351782
"46980","ENSG00000280242","17",2255719,2256157,438
"46981","ENSG00000280243","21",8845566,8846646,1080
"46982","ENSG00000280244","14",105110347,105110807,460
"46983","ENSG00000280245","17",32504567,32505644,1077
"46984","ENSG00000280247","19",4246339,4247358,1019
"46985","ENSG00000280248","17",80339898,80342058,2160
"46986","ENSG00000280249","X",134799782,134799945,163
"46987","ENSG00000280250","4",146231892,146232267,375
"46988","ENSG00000280254","17",4787057,4789162,2105
"46989","ENSG00000280255","7",26538378,26541048,2670
"46990","ENSG00000280262","4",140498402,140501330,2928
"46991","ENSG00000280265","16",19392213,19393468,1255
"46992","ENSG00000280266","7",157525783,157527325,1542
"46993","ENSG00000280268","17",3439923,3441844,1921
"46994","ENSG00000280269","11",74204869,74205746,877
"46995","ENSG00000280272","12",126141952,126142377,425
"46996","ENSG00000280273","8",11283481,11285068,1587
"46997","ENSG00000280274","16",79016136,79017429,1293
"46998","ENSG00000280275","X",127392760,127394771,2011
"46999","ENSG00000280276","2",38121935,38123881,1946
"47000","ENSG00000280277","6",88964527,88966587,2060
"47001","ENSG00000280278","16",86555320,86557299,1979
"47002","ENSG00000280279","17",64099,76866,12767
"47003","ENSG00000280280","17",2460183,2460294,111
"47004","ENSG00000280281","14",32879246,32882830,3584
"47005","ENSG00000280283","16",17961597,17962370,773
"47006","ENSG00000280284","4",156876435,156876820,385
"47007","ENSG00000280285","4",56662469,56665694,3225
"47008","ENSG00000280286","9",65646982,65652679,5697
"47009","ENSG00000280287","12",132550729,132554947,4218
"47010","ENSG00000280288","11",11725332,11726702,1370
"47011","ENSG00000280291","15",96294935,96298023,3088
"47012","ENSG00000280294","8",10856085,10859436,3351
"47013","ENSG00000280295","17",42233832,42235469,1637
"47014","ENSG00000280296","13",52497097,52500195,3098
"47015","ENSG00000280299","17",64940602,64954177,13575
"47016","ENSG00000280300","12",123754246,123754794,548
"47017","ENSG00000280302","18",12279427,12282739,3312
"47018","ENSG00000280303","8",140636281,140638283,2002
"47019","ENSG00000280304","15",95280753,95284249,3496
"47020","ENSG00000280305","5",29979669,29983114,3445
"47021","ENSG00000280306","16",20487702,20489659,1957
"47022","ENSG00000280309","15",74299503,74304527,5024
"47023","ENSG00000280310","4",4820405,4821452,1047
"47024","ENSG00000280311","12",132621999,132622973,974
"47025","ENSG00000280312","22",47259366,47261007,1641
"47026","ENSG00000280317","1",72979014,72979314,300
"47027","ENSG00000280318","5",172609094,172609444,350
"47028","ENSG00000280319","12",131436447,131436960,513
"47029","ENSG00000280321","11",36196248,36197901,1653
"47030","ENSG00000280322","X",108725886,108726948,1062
"47031","ENSG00000280323","2",219427477,219429319,1842
"47032","ENSG00000280325","7",84939335,84940256,921
"47033","ENSG00000280326","8",140591684,140593201,1517
"47034","ENSG00000280327","16",1576716,1578371,1655
"47035","ENSG00000280331","11",36510361,36510537,176
"47036","ENSG00000280332","19",16356329,16358327,1998
"47037","ENSG00000280333","17",2072823,2072956,133
"47038","ENSG00000280334","16",67006672,67009481,2809
"47039","ENSG00000280335","18",49013106,49013819,713
"47040","ENSG00000280336","5",141168231,141168893,662
"47041","ENSG00000280338","5",8080186,8080761,575
"47042","ENSG00000280339","11",86908990,86912238,3248
"47043","ENSG00000280340","7",18000290,18000879,589
"47044","ENSG00000280341","22",15282557,15288670,6113
"47045","ENSG00000280344","16",51176066,51178898,2832
"47046","ENSG00000280345","12",8631545,8632259,714
"47047","ENSG00000280347","7",127359785,127364759,4974
"47048","ENSG00000280348","13",73800074,73802203,2129
"47049","ENSG00000280349","17",33099969,33100319,350
"47050","ENSG00000280350","20",21610787,21703585,92798
"47051","ENSG00000280351","17",81003335,81005132,1797
"47052","ENSG00000280353","19",48198107,48199720,1613
"47053","ENSG00000280354","12",124542503,124542873,370
"47054","ENSG00000280355","10",79681973,79684094,2121
"47055","ENSG00000280356","22",34641179,34651862,10683
"47056","ENSG00000280359","15",77784610,77785070,460
"47057","ENSG00000280360","2",687799,688348,549
"47058","ENSG00000280362","15",53910769,53914712,3943
"47059","ENSG00000280364","12",126106459,126107047,588
"47060","ENSG00000280365","18",44732575,44733315,740
"47061","ENSG00000280366","9",79975023,79990064,15041
"47062","ENSG00000280367","11",90223153,90226538,3385
"47063","ENSG00000280368","5",10171030,10171214,184
"47064","ENSG00000280369","5",10342813,10343131,318
"47065","ENSG00000280372","21",10028361,10029855,1494
"47066","ENSG00000280373","5",8669018,8669250,232
"47067","ENSG00000280374","2",177317715,177318471,756
"47068","ENSG00000280375","X",74122134,74122725,591
"47069","ENSG00000280376","16",46673443,46673927,484
"47070","ENSG00000280377","15",89950760,89951345,585
"47071","ENSG00000280378","1",54033126,54034880,1754
"47072","ENSG00000280379","11",93171134,93171906,772
"47073","ENSG00000280380","18",31982899,31986087,3188
"47074","ENSG00000280381","12",123087256,123092821,5565
"47075","ENSG00000280382","3",50599879,50601148,1269
"47076","ENSG00000280383","22",45657019,45680130,23111
"47077","ENSG00000280384","22",46163303,46165347,2044
"47078","ENSG00000280385","11",90193614,90198120,4506
"47079","ENSG00000280387","20",56522252,56523499,1247
"47080","ENSG00000280388","7",76043977,76045963,1986
"47081","ENSG00000280390","2",21023496,21024170,674
"47082","ENSG00000280392","16",53991012,53994454,3442
"47083","ENSG00000280394","19",6263068,6263469,401
"47084","ENSG00000280395","22",50092745,50096437,3692
"47085","ENSG00000280396","15",34999902,35000270,368
"47086","ENSG00000280397","3",144442211,144445844,3633
"47087","ENSG00000280398","12",126130166,126130865,699
"47088","ENSG00000280399","3",138482065,138485755,3690
"47089","ENSG00000280401","10",70434829,70436556,1727
"47090","ENSG00000280402","16",2578395,2579963,1568
"47091","ENSG00000280404","7",102161120,102161337,217
"47092","ENSG00000280407","17",82249067,82251844,2777
"47093","ENSG00000280408","17",1352070,1352255,185
"47094","ENSG00000280409","2",120464335,120466218,1883
"47095","ENSG00000280411","14",106762092,106762588,496
"47096","ENSG00000280412","19",16019719,16020290,571
"47097","ENSG00000280414","2",174334438,174337566,3128
"47098","ENSG00000280415","12",125858862,125861119,2257
"47099","ENSG00000280417","3",53046166,53048122,1956
"47100","ENSG00000280418","22",18951934,18959512,7578
"47101","ENSG00000280419","16",87296949,87297633,684
"47102","ENSG00000280420","5",134522613,134523096,483
"47103","ENSG00000280422","3",51951849,51953902,2053
"47104","ENSG00000280423","6",2561947,2564143,2196
"47105","ENSG00000280424","22",46006616,46010777,4161
"47106","ENSG00000280425","1",54137746,54142980,5234
"47107","ENSG00000280426","12",109997419,109999127,1708
"47108","ENSG00000280429","16",15790975,15792717,1742
"47109","ENSG00000280431","13",34079411,34080134,723
"47110","ENSG00000280432","21",16525919,16527019,1100
"47111","ENSG00000280433","21",5155499,5165472,9973
"47112","ENSG00000280434","22",44139365,44153626,14261
"47113","ENSG00000280435","3",44115818,44117487,1669
"47114","ENSG00000280436","21",9053122,9059060,5938
"47115","ENSG00000280439","7",106035798,106036431,633
"47116","ENSG00000280440","7",90345873,90346218,345
"47117","ENSG00000280441","21",8380643,8454792,74149
"47118","ENSG00000280443","6",21822536,21822737,201
"47119","ENSG00000280444","12",124623391,124623987,596
"47120","ENSG00000280445","22",27414462,27419713,5251
"47121","ENSG00000280446","10",131831910,131833508,1598
"47122","ENSG00000280451","6",93811825,93813036,1211
"47123","ENSG00000280474","9",128595893,128596633,740
"47124","ENSG00000280485","10",93772681,93788605,15924
"47125","ENSG00000280486","19",1385473,1389665,4192
"47126","ENSG00000280502","11",118994334,118994630,296
"47127","ENSG00000280511","6",76561328,76562590,1262
"47128","ENSG00000280515","15",70635249,70637314,2065
"47129","ENSG00000280537","2",219075329,219170827,95498
"47130","ENSG00000280543","8",130082738,130084768,2030
"47131","ENSG00000280560","10",89853595,90225443,371848
"47132","ENSG00000280571","3",42705756,42804518,98762
"47133","ENSG00000280580","13",68878380,68893573,15193
"47134","ENSG00000280587","1",235065479,235074220,8741
"47135","ENSG00000280594","21",17611744,17633199,21455
"47136","ENSG00000280604","21",45914296,45919483,5187
"47137","ENSG00000280614","21",8393419,8394341,922
"47138","ENSG00000280620","3",63911518,63911772,254
"47139","ENSG00000280623","22",23536881,23547797,10916
"47140","ENSG00000280639","15",70570958,70586606,15648
"47141","ENSG00000280649","1",148458814,148459871,1057
"47142","ENSG00000280650","4",21843341,21853188,9847
"47143","ENSG00000280660","10",93762453,93771991,9538
"47144","ENSG00000280665","6",168820423,168820656,233
"47145","ENSG00000280670","1",45493866,45500079,6213
"47146","ENSG00000280683","9",30388935,30575012,186077
"47147","ENSG00000280693","10",103745966,103755423,9457
"47148","ENSG00000280707","6",167228300,167237511,9211
"47149","ENSG00000280709","15",21552795,21653276,100481
"47150","ENSG00000280710","13",99498737,99501250,2513
"47151","ENSG00000280711","4",128768228,128769948,1720
"47152","ENSG00000280719","10",35778302,35800920,22618
"47153","ENSG00000280721","2",87439523,87459044,19521
"47154","ENSG00000280725","8",65161145,65184210,23065
"47155","ENSG00000280734","13",99486962,99499306,12344
"47156","ENSG00000280739","3",40061110,40309698,248588
"47157","ENSG00000280752","X",149825708,149879799,54091
"47158","ENSG00000280758","9",128630328,128631685,1357
"47159","ENSG00000280767","X",419157,421980,2823
"47160","ENSG00000280776","5",161907111,162001536,94425
"47161","ENSG00000280778","1",145927258,145977811,50553
"47162","ENSG00000280780","5",147559994,147662009,102015
"47163","ENSG00000280789","16",29816152,29822489,6337
"47164","ENSG00000280798","11",33076149,33079454,3305
"47165","ENSG00000280800","21",8210384,8211306,922
"47166","ENSG00000280809","10",25651712,25732935,81223
"47167","ENSG00000280828","7",128533652,128615970,82318
"47168","ENSG00000280832","11",126340889,126355587,14698
"47169","ENSG00000280836","1",45581219,45581321,102
"47170","ENSG00000280837","2",210617571,210619876,2305
"47171","ENSG00000280850","6",166275462,166277077,1615
"47172","ENSG00000280852","17",60101759,60102919,1160
"47173","ENSG00000280870","X",76656866,77014532,357666
"47174","ENSG00000280878","2",111468810,111637967,169157
"47175","ENSG00000280890","7",55235965,55255635,19670
"47176","ENSG00000280904","3",52688882,52688961,79
"47177","ENSG00000280913","10",46753605,46759740,6135
"47178","ENSG00000280916","6",1601654,1607354,5700
"47179","ENSG00000280924","1",204368431,204369719,1288
"47180","ENSG00000280927","4",1210120,1218591,8471
"47181","ENSG00000280936","20",63422269,63424555,2286
"47182","ENSG00000280953","10",128181032,128317726,136694
"47183","ENSG00000280958","7",78170195,78170915,720
"47184","ENSG00000280968","22",29333158,29333267,109
"47185","ENSG00000280969","Y",20756164,20781032,24868
"47186","ENSG00000280987","5",139273752,139331671,57919
"47187","ENSG00000280989","6",21485896,21521414,35518
"47188","ENSG00000280997","8",127400399,127402150,1751
"47189","ENSG00000281005","16",3263743,3267567,3824
"47190","ENSG00000281008","7",78134079,78134851,772
"47191","ENSG00000281016","4",386174,454070,67896
"47192","ENSG00000281021","6",149576089,149590864,14775
"47193","ENSG00000281026","13",32504506,32509395,4889
"47194","ENSG00000281039","7",30497077,30550761,53684
"47195","ENSG00000281072","2",231768604,231768680,76
"47196","ENSG00000281091","X",103404777,103452754,47977
"47197","ENSG00000281097","11",129612116,129617269,5153
"47198","ENSG00000281100","3",36823151,36825158,2007
"47199","ENSG00000281103","7",38341577,38378804,37227
"47200","ENSG00000281106","13",51813347,51845177,31830
"47201","ENSG00000281112","1",45592722,45592814,92
"47202","ENSG00000281120","7",79139829,79177210,37381
"47203","ENSG00000281128","9",33676785,33688011,11226
"47204","ENSG00000281131","2",180692104,180916939,224835
"47205","ENSG00000281133","1",45580892,45580996,104
"47206","ENSG00000281156","9",92292458,92292547,89
"47207","ENSG00000281160","3",42264989,42266390,1401
"47208","ENSG00000281162","2",101962056,101987167,25111
"47209","ENSG00000281167","13",74434538,74555515,120977
"47210","ENSG00000281179","15",21717808,21718245,437
"47211","ENSG00000281181","21",8437629,8438551,922
"47212","ENSG00000281183","15",73567012,73569294,2282
"47213","ENSG00000281186","10",6774307,6779180,4873
"47214","ENSG00000281189","7",148987527,148989432,1905
"47215","ENSG00000281195","2",71373938,71376320,2382
"47216","ENSG00000281196","12",119283825,119303380,19555
"47217","ENSG00000281202","4",13526319,13534335,8016
"47218","ENSG00000281207","1",41014590,41043890,29300
"47219","ENSG00000281219","16",1878285,1884233,5948
"47220","ENSG00000281228","14",67616903,67617084,181
"47221","ENSG00000281248","6",127664554,127681555,17001
"47222","ENSG00000281264","15",70615547,70616567,1020
"47223","ENSG00000281269","15",43109928,43110018,90
"47224","ENSG00000281327","5",82848260,82859958,11698
"47225","ENSG00000281332","7",32760279,32762924,2645
"47226","ENSG00000281333","12",88580531,88600725,20194
"47227","ENSG00000281344","12",102197585,102402596,205011
"47228","ENSG00000281348","16",29817239,29830627,13388
"47229","ENSG00000281357","5",91380349,91612566,232217
"47230","ENSG00000281358","3",50337511,50338300,789
"47231","ENSG00000281365","20",48471308,48472414,1106
"47232","ENSG00000281369","4",129041766,129041877,111
"47233","ENSG00000281376","20",31721507,31723409,1902
"47234","ENSG00000281379","19",186373,195696,9323
"47235","ENSG00000281383","21",8254592,8255514,922
"47236","ENSG00000281386","11",129591493,129612110,20617
"47237","ENSG00000281392","3",87089129,87158363,69234
"47238","ENSG00000281394","1",155925958,155926086,128
"47239","ENSG00000281398","5",139274102,139284899,10797
"47240","ENSG00000281404","7",30390885,30412375,21490
"47241","ENSG00000281406","1",205434885,205457091,22206
"47242","ENSG00000281420","21",43748365,43748468,103
"47243","ENSG00000281450","6",36673621,36675126,1505
"47244","ENSG00000281460","20",48476999,48477553,554
"47245","ENSG00000281468","19",27802838,27803472,634
"47246","ENSG00000281469","2",148044380,148044894,514
"47247","ENSG00000281473","3",139232992,139233522,530
"47248","ENSG00000281477","2",87249095,87253750,4655
"47249","ENSG00000281490","7",128655962,128658791,2829
"47250","ENSG00000281491","9",34985410,34989379,3969
"47251","ENSG00000281501","4",25160641,25201440,40799
"47252","ENSG00000281530","22",19061041,19061843,802
"47253","ENSG00000281538","22",42138060,42139726,1666
"47254","ENSG00000281548","22",19565203,19566839,1636
"47255","ENSG00000281550","15",21735506,21735945,439
"47256","ENSG00000281560","5",2712591,2715237,2646
"47257","ENSG00000281571","1",145214851,145215938,1087
"47258","ENSG00000281591","4",190064502,190067864,3362
"47259","ENSG00000281593","7",30362400,30412502,50102
"47260","ENSG00000281613","6",112236806,112350094,113288
"47261","ENSG00000281641","8",118620498,118906155,285657
"47262","ENSG00000281649","9",37079645,37090928,11283
"47263","ENSG00000281655","11",102681310,102683913,2603
"47264","ENSG00000281664","1",213924749,213926654,1905
"47265","ENSG00000281691","3",50099603,50100988,1385
"47266","ENSG00000281692","6",163306907,163324530,17623
"47267","ENSG00000281696","1",220200538,220200619,81
"47268","ENSG00000281706","6",27694035,27713352,19317
"47269","ENSG00000281708","3",55657206,55659382,2176
"47270","ENSG00000281721","13",80011077,80028283,17206
"47271","ENSG00000281731","4",118664087,118685343,21256
"47272","ENSG00000281732","22",48538900,48547387,8487
"47273","ENSG00000281741","1",120913151,120914238,1087
"47274","ENSG00000281756","6",31934474,31941724,7250
"47275","ENSG00000281769","9",1045625,1048641,3016
"47276","ENSG00000281772","2",148062154,148062577,423
"47277","ENSG00000281778","13",68861284,68885325,24041
"47278","ENSG00000281780","2",206161841,206161929,88
"47279","ENSG00000281809","6",1321698,1324022,2324
"47280","ENSG00000281825","1",45605657,45605730,73
"47281","ENSG00000281831","6",29871895,29873783,1888
"47282","ENSG00000281832","6",165987551,165989615,2064
"47283","ENSG00000281842","12",48654444,48654530,86
"47284","ENSG00000281849","X",386980,405579,18599
"47285","ENSG00000281852","X",71697196,71706455,9259
"47286","ENSG00000281880","11",31812307,32002405,190098
"47287","ENSG00000281883","13",43883800,44028526,144726
"47288","ENSG00000281896","7",128617865,128625905,8040
"47289","ENSG00000281903","21",14819699,14918552,98853
"47290","ENSG00000281904","2",90365737,90367699,1962
"47291","ENSG00000281909","15",22480439,22484840,4401
"47292","ENSG00000281910","16",58559796,58559931,135
"47293","ENSG00000281912","1",45303910,45305619,1709
"47294","ENSG00000281920","2",65623272,65628424,5152
