"","ensembl_gene_id","chromosome_name","start_position","end_position","length"
"1","ENSMODG00000000001","7",122757216,122916959,159743
"2","ENSMODG00000000002","5",145989715,145990161,446
"3","ENSMODG00000000003","8",204471644,204477122,5478
"4","ENSMODG00000000005","7",45783445,45978844,195399
"5","ENSMODG00000000006","2",104259348,104284523,25175
"6","ENSMODG00000000008","4",261827928,261829022,1094
"7","ENSMODG00000000011","7",123403897,123433514,29617
"8","ENSMODG00000000012","1",48803982,48839860,35878
"9","ENSMODG00000000013","8",204556919,204573347,16428
"10","ENSMODG00000000014","5",144324142,144324600,458
"11","ENSMODG00000000015","7",124621096,124623030,1934
"12","ENSMODG00000000016","5",144011304,144012227,923
"13","ENSMODG00000000018","1",400325640,400331442,5802
"14","ENSMODG00000000020","7",46438099,46474562,36463
"15","ENSMODG00000000021","2",413014846,413015526,680
"16","ENSMODG00000000022","1",199067622,199094410,26788
"17","ENSMODG00000000026","2",41385159,41433462,48303
"18","ENSMODG00000000029","1",154122154,154123065,911
"19","ENSMODG00000000031","1",48968948,48982431,13483
"20","ENSMODG00000000032","6",206450164,206760986,310822
"21","ENSMODG00000000033","3",428515303,428516589,1286
"22","ENSMODG00000000034","5",195699202,195795621,96419
"23","ENSMODG00000000035","1",49021696,49023941,2245
"24","ENSMODG00000000036","7",46893607,47044060,150453
"25","ENSMODG00000000038","3",428809815,428813384,3569
"26","ENSMODG00000000040","5",142683376,142697325,13949
"27","ENSMODG00000000041","1",400216332,400237671,21339
"28","ENSMODG00000000042","3",428719821,428728923,9102
"29","ENSMODG00000000043","1",49128516,49143625,15109
"30","ENSMODG00000000044","7",46983213,47019444,36231
"31","ENSMODG00000000048","3",428312196,428421526,109330
"32","ENSMODG00000000049","7",47042976,47077298,34322
"33","ENSMODG00000000050","1",400160322,400194922,34600
"34","ENSMODG00000000052","1",198867502,198952358,84856
"35","ENSMODG00000000053","5",141870283,141987389,117106
"36","ENSMODG00000000054","8",204627118,204727563,100445
"37","ENSMODG00000000056","2",41499701,41587872,88171
"38","ENSMODG00000000057","1",400111951,400132569,20618
"39","ENSMODG00000000058","6",207251608,207419843,168235
"40","ENSMODG00000000060","7",47115385,47177807,62422
"41","ENSMODG00000000065","6",207493044,207592780,99736
"42","ENSMODG00000000067","1",49175586,49413285,237699
"43","ENSMODG00000000068","7",47675919,48205196,529277
"44","ENSMODG00000000074","7",49032315,49082774,50459
"45","ENSMODG00000000076","2",41742817,41836906,94089
"46","ENSMODG00000000079","6",207622947,207828327,205380
"47","ENSMODG00000000082","7",49096754,49141724,44970
"48","ENSMODG00000000083","5",200608985,200628021,19036
"49","ENSMODG00000000084","1",49408157,49408899,742
"50","ENSMODG00000000085","6",207846569,207918537,71968
"51","ENSMODG00000000086","7",49296371,49297450,1079
"52","ENSMODG00000000087","5",140890338,140934017,43679
"53","ENSMODG00000000088","1",49548686,49697626,148940
"54","ENSMODG00000000089","5",140821974,140880457,58483
"55","ENSMODG00000000090","7",49361558,49402452,40894
"56","ENSMODG00000000092","1",198541462,198562520,21058
"57","ENSMODG00000000094","6",208282546,208327601,45055
"58","ENSMODG00000000095","1",49705940,49748393,42453
"59","ENSMODG00000000097","4",262004844,262056765,51921
"60","ENSMODG00000000098","5",140635997,140643829,7832
"61","ENSMODG00000000099","4",114202897,114720677,517780
"62","ENSMODG00000000101","7",49417001,49420579,3578
"63","ENSMODG00000000102","1",49749251,49779268,30017
"64","ENSMODG00000000104","4",262347761,262497884,150123
"65","ENSMODG00000000105","6",208334160,208348716,14556
"66","ENSMODG00000000106","7",50370620,50371251,631
"67","ENSMODG00000000107","5",140544712,140630993,86281
"68","ENSMODG00000000109","5",200915616,201152188,236572
"69","ENSMODG00000000111","1",198492519,198511209,18690
"70","ENSMODG00000000113","5",201144187,201156028,11841
"71","ENSMODG00000000115","5",140468615,140584615,116000
"72","ENSMODG00000000116","4",262579682,262699451,119769
"73","ENSMODG00000000117","1",198476511,198490855,14344
"74","ENSMODG00000000118","5",140453065,140468971,15906
"75","ENSMODG00000000120","6",77074643,77075596,953
"76","ENSMODG00000000121","1",49820807,49894311,73504
"77","ENSMODG00000000122","5",140354321,140412366,58045
"78","ENSMODG00000000123","4",115958399,115960594,2195
"79","ENSMODG00000000124","7",127580340,128166870,586530
"80","ENSMODG00000000125","6",77106742,77113704,6962
"81","ENSMODG00000000126","1",198468707,198478549,9842
"82","ENSMODG00000000127","7",51180926,51195498,14572
"83","ENSMODG00000000129","5",201232040,201319862,87822
"84","ENSMODG00000000130","6",77364870,77391225,26355
"85","ENSMODG00000000131","4",262699134,262772602,73468
"86","ENSMODG00000000132","5",139939315,140163219,223904
"87","ENSMODG00000000134","7",51876878,52000069,123191
"88","ENSMODG00000000135","1",198402818,198452519,49701
"89","ENSMODG00000000137","5",201751007,201782978,31971
"90","ENSMODG00000000138","1",399750013,399759082,9069
"91","ENSMODG00000000139","4",262773921,262789362,15441
"92","ENSMODG00000000141","1",198349928,198369385,19457
"93","ENSMODG00000000142","1",49920384,49944911,24527
"94","ENSMODG00000000144","2",104366786,104438261,71475
"95","ENSMODG00000000145","6",77463040,77644130,181090
"96","ENSMODG00000000147","4",118149607,118155932,6325
"97","ENSMODG00000000148","1",399665722,399700021,34299
"98","ENSMODG00000000149","1",49982408,49998570,16162
"99","ENSMODG00000000151","1",198322884,198357201,34317
"100","ENSMODG00000000152","4",118178009,118193711,15702
"101","ENSMODG00000000154","5",201831454,201957877,126423
"102","ENSMODG00000000155","6",208543821,208551988,8167
"103","ENSMODG00000000157","2",246510343,246666978,156635
"104","ENSMODG00000000158","1",198224537,198273552,49015
"105","ENSMODG00000000160","5",139251941,139293376,41435
"106","ENSMODG00000000161","1",49999905,50061988,62083
"107","ENSMODG00000000162","6",77708300,77777854,69554
"108","ENSMODG00000000163","4",263525349,263607299,81950
"109","ENSMODG00000000164","1",198199703,198222958,23255
"110","ENSMODG00000000165","4",263701541,263747740,46199
"111","ENSMODG00000000167","1",50064342,50066984,2642
"112","ENSMODG00000000168","1",50073778,50074739,961
"113","ENSMODG00000000169","4",263801963,263961540,159577
"114","ENSMODG00000000170","2",104467575,104574012,106437
"115","ENSMODG00000000172","5",138908757,138925466,16709
"116","ENSMODG00000000173","7",130014085,130500153,486068
"117","ENSMODG00000000174","2",104576550,104577206,656
"118","ENSMODG00000000175","1",399553402,399583696,30294
"119","ENSMODG00000000176","6",77788126,77817001,28875
"120","ENSMODG00000000178","7",131722824,131730494,7670
"121","ENSMODG00000000179","6",77806120,77806842,722
"122","ENSMODG00000000180","4",263956249,264132883,176634
"123","ENSMODG00000000181","2",104603083,104636292,33209
"124","ENSMODG00000000182","6",77885777,77924796,39019
"125","ENSMODG00000000183","1",399475526,399502387,26861
"126","ENSMODG00000000184","1",197971371,198065414,94043
"127","ENSMODG00000000185","6",208554907,208578260,23353
"128","ENSMODG00000000187","3",76415533,76429619,14086
"129","ENSMODG00000000188","1",50078676,50164048,85372
"130","ENSMODG00000000189","7",131731902,131761316,29414
"131","ENSMODG00000000190","1",197935478,197938731,3253
"132","ENSMODG00000000192","6",77935488,78066952,131464
"133","ENSMODG00000000193","4",118283058,118638912,355854
"134","ENSMODG00000000195","1",399211125,399289487,78362
"135","ENSMODG00000000196","6",250521343,250521558,215
"136","ENSMODG00000000197","6",78098817,78126039,27222
"137","ENSMODG00000000198","1",197912441,197922117,9676
"138","ENSMODG00000000199","1",454862306,454863055,749
"139","ENSMODG00000000200","1",197854321,197862717,8396
"140","ENSMODG00000000203","1",399034926,399091853,56927
"141","ENSMODG00000000204","6",208584687,208643177,58490
"142","ENSMODG00000000206","3",76751396,77314175,562779
"143","ENSMODG00000000207","1",197817721,197820898,3177
"144","ENSMODG00000000208","7",131766462,131801208,34746
"145","ENSMODG00000000209","5",138736451,138858393,121942
"146","ENSMODG00000000210","1",398920374,399006398,86024
"147","ENSMODG00000000211","1",50165398,50204068,38670
"148","ENSMODG00000000212","1",197775472,197796940,21468
"149","ENSMODG00000000213","6",78258748,78401760,143012
"150","ENSMODG00000000214","1",398858781,398897053,38272
"151","ENSMODG00000000215","1",197711191,197722441,11250
"152","ENSMODG00000000216","5",138495787,138619224,123437
"153","ENSMODG00000000217","4",264320788,264378314,57526
"154","ENSMODG00000000218","1",398748864,398825946,77082
"155","ENSMODG00000000219","3",78433636,78649595,215959
"156","ENSMODG00000000220","1",50208099,50257009,48910
"157","ENSMODG00000000221","1",197703320,197710634,7314
"158","ENSMODG00000000222","4",264551255,264574702,23447
"159","ENSMODG00000000223","5",138111061,138135613,24552
"160","ENSMODG00000000226","1",398438450,398673985,235535
"161","ENSMODG00000000227","6",208690287,208858896,168609
"162","ENSMODG00000000228","1",197667917,197668929,1012
"163","ENSMODG00000000229","4",118726102,118784633,58531
"164","ENSMODG00000000231","4",264575731,264648577,72846
"165","ENSMODG00000000232","6",78969376,80023936,1054560
"166","ENSMODG00000000233","2",245832615,246586868,754253
"167","ENSMODG00000000234","1",332457972,332458367,395
"168","ENSMODG00000000235","5",137492021,137580436,88415
"169","ENSMODG00000000236","4",264686346,264703760,17414
"170","ENSMODG00000000237","Un",59839136,59847375,8239
"171","ENSMODG00000000241","Un",102322255,102325135,2880
"172","ENSMODG00000000242","Un",65164123,65171399,7276
"173","ENSMODG00000000243","2",245142532,245756288,613756
"174","ENSMODG00000000244","Un",59847270,59849431,2161
"175","ENSMODG00000000245","4",119189892,119311699,121807
"176","ENSMODG00000000246","Un",56522561,56531497,8936
"177","ENSMODG00000000247","1",398169207,398223393,54186
"178","ENSMODG00000000248","2",437294878,437295599,721
"179","ENSMODG00000000249","1",197638681,197661796,23115
"180","ENSMODG00000000250","1",50262551,50341431,78880
"181","ENSMODG00000000252","Un",56533670,56546973,13303
"182","ENSMODG00000000253","1",398005263,398015064,9801
"183","ENSMODG00000000254","4",120431355,120434985,3630
"184","ENSMODG00000000255","Un",66732077,66746784,14707
"185","ENSMODG00000000256","Un",65171974,65175597,3623
"186","ENSMODG00000000260","4",264770686,264778621,7935
"187","ENSMODG00000000261","2",42001825,42142829,141004
"188","ENSMODG00000000264","4",120512676,120531254,18578
"189","ENSMODG00000000265","Un",56886632,56887875,1243
"190","ENSMODG00000000267","4",264953321,264954031,710
"191","ENSMODG00000000268","1",197593498,197635177,41679
"192","ENSMODG00000000271","4",264963591,264964465,874
"193","ENSMODG00000000272","1",50435993,50442806,6813
"194","ENSMODG00000000273","8",92856027,92862296,6269
"195","ENSMODG00000000274","2",244558373,244560476,2103
"196","ENSMODG00000000275","Un",56893274,56894758,1484
"197","ENSMODG00000000278","4",264999934,265065216,65282
"198","ENSMODG00000000279","Un",56794019,56898164,104145
"199","ENSMODG00000000280","Un",67622163,67637860,15697
"200","ENSMODG00000000281","Un",52756516,52772537,16021
"201","ENSMODG00000000285","2",42298579,42302784,4205
"202","ENSMODG00000000288","Un",32744484,32746142,1658
"203","ENSMODG00000000289","8",296527814,296648319,120505
"204","ENSMODG00000000290","Un",52773629,52786781,13152
"205","ENSMODG00000000291","1",50444469,50455242,10773
"206","ENSMODG00000000292","2",42511714,42728943,217229
"207","ENSMODG00000000294","1",197503427,197576844,73417
"208","ENSMODG00000000298","2",16586999,16648594,61595
"209","ENSMODG00000000299","2",42785217,42799717,14500
"210","ENSMODG00000000300","1",197448703,197455072,6369
"211","ENSMODG00000000302","2",42804209,42819072,14863
"212","ENSMODG00000000303","1",197430700,197443190,12490
"213","ENSMODG00000000304","5",202601638,202609701,8063
"214","ENSMODG00000000305","7",51999927,52123735,123808
"215","ENSMODG00000000306","3",85535826,85669562,133736
"216","ENSMODG00000000307","Un",62925387,62934935,9548
"217","ENSMODG00000000308","5",136748344,137299985,551641
"218","ENSMODG00000000309","3",499462908,499472050,9142
"219","ENSMODG00000000311","2",42890995,42987805,96810
"220","ENSMODG00000000312","2",104718806,104740009,21203
"221","ENSMODG00000000314","1",397873673,397928791,55118
"222","ENSMODG00000000315","8",296649820,296698676,48856
"223","ENSMODG00000000316","1",197228050,197259554,31504
"224","ENSMODG00000000317","3",86269745,86344450,74705
"225","ENSMODG00000000318","Un",6525978,6885794,359816
"226","ENSMODG00000000319","5",135866294,135904773,38479
"227","ENSMODG00000000320","1",657472871,657485469,12598
"228","ENSMODG00000000321","3",86278422,86279700,1278
"229","ENSMODG00000000322","1",657341461,657342490,1029
"230","ENSMODG00000000324","Un",6787375,6826713,39338
"231","ENSMODG00000000325","4",120861761,121114289,252528
"232","ENSMODG00000000326","7",52042119,52145528,103409
"233","ENSMODG00000000327","6",80048832,80105385,56553
"234","ENSMODG00000000328","5",202642175,202709118,66943
"235","ENSMODG00000000329","2",104819209,104912412,93203
"236","ENSMODG00000000330","1",197170564,197187202,16638
"237","ENSMODG00000000333","4",121279243,121279791,548
"238","ENSMODG00000000334","3",499480061,499485975,5914
"239","ENSMODG00000000336","5",135551895,135717594,165699
"240","ENSMODG00000000337","1",397808547,397867723,59176
"241","ENSMODG00000000338","2",243991319,244058928,67609
"242","ENSMODG00000000339","1",657127666,657218997,91331
"243","ENSMODG00000000340","8",296775197,296934255,159058
"244","ENSMODG00000000342","1",657046183,657059319,13136
"245","ENSMODG00000000343","2",244058312,244080120,21808
"246","ENSMODG00000000344","2",16678419,16918668,240249
"247","ENSMODG00000000345","4",121218557,121305227,86670
"248","ENSMODG00000000346","1",50482582,50500584,18002
"249","ENSMODG00000000347","7",52149756,52187151,37395
"250","ENSMODG00000000348","2",485643322,485679730,36408
"251","ENSMODG00000000349","3",499519009,499524845,5836
"252","ENSMODG00000000350","1",656893899,656935706,41807
"253","ENSMODG00000000351","4",121319209,121460275,141066
"254","ENSMODG00000000352","2",16708521,16720760,12239
"255","ENSMODG00000000353","3",499550648,499551513,865
"256","ENSMODG00000000354","2",43004381,43147642,143261
"257","ENSMODG00000000355","1",50501821,50506660,4839
"258","ENSMODG00000000356","2",16678936,17118290,439354
"259","ENSMODG00000000357","4",265082006,265153960,71954
"260","ENSMODG00000000358","3",499552768,499554225,1457
"261","ENSMODG00000000359","3",86360860,86707070,346210
"262","ENSMODG00000000361","1",50512662,50514221,1559
"263","ENSMODG00000000363","5",202909942,202952491,42549
"264","ENSMODG00000000364","2",104958857,104985886,27029
"265","ENSMODG00000000365","3",86450502,86451587,1085
"266","ENSMODG00000000367","2",485617725,485641402,23677
"267","ENSMODG00000000369","Un",6932715,6963741,31026
"268","ENSMODG00000000370","4",265341077,265367470,26393
"269","ENSMODG00000000373","3",86900017,86900625,608
"270","ENSMODG00000000374","1",397718447,397793088,74641
"271","ENSMODG00000000375","7",52368619,52390517,21898
"272","ENSMODG00000000376","1",656590979,656775024,184045
"273","ENSMODG00000000377","Un",7082899,7119626,36727
"274","ENSMODG00000000378","2",43169438,43226918,57480
"275","ENSMODG00000000380","4",121512700,121601009,88309
"276","ENSMODG00000000382","4",121611274,121616331,5057
"277","ENSMODG00000000383","4",265368698,265399693,30995
"278","ENSMODG00000000384","1",656560503,656561459,956
"279","ENSMODG00000000386","2",104997943,105038793,40850
"280","ENSMODG00000000387","3",87114693,87220586,105893
"281","ENSMODG00000000388","5",202955444,203035760,80316
"282","ENSMODG00000000390","2",43271012,43346414,75402
"283","ENSMODG00000000391","5",135467634,135510649,43015
"284","ENSMODG00000000392","1",656533702,656550678,16976
"285","ENSMODG00000000393","4",121680749,121685638,4889
"286","ENSMODG00000000394","5",202996754,202997715,961
"287","ENSMODG00000000395","2",105051067,105062964,11897
"288","ENSMODG00000000396","1",50517114,50533149,16035
"289","ENSMODG00000000397","1",656047488,656139802,92314
"290","ENSMODG00000000398","5",203050028,203050771,743
"291","ENSMODG00000000399","3",87384830,87423651,38821
"292","ENSMODG00000000400","4",121687644,121775525,87881
"293","ENSMODG00000000401","2",43389133,43557878,168745
"294","ENSMODG00000000403","2",105185535,105220761,35226
"295","ENSMODG00000000405","5",203092798,203127875,35077
"296","ENSMODG00000000406","1",397630281,397722126,91845
"297","ENSMODG00000000407","1",655753032,655755267,2235
"298","ENSMODG00000000408","4",121813888,121900334,86446
"299","ENSMODG00000000409","2",43847565,43886247,38682
"300","ENSMODG00000000412","4",265416222,265433935,17713
"301","ENSMODG00000000414","Un",63764387,63773488,9101
"302","ENSMODG00000000415","4",255186083,255186889,806
"303","ENSMODG00000000416","3",500806218,500820412,14194
"304","ENSMODG00000000417","5",135346357,135463097,116740
"305","ENSMODG00000000418","1",397431847,397568363,136516
"306","ENSMODG00000000420","4",122013605,122018934,5329
"307","ENSMODG00000000421","2",44115265,44215183,99918
"308","ENSMODG00000000422","3",499622866,499623671,805
"309","ENSMODG00000000423","5",203204312,203290535,86223
"310","ENSMODG00000000424","2",1708689,1712878,4189
"311","ENSMODG00000000427","1",50533243,50539201,5958
"312","ENSMODG00000000429","1",397297123,397302874,5751
"313","ENSMODG00000000430","3",500921542,500932901,11359
"314","ENSMODG00000000432","5",134362727,134498754,136027
"315","ENSMODG00000000433","4",122312092,122378554,66462
"316","ENSMODG00000000434","4",265495577,265498215,2638
"317","ENSMODG00000000436","3",87239986,87296679,56693
"318","ENSMODG00000000438","4",122517413,122524707,7294
"319","ENSMODG00000000439","5",134007459,134160935,153476
"320","ENSMODG00000000441","4",255587777,256219506,631729
"321","ENSMODG00000000442","1",397239759,397279504,39745
"322","ENSMODG00000000443","2",485277054,485468293,191239
"323","ENSMODG00000000444","7",52403713,52552777,149064
"324","ENSMODG00000000446","2",1929481,1966488,37007
"325","ENSMODG00000000447","8",297227600,297232963,5363
"326","ENSMODG00000000448","1",397069075,397222910,153835
"327","ENSMODG00000000449","8",297309769,297313611,3842
"328","ENSMODG00000000450","2",205673524,205674325,801
"329","ENSMODG00000000451","1",655328301,655500239,171938
"330","ENSMODG00000000452","2",44215289,44248704,33415
"331","ENSMODG00000000453","8",297328142,297332559,4417
"332","ENSMODG00000000454","7",52649691,52691679,41988
"333","ENSMODG00000000455","3",87303273,87304764,1491
"334","ENSMODG00000000456","1",397020497,397058345,37848
"335","ENSMODG00000000457","8",92649827,92655215,5388
"336","ENSMODG00000000458","4",123538433,123571827,33394
"337","ENSMODG00000000459","2",105408747,105641264,232517
"338","ENSMODG00000000460","5",203427128,203472921,45793
"339","ENSMODG00000000462","2",1984494,1992692,8198
"340","ENSMODG00000000463","8",297341283,297346061,4778
"341","ENSMODG00000000464","1",196921444,197127333,205889
"342","ENSMODG00000000465","5",133969661,133998404,28743
"343","ENSMODG00000000466","2",105581232,105582392,1160
"344","ENSMODG00000000469","8",297362409,297367602,5193
"345","ENSMODG00000000470","2",1995387,2001629,6242
"346","ENSMODG00000000471","5",203546844,203695388,148544
"347","ENSMODG00000000472","8",297373240,297375331,2091
"348","ENSMODG00000000474","5",203698731,203699447,716
"349","ENSMODG00000000475","1",197075380,197090467,15087
"350","ENSMODG00000000476","3",87306465,87344152,37687
"351","ENSMODG00000000479","7",52805512,53051294,245782
"352","ENSMODG00000000481","2",2003769,2015626,11857
"353","ENSMODG00000000482","2",19185005,20142328,957323
"354","ENSMODG00000000483","8",297377519,297379442,1923
"355","ENSMODG00000000485","2",105654131,105689907,35776
"356","ENSMODG00000000486","4",256761863,257161880,400017
"357","ENSMODG00000000487","5",133902625,133956153,53528
"358","ENSMODG00000000488","6",19197130,19265140,68010
"359","ENSMODG00000000489","8",92599422,92627668,28246
"360","ENSMODG00000000490","1",196996371,197004797,8426
"361","ENSMODG00000000491","8",297391482,297392998,1516
"362","ENSMODG00000000492","2",105706005,105709420,3415
"363","ENSMODG00000000493","2",2120850,2211207,90357
"364","ENSMODG00000000494","8",297411805,297414466,2661
"365","ENSMODG00000000495","1",396940732,397005632,64900
"366","ENSMODG00000000497","4",123719382,123835654,116272
"367","ENSMODG00000000498","2",44361533,44413778,52245
"368","ENSMODG00000000499","6",19275842,19302405,26563
"369","ENSMODG00000000500","5",133572511,133669546,97035
"370","ENSMODG00000000501","3",87838409,88003454,165045
"371","ENSMODG00000000502","8",297419951,297422492,2541
"372","ENSMODG00000000504","2",20426185,20452895,26710
"373","ENSMODG00000000505","2",105725352,105787783,62431
"374","ENSMODG00000000506","3",88104102,88160323,56221
"375","ENSMODG00000000507","8",297427933,297429569,1636
"376","ENSMODG00000000508","5",133476374,133522117,45743
"377","ENSMODG00000000509","4",257299976,257401101,101125
"378","ENSMODG00000000510","4",123846627,123872244,25617
"379","ENSMODG00000000511","6",80608468,80640626,32158
"380","ENSMODG00000000512","2",20541192,20990000,448808
"381","ENSMODG00000000513","2",44339669,44360937,21268
"382","ENSMODG00000000514","6",19364097,19400047,35950
"383","ENSMODG00000000515","1",655142807,655254840,112033
"384","ENSMODG00000000516","5",203906033,203977151,71118
"385","ENSMODG00000000517","2",105824368,105841189,16821
"386","ENSMODG00000000518","4",123890096,123890909,813
"387","ENSMODG00000000520","5",133101134,133364842,263708
"388","ENSMODG00000000521","8",297618323,297767843,149520
"389","ENSMODG00000000522","5",132428969,132712740,283771
"390","ENSMODG00000000524","8",92568023,92596245,28222
"391","ENSMODG00000000525","7",53217176,53265460,48284
"392","ENSMODG00000000526","5",132779015,132805327,26312
"393","ENSMODG00000000527","2",105857756,105876185,18429
"394","ENSMODG00000000528","1",196924183,196965416,41233
"395","ENSMODG00000000529","2",2275466,2342252,66786
"396","ENSMODG00000000531","2",21041592,21113963,72371
"397","ENSMODG00000000533","4",123905973,123929036,23063
"398","ENSMODG00000000534","1",394337793,394402213,64420
"399","ENSMODG00000000535","1",196871728,196906130,34402
"400","ENSMODG00000000536","1",50541684,50606783,65099
"401","ENSMODG00000000537","4",257671226,257824735,153509
"402","ENSMODG00000000538","8",92516758,92526705,9947
"403","ENSMODG00000000539","2",44570679,44601979,31300
"404","ENSMODG00000000541","1",655089008,655132433,43425
"405","ENSMODG00000000542","2",2368653,2390128,21475
"406","ENSMODG00000000543","8",92197713,92199116,1403
"407","ENSMODG00000000544","6",19405542,19555127,149585
"408","ENSMODG00000000545","2",105893659,105899650,5991
"409","ENSMODG00000000546","8",92503055,92515885,12830
"410","ENSMODG00000000547","5",132742206,132754814,12608
"411","ENSMODG00000000549","5",204685278,204830263,144985
"412","ENSMODG00000000550","4",258147822,258190541,42719
"413","ENSMODG00000000552","2",2397225,2424992,27767
"414","ENSMODG00000000553","8",298086202,298103526,17324
"415","ENSMODG00000000554","7",53285456,53432593,147137
"416","ENSMODG00000000555","4",126210122,126871155,661033
"417","ENSMODG00000000556","3",428025496,428276814,251318
"418","ENSMODG00000000557","5",132324728,132327050,2322
"419","ENSMODG00000000558","4",258202264,258346224,143960
"420","ENSMODG00000000559","2",21119412,21135406,15994
"421","ENSMODG00000000560","5",205875633,206009288,133655
"422","ENSMODG00000000561","1",655064775,655082154,17379
"423","ENSMODG00000000562","2",106020011,106032521,12510
"424","ENSMODG00000000563","1",152588426,152588809,383
"425","ENSMODG00000000564","1",50657962,50667080,9118
"426","ENSMODG00000000565","7",53430724,53455172,24448
"427","ENSMODG00000000566","6",20103860,20314113,210253
"428","ENSMODG00000000567","4",258386061,258409956,23895
"429","ENSMODG00000000568","1",196673848,196761195,87347
"430","ENSMODG00000000569","2",2445094,2513380,68286
"431","ENSMODG00000000571","8",204728368,204786287,57919
"432","ENSMODG00000000572","8",298215876,298219768,3892
"433","ENSMODG00000000573","1",393742970,393870147,127177
"434","ENSMODG00000000574","2",106008049,106014363,6314
"435","ENSMODG00000000575","4",258549549,258629252,79703
"436","ENSMODG00000000576","2",2561257,2568046,6789
"437","ENSMODG00000000577","1",196518685,196549941,31256
"438","ENSMODG00000000578","8",92369725,92415516,45791
"439","ENSMODG00000000579","1",655027464,655050740,23276
"440","ENSMODG00000000580","3",439940703,439988220,47517
"441","ENSMODG00000000581","7",53480141,53539857,59716
"442","ENSMODG00000000582","5",206170768,206335957,165189
"443","ENSMODG00000000583","5",131988814,132254823,266009
"444","ENSMODG00000000587","4",258651757,258652639,882
"445","ENSMODG00000000588","2",2727154,2837116,109962
"446","ENSMODG00000000589","4",258736645,258745918,9273
"447","ENSMODG00000000592","8",92333065,92357893,24828
"448","ENSMODG00000000596","2",44801827,44911761,109934
"449","ENSMODG00000000597","2",106040571,106066609,26038
"450","ENSMODG00000000598","3",439986226,439995803,9577
"451","ENSMODG00000000599","3",88739683,88753688,14005
"452","ENSMODG00000000601","3",88766153,88768815,2662
"453","ENSMODG00000000602","3",439997415,440001387,3972
"454","ENSMODG00000000603","8",298224651,298229296,4645
"455","ENSMODG00000000604","2",21147318,21195162,47844
"456","ENSMODG00000000607","3",440011861,440015828,3967
"457","ENSMODG00000000608","4",258776822,258809483,32661
"458","ENSMODG00000000609","2",45892084,45893769,1685
"459","ENSMODG00000000611","4",258842368,258906829,64461
"460","ENSMODG00000000612","4",128630291,128682646,52355
"461","ENSMODG00000000614","2",106077008,106114275,37267
"462","ENSMODG00000000615","4",128853243,128915908,62665
"463","ENSMODG00000000617","8",204871162,204882694,11532
"464","ENSMODG00000000618","2",2882816,2944653,61837
"465","ENSMODG00000000619","1",196266747,196403483,136736
"466","ENSMODG00000000621","8",92043075,92080717,37642
"467","ENSMODG00000000623","4",258976469,258992320,15851
"468","ENSMODG00000000624","3",88774964,88816933,41969
"469","ENSMODG00000000625","5",207825606,208062021,236415
"470","ENSMODG00000000626","1",393644321,393715603,71282
"471","ENSMODG00000000627","3",425143248,425236961,93713
"472","ENSMODG00000000628","2",484838254,484913384,75130
"473","ENSMODG00000000629","1",196100269,196240473,140204
"474","ENSMODG00000000630","8",204891463,204905255,13792
"475","ENSMODG00000000631","3",88822085,88852701,30616
"476","ENSMODG00000000633","1",50774343,50893198,118855
"477","ENSMODG00000000635","8",91994553,92023562,29009
"478","ENSMODG00000000636","1",393625269,393635683,10414
"479","ENSMODG00000000637","3",440020486,440032721,12235
"480","ENSMODG00000000638","3",88903373,89180583,277210
"481","ENSMODG00000000639","4",259104674,259155639,50965
"482","ENSMODG00000000640","8",299003931,299052832,48901
"483","ENSMODG00000000641","5",208071334,208104645,33311
"484","ENSMODG00000000644","2",2950504,2965245,14741
"485","ENSMODG00000000645","8",91974905,91975897,992
"486","ENSMODG00000000646","2",106166238,106291783,125545
"487","ENSMODG00000000647","2",484691772,484695268,3496
"488","ENSMODG00000000648","1",654908561,655019802,111241
"489","ENSMODG00000000649","2",21217371,21797834,580463
"490","ENSMODG00000000650","8",91944216,91955964,11748
"491","ENSMODG00000000651","3",425046286,425078060,31774
"492","ENSMODG00000000652","2",106298093,106356237,58144
"493","ENSMODG00000000653","8",299069251,299071564,2313
"494","ENSMODG00000000655","6",22854728,23531403,676675
"495","ENSMODG00000000657","4",129351077,129378192,27115
"496","ENSMODG00000000658","5",131059361,131144658,85297
"497","ENSMODG00000000660","1",50893325,50909338,16013
"498","ENSMODG00000000661","3",89194126,89231574,37448
"499","ENSMODG00000000662","2",106355287,106669230,313943
"500","ENSMODG00000000663","3",424383272,424496354,113082
"501","ENSMODG00000000664","6",23354852,23355611,759
"502","ENSMODG00000000665","2",484618955,484679242,60287
"503","ENSMODG00000000666","2",2967278,2980220,12942
"504","ENSMODG00000000667","8",91882031,91910982,28951
"505","ENSMODG00000000670","5",130908432,130931325,22893
"506","ENSMODG00000000671","8",204930250,204934673,4423
"507","ENSMODG00000000672","2",484588759,484756477,167718
"508","ENSMODG00000000675","3",440084388,440203145,118757
"509","ENSMODG00000000676","1",393369807,393417323,47516
"510","ENSMODG00000000677","3",424300804,424346826,46022
"511","ENSMODG00000000678","1",654572421,654597503,25082
"512","ENSMODG00000000679","1",195708620,195726898,18278
"513","ENSMODG00000000680","3",89248816,89375786,126970
"514","ENSMODG00000000682","7",53688887,53895268,206381
"515","ENSMODG00000000683","1",393356288,393371707,15419
"516","ENSMODG00000000684","2",106675469,106756483,81014
"517","ENSMODG00000000686","2",22859491,22871735,12244
"518","ENSMODG00000000687","1",50977336,51559850,582514
"519","ENSMODG00000000689","2",107037360,107054983,17623
"520","ENSMODG00000000690","4",131036948,131444048,407100
"521","ENSMODG00000000691","5",130856585,130894267,37682
"522","ENSMODG00000000693","8",91804919,91856413,51494
"523","ENSMODG00000000694","8",205073652,205073912,260
"524","ENSMODG00000000696","3",440250023,440295669,45646
"525","ENSMODG00000000697","8",205174564,205175172,608
"526","ENSMODG00000000699","2",484574968,484588099,13131
"527","ENSMODG00000000700","7",54069639,54623945,554306
"528","ENSMODG00000000701","3",89725712,89858433,132721
"529","ENSMODG00000000702","6",23423256,23584812,161556
"530","ENSMODG00000000704","4",131450470,131715647,265177
"531","ENSMODG00000000705","1",654478528,654511261,32733
"532","ENSMODG00000000707","3",423555022,423862863,307841
"533","ENSMODG00000000708","8",91782663,91801749,19086
"534","ENSMODG00000000709","3",440333413,440349257,15844
"535","ENSMODG00000000710","2",22887381,22903875,16494
"536","ENSMODG00000000712","4",259343747,259356677,12930
"537","ENSMODG00000000713","2",47503039,47738861,235822
"538","ENSMODG00000000714","4",265462812,265728324,265512
"539","ENSMODG00000000715","4",131882137,132022441,140304
"540","ENSMODG00000000716","8",91746340,91752754,6414
"541","ENSMODG00000000717","6",85131160,85152438,21278
"542","ENSMODG00000000718","3",440373000,440387454,14454
"543","ENSMODG00000000719","2",484378911,484439795,60884
"544","ENSMODG00000000720","1",393167166,393279739,112573
"545","ENSMODG00000000721","2",22905191,22965728,60537
"546","ENSMODG00000000723","8",299195566,299330662,135096
"547","ENSMODG00000000724","8",91729761,91741250,11489
"548","ENSMODG00000000725","8",91691153,91720812,29659
"549","ENSMODG00000000726","4",265649315,265650296,981
"550","ENSMODG00000000727","4",132030788,132072923,42135
"551","ENSMODG00000000728","8",299350293,299406306,56013
"552","ENSMODG00000000730","2",2984835,3001278,16443
"553","ENSMODG00000000731","5",208174468,208353876,179408
"554","ENSMODG00000000735","1",654436104,654472376,36272
"555","ENSMODG00000000736","1",51638512,51847010,208498
"556","ENSMODG00000000740","8",299408751,299435327,26576
"557","ENSMODG00000000742","2",484314579,484371370,56791
"558","ENSMODG00000000744","8",91637386,91675576,38190
"559","ENSMODG00000000745","8",299767366,299779814,12448
"560","ENSMODG00000000746","1",51850227,51898159,47932
"561","ENSMODG00000000747","1",653905129,653975865,70736
"562","ENSMODG00000000748","3",423313621,423452955,139334
"563","ENSMODG00000000750","3",440390048,440397701,7653
"564","ENSMODG00000000751","5",210902059,210950303,48244
"565","ENSMODG00000000753","1",653654905,653658790,3885
"566","ENSMODG00000000754","2",23129136,23259882,130746
"567","ENSMODG00000000755","2",106893308,106966074,72766
"568","ENSMODG00000000756","3",423288810,423293406,4596
"569","ENSMODG00000000757","5",211186646,211300242,113596
"570","ENSMODG00000000761","1",653513967,653518214,4247
"571","ENSMODG00000000762","1",51925679,51934288,8609
"572","ENSMODG00000000764","3",421755861,421948131,192270
"573","ENSMODG00000000765","3",440433066,440488288,55222
"574","ENSMODG00000000766","2",23357142,23357739,597
"575","ENSMODG00000000768","3",421671949,421672965,1016
"576","ENSMODG00000000769","8",91554994,91587081,32087
"577","ENSMODG00000000770","2",3241999,3261891,19892
"578","ENSMODG00000000771","2",23776128,23777486,1358
"579","ENSMODG00000000772","5",130396709,130815186,418477
"580","ENSMODG00000000774","2",3273082,3274171,1089
"581","ENSMODG00000000777","8",300039661,300107108,67447
"582","ENSMODG00000000778","3",440504070,440509989,5919
"583","ENSMODG00000000781","5",211351282,211437127,85845
"584","ENSMODG00000000783","8",91471158,91492117,20959
"585","ENSMODG00000000785","4",132093746,132168514,74768
"586","ENSMODG00000000787","8",300113078,300134234,21156
"587","ENSMODG00000000788","2",23790213,23791922,1709
"588","ENSMODG00000000789","6",24977135,24977670,535
"589","ENSMODG00000000790","8",91403096,91428091,24995
"590","ENSMODG00000000791","2",3300605,3362394,61789
"591","ENSMODG00000000792","8",300164223,300188451,24228
"592","ENSMODG00000000794","4",259550159,259562430,12271
"593","ENSMODG00000000796","6",80734338,80768989,34651
"594","ENSMODG00000000799","8",91172469,91347927,175458
"595","ENSMODG00000000800","3",90234543,90286851,52308
"596","ENSMODG00000000802","2",24044213,24062298,18085
"597","ENSMODG00000000803","2",484268996,484311741,42745
"598","ENSMODG00000000804","5",211471466,211588553,117087
"599","ENSMODG00000000805","7",55210026,55588273,378247
"600","ENSMODG00000000806","Un",40522645,40533203,10558
"601","ENSMODG00000000807","8",300227620,300260954,33334
"602","ENSMODG00000000809","3",440558924,440589636,30712
"603","ENSMODG00000000812","7",56062423,56114570,52147
"604","ENSMODG00000000813","5",211588802,211597927,9125
"605","ENSMODG00000000814","1",652652326,652784387,132061
"606","ENSMODG00000000817","3",440635976,440647941,11965
"607","ENSMODG00000000818","3",90285403,90328880,43477
"608","ENSMODG00000000820","6",25556561,25648587,92026
"609","ENSMODG00000000821","8",91124304,91135351,11047
"610","ENSMODG00000000822","1",652556171,652627393,71222
"611","ENSMODG00000000824","4",259666105,259686583,20478
"612","ENSMODG00000000827","3",440651480,440668641,17161
"613","ENSMODG00000000828","3",91018996,91119794,100798
"614","ENSMODG00000000829","6",80783378,80814644,31266
"615","ENSMODG00000000830","5",130001654,130389753,388099
"616","ENSMODG00000000832","3",440699621,440713919,14298
"617","ENSMODG00000000833","8",91100985,91122829,21844
"618","ENSMODG00000000835","4",132197270,132294338,97068
"619","ENSMODG00000000837","8",91070137,91080828,10691
"620","ENSMODG00000000838","4",119610165,119730170,120005
"621","ENSMODG00000000839","2",3401469,3480293,78824
"622","ENSMODG00000000840","7",56160271,56283222,122951
"623","ENSMODG00000000841","3",440755839,440769637,13798
"624","ENSMODG00000000844","4",259747059,259789349,42290
"625","ENSMODG00000000845","8",205406528,205411795,5267
"626","ENSMODG00000000846","6",25735728,25797984,62256
"627","ENSMODG00000000847","8",205327497,205335587,8090
"628","ENSMODG00000000848","4",132323850,132517887,194037
"629","ENSMODG00000000851","7",131805432,132151065,345633
"630","ENSMODG00000000853","1",51937267,51947342,10075
"631","ENSMODG00000000855","2",107057964,107084954,26990
"632","ENSMODG00000000858","3",440786333,440796980,10647
"633","ENSMODG00000000859","2",24066480,24119832,53352
"634","ENSMODG00000000860","8",205328349,205361196,32847
"635","ENSMODG00000000861","5",211599581,211634241,34660
"636","ENSMODG00000000862","8",205326437,205374157,47720
"637","ENSMODG00000000863","7",132919648,133427843,508195
"638","ENSMODG00000000866","6",81207073,81340283,133210
"639","ENSMODG00000000867","5",211687245,211704637,17392
"640","ENSMODG00000000868","5",127802555,127990234,187679
"641","ENSMODG00000000869","8",205384411,205384867,456
"642","ENSMODG00000000871","3",420323023,420822133,499110
"643","ENSMODG00000000873","1",51993897,52019527,25630
"644","ENSMODG00000000874","2",484003734,484246379,242645
"645","ENSMODG00000000876","2",107092111,107099513,7402
"646","ENSMODG00000000877","2",24170870,24241707,70837
"647","ENSMODG00000000878","3",91165723,91321629,155906
"648","ENSMODG00000000879","5",211713393,211752184,38791
"649","ENSMODG00000000881","3",440814850,440838840,23990
"650","ENSMODG00000000883","2",24356738,24398890,42152
"651","ENSMODG00000000885","3",419571740,419940583,368843
"652","ENSMODG00000000887","8",205287620,205291294,3674
"653","ENSMODG00000000890","3",499732020,499732950,930
"654","ENSMODG00000000891","6",81360043,81387628,27585
"655","ENSMODG00000000892","2",484029842,484031103,1261
"656","ENSMODG00000000893","3",419169518,419170507,989
"657","ENSMODG00000000894","2",107119402,107124951,5549
"658","ENSMODG00000000895","3",440839443,440852759,13316
"659","ENSMODG00000000896","1",52068453,52092010,23557
"660","ENSMODG00000000898","7",56507962,56774424,266462
"661","ENSMODG00000000900","3",499774166,499798709,24543
"662","ENSMODG00000000901","2",107163939,107168443,4504
"663","ENSMODG00000000904","7",57178156,57178708,552
"664","ENSMODG00000000905","3",91644557,91696232,51675
"665","ENSMODG00000000906","1",52095130,52098709,3579
"666","ENSMODG00000000907","3",440853605,440862481,8876
"667","ENSMODG00000000908","2",483609194,483649489,40295
"668","ENSMODG00000000909","3",499868867,499902669,33802
"669","ENSMODG00000000910","5",212413689,212812532,398843
"670","ENSMODG00000000911","1",52305619,52313158,7539
"671","ENSMODG00000000912","2",51517576,51657496,139920
"672","ENSMODG00000000913","3",499908622,499910323,1701
"673","ENSMODG00000000915","2",107215792,107240551,24759
"674","ENSMODG00000000916","5",127122194,127799355,677161
"675","ENSMODG00000000918","3",418977455,418979176,1721
"676","ENSMODG00000000919","1",52349497,53755996,1406499
"677","ENSMODG00000000921","3",91701263,91738745,37482
"678","ENSMODG00000000922","4",266082079,266226014,143935
"679","ENSMODG00000000923","4",132536288,132739315,203027
"680","ENSMODG00000000925","4",259807903,260181002,373099
"681","ENSMODG00000000926","6",81384024,81499317,115293
"682","ENSMODG00000000927","2",52245331,52256223,10892
"683","ENSMODG00000000928","1",652008232,652053448,45216
"684","ENSMODG00000000929","2",483394612,483439478,44866
"685","ENSMODG00000000930","5",213160579,213262178,101599
"686","ENSMODG00000000931","3",440865071,440954575,89504
"687","ENSMODG00000000933","6",81529215,81635667,106452
"688","ENSMODG00000000934","2",3479427,3629573,150146
"689","ENSMODG00000000935","7",57829571,58118503,288932
"690","ENSMODG00000000936","2",52307200,52352775,45575
"691","ENSMODG00000000937","6",25807776,25992120,184344
"692","ENSMODG00000000938","2",52365767,52367991,2224
"693","ENSMODG00000000942","4",260800533,261105269,304736
"694","ENSMODG00000000943","5",127522779,127523239,460
"695","ENSMODG00000000944","4",132738010,132784349,46339
"696","ENSMODG00000000946","2",3653398,3679421,26023
"697","ENSMODG00000000947","6",25876771,25940195,63424
"698","ENSMODG00000000950","3",440983930,441049731,65801
"699","ENSMODG00000000951","2",24444353,24484622,40269
"700","ENSMODG00000000952","2",52426493,52427337,844
"701","ENSMODG00000000953","1",651499034,651617872,118838
"702","ENSMODG00000000954","1",54078191,54792532,714341
"703","ENSMODG00000000956","6",81704471,81734051,29580
"704","ENSMODG00000000957","4",266380486,266473869,93383
"705","ENSMODG00000000961","6",26010070,26085092,75022
"706","ENSMODG00000000962","2",52436563,52447070,10507
"707","ENSMODG00000000963","2",24510045,24539548,29503
"708","ENSMODG00000000964","7",134913692,134998942,85250
"709","ENSMODG00000000965","1",651239182,651279158,39976
"710","ENSMODG00000000966","3",91744015,91795092,51077
"711","ENSMODG00000000967","3",441055134,441073775,18641
"712","ENSMODG00000000968","1",651204445,651238766,34321
"713","ENSMODG00000000969","5",126862292,126924432,62140
"714","ENSMODG00000000970","7",135165798,135177674,11876
"715","ENSMODG00000000972","4",132783944,132831103,47159
"716","ENSMODG00000000973","1",651186833,651199683,12850
"717","ENSMODG00000000974","7",58620613,58706069,85456
"718","ENSMODG00000000975","3",415787638,416027262,239624
"719","ENSMODG00000000976","Un",60263047,60266726,3679
"720","ENSMODG00000000977","6",26149496,26259966,110470
"721","ENSMODG00000000978","7",58644987,58646081,1094
"722","ENSMODG00000000979","6",81905360,81962658,57298
"723","ENSMODG00000000980","2",52459978,52684135,224157
"724","ENSMODG00000000981","2",483150071,483159077,9006
"725","ENSMODG00000000983","8",205485989,205500367,14378
"726","ENSMODG00000000984","6",26274513,26322893,48380
"727","ENSMODG00000000986","3",40946493,40962523,16030
"728","ENSMODG00000000987","5",213369505,213514007,144502
"729","ENSMODG00000000988","3",441106011,441134941,28930
"730","ENSMODG00000000989","4",132836379,132876722,40343
"731","ENSMODG00000000990","7",135208357,135315004,106647
"732","ENSMODG00000000991","3",91819409,91852529,33120
"733","ENSMODG00000000992","4",432013373,432013807,434
"734","ENSMODG00000000993","5",213630327,213631061,734
"735","ENSMODG00000000994","6",81972462,82057051,84589
"736","ENSMODG00000000995","2",52724079,52785392,61313
"737","ENSMODG00000000996","2",107240636,107303814,63178
"738","ENSMODG00000000997","5",126676741,126913943,237202
"739","ENSMODG00000000998","3",441138445,441146066,7621
"740","ENSMODG00000000999","6",82459795,82517232,57437
"741","ENSMODG00000001001","3",40967613,41023146,55533
"742","ENSMODG00000001002","1",55149386,55305586,156200
"743","ENSMODG00000001004","7",58766084,58868403,102319
"744","ENSMODG00000001006","4",266512333,266551648,39315
"745","ENSMODG00000001007","5",213659888,213744587,84699
"746","ENSMODG00000001008","2",483126023,483152601,26578
"747","ENSMODG00000001009","2",107314250,107317846,3596
"748","ENSMODG00000001011","1",650777167,650782998,5831
"749","ENSMODG00000001012","4",266694845,266733204,38359
"750","ENSMODG00000001013","2",52899139,53313430,414291
"751","ENSMODG00000001014","8",300286120,300391539,105419
"752","ENSMODG00000001015","6",82531710,82540801,9091
"753","ENSMODG00000001016","3",441157002,441174581,17579
"754","ENSMODG00000001017","5",213776995,213822297,45302
"755","ENSMODG00000001018","8",205494486,205517834,23348
"756","ENSMODG00000001019","2",53291968,53295687,3719
"757","ENSMODG00000001020","7",58887526,59175587,288061
"758","ENSMODG00000001021","5",126164470,126366974,202504
"759","ENSMODG00000001022","3",441196439,441197464,1025
"760","ENSMODG00000001023","2",107372509,107433633,61124
"761","ENSMODG00000001024","2",53344492,53378920,34428
"762","ENSMODG00000001026","3",441402147,441433781,31634
"763","ENSMODG00000001027","3",41036903,41093920,57017
"764","ENSMODG00000001028","6",82778347,82824744,46397
"765","ENSMODG00000001029","2",24558777,24794830,236053
"766","ENSMODG00000001030","8",300392808,300398384,5576
"767","ENSMODG00000001031","5",126056603,126161395,104792
"768","ENSMODG00000001032","2",483002802,483068193,65391
"769","ENSMODG00000001033","3",441440155,441452595,12440
"770","ENSMODG00000001036","1",55362269,55416342,54073
"771","ENSMODG00000001037","2",7107834,7108722,888
"772","ENSMODG00000001039","3",441460069,441497557,37488
"773","ENSMODG00000001040","2",107433153,107451140,17987
"774","ENSMODG00000001041","1",650561256,650748538,187282
"775","ENSMODG00000001042","7",59283885,59284568,683
"776","ENSMODG00000001043","2",3802669,3830543,27874
"777","ENSMODG00000001045","3",41903336,42218857,315521
"778","ENSMODG00000001046","8",300431428,300464694,33266
"779","ENSMODG00000001048","2",53400432,53418404,17972
"780","ENSMODG00000001049","8",205563039,205585367,22328
"781","ENSMODG00000001050","1",650494020,650526947,32927
"782","ENSMODG00000001051","7",55955430,55955621,191
"783","ENSMODG00000001052","6",82855508,82956285,100777
"784","ENSMODG00000001054","3",414345762,414348009,2247
"785","ENSMODG00000001055","8",205590322,205592692,2370
"786","ENSMODG00000001056","4",132915513,132999356,83843
"787","ENSMODG00000001058","3",441637840,441639861,2021
"788","ENSMODG00000001059","1",650470940,650479649,8709
"789","ENSMODG00000001060","6",26449569,26455127,5558
"790","ENSMODG00000001061","6",83117373,83118417,1044
"791","ENSMODG00000001062","5",125018260,125163431,145171
"792","ENSMODG00000001063","3",441639761,441677133,37372
"793","ENSMODG00000001064","5",213880639,213936282,55643
"794","ENSMODG00000001065","2",107458261,107472155,13894
"795","ENSMODG00000001067","8",205590884,205613813,22929
"796","ENSMODG00000001068","3",414122354,414441533,319179
"797","ENSMODG00000001070","7",59420885,59578165,157280
"798","ENSMODG00000001071","5",124586556,124588076,1520
"799","ENSMODG00000001072","2",24925205,25448938,523733
"800","ENSMODG00000001073","8",205789911,205812095,22184
"801","ENSMODG00000001074","6",26370551,26380395,9844
"802","ENSMODG00000001075","8",300520363,300574049,53686
"803","ENSMODG00000001077","1",650159019,650169018,9999
"804","ENSMODG00000001078","8",90887788,90948565,60777
"805","ENSMODG00000001079","6",83151655,83265160,113505
"806","ENSMODG00000001080","7",59619475,59723791,104316
"807","ENSMODG00000001081","3",441702079,441713772,11693
"808","ENSMODG00000001082","2",107539418,107576625,37207
"809","ENSMODG00000001084","2",53484718,53520882,36164
"810","ENSMODG00000001085","6",26380499,26383406,2907
"811","ENSMODG00000001087","5",124396624,124499254,102630
"812","ENSMODG00000001088","3",412525808,412603619,77811
"813","ENSMODG00000001089","2",107674990,107679456,4466
"814","ENSMODG00000001093","6",83290317,83326189,35872
"815","ENSMODG00000001094","2",107744697,107761263,16566
"816","ENSMODG00000001096","8",300669801,300787247,117446
"817","ENSMODG00000001098","1",650064697,650136741,72044
"818","ENSMODG00000001099","7",135373341,135614809,241468
"819","ENSMODG00000001101","4",133184083,133188958,4875
"820","ENSMODG00000001102","5",213944204,214274944,330740
"821","ENSMODG00000001103","8",90761181,90762939,1758
"822","ENSMODG00000001104","6",26402604,26412397,9793
"823","ENSMODG00000001105","2",107907627,107934280,26653
"824","ENSMODG00000001106","1",649943712,650000145,56433
"825","ENSMODG00000001108","3",441797627,441844841,47214
"826","ENSMODG00000001109","3",412174631,412244891,70260
"827","ENSMODG00000001112","5",124307134,124363426,56292
"828","ENSMODG00000001113","2",107947187,107963541,16354
"829","ENSMODG00000001114","3",412111898,412156766,44868
"830","ENSMODG00000001115","4",133560069,133561283,1214
"831","ENSMODG00000001116","1",57431967,57629688,197721
"832","ENSMODG00000001119","6",26487152,26496653,9501
"833","ENSMODG00000001121","6",26509265,26510975,1710
"834","ENSMODG00000001122","8",90379684,90450881,71197
"835","ENSMODG00000001125","8",90336335,90357224,20889
"836","ENSMODG00000001127","5",123872642,123945750,73108
"837","ENSMODG00000001128","1",57677262,57688307,11045
"838","ENSMODG00000001129","1",649547184,649581553,34369
"839","ENSMODG00000001130","3",441844492,442148955,304463
"840","ENSMODG00000001131","4",134607916,135387246,779330
"841","ENSMODG00000001133","8",90247927,90260186,12259
"842","ENSMODG00000001134","1",57754622,57887422,132800
"843","ENSMODG00000001135","7",137116306,137117241,935
"844","ENSMODG00000001136","5",123720546,123858103,137557
"845","ENSMODG00000001137","2",108168622,108216020,47398
"846","ENSMODG00000001138","6",26523673,26535832,12159
"847","ENSMODG00000001139","1",194151630,194271304,119674
"848","ENSMODG00000001141","7",137195897,137201934,6037
"849","ENSMODG00000001143","7",137222287,137230293,8006
"850","ENSMODG00000001144","3",442313151,442361733,48582
"851","ENSMODG00000001145","1",57998782,58013208,14426
"852","ENSMODG00000001146","1",58116494,58123006,6512
"853","ENSMODG00000001147","8",205834754,205836280,1526
"854","ENSMODG00000001148","3",442423689,442697390,273701
"855","ENSMODG00000001149","5",214498917,214576876,77959
"856","ENSMODG00000001150","7",137253560,137270132,16572
"857","ENSMODG00000001151","2",53612823,53778197,165374
"858","ENSMODG00000001152","8",90074849,90088437,13588
"859","ENSMODG00000001153","1",58203667,58204364,697
"860","ENSMODG00000001154","3",411623333,412004659,381326
"861","ENSMODG00000001155","5",215466943,215467647,704
"862","ENSMODG00000001157","7",137270224,137308359,38135
"863","ENSMODG00000001159","1",194108316,194225313,116997
"864","ENSMODG00000001160","1",649516547,649545989,29442
"865","ENSMODG00000001161","2",25708850,25781451,72601
"866","ENSMODG00000001162","2",482947639,483002250,54611
"867","ENSMODG00000001163","8",90049573,90063256,13683
"868","ENSMODG00000001164","3",411851286,411946828,95542
"869","ENSMODG00000001166","1",193843639,193984557,140918
"870","ENSMODG00000001168","4",135765583,135823445,57862
"871","ENSMODG00000001169","1",648918075,648966667,48592
"872","ENSMODG00000001170","2",25881430,25890721,9291
"873","ENSMODG00000001173","2",53790930,53818352,27422
"874","ENSMODG00000001174","1",193422317,193446710,24393
"875","ENSMODG00000001175","5",123461351,123625406,164055
"876","ENSMODG00000001176","2",53820274,53841086,20812
"877","ENSMODG00000001177","1",58295243,58340148,44905
"878","ENSMODG00000001178","3",443004712,443045821,41109
"879","ENSMODG00000001179","2",3893342,3904872,11530
"880","ENSMODG00000001180","5",216147035,216221065,74030
"881","ENSMODG00000001182","7",59657877,59751420,93543
"882","ENSMODG00000001183","5",123329460,123340507,11047
"883","ENSMODG00000001184","2",108313083,108363353,50270
"884","ENSMODG00000001185","2",3838351,4016597,178246
"885","ENSMODG00000001186","1",648738142,648838637,100495
"886","ENSMODG00000001188","3",411497939,411603535,105596
"887","ENSMODG00000001190","1",648573598,648662860,89262
"888","ENSMODG00000001191","2",54158121,54167002,8881
"889","ENSMODG00000001192","2",108714894,108742706,27812
"890","ENSMODG00000001194","2",4229085,4233516,4431
"891","ENSMODG00000001195","4",136531522,136604227,72705
"892","ENSMODG00000001196","2",482897808,482913672,15864
"893","ENSMODG00000001197","7",59926379,59939917,13538
"894","ENSMODG00000001198","1",391340148,392362623,1022475
"895","ENSMODG00000001199","5",122438348,122789291,350943
"896","ENSMODG00000001201","4",136727637,136987128,259491
"897","ENSMODG00000001204","2",25906103,26073757,167654
"898","ENSMODG00000001207","3",411187990,411293324,105334
"899","ENSMODG00000001208","2",54231265,54314937,83672
"900","ENSMODG00000001209","7",59939589,59957297,17708
"901","ENSMODG00000001210","2",108752438,108782523,30085
"902","ENSMODG00000001211","2",482774329,482848712,74383
"903","ENSMODG00000001212","1",58829904,58992358,162454
"904","ENSMODG00000001213","3",410490931,410590400,99469
"905","ENSMODG00000001215","5",122321505,122348565,27060
"906","ENSMODG00000001216","3",42628328,42629253,925
"907","ENSMODG00000001217","2",26124830,26175379,50549
"908","ENSMODG00000001218","3",410831983,410834019,2036
"909","ENSMODG00000001219","2",26192238,26200105,7867
"910","ENSMODG00000001220","8",206250487,206256708,6221
"911","ENSMODG00000001223","5",216308813,216463626,154813
"912","ENSMODG00000001225","3",42797892,42800336,2444
"913","ENSMODG00000001226","2",26514548,26521812,7264
"914","ENSMODG00000001228","1",390591651,390641927,50276
"915","ENSMODG00000001230","1",550336258,550344535,8277
"916","ENSMODG00000001231","3",410316877,410357537,40660
"917","ENSMODG00000001232","1",59014793,59048251,33458
"918","ENSMODG00000001235","5",216329172,216330372,1200
"919","ENSMODG00000001236","3",443046366,443082565,36199
"920","ENSMODG00000001238","2",56117886,56186703,68817
"921","ENSMODG00000001239","5",122285883,122301677,15794
"922","ENSMODG00000001240","1",648467783,648544894,77111
"923","ENSMODG00000001241","7",59967498,60118935,151437
"924","ENSMODG00000001242","2",26526276,26611193,84917
"925","ENSMODG00000001243","2",4242994,4674509,431515
"926","ENSMODG00000001244","8",89898939,89931961,33022
"927","ENSMODG00000001245","1",390539712,390580508,40796
"928","ENSMODG00000001246","7",60208126,60495920,287794
"929","ENSMODG00000001247","3",42885021,43055893,170872
"930","ENSMODG00000001250","3",43092877,43252835,159958
"931","ENSMODG00000001251","2",4721291,4726457,5166
"932","ENSMODG00000001252","5",122268584,122278630,10046
"933","ENSMODG00000001253","8",300810968,300822933,11965
"934","ENSMODG00000001254","4",137800954,137801476,522
"935","ENSMODG00000001257","3",43269598,43270576,978
"936","ENSMODG00000001258","6",26535362,26542046,6684
"937","ENSMODG00000001259","7",60429781,60430935,1154
"938","ENSMODG00000001260","1",390481859,390533196,51337
"939","ENSMODG00000001262","1",59065387,59399070,333683
"940","ENSMODG00000001263","3",443107968,443146103,38135
"941","ENSMODG00000001264","8",88039649,88448686,409037
"942","ENSMODG00000001265","8",300893106,300899713,6607
"943","ENSMODG00000001267","1",647871603,648149255,277652
"944","ENSMODG00000001268","3",443152251,443156569,4318
"945","ENSMODG00000001269","1",59758224,59775002,16778
"946","ENSMODG00000001270","2",56549051,56741618,192567
"947","ENSMODG00000001273","6",83369961,83453881,83920
"948","ENSMODG00000001274","1",192124741,192347741,223000
"949","ENSMODG00000001275","3",443160244,443162318,2074
"950","ENSMODG00000001277","8",301288444,301369787,81343
"951","ENSMODG00000001279","5",122235155,122246455,11300
"952","ENSMODG00000001280","1",390352359,390409170,56811
"953","ENSMODG00000001282","2",481724396,482068432,344036
"954","ENSMODG00000001284","5",122052287,122059430,7143
"955","ENSMODG00000001285","2",26696827,26918493,221666
"956","ENSMODG00000001286","3",162368997,162372086,3089
"957","ENSMODG00000001287","8",301506967,301513973,7006
"958","ENSMODG00000001289","1",390334297,390350334,16037
"959","ENSMODG00000001290","5",218890088,218890633,545
"960","ENSMODG00000001291","2",56807457,56910514,103057
"961","ENSMODG00000001292","8",87571207,87637368,66161
"962","ENSMODG00000001293","1",191768303,192013247,244944
"963","ENSMODG00000001295","8",206307892,206313159,5267
"964","ENSMODG00000001296","2",57063368,57107109,43741
"965","ENSMODG00000001298","1",390180107,390266663,86556
"966","ENSMODG00000001300","2",4920510,5065141,144631
"967","ENSMODG00000001301","1",645986079,646560447,574368
"968","ENSMODG00000001302","5",121914918,121996120,81202
"969","ENSMODG00000001303","6",83481810,83516848,35038
"970","ENSMODG00000001304","1",59941085,59964226,23141
"971","ENSMODG00000001305","2",57154792,57181625,26833
"972","ENSMODG00000001306","1",646015334,646016177,843
"973","ENSMODG00000001307","3",410151874,410310359,158485
"974","ENSMODG00000001308","3",443163521,443196142,32621
"975","ENSMODG00000001310","3",43653339,43855639,202300
"976","ENSMODG00000001311","2",481702957,481715291,12334
"977","ENSMODG00000001313","1",390148236,390162350,14114
"978","ENSMODG00000001314","3",443363713,443365216,1503
"979","ENSMODG00000001316","6",83543455,83588390,44935
"980","ENSMODG00000001318","7",60540238,60619423,79185
"981","ENSMODG00000001319","5",219879172,219929747,50575
"982","ENSMODG00000001320","8",87309353,87809422,500069
"983","ENSMODG00000001321","2",57216197,57238432,22235
"984","ENSMODG00000001322","8",206315737,206336157,20420
"985","ENSMODG00000001323","2",481608018,481624334,16316
"986","ENSMODG00000001324","6",83599007,83604303,5296
"987","ENSMODG00000001325","5",121723365,121724369,1004
"988","ENSMODG00000001327","3",44173590,44264882,91292
"989","ENSMODG00000001329","6",83610637,83612234,1597
"990","ENSMODG00000001331","2",481403274,481408116,4842
"991","ENSMODG00000001332","7",60681431,60695906,14475
"992","ENSMODG00000001333","1",190047580,190464995,417415
"993","ENSMODG00000001335","2",57303297,57357285,53988
"994","ENSMODG00000001336","8",87278758,87299993,21235
"995","ENSMODG00000001337","7",60708523,60715599,7076
"996","ENSMODG00000001338","2",481320550,481332128,11578
"997","ENSMODG00000001339","3",443368866,443397339,28473
"998","ENSMODG00000001340","5",121294299,121373031,78732
"999","ENSMODG00000001343","3",443542880,443563816,20936
"1000","ENSMODG00000001344","3",91903113,91994580,91467
"1001","ENSMODG00000001346","3",443563724,443571441,7717
"1002","ENSMODG00000001347","7",60764566,60796118,31552
"1003","ENSMODG00000001348","2",5148386,6003224,854838
"1004","ENSMODG00000001349","2",57422382,57501746,79364
"1005","ENSMODG00000001350","6",83613041,83648393,35352
"1006","ENSMODG00000001351","2",481347560,481359225,11665
"1007","ENSMODG00000001352","2",27288821,27389244,100423
"1008","ENSMODG00000001353","1",390075417,390123678,48261
"1009","ENSMODG00000001355","8",87215075,87256476,41401
"1010","ENSMODG00000001356","8",301514292,301838853,324561
"1011","ENSMODG00000001357","3",443572309,443575090,2781
"1012","ENSMODG00000001358","7",60824176,60837809,13633
"1013","ENSMODG00000001359","2",108789476,108816152,26676
"1014","ENSMODG00000001360","2",57738184,57861312,123128
"1015","ENSMODG00000001364","2",481340819,481347145,6326
"1016","ENSMODG00000001367","6",83648014,83665080,17066
"1017","ENSMODG00000001368","8",301864854,301923138,58284
"1018","ENSMODG00000001369","1",189588886,189706262,117376
"1019","ENSMODG00000001370","2",6058049,6198982,140933
"1020","ENSMODG00000001371","3",443579003,443657753,78750
"1021","ENSMODG00000001372","2",481287577,481305651,18074
"1022","ENSMODG00000001373","2",109158961,109186488,27527
"1023","ENSMODG00000001374","2",27811309,27879101,67792
"1024","ENSMODG00000001375","8",302548059,302549209,1150
"1025","ENSMODG00000001377","6",83830079,83836708,6629
"1026","ENSMODG00000001378","1",390039935,390074742,34807
"1027","ENSMODG00000001379","2",27898589,27899003,414
"1028","ENSMODG00000001380","7",137391614,137763153,371539
"1029","ENSMODG00000001384","1",189524266,189533877,9611
"1030","ENSMODG00000001386","8",206381658,206385331,3673
"1031","ENSMODG00000001387","7",60882666,60920704,38038
"1032","ENSMODG00000001388","8",302823588,302926908,103320
"1033","ENSMODG00000001389","2",243694708,243726003,31295
"1034","ENSMODG00000001390","3",44334819,44519602,184783
"1035","ENSMODG00000001391","1",390000527,390028178,27651
"1036","ENSMODG00000001392","5",220252665,220306021,53356
"1037","ENSMODG00000001393","2",28585544,28623529,37985
"1038","ENSMODG00000001394","8",303087734,303163039,75305
"1039","ENSMODG00000001395","1",189482274,189485312,3038
"1040","ENSMODG00000001396","8",303541635,303621347,79712
"1041","ENSMODG00000001398","3",443674481,443821460,146979
"1042","ENSMODG00000001399","2",6216879,6231296,14417
"1043","ENSMODG00000001402","8",303640065,303646357,6292
"1044","ENSMODG00000001404","6",84265412,84344686,79274
"1045","ENSMODG00000001405","8",304069648,304070145,497
"1046","ENSMODG00000001406","8",206464126,206473722,9596
"1047","ENSMODG00000001408","6",84404381,84456399,52018
"1048","ENSMODG00000001409","7",60916610,60984843,68233
"1049","ENSMODG00000001410","6",84544076,84560883,16807
"1050","ENSMODG00000001412","2",531405874,531406359,485
"1051","ENSMODG00000001413","2",7154315,7155889,1574
"1052","ENSMODG00000001414","8",87193736,87212204,18468
"1053","ENSMODG00000001415","3",44963360,44988200,24840
"1054","ENSMODG00000001416","2",7155222,7326820,171598
"1055","ENSMODG00000001417","1",189139611,189169498,29887
"1056","ENSMODG00000001419","2",7186371,7187582,1211
"1057","ENSMODG00000001420","3",92025893,92206233,180340
"1058","ENSMODG00000001421","6",84563588,84642092,78504
"1059","ENSMODG00000001422","1",189063260,189128853,65593
"1060","ENSMODG00000001423","1",389840365,389981191,140826
"1061","ENSMODG00000001425","3",92919710,92936255,16545
"1062","ENSMODG00000001426","1",189005835,189006389,554
"1063","ENSMODG00000001427","1",389634248,389655018,20770
"1064","ENSMODG00000001428","3",93000396,93000969,573
"1065","ENSMODG00000001430","3",408342411,408724584,382173
"1066","ENSMODG00000001431","3",443912838,443982805,69967
"1067","ENSMODG00000001433","2",481236205,481249194,12989
"1068","ENSMODG00000001434","7",138111459,138253326,141867
"1069","ENSMODG00000001435","6",84781095,85043599,262504
"1070","ENSMODG00000001436","3",44999966,45033106,33140
"1071","ENSMODG00000001437","3",93079479,93084814,5335
"1072","ENSMODG00000001441","1",188611000,188966780,355780
"1073","ENSMODG00000001442","8",304257015,304835865,578850
"1074","ENSMODG00000001444","1",188447791,188449689,1898
"1075","ENSMODG00000001445","3",45050303,45053513,3210
"1076","ENSMODG00000001446","3",94853686,94860053,6367
"1077","ENSMODG00000001448","8",87098958,87124544,25586
"1078","ENSMODG00000001449","6",85059355,85112563,53208
"1079","ENSMODG00000001450","5",220379770,220735637,355867
"1080","ENSMODG00000001451","3",96228973,96235938,6965
"1081","ENSMODG00000001452","Un",9375973,9376284,311
"1082","ENSMODG00000001453","6",85194265,85196026,1761
"1083","ENSMODG00000001455","8",305163752,305164833,1081
"1084","ENSMODG00000001456","6",85157002,85159945,2943
"1085","ENSMODG00000001457","1",188298169,188317912,19743
"1086","ENSMODG00000001458","7",61660546,61781237,120691
"1087","ENSMODG00000001460","3",45028304,45177412,149108
"1088","ENSMODG00000001462","5",220841402,220842838,1436
"1089","ENSMODG00000001464","8",305330184,305419576,89392
"1090","ENSMODG00000001465","8",206474621,206494370,19749
"1091","ENSMODG00000001467","2",481208059,481222732,14673
"1092","ENSMODG00000001468","6",85200066,85206516,6450
"1093","ENSMODG00000001470","2",7223026,7251890,28864
"1094","ENSMODG00000001471","8",87077872,87091187,13315
"1095","ENSMODG00000001472","7",62105394,62223432,118038
"1096","ENSMODG00000001473","2",481179975,481188718,8743
"1097","ENSMODG00000001474","2",109547356,109562455,15099
"1098","ENSMODG00000001476","6",85210707,85214664,3957
"1099","ENSMODG00000001481","7",138284720,138375028,90308
"1100","ENSMODG00000001482","7",62362328,62416808,54480
"1101","ENSMODG00000001483","2",243035770,243216581,180811
"1102","ENSMODG00000001484","2",28720386,28850353,129967
"1103","ENSMODG00000001485","2",481121540,481137153,15613
"1104","ENSMODG00000001489","7",62589091,62598564,9473
"1105","ENSMODG00000001490","1",389524676,389604496,79820
"1106","ENSMODG00000001491","1",60046932,60057736,10804
"1107","ENSMODG00000001493","2",481047890,481077317,29427
"1108","ENSMODG00000001494","2",7275912,7334235,58323
"1109","ENSMODG00000001497","6",26550803,26559257,8454
"1110","ENSMODG00000001498","2",242984209,242991660,7451
"1111","ENSMODG00000001499","6",85216155,85223719,7564
"1112","ENSMODG00000001500","5",220972298,220986921,14623
"1113","ENSMODG00000001501","1",389359945,389448544,88599
"1114","ENSMODG00000001502","2",7370462,7382400,11938
"1115","ENSMODG00000001503","8",305628425,305629080,655
"1116","ENSMODG00000001504","1",389297857,389298381,524
"1117","ENSMODG00000001505","6",85240706,85271749,31043
"1118","ENSMODG00000001506","2",28768852,28777676,8824
"1119","ENSMODG00000001507","7",138554321,138582794,28473
"1120","ENSMODG00000001508","1",60174401,60179533,5132
"1121","ENSMODG00000001509","2",7420057,7432986,12929
"1122","ENSMODG00000001511","2",109587145,109637266,50121
"1123","ENSMODG00000001512","7",139324254,139325072,818
"1124","ENSMODG00000001513","6",85274910,85281163,6253
"1125","ENSMODG00000001514","2",28850199,28858660,8461
"1126","ENSMODG00000001515","7",139422641,139424967,2326
"1127","ENSMODG00000001516","5",221002995,221034133,31138
"1128","ENSMODG00000001517","6",26560546,26566154,5608
"1129","ENSMODG00000001518","2",242871566,242945768,74202
"1130","ENSMODG00000001519","5",221089272,221121778,32506
"1131","ENSMODG00000001520","2",481000626,481044321,43695
"1132","ENSMODG00000001521","2",7458787,7508019,49232
"1133","ENSMODG00000001522","3",407247238,407770798,523560
"1134","ENSMODG00000001523","3",98748003,99006894,258891
"1135","ENSMODG00000001524","1",60212083,60252647,40564
"1136","ENSMODG00000001525","7",139435400,139486813,51413
"1137","ENSMODG00000001526","3",500381279,500400453,19174
"1138","ENSMODG00000001528","8",305708701,305739241,30540
"1139","ENSMODG00000001530","5",221121084,221298655,177571
"1140","ENSMODG00000001531","1",645614393,645822120,207727
"1141","ENSMODG00000001532","1",60283380,60309428,26048
"1142","ENSMODG00000001533","1",389147154,389293716,146562
"1143","ENSMODG00000001534","8",206573946,206575720,1774
"1144","ENSMODG00000001535","5",221747682,221751944,4262
"1145","ENSMODG00000001537","8",306062196,306075505,13309
"1146","ENSMODG00000001538","3",499651101,499749292,98191
"1147","ENSMODG00000001539","2",29031623,29092030,60407
"1148","ENSMODG00000001540","3",99207674,99294916,87242
"1149","ENSMODG00000001542","5",221935276,221944947,9671
"1150","ENSMODG00000001544","8",306108878,306117729,8851
"1151","ENSMODG00000001545","1",60386331,60430053,43722
"1152","ENSMODG00000001547","2",242718821,242823838,105017
"1153","ENSMODG00000001548","2",480949316,480977727,28411
"1154","ENSMODG00000001550","8",206615809,206616735,926
"1155","ENSMODG00000001551","8",306128038,306157406,29368
"1156","ENSMODG00000001556","1",60477198,60566371,89173
"1157","ENSMODG00000001557","1",389112256,389138321,26065
"1158","ENSMODG00000001558","2",109871884,109883134,11250
"1159","ENSMODG00000001559","8",86723351,87054145,330794
"1160","ENSMODG00000001562","1",389107932,389108474,542
"1161","ENSMODG00000001563","8",206799988,206800968,980
"1162","ENSMODG00000001565","2",480880925,480904593,23668
"1163","ENSMODG00000001566","2",242554617,242561590,6973
"1164","ENSMODG00000001567","8",206820082,206821035,953
"1165","ENSMODG00000001568","6",85310115,85351241,41126
"1166","ENSMODG00000001570","2",242550575,242553890,3315
"1167","ENSMODG00000001571","1",60570639,60653884,83245
"1168","ENSMODG00000001572","8",206769308,206770264,956
"1169","ENSMODG00000001574","7",140282601,140386614,104013
"1170","ENSMODG00000001575","2",242546470,242765127,218657
"1171","ENSMODG00000001577","6",85366709,85387323,20614
"1172","ENSMODG00000001578","2",480850247,480873840,23593
"1173","ENSMODG00000001579","8",86486980,86536025,49045
"1174","ENSMODG00000001580","2",242513083,242545526,32443
"1175","ENSMODG00000001582","8",306193046,306234915,41869
"1176","ENSMODG00000001583","2",109890654,109946843,56189
"1177","ENSMODG00000001584","1",641247978,641345914,97936
"1178","ENSMODG00000001585","1",389089576,389108405,18829
"1179","ENSMODG00000001586","7",140380260,140609171,228911
"1180","ENSMODG00000001588","6",85462199,85469803,7604
"1181","ENSMODG00000001589","8",86466779,86467969,1190
"1182","ENSMODG00000001590","5",121163882,121164916,1034
"1183","ENSMODG00000001591","1",389063021,389068642,5621
"1184","ENSMODG00000001592","7",141537533,141538960,1427
"1185","ENSMODG00000001593","1",641221635,641233418,11783
"1186","ENSMODG00000001594","3",406991590,407031987,40397
"1187","ENSMODG00000001595","8",86447412,86461450,14038
"1188","ENSMODG00000001600","8",306265775,306282788,17013
"1189","ENSMODG00000001601","2",242290353,242462175,171822
"1190","ENSMODG00000001602","6",85476642,85482190,5548
"1191","ENSMODG00000001603","5",120847064,120902096,55032
"1192","ENSMODG00000001605","2",110022354,110069666,47312
"1193","ENSMODG00000001607","8",306366248,306371929,5681
"1194","ENSMODG00000001608","2",480829432,480830493,1061
"1195","ENSMODG00000001609","2",58363849,58395144,31295
"1196","ENSMODG00000001611","1",60719128,60924693,205565
"1197","ENSMODG00000001618","2",58558700,58587861,29161
"1198","ENSMODG00000001619","6",85617273,85623443,6170
"1199","ENSMODG00000001620","1",668943915,668945552,1637
"1200","ENSMODG00000001625","2",58587656,58606231,18575
"1201","ENSMODG00000001626","1",187413706,188193535,779829
"1202","ENSMODG00000001627","6",85623867,85628076,4209
"1203","ENSMODG00000001629","8",86291355,86383361,92006
"1204","ENSMODG00000001630","5",120741861,120820524,78663
"1205","ENSMODG00000001631","1",641163732,641192820,29088
"1206","ENSMODG00000001635","8",207300019,207331694,31675
"1207","ENSMODG00000001637","2",480480313,480482082,1769
"1208","ENSMODG00000001638","2",241927108,242011548,84440
"1209","ENSMODG00000001640","3",45203615,45301439,97824
"1210","ENSMODG00000001641","3",406908831,406925985,17154
"1211","ENSMODG00000001642","1",187220330,187466627,246297
"1212","ENSMODG00000001644","3",45348862,45351820,2958
"1213","ENSMODG00000001646","8",306441821,306666242,224421
"1214","ENSMODG00000001647","1",187166002,187188550,22548
"1215","ENSMODG00000001650","2",484538740,484539557,817
"1216","ENSMODG00000001652","2",241441903,241668478,226575
"1217","ENSMODG00000001653","3",406816642,406831037,14395
"1218","ENSMODG00000001655","1",64075195,64112839,37644
"1219","ENSMODG00000001656","8",307067782,307155460,87678
"1220","ENSMODG00000001657","1",187089608,187122089,32481
"1221","ENSMODG00000001658","1",389038953,389043195,4242
"1222","ENSMODG00000001661","8",86170678,86272526,101848
"1223","ENSMODG00000001662","2",110585428,110788610,203182
"1224","ENSMODG00000001665","1",187030648,187035031,4383
"1225","ENSMODG00000001667","8",207384082,207403002,18920
"1226","ENSMODG00000001668","6",85628213,85637013,8800
"1227","ENSMODG00000001669","1",389032109,389036334,4225
"1228","ENSMODG00000001673","1",640976516,641075009,98493
"1229","ENSMODG00000001677","2",480098414,480111838,13424
"1230","ENSMODG00000001679","6",85651351,85693302,41951
"1231","ENSMODG00000001681","3",45907983,46032571,124588
"1232","ENSMODG00000001686","2",480051057,480058120,7063
"1233","ENSMODG00000001687","3",46065496,46218946,153450
"1234","ENSMODG00000001688","6",85750896,85757468,6572
"1235","ENSMODG00000001690","5",120468111,120497824,29713
"1236","ENSMODG00000001691","7",63098681,63378457,279776
"1237","ENSMODG00000001692","2",110841099,110879302,38203
"1238","ENSMODG00000001693","1",65309458,65326180,16722
"1239","ENSMODG00000001694","5",120420398,120461976,41578
"1240","ENSMODG00000001695","3",46217612,46261096,43484
"1241","ENSMODG00000001697","5",222100259,222386935,286676
"1242","ENSMODG00000001699","6",85759204,85764619,5415
"1243","ENSMODG00000001701","2",479926414,479952773,26359
"1244","ENSMODG00000001702","3",46378146,46496445,118299
"1245","ENSMODG00000001703","6",85764775,85768182,3407
"1246","ENSMODG00000001704","7",63387109,63391752,4643
"1247","ENSMODG00000001705","6",85814852,85824572,9720
"1248","ENSMODG00000001706","2",479766418,479915008,148590
"1249","ENSMODG00000001708","2",110890905,110941861,50956
"1250","ENSMODG00000001709","2",7691554,7716124,24570
"1251","ENSMODG00000001710","2",479488081,479505060,16979
"1252","ENSMODG00000001711","6",85826029,85829789,3760
"1253","ENSMODG00000001715","1",65381041,65434552,53511
"1254","ENSMODG00000001716","5",222480357,222655776,175419
"1255","ENSMODG00000001718","1",65447060,65452663,5603
"1256","ENSMODG00000001720","2",479673741,479713972,40231
"1257","ENSMODG00000001721","3",46993315,47065733,72418
"1258","ENSMODG00000001722","Un",11928037,11931682,3645
"1259","ENSMODG00000001723","5",118959562,119227456,267894
"1260","ENSMODG00000001724","7",63390008,63532033,142025
"1261","ENSMODG00000001725","1",187000757,187031113,30356
"1262","ENSMODG00000001726","6",85832734,85903461,70727
"1263","ENSMODG00000001727","Un",11932776,11941392,8616
"1264","ENSMODG00000001728","3",405238761,405239626,865
"1265","ENSMODG00000001729","1",65463877,65473902,10025
"1266","ENSMODG00000001730","1",388986205,389017870,31665
"1267","ENSMODG00000001731","5",222683589,222834391,150802
"1268","ENSMODG00000001734","Un",56769575,56796012,26437
"1269","ENSMODG00000001735","3",403998703,404002709,4006
"1270","ENSMODG00000001736","1",640082697,640271040,188343
"1271","ENSMODG00000001737","7",63628496,63666213,37717
"1272","ENSMODG00000001738","6",85848652,85852773,4121
"1273","ENSMODG00000001739","5",118723911,118830804,106893
"1274","ENSMODG00000001741","3",400441426,400451849,10423
"1275","ENSMODG00000001742","3",47141279,47259636,118357
"1276","ENSMODG00000001744","2",479595054,479633947,38893
"1277","ENSMODG00000001746","1",186880296,186897474,17178
"1278","ENSMODG00000001747","3",47310152,47359755,49603
"1279","ENSMODG00000001748","4",53689979,53896664,206685
"1280","ENSMODG00000001750","7",63680395,63709854,29459
"1281","ENSMODG00000001752","Un",12051598,12072626,21028
"1282","ENSMODG00000001753","3",400386625,400388346,1721
"1283","ENSMODG00000001755","2",479382829,479398698,15869
"1284","ENSMODG00000001756","3",47415284,47417699,2415
"1285","ENSMODG00000001757","2",111019455,111086127,66672
"1286","ENSMODG00000001759","7",63754164,63815996,61832
"1287","ENSMODG00000001760","5",222830557,222909613,79056
"1288","ENSMODG00000001762","3",47885076,47895472,10396
"1289","ENSMODG00000001763","7",63936835,63938108,1273
"1290","ENSMODG00000001764","3",400316809,400318533,1724
"1291","ENSMODG00000001766","Un",12073390,12088017,14627
"1292","ENSMODG00000001767","1",388976196,388983135,6939
"1293","ENSMODG00000001769","2",111135398,111160395,24997
"1294","ENSMODG00000001770","1",186868955,186883097,14142
"1295","ENSMODG00000001771","1",65519098,65537132,18034
"1296","ENSMODG00000001772","Un",12184996,12213719,28723
"1297","ENSMODG00000001775","6",85858325,85874839,16514
"1298","ENSMODG00000001777","3",47948308,47969191,20883
"1299","ENSMODG00000001778","2",111203898,111224384,20486
"1300","ENSMODG00000001780","Un",12214895,12243582,28687
"1301","ENSMODG00000001782","1",185647573,186319756,672183
"1302","ENSMODG00000001783","1",639697365,639866910,169545
"1303","ENSMODG00000001784","1",65552227,65683430,131203
"1304","ENSMODG00000001785","2",239902177,240167191,265014
"1305","ENSMODG00000001788","1",388893996,388935033,41037
"1306","ENSMODG00000001789","3",47968846,47990791,21945
"1307","ENSMODG00000001792","1",388856175,388861987,5812
"1308","ENSMODG00000001794","6",85904777,85910397,5620
"1309","ENSMODG00000001795","2",111434396,111492236,57840
"1310","ENSMODG00000001796","1",184779928,185101196,321268
"1311","ENSMODG00000001797","2",479346120,479375202,29082
"1312","ENSMODG00000001799","6",85938067,85940944,2877
"1313","ENSMODG00000001800","3",399916552,399994749,78197
"1314","ENSMODG00000001801","1",183748610,183789251,40641
"1315","ENSMODG00000001803","1",639632476,639694164,61688
"1316","ENSMODG00000001804","2",111548319,111640224,91905
"1317","ENSMODG00000001805","2",239845481,239873508,28027
"1318","ENSMODG00000001806","8",210966762,212617006,1650244
"1319","ENSMODG00000001807","5",118481215,118663619,182404
"1320","ENSMODG00000001808","6",85954935,85960433,5498
"1321","ENSMODG00000001809","6",26590870,26591639,769
"1322","ENSMODG00000001810","6",85963223,85968355,5132
"1323","ENSMODG00000001811","3",399866983,399914421,47438
"1324","ENSMODG00000001812","6",85969517,85971162,1645
"1325","ENSMODG00000001813","1",639390367,639437029,46662
"1326","ENSMODG00000001814","3",399844607,399850385,5778
"1327","ENSMODG00000001815","1",183568792,183665054,96262
"1328","ENSMODG00000001816","4",56213574,56434582,221008
"1329","ENSMODG00000001817","2",111652570,111664744,12174
"1330","ENSMODG00000001818","1",388730286,388837364,107078
"1331","ENSMODG00000001819","1",639370771,639372916,2145
"1332","ENSMODG00000001820","2",239793780,239818801,25021
"1333","ENSMODG00000001821","2",479292651,479342620,49969
"1334","ENSMODG00000001823","1",183527702,183539988,12286
"1335","ENSMODG00000001824","2",111703334,111733357,30023
"1336","ENSMODG00000001825","8",212878934,212985605,106671
"1337","ENSMODG00000001827","2",479207305,479213883,6578
"1338","ENSMODG00000001828","3",399265793,399504967,239174
"1339","ENSMODG00000001829","4",56529619,56772789,243170
"1340","ENSMODG00000001830","1",214920988,215142911,221923
"1341","ENSMODG00000001831","3",399260887,399267558,6671
"1342","ENSMODG00000001832","2",111801529,111845358,43829
"1343","ENSMODG00000001833","1",639342865,639369399,26534
"1344","ENSMODG00000001835","1",639318564,639320319,1755
"1345","ENSMODG00000001837","6",85989910,85992782,2872
"1346","ENSMODG00000001838","3",48096095,48443604,347509
"1347","ENSMODG00000001840","3",399205970,399261659,55689
"1348","ENSMODG00000001842","2",478884307,478895443,11136
"1349","ENSMODG00000001843","2",111869335,111880724,11389
"1350","ENSMODG00000001844","1",388623349,388671956,48607
"1351","ENSMODG00000001846","2",239656222,239708290,52068
"1352","ENSMODG00000001847","3",399196717,399208177,11460
"1353","ENSMODG00000001848","1",388590506,388595071,4565
"1354","ENSMODG00000001852","8",212989472,213048055,58583
"1355","ENSMODG00000001853","2",7754225,7754716,491
"1356","ENSMODG00000001854","2",239682198,239699756,17558
"1357","ENSMODG00000001856","6",85995920,86005379,9459
"1358","ENSMODG00000001859","2",111889358,111928891,39533
"1359","ENSMODG00000001864","8",213249172,213291183,42011
"1360","ENSMODG00000001865","1",388548236,388572620,24384
"1361","ENSMODG00000001866","1",217135528,217514192,378664
"1362","ENSMODG00000001868","3",398999010,399052938,53928
"1363","ENSMODG00000001870","2",111960883,112012069,51186
"1364","ENSMODG00000001871","2",239617149,239640926,23777
"1365","ENSMODG00000001872","3",49634200,49664447,30247
"1366","ENSMODG00000001873","1",183287065,183493232,206167
"1367","ENSMODG00000001874","6",86005087,86008941,3854
"1368","ENSMODG00000001875","1",65692046,65713025,20979
"1369","ENSMODG00000001876","2",478819578,478824655,5077
"1370","ENSMODG00000001877","4",61389493,61454063,64570
"1371","ENSMODG00000001878","1",388447259,388536168,88909
"1372","ENSMODG00000001879","2",239316255,239317232,977
"1373","ENSMODG00000001880","8",213308335,213320913,12578
"1374","ENSMODG00000001881","2",239288461,239289165,704
"1375","ENSMODG00000001883","6",86010754,86023203,12449
"1376","ENSMODG00000001884","8",85958852,86108296,149444
"1377","ENSMODG00000001885","1",639177251,639310782,133531
"1378","ENSMODG00000001886","3",444128456,444246376,117920
"1379","ENSMODG00000001887","2",112026008,112069222,43214
"1380","ENSMODG00000001888","4",62095113,62107177,12064
"1381","ENSMODG00000001889","6",86075784,86086235,10451
"1382","ENSMODG00000001890","2",7828543,7854592,26049
"1383","ENSMODG00000001891","4",62154981,62210233,55252
"1384","ENSMODG00000001892","3",49667218,49722012,54794
"1385","ENSMODG00000001893","2",239155669,239210500,54831
"1386","ENSMODG00000001894","1",639029900,639066821,36921
"1387","ENSMODG00000001895","1",65742417,65777155,34738
"1388","ENSMODG00000001896","6",86124135,86770461,646326
"1389","ENSMODG00000001897","3",398540969,398714091,173122
"1390","ENSMODG00000001899","2",478806289,478814289,8000
"1391","ENSMODG00000001900","3",49721851,49732197,10346
"1392","ENSMODG00000001901","1",65803766,65889579,85813
"1393","ENSMODG00000001902","1",217729972,217734081,4109
"1394","ENSMODG00000001903","4",62236791,62269994,33203
"1395","ENSMODG00000001904","6",87120584,87132043,11459
"1396","ENSMODG00000001905","1",65906377,65907015,638
"1397","ENSMODG00000001906","2",7886995,7921183,34188
"1398","ENSMODG00000001908","2",7922258,7922800,542
"1399","ENSMODG00000001909","8",85921097,85951217,30120
"1400","ENSMODG00000001910","3",279210519,279211290,771
"1401","ENSMODG00000001911","1",217741778,217742466,688
"1402","ENSMODG00000001912","1",183124640,183274877,150237
"1403","ENSMODG00000001913","3",444309580,444332058,22478
"1404","ENSMODG00000001914","3",49746869,49808700,61831
"1405","ENSMODG00000001915","2",112148876,112173283,24407
"1406","ENSMODG00000001916","4",62343369,62454267,110898
"1407","ENSMODG00000001917","8",85819465,85837233,17768
"1408","ENSMODG00000001918","2",7937879,7952916,15037
"1409","ENSMODG00000001919","3",398280989,398334544,53555
"1410","ENSMODG00000001920","1",217768933,217924464,155531
"1411","ENSMODG00000001921","3",444351580,444352162,582
"1412","ENSMODG00000001922","2",478748308,478765184,16876
"1413","ENSMODG00000001923","3",444383721,444386208,2487
"1414","ENSMODG00000001925","1",217949399,218223580,274181
"1415","ENSMODG00000001926","8",85659172,85741150,81978
"1416","ENSMODG00000001927","4",62354345,62384638,30293
"1417","ENSMODG00000001928","2",7976961,7994256,17295
"1418","ENSMODG00000001929","3",398121960,398165547,43587
"1419","ENSMODG00000001930","4",62354581,62354889,308
"1420","ENSMODG00000001931","8",85175448,85176232,784
"1421","ENSMODG00000001932","6",87192065,87851073,659008
"1422","ENSMODG00000001933","2",478722260,478735358,13098
"1423","ENSMODG00000001934","1",66002545,66194866,192321
"1424","ENSMODG00000001935","1",638943505,639026556,83051
"1425","ENSMODG00000001936","1",134563248,134565778,2530
"1426","ENSMODG00000001937","1",218306861,218378576,71715
"1427","ENSMODG00000001939","2",112189248,112199660,10412
"1428","ENSMODG00000001940","6",88562596,88563297,701
"1429","ENSMODG00000001941","3",444394286,444399941,5655
"1430","ENSMODG00000001942","5",117195870,117241932,46062
"1431","ENSMODG00000001943","4",62408251,62423171,14920
"1432","ENSMODG00000001944","3",398069737,398091660,21923
"1433","ENSMODG00000001946","Un",12248054,12248776,722
"1434","ENSMODG00000001947","4",62458463,62463379,4916
"1435","ENSMODG00000001948","1",183040456,183091646,51190
"1436","ENSMODG00000001949","1",66227818,66253839,26021
"1437","ENSMODG00000001950","1",183005448,183010342,4894
"1438","ENSMODG00000001951","2",8006847,8041501,34654
"1439","ENSMODG00000001952","3",444467686,444480325,12639
"1440","ENSMODG00000001954","3",444636654,444642390,5736
"1441","ENSMODG00000001955","6",88798568,88860524,61956
"1442","ENSMODG00000001956","5",117084760,117157688,72928
"1443","ENSMODG00000001957","2",238925018,239156894,231876
"1444","ENSMODG00000001959","3",444529894,444932122,402228
"1445","ENSMODG00000001960","2",112324419,112335244,10825
"1446","ENSMODG00000001961","8",213368860,213425397,56537
"1447","ENSMODG00000001962","1",182911828,182941944,30116
"1448","ENSMODG00000001963","2",8118550,8125498,6948
"1449","ENSMODG00000001964","4",62466107,62662141,196034
"1450","ENSMODG00000001966","6",88866326,88899687,33361
"1451","ENSMODG00000001967","3",99656329,99657230,901
"1452","ENSMODG00000001969","2",238999053,239007787,8734
"1453","ENSMODG00000001970","2",112402970,112414065,11095
"1454","ENSMODG00000001972","3",397884723,397926566,41843
"1455","ENSMODG00000001973","5",116488754,116698987,210233
"1456","ENSMODG00000001974","8",213435850,213466451,30601
"1457","ENSMODG00000001975","2",478664332,478709677,45345
"1458","ENSMODG00000001977","5",116544740,116546221,1481
"1459","ENSMODG00000001978","8",84889224,84981298,92074
"1460","ENSMODG00000001979","1",182794067,182858510,64443
"1461","ENSMODG00000001980","Un",12314139,12357374,43235
"1462","ENSMODG00000001981","3",397794347,397812225,17878
"1463","ENSMODG00000001982","1",66284610,66341680,57070
"1464","ENSMODG00000001983","4",62675204,62790595,115391
"1465","ENSMODG00000001984","1",638839494,638901344,61850
"1466","ENSMODG00000001985","2",478656748,478658097,1349
"1467","ENSMODG00000001986","2",8340152,8365055,24903
"1468","ENSMODG00000001987","8",213477818,213500295,22477
"1469","ENSMODG00000001988","2",238808937,238893763,84826
"1470","ENSMODG00000001989","2",478569931,478572631,2700
"1471","ENSMODG00000001990","6",88995656,89044623,48967
"1472","ENSMODG00000001991","8",213523365,213544808,21443
"1473","ENSMODG00000001992","1",182700514,182778666,78152
"1474","ENSMODG00000001993","2",112419575,112651310,231735
"1475","ENSMODG00000001994","1",218633528,218712046,78518
"1476","ENSMODG00000001995","6",89075425,89088911,13486
"1477","ENSMODG00000001996","2",8409134,8419025,9891
"1478","ENSMODG00000001998","2",8420917,8421663,746
"1479","ENSMODG00000001999","2",238591170,238636651,45481
"1480","ENSMODG00000002000","1",66375980,66455769,79789
"1481","ENSMODG00000002001","Un",12358873,12369148,10275
"1482","ENSMODG00000002002","1",182637711,182683813,46102
"1483","ENSMODG00000002003","2",478558632,478568557,9925
"1484","ENSMODG00000002005","1",638623641,638690243,66602
"1485","ENSMODG00000002006","1",218748339,218788438,40099
"1486","ENSMODG00000002007","1",182598515,182625957,27442
"1487","ENSMODG00000002009","5",116406100,116451075,44975
"1488","ENSMODG00000002010","4",63048215,63344948,296733
"1489","ENSMODG00000002011","1",66462766,66469630,6864
"1490","ENSMODG00000002012","1",218796721,218798982,2261
"1491","ENSMODG00000002014","2",238482783,238574249,91466
"1492","ENSMODG00000002015","3",50076263,50077630,1367
"1493","ENSMODG00000002016","2",112662411,112697934,35523
"1494","ENSMODG00000002018","2",8426213,8441815,15602
"1495","ENSMODG00000002019","2",478536282,478557414,21132
"1496","ENSMODG00000002020","7",64037776,64038445,669
"1497","ENSMODG00000002021","2",238254892,238286760,31868
"1498","ENSMODG00000002022","3",50166823,50316388,149565
"1499","ENSMODG00000002023","3",444536305,444541756,5451
"1500","ENSMODG00000002024","8",84832478,84887225,54747
"1501","ENSMODG00000002025","3",100902987,100942106,39119
"1502","ENSMODG00000002026","1",182532481,182580919,48438
"1503","ENSMODG00000002027","3",397704071,397781166,77095
"1504","ENSMODG00000002030","2",238186865,238256029,69164
"1505","ENSMODG00000002031","6",89118822,89375733,256911
"1506","ENSMODG00000002032","2",8442224,8460746,18522
"1507","ENSMODG00000002033","2",8471908,8478781,6873
"1508","ENSMODG00000002034","2",478468694,478488711,20017
"1509","ENSMODG00000002035","3",397646734,397649481,2747
"1510","ENSMODG00000002037","2",238136641,238157538,20897
"1511","ENSMODG00000002038","2",112723110,112836827,113717
"1512","ENSMODG00000002039","3",101270960,101309321,38361
"1513","ENSMODG00000002040","3",397585134,397623987,38853
"1514","ENSMODG00000002041","1",638270916,638280710,9794
"1515","ENSMODG00000002042","1",218814313,218838184,23871
"1516","ENSMODG00000002043","3",101309522,101339104,29582
"1517","ENSMODG00000002044","7",64130050,64170448,40398
"1518","ENSMODG00000002046","6",89447123,89674638,227515
"1519","ENSMODG00000002047","1",66639244,66673865,34621
"1520","ENSMODG00000002048","3",444552373,444562029,9656
"1521","ENSMODG00000002049","1",637324198,637489403,165205
"1522","ENSMODG00000002050","3",397556605,397580361,23756
"1523","ENSMODG00000002051","7",64289206,64298637,9431
"1524","ENSMODG00000002052","3",101496280,101584902,88622
"1525","ENSMODG00000002053","5",116244025,116390192,146167
"1526","ENSMODG00000002055","3",444571926,444577734,5808
"1527","ENSMODG00000002056","1",636634784,636635591,807
"1528","ENSMODG00000002057","3",50578585,50602511,23926
"1529","ENSMODG00000002058","1",182305560,182471908,166348
"1530","ENSMODG00000002059","5",116451751,116457950,6199
"1531","ENSMODG00000002060","3",444608721,444611603,2882
"1532","ENSMODG00000002061","1",66742770,66847899,105129
"1533","ENSMODG00000002062","2",478400565,478464434,63869
"1534","ENSMODG00000002069","1",66939608,66957088,17480
"1535","ENSMODG00000002070","2",112842245,112880907,38662
"1536","ENSMODG00000002071","8",84726814,84823416,96602
"1537","ENSMODG00000002073","1",182192744,182285560,92816
"1538","ENSMODG00000002074","2",478355948,478364476,8528
"1539","ENSMODG00000002075","1",67004409,67011415,7006
"1540","ENSMODG00000002076","6",90242371,90247365,4994
"1541","ENSMODG00000002078","8",84717883,84723478,5595
"1542","ENSMODG00000002080","2",112921365,112936787,15422
"1543","ENSMODG00000002081","3",102626545,103194559,568014
"1544","ENSMODG00000002082","4",63346687,63372522,25835
"1545","ENSMODG00000002085","1",67022518,67042549,20031
"1546","ENSMODG00000002087","2",113014569,113079663,65094
"1547","ENSMODG00000002089","2",237936051,238133918,197867
"1548","ENSMODG00000002091","3",444825615,444828389,2774
"1549","ENSMODG00000002092","5",115657676,115983714,326038
"1550","ENSMODG00000002093","4",63420557,63460680,40123
"1551","ENSMODG00000002094","3",103230549,103246611,16062
"1552","ENSMODG00000002096","1",635367140,635461310,94170
"1553","ENSMODG00000002097","2",113139394,113144945,5551
"1554","ENSMODG00000002099","5",114677854,114681329,3475
"1555","ENSMODG00000002100","1",219150879,219445528,294649
"1556","ENSMODG00000002101","1",181959271,181991052,31781
"1557","ENSMODG00000002103","2",113310183,113310861,678
"1558","ENSMODG00000002104","8",84556597,84661482,104885
"1559","ENSMODG00000002105","1",635282238,635367062,84824
"1560","ENSMODG00000002106","2",8483314,8499692,16378
"1561","ENSMODG00000002107","3",50621545,50796353,174808
"1562","ENSMODG00000002109","1",181747403,181747978,575
"1563","ENSMODG00000002110","3",103251236,103283762,32526
"1564","ENSMODG00000002113","2",8501645,8508341,6696
"1565","ENSMODG00000002114","1",632332219,632442947,110728
"1566","ENSMODG00000002115","2",113320849,113324608,3759
"1567","ENSMODG00000002116","5",112880178,113029108,148930
"1568","ENSMODG00000002117","8",84185443,84516892,331449
"1569","ENSMODG00000002119","5",112060407,112826701,766294
"1570","ENSMODG00000002120","2",113380406,113401053,20647
"1571","ENSMODG00000002122","2",478300832,478355456,54624
"1572","ENSMODG00000002124","1",67624933,67704382,79449
"1573","ENSMODG00000002125","1",219530561,219652040,121479
"1574","ENSMODG00000002127","2",236571493,236585865,14372
"1575","ENSMODG00000002130","1",181591880,181693539,101659
"1576","ENSMODG00000002131","3",50835446,50887938,52492
"1577","ENSMODG00000002132","2",236499043,236499268,225
"1578","ENSMODG00000002133","Un",30651082,30655345,4263
"1579","ENSMODG00000002134","1",67861341,67889313,27972
"1580","ENSMODG00000002137","2",236449020,236462603,13583
"1581","ENSMODG00000002138","3",104789348,105339015,549667
"1582","ENSMODG00000002139","2",8637999,8679577,41578
"1583","ENSMODG00000002140","Un",30676964,30677615,651
"1584","ENSMODG00000002141","2",113416963,113450717,33754
"1585","ENSMODG00000002142","2",236350698,236438459,87761
"1586","ENSMODG00000002143","3",444771366,444866759,95393
"1587","ENSMODG00000002145","2",8703994,8831186,127192
"1588","ENSMODG00000002147","Un",30685538,30692149,6611
"1589","ENSMODG00000002148","1",181414618,181471979,57361
"1590","ENSMODG00000002150","8",84000099,84062989,62890
"1591","ENSMODG00000002151","3",444931892,444936937,5045
"1592","ENSMODG00000002152","Un",30744719,30772511,27792
"1593","ENSMODG00000002153","2",113577284,113596539,19255
"1594","ENSMODG00000002154","2",478246708,478273852,27144
"1595","ENSMODG00000002155","5",110349883,110352567,2684
"1596","ENSMODG00000002157","Un",30814840,30838220,23380
"1597","ENSMODG00000002158","4",63950956,63983316,32360
"1598","ENSMODG00000002159","2",113646418,113651016,4598
"1599","ENSMODG00000002160","1",632034687,632083739,49052
"1600","ENSMODG00000002161","2",236056982,236214433,157451
"1601","ENSMODG00000002162","8",83860774,83872065,11291
"1602","ENSMODG00000002163","3",397445524,397521512,75988
"1603","ENSMODG00000002164","1",703888828,704036950,148122
"1604","ENSMODG00000002165","5",110254677,110327770,73093
"1605","ENSMODG00000002166","1",631972831,631973736,905
"1606","ENSMODG00000002167","1",219694369,219722343,27974
"1607","ENSMODG00000002168","2",235932127,236046569,114442
"1608","ENSMODG00000002169","1",703868763,703881868,13105
"1609","ENSMODG00000002170","5",109882568,109957922,75354
"1610","ENSMODG00000002171","4",63990505,64010461,19956
"1611","ENSMODG00000002172","1",631801522,631845968,44446
"1612","ENSMODG00000002173","1",703838025,703839215,1190
"1613","ENSMODG00000002174","5",109668110,109879956,211846
"1614","ENSMODG00000002175","1",219777988,219820278,42290
"1615","ENSMODG00000002176","3",444937847,444938335,488
"1616","ENSMODG00000002178","8",83818149,83848735,30586
"1617","ENSMODG00000002179","3",397375881,397413572,37691
"1618","ENSMODG00000002180","1",703817549,703827209,9660
"1619","ENSMODG00000002181","2",235874369,235905028,30659
"1620","ENSMODG00000002182","2",478134416,478243706,109290
"1621","ENSMODG00000002183","6",92391531,92419662,28131
"1622","ENSMODG00000002184","3",397262047,397264560,2513
"1623","ENSMODG00000002186","1",703792387,703801920,9533
"1624","ENSMODG00000002189","6",208925697,209084738,159041
"1625","ENSMODG00000002190","2",235818264,235842548,24284
"1626","ENSMODG00000002191","2",113654536,113675930,21394
"1627","ENSMODG00000002192","3",395412733,395433289,20556
"1628","ENSMODG00000002193","1",67940467,68040298,99831
"1629","ENSMODG00000002194","8",83764253,83807409,43156
"1630","ENSMODG00000002196","1",181192059,181359256,167197
"1631","ENSMODG00000002197","2",478126105,478130557,4452
"1632","ENSMODG00000002199","1",219942888,219973504,30616
"1633","ENSMODG00000002200","2",113693480,113695116,1636
"1634","ENSMODG00000002202","1",631685716,631790481,104765
"1635","ENSMODG00000002203","1",703775116,703785891,10775
"1636","ENSMODG00000002205","2",478070626,478079404,8778
"1637","ENSMODG00000002206","8",83735107,83764000,28893
"1638","ENSMODG00000002207","1",181166676,181182202,15526
"1639","ENSMODG00000002208","2",8939041,8963006,23965
"1640","ENSMODG00000002209","1",219973602,220281200,307598
"1641","ENSMODG00000002210","1",220398527,220398919,392
"1642","ENSMODG00000002211","2",113697519,113710638,13119
"1643","ENSMODG00000002212","2",8963981,8968525,4544
"1644","ENSMODG00000002213","2",235693270,235761773,68503
"1645","ENSMODG00000002215","1",703758679,703767943,9264
"1646","ENSMODG00000002216","1",68076545,68450328,373783
"1647","ENSMODG00000002217","1",631651434,631661576,10142
"1648","ENSMODG00000002218","4",64021733,64082727,60994
"1649","ENSMODG00000002220","1",181105906,181163499,57593
"1650","ENSMODG00000002221","2",477943907,478052194,108287
"1651","ENSMODG00000002222","2",235677847,235689687,11840
"1652","ENSMODG00000002223","1",220413906,220448148,34242
"1653","ENSMODG00000002226","6",289799176,289810331,11155
"1654","ENSMODG00000002228","Un",334119,376532,42413
"1655","ENSMODG00000002229","Un",71065225,71067161,1936
"1656","ENSMODG00000002230","2",113719432,113764366,44934
"1657","ENSMODG00000002231","6",289843904,289854345,10441
"1658","ENSMODG00000002234","8",83681692,83697017,15325
"1659","ENSMODG00000002236","X",11782318,11827928,45610
"1660","ENSMODG00000002238","1",703569937,703598084,28147
"1661","ENSMODG00000002239","2",9004171,9049202,45031
"1662","ENSMODG00000002241","6",92592187,92612557,20370
"1663","ENSMODG00000002243","1",220490249,220546795,56546
"1664","ENSMODG00000002244","8",83569709,83680365,110656
"1665","ENSMODG00000002245","5",107831512,107832661,1149
"1666","ENSMODG00000002246","X",12138274,12361358,223084
"1667","ENSMODG00000002248","1",703563578,703568032,4454
"1668","ENSMODG00000002249","X",12038692,12092095,53403
"1669","ENSMODG00000002250","7",65224347,65476981,252634
"1670","ENSMODG00000002252","1",631580118,631629042,48924
"1671","ENSMODG00000002253","1",180977208,181049953,72745
"1672","ENSMODG00000002254","2",235621523,235679157,57634
"1673","ENSMODG00000002255","2",536372521,536374765,2244
"1674","ENSMODG00000002257","2",9068062,9071883,3821
"1675","ENSMODG00000002258","5",107782955,107813597,30642
"1676","ENSMODG00000002259","3",444959828,444971890,12062
"1677","ENSMODG00000002261","2",536392182,536395697,3515
"1678","ENSMODG00000002265","1",703456755,703465483,8728
"1679","ENSMODG00000002266","7",65540801,65543394,2593
"1680","ENSMODG00000002268","2",477888541,477935122,46581
"1681","ENSMODG00000002269","6",209122350,209143253,20903
"1682","ENSMODG00000002270","1",220821273,221159649,338376
"1683","ENSMODG00000002274","3",394023546,394360983,337437
"1684","ENSMODG00000002275","4",64176624,64422314,245690
"1685","ENSMODG00000002278","X",12109569,12168143,58574
"1686","ENSMODG00000002279","1",68554637,68679610,124973
"1687","ENSMODG00000002281","1",703326037,703345477,19440
"1688","ENSMODG00000002282","2",113871638,113899037,27399
"1689","ENSMODG00000002283","8",83479170,83551599,72429
"1690","ENSMODG00000002284","1",180925222,180959625,34403
"1691","ENSMODG00000002285","1",631466935,631486725,19790
"1692","ENSMODG00000002286","2",477811376,477857914,46538
"1693","ENSMODG00000002287","4",64462904,64585912,123008
"1694","ENSMODG00000002288","2",9073749,9099384,25635
"1695","ENSMODG00000002290","3",393909799,394009174,99375
"1696","ENSMODG00000002291","3",444968173,444978169,9996
"1697","ENSMODG00000002293","7",65591021,65632868,41847
"1698","ENSMODG00000002296","1",221626594,221702835,76241
"1699","ENSMODG00000002297","Un",368873,691503,322630
"1700","ENSMODG00000002299","1",703224301,703316994,92693
"1701","ENSMODG00000002300","3",393850573,393910672,60099
"1702","ENSMODG00000002302","2",540166606,540170759,4153
"1703","ENSMODG00000002305","1",68681026,68926489,245463
"1704","ENSMODG00000002306","4",64630183,64867553,237370
"1705","ENSMODG00000002308","2",114014305,114030906,16601
"1706","ENSMODG00000002309","6",290215724,290347808,132084
"1707","ENSMODG00000002310","Un",769358,771816,2458
"1708","ENSMODG00000002311","2",477721255,477798619,77364
"1709","ENSMODG00000002312","X",12254011,12293108,39097
"1710","ENSMODG00000002313","8",213561172,213589653,28481
"1711","ENSMODG00000002314","3",445000102,445031043,30941
"1712","ENSMODG00000002315","1",68817523,68849606,32083
"1713","ENSMODG00000002317","1",221856326,221892984,36658
"1714","ENSMODG00000002320","1",180825636,180912405,86769
"1715","ENSMODG00000002322","1",68932881,68934464,1583
"1716","ENSMODG00000002323","1",180805353,180805790,437
"1717","ENSMODG00000002324","2",477678659,477705296,26637
"1718","ENSMODG00000002325","1",69017777,69144422,126645
"1719","ENSMODG00000002327","3",105501153,105502859,1706
"1720","ENSMODG00000002329","8",213888317,213920053,31736
"1721","ENSMODG00000002332","7",65805518,65823867,18349
"1722","ENSMODG00000002333","6",209188504,209236443,47939
"1723","ENSMODG00000002334","5",107506244,107651780,145536
"1724","ENSMODG00000002335","1",69435933,69440372,4439
"1725","ENSMODG00000002336","1",221895142,221932420,37278
"1726","ENSMODG00000002337","3",106083195,106084176,981
"1727","ENSMODG00000002338","3",445056945,445186451,129506
"1728","ENSMODG00000002339","8",213931294,213946509,15215
"1729","ENSMODG00000002340","8",83282268,83466649,184381
"1730","ENSMODG00000002341","3",106140262,106184806,44544
"1731","ENSMODG00000002343","4",65002020,65003173,1153
"1732","ENSMODG00000002344","6",209259755,209263666,3911
"1733","ENSMODG00000002345","X",12402940,12514864,111924
"1734","ENSMODG00000002347","8",82629349,82629903,554
"1735","ENSMODG00000002349","5",107457599,107473234,15635
"1736","ENSMODG00000002350","2",477631852,477640493,8641
"1737","ENSMODG00000002351","7",65842460,65875771,33311
"1738","ENSMODG00000002352","2",531341149,531360310,19161
"1739","ENSMODG00000002355","2",9128583,9132795,4212
"1740","ENSMODG00000002356","3",106184458,106205705,21247
"1741","ENSMODG00000002357","2",235377156,235527268,150112
"1742","ENSMODG00000002359","4",407801178,407802145,967
"1743","ENSMODG00000002360","4",65775171,65870782,95611
"1744","ENSMODG00000002361","2",477586500,477616728,30228
"1745","ENSMODG00000002362","X",12548729,12671459,122730
"1746","ENSMODG00000002363","2",531901652,531912263,10611
"1747","ENSMODG00000002364","3",445331640,445358574,26934
"1748","ENSMODG00000002365","1",180402282,180779019,376737
"1749","ENSMODG00000002366","4",387524884,387732444,207560
"1750","ENSMODG00000002367","1",221974919,222103466,128547
"1751","ENSMODG00000002368","7",65977900,66004444,26544
"1752","ENSMODG00000002369","2",540177418,540217076,39658
"1753","ENSMODG00000002371","3",106205759,106218493,12734
"1754","ENSMODG00000002372","2",235290493,235328080,37587
"1755","ENSMODG00000002373","5",107295167,107416854,121687
"1756","ENSMODG00000002374","4",65872228,65959843,87615
"1757","ENSMODG00000002375","4",407875144,407891468,16324
"1758","ENSMODG00000002376","3",106225724,106226997,1273
"1759","ENSMODG00000002377","2",477502349,477574754,72405
"1760","ENSMODG00000002378","6",209269390,209312659,43269
"1761","ENSMODG00000002379","1",222107840,222120701,12861
"1762","ENSMODG00000002380","8",82517143,82721820,204677
"1763","ENSMODG00000002382","2",9171921,9177375,5454
"1764","ENSMODG00000002383","2",540179760,540180631,871
"1765","ENSMODG00000002384","1",527644984,527645767,783
"1766","ENSMODG00000002385","7",66020612,66054433,33821
"1767","ENSMODG00000002386","1",180001567,180113661,112094
"1768","ENSMODG00000002387","4",387296368,387401374,105006
"1769","ENSMODG00000002391","2",9129273,9183047,53774
"1770","ENSMODG00000002394","1",180112669,180141048,28379
"1771","ENSMODG00000002395","X",75739455,75740795,1340
"1772","ENSMODG00000002396","2",235139019,235149436,10417
"1773","ENSMODG00000002397","2",9183714,9185364,1650
"1774","ENSMODG00000002398","6",209314776,209324107,9331
"1775","ENSMODG00000002400","6",209401592,209411364,9772
"1776","ENSMODG00000002401","7",66102527,66136167,33640
"1777","ENSMODG00000002402","1",179913859,179995108,81249
"1778","ENSMODG00000002404","2",114512530,114812601,300071
"1779","ENSMODG00000002405","4",408265297,408270507,5210
"1780","ENSMODG00000002406","6",209554459,209588302,33843
"1781","ENSMODG00000002407","1",703125090,703191527,66437
"1782","ENSMODG00000002411","1",222138021,222178308,40287
"1783","ENSMODG00000002412","2",9197272,9382597,185325
"1784","ENSMODG00000002416","7",66159211,66238313,79102
"1785","ENSMODG00000002417","4",66693994,66751076,57082
"1786","ENSMODG00000002419","6",209686135,209927507,241372
"1787","ENSMODG00000002420","2",540225306,540234511,9205
"1788","ENSMODG00000002423","1",179585844,179796020,210176
"1789","ENSMODG00000002424","6",92940447,92941124,677
"1790","ENSMODG00000002425","1",703036865,703050018,13153
"1791","ENSMODG00000002426","4",67029363,67030115,752
"1792","ENSMODG00000002429","8",82441041,82502283,61242
"1793","ENSMODG00000002430","2",9383875,9386118,2243
"1794","ENSMODG00000002432","3",445880604,445911864,31260
"1795","ENSMODG00000002434","7",66333747,66449894,116147
"1796","ENSMODG00000002435","5",106528242,106783459,255217
"1797","ENSMODG00000002436","2",234309370,234870542,561172
"1798","ENSMODG00000002439","2",29085130,29489218,404088
"1799","ENSMODG00000002440","3",106272727,106365792,93065
"1800","ENSMODG00000002443","7",66461879,66483647,21768
"1801","ENSMODG00000002444","X",74663391,75599492,936101
"1802","ENSMODG00000002445","2",234811373,234812997,1624
"1803","ENSMODG00000002446","1",703004904,703014000,9096
"1804","ENSMODG00000002447","7",66534618,66621192,86574
"1805","ENSMODG00000002448","3",445861271,445883195,21924
"1806","ENSMODG00000002449","2",234405871,234406187,316
"1807","ENSMODG00000002450","2",540238943,540256221,17278
"1808","ENSMODG00000002452","2",536359834,536401488,41654
"1809","ENSMODG00000002453","X",74769177,74770871,1694
"1810","ENSMODG00000002454","3",106384357,106406808,22451
"1811","ENSMODG00000002455","2",116773112,116829676,56564
"1812","ENSMODG00000002457","3",106627417,106723108,95691
"1813","ENSMODG00000002458","2",234232727,234249942,17215
"1814","ENSMODG00000002459","2",9390840,9393576,2736
"1815","ENSMODG00000002460","7",69156684,69177355,20671
"1816","ENSMODG00000002461","2",540258935,540262522,3587
"1817","ENSMODG00000002463","X",74351465,74352028,563
"1818","ENSMODG00000002465","1",702940714,703002951,62237
"1819","ENSMODG00000002466","1",179524202,179580672,56470
"1820","ENSMODG00000002467","2",58663893,58745480,81587
"1821","ENSMODG00000002469","2",29510458,29596465,86007
"1822","ENSMODG00000002470","2",536432084,536440080,7996
"1823","ENSMODG00000002471","3",106822309,106823403,1094
"1824","ENSMODG00000002472","6",291006958,291034849,27891
"1825","ENSMODG00000002473","Un",43758252,43762363,4111
"1826","ENSMODG00000002474","5",105114048,105478754,364706
"1827","ENSMODG00000002475","2",29795317,30534826,739509
"1828","ENSMODG00000002476","2",536452371,536455430,3059
"1829","ENSMODG00000002477","2",531945837,532036481,90644
"1830","ENSMODG00000002478","2",71547136,71547498,362
"1831","ENSMODG00000002479","7",69350670,69463119,112449
"1832","ENSMODG00000002480","1",702902965,702919513,16548
"1833","ENSMODG00000002481","2",9460358,9463851,3493
"1834","ENSMODG00000002482","2",58753634,58782786,29152
"1835","ENSMODG00000002485","2",116828375,116893891,65516
"1836","ENSMODG00000002486","2",536621473,536624134,2661
"1837","ENSMODG00000002489","3",107143204,107875516,732312
"1838","ENSMODG00000002493","2",186563590,186593934,30344
"1839","ENSMODG00000002494","1",702880216,702883035,2819
"1840","ENSMODG00000002495","2",31310835,31373901,63066
"1841","ENSMODG00000002497","7",69617246,69683967,66721
"1842","ENSMODG00000002501","6",92999484,93042595,43111
"1843","ENSMODG00000002502","2",536678955,536692721,13766
"1844","ENSMODG00000002503","1",702875161,702877486,2325
"1845","ENSMODG00000002504","2",9493164,9581257,88093
"1846","ENSMODG00000002506","8",82009531,82122427,112896
"1847","ENSMODG00000002507","2",31721114,31873176,152062
"1848","ENSMODG00000002508","7",69694224,69702323,8099
"1849","ENSMODG00000002509","1",69616104,69752642,136538
"1850","ENSMODG00000002512","6",26632576,26673546,40970
"1851","ENSMODG00000002516","1",179398684,179475891,77207
"1852","ENSMODG00000002517","4",408451675,408453483,1808
"1853","ENSMODG00000002518","2",536746530,536753446,6916
"1854","ENSMODG00000002519","2",58874514,58903254,28740
"1855","ENSMODG00000002520","2",116992891,117030361,37470
"1856","ENSMODG00000002521","2",233921551,234074681,153130
"1857","ENSMODG00000002522","1",69855641,69857149,1508
"1858","ENSMODG00000002524","3",445828028,445848016,19988
"1859","ENSMODG00000002526","2",9587614,9601532,13918
"1860","ENSMODG00000002527","8",81859313,81866293,6980
"1861","ENSMODG00000002529","1",222266146,222337302,71156
"1862","ENSMODG00000002531","2",186462254,186553228,90974
"1863","ENSMODG00000002532","3",445809018,445811459,2441
"1864","ENSMODG00000002535","2",537044608,537067616,23008
"1865","ENSMODG00000002538","7",69720940,69835319,114379
"1866","ENSMODG00000002539","2",117049104,117072481,23377
"1867","ENSMODG00000002541","1",388381889,388445039,63150
"1868","ENSMODG00000002543","4",372532811,372534586,1775
"1869","ENSMODG00000002544","8",81778412,81955459,177047
"1870","ENSMODG00000002546","7",70348491,70474210,125719
"1871","ENSMODG00000002547","1",69866421,69956181,89760
"1872","ENSMODG00000002548","6",291045728,291147945,102217
"1873","ENSMODG00000002549","1",702849103,702871259,22156
"1874","ENSMODG00000002551","3",445798356,445804928,6572
"1875","ENSMODG00000002552","1",179164522,179346868,182346
"1876","ENSMODG00000002553","4",372652170,372953169,300999
"1877","ENSMODG00000002554","6",92721396,93111678,390282
"1878","ENSMODG00000002555","8",81723055,81779422,56367
"1879","ENSMODG00000002557","2",540264288,540278738,14450
"1880","ENSMODG00000002558","4",373501541,373599977,98436
"1881","ENSMODG00000002559","2",233686841,233902051,215210
"1882","ENSMODG00000002560","2",186345794,186412010,66216
"1883","ENSMODG00000002561","6",26806758,26827981,21223
"1884","ENSMODG00000002562","2",9628971,9633646,4675
"1885","ENSMODG00000002563","2",117125715,117177147,51432
"1886","ENSMODG00000002564","8",81291381,81329278,37897
"1887","ENSMODG00000002565","1",222365344,222608335,242991
"1888","ENSMODG00000002566","4",373515711,373522286,6575
"1889","ENSMODG00000002568","6",26862263,26868120,5857
"1890","ENSMODG00000002570","2",540284793,540291342,6549
"1891","ENSMODG00000002571","2",9651132,9656546,5414
"1892","ENSMODG00000002572","2",59140034,59383779,243745
"1893","ENSMODG00000002574","1",222663075,222664140,1065
"1894","ENSMODG00000002575","1",388365565,388366444,879
"1895","ENSMODG00000002576","2",186282531,186307214,24683
"1896","ENSMODG00000002579","8",81648747,81700756,52009
"1897","ENSMODG00000002580","6",211568232,211569383,1151
"1898","ENSMODG00000002581","2",540294681,540296896,2215
"1899","ENSMODG00000002582","1",179030465,179140037,109572
"1900","ENSMODG00000002586","2",59399250,59496038,96788
"1901","ENSMODG00000002587","1",222687956,222872998,185042
"1902","ENSMODG00000002588","7",70607938,70726345,118407
"1903","ENSMODG00000002589","2",233526949,233618444,91495
"1904","ENSMODG00000002590","3",445726476,445774692,48216
"1905","ENSMODG00000002591","6",93250162,93455646,205484
"1906","ENSMODG00000002592","2",537202874,537212460,9586
"1907","ENSMODG00000002593","8",81530370,81578570,48200
"1908","ENSMODG00000002595","6",26936125,27011679,75554
"1909","ENSMODG00000002596","3",445719356,445725567,6211
"1910","ENSMODG00000002597","2",59603334,59685449,82115
"1911","ENSMODG00000002598","1",388327331,388347470,20139
"1912","ENSMODG00000002599","2",233505360,233523561,18201
"1913","ENSMODG00000002600","1",701482186,701699671,217485
"1914","ENSMODG00000002601","6",27014708,27097623,82915
"1915","ENSMODG00000002602","2",117327924,117630014,302090
"1916","ENSMODG00000002603","6",93885594,93895596,10002
"1917","ENSMODG00000002604","2",117713425,117725565,12140
"1918","ENSMODG00000002605","6",291202763,291234566,31803
"1919","ENSMODG00000002606","6",94235726,94399786,164060
"1920","ENSMODG00000002607","7",70749053,70893604,144551
"1921","ENSMODG00000002610","6",27173312,27198759,25447
"1922","ENSMODG00000002612","8",81363056,81460146,97090
"1923","ENSMODG00000002613","1",70021516,70085421,63905
"1924","ENSMODG00000002614","1",388295733,388325900,30167
"1925","ENSMODG00000002617","Un",77863063,77866524,3461
"1926","ENSMODG00000002618","7",71440284,71544266,103982
"1927","ENSMODG00000002620","2",9668244,9698507,30263
"1928","ENSMODG00000002621","2",117879098,118445451,566353
"1929","ENSMODG00000002623","4",370955469,370974836,19367
"1930","ENSMODG00000002624","2",537252473,537269989,17516
"1931","ENSMODG00000002626","1",222879505,223072005,192500
"1932","ENSMODG00000002627","2",540531194,540538285,7091
"1933","ENSMODG00000002628","2",9710451,9756004,45553
"1934","ENSMODG00000002629","2",233422304,233493301,70997
"1935","ENSMODG00000002630","1",388179718,388212134,32416
"1936","ENSMODG00000002631","1",699904035,699916494,12459
"1937","ENSMODG00000002632","6",27202849,27249528,46679
"1938","ENSMODG00000002633","7",71771444,71913111,141667
"1939","ENSMODG00000002634","7",72242102,72242637,535
"1940","ENSMODG00000002635","4",373692895,373928647,235752
"1941","ENSMODG00000002636","2",118468685,118960744,492059
"1942","ENSMODG00000002637","2",232960209,233118578,158369
"1943","ENSMODG00000002640","1",70123374,70286539,163165
"1944","ENSMODG00000002641","6",94040454,94132467,92013
"1945","ENSMODG00000002643","4",370734063,371139647,405584
"1946","ENSMODG00000002644","2",10144307,10280948,136641
"1947","ENSMODG00000002645","5",102960802,103076365,115563
"1948","ENSMODG00000002646","2",537366524,537374844,8320
"1949","ENSMODG00000002647","2",232824291,232826095,1804
"1950","ENSMODG00000002648","2",9783139,9787725,4586
"1951","ENSMODG00000002650","7",72871732,72913312,41580
"1952","ENSMODG00000002651","1",388104852,388168578,63726
"1953","ENSMODG00000002652","3",445589497,445654003,64506
"1954","ENSMODG00000002653","4",374097705,374125102,27397
"1955","ENSMODG00000002654","2",540856645,540991757,135112
"1956","ENSMODG00000002655","1",699779732,699883402,103670
"1957","ENSMODG00000002658","6",94426603,94440379,13776
"1958","ENSMODG00000002659","2",541050403,541100082,49679
"1959","ENSMODG00000002660","4",371144992,371155236,10244
"1960","ENSMODG00000002661","1",70286303,70308968,22665
"1961","ENSMODG00000002662","2",232733680,232752176,18496
"1962","ENSMODG00000002663","4",371174594,371177978,3384
"1963","ENSMODG00000002664","1",388091984,388096458,4474
"1964","ENSMODG00000002665","6",27386632,27468616,81984
"1965","ENSMODG00000002666","2",537381334,537390005,8671
"1966","ENSMODG00000002667","4",338630745,338713507,82762
"1967","ENSMODG00000002668","4",371220416,371239642,19226
"1968","ENSMODG00000002671","2",541137335,541172459,35124
"1969","ENSMODG00000002672","2",232650105,232680364,30259
"1970","ENSMODG00000002674","4",338827473,338829440,1967
"1971","ENSMODG00000002675","1",178542238,178857833,315595
"1972","ENSMODG00000002676","4",386809394,386922518,113124
"1973","ENSMODG00000002677","1",699724522,699735841,11319
"1974","ENSMODG00000002678","1",223117636,223470877,353241
"1975","ENSMODG00000002679","2",541256825,541259296,2471
"1976","ENSMODG00000002680","2",537392387,537403301,10914
"1977","ENSMODG00000002681","1",699702307,699702719,412
"1978","ENSMODG00000002682","1",70309643,70325002,15359
"1979","ENSMODG00000002683","1",387957471,388061824,104353
"1980","ENSMODG00000002685","2",9792002,10042424,250422
"1981","ENSMODG00000002687","1",178423450,178436831,13381
"1982","ENSMODG00000002688","2",119180446,119231630,51184
"1983","ENSMODG00000002689","4",374173102,374237413,64311
"1984","ENSMODG00000002690","2",232530281,232581955,51674
"1985","ENSMODG00000002691","1",70356454,70362256,5802
"1986","ENSMODG00000002693","4",386962221,387190465,228244
"1987","ENSMODG00000002694","1",387953299,387955184,1885
"1988","ENSMODG00000002695","6",27654422,27738020,83598
"1989","ENSMODG00000002696","1",223876584,223885560,8976
"1990","ENSMODG00000002697","1",70382205,70383841,1636
"1991","ENSMODG00000002698","7",39511528,39559733,48205
"1992","ENSMODG00000002699","2",232467670,232497873,30203
"1993","ENSMODG00000002702","1",387942709,387948620,5911
"1994","ENSMODG00000002703","7",73293162,73311779,18617
"1995","ENSMODG00000002704","2",537444299,537458627,14328
"1996","ENSMODG00000002705","2",10186163,10296573,110410
"1997","ENSMODG00000002707","1",699655838,699670027,14189
"1998","ENSMODG00000002708","2",541349576,541385493,35917
"1999","ENSMODG00000002709","2",232425809,232460270,34461
"2000","ENSMODG00000002710","6",94603313,94678257,74944
"2001","ENSMODG00000002711","1",224019635,224091120,71485
"2002","ENSMODG00000002712","6",19103541,19192225,88684
"2003","ENSMODG00000002713","2",232407432,232426009,18577
"2004","ENSMODG00000002714","Un",1439149,1522205,83056
"2005","ENSMODG00000002715","2",541391547,541397841,6294
"2006","ENSMODG00000002716","1",70462330,70480300,17970
"2007","ENSMODG00000002717","8",214089816,214096403,6587
"2008","ENSMODG00000002718","6",18646042,18823680,177638
"2009","ENSMODG00000002719","1",178251466,178385294,133828
"2010","ENSMODG00000002720","6",28082705,28438891,356186
"2011","ENSMODG00000002721","Un",1790117,1803861,13744
"2012","ENSMODG00000002722","6",213506016,213884902,378886
"2013","ENSMODG00000002723","2",119293317,119315795,22478
"2014","ENSMODG00000002724","1",70493642,70609321,115679
"2015","ENSMODG00000002725","1",224115227,224140631,25404
"2016","ENSMODG00000002727","2",119350540,119359050,8510
"2017","ENSMODG00000002729","6",28530070,28834277,304207
"2018","ENSMODG00000002730","2",119478782,119486349,7567
"2019","ENSMODG00000002732","1",387747404,387929622,182218
"2020","ENSMODG00000002734","1",631212040,631466132,254092
"2021","ENSMODG00000002737","2",537463328,537483339,20011
"2022","ENSMODG00000002738","6",213987353,213992425,5072
"2023","ENSMODG00000002739","4",338910497,339143890,233393
"2024","ENSMODG00000002740","8",214134328,214144705,10377
"2025","ENSMODG00000002742","2",541400320,541423098,22778
"2026","ENSMODG00000002743","1",699560728,699628840,68112
"2027","ENSMODG00000002744","1",178161846,178196342,34496
"2028","ENSMODG00000002745","7",73448797,73468805,20008
"2029","ENSMODG00000002746","4",338936568,338940560,3992
"2030","ENSMODG00000002748","2",537522094,537535683,13589
"2031","ENSMODG00000002749","1",699305865,699367967,62102
"2032","ENSMODG00000002750","6",95412656,96132299,719643
"2033","ENSMODG00000002751","2",477235853,477293500,57647
"2034","ENSMODG00000002753","1",387683102,387697471,14369
"2035","ENSMODG00000002754","2",232349344,232356246,6902
"2036","ENSMODG00000002755","4",339184399,339352899,168500
"2037","ENSMODG00000002756","1",70608083,70644254,36171
"2038","ENSMODG00000002757","4",374532530,374600565,68035
"2039","ENSMODG00000002759","1",70654278,70663570,9292
"2040","ENSMODG00000002760","6",96283095,96306682,23587
"2041","ENSMODG00000002761","1",178125978,178162581,36603
"2042","ENSMODG00000002762","1",387617414,387674524,57110
"2043","ENSMODG00000002763","1",70682215,70690196,7981
"2044","ENSMODG00000002764","7",73352921,73504003,151082
"2045","ENSMODG00000002765","1",387545455,387548019,2564
"2046","ENSMODG00000002766","1",699211470,699235833,24363
"2047","ENSMODG00000002767","3",488298503,488354859,56356
"2048","ENSMODG00000002768","4",339713502,339714371,869
"2049","ENSMODG00000002769","6",18096862,18178778,81916
"2050","ENSMODG00000002770","4",374625263,374643597,18334
"2051","ENSMODG00000002771","1",699192842,699208499,15657
"2052","ENSMODG00000002772","1",70771500,70861378,89878
"2053","ENSMODG00000002773","4",340035975,340218574,182599
"2054","ENSMODG00000002778","2",541500312,541528574,28262
"2055","ENSMODG00000002779","2",59727987,59862789,134802
"2056","ENSMODG00000002781","6",17728734,17951497,222763
"2057","ENSMODG00000002782","1",699188186,699190900,2714
"2058","ENSMODG00000002783","1",699181748,699187904,6156
"2059","ENSMODG00000002784","3",488358215,488389712,31497
"2060","ENSMODG00000002785","1",699170436,699178342,7906
"2061","ENSMODG00000002787","2",59860282,59899551,39269
"2062","ENSMODG00000002788","2",119628154,119643208,15054
"2063","ENSMODG00000002789","4",340395774,340440662,44888
"2064","ENSMODG00000002791","Un",56727312,56733616,6304
"2065","ENSMODG00000002793","4",374654796,374698424,43628
"2066","ENSMODG00000002794","4",340757980,340798367,40387
"2067","ENSMODG00000002796","2",476500052,476945982,445930
"2068","ENSMODG00000002797","2",119742078,119846321,104243
"2069","ENSMODG00000002798","6",17178569,17700845,522276
"2070","ENSMODG00000002799","Un",57145396,57153552,8156
"2071","ENSMODG00000002800","2",232320928,232349893,28965
"2072","ENSMODG00000002801","6",96350649,96427725,77076
"2073","ENSMODG00000002802","4",371255021,371414856,159835
"2074","ENSMODG00000002804","3",488401469,488486145,84676
"2075","ENSMODG00000002805","1",387441914,387460943,19029
"2076","ENSMODG00000002806","2",32040672,32070785,30113
"2077","ENSMODG00000002807","6",17041916,17078882,36966
"2078","ENSMODG00000002808","3",59968204,59970302,2098
"2079","ENSMODG00000002810","5",223109878,223234954,125076
"2080","ENSMODG00000002812","6",96492013,96732988,240975
"2081","ENSMODG00000002813","8",214155158,214261216,106058
"2082","ENSMODG00000002814","2",476048847,476360303,311456
"2083","ENSMODG00000002815","4",341629224,341656893,27669
"2084","ENSMODG00000002817","3",111324985,111618032,293047
"2085","ENSMODG00000002818","6",16959323,17031767,72444
"2086","ENSMODG00000002819","1",387360960,387430588,69628
"2087","ENSMODG00000002820","8",214269870,214310499,40629
"2088","ENSMODG00000002821","6",97110835,97163890,53055
"2089","ENSMODG00000002822","2",541538780,541556102,17322
"2090","ENSMODG00000002823","2",475773418,475774554,1136
"2091","ENSMODG00000002824","3",488521025,488630208,109183
"2092","ENSMODG00000002825","5",223448339,223503099,54760
"2093","ENSMODG00000002826","1",225154047,225155046,999
"2094","ENSMODG00000002828","3",488735983,488747023,11040
"2095","ENSMODG00000002829","7",73606427,73664599,58172
"2096","ENSMODG00000002830","1",387167562,387227379,59817
"2097","ENSMODG00000002831","1",630956317,631002988,46671
"2098","ENSMODG00000002836","1",387190808,387191452,644
"2099","ENSMODG00000002837","5",102438386,102929370,490984
"2100","ENSMODG00000002838","4",371491312,371609317,118005
"2101","ENSMODG00000002842","1",176689889,176757159,67270
"2102","ENSMODG00000002844","6",16648099,16908910,260811
"2103","ENSMODG00000002847","4",138921199,140616672,1695473
"2104","ENSMODG00000002848","6",97212897,97487150,274253
"2105","ENSMODG00000002849","3",497508344,497510626,2282
"2106","ENSMODG00000002850","1",630609216,630615442,6226
"2107","ENSMODG00000002852","5",102392399,102425614,33215
"2108","ENSMODG00000002855","2",59900796,60180404,279608
"2109","ENSMODG00000002856","1",387109091,387154877,45786
"2110","ENSMODG00000002859","3",488756155,488789002,32847
"2111","ENSMODG00000002860","3",497097201,497502943,405742
"2112","ENSMODG00000002861","4",371658387,371679093,20706
"2113","ENSMODG00000002862","6",29003551,29030531,26980
"2114","ENSMODG00000002863","3",488791561,488796795,5234
"2115","ENSMODG00000002864","1",387050205,387063946,13741
"2116","ENSMODG00000002865","7",73719012,73915291,196279
"2117","ENSMODG00000002866","5",223527903,223725776,197873
"2118","ENSMODG00000002867","2",533620170,533738612,118442
"2119","ENSMODG00000002868","3",497365003,497427850,62847
"2120","ENSMODG00000002869","6",97506192,97584718,78526
"2121","ENSMODG00000002870","2",60091017,60116344,25327
"2122","ENSMODG00000002873","4",371695374,371707060,11686
"2123","ENSMODG00000002875","1",387016586,387031706,15120
"2124","ENSMODG00000002876","5",102051730,102271471,219741
"2125","ENSMODG00000002880","2",60184833,60216674,31841
"2126","ENSMODG00000002882","1",630559195,630586647,27452
"2127","ENSMODG00000002883","2",119999975,120096186,96211
"2128","ENSMODG00000002884","6",29095835,29127870,32035
"2129","ENSMODG00000002885","4",371822873,371842104,19231
"2130","ENSMODG00000002887","1",630290345,630540770,250425
"2131","ENSMODG00000002889","5",223952075,224039246,87171
"2132","ENSMODG00000002891","3",489141082,489217671,76589
"2133","ENSMODG00000002894","3",441585161,441586573,1412
"2134","ENSMODG00000002895","1",629828144,629831780,3636
"2135","ENSMODG00000002896","2",60229761,60257310,27549
"2136","ENSMODG00000002898","6",29130541,29212217,81676
"2137","ENSMODG00000002899","2",538322890,538363148,40258
"2138","ENSMODG00000002901","6",214031712,214595677,563965
"2139","ENSMODG00000002902","2",232248150,232260905,12755
"2140","ENSMODG00000002903","6",29271942,29272067,125
"2141","ENSMODG00000002904","4",386796238,386810166,13928
"2142","ENSMODG00000002905","2",471181157,471205218,24061
"2143","ENSMODG00000002906","5",224291708,224385776,94068
"2144","ENSMODG00000002909","3",111967441,112490545,523104
"2145","ENSMODG00000002910","2",120095318,120151122,55804
"2146","ENSMODG00000002912","1",173969149,173973285,4136
"2147","ENSMODG00000002913","8",214523360,214524175,815
"2148","ENSMODG00000002914","7",73941192,74018046,76854
"2149","ENSMODG00000002915","2",534303432,536140010,1836578
"2150","ENSMODG00000002917","3",497363040,497416310,53270
"2151","ENSMODG00000002918","1",225573807,225805715,231908
"2152","ENSMODG00000002920","2",232216828,232240992,24164
"2153","ENSMODG00000002922","3",489664618,489682662,18044
"2154","ENSMODG00000002923","2",232089689,232106159,16470
"2155","ENSMODG00000002925","1",173887410,173891901,4491
"2156","ENSMODG00000002926","Un",75520845,75525924,5079
"2157","ENSMODG00000002927","3",112604110,112645637,41527
"2158","ENSMODG00000002928","1",225690843,225708084,17241
"2159","ENSMODG00000002929","3",497282101,497306637,24536
"2160","ENSMODG00000002930","6",29425001,29559963,134962
"2161","ENSMODG00000002931","2",10425747,10470472,44725
"2162","ENSMODG00000002932","5",224443611,224591606,147995
"2163","ENSMODG00000002933","2",60627963,60632612,4649
"2164","ENSMODG00000002935","7",74023467,74099788,76321
"2165","ENSMODG00000002936","2",60760388,60761102,714
"2166","ENSMODG00000002937","3",489698373,489706210,7837
"2167","ENSMODG00000002938","6",97675233,97809629,134396
"2168","ENSMODG00000002941","3",112698674,112756611,57937
"2169","ENSMODG00000002942","2",60816683,60862528,45845
"2170","ENSMODG00000002944","4",371894133,372015565,121432
"2171","ENSMODG00000002945","2",120397905,120485066,87161
"2172","ENSMODG00000002946","2",471138215,471161013,22798
"2173","ENSMODG00000002949","2",10481704,10491435,9731
"2174","ENSMODG00000002951","6",29513860,29591643,77783
"2175","ENSMODG00000002952","6",97882429,97911626,29197
"2176","ENSMODG00000002954","6",215543658,215762634,218976
"2177","ENSMODG00000002955","5",224620230,224635534,15304
"2178","ENSMODG00000002958","1",225856683,226056605,199922
"2179","ENSMODG00000002959","7",74169518,74291268,121750
"2180","ENSMODG00000002960","X",22407824,22408431,607
"2181","ENSMODG00000002961","2",232139911,232169209,29298
"2182","ENSMODG00000002962","1",173870562,173875513,4951
"2183","ENSMODG00000002963","1",226055996,226253954,197958
"2184","ENSMODG00000002966","3",489707605,489734475,26870
"2185","ENSMODG00000002967","3",50904829,50989382,84553
"2186","ENSMODG00000002968","5",225067211,225068140,929
"2187","ENSMODG00000002969","6",215582881,215583582,701
"2188","ENSMODG00000002970","3",112778191,112981767,203576
"2189","ENSMODG00000002972","1",173824248,173862633,38385
"2190","ENSMODG00000002974","2",10494563,10497481,2918
"2191","ENSMODG00000002975","6",215762665,215782903,20238
"2192","ENSMODG00000002976","2",120485094,120530491,45397
"2193","ENSMODG00000002977","1",386976854,387012572,35718
"2194","ENSMODG00000002978","6",29598657,29604293,5636
"2195","ENSMODG00000002980","2",61351528,61375432,23904
"2196","ENSMODG00000002981","5",101853755,101987675,133920
"2197","ENSMODG00000002982","2",120541699,120562481,20782
"2198","ENSMODG00000002983","3",489815639,489952460,136821
"2199","ENSMODG00000002985","6",215882805,215999391,116586
"2200","ENSMODG00000002986","1",629247732,629654582,406850
"2201","ENSMODG00000002987","2",10504685,10511366,6681
"2202","ENSMODG00000002988","1",387002264,387003043,779
"2203","ENSMODG00000002991","X",22043274,22044378,1104
"2204","ENSMODG00000002992","1",173767850,173780895,13045
"2205","ENSMODG00000002993","1",386995364,386996250,886
"2206","ENSMODG00000002994","3",50994579,51065591,71012
"2207","ENSMODG00000002995","5",226000007,226267446,267439
"2208","ENSMODG00000002996","X",21756335,21759347,3012
"2209","ENSMODG00000002997","4",142765990,142920669,154679
"2210","ENSMODG00000002999","6",29669818,29717569,47751
"2211","ENSMODG00000003000","2",232042470,232069056,26586
"2212","ENSMODG00000003001","1",226745851,227027494,281643
"2213","ENSMODG00000003002","2",61375945,61570170,194225
"2214","ENSMODG00000003003","6",29825567,29961236,135669
"2215","ENSMODG00000003005","4",371984661,372000146,15485
"2216","ENSMODG00000003009","6",216042701,216051164,8463
"2217","ENSMODG00000003010","3",489962072,489981030,18958
"2218","ENSMODG00000003012","5",226302137,226526662,224525
"2219","ENSMODG00000003013","6",30669282,30670468,1186
"2220","ENSMODG00000003014","2",232003750,232013259,9509
"2221","ENSMODG00000003015","2",61572088,61605862,33774
"2222","ENSMODG00000003016","4",143001163,143877034,875871
"2223","ENSMODG00000003017","2",10521949,10549933,27984
"2224","ENSMODG00000003019","1",629549060,629550134,1074
"2225","ENSMODG00000003021","3",489996650,490001303,4653
"2226","ENSMODG00000003022","3",497053619,497359786,306167
"2227","ENSMODG00000003023","1",386816288,386972140,155852
"2228","ENSMODG00000003024","5",101711471,101854478,143007
"2229","ENSMODG00000003026","8",81170063,81281271,111208
"2230","ENSMODG00000003027","2",31696424,31697669,1245
"2231","ENSMODG00000003028","6",31307137,31375367,68230
"2232","ENSMODG00000003030","2",231926789,231930262,3473
"2233","ENSMODG00000003031","4",372110073,372161098,51025
"2234","ENSMODG00000003033","1",173724112,173748298,24186
"2235","ENSMODG00000003035","1",629234468,629238550,4082
"2236","ENSMODG00000003037","5",101688690,101710025,21335
"2237","ENSMODG00000003040","2",10641718,10751148,109430
"2238","ENSMODG00000003041","2",231907631,231908172,541
"2239","ENSMODG00000003042","2",120835088,120845709,10621
"2240","ENSMODG00000003043","1",173721773,173722825,1052
"2241","ENSMODG00000003044","8",81100639,81107601,6962
"2242","ENSMODG00000003046","5",101359135,101425564,66429
"2243","ENSMODG00000003047","1",173712491,173713609,1118
"2244","ENSMODG00000003048","3",500714366,500730481,16115
"2245","ENSMODG00000003049","1",628893032,628992850,99818
"2246","ENSMODG00000003050","1",386732138,386751281,19143
"2247","ENSMODG00000003051","3",490015306,490033114,17808
"2248","ENSMODG00000003052","2",61594946,61632520,37574
"2249","ENSMODG00000003053","6",31397110,31472980,75870
"2250","ENSMODG00000003055","2",120980956,121011773,30817
"2251","ENSMODG00000003056","8",81005688,81026212,20524
"2252","ENSMODG00000003057","2",538424607,538430257,5650
"2253","ENSMODG00000003058","1",173700401,173709414,9013
"2254","ENSMODG00000003059","4",372161828,372196215,34387
"2255","ENSMODG00000003060","1",227338988,227399825,60837
"2256","ENSMODG00000003062","5",226596684,226897529,300845
"2257","ENSMODG00000003063","6",97964943,98270260,305317
"2258","ENSMODG00000003065","2",231885277,231897296,12019
"2259","ENSMODG00000003066","3",490110394,490117553,7159
"2260","ENSMODG00000003068","8",81015633,81017408,1775
"2261","ENSMODG00000003069","2",121045064,121073207,28143
"2262","ENSMODG00000003070","1",386302717,386638148,335431
"2263","ENSMODG00000003071","2",61649833,61678158,28325
"2264","ENSMODG00000003072","1",173694407,173703727,9320
"2265","ENSMODG00000003073","1",628758191,628772423,14232
"2266","ENSMODG00000003074","6",216156195,216164917,8722
"2267","ENSMODG00000003075","2",121072678,121103362,30684
"2268","ENSMODG00000003076","2",231875394,231885033,9639
"2269","ENSMODG00000003078","3",62273975,62722873,448898
"2270","ENSMODG00000003080","2",10768345,11008929,240584
"2271","ENSMODG00000003081","2",231869418,231870023,605
"2272","ENSMODG00000003082","2",538473126,538473775,649
"2273","ENSMODG00000003083","2",121180160,121203508,23348
"2274","ENSMODG00000003084","4",144099705,144383533,283828
"2275","ENSMODG00000003085","Un",62789502,62791597,2095
"2276","ENSMODG00000003088","2",539197640,539219294,21654
"2277","ENSMODG00000003089","1",173684192,173693430,9238
"2278","ENSMODG00000003090","6",216328797,216463763,134966
"2279","ENSMODG00000003092","6",98498546,98503908,5362
"2280","ENSMODG00000003093","6",31529752,31648574,118822
"2281","ENSMODG00000003094","3",501021399,501022433,1034
"2282","ENSMODG00000003095","6",216760553,216761249,696
"2283","ENSMODG00000003096","3",496984809,496989570,4761
"2284","ENSMODG00000003098","5",227015108,227064569,49461
"2285","ENSMODG00000003099","3",51460094,51691364,231270
"2286","ENSMODG00000003100","3",500453927,500455681,1754
"2287","ENSMODG00000003102","1",628375122,628399563,24441
"2288","ENSMODG00000003103","2",121281564,121321872,40308
"2289","ENSMODG00000003104","7",75273904,75347143,73239
"2290","ENSMODG00000003105","1",699155324,699164365,9041
"2291","ENSMODG00000003106","4",374805779,374827071,21292
"2292","ENSMODG00000003107","1",386012900,386016949,4049
"2293","ENSMODG00000003108","4",266862414,267611604,749190
"2294","ENSMODG00000003111","3",490116549,490147385,30836
"2295","ENSMODG00000003112","4",144642438,144683352,40914
"2296","ENSMODG00000003113","5",227198110,227248035,49925
"2297","ENSMODG00000003114","7",75348280,75350178,1898
"2298","ENSMODG00000003115","3",63620531,63816984,196453
"2299","ENSMODG00000003116","3",450755444,450779144,23700
"2300","ENSMODG00000003118","1",173643718,173654516,10798
"2301","ENSMODG00000003119","2",538465357,538467977,2620
"2302","ENSMODG00000003120","3",496904744,496973201,68457
"2303","ENSMODG00000003121","1",698987465,698989312,1847
"2304","ENSMODG00000003122","2",231794533,231802037,7504
"2305","ENSMODG00000003124","3",490158297,490176991,18694
"2306","ENSMODG00000003126","2",61710659,61807155,96496
"2307","ENSMODG00000003127","Un",16523801,16542623,18822
"2308","ENSMODG00000003128","7",75617782,75620505,2723
"2309","ENSMODG00000003130","2",231740961,231741872,911
"2310","ENSMODG00000003131","6",98519291,98749088,229797
"2311","ENSMODG00000003133","3",490175655,490178156,2501
"2312","ENSMODG00000003134","2",538527945,538543733,15788
"2313","ENSMODG00000003135","2",537600609,537654723,54114
"2314","ENSMODG00000003136","3",450964018,450972009,7991
"2315","ENSMODG00000003138","7",75674957,75677290,2333
"2316","ENSMODG00000003140","6",216806012,216977679,171667
"2317","ENSMODG00000003141","8",80902887,81005659,102772
"2318","ENSMODG00000003142","6",98762764,98764493,1729
"2319","ENSMODG00000003143","6",31664970,31782065,117095
"2320","ENSMODG00000003144","7",75678266,75711117,32851
"2321","ENSMODG00000003145","2",121338110,121377796,39686
"2322","ENSMODG00000003146","3",490227773,490236538,8765
"2323","ENSMODG00000003147","2",231610308,231624167,13859
"2324","ENSMODG00000003148","1",699040310,699146512,106202
"2325","ENSMODG00000003149","2",537699712,537709118,9406
"2326","ENSMODG00000003150","5",227364049,227455398,91349
"2327","ENSMODG00000003151","6",98806019,98860934,54915
"2328","ENSMODG00000003152","3",490237541,490296496,58955
"2329","ENSMODG00000003153","6",217915741,218229648,313907
"2330","ENSMODG00000003156","2",31926062,31944932,18870
"2331","ENSMODG00000003157","3",490239473,490240665,1192
"2332","ENSMODG00000003159","7",75716389,75846550,130161
"2333","ENSMODG00000003160","1",173617502,173640510,23008
"2334","ENSMODG00000003163","2",259157856,259158962,1106
"2335","ENSMODG00000003164","2",61819596,61870562,50966
"2336","ENSMODG00000003165","1",227434254,227670836,236582
"2337","ENSMODG00000003166","5",227480276,227535907,55631
"2338","ENSMODG00000003167","2",259137430,259139273,1843
"2339","ENSMODG00000003168","3",490212467,490247339,34872
"2340","ENSMODG00000003175","5",227838464,227849456,10992
"2341","ENSMODG00000003176","2",259000738,259002327,1589
"2342","ENSMODG00000003178","3",450813459,450910317,96858
"2343","ENSMODG00000003179","6",31786274,31810606,24332
"2344","ENSMODG00000003181","1",173575145,173577547,2402
"2345","ENSMODG00000003183","1",698999098,699027643,28545
"2346","ENSMODG00000003186","2",121509611,121635846,126235
"2347","ENSMODG00000003187","8",80777191,80835191,58000
"2348","ENSMODG00000003188","3",496462974,496670209,207235
"2349","ENSMODG00000003189","3",490319750,490347754,28004
"2350","ENSMODG00000003191","1",628303501,628372707,69206
"2351","ENSMODG00000003192","7",75750362,75790779,40417
"2352","ENSMODG00000003193","3",64113252,64203977,90725
"2353","ENSMODG00000003195","X",21283717,21524527,240810
"2354","ENSMODG00000003196","2",537773956,537788288,14332
"2355","ENSMODG00000003199","3",450974184,450984890,10706
"2356","ENSMODG00000003201","1",698976722,698983717,6995
"2357","ENSMODG00000003202","6",31819209,31874093,54884
"2358","ENSMODG00000003205","3",490372943,490378323,5380
"2359","ENSMODG00000003207","8",80695111,80718575,23464
"2360","ENSMODG00000003208","3",64233409,64253423,20014
"2361","ENSMODG00000003209","5",227858893,227927509,68616
"2362","ENSMODG00000003210","6",31872349,31891915,19566
"2363","ENSMODG00000003211","2",122622980,122676927,53947
"2364","ENSMODG00000003212","1",628151456,628163531,12075
"2365","ENSMODG00000003213","4",374868909,374902348,33439
"2366","ENSMODG00000003214","3",450986907,450994366,7459
"2367","ENSMODG00000003215","1",698732133,698822080,89947
"2368","ENSMODG00000003216","Un",74999618,75001157,1539
"2369","ENSMODG00000003218","2",538697341,538754445,57104
"2370","ENSMODG00000003219","X",20711069,21178277,467208
"2371","ENSMODG00000003220","2",231353021,231534300,181279
"2372","ENSMODG00000003221","4",270497758,270529712,31954
"2373","ENSMODG00000003224","Un",73837837,73838414,577
"2374","ENSMODG00000003225","2",31876534,31916263,39729
"2375","ENSMODG00000003226","1",627659613,627664566,4953
"2376","ENSMODG00000003228","6",32240282,32256319,16037
"2377","ENSMODG00000003229","2",537800620,537807452,6832
"2378","ENSMODG00000003230","Un",74062558,74070609,8051
"2379","ENSMODG00000003233","4",375051908,375064941,13033
"2380","ENSMODG00000003235","1",627443473,627514173,70700
"2381","ENSMODG00000003237","2",123092057,123136210,44153
"2382","ENSMODG00000003239","6",32268179,32275861,7682
"2383","ENSMODG00000003240","2",185946931,186222836,275905
"2384","ENSMODG00000003241","3",64218378,64231647,13269
"2385","ENSMODG00000003242","4",375081431,375086000,4569
"2386","ENSMODG00000003243","5",100558200,100563842,5642
"2387","ENSMODG00000003244","2",231348214,231350918,2704
"2388","ENSMODG00000003245","1",173566632,173573569,6937
"2389","ENSMODG00000003247","6",32230973,32459906,228933
"2390","ENSMODG00000003248","6",219161919,219313611,151692
"2391","ENSMODG00000003249","4",405566584,405571743,5159
"2392","ENSMODG00000003250","3",64313247,64408128,94881
"2393","ENSMODG00000003251","1",70868901,70926466,57565
"2394","ENSMODG00000003252","3",496434186,496439413,5227
"2395","ENSMODG00000003253","2",61984757,62046079,61322
"2396","ENSMODG00000003254","1",173558198,173558733,535
"2397","ENSMODG00000003255","2",231342009,231347245,5236
"2398","ENSMODG00000003256","1",698691016,698713705,22689
"2399","ENSMODG00000003258","2",31834682,31972277,137595
"2400","ENSMODG00000003260","3",64695802,64719957,24155
"2401","ENSMODG00000003261","6",32358769,32408715,49946
"2402","ENSMODG00000003263","3",451005665,451046563,40898
"2403","ENSMODG00000003264","6",219314420,219454003,139583
"2404","ENSMODG00000003265","4",375093673,375111781,18108
"2405","ENSMODG00000003266","1",173548486,173553210,4724
"2406","ENSMODG00000003267","2",231306172,231317924,11752
"2407","ENSMODG00000003269","2",123152362,123426501,274139
"2408","ENSMODG00000003270","6",32428011,32453904,25893
"2409","ENSMODG00000003273","1",70950152,71071141,120989
"2410","ENSMODG00000003275","1",173546118,173550169,4051
"2411","ENSMODG00000003276","6",219987447,219999055,11608
"2412","ENSMODG00000003277","2",258527557,258528900,1343
"2413","ENSMODG00000003278","2",470298605,470599630,301025
"2414","ENSMODG00000003279","2",185812484,185925338,112854
"2415","ENSMODG00000003280","2",31503853,31545163,41310
"2416","ENSMODG00000003282","1",227671576,227724019,52443
"2417","ENSMODG00000003284","1",698572510,698593616,21106
"2418","ENSMODG00000003285","3",64757663,64948037,190374
"2419","ENSMODG00000003286","2",231208119,231235245,27126
"2420","ENSMODG00000003287","1",698495639,698497744,2105
"2421","ENSMODG00000003288","2",261743317,261748788,5471
"2422","ENSMODG00000003289","3",496406365,496409734,3369
"2423","ENSMODG00000003290","5",228735149,228736558,1409
"2424","ENSMODG00000003291","2",123522677,123548047,25370
"2425","ENSMODG00000003292","1",698480652,698495052,14400
"2426","ENSMODG00000003294","6",220453232,220800531,347299
"2427","ENSMODG00000003295","4",149310451,149450100,139649
"2428","ENSMODG00000003296","1",173537847,173542408,4561
"2429","ENSMODG00000003297","4",270543039,270634343,91304
"2430","ENSMODG00000003299","1",698437388,698442093,4705
"2431","ENSMODG00000003300","2",185797666,185804595,6929
"2432","ENSMODG00000003301","4",375113603,375142371,28768
"2433","ENSMODG00000003302","6",32471006,32728377,257371
"2434","ENSMODG00000003303","2",537813924,537819564,5640
"2435","ENSMODG00000003305","3",65132323,65269762,137439
"2436","ENSMODG00000003306","6",98899291,99204085,304794
"2437","ENSMODG00000003307","2",185238291,185243251,4960
"2438","ENSMODG00000003308","2",32084314,32755816,671502
"2439","ENSMODG00000003309","4",375228993,375262476,33483
"2440","ENSMODG00000003310","1",626909327,626940122,30795
"2441","ENSMODG00000003315","1",626811292,626823251,11959
"2442","ENSMODG00000003316","2",185226762,185237154,10392
"2443","ENSMODG00000003317","6",99223885,99224802,917
"2444","ENSMODG00000003318","2",33480090,33481055,965
"2445","ENSMODG00000003320","4",375338883,375367601,28718
"2446","ENSMODG00000003321","2",33278915,33279949,1034
"2447","ENSMODG00000003323","2",33358941,33361193,2252
"2448","ENSMODG00000003324","3",65296625,65414042,117417
"2449","ENSMODG00000003325","1",698402433,698428352,25919
"2450","ENSMODG00000003327","4",149455915,149533388,77473
"2451","ENSMODG00000003328","3",496264090,496293013,28923
"2452","ENSMODG00000003329","2",124060691,124227281,166590
"2453","ENSMODG00000003330","6",32825293,33066588,241295
"2454","ENSMODG00000003331","2",231200558,231207710,7152
"2455","ENSMODG00000003334","1",227773478,227882330,108852
"2456","ENSMODG00000003335","6",33158372,33175987,17615
"2457","ENSMODG00000003337","1",173522649,173537522,14873
"2458","ENSMODG00000003338","5",100114340,100120117,5777
"2459","ENSMODG00000003339","2",537821324,537828154,6830
"2460","ENSMODG00000003340","1",626764286,626804228,39942
"2461","ENSMODG00000003341","2",33391205,33421607,30402
"2462","ENSMODG00000003344","1",228047537,228240869,193332
"2463","ENSMODG00000003345","Un",76673683,76674915,1232
"2464","ENSMODG00000003346","6",33176089,33315236,139147
"2465","ENSMODG00000003347","2",468825010,468895413,70403
"2466","ENSMODG00000003349","1",698373620,698388512,14892
"2467","ENSMODG00000003351","2",231167666,231198978,31312
"2468","ENSMODG00000003352","2",185192926,185217512,24586
"2469","ENSMODG00000003354","2",33530337,33582749,52412
"2470","ENSMODG00000003356","2",124648452,124741771,93319
"2471","ENSMODG00000003357","3",496101395,496162764,61369
"2472","ENSMODG00000003358","3",65496545,65650060,153515
"2473","ENSMODG00000003359","1",173515823,173528843,13020
"2474","ENSMODG00000003360","2",538855836,538860596,4760
"2475","ENSMODG00000003362","1",727339954,727356362,16408
"2476","ENSMODG00000003363","3",280326474,280341475,15001
"2477","ENSMODG00000003364","1",626565021,626614062,49041
"2478","ENSMODG00000003365","6",33372012,33396001,23989
"2479","ENSMODG00000003366","1",228567409,228824587,257178
"2480","ENSMODG00000003368","1",173502280,173509176,6896
"2481","ENSMODG00000003369","4",375366264,375446359,80095
"2482","ENSMODG00000003370","2",467785483,467822881,37398
"2483","ENSMODG00000003372","2",185125833,185174487,48654
"2484","ENSMODG00000003374","3",65651883,65707353,55470
"2485","ENSMODG00000003375","4",375469869,375474659,4790
"2486","ENSMODG00000003377","2",35018524,35238656,220132
"2487","ENSMODG00000003379","2",185118232,185124389,6157
"2488","ENSMODG00000003380","1",626314618,626496193,181575
"2489","ENSMODG00000003381","3",65818942,65827881,8939
"2490","ENSMODG00000003382","4",375551285,375552142,857
"2491","ENSMODG00000003383","3",496053674,496096472,42798
"2492","ENSMODG00000003384","6",33405430,33418886,13456
"2493","ENSMODG00000003385","Un",76656725,76664486,7761
"2494","ENSMODG00000003386","2",267981732,267983660,1928
"2495","ENSMODG00000003387","6",99255219,99535825,280606
"2496","ENSMODG00000003389","1",71072844,71199345,126501
"2497","ENSMODG00000003390","2",62077428,62078555,1127
"2498","ENSMODG00000003391","4",375522563,375576043,53480
"2499","ENSMODG00000003393","3",66706510,66782413,75903
"2500","ENSMODG00000003396","1",624803772,624955815,152043
"2501","ENSMODG00000003397","1",173493075,173500716,7641
"2502","ENSMODG00000003400","3",66844826,66845522,696
"2503","ENSMODG00000003401","6",99635121,99775904,140783
"2504","ENSMODG00000003402","1",698257800,698300995,43195
"2505","ENSMODG00000003403","2",35256677,35316034,59357
"2506","ENSMODG00000003404","5",98051742,98055392,3650
"2507","ENSMODG00000003405","6",221749901,221839897,89996
"2508","ENSMODG00000003406","2",539038735,539050327,11592
"2509","ENSMODG00000003407","6",99786003,99809221,23218
"2510","ENSMODG00000003411","4",375580193,375658157,77964
"2511","ENSMODG00000003412","3",66987757,67434168,446411
"2512","ENSMODG00000003413","3",496014059,496027842,13783
"2513","ENSMODG00000003415","4",149942049,150000226,58177
"2514","ENSMODG00000003418","2",35326260,35425803,99543
"2515","ENSMODG00000003419","3",496009256,496012581,3325
"2516","ENSMODG00000003421","4",375705054,375733666,28612
"2517","ENSMODG00000003422","4",271177886,271178824,938
"2518","ENSMODG00000003423","2",231059998,231112048,52050
"2519","ENSMODG00000003425","2",539070854,539075165,4311
"2520","ENSMODG00000003429","4",375791861,375801946,10085
"2521","ENSMODG00000003430","6",99898320,99907995,9675
"2522","ENSMODG00000003432","3",495982596,496006817,24221
"2523","ENSMODG00000003433","2",62083588,62149866,66278
"2524","ENSMODG00000003435","3",114015301,114175992,160691
"2525","ENSMODG00000003436","6",222480603,222482503,1900
"2526","ENSMODG00000003437","Un",73735430,73737298,1868
"2527","ENSMODG00000003438","3",114496837,114511856,15019
"2528","ENSMODG00000003439","6",33433054,33455973,22919
"2529","ENSMODG00000003440","1",698179990,698237530,57540
"2530","ENSMODG00000003441","2",467683543,467776115,92572
"2531","ENSMODG00000003442","3",451184598,451185749,1151
"2532","ENSMODG00000003443","2",230729350,231049662,320312
"2533","ENSMODG00000003445","3",114663002,114807838,144836
"2534","ENSMODG00000003446","4",375809221,375819853,10632
"2535","ENSMODG00000003447","4",150224582,150415934,191352
"2536","ENSMODG00000003449","2",62149434,62176057,26623
"2537","ENSMODG00000003450","6",222320172,222338537,18365
"2538","ENSMODG00000003452","2",230850750,230853489,2739
"2539","ENSMODG00000003453","2",467650382,467678787,28405
"2540","ENSMODG00000003454","1",228865924,228867102,1178
"2541","ENSMODG00000003455","3",451259128,451292788,33660
"2542","ENSMODG00000003456","2",539078577,539090231,11654
"2543","ENSMODG00000003458","Un",73000654,73003404,2750
"2544","ENSMODG00000003459","3",115102024,115132043,30019
"2545","ENSMODG00000003461","5",229539508,229591434,51926
"2546","ENSMODG00000003463","1",698056675,698145607,88932
"2547","ENSMODG00000003464","3",67821174,68297672,476498
"2548","ENSMODG00000003465","1",229212502,229370333,157831
"2549","ENSMODG00000003467","1",229058732,229060087,1355
"2550","ENSMODG00000003468","6",222380714,222409227,28513
"2551","ENSMODG00000003469","5",229666099,229751124,85025
"2552","ENSMODG00000003470","3",451508064,451674114,166050
"2553","ENSMODG00000003472","1",173488583,173491865,3282
"2554","ENSMODG00000003473","3",451529062,451530942,1880
"2555","ENSMODG00000003474","1",229075144,229075855,711
"2556","ENSMODG00000003475","3",68416140,68452266,36126
"2557","ENSMODG00000003477","3",115138559,115442227,303668
"2558","ENSMODG00000003479","1",698046490,698056004,9514
"2559","ENSMODG00000003480","6",16287880,16742983,455103
"2560","ENSMODG00000003481","3",495916758,495975721,58963
"2561","ENSMODG00000003482","2",539372242,539378637,6395
"2562","ENSMODG00000003483","3",451687967,451707626,19659
"2563","ENSMODG00000003485","5",229770932,229832240,61308
"2564","ENSMODG00000003486","3",460140509,460205999,65490
"2565","ENSMODG00000003487","1",71199190,71220707,21517
"2566","ENSMODG00000003488","1",173470304,173471763,1459
"2567","ENSMODG00000003489","3",451747725,451753635,5910
"2568","ENSMODG00000003490","3",495793319,495818146,24827
"2569","ENSMODG00000003492","4",375824204,375841816,17612
"2570","ENSMODG00000003493","1",698017735,698038379,20644
"2571","ENSMODG00000003495","6",15525643,15526746,1103
"2572","ENSMODG00000003496","1",697993466,697996439,2973
"2573","ENSMODG00000003497","2",467517196,467542137,24941
"2574","ENSMODG00000003499","3",451759978,451763543,3565
"2575","ENSMODG00000003500","1",229849833,229997348,147515
"2576","ENSMODG00000003502","5",229850880,230065542,214662
"2577","ENSMODG00000003503","1",230580692,230581545,853
"2578","ENSMODG00000003504","1",697976001,697988879,12878
"2579","ENSMODG00000003505","1",71225327,71280331,55004
"2580","ENSMODG00000003506","3",68626256,69242668,616412
"2581","ENSMODG00000003507","3",495881095,495915737,34642
"2582","ENSMODG00000003508","5",230161798,230234457,72659
"2583","ENSMODG00000003509","4",271239515,271240506,991
"2584","ENSMODG00000003510","3",451770948,451782410,11462
"2585","ENSMODG00000003513","1",233521541,233523526,1985
"2586","ENSMODG00000003514","5",96718871,97089025,370154
"2587","ENSMODG00000003515","4",375864760,375944060,79300
"2588","ENSMODG00000003517","1",697895048,697911569,16521
"2589","ENSMODG00000003518","3",69304136,69305060,924
"2590","ENSMODG00000003519","1",71280887,71291379,10492
"2591","ENSMODG00000003520","3",475399687,475401288,1601
"2592","ENSMODG00000003521","2",467047629,467342180,294551
"2593","ENSMODG00000003524","4",406031530,406054489,22959
"2594","ENSMODG00000003525","6",33553436,33890807,337371
"2595","ENSMODG00000003526","4",150526997,150744747,217750
"2596","ENSMODG00000003527","5",96246711,96250785,4074
"2597","ENSMODG00000003528","4",375988206,376003273,15067
"2598","ENSMODG00000003529","1",71400254,71404019,3765
"2599","ENSMODG00000003530","3",460214080,460244113,30033
"2600","ENSMODG00000003531","4",271374121,271375089,968
"2601","ENSMODG00000003532","1",173466920,173470098,3178
"2602","ENSMODG00000003534","3",69312009,69317283,5274
"2603","ENSMODG00000003535","3",495780077,495788049,7972
"2604","ENSMODG00000003536","5",96195557,96202731,7174
"2605","ENSMODG00000003537","4",151011548,151025264,13716
"2606","ENSMODG00000003539","1",173464784,173466134,1350
"2607","ENSMODG00000003542","6",14792026,14883743,91717
"2608","ENSMODG00000003543","5",96176137,96178914,2777
"2609","ENSMODG00000003544","2",62224850,62412341,187491
"2610","ENSMODG00000003545","1",697872643,697888143,15500
"2611","ENSMODG00000003546","4",151315449,151316354,905
"2612","ENSMODG00000003547","4",271513608,271514558,950
"2613","ENSMODG00000003548","5",95916424,95922186,5762
"2614","ENSMODG00000003549","5",303487645,303539186,51541
"2615","ENSMODG00000003550","3",451794030,451798969,4939
"2616","ENSMODG00000003551","2",230561902,230593461,31559
"2617","ENSMODG00000003552","3",115002521,115624647,622126
"2618","ENSMODG00000003553","4",151219937,151382154,162217
"2619","ENSMODG00000003554","1",623688392,623701096,12704
"2620","ENSMODG00000003555","1",697641234,697660377,19143
"2621","ENSMODG00000003557","2",467014028,467044823,30795
"2622","ENSMODG00000003558","1",71562118,71594777,32659
"2623","ENSMODG00000003559","6",14762142,14773642,11500
"2624","ENSMODG00000003560","3",116034649,116035320,671
"2625","ENSMODG00000003561","1",622935385,622939520,4135
"2626","ENSMODG00000003562","2",62463106,62492107,29001
"2627","ENSMODG00000003563","4",376007080,376041224,34144
"2628","ENSMODG00000003564","3",69419528,69453611,34083
"2629","ENSMODG00000003565","3",495734205,495753613,19408
"2630","ENSMODG00000003566","4",151468670,151497554,28884
"2631","ENSMODG00000003567","1",622798879,622818128,19249
"2632","ENSMODG00000003568","3",451846114,451918457,72343
"2633","ENSMODG00000003569","4",376074397,376075488,1091
"2634","ENSMODG00000003570","1",173452555,173462485,9930
"2635","ENSMODG00000003571","1",697587972,697593643,5671
"2636","ENSMODG00000003572","2",62866389,62888443,22054
"2637","ENSMODG00000003574","6",34599391,34731135,131744
"2638","ENSMODG00000003575","4",152628284,152653873,25589
"2639","ENSMODG00000003576","1",71601393,71666040,64647
"2640","ENSMODG00000003577","4",271571750,271573107,1357
"2641","ENSMODG00000003578","6",101206132,101401014,194882
"2642","ENSMODG00000003579","7",75928289,76230127,301838
"2643","ENSMODG00000003581","4",153668926,153677213,8287
"2644","ENSMODG00000003582","2",62966729,63061898,95169
"2645","ENSMODG00000003584","5",94979017,95029008,49991
"2646","ENSMODG00000003585","6",14637146,14705283,68137
"2647","ENSMODG00000003586","4",271575640,271576590,950
"2648","ENSMODG00000003587","2",230500798,230583653,82855
"2649","ENSMODG00000003588","2",466897332,466965146,67814
"2650","ENSMODG00000003590","3",117331372,117331890,518
"2651","ENSMODG00000003591","2",35630311,35706435,76124
"2652","ENSMODG00000003592","8",214788285,214789070,785
"2653","ENSMODG00000003593","2",63254462,63331466,77004
"2654","ENSMODG00000003594","4",153701274,153724306,23032
"2655","ENSMODG00000003595","3",69721774,69755758,33984
"2656","ENSMODG00000003597","3",495118580,495295824,177244
"2657","ENSMODG00000003598","1",622818505,622855068,36563
"2658","ENSMODG00000003599","1",173436491,173457825,21334
"2659","ENSMODG00000003600","8",214794750,214801488,6738
"2660","ENSMODG00000003602","1",72139274,72471467,332193
"2661","ENSMODG00000003603","5",94931871,94981032,49161
"2662","ENSMODG00000003605","1",235136329,235137136,807
"2663","ENSMODG00000003606","4",153787951,153815744,27793
"2664","ENSMODG00000003607","3",451918562,452048568,130006
"2665","ENSMODG00000003608","2",35795050,35879914,84864
"2666","ENSMODG00000003609","1",173421624,173423437,1813
"2667","ENSMODG00000003610","3",460270109,460301008,30899
"2668","ENSMODG00000003611","2",63345257,63363067,17810
"2669","ENSMODG00000003612","4",376079189,376111441,32252
"2670","ENSMODG00000003613","3",495098335,495099473,1138
"2671","ENSMODG00000003614","1",622735038,622793610,58572
"2672","ENSMODG00000003615","5",230237564,230433745,196181
"2673","ENSMODG00000003616","8",214828399,214863556,35157
"2674","ENSMODG00000003618","2",466872519,466897252,24733
"2675","ENSMODG00000003619","3",460327742,460334225,6483
"2676","ENSMODG00000003620","6",101931973,101972078,40105
"2677","ENSMODG00000003621","1",622739423,622740010,587
"2678","ENSMODG00000003622","6",222411536,222438442,26906
"2679","ENSMODG00000003626","5",94604573,94645240,40667
"2680","ENSMODG00000003627","8",215009140,215044657,35517
"2681","ENSMODG00000003628","1",622565595,622580271,14676
"2682","ENSMODG00000003629","3",460327975,460334225,6250
"2683","ENSMODG00000003631","6",102078809,102090547,11738
"2684","ENSMODG00000003633","7",76611011,76705345,94334
"2685","ENSMODG00000003634","6",34988973,35346137,357164
"2686","ENSMODG00000003635","6",102273423,102428626,155203
"2687","ENSMODG00000003637","2",63380643,63405452,24809
"2688","ENSMODG00000003639","6",222486450,222524097,37647
"2689","ENSMODG00000003640","2",540159499,540161442,1943
"2690","ENSMODG00000003641","1",173362217,173418801,56584
"2691","ENSMODG00000003642","1",697481982,697510925,28943
"2692","ENSMODG00000003644","8",215095886,215104106,8220
"2693","ENSMODG00000003646","2",466849949,466875134,25185
"2694","ENSMODG00000003647","1",385894553,385964408,69855
"2695","ENSMODG00000003649","4",376124876,376139244,14368
"2696","ENSMODG00000003650","5",94082363,94377710,295347
"2697","ENSMODG00000003651","3",452056133,452070342,14209
"2698","ENSMODG00000003652","8",215066893,215078365,11472
"2699","ENSMODG00000003654","1",622497161,622528228,31067
"2700","ENSMODG00000003655","6",35358160,35398119,39959
"2701","ENSMODG00000003657","8",215112372,215113220,848
"2702","ENSMODG00000003658","2",63420779,63446366,25587
"2703","ENSMODG00000003663","1",697432683,697436158,3475
"2704","ENSMODG00000003664","1",72497557,72534754,37197
"2705","ENSMODG00000003666","8",215132421,215133132,711
"2706","ENSMODG00000003668","1",239374557,239375372,815
"2707","ENSMODG00000003669","8",215209441,215215880,6439
"2708","ENSMODG00000003670","3",119016784,119585544,568760
"2709","ENSMODG00000003673","1",385782151,385782561,410
"2710","ENSMODG00000003674","6",14347163,14445164,98001
"2711","ENSMODG00000003675","1",173378162,173392042,13880
"2712","ENSMODG00000003676","2",466813003,466849660,36657
"2713","ENSMODG00000003677","4",271627202,271646576,19374
"2714","ENSMODG00000003679","1",622361131,622437099,75968
"2715","ENSMODG00000003685","8",215295360,215308757,13397
"2716","ENSMODG00000003686","6",14213939,14340788,126849
"2717","ENSMODG00000003687","2",466759462,466812910,53448
"2718","ENSMODG00000003688","6",222560986,222729408,168422
"2719","ENSMODG00000003689","3",452071184,452268479,197295
"2720","ENSMODG00000003690","3",393567260,393805182,237922
"2721","ENSMODG00000003691","1",173345292,173378072,32780
"2722","ENSMODG00000003692","1",72539627,72576257,36630
"2723","ENSMODG00000003693","5",230498010,230653630,155620
"2724","ENSMODG00000003694","2",230049383,230050101,718
"2725","ENSMODG00000003695","1",622186621,622198032,11411
"2726","ENSMODG00000003696","2",63483404,63527843,44439
"2727","ENSMODG00000003698","4",271646644,271653133,6489
"2728","ENSMODG00000003699","3",494670099,494671972,1873
"2729","ENSMODG00000003700","5",230566128,230567480,1352
"2730","ENSMODG00000003701","2",229965981,229995382,29401
"2731","ENSMODG00000003703","4",153822134,153867850,45716
"2732","ENSMODG00000003704","5",92276021,92504682,228661
"2733","ENSMODG00000003705","3",452270762,452276067,5305
"2734","ENSMODG00000003706","8",215385209,215400911,15702
"2735","ENSMODG00000003708","1",385722169,385741303,19134
"2736","ENSMODG00000003710","7",76941035,76964827,23792
"2737","ENSMODG00000003712","2",466672056,466727684,55628
"2738","ENSMODG00000003714","1",239506437,239578107,71670
"2739","ENSMODG00000003715","1",697331807,697416846,85039
"2740","ENSMODG00000003717","2",63534414,63568201,33787
"2741","ENSMODG00000003718","1",173203025,173240459,37434
"2742","ENSMODG00000003719","4",271654823,271709265,54442
"2743","ENSMODG00000003720","7",76977711,77007117,29406
"2744","ENSMODG00000003722","1",239689079,239820212,131133
"2745","ENSMODG00000003723","4",271713793,271734055,20262
"2746","ENSMODG00000003725","1",385670855,385719099,48244
"2747","ENSMODG00000003726","1",72786461,72797036,10575
"2748","ENSMODG00000003728","1",728170231,728188123,17892
"2749","ENSMODG00000003729","3",452294179,452314846,20667
"2750","ENSMODG00000003730","3",494489491,494506319,16828
"2751","ENSMODG00000003731","1",239918046,239967653,49607
"2752","ENSMODG00000003732","2",532156558,532185384,28826
"2753","ENSMODG00000003733","1",385653644,385655869,2225
"2754","ENSMODG00000003734","5",91772633,91908387,135754
"2755","ENSMODG00000003735","1",621735148,621789366,54218
"2756","ENSMODG00000003736","5",230654722,230723710,68988
"2757","ENSMODG00000003737","7",77011217,77124883,113666
"2758","ENSMODG00000003738","3",494538177,494539028,851
"2759","ENSMODG00000003739","2",63634305,63657410,23105
"2760","ENSMODG00000003740","1",696976528,697006128,29600
"2761","ENSMODG00000003741","3",494565377,494566327,950
"2762","ENSMODG00000003742","1",621416898,621536853,119955
"2763","ENSMODG00000003743","2",229955212,229962137,6925
"2764","ENSMODG00000003744","5",91740406,91760922,20516
"2765","ENSMODG00000003745","3",452315148,452328534,13386
"2766","ENSMODG00000003748","1",72799658,73024356,224698
"2767","ENSMODG00000003749","2",258383457,258430690,47233
"2768","ENSMODG00000003750","3",432739073,432743503,4430
"2769","ENSMODG00000003753","3",69764662,70332577,567915
"2770","ENSMODG00000003754","6",223174053,223462775,288722
"2771","ENSMODG00000003755","3",503944413,503950171,5758
"2772","ENSMODG00000003756","3",122205710,122822988,617278
"2773","ENSMODG00000003757","5",230800542,230832101,31559
"2774","ENSMODG00000003758","3",432834857,432835207,350
"2775","ENSMODG00000003761","1",621352022,621355838,3816
"2776","ENSMODG00000003762","1",696933038,696940540,7502
"2777","ENSMODG00000003763","1",474399966,474418379,18413
"2778","ENSMODG00000003764","4",271825359,271831587,6228
"2779","ENSMODG00000003765","3",494422953,494423878,925
"2780","ENSMODG00000003766","5",91622054,91712506,90452
"2781","ENSMODG00000003767","1",240032185,240189474,157289
"2782","ENSMODG00000003768","1",173159547,173171195,11648
"2783","ENSMODG00000003769","3",124397263,124397628,365
"2784","ENSMODG00000003770","3",494270504,494272609,2105
"2785","ENSMODG00000003771","3",452328840,452333308,4468
"2786","ENSMODG00000003772","2",63730060,63825424,95364
"2787","ENSMODG00000003773","3",70379687,70441807,62120
"2788","ENSMODG00000003774","3",494184678,494186473,1795
"2789","ENSMODG00000003778","1",385595183,385654749,59566
"2790","ENSMODG00000003779","2",229916085,229954350,38265
"2791","ENSMODG00000003781","6",36161126,36238921,77795
"2792","ENSMODG00000003782","5",91569721,91581266,11545
"2793","ENSMODG00000003784","1",621305147,621333635,28488
"2794","ENSMODG00000003787","1",172993912,173001600,7688
"2795","ENSMODG00000003789","7",77224847,77277640,52793
"2796","ENSMODG00000003790","2",258341743,258375340,33597
"2797","ENSMODG00000003791","4",271830394,271838367,7973
"2798","ENSMODG00000003795","3",70459674,70507013,47339
"2799","ENSMODG00000003796","2",63842280,63863147,20867
"2800","ENSMODG00000003797","3",494882080,494883012,932
"2801","ENSMODG00000003798","8",215480666,215536312,55646
"2802","ENSMODG00000003799","5",91100221,91144337,44116
"2803","ENSMODG00000003800","4",271841242,271845956,4714
"2804","ENSMODG00000003801","3",460359248,460492931,133683
"2805","ENSMODG00000003802","6",14145845,14166602,20757
"2806","ENSMODG00000003804","2",229742409,229889476,147067
"2807","ENSMODG00000003805","3",70524235,70535974,11739
"2808","ENSMODG00000003806","1",385459498,385471736,12238
"2809","ENSMODG00000003807","1",73075290,73310087,234797
"2810","ENSMODG00000003808","7",77316378,77342425,26047
"2811","ENSMODG00000003809","2",229855658,229856530,872
"2812","ENSMODG00000003811","2",63912007,63950941,38934
"2813","ENSMODG00000003813","5",90224764,90281461,56697
"2814","ENSMODG00000003814","2",37324196,37500469,176273
"2815","ENSMODG00000003815","5",230835689,230947771,112082
"2816","ENSMODG00000003816","4",406082329,406085890,3561
"2817","ENSMODG00000003818","4",271857214,271884197,26983
"2818","ENSMODG00000003819","3",70962956,71030211,67255
"2819","ENSMODG00000003820","6",36297238,36304774,7536
"2820","ENSMODG00000003821","5",90122407,90139246,16839
"2821","ENSMODG00000003822","1",172982212,172990857,8645
"2822","ENSMODG00000003824","3",460405009,460426664,21655
"2823","ENSMODG00000003825","6",14110376,14120264,9888
"2824","ENSMODG00000003828","1",172976665,172982841,6176
"2825","ENSMODG00000003829","6",36842994,36855777,12783
"2826","ENSMODG00000003830","2",37502613,37524740,22127
"2827","ENSMODG00000003831","2",466483352,466558509,75157
"2828","ENSMODG00000003833","3",71098755,71128531,29776
"2829","ENSMODG00000003834","Un",69546209,69557850,11641
"2830","ENSMODG00000003838","2",258181589,258209136,27547
"2831","ENSMODG00000003841","3",460434464,460475029,40565
"2832","ENSMODG00000003842","1",696917913,696931255,13342
"2833","ENSMODG00000003843","5",231036493,231149036,112543
"2834","ENSMODG00000003845","6",13916238,13947779,31541
"2835","ENSMODG00000003846","7",77346250,77429270,83020
"2836","ENSMODG00000003848","Un",101216427,101216915,488
"2837","ENSMODG00000003849","2",37699845,37722053,22208
"2838","ENSMODG00000003850","X",55424314,55425874,1560
"2839","ENSMODG00000003852","3",125069376,125070122,746
"2840","ENSMODG00000003854","2",466347750,466402385,54635
"2841","ENSMODG00000003855","1",696622248,696829550,207302
"2842","ENSMODG00000003856","3",393227206,393251647,24441
"2843","ENSMODG00000003857","2",37738634,37793425,54791
"2844","ENSMODG00000003859","1",73436270,73442034,5764
"2845","ENSMODG00000003861","4",271944805,271961203,16398
"2846","ENSMODG00000003862","1",451260511,451265945,5434
"2847","ENSMODG00000003864","2",37791840,37828200,36360
"2848","ENSMODG00000003865","1",621265930,621299968,34038
"2849","ENSMODG00000003866","2",229375804,229559723,183919
"2850","ENSMODG00000003867","2",466260693,466320953,60260
"2851","ENSMODG00000003869","1",696138319,696176068,37749
"2852","ENSMODG00000003871","X",55504058,55579974,75916
"2853","ENSMODG00000003873","1",696115957,696120576,4619
"2854","ENSMODG00000003874","4",271962660,271971291,8631
"2855","ENSMODG00000003875","7",77489498,77554188,64690
"2856","ENSMODG00000003880","6",37952275,37954520,2245
"2857","ENSMODG00000003881","3",460544442,460557810,13368
"2858","ENSMODG00000003882","1",385366314,385433831,67517
"2859","ENSMODG00000003883","1",621230481,621244535,14054
"2860","ENSMODG00000003884","6",224694698,224968275,273577
"2861","ENSMODG00000003885","X",55811827,55812160,333
"2862","ENSMODG00000003886","2",63990995,64011550,20555
"2863","ENSMODG00000003888","2",37864826,37950685,85859
"2864","ENSMODG00000003889","1",696099055,696105318,6263
"2865","ENSMODG00000003890","3",460559507,460560033,526
"2866","ENSMODG00000003891","4",271986467,272005241,18774
"2867","ENSMODG00000003892","5",231266056,231295767,29711
"2868","ENSMODG00000003893","1",728203412,728220160,16748
"2869","ENSMODG00000003894","7",77563029,77587823,24794
"2870","ENSMODG00000003895","3",460560206,460567024,6818
"2871","ENSMODG00000003896","2",465693289,465762994,69705
"2872","ENSMODG00000003897","2",229685646,229691743,6097
"2873","ENSMODG00000003898","1",621217200,621225312,8112
"2874","ENSMODG00000003899","6",225502508,225550227,47719
"2875","ENSMODG00000003900","X",55887361,55901099,13738
"2876","ENSMODG00000003901","2",258109567,258110517,950
"2877","ENSMODG00000003902","6",225621014,225622216,1202
"2878","ENSMODG00000003903","8",215556750,215584448,27698
"2879","ENSMODG00000003904","1",385212621,385321663,109042
"2880","ENSMODG00000003907","1",73456184,73476552,20368
"2881","ENSMODG00000003909","2",37964990,37984011,19021
"2882","ENSMODG00000003910","6",225650162,225667710,17548
"2883","ENSMODG00000003911","1",73502670,73503113,443
"2884","ENSMODG00000003913","8",215582819,215592170,9351
"2885","ENSMODG00000003914","2",37999152,38002289,3137
"2886","ENSMODG00000003915","7",77628339,77696859,68520
"2887","ENSMODG00000003917","1",73527163,73528264,1101
"2888","ENSMODG00000003918","1",385013820,385116307,102487
"2889","ENSMODG00000003919","1",621122040,621177856,55816
"2890","ENSMODG00000003920","X",55917456,56102040,184584
"2891","ENSMODG00000003921","6",226398729,226468621,69892
"2892","ENSMODG00000003923","1",620613239,620614051,812
"2893","ENSMODG00000003925","5",231327539,231423166,95627
"2894","ENSMODG00000003926","6",226878677,226965952,87275
"2895","ENSMODG00000003927","2",38024438,38027262,2824
"2896","ENSMODG00000003928","1",619951588,620161116,209528
"2897","ENSMODG00000003929","6",227001892,227081217,79325
"2898","ENSMODG00000003931","1",73532343,73552217,19874
"2899","ENSMODG00000003932","2",38042257,38074110,31853
"2900","ENSMODG00000003934","2",258025491,258042086,16595
"2901","ENSMODG00000003935","4",153896945,154127506,230561
"2902","ENSMODG00000003936","6",38999930,39160203,160273
"2903","ENSMODG00000003937","8",215594194,215611912,17718
"2904","ENSMODG00000003938","5",231607238,231639984,32746
"2905","ENSMODG00000003939","6",102475686,102824072,348386
"2906","ENSMODG00000003940","6",227115714,227176492,60778
"2907","ENSMODG00000003942","1",73565574,73570562,4988
"2908","ENSMODG00000003943","3",393101658,393219029,117371
"2909","ENSMODG00000003944","X",56128943,56147469,18526
"2910","ENSMODG00000003945","7",77698307,77782005,83698
"2911","ENSMODG00000003946","1",384854750,384898271,43521
"2912","ENSMODG00000003947","Un",98854837,98859884,5047
"2913","ENSMODG00000003951","2",465090282,465290025,199743
"2914","ENSMODG00000003952","4",272022402,272065874,43472
"2915","ENSMODG00000003953","X",56148649,56155109,6460
"2916","ENSMODG00000003955","7",77721842,77723149,1307
"2917","ENSMODG00000003956","2",229158842,229205350,46508
"2918","ENSMODG00000003958","1",451294523,451576579,282056
"2919","ENSMODG00000003959","6",227513482,227801223,287741
"2920","ENSMODG00000003960","4",408778568,408792060,13492
"2921","ENSMODG00000003961","2",228722897,229144615,421718
"2922","ENSMODG00000003962","2",64078149,64759268,681119
"2923","ENSMODG00000003963","1",73572561,73608976,36415
"2924","ENSMODG00000003964","2",257967453,257984231,16778
"2925","ENSMODG00000003966","1",451653459,451682019,28560
"2926","ENSMODG00000003967","Un",54076825,54090783,13958
"2927","ENSMODG00000003968","7",77793419,77834590,41171
"2928","ENSMODG00000003969","1",384766588,384821452,54864
"2929","ENSMODG00000003970","1",73595132,73596035,903
"2930","ENSMODG00000003974","4",408791375,408792537,1162
"2931","ENSMODG00000003976","1",696036141,696098788,62647
"2932","ENSMODG00000003977","3",392793799,392996600,202801
"2933","ENSMODG00000003978","4",154232436,154257900,25464
"2934","ENSMODG00000003979","1",384504288,384552263,47975
"2935","ENSMODG00000003980","4",272153135,272185895,32760
"2936","ENSMODG00000003982","Un",54107946,54109442,1496
"2937","ENSMODG00000003983","6",102997550,103201575,204025
"2938","ENSMODG00000003984","4",408796172,408798029,1857
"2939","ENSMODG00000003985","X",42203468,42231856,28388
"2940","ENSMODG00000003986","2",228561666,228601968,40302
"2941","ENSMODG00000003987","4",272192433,272200320,7887
"2942","ENSMODG00000003988","7",77851587,77885271,33684
"2943","ENSMODG00000003989","1",73610779,73623430,12651
"2944","ENSMODG00000003990","6",13822158,13911761,89603
"2945","ENSMODG00000003991","6",228658374,229120665,462291
"2946","ENSMODG00000003992","3",452453682,452484954,31272
"2947","ENSMODG00000003993","2",464839005,464943180,104175
"2948","ENSMODG00000003994","3",392628352,392641230,12878
"2949","ENSMODG00000003995","5",303541966,303574784,32818
"2950","ENSMODG00000003997","2",64885783,64985694,99911
"2951","ENSMODG00000003998","6",229320999,229321858,859
"2952","ENSMODG00000003999","6",103350193,103482554,132361
"2953","ENSMODG00000004001","6",42022565,42023257,692
"2954","ENSMODG00000004003","3",392595854,392596301,447
"2955","ENSMODG00000004006","4",154291691,154454117,162426
"2956","ENSMODG00000004007","4",408798789,408801804,3015
"2957","ENSMODG00000004010","X",56160009,56272938,112929
"2958","ENSMODG00000004011","3",392418951,392453921,34970
"2959","ENSMODG00000004012","6",13781478,13813105,31627
"2960","ENSMODG00000004013","5",303632292,303651684,19392
"2961","ENSMODG00000004015","7",77901032,77934447,33415
"2962","ENSMODG00000004016","Un",54109837,54119770,9933
"2963","ENSMODG00000004017","5",231865096,232129543,264447
"2964","ENSMODG00000004018","2",65700960,65701459,499
"2965","ENSMODG00000004020","1",451693554,451705704,12150
"2966","ENSMODG00000004022","4",272587094,272739760,152666
"2967","ENSMODG00000004024","Un",54120851,54123008,2157
"2968","ENSMODG00000004026","6",13717216,13776151,58935
"2969","ENSMODG00000004027","1",618268617,618335459,66842
"2970","ENSMODG00000004028","3",452488684,452510887,22203
"2971","ENSMODG00000004029","4",408802256,408807109,4853
"2972","ENSMODG00000004030","3",392198977,392285783,86806
"2973","ENSMODG00000004031","6",13706994,13712887,5893
"2974","ENSMODG00000004032","2",65883375,65907916,24541
"2975","ENSMODG00000004033","5",232202682,232240742,38060
"2976","ENSMODG00000004034","2",228199476,228466142,266666
"2977","ENSMODG00000004035","1",618107851,618198804,90953
"2978","ENSMODG00000004036","6",103992989,104049385,56396
"2979","ENSMODG00000004037","3",392299938,392301239,1301
"2980","ENSMODG00000004038","Un",52524811,52547085,22274
"2981","ENSMODG00000004039","4",408807658,408809239,1581
"2982","ENSMODG00000004040","5",303651238,303671481,20243
"2983","ENSMODG00000004041","1",696000273,696003853,3580
"2984","ENSMODG00000004044","3",452589311,452616320,27009
"2985","ENSMODG00000004045","2",228153025,228172310,19285
"2986","ENSMODG00000004046","8",215621840,215625908,4068
"2987","ENSMODG00000004047","4",154659248,154708269,49021
"2988","ENSMODG00000004049","5",303671561,303685009,13448
"2989","ENSMODG00000004050","5",232260932,232281381,20449
"2990","ENSMODG00000004051","4",272766618,272800751,34133
"2991","ENSMODG00000004052","1",384243458,384452357,208899
"2992","ENSMODG00000004053","1",695994882,695999581,4699
"2993","ENSMODG00000004054","5",303713159,303719422,6263
"2994","ENSMODG00000004055","X",56305359,56329307,23948
"2995","ENSMODG00000004057","2",228016137,228128939,112802
"2996","ENSMODG00000004058","6",13502060,13583854,81794
"2997","ENSMODG00000004059","3",126302036,126594308,292272
"2998","ENSMODG00000004060","7",260551838,260559674,7836
"2999","ENSMODG00000004062","2",65909434,65976701,67267
"3000","ENSMODG00000004063","1",451740212,451892609,152397
"3001","ENSMODG00000004064","3",391970573,392013466,42893
"3002","ENSMODG00000004065","2",462746681,463785040,1038359
"3003","ENSMODG00000004066","4",408809475,408815836,6361
"3004","ENSMODG00000004068","3",390916720,391466677,549957
"3005","ENSMODG00000004069","1",728338497,728339975,1478
"3006","ENSMODG00000004070","2",66032178,66151586,119408
"3007","ENSMODG00000004073","5",303738957,303740287,1330
"3008","ENSMODG00000004074","5",232281814,232742134,460320
"3009","ENSMODG00000004075","4",272864272,272880012,15740
"3010","ENSMODG00000004076","8",215621807,215637404,15597
"3011","ENSMODG00000004077","X",56333175,56339576,6401
"3012","ENSMODG00000004078","6",13319088,13355200,36112
"3013","ENSMODG00000004080","5",304446566,304452215,5649
"3014","ENSMODG00000004083","3",452623613,452636071,12458
"3015","ENSMODG00000004084","5",232531132,232532015,883
"3016","ENSMODG00000004085","5",304470846,304475007,4161
"3017","ENSMODG00000004086","Un",77273196,77275631,2435
"3018","ENSMODG00000004087","4",323426330,323803585,377255
"3019","ENSMODG00000004088","5",232759958,232825711,65753
"3020","ENSMODG00000004090","1",337860711,337861422,711
"3021","ENSMODG00000004091","2",257955789,257964569,8780
"3022","ENSMODG00000004092","3",390465393,390799986,334593
"3023","ENSMODG00000004093","5",304488292,304493252,4960
"3024","ENSMODG00000004095","6",13285449,13293174,7725
"3025","ENSMODG00000004096","7",77948402,78139407,191005
"3026","ENSMODG00000004098","4",408818347,408821993,3646
"3027","ENSMODG00000004099","1",73696290,73720295,24005
"3028","ENSMODG00000004100","4",272886007,272922701,36694
"3029","ENSMODG00000004101","2",257888326,257889270,944
"3030","ENSMODG00000004102","4",323908474,323912994,4520
"3031","ENSMODG00000004103","3",389937687,390007090,69403
"3032","ENSMODG00000004105","3",452679499,452721741,42242
"3033","ENSMODG00000004106","4",400583646,400638220,54574
"3034","ENSMODG00000004107","5",82923090,83358371,435281
"3035","ENSMODG00000004108","5",304546701,304552997,6296
"3036","ENSMODG00000004109","3",389169712,389170058,346
"3037","ENSMODG00000004110","5",232863478,232941331,77853
"3038","ENSMODG00000004113","2",124759197,125854639,1095442
"3039","ENSMODG00000004114","5",304437902,304612433,174531
"3040","ENSMODG00000004115","4",408827514,408830206,2692
"3041","ENSMODG00000004116","3",452758939,452784801,25862
"3042","ENSMODG00000004118","4",408830310,408831184,874
"3043","ENSMODG00000004119","1",384157462,384193537,36075
"3044","ENSMODG00000004120","4",400451300,400452298,998
"3045","ENSMODG00000004122","1",695762136,695805739,43603
"3046","ENSMODG00000004124","5",82766183,82807673,41490
"3047","ENSMODG00000004125","3",452836342,452861886,25544
"3048","ENSMODG00000004126","8",27937982,27943102,5120
"3049","ENSMODG00000004127","3",511386434,511391303,4869
"3050","ENSMODG00000004129","6",43587432,43659202,71770
"3051","ENSMODG00000004130","2",66154429,66226817,72388
"3052","ENSMODG00000004131","1",384126986,384150184,23198
"3053","ENSMODG00000004132","3",452881250,452885728,4478
"3054","ENSMODG00000004133","3",389108452,389134543,26091
"3055","ENSMODG00000004135","4",272935874,272947295,11421
"3056","ENSMODG00000004137","4",406131561,406141364,9803
"3057","ENSMODG00000004138","4",155116864,155311228,194364
"3058","ENSMODG00000004139","1",383623008,383636620,13612
"3059","ENSMODG00000004140","3",389015208,389022524,7316
"3060","ENSMODG00000004142","X",56402358,56469221,66863
"3061","ENSMODG00000004143","3",452929838,453030047,100209
"3062","ENSMODG00000004145","2",257841788,257856937,15149
"3063","ENSMODG00000004147","2",227148425,227726915,578490
"3064","ENSMODG00000004148","2",66233965,66260903,26938
"3065","ENSMODG00000004149","3",453302265,453350761,48496
"3066","ENSMODG00000004151","1",695739630,695761231,21601
"3067","ENSMODG00000004153","6",230513452,230598367,84915
"3068","ENSMODG00000004154","3",388874747,389001157,126410
"3069","ENSMODG00000004155","6",43662143,43694719,32576
"3070","ENSMODG00000004158","4",324197870,324506191,308321
"3071","ENSMODG00000004159","2",257748746,257762525,13779
"3072","ENSMODG00000004160","1",695718659,695739321,20662
"3073","ENSMODG00000004162","5",232962367,233039434,77067
"3074","ENSMODG00000004163","2",125938382,126162826,224444
"3075","ENSMODG00000004164","1",452399644,452624914,225270
"3076","ENSMODG00000004165","1",695666066,695675186,9120
"3077","ENSMODG00000004166","6",13202228,13284545,82317
"3078","ENSMODG00000004168","4",406160160,406167324,7164
"3079","ENSMODG00000004169","2",226998587,227019905,21318
"3080","ENSMODG00000004170","2",257691515,257694330,2815
"3081","ENSMODG00000004171","5",82380057,82633491,253434
"3082","ENSMODG00000004172","1",383658154,383770775,112621
"3083","ENSMODG00000004173","8",35700724,35711559,10835
"3084","ENSMODG00000004174","1",564871437,564872130,693
"3085","ENSMODG00000004175","6",13030039,13030699,660
"3086","ENSMODG00000004176","4",237281928,237282874,946
"3087","ENSMODG00000004177","1",73721498,73727007,5509
"3088","ENSMODG00000004179","4",155317172,155375520,58348
"3089","ENSMODG00000004180","3",130297914,130298998,1084
"3090","ENSMODG00000004181","3",387289257,387584908,295651
"3091","ENSMODG00000004182","3",511412613,511474470,61857
"3092","ENSMODG00000004183","4",324531152,324657413,126261
"3093","ENSMODG00000004184","5",233256857,233259299,2442
"3094","ENSMODG00000004186","4",155376605,155450164,73559
"3095","ENSMODG00000004188","2",66271138,66305764,34626
"3096","ENSMODG00000004189","1",695607849,695623070,15221
"3097","ENSMODG00000004190","8",27952670,27957240,4570
"3098","ENSMODG00000004191","7",78386657,78633175,246518
"3099","ENSMODG00000004192","5",82150461,82156148,5687
"3100","ENSMODG00000004194","6",104068987,104236668,167681
"3101","ENSMODG00000004195","2",127004531,127293357,288826
"3102","ENSMODG00000004196","X",56476655,56509301,32646
"3103","ENSMODG00000004198","6",231649337,232144313,494976
"3104","ENSMODG00000004199","8",27975180,27987095,11915
"3105","ENSMODG00000004200","5",82092157,82101519,9362
"3106","ENSMODG00000004202","2",66352668,66366965,14297
"3107","ENSMODG00000004204","6",104254534,104263706,9172
"3108","ENSMODG00000004205","6",232100692,232101515,823
"3109","ENSMODG00000004206","8",28091257,28091771,514
"3110","ENSMODG00000004207","X",56516128,56517150,1022
"3111","ENSMODG00000004209","3",453362491,453432046,69555
"3112","ENSMODG00000004211","2",462205572,462346025,140453
"3113","ENSMODG00000004213","1",73731045,73737680,6635
"3114","ENSMODG00000004214","X",57022721,57023767,1046
"3115","ENSMODG00000004216","8",28026361,28149007,122646
"3116","ENSMODG00000004217","1",383560865,383620596,59731
"3117","ENSMODG00000004220","1",695585637,695595855,10218
"3118","ENSMODG00000004222","4",274004729,274027220,22491
"3119","ENSMODG00000004223","5",81895896,81913753,17857
"3120","ENSMODG00000004225","8",215643434,215665054,21620
"3121","ENSMODG00000004227","4",157428797,157866658,437861
"3122","ENSMODG00000004228","2",66321631,66334103,12472
"3123","ENSMODG00000004229","2",257681213,257690984,9771
"3124","ENSMODG00000004230","1",695575447,695577476,2029
"3125","ENSMODG00000004231","1",383543917,383546375,2458
"3126","ENSMODG00000004232","4",274024307,274025416,1109
"3127","ENSMODG00000004233","X",57185877,57205670,19793
"3128","ENSMODG00000004236","6",43709535,43816670,107135
"3129","ENSMODG00000004237","3",131015064,131271489,256425
"3130","ENSMODG00000004238","4",158403427,158424273,20846
"3131","ENSMODG00000004240","7",78912936,79053604,140668
"3132","ENSMODG00000004241","X",57342900,57355937,13037
"3133","ENSMODG00000004242","1",73738477,73750431,11954
"3134","ENSMODG00000004243","8",215665716,215668403,2687
"3135","ENSMODG00000004244","1",172948416,172961945,13529
"3136","ENSMODG00000004246","6",43732288,43748204,15916
"3137","ENSMODG00000004247","2",127293011,127724770,431759
"3138","ENSMODG00000004248","8",28249500,28262733,13233
"3139","ENSMODG00000004250","5",233147794,233216361,68567
"3140","ENSMODG00000004251","1",695471222,695556774,85552
"3141","ENSMODG00000004252","3",511543052,511588375,45323
"3142","ENSMODG00000004253","4",324675405,324710449,35044
"3143","ENSMODG00000004255","X",57626561,57640250,13689
"3144","ENSMODG00000004257","1",172899407,172908686,9279
"3145","ENSMODG00000004259","1",695262329,695280858,18529
"3146","ENSMODG00000004260","2",226237976,226284383,46407
"3147","ENSMODG00000004263","1",383510206,383541291,31085
"3148","ENSMODG00000004264","2",257673247,257680752,7505
"3149","ENSMODG00000004267","7",79613001,79614182,1181
"3150","ENSMODG00000004268","5",233265777,233299344,33567
"3151","ENSMODG00000004269","6",43858372,43985014,126642
"3152","ENSMODG00000004271","3",432445158,432485550,40392
"3153","ENSMODG00000004273","X",57744531,57773816,29285
"3154","ENSMODG00000004274","1",383399293,383415169,15876
"3155","ENSMODG00000004275","4",274030208,274068605,38397
"3156","ENSMODG00000004276","2",128216500,128217143,643
"3157","ENSMODG00000004277","8",28481007,28488645,7638
"3158","ENSMODG00000004278","2",460406420,460438967,32547
"3159","ENSMODG00000004279","7",80725800,80727996,2196
"3160","ENSMODG00000004280","4",406237359,406255200,17841
"3161","ENSMODG00000004282","8",28555098,28561993,6895
"3162","ENSMODG00000004283","3",432217514,432221304,3790
"3163","ENSMODG00000004284","5",234000763,234061323,60560
"3164","ENSMODG00000004285","2",460311489,460365034,53545
"3165","ENSMODG00000004286","2",257667154,257676869,9715
"3166","ENSMODG00000004287","4",406261274,406277778,16504
"3167","ENSMODG00000004288","2",128303954,128350546,46592
"3168","ENSMODG00000004289","2",66399777,66448610,48833
"3169","ENSMODG00000004290","5",234069711,234095209,25498
"3170","ENSMODG00000004291","2",460141526,460226572,85046
"3171","ENSMODG00000004292","5",81818830,81896054,77224
"3172","ENSMODG00000004294","6",44094038,44341359,247321
"3173","ENSMODG00000004295","X",5272421,5285737,13316
"3174","ENSMODG00000004296","2",257647214,257656571,9357
"3175","ENSMODG00000004297","4",325019758,325136552,116794
"3176","ENSMODG00000004298","4",160865620,160874858,9238
"3177","ENSMODG00000004300","8",28576946,28634995,58049
"3178","ENSMODG00000004302","2",257584705,257593539,8834
"3179","ENSMODG00000004303","3",511607099,511652513,45414
"3180","ENSMODG00000004304","5",234116146,234131125,14979
"3181","ENSMODG00000004305","6",43986637,44026704,40067
"3182","ENSMODG00000004306","3",432002681,432020350,17669
"3183","ENSMODG00000004307","2",128366917,128467995,101078
"3184","ENSMODG00000004308","X",58349561,58470922,121361
"3185","ENSMODG00000004309","6",44332661,44333269,608
"3186","ENSMODG00000004310","5",81427794,81497225,69431
"3187","ENSMODG00000004311","4",325166513,325232397,65884
"3188","ENSMODG00000004312","4",406308823,406330332,21509
"3189","ENSMODG00000004313","5",234300009,234383190,83181
"3190","ENSMODG00000004315","1",73801482,73833419,31937
"3191","ENSMODG00000004318","2",129357207,129404006,46799
"3192","ENSMODG00000004320","3",460598500,460619029,20529
"3193","ENSMODG00000004322","X",58764660,58848115,83455
"3194","ENSMODG00000004323","6",233743121,234376087,632966
"3195","ENSMODG00000004326","2",460037925,460078280,40355
"3196","ENSMODG00000004328","6",44390103,44436109,46006
"3197","ENSMODG00000004329","2",130260135,130275446,15311
"3198","ENSMODG00000004331","4",404235151,404270004,34853
"3199","ENSMODG00000004332","2",225778931,225952961,174030
"3200","ENSMODG00000004336","5",235148824,235267700,118876
"3201","ENSMODG00000004337","1",383389433,383395766,6333
"3202","ENSMODG00000004338","4",404243555,404244358,803
"3203","ENSMODG00000004339","5",81143727,81306566,162839
"3204","ENSMODG00000004340","8",28819996,28855939,35943
"3205","ENSMODG00000004341","6",47329308,47331089,1781
"3206","ENSMODG00000004343","4",161052063,161197894,145831
"3207","ENSMODG00000004345","8",215673461,215751855,78394
"3208","ENSMODG00000004347","Un",58659749,58668881,9132
"3209","ENSMODG00000004349","4",406436062,406442196,6134
"3210","ENSMODG00000004350","1",693896186,694115663,219477
"3211","ENSMODG00000004351","6",234384929,234422411,37482
"3212","ENSMODG00000004352","2",225662738,225714401,51663
"3213","ENSMODG00000004354","5",235309557,235492410,182853
"3214","ENSMODG00000004355","2",257579581,257583714,4133
"3215","ENSMODG00000004356","8",215754630,215778702,24072
"3216","ENSMODG00000004357","4",408032169,408038933,6764
"3217","ENSMODG00000004358","1",452651625,452655279,3654
"3218","ENSMODG00000004359","4",325393547,325436447,42900
"3219","ENSMODG00000004360","6",104273189,104409252,136063
"3220","ENSMODG00000004361","2",66648999,67313052,664053
"3221","ENSMODG00000004362","3",511664436,511712642,48206
"3222","ENSMODG00000004363","Un",64993157,64994239,1082
"3223","ENSMODG00000004364","1",73971634,74032440,60806
"3224","ENSMODG00000004365","X",66656376,66688968,32592
"3225","ENSMODG00000004366","8",29024875,29081268,56393
"3226","ENSMODG00000004367","8",215787326,215802621,15295
"3227","ENSMODG00000004368","6",234445969,234466507,20538
"3228","ENSMODG00000004370","4",325448501,325449517,1016
"3229","ENSMODG00000004371","4",162009337,162078640,69303
"3230","ENSMODG00000004372","3",431868982,431904294,35312
"3231","ENSMODG00000004373","Un",79388400,79388687,287
"3232","ENSMODG00000004374","1",693776100,693836235,60135
"3233","ENSMODG00000004375","2",257571098,257579642,8544
"3234","ENSMODG00000004376","2",225539563,225574704,35141
"3235","ENSMODG00000004377","4",325476682,325478029,1347
"3236","ENSMODG00000004378","4",162087391,162095392,8001
"3237","ENSMODG00000004379","8",215805339,215813626,8287
"3238","ENSMODG00000004380","5",235979138,236059269,80131
"3239","ENSMODG00000004381","X",70030502,70049049,18547
"3240","ENSMODG00000004383","2",67297593,67339448,41855
"3241","ENSMODG00000004384","4",325484424,325510065,25641
"3242","ENSMODG00000004385","6",104409614,104443321,33707
"3243","ENSMODG00000004386","1",383377474,383386845,9371
"3244","ENSMODG00000004387","X",69960827,70012205,51378
"3245","ENSMODG00000004388","3",511740134,511762724,22590
"3246","ENSMODG00000004389","4",162171401,162211252,39851
"3247","ENSMODG00000004390","2",67341427,67345440,4013
"3248","ENSMODG00000004391","3",431814417,431854142,39725
"3249","ENSMODG00000004392","1",452663209,452671823,8614
"3250","ENSMODG00000004393","5",80844869,80986375,141506
"3251","ENSMODG00000004394","5",236235506,236250937,15431
"3252","ENSMODG00000004395","3",453506881,453560232,53351
"3253","ENSMODG00000004396","3",431797847,431808837,10990
"3254","ENSMODG00000004397","3",511793490,511808615,15125
"3255","ENSMODG00000004398","2",130326932,130392102,65170
"3256","ENSMODG00000004402","1",452713917,452729120,15203
"3257","ENSMODG00000004403","6",234471326,234509787,38461
"3258","ENSMODG00000004404","2",225381685,225521465,139780
"3259","ENSMODG00000004407","1",693697339,693746192,48853
"3260","ENSMODG00000004410","4",133802440,133803538,1098
"3261","ENSMODG00000004411","4",162293492,162395454,101962
"3262","ENSMODG00000004412","2",257561179,257570148,8969
"3263","ENSMODG00000004413","1",383341058,383371534,30476
"3264","ENSMODG00000004414","2",130395001,130433070,38069
"3265","ENSMODG00000004415","1",616837970,617171893,333923
"3266","ENSMODG00000004416","1",452740141,452766148,26007
"3267","ENSMODG00000004418","2",225332143,225380138,47995
"3268","ENSMODG00000004419","X",69984728,69997616,12888
"3269","ENSMODG00000004420","8",215837570,215853903,16333
"3270","ENSMODG00000004421","3",453677165,453689982,12817
"3271","ENSMODG00000004422","1",172769650,172864562,94912
"3272","ENSMODG00000004423","6",104464409,104511632,47223
"3273","ENSMODG00000004425","5",236840719,236851631,10912
"3274","ENSMODG00000004426","3",453714130,453736800,22670
"3275","ENSMODG00000004427","1",693454026,693552672,98646
"3276","ENSMODG00000004428","1",172758391,172761289,2898
"3277","ENSMODG00000004429","8",215880032,215884902,4870
"3278","ENSMODG00000004430","3",431777086,431796067,18981
"3279","ENSMODG00000004431","4",162539485,162689401,149916
"3280","ENSMODG00000004432","1",172750148,172752563,2415
"3281","ENSMODG00000004433","5",236693571,236815507,121936
"3282","ENSMODG00000004435","2",459927863,460029103,101240
"3283","ENSMODG00000004436","4",328041790,328255740,213950
"3284","ENSMODG00000004437","6",235992324,235998806,6482
"3285","ENSMODG00000004438","1",693235743,693436052,200309
"3286","ENSMODG00000004440","2",257528017,257558795,30778
"3287","ENSMODG00000004441","3",431749689,431772639,22950
"3288","ENSMODG00000004442","6",236023596,236140115,116519
"3289","ENSMODG00000004443","4",326939825,326940340,515
"3290","ENSMODG00000004444","1",452779720,452799100,19380
"3291","ENSMODG00000004445","X",69964961,69971746,6785
"3292","ENSMODG00000004446","2",67404787,67475817,71030
"3293","ENSMODG00000004449","4",163018641,163070439,51798
"3294","ENSMODG00000004450","6",104526234,104669383,143149
"3295","ENSMODG00000004451","8",215885338,216061281,175943
"3296","ENSMODG00000004452","2",225168544,225185434,16890
"3297","ENSMODG00000004453","3",431760837,431766190,5353
"3298","ENSMODG00000004455","5",236886027,236921768,35741
"3299","ENSMODG00000004456","4",328534997,328557715,22718
"3300","ENSMODG00000004457","2",257454693,257458500,3807
"3301","ENSMODG00000004459","3",431666783,431752536,85753
"3302","ENSMODG00000004460","4",163124289,163470427,346138
"3303","ENSMODG00000004462","3",453840845,453872324,31479
"3304","ENSMODG00000004463","6",50823224,50884670,61446
"3305","ENSMODG00000004464","X",69958744,69963524,4780
"3306","ENSMODG00000004465","2",225079990,225162488,82498
"3307","ENSMODG00000004466","3",431664160,431665649,1489
"3308","ENSMODG00000004467","2",130432360,130504238,71878
"3309","ENSMODG00000004468","2",257380008,257383618,3610
"3310","ENSMODG00000004471","3",511840870,511902091,61221
"3311","ENSMODG00000004472","2",459546393,459562620,16227
"3312","ENSMODG00000004473","5",80718012,80731862,13850
"3313","ENSMODG00000004474","2",224802788,224929347,126559
"3314","ENSMODG00000004475","3",453949251,453980140,30889
"3315","ENSMODG00000004476","8",215997670,216038506,40836
"3316","ENSMODG00000004477","4",328561577,328696900,135323
"3317","ENSMODG00000004479","4",163690033,163766377,76344
"3318","ENSMODG00000004481","7",80877809,81262353,384544
"3319","ENSMODG00000004482","5",236931234,237041336,110102
"3320","ENSMODG00000004483","1",383269435,383286889,17454
"3321","ENSMODG00000004484","3",511923106,511924482,1376
"3322","ENSMODG00000004485","4",163960406,164000803,40397
"3323","ENSMODG00000004486","6",104725269,104737360,12091
"3324","ENSMODG00000004487","4",164069816,164070497,681
"3325","ENSMODG00000004488","1",692925889,692938320,12431
"3326","ENSMODG00000004489","3",382566197,384232901,1666704
"3327","ENSMODG00000004490","2",257193130,257388654,195524
"3328","ENSMODG00000004491","4",164135084,164429309,294225
"3329","ENSMODG00000004492","1",74062268,74312009,249741
"3330","ENSMODG00000004493","1",692909573,692918688,9115
"3331","ENSMODG00000004494","3",512185079,512214602,29523
"3332","ENSMODG00000004495","6",236224195,236610337,386142
"3333","ENSMODG00000004496","1",172722516,172726870,4354
"3334","ENSMODG00000004497","2",459383624,459513232,129608
"3335","ENSMODG00000004498","4",328701394,328734637,33243
"3336","ENSMODG00000004499","4",274135932,274237151,101219
"3337","ENSMODG00000004500","3",335187466,335188131,665
"3338","ENSMODG00000004501","7",81435879,81480943,45064
"3339","ENSMODG00000004502","5",80667489,80692890,25401
"3340","ENSMODG00000004503","2",257365348,257372942,7594
"3341","ENSMODG00000004504","3",512213850,512238406,24556
"3342","ENSMODG00000004506","4",328911879,328942073,30194
"3343","ENSMODG00000004507","4",274415517,274416280,763
"3344","ENSMODG00000004508","2",130506276,130674188,167912
"3345","ENSMODG00000004509","1",692834683,692884095,49412
"3346","ENSMODG00000004511","3",380607860,380617919,10059
"3347","ENSMODG00000004513","4",328954330,328991657,37327
"3348","ENSMODG00000004515","2",257246804,257307735,60931
"3349","ENSMODG00000004516","6",236720189,236728332,8143
"3350","ENSMODG00000004518","7",81773448,81781471,8023
"3351","ENSMODG00000004520","1",691609804,691611129,1325
"3352","ENSMODG00000004521","4",274441979,274460432,18453
"3353","ENSMODG00000004523","1",383230858,383247849,16991
"3354","ENSMODG00000004526","5",80641372,80668282,26910
"3355","ENSMODG00000004527","3",454082892,454155484,72592
"3356","ENSMODG00000004528","1",172712808,172721814,9006
"3357","ENSMODG00000004529","1",691595735,691597252,1517
"3358","ENSMODG00000004530","6",236886105,236926414,40309
"3359","ENSMODG00000004531","1",74359153,74446538,87385
"3360","ENSMODG00000004533","3",461097353,461151859,54506
"3361","ENSMODG00000004534","7",81787369,81885443,98074
"3362","ENSMODG00000004535","1",172705010,172710212,5202
"3363","ENSMODG00000004536","5",80594302,80636809,42507
"3364","ENSMODG00000004537","1",691515935,691581468,65533
"3365","ENSMODG00000004538","3",454166020,454252378,86358
"3366","ENSMODG00000004539","1",172696989,172699144,2155
"3367","ENSMODG00000004541","4",329002030,329081122,79092
"3368","ENSMODG00000004542","1",691481736,691484729,2993
"3369","ENSMODG00000004543","1",172692509,172693677,1168
"3370","ENSMODG00000004544","2",459125274,459182710,57436
"3371","ENSMODG00000004545","8",216039282,216104697,65415
"3372","ENSMODG00000004546","4",329177738,329178877,1139
"3373","ENSMODG00000004547","2",257220813,257230422,9609
"3374","ENSMODG00000004548","1",452867500,452947452,79952
"3375","ENSMODG00000004550","4",274459268,274541922,82654
"3376","ENSMODG00000004552","4",404320525,404335485,14960
"3377","ENSMODG00000004553","3",512260502,512307645,47143
"3378","ENSMODG00000004554","1",240270088,240782347,512259
"3379","ENSMODG00000004555","8",216132289,216149942,17653
"3380","ENSMODG00000004556","6",236934394,236973884,39490
"3381","ENSMODG00000004557","Un",65003579,65006694,3115
"3382","ENSMODG00000004558","1",172588303,172671599,83296
"3383","ENSMODG00000004559","7",81896917,81970595,73678
"3384","ENSMODG00000004560","1",452948009,452969001,20992
"3385","ENSMODG00000004561","3",454310605,454332559,21954
"3386","ENSMODG00000004562","7",82081048,82123933,42885
"3387","ENSMODG00000004563","6",104770929,104844903,73974
"3388","ENSMODG00000004565","2",257203499,257219859,16360
"3389","ENSMODG00000004568","6",104848022,104863507,15485
"3390","ENSMODG00000004569","3",454404193,454450683,46490
"3391","ENSMODG00000004570","X",69906533,69944388,37855
"3392","ENSMODG00000004571","1",452986336,452993410,7074
"3393","ENSMODG00000004572","1",690463874,690489694,25820
"3394","ENSMODG00000004575","5",237091307,237321526,230219
"3395","ENSMODG00000004576","4",274539339,274550290,10951
"3396","ENSMODG00000004578","2",485732581,485777764,45183
"3397","ENSMODG00000004579","1",172472856,172572767,99911
"3398","ENSMODG00000004581","2",257166129,257183141,17012
"3399","ENSMODG00000004582","5",237329752,237336831,7079
"3400","ENSMODG00000004585","6",51008813,51020364,11551
"3401","ENSMODG00000004586","1",172418661,172421043,2382
"3402","ENSMODG00000004588","Un",7888584,7907561,18977
"3403","ENSMODG00000004589","1",452994861,453043047,48186
"3404","ENSMODG00000004590","2",485797336,485802806,5470
"3405","ENSMODG00000004591","1",690322491,690329786,7295
"3406","ENSMODG00000004592","6",239156695,239193942,37247
"3407","ENSMODG00000004594","1",74593359,74735365,142006
"3408","ENSMODG00000004595","4",274549652,274556491,6839
"3409","ENSMODG00000004596","1",690301600,690319172,17572
"3410","ENSMODG00000004597","6",104869035,104903695,34660
"3411","ENSMODG00000004598","2",257155199,257164135,8936
"3412","ENSMODG00000004599","1",690157996,690162273,4277
"3413","ENSMODG00000004601","4",274560807,274568048,7241
"3414","ENSMODG00000004602","1",383180338,383201183,20845
"3415","ENSMODG00000004603","3",501342542,501348067,5525
"3416","ENSMODG00000004604","1",690129871,690137246,7375
"3417","ENSMODG00000004605","6",239357111,240229870,872759
"3418","ENSMODG00000004606","1",74771062,74771598,536
"3419","ENSMODG00000004607","1",172391853,172393716,1863
"3420","ENSMODG00000004608","6",51333350,51458591,125241
"3421","ENSMODG00000004609","1",383152394,383153544,1150
"3422","ENSMODG00000004610","2",257132680,257135787,3107
"3423","ENSMODG00000004611","1",172388119,172388532,413
"3424","ENSMODG00000004613","1",453045166,453156172,111006
"3425","ENSMODG00000004614","8",216200631,216775563,574932
"3426","ENSMODG00000004615","X",69875662,69902060,26398
"3427","ENSMODG00000004617","4",274582993,274630915,47922
"3428","ENSMODG00000004619","3",512335134,512394157,59023
"3429","ENSMODG00000004620","5",80494543,80562299,67756
"3430","ENSMODG00000004621","1",690057580,690122502,64922
"3431","ENSMODG00000004622","2",130973779,131137666,163887
"3432","ENSMODG00000004625","6",104993020,105012705,19685
"3433","ENSMODG00000004627","1",74790535,74863110,72575
"3434","ENSMODG00000004628","5",80229289,80233348,4059
"3435","ENSMODG00000004629","2",131142879,131166561,23682
"3436","ENSMODG00000004631","3",454479262,454649034,169772
"3437","ENSMODG00000004632","7",82134533,82420142,285609
"3438","ENSMODG00000004633","1",383136641,383152005,15364
"3439","ENSMODG00000004634","1",689058769,689078260,19491
"3440","ENSMODG00000004636","1",453197404,453286295,88891
"3441","ENSMODG00000004637","X",69826431,69827496,1065
"3442","ENSMODG00000004639","5",80101374,80109099,7725
"3443","ENSMODG00000004641","1",689005147,689031733,26586
"3444","ENSMODG00000004643","X",70964146,70989910,25764
"3445","ENSMODG00000004644","2",131212416,131243901,31485
"3446","ENSMODG00000004646","1",688856734,688879225,22491
"3447","ENSMODG00000004647","5",80063970,80111690,47720
"3448","ENSMODG00000004648","1",74960955,75046851,85896
"3449","ENSMODG00000004649","5",237365717,237400296,34579
"3450","ENSMODG00000004650","X",70783632,70943205,159573
"3451","ENSMODG00000004651","6",241165020,241253265,88245
"3452","ENSMODG00000004657","4",274700549,274706049,5500
"3453","ENSMODG00000004658","1",75084311,75119901,35590
"3454","ENSMODG00000004659","6",241353540,241401440,47900
"3455","ENSMODG00000004660","2",257121905,257130634,8729
"3456","ENSMODG00000004661","5",237426247,237439859,13612
"3457","ENSMODG00000004662","3",454809669,454894538,84869
"3458","ENSMODG00000004664","2",131394676,131403899,9223
"3459","ENSMODG00000004665","1",688800435,688808523,8088
"3460","ENSMODG00000004666","6",241522852,241550779,27927
"3461","ENSMODG00000004667","4",333918258,334574084,655826
"3462","ENSMODG00000004668","2",257012063,257015899,3836
"3463","ENSMODG00000004669","1",383075148,383100453,25305
"3464","ENSMODG00000004671","3",454905285,454919442,14157
"3465","ENSMODG00000004672","2",132435786,132482174,46388
"3466","ENSMODG00000004673","6",241553358,241589304,35946
"3467","ENSMODG00000004674","1",383063141,383067391,4250
"3468","ENSMODG00000004676","4",274721684,274924239,202555
"3469","ENSMODG00000004677","3",431653792,431660701,6909
"3470","ENSMODG00000004678","5",237504355,237523135,18780
"3471","ENSMODG00000004679","6",241720576,241859717,139141
"3472","ENSMODG00000004680","6",51503788,51540048,36260
"3473","ENSMODG00000004681","3",454931229,454946305,15076
"3474","ENSMODG00000004683","3",136871713,136872306,593
"3475","ENSMODG00000004684","5",79785849,79971938,186089
"3476","ENSMODG00000004685","2",485803749,485842918,39169
"3477","ENSMODG00000004686","X",70756383,70774347,17964
"3478","ENSMODG00000004687","6",51513449,51515124,1675
"3479","ENSMODG00000004691","6",72779708,72851467,71759
"3480","ENSMODG00000004692","5",237537342,237654280,116938
"3481","ENSMODG00000004693","3",454952553,454956115,3562
"3482","ENSMODG00000004695","2",133484848,133517517,32669
"3483","ENSMODG00000004696","4",276698504,276699843,1339
"3484","ENSMODG00000004697","1",616130324,616295825,165501
"3485","ENSMODG00000004698","5",79734986,79783262,48276
"3486","ENSMODG00000004699","6",72872324,72879041,6717
"3487","ENSMODG00000004700","2",485874037,485893348,19311
"3488","ENSMODG00000004701","X",70714956,70725471,10515
"3489","ENSMODG00000004702","5",79624385,79730797,106412
"3490","ENSMODG00000004703","3",455037652,455043732,6080
"3491","ENSMODG00000004705","2",133519021,133554430,35409
"3492","ENSMODG00000004706","1",688563000,688633634,70634
"3493","ENSMODG00000004707","3",378237688,378238887,1199
"3494","ENSMODG00000004708","3",455089944,455092126,2182
"3495","ENSMODG00000004709","X",70691131,70700761,9630
"3496","ENSMODG00000004710","8",217044778,217161351,116573
"3497","ENSMODG00000004711","1",616066816,616093329,26513
"3498","ENSMODG00000004712","6",241890094,242169299,279205
"3499","ENSMODG00000004713","4",334669569,334849210,179641
"3500","ENSMODG00000004714","1",383047065,383055693,8628
"3501","ENSMODG00000004715","6",242269281,242286208,16927
"3502","ENSMODG00000004716","3",431634950,431652605,17655
"3503","ENSMODG00000004717","6",72892866,72921859,28993
"3504","ENSMODG00000004718","3",455113416,455140139,26723
"3505","ENSMODG00000004719","6",51562449,51614843,52394
"3506","ENSMODG00000004720","3",378116938,378130368,13430
"3507","ENSMODG00000004721","2",485940437,485961820,21383
"3508","ENSMODG00000004722","3",455203873,455212890,9017
"3509","ENSMODG00000004723","2",458763077,458949666,186589
"3510","ENSMODG00000004724","3",431588728,431612863,24135
"3511","ENSMODG00000004726","1",688418961,688457592,38631
"3512","ENSMODG00000004727","5",79696224,79728911,32687
"3513","ENSMODG00000004728","6",105052825,105094241,41416
"3514","ENSMODG00000004729","4",335037954,335130665,92711
"3515","ENSMODG00000004730","4",277871201,277954141,82940
"3516","ENSMODG00000004731","8",217167624,217221499,53875
"3517","ENSMODG00000004732","3",138232617,138429084,196467
"3518","ENSMODG00000004733","1",382997049,383018230,21181
"3519","ENSMODG00000004734","1",615934201,616050140,115939
"3520","ENSMODG00000004735","3",378016852,378019515,2663
"3521","ENSMODG00000004736","X",70671827,70678825,6998
"3522","ENSMODG00000004738","5",237654554,237657984,3430
"3523","ENSMODG00000004739","2",256964100,256978582,14482
"3524","ENSMODG00000004740","2",458598095,458627868,29773
"3525","ENSMODG00000004742","6",72945603,72986996,41393
"3526","ENSMODG00000004743","2",133586267,133648332,62065
"3527","ENSMODG00000004744","1",382916352,382924880,8528
"3528","ENSMODG00000004745","8",217242034,217500387,258353
"3529","ENSMODG00000004746","3",377687157,377788936,101779
"3530","ENSMODG00000004747","6",105224202,105860390,636188
"3531","ENSMODG00000004749","X",70664423,70665469,1046
"3532","ENSMODG00000004750","4",335140215,335192059,51844
"3533","ENSMODG00000004751","5",79645372,79696384,51012
"3534","ENSMODG00000004753","3",431521935,431566661,44726
"3535","ENSMODG00000004754","6",73001212,73023003,21791
"3536","ENSMODG00000004755","1",688351344,688356443,5099
"3537","ENSMODG00000004756","3",455213406,455259064,45658
"3538","ENSMODG00000004758","8",217380014,217501151,121137
"3539","ENSMODG00000004759","6",73151203,73174171,22968
"3540","ENSMODG00000004760","1",688237506,688298127,60621
"3541","ENSMODG00000004761","2",458571572,458588736,17164
"3542","ENSMODG00000004762","5",79604462,79623188,18726
"3543","ENSMODG00000004763","4",278239517,278400483,160966
"3544","ENSMODG00000004764","1",615378070,615420067,41997
"3545","ENSMODG00000004765","6",73174422,73176155,1733
"3546","ENSMODG00000004766","7",82421232,82622279,201047
"3547","ENSMODG00000004768","4",278471712,278472851,1139
"3548","ENSMODG00000004769","6",106170790,106394638,223848
"3549","ENSMODG00000004770","4",335311997,335357876,45879
"3550","ENSMODG00000004771","6",51640178,51656845,16667
"3551","ENSMODG00000004773","1",688068633,688087291,18658
"3552","ENSMODG00000004774","2",133654541,133700134,45593
"3553","ENSMODG00000004775","7",82561757,82562658,901
"3554","ENSMODG00000004777","2",458172499,458345082,172583
"3555","ENSMODG00000004778","6",73202945,73382775,179830
"3556","ENSMODG00000004779","6",106398538,106399266,728
"3557","ENSMODG00000004781","6",242333680,242373041,39361
"3558","ENSMODG00000004782","3",455307954,455359828,51874
"3559","ENSMODG00000004783","4",278583058,278629247,46189
"3560","ENSMODG00000004784","6",107286413,107287331,918
"3561","ENSMODG00000004785","5",237658770,237678223,19453
"3562","ENSMODG00000004790","X",70644845,70652380,7535
"3563","ENSMODG00000004791","1",382896439,382911407,14968
"3564","ENSMODG00000004794","3",455362466,455364122,1656
"3565","ENSMODG00000004795","3",377633710,377673933,40223
"3566","ENSMODG00000004796","5",79513961,79573062,59101
"3567","ENSMODG00000004797","Un",80111746,80112296,550
"3568","ENSMODG00000004798","X",70634362,70636945,2583
"3569","ENSMODG00000004799","1",615042353,615069146,26793
"3570","ENSMODG00000004800","2",485961893,486037518,75625
"3571","ENSMODG00000004802","Un",53314323,53314615,292
"3572","ENSMODG00000004803","2",133699692,133743454,43762
"3573","ENSMODG00000004804","1",382892709,382895537,2828
"3574","ENSMODG00000004807","3",138513516,138613457,99941
"3575","ENSMODG00000004809","6",51996944,52525296,528352
"3576","ENSMODG00000004813","2",256913843,256934637,20794
"3577","ENSMODG00000004814","1",382889011,382892015,3004
"3578","ENSMODG00000004815","6",52598831,52608998,10167
"3579","ENSMODG00000004817","5",237670598,237677669,7071
"3580","ENSMODG00000004819","2",134019548,134110829,91281
"3581","ENSMODG00000004820","6",108162525,108279386,116861
"3582","ENSMODG00000004821","8",79118612,79319691,201079
"3583","ENSMODG00000004822","2",458063851,458177546,113695
"3584","ENSMODG00000004823","3",138636928,138656916,19988
"3585","ENSMODG00000004824","3",455367911,455400899,32988
"3586","ENSMODG00000004825","7",83237401,83241258,3857
"3587","ENSMODG00000004826","6",52619196,52794173,174977
"3588","ENSMODG00000004827","1",687948386,688065247,116861
"3589","ENSMODG00000004828","2",486097752,486169888,72136
"3590","ENSMODG00000004829","8",79242035,79245701,3666
"3591","ENSMODG00000004830","6",242519904,242565334,45430
"3592","ENSMODG00000004831","6",52887096,52892052,4956
"3593","ENSMODG00000004832","1",687877096,687887689,10593
"3594","ENSMODG00000004834","2",256894472,256903562,9090
"3595","ENSMODG00000004835","2",457895448,457916407,20959
"3596","ENSMODG00000004837","8",30203167,30264145,60978
"3597","ENSMODG00000004839","1",75170106,75289131,119025
"3598","ENSMODG00000004840","6",108183381,108226439,43058
"3599","ENSMODG00000004842","8",79145651,79147028,1377
"3600","ENSMODG00000004843","3",455469870,455472718,2848
"3601","ENSMODG00000004844","8",29977672,29997652,19980
"3602","ENSMODG00000004845","5",79287604,79439538,151934
"3603","ENSMODG00000004846","2",486177287,486178090,803
"3604","ENSMODG00000004847","3",139620881,139622204,1323
"3605","ENSMODG00000004848","7",83548184,83549192,1008
"3606","ENSMODG00000004849","6",52999048,53186354,187306
"3607","ENSMODG00000004851","1",75298406,75302967,4561
"3608","ENSMODG00000004852","8",217978810,218105665,126855
"3609","ENSMODG00000004854","1",687691188,687726393,35205
"3610","ENSMODG00000004856","7",83784331,83945605,161274
"3611","ENSMODG00000004858","3",455667311,455668003,692
"3612","ENSMODG00000004859","4",278776822,278925920,149098
"3613","ENSMODG00000004860","1",614846465,614875497,29032
"3614","ENSMODG00000004861","5",78813318,78830160,16842
"3615","ENSMODG00000004862","2",256853209,256857231,4022
"3616","ENSMODG00000004863","2",486422668,486437033,14365
"3617","ENSMODG00000004864","X",70551414,70634189,82775
"3618","ENSMODG00000004869","1",75453789,75473572,19783
"3619","ENSMODG00000004870","1",382751253,382881884,130631
"3620","ENSMODG00000004872","2",457681726,457795855,114129
"3621","ENSMODG00000004873","4",279385667,279480492,94825
"3622","ENSMODG00000004875","3",461232582,461249375,16793
"3623","ENSMODG00000004876","7",84044936,84046941,2005
"3624","ENSMODG00000004878","3",455983126,455993475,10349
"3625","ENSMODG00000004879","5",237682231,237686079,3848
"3626","ENSMODG00000004880","6",108506809,108614494,107685
"3627","ENSMODG00000004881","5",78701706,78746440,44734
"3628","ENSMODG00000004882","2",256844692,256856035,11343
"3629","ENSMODG00000004883","2",486982925,486993845,10920
"3630","ENSMODG00000004884","1",75483844,75619782,135938
"3631","ENSMODG00000004886","7",84100385,84100942,557
"3632","ENSMODG00000004887","8",220016206,220051309,35103
"3633","ENSMODG00000004888","1",687666400,687672608,6208
"3634","ENSMODG00000004889","4",335460335,335554921,94586
"3635","ENSMODG00000004890","4",279873237,279948189,74952
"3636","ENSMODG00000004891","3",377391541,377597717,206176
"3637","ENSMODG00000004892","2",457655436,457682589,27153
"3638","ENSMODG00000004893","7",84162337,84163728,1391
"3639","ENSMODG00000004894","5",237689607,237692845,3238
"3640","ENSMODG00000004895","X",70544524,70551239,6715
"3641","ENSMODG00000004897","X",66909166,66910317,1151
"3642","ENSMODG00000004898","8",219934956,220696829,761873
"3643","ENSMODG00000004899","1",382601673,382616882,15209
"3644","ENSMODG00000004900","3",456050792,456094052,43260
"3645","ENSMODG00000004901","4",335588284,335667605,79321
"3646","ENSMODG00000004905","3",140546482,140834371,287889
"3647","ENSMODG00000004907","2",256738695,256760085,21390
"3648","ENSMODG00000004909","4",406557479,406562336,4857
"3649","ENSMODG00000004910","1",614424011,614461225,37214
"3650","ENSMODG00000004911","5",202261346,202295240,33894
"3651","ENSMODG00000004913","2",256686523,256700252,13729
"3652","ENSMODG00000004914","2",487008313,487111793,103480
"3653","ENSMODG00000004915","6",109021055,109105674,84619
"3654","ENSMODG00000004916","3",461296736,461341004,44268
"3655","ENSMODG00000004917","4",335709172,335838946,129774
"3656","ENSMODG00000004918","1",382524190,382549911,25721
"3657","ENSMODG00000004920","5",237704508,237707090,2582
"3658","ENSMODG00000004921","1",687647867,687653584,5717
"3659","ENSMODG00000004923","8",29751561,29831292,79731
"3660","ENSMODG00000004924","1",612713653,612722120,8467
"3661","ENSMODG00000004926","3",377243008,377351744,108736
"3662","ENSMODG00000004927","5",237714809,237717198,2389
"3663","ENSMODG00000004928","2",256633734,256634998,1264
"3664","ENSMODG00000004929","8",220774820,220919265,144445
"3665","ENSMODG00000004930","6",109124568,109165498,40930
"3666","ENSMODG00000004931","2",487396571,487491873,95302
"3667","ENSMODG00000004933","8",29551042,29572812,21770
"3668","ENSMODG00000004935","3",377037461,377072344,34883
"3669","ENSMODG00000004939","3",376642161,376643090,929
"3670","ENSMODG00000004940","X",66980691,67095745,115054
"3671","ENSMODG00000004944","1",687621833,687639673,17840
"3672","ENSMODG00000004946","2",256610457,256621437,10980
"3673","ENSMODG00000004947","2",487528776,487552615,23839
"3674","ENSMODG00000004949","6",109167934,109178955,11021
"3675","ENSMODG00000004950","1",687580879,687591526,10647
"3676","ENSMODG00000004951","5",237733513,237741328,7815
"3677","ENSMODG00000004952","2",256610415,256612319,1904
"3678","ENSMODG00000004954","3",376177059,376237405,60346
"3679","ENSMODG00000004955","1",382331997,382479023,147026
"3680","ENSMODG00000004956","3",141592780,141829985,237205
"3681","ENSMODG00000004957","4",164431090,164514953,83863
"3682","ENSMODG00000004958","4",280040251,280074579,34328
"3683","ENSMODG00000004959","2",134481192,134736046,254854
"3684","ENSMODG00000004960","1",612234425,612236106,1681
"3685","ENSMODG00000004961","5",237742891,237747070,4179
"3686","ENSMODG00000004962","X",70433978,70539820,105842
"3687","ENSMODG00000004964","2",134765429,134767156,1727
"3688","ENSMODG00000004965","1",75682601,75785212,102611
"3689","ENSMODG00000004966","8",78370876,78844366,473490
"3690","ENSMODG00000004968","5",237747653,237749543,1890
"3691","ENSMODG00000004969","8",220918082,220954672,36590
"3692","ENSMODG00000004971","2",457603142,457639397,36255
"3693","ENSMODG00000004972","5",78612720,78642441,29721
"3694","ENSMODG00000004973","8",78211843,78238177,26334
"3695","ENSMODG00000004974","8",221251559,221271054,19495
"3696","ENSMODG00000004975","5",237750166,237752160,1994
"3697","ENSMODG00000004976","1",75859263,75907631,48368
"3698","ENSMODG00000004977","2",256538244,256546136,7892
"3699","ENSMODG00000004978","8",221540941,221594102,53161
"3700","ENSMODG00000004979","4",280075333,280147644,72311
"3701","ENSMODG00000004981","8",221601522,221608702,7180
"3702","ENSMODG00000004982","5",237756688,237771147,14459
"3703","ENSMODG00000004984","3",444090707,444435775,345068
"3704","ENSMODG00000004985","X",70177638,70554374,376736
"3705","ENSMODG00000004986","6",109323113,109375106,51993
"3706","ENSMODG00000004987","7",84102467,84103810,1343
"3707","ENSMODG00000004988","2",457407406,457408312,906
"3708","ENSMODG00000004989","5",78560404,78609515,49111
"3709","ENSMODG00000004990","1",687493915,687546865,52950
"3710","ENSMODG00000004992","X",70080594,70086821,6227
"3711","ENSMODG00000004993","5",237771862,237776290,4428
"3712","ENSMODG00000004994","3",456139320,456191579,52259
"3713","ENSMODG00000004996","8",78101749,78184907,83158
"3714","ENSMODG00000004997","5",237776707,237779528,2821
"3715","ENSMODG00000004998","3",431441076,431477025,35949
"3716","ENSMODG00000004999","5",78336903,78337724,821
"3717","ENSMODG00000005000","1",382263884,382299361,35477
"3718","ENSMODG00000005001","4",335872926,335874146,1220
"3719","ENSMODG00000005002","1",687454078,687476642,22564
"3720","ENSMODG00000005003","2",134976177,135107050,130873
"3721","ENSMODG00000005005","4",164530974,164690425,159451
"3722","ENSMODG00000005006","8",221768130,221928706,160576
"3723","ENSMODG00000005007","6",109380906,109446916,66010
"3724","ENSMODG00000005008","1",75917719,75969141,51422
"3725","ENSMODG00000005011","3",461500422,461608998,108576
"3726","ENSMODG00000005012","7",84282200,84284186,1986
"3727","ENSMODG00000005013","5",237787589,237805774,18185
"3728","ENSMODG00000005014","6",109750498,109759305,8807
"3729","ENSMODG00000005015","1",610991272,611139488,148216
"3730","ENSMODG00000005016","2",457306197,457313552,7355
"3731","ENSMODG00000005017","2",256494594,256507947,13353
"3732","ENSMODG00000005018","5",78109677,78252929,143252
"3733","ENSMODG00000005019","3",431431988,431439121,7133
"3734","ENSMODG00000005022","1",610806643,610851358,44715
"3735","ENSMODG00000005023","8",77999850,78050495,50645
"3736","ENSMODG00000005024","2",256488672,256491387,2715
"3737","ENSMODG00000005025","4",335881959,335899658,17699
"3738","ENSMODG00000005026","X",67382988,67439810,56822
"3739","ENSMODG00000005028","8",221975806,221989105,13299
"3740","ENSMODG00000005029","3",456196122,456207666,11544
"3741","ENSMODG00000005030","2",256449842,256467976,18134
"3742","ENSMODG00000005031","2",457267816,457306350,38534
"3743","ENSMODG00000005032","4",165025015,165065032,40017
"3744","ENSMODG00000005033","4",335924485,335943145,18660
"3745","ENSMODG00000005034","2",256443250,256447278,4028
"3746","ENSMODG00000005035","2",487870774,487903929,33155
"3747","ENSMODG00000005036","6",242566753,242575274,8521
"3748","ENSMODG00000005037","X",67497722,67548590,50868
"3749","ENSMODG00000005038","1",687389845,687444848,55003
"3750","ENSMODG00000005039","3",456212932,456231335,18403
"3751","ENSMODG00000005040","4",280322961,280413196,90235
"3752","ENSMODG00000005041","3",461667394,461750004,82610
"3753","ENSMODG00000005042","X",67642858,67653581,10723
"3754","ENSMODG00000005043","2",457252719,457259107,6388
"3755","ENSMODG00000005044","1",610465996,610703483,237487
"3756","ENSMODG00000005045","2",256351817,256393325,41508
"3757","ENSMODG00000005047","X",68181815,68183023,1208
"3758","ENSMODG00000005049","1",687381753,687386401,4648
"3759","ENSMODG00000005050","3",456232413,456253403,20990
"3760","ENSMODG00000005051","2",256300915,256302554,1639
"3761","ENSMODG00000005052","1",610351282,610353908,2626
"3762","ENSMODG00000005054","X",69081155,69130842,49687
"3763","ENSMODG00000005055","1",382240469,382266245,25776
"3764","ENSMODG00000005056","7",84303470,84970290,666820
"3765","ENSMODG00000005059","3",141833311,141982540,149229
"3766","ENSMODG00000005060","X",70167797,70172658,4861
"3767","ENSMODG00000005061","3",461755544,461812696,57152
"3768","ENSMODG00000005062","3",456271493,456303828,32335
"3769","ENSMODG00000005063","2",488095858,488411316,315458
"3770","ENSMODG00000005064","4",280446054,280519800,73746
"3771","ENSMODG00000005065","6",109829471,109955841,126370
"3772","ENSMODG00000005066","1",610233507,610336753,103246
"3773","ENSMODG00000005067","7",85549834,85600204,50370
"3774","ENSMODG00000005068","3",456337535,456345544,8009
"3775","ENSMODG00000005069","3",461817021,461829059,12038
"3776","ENSMODG00000005072","3",142009607,142135218,125611
"3777","ENSMODG00000005073","8",223014539,223088706,74167
"3778","ENSMODG00000005074","2",488352599,488574953,222354
"3779","ENSMODG00000005075","8",77911339,77984585,73246
"3780","ENSMODG00000005077","1",686621945,686640810,18865
"3781","ENSMODG00000005078","4",336167324,336262582,95258
"3782","ENSMODG00000005080","4",280545418,280599288,53870
"3783","ENSMODG00000005081","8",223118243,223326411,208168
"3784","ENSMODG00000005082","1",610188052,610213967,25915
"3785","ENSMODG00000005083","1",172346707,172385989,39282
"3786","ENSMODG00000005085","6",242581416,242595411,13995
"3787","ENSMODG00000005086","1",381926174,381954813,28639
"3788","ENSMODG00000005087","3",461938235,461993007,54772
"3789","ENSMODG00000005088","X",70070756,70075766,5010
"3790","ENSMODG00000005089","2",457179789,457187287,7498
"3791","ENSMODG00000005090","4",336332920,336444513,111593
"3792","ENSMODG00000005091","1",686742551,686773679,31128
"3793","ENSMODG00000005093","8",29487504,29515416,27912
"3794","ENSMODG00000005094","2",135173699,135271725,98026
"3795","ENSMODG00000005096","2",488739000,488824742,85742
"3796","ENSMODG00000005097","1",381916138,381920730,4592
"3797","ENSMODG00000005098","X",68757522,68803131,45609
"3798","ENSMODG00000005099","6",242595524,242597645,2121
"3799","ENSMODG00000005100","5",73865986,74077275,211289
"3800","ENSMODG00000005101","3",142371822,142461920,90098
"3801","ENSMODG00000005102","1",381851050,381853419,2369
"3802","ENSMODG00000005103","2",488846872,488871233,24361
"3803","ENSMODG00000005104","8",223384344,223385286,942
"3804","ENSMODG00000005106","8",77888937,77912351,23414
"3805","ENSMODG00000005107","3",431390134,431427378,37244
"3806","ENSMODG00000005108","4",280670556,280702741,32185
"3807","ENSMODG00000005109","X",68843470,68860969,17499
"3808","ENSMODG00000005110","1",686666091,686733882,67791
"3809","ENSMODG00000005111","2",457173317,457178996,5679
"3810","ENSMODG00000005113","3",456353977,456401427,47450
"3811","ENSMODG00000005114","6",242595969,242616235,20266
"3812","ENSMODG00000005115","2",135270922,135375364,104442
"3813","ENSMODG00000005117","1",686650282,686658290,8008
"3814","ENSMODG00000005118","2",457169672,457170785,1113
"3815","ENSMODG00000005119","3",456427822,456436412,8590
"3816","ENSMODG00000005120","3",431370587,431375743,5156
"3817","ENSMODG00000005121","X",70063798,70069512,5714
"3818","ENSMODG00000005122","8",77857801,77882017,24216
"3819","ENSMODG00000005124","2",457164619,457166550,1931
"3820","ENSMODG00000005125","1",381785902,381848751,62849
"3821","ENSMODG00000005126","4",165069789,165268486,198697
"3822","ENSMODG00000005128","2",135522567,135597675,75108
"3823","ENSMODG00000005129","6",242618776,242628075,9299
"3824","ENSMODG00000005130","6",109978929,109988768,9839
"3825","ENSMODG00000005131","8",29388674,29407967,19293
"3826","ENSMODG00000005132","4",399856811,399890134,33323
"3827","ENSMODG00000005134","2",135613616,135625643,12027
"3828","ENSMODG00000005135","6",110070341,110070867,526
"3829","ENSMODG00000005136","6",242632490,242636929,4439
"3830","ENSMODG00000005137","3",431362601,431371967,9366
"3831","ENSMODG00000005139","1",686519933,686557508,37575
"3832","ENSMODG00000005140","6",110113796,110114470,674
"3833","ENSMODG00000005141","5",237878817,237913045,34228
"3834","ENSMODG00000005145","2",488938267,488996541,58274
"3835","ENSMODG00000005146","1",686428368,686429312,944
"3836","ENSMODG00000005148","2",457130304,457139736,9432
"3837","ENSMODG00000005150","1",241801245,243850237,2048992
"3838","ENSMODG00000005152","1",172335675,172344326,8651
"3839","ENSMODG00000005153","1",381734690,381740314,5624
"3840","ENSMODG00000005157","3",456440098,456486797,46699
"3841","ENSMODG00000005158","3",431354231,431359942,5711
"3842","ENSMODG00000005159","X",69195014,69232672,37658
"3843","ENSMODG00000005160","2",489001237,489012402,11165
"3844","ENSMODG00000005161","4",280733903,280771209,37306
"3845","ENSMODG00000005162","X",13186195,13195134,8939
"3846","ENSMODG00000005163","2",135676978,135778768,101790
"3847","ENSMODG00000005164","1",172312744,172320120,7376
"3848","ENSMODG00000005166","6",110295336,110544256,248920
"3849","ENSMODG00000005167","3",456521154,456536281,15127
"3850","ENSMODG00000005168","4",336447002,336631416,184414
"3851","ENSMODG00000005169","4",410656419,410658142,1723
"3852","ENSMODG00000005170","2",489036567,489094300,57733
"3853","ENSMODG00000005171","1",172265585,172278269,12684
"3854","ENSMODG00000005172","X",13208597,13383193,174596
"3855","ENSMODG00000005173","3",431345926,431350799,4873
"3856","ENSMODG00000005174","6",110738204,110754195,15991
"3857","ENSMODG00000005175","X",69257818,69269907,12089
"3858","ENSMODG00000005176","1",381641437,381720781,79344
"3859","ENSMODG00000005177","8",223435335,223465258,29923
"3860","ENSMODG00000005180","2",135813815,135834343,20528
"3861","ENSMODG00000005181","8",77729031,77830043,101012
"3862","ENSMODG00000005182","3",456540567,456559024,18457
"3863","ENSMODG00000005183","1",686366693,686369650,2957
"3864","ENSMODG00000005184","5",237925755,237931088,5333
"3865","ENSMODG00000005185","1",172205422,172253767,48345
"3866","ENSMODG00000005187","4",281413650,281477849,64199
"3867","ENSMODG00000005188","1",172196346,172197255,909
"3868","ENSMODG00000005189","4",165412791,165576270,163479
"3869","ENSMODG00000005190","1",381559624,381596150,36526
"3870","ENSMODG00000005191","8",223495585,223502365,6780
"3871","ENSMODG00000005192","2",457116591,457126832,10241
"3872","ENSMODG00000005193","2",489351179,489610084,258905
"3873","ENSMODG00000005195","X",13388019,13398414,10395
"3874","ENSMODG00000005196","3",456562665,456592391,29726
"3875","ENSMODG00000005197","1",381553136,381554375,1239
"3876","ENSMODG00000005198","4",336657693,336835597,177904
"3877","ENSMODG00000005199","X",69461976,69500843,38867
"3878","ENSMODG00000005200","1",243417176,243417637,461
"3879","ENSMODG00000005201","6",242640678,242660464,19786
"3880","ENSMODG00000005203","1",610066122,610085604,19482
"3881","ENSMODG00000005204","1",172177294,172185393,8099
"3882","ENSMODG00000005205","4",336778854,336779314,460
"3883","ENSMODG00000005206","X",13412893,13563571,150678
"3884","ENSMODG00000005207","1",244626049,244631449,5400
"3885","ENSMODG00000005208","5",237931092,237938839,7747
"3886","ENSMODG00000005209","1",610073940,610075218,1278
"3887","ENSMODG00000005210","6",242661879,242667281,5402
"3888","ENSMODG00000005212","1",172143789,172149934,6145
"3889","ENSMODG00000005213","X",13729376,13745420,16044
"3890","ENSMODG00000005214","1",381549264,381552779,3515
"3891","ENSMODG00000005215","2",490074642,490154251,79609
"3892","ENSMODG00000005216","4",336919138,337127990,208852
"3893","ENSMODG00000005217","5",68934333,69348220,413887
"3894","ENSMODG00000005218","3",142445966,142915299,469333
"3895","ENSMODG00000005219","2",256238625,256257355,18730
"3896","ENSMODG00000005220","Un",75464406,75465366,960
"3897","ENSMODG00000005221","X",13804215,13805636,1421
"3898","ENSMODG00000005222","1",609962470,610020103,57633
"3899","ENSMODG00000005223","4",337232168,337233961,1793
"3900","ENSMODG00000005225","6",242673343,242684656,11313
"3901","ENSMODG00000005227","2",135840326,135887517,47191
"3902","ENSMODG00000005228","1",244414636,244487850,73214
"3903","ENSMODG00000005229","2",457077584,457084640,7056
"3904","ENSMODG00000005232","3",375920893,375969704,48811
"3905","ENSMODG00000005233","1",172119945,172135385,15440
"3906","ENSMODG00000005234","6",110568888,110639933,71045
"3907","ENSMODG00000005235","4",165623999,165721012,97013
"3908","ENSMODG00000005236","6",242706216,242707870,1654
"3909","ENSMODG00000005237","1",381535321,381547760,12439
"3910","ENSMODG00000005238","X",69514436,69540435,25999
"3911","ENSMODG00000005239","8",223693392,223877400,184008
"3912","ENSMODG00000005240","1",76237908,76386302,148394
"3913","ENSMODG00000005241","2",256224240,256237505,13265
"3914","ENSMODG00000005242","3",143118316,143339223,220907
"3915","ENSMODG00000005243","2",490154318,490189190,34872
"3916","ENSMODG00000005246","3",375599531,375844850,245319
"3917","ENSMODG00000005247","2",457073187,457076914,3727
"3918","ENSMODG00000005248","2",136506069,136507652,1583
"3919","ENSMODG00000005249","6",110751120,110771908,20788
"3920","ENSMODG00000005250","4",165863247,166138233,274986
"3921","ENSMODG00000005251","5",68694587,68760827,66240
"3922","ENSMODG00000005252","1",244592765,244627891,35126
"3923","ENSMODG00000005254","8",224043928,224125549,81621
"3924","ENSMODG00000005255","X",69550162,69581479,31317
"3925","ENSMODG00000005256","5",237972553,238072364,99811
"3926","ENSMODG00000005257","3",456790230,456901504,111274
"3927","ENSMODG00000005258","3",143361710,143429458,67748
"3928","ENSMODG00000005259","6",110797808,110876900,79092
"3929","ENSMODG00000005262","8",224455909,224636293,180384
"3930","ENSMODG00000005263","1",244631628,244665202,33574
"3931","ENSMODG00000005265","6",242711106,242724764,13658
"3932","ENSMODG00000005266","4",337561544,337614600,53056
"3933","ENSMODG00000005267","2",457064699,457071745,7046
"3934","ENSMODG00000005270","6",111019611,111032889,13278
"3935","ENSMODG00000005272","3",438815632,439017769,202137
"3936","ENSMODG00000005273","2",256217487,256226861,9374
"3937","ENSMODG00000005274","1",381472730,381500683,27953
"3938","ENSMODG00000005275","X",69642559,69649060,6501
"3939","ENSMODG00000005276","1",686168284,686360632,192348
"3940","ENSMODG00000005277","1",609751298,609843809,92511
"3941","ENSMODG00000005278","4",337669580,337705141,35561
"3942","ENSMODG00000005279","1",172066057,172085090,19033
"3943","ENSMODG00000005282","2",457056017,457062308,6291
"3944","ENSMODG00000005283","3",374844447,375152283,307836
"3945","ENSMODG00000005284","1",171808329,172065479,257150
"3946","ENSMODG00000005285","3",143442279,143483914,41635
"3947","ENSMODG00000005286","6",111086839,111136163,49324
"3948","ENSMODG00000005287","1",244771822,244919966,148144
"3949","ENSMODG00000005288","1",609507927,609509912,1985
"3950","ENSMODG00000005289","X",69664510,69676404,11894
"3951","ENSMODG00000005290","3",456983566,457020941,37375
"3952","ENSMODG00000005293","1",76403554,76453743,50189
"3953","ENSMODG00000005295","1",686088918,686143212,54294
"3954","ENSMODG00000005296","3",143603320,143642174,38854
"3955","ENSMODG00000005297","3",374244323,374254598,10275
"3956","ENSMODG00000005298","5",238091363,238101032,9669
"3957","ENSMODG00000005299","2",256211219,256213674,2455
"3958","ENSMODG00000005300","3",457081984,457092035,10051
"3959","ENSMODG00000005301","1",244960673,244961197,524
"3960","ENSMODG00000005303","1",686071703,686073379,1676
"3961","ENSMODG00000005305","4",337898082,337998436,100354
"3962","ENSMODG00000005306","2",490190418,490468821,278403
"3963","ENSMODG00000005308","5",67617219,67752045,134826
"3964","ENSMODG00000005310","4",166954675,167046287,91612
"3965","ENSMODG00000005311","6",85197886,85198293,407
"3966","ENSMODG00000005312","3",143696103,143746283,50180
"3967","ENSMODG00000005314","3",457124504,457130389,5885
"3968","ENSMODG00000005315","4",338126266,338149484,23218
"3969","ENSMODG00000005316","6",53243933,53277621,33688
"3970","ENSMODG00000005317","5",67041670,67402351,360681
"3971","ENSMODG00000005318","3",143751664,143752635,971
"3972","ENSMODG00000005319","2",491244157,491390235,146078
"3973","ENSMODG00000005320","X",69731151,69744811,13660
"3974","ENSMODG00000005322","4",283121683,283697359,575676
"3975","ENSMODG00000005323","3",143792127,143806300,14173
"3976","ENSMODG00000005326","2",456999975,457010598,10623
"3977","ENSMODG00000005327","1",381434552,381470166,35614
"3978","ENSMODG00000005328","6",242725226,242744017,18791
"3979","ENSMODG00000005329","1",171994298,172023547,29249
"3980","ENSMODG00000005330","2",256176362,256211149,34787
"3981","ENSMODG00000005331","4",283762713,284226533,463820
"3982","ENSMODG00000005334","2",491440510,491517248,76738
"3983","ENSMODG00000005335","1",685997034,686011772,14738
"3984","ENSMODG00000005337","4",167209334,167309618,100284
"3985","ENSMODG00000005339","1",381394681,381405301,10620
"3986","ENSMODG00000005341","X",69747721,69758428,10707
"3987","ENSMODG00000005342","3",457147963,457163220,15257
"3988","ENSMODG00000005343","3",373729773,374233749,503976
"3989","ENSMODG00000005344","4",285841902,285849642,7740
"3990","ENSMODG00000005345","1",608091521,608091972,451
"3991","ENSMODG00000005346","2",456998319,457001012,2693
"3992","ENSMODG00000005347","1",171991833,171997477,5644
"3993","ENSMODG00000005348","X",69811259,69812542,1283
"3994","ENSMODG00000005349","5",238227018,238236330,9312
"3995","ENSMODG00000005350","Un",70978385,70978787,402
"3996","ENSMODG00000005351","1",381304032,381315953,11921
"3997","ENSMODG00000005353","4",167313192,167322292,9100
"3998","ENSMODG00000005355","6",242746101,242749502,3401
"3999","ENSMODG00000005356","3",457167152,457330740,163588
"4000","ENSMODG00000005358","2",256202761,256205409,2648
"4001","ENSMODG00000005359","3",372495221,373067351,572130
"4002","ENSMODG00000005360","2",456987200,456998161,10961
"4003","ENSMODG00000005361","1",76489213,76508342,19129
"4004","ENSMODG00000005362","8",14482427,14489049,6622
"4005","ENSMODG00000005363","6",111559585,112072444,512859
"4006","ENSMODG00000005364","4",285874947,285936790,61843
"4007","ENSMODG00000005365","2",256196989,256198923,1934
"4008","ENSMODG00000005367","2",456987390,456994024,6634
"4009","ENSMODG00000005370","4",399439112,399461809,22697
"4010","ENSMODG00000005371","6",242787154,242807024,19870
"4011","ENSMODG00000005373","1",381138006,381156111,18105
"4012","ENSMODG00000005374","1",76528583,76553024,24441
"4013","ENSMODG00000005375","1",606835578,607055211,219633
"4014","ENSMODG00000005376","1",244968561,244977545,8984
"4015","ENSMODG00000005378","6",113478157,113512948,34791
"4016","ENSMODG00000005379","8",14516405,14555493,39088
"4017","ENSMODG00000005382","3",457407154,457649294,242140
"4018","ENSMODG00000005384","4",286133805,286233147,99342
"4019","ENSMODG00000005385","2",491764039,491826417,62378
"4020","ENSMODG00000005386","2",456931177,456940697,9520
"4021","ENSMODG00000005387","1",380615220,380620362,5142
"4022","ENSMODG00000005388","4",167493180,167891258,398078
"4023","ENSMODG00000005391","8",226095260,226209230,113970
"4024","ENSMODG00000005392","1",606532278,606544132,11854
"4025","ENSMODG00000005393","1",685914482,685966255,51773
"4026","ENSMODG00000005395","2",256174010,256183611,9601
"4027","ENSMODG00000005396","8",14578878,14619132,40254
"4028","ENSMODG00000005397","1",171881106,171882293,1187
"4029","ENSMODG00000005398","1",606520915,606525997,5082
"4030","ENSMODG00000005399","1",244982250,245005273,23023
"4031","ENSMODG00000005400","5",238276547,238469458,192911
"4032","ENSMODG00000005401","4",409873153,409893639,20486
"4033","ENSMODG00000005402","5",238488767,238491155,2388
"4034","ENSMODG00000005403","4",286230398,286346058,115660
"4035","ENSMODG00000005404","1",605610190,605933047,322857
"4036","ENSMODG00000005405","1",685907702,685911356,3654
"4037","ENSMODG00000005406","1",245008202,245022792,14590
"4038","ENSMODG00000005407","3",143832284,143844110,11826
"4039","ENSMODG00000005408","3",371383767,371515947,132180
"4040","ENSMODG00000005409","5",238496251,238500078,3827
"4041","ENSMODG00000005411","2",456901536,456930673,29137
"4042","ENSMODG00000005413","1",605549059,605602922,53863
"4043","ENSMODG00000005415","1",245019922,245033082,13160
"4044","ENSMODG00000005416","5",238546916,238551629,4713
"4045","ENSMODG00000005417","4",286347007,286370701,23694
"4046","ENSMODG00000005418","1",245033532,245075962,42430
"4047","ENSMODG00000005419","8",14632181,14708810,76629
"4048","ENSMODG00000005421","1",685896731,685901395,4664
"4049","ENSMODG00000005422","2",491895686,491939389,43703
"4050","ENSMODG00000005424","4",286373173,286384052,10879
"4051","ENSMODG00000005427","1",245090534,245109630,19096
"4052","ENSMODG00000005428","1",605428920,605439424,10504
"4053","ENSMODG00000005432","4",167896065,168048754,152689
"4054","ENSMODG00000005433","5",238518489,238522710,4221
"4055","ENSMODG00000005434","3",371205047,371337326,132279
"4056","ENSMODG00000005435","8",226223865,226334955,111090
"4057","ENSMODG00000005437","2",491969194,491974225,5031
"4058","ENSMODG00000005438","3",143912661,143932404,19743
"4059","ENSMODG00000005439","1",76559716,76607259,47543
"4060","ENSMODG00000005440","6",242809881,242876266,66385
"4061","ENSMODG00000005441","5",238541142,238542786,1644
"4062","ENSMODG00000005442","1",685874889,685879479,4590
"4063","ENSMODG00000005443","2",456892920,456895550,2630
"4064","ENSMODG00000005444","1",605368195,605421014,52819
"4065","ENSMODG00000005445","1",605218233,605227491,9258
"4066","ENSMODG00000005447","3",371095405,371107047,11642
"4067","ENSMODG00000005448","6",242898434,242907192,8758
"4068","ENSMODG00000005449","1",685832334,685869821,37487
"4069","ENSMODG00000005451","3",144019570,144045871,26301
"4070","ENSMODG00000005452","2",456890459,456891533,1074
"4071","ENSMODG00000005454","5",238573106,238619176,46070
"4072","ENSMODG00000005456","3",144055065,144164242,109177
"4073","ENSMODG00000005457","1",171806983,171809575,2592
"4074","ENSMODG00000005458","8",226360891,226474966,114075
"4075","ENSMODG00000005459","1",76668644,76680079,11435
"4076","ENSMODG00000005460","3",144169635,144206479,36844
"4077","ENSMODG00000005461","5",238623958,238626670,2712
"4078","ENSMODG00000005462","1",245110055,245153442,43387
"4079","ENSMODG00000005463","3",431159271,431342072,182801
"4080","ENSMODG00000005464","4",286383801,286409278,25477
"4081","ENSMODG00000005465","2",456829654,456867383,37729
"4082","ENSMODG00000005468","3",144258038,144285873,27835
"4083","ENSMODG00000005470","5",238636440,238658961,22521
"4084","ENSMODG00000005472","8",226712088,226876977,164889
"4085","ENSMODG00000005473","2",256114091,256173189,59098
"4086","ENSMODG00000005474","5",238663455,238675690,12235
"4087","ENSMODG00000005475","1",245168267,245180485,12218
"4088","ENSMODG00000005476","3",431079549,431085869,6320
"4089","ENSMODG00000005477","2",456809804,456823728,13924
"4090","ENSMODG00000005479","8",14711568,14731050,19482
"4091","ENSMODG00000005480","6",242934075,242991972,57897
"4092","ENSMODG00000005481","2",67662819,67925590,262771
"4093","ENSMODG00000005482","1",453317691,453332933,15242
"4094","ENSMODG00000005484","2",456787583,456801678,14095
"4095","ENSMODG00000005485","8",14852799,14866620,13821
"4096","ENSMODG00000005486","3",457662481,457663545,1064
"4097","ENSMODG00000005488","8",14759078,14778561,19483
"4098","ENSMODG00000005489","1",604795587,604836997,41410
"4099","ENSMODG00000005490","3",144299964,144318654,18690
"4100","ENSMODG00000005491","6",243054669,243066430,11761
"4101","ENSMODG00000005494","3",457674140,457687110,12970
"4102","ENSMODG00000005495","1",604780599,604792348,11749
"4103","ENSMODG00000005496","6",243023725,243171193,147468
"4104","ENSMODG00000005497","8",14798366,14826668,28302
"4105","ENSMODG00000005498","3",370163881,370969386,805505
"4106","ENSMODG00000005499","4",404652500,404656520,4020
"4107","ENSMODG00000005500","8",14823359,14823855,496
"4108","ENSMODG00000005502","6",53439852,53538621,98769
"4109","ENSMODG00000005503","1",453327292,453334643,7351
"4110","ENSMODG00000005504","1",604710362,604759944,49582
"4111","ENSMODG00000005505","6",243077292,243101116,23824
"4112","ENSMODG00000005508","1",453336895,453340210,3315
"4113","ENSMODG00000005509","3",144361875,144372152,10277
"4114","ENSMODG00000005510","1",685756369,685778975,22606
"4115","ENSMODG00000005511","1",245220512,245316350,95838
"4116","ENSMODG00000005512","8",14876886,14883226,6340
"4117","ENSMODG00000005513","1",245397539,245409082,11543
"4118","ENSMODG00000005516","1",76627968,76652670,24702
"4119","ENSMODG00000005517","1",685743962,685750780,6818
"4120","ENSMODG00000005518","1",453349690,453357606,7916
"4121","ENSMODG00000005519","1",379794194,379828142,33948
"4122","ENSMODG00000005520","1",245450301,245458606,8305
"4123","ENSMODG00000005522","1",685721329,685722195,866
"4124","ENSMODG00000005523","5",238738343,238903780,165437
"4125","ENSMODG00000005524","3",457692445,457720032,27587
"4126","ENSMODG00000005525","6",53588259,53972192,383933
"4127","ENSMODG00000005529","7",87967532,88003782,36250
"4128","ENSMODG00000005530","1",245601244,245603649,2405
"4129","ENSMODG00000005532","8",14883713,14916471,32758
"4130","ENSMODG00000005534","2",256093114,256102671,9557
"4131","ENSMODG00000005536","1",245821609,245879396,57787
"4132","ENSMODG00000005537","6",243468399,243893957,425558
"4133","ENSMODG00000005538","4",338434784,338483724,48940
"4134","ENSMODG00000005539","6",54242575,54302363,59788
"4135","ENSMODG00000005542","1",453362842,453391159,28317
"4136","ENSMODG00000005543","1",604559376,604591731,32355
"4137","ENSMODG00000005544","1",379361066,379422466,61400
"4138","ENSMODG00000005545","Un",49102742,49126821,24079
"4139","ENSMODG00000005546","3",431042744,431044489,1745
"4140","ENSMODG00000005547","1",379352336,379353181,845
"4141","ENSMODG00000005548","1",245873261,245916010,42749
"4142","ENSMODG00000005549","3",370055878,370090840,34962
"4143","ENSMODG00000005550","X",37378891,37440337,61446
"4144","ENSMODG00000005552","1",453418704,453427977,9273
"4145","ENSMODG00000005554","2",256087163,256092426,5263
"4146","ENSMODG00000005555","5",238944145,238998932,54787
"4147","ENSMODG00000005556","7",88013386,88066819,53433
"4148","ENSMODG00000005558","1",453431395,453432162,767
"4149","ENSMODG00000005559","8",14917465,14933228,15763
"4150","ENSMODG00000005561","2",256081012,256084049,3037
"4151","ENSMODG00000005562","1",685667107,685671424,4317
"4152","ENSMODG00000005563","2",256050222,256051486,1264
"4153","ENSMODG00000005565","4",286575331,286649265,73934
"4154","ENSMODG00000005566","4",168139324,168153983,14659
"4155","ENSMODG00000005567","4",399054281,399068375,14094
"4156","ENSMODG00000005568","1",245915706,245942985,27279
"4157","ENSMODG00000005569","3",370034611,370057127,22516
"4158","ENSMODG00000005570","X",38029206,38439479,410273
"4159","ENSMODG00000005572","8",227556744,227636994,80250
"4160","ENSMODG00000005573","2",456753939,456768116,14177
"4161","ENSMODG00000005575","1",685648805,685666103,17298
"4162","ENSMODG00000005578","Un",53463423,53470480,7057
"4163","ENSMODG00000005579","2",68659473,69004307,344834
"4164","ENSMODG00000005581","1",378996667,378997642,975
"4165","ENSMODG00000005583","3",44991526,44991702,176
"4166","ENSMODG00000005584","3",431031143,431041756,10613
"4167","ENSMODG00000005586","1",246279905,246525231,245326
"4168","ENSMODG00000005587","3",457771290,457821957,50667
"4169","ENSMODG00000005588","4",168182888,168274084,91196
"4170","ENSMODG00000005589","1",76728718,76908206,179488
"4171","ENSMODG00000005592","4",286653604,286702343,48739
"4172","ENSMODG00000005593","3",369985577,370023610,38033
"4173","ENSMODG00000005594","1",453462915,453483709,20794
"4174","ENSMODG00000005595","2",256038006,256045997,7991
"4175","ENSMODG00000005597","X",38768313,38798252,29939
"4176","ENSMODG00000005601","3",369917218,369918218,1000
"4177","ENSMODG00000005602","6",243997185,244192521,195336
"4178","ENSMODG00000005604","4",287121569,287122875,1306
"4179","ENSMODG00000005605","X",38837095,39008992,171897
"4180","ENSMODG00000005606","1",604385318,604509282,123964
"4181","ENSMODG00000005607","2",456362727,456372331,9604
"4182","ENSMODG00000005608","1",246639329,246711892,72563
"4183","ENSMODG00000005609","1",171692172,171709201,17029
"4184","ENSMODG00000005613","1",378256038,378332053,76015
"4185","ENSMODG00000005614","3",457843864,457866907,23043
"4186","ENSMODG00000005615","1",685489602,685636686,147084
"4187","ENSMODG00000005616","2",256017468,256023878,6410
"4188","ENSMODG00000005617","6",54598614,54749896,151282
"4189","ENSMODG00000005618","1",453482614,453526770,44156
"4190","ENSMODG00000005619","1",171669247,171684288,15041
"4191","ENSMODG00000005620","X",39125735,39131242,5507
"4192","ENSMODG00000005621","3",369823183,369909708,86525
"4193","ENSMODG00000005623","6",54765152,54768731,3579
"4194","ENSMODG00000005624","1",604342740,604368425,25685
"4195","ENSMODG00000005626","2",69361120,69803332,442212
"4196","ENSMODG00000005627","X",39642101,39775748,133647
"4197","ENSMODG00000005628","4",168316865,168417960,101095
"4198","ENSMODG00000005630","1",171608012,171634192,26180
"4199","ENSMODG00000005631","3",369583971,369584159,188
"4200","ENSMODG00000005632","1",246819600,246937460,117860
"4201","ENSMODG00000005633","3",144417495,144431043,13548
"4202","ENSMODG00000005635","6",54807583,54825661,18078
"4203","ENSMODG00000005636","8",14957425,14971686,14261
"4204","ENSMODG00000005637","1",171516246,171516834,588
"4205","ENSMODG00000005638","5",66598683,66944492,345809
"4206","ENSMODG00000005639","1",453536220,453548080,11860
"4207","ENSMODG00000005642","1",604322753,604330868,8115
"4208","ENSMODG00000005643","1",378115705,378185003,69298
"4209","ENSMODG00000005644","3",457888978,457939156,50178
"4210","ENSMODG00000005645","2",455428561,455480721,52160
"4211","ENSMODG00000005646","4",406792831,406818144,25313
"4212","ENSMODG00000005648","4",406830907,406831860,953
"4213","ENSMODG00000005649","1",453567341,453652987,85646
"4214","ENSMODG00000005650","1",377965826,377967040,1214
"4215","ENSMODG00000005651","2",455396634,455428883,32249
"4216","ENSMODG00000005655","5",239006183,239113448,107265
"4217","ENSMODG00000005656","3",457942226,457958878,16652
"4218","ENSMODG00000005657","2",255996450,256006275,9825
"4219","ENSMODG00000005658","1",246949196,246991823,42627
"4220","ENSMODG00000005662","5",239107922,239109171,1249
"4221","ENSMODG00000005663","1",453672003,453679485,7482
"4222","ENSMODG00000005664","1",76949447,76988184,38737
"4223","ENSMODG00000005665","4",168471720,168509117,37397
"4224","ENSMODG00000005666","4",406842740,406843706,966
"4225","ENSMODG00000005667","3",458000012,458136905,136893
"4226","ENSMODG00000005668","1",685375483,685414782,39299
"4227","ENSMODG00000005669","5",66058717,66090061,31344
"4228","ENSMODG00000005671","X",39846700,39945411,98711
"4229","ENSMODG00000005672","5",239292110,239396052,103942
"4230","ENSMODG00000005676","3",369461181,369498158,36977
"4231","ENSMODG00000005677","5",239433220,239468935,35715
"4232","ENSMODG00000005678","1",685348773,685351577,2804
"4233","ENSMODG00000005679","1",377686532,377765386,78854
"4234","ENSMODG00000005680","1",171130524,171131799,1275
"4235","ENSMODG00000005681","8",14993836,15023717,29881
"4236","ENSMODG00000005682","6",54901965,55181740,279775
"4237","ENSMODG00000005683","5",66021807,66053931,32124
"4238","ENSMODG00000005684","3",430988094,431000259,12165
"4239","ENSMODG00000005687","1",604276875,604306279,29404
"4240","ENSMODG00000005688","1",453709410,453763170,53760
"4241","ENSMODG00000005689","2",455361061,455396255,35194
"4242","ENSMODG00000005691","3",144470168,144480445,10277
"4243","ENSMODG00000005692","8",227677152,227963830,286678
"4244","ENSMODG00000005693","1",171091625,171093073,1448
"4245","ENSMODG00000005695","1",453801140,453806188,5048
"4246","ENSMODG00000005696","1",604073854,604253130,179276
"4247","ENSMODG00000005697","1",685345201,685347775,2574
"4248","ENSMODG00000005698","3",458185364,458208762,23398
"4249","ENSMODG00000005699","4",168514941,169138607,623666
"4250","ENSMODG00000005700","1",171072782,171073296,514
"4251","ENSMODG00000005701","3",430974722,430986786,12064
"4252","ENSMODG00000005702","6",113810811,113853668,42857
"4253","ENSMODG00000005703","5",65957574,66003964,46390
"4254","ENSMODG00000005704","1",685336603,685340227,3624
"4255","ENSMODG00000005705","6",49606019,49607980,1961
"4256","ENSMODG00000005706","1",377464038,377650576,186538
"4257","ENSMODG00000005707","2",455008511,455310874,302363
"4258","ENSMODG00000005708","2",255963610,255994615,31005
"4259","ENSMODG00000005711","2",69831067,70318817,487750
"4260","ENSMODG00000005712","5",65926324,65927214,890
"4261","ENSMODG00000005714","X",39955348,40018106,62758
"4262","ENSMODG00000005715","1",171035535,171035993,458
"4263","ENSMODG00000005716","4",169740944,169741843,899
"4264","ENSMODG00000005717","1",170975800,170976306,506
"4265","ENSMODG00000005718","2",255933556,255937065,3509
"4266","ENSMODG00000005719","3",458229555,458271700,42145
"4267","ENSMODG00000005721","6",113961063,113965983,4920
"4268","ENSMODG00000005722","1",567736680,567738440,1760
"4269","ENSMODG00000005725","1",453826322,453841320,14998
"4270","ENSMODG00000005727","3",430890529,430921037,30508
"4271","ENSMODG00000005729","5",65811941,65887584,75643
"4272","ENSMODG00000005730","7",91715181,91716045,864
"4273","ENSMODG00000005731","1",170870497,170871313,816
"4274","ENSMODG00000005732","2",70328371,70494544,166173
"4275","ENSMODG00000005734","1",685314950,685336386,21436
"4276","ENSMODG00000005735","X",40254007,40263016,9009
"4277","ENSMODG00000005737","6",113970920,114000470,29550
"4278","ENSMODG00000005740","1",246993076,247391659,398583
"4279","ENSMODG00000005741","8",15092722,15122985,30263
"4280","ENSMODG00000005742","1",170825321,170825632,311
"4281","ENSMODG00000005743","2",70939137,70940114,977
"4282","ENSMODG00000005744","6",113999953,114003276,3323
"4283","ENSMODG00000005745","3",430870163,430873600,3437
"4284","ENSMODG00000005746","5",65686562,65703049,16487
"4285","ENSMODG00000005747","X",40369721,40439163,69442
"4286","ENSMODG00000005748","1",453884232,453892416,8184
"4287","ENSMODG00000005749","4",170459300,170638043,178743
"4288","ENSMODG00000005750","1",76996363,77335655,339292
"4289","ENSMODG00000005751","5",65497099,65570497,73398
"4290","ENSMODG00000005754","1",453894419,453900227,5808
"4291","ENSMODG00000005757","1",685282646,685300408,17762
"4292","ENSMODG00000005760","1",377357365,377444903,87538
"4293","ENSMODG00000005761","3",430865325,430866440,1115
"4294","ENSMODG00000005762","1",247394515,247431066,36551
"4295","ENSMODG00000005764","2",384796050,384797132,1082
"4296","ENSMODG00000005765","1",77429597,77440520,10923
"4297","ENSMODG00000005766","8",15226100,15288528,62428
"4298","ENSMODG00000005770","4",396384471,396390808,6337
"4299","ENSMODG00000005772","1",247428570,247522725,94155
"4300","ENSMODG00000005775","1",377328925,377339083,10158
"4301","ENSMODG00000005777","1",247490694,247491540,846
"4302","ENSMODG00000005778","1",170570025,170570573,548
"4303","ENSMODG00000005780","2",454662220,454709926,47706
"4304","ENSMODG00000005781","6",114013287,114136231,122944
"4305","ENSMODG00000005782","4",171741613,172198282,456669
"4306","ENSMODG00000005783","4",399141603,399153164,11561
"4307","ENSMODG00000005784","1",77513067,77569208,56141
"4308","ENSMODG00000005785","2",454322428,454322903,475
"4309","ENSMODG00000005786","7",92762637,92763447,810
"4310","ENSMODG00000005788","2",136761648,136797790,36142
"4311","ENSMODG00000005789","5",300607634,300608554,920
"4312","ENSMODG00000005790","3",430795952,430800601,4649
"4313","ENSMODG00000005791","1",77607304,77673771,66467
"4314","ENSMODG00000005792","6",114171659,114190630,18971
"4315","ENSMODG00000005797","6",114246757,114300114,53357
"4316","ENSMODG00000005798","X",40919679,41000075,80396
"4317","ENSMODG00000005799","Un",96974970,96975920,950
"4318","ENSMODG00000005800","5",64977166,64977735,569
"4319","ENSMODG00000005802","4",396407483,396452444,44961
"4320","ENSMODG00000005804","5",63557438,63579337,21899
"4321","ENSMODG00000005805","8",15300210,15310459,10249
"4322","ENSMODG00000005806","5",239615579,239665690,50111
"4323","ENSMODG00000005807","2",453548449,453824709,276260
"4324","ENSMODG00000005808","4",399185165,399197897,12732
"4325","ENSMODG00000005809","1",377299791,377322739,22948
"4326","ENSMODG00000005811","7",93403978,93429424,25446
"4327","ENSMODG00000005815","6",55047564,55125059,77495
"4328","ENSMODG00000005816","3",430785217,430794870,9653
"4329","ENSMODG00000005817","1",377163032,377291017,127985
"4330","ENSMODG00000005818","2",453322499,453338830,16331
"4331","ENSMODG00000005819","X",41097589,41106274,8685
"4332","ENSMODG00000005821","4",172376592,172549157,172565
"4333","ENSMODG00000005822","2",136864409,137028299,163890
"4334","ENSMODG00000005823","2",71561420,71637693,76273
"4335","ENSMODG00000005824","7",93614529,93647614,33085
"4336","ENSMODG00000005825","3",145471453,145498831,27378
"4337","ENSMODG00000005826","6",116066817,116247687,180870
"4338","ENSMODG00000005827","5",239668889,239685256,16367
"4339","ENSMODG00000005828","3",430781821,430783768,1947
"4340","ENSMODG00000005831","2",71645836,71664553,18717
"4341","ENSMODG00000005833","3",145598211,145609184,10973
"4342","ENSMODG00000005834","4",407004406,407005910,1504
"4343","ENSMODG00000005835","4",396236508,396377032,140524
"4344","ENSMODG00000005838","3",430771476,430781046,9570
"4345","ENSMODG00000005839","6",118992075,119050800,58725
"4346","ENSMODG00000005842","4",395446670,395916429,469759
"4347","ENSMODG00000005843","4",407025788,407026729,941
"4348","ENSMODG00000005844","4",395033320,395125437,92117
"4349","ENSMODG00000005845","1",685211588,685224389,12801
"4350","ENSMODG00000005847","5",63361913,63489503,127590
"4351","ENSMODG00000005848","2",137054253,137082474,28221
"4352","ENSMODG00000005850","X",41326495,41373674,47179
"4353","ENSMODG00000005853","6",119053150,119064811,11661
"4354","ENSMODG00000005854","4",404878483,404885701,7218
"4355","ENSMODG00000005856","2",137209733,137462631,252898
"4356","ENSMODG00000005857","1",377037431,377123058,85627
"4357","ENSMODG00000005859","3",430729548,430742910,13362
"4358","ENSMODG00000005860","1",685016901,685029173,12272
"4359","ENSMODG00000005862","6",119093522,119096299,2777
"4360","ENSMODG00000005863","8",15379236,15390226,10990
"4361","ENSMODG00000005864","3",369188855,369212174,23319
"4362","ENSMODG00000005865","2",452719392,452745205,25813
"4363","ENSMODG00000005866","4",407178790,407179737,947
"4364","ENSMODG00000005868","1",453943195,454011801,68606
"4365","ENSMODG00000005870","5",62659377,62808653,149276
"4366","ENSMODG00000005871","6",119132168,119138728,6560
"4367","ENSMODG00000005872","3",438815320,438861765,46445
"4368","ENSMODG00000005873","8",15424592,15427948,3356
"4369","ENSMODG00000005874","4",407234358,407235290,932
"4370","ENSMODG00000005876","2",261708725,261710386,1661
"4371","ENSMODG00000005879","5",62585337,62614207,28870
"4372","ENSMODG00000005882","2",137596068,137648526,52458
"4373","ENSMODG00000005883","1",170467178,170467644,466
"4374","ENSMODG00000005884","1",77677282,77766139,88857
"4375","ENSMODG00000005887","1",376783357,376816587,33230
"4376","ENSMODG00000005889","5",62557746,62581860,24114
"4377","ENSMODG00000005890","1",602702276,603015798,313522
"4378","ENSMODG00000005891","1",376721950,376724471,2521
"4379","ENSMODG00000005894","6",119141989,119150706,8717
"4380","ENSMODG00000005895","1",247574390,247575648,1258
"4381","ENSMODG00000005896","3",368819051,368830275,11224
"4382","ENSMODG00000005897","5",62542002,62550104,8102
"4383","ENSMODG00000005899","X",41451439,41648569,197130
"4384","ENSMODG00000005901","3",368664669,368689280,24611
"4385","ENSMODG00000005902","1",247652922,247653651,729
"4386","ENSMODG00000005903","1",684873915,684875802,1887
"4387","ENSMODG00000005904","6",56596254,57012092,415838
"4388","ENSMODG00000005905","1",247670483,247715136,44653
"4389","ENSMODG00000005906","4",407474175,407475420,1245
"4390","ENSMODG00000005907","1",77795598,77805921,10323
"4391","ENSMODG00000005908","4",394904414,394978127,73713
"4392","ENSMODG00000005909","1",247789046,247870592,81546
"4393","ENSMODG00000005911","3",430694247,430709707,15460
"4394","ENSMODG00000005914","5",62470835,62520854,50019
"4395","ENSMODG00000005915","1",454012174,454055781,43607
"4396","ENSMODG00000005916","1",602394767,602444223,49456
"4397","ENSMODG00000005917","X",41846113,41907854,61741
"4398","ENSMODG00000005918","1",684763706,684871875,108169
"4399","ENSMODG00000005919","1",454042487,454049950,7463
"4400","ENSMODG00000005920","6",57687440,57694418,6978
"4401","ENSMODG00000005921","3",145717171,145786884,69713
"4402","ENSMODG00000005922","4",394893918,394904802,10884
"4403","ENSMODG00000005923","3",430599646,430671698,72052
"4404","ENSMODG00000005925","6",119164760,119177702,12942
"4405","ENSMODG00000005926","8",15444890,15450928,6038
"4406","ENSMODG00000005927","1",248163902,248168550,4648
"4407","ENSMODG00000005928","5",62450267,62458278,8011
"4408","ENSMODG00000005929","1",684760119,684761207,1088
"4409","ENSMODG00000005931","1",602350807,602358473,7666
"4410","ENSMODG00000005932","X",42016815,42022513,5698
"4411","ENSMODG00000005933","1",375714288,375723122,8834
"4412","ENSMODG00000005934","2",137653874,137699284,45410
"4413","ENSMODG00000005935","1",77819415,77850642,31227
"4414","ENSMODG00000005939","8",15458499,15465000,6501
"4415","ENSMODG00000005940","1",454056778,454072563,15785
"4416","ENSMODG00000005941","X",42044555,42058152,13597
"4417","ENSMODG00000005943","1",684669271,684718353,49082
"4418","ENSMODG00000005944","6",57712196,57725170,12974
"4419","ENSMODG00000005946","8",15479998,15481128,1130
"4420","ENSMODG00000005947","4",394883037,394888598,5561
"4421","ENSMODG00000005948","5",62418008,62428178,10170
"4422","ENSMODG00000005949","1",248273312,248318435,45123
"4423","ENSMODG00000005950","1",684660881,684662517,1636
"4424","ENSMODG00000005951","1",454072995,454085219,12224
"4425","ENSMODG00000005952","6",119192134,119205147,13013
"4426","ENSMODG00000005954","3",430358936,430368871,9935
"4427","ENSMODG00000005955","4",404984365,404993886,9521
"4428","ENSMODG00000005956","2",137772039,137781614,9575
"4429","ENSMODG00000005957","8",228511620,228610405,98785
"4430","ENSMODG00000005958","3",145823200,145874900,51700
"4431","ENSMODG00000005959","5",62325917,62415053,89136
"4432","ENSMODG00000005960","7",93696890,93741285,44395
"4433","ENSMODG00000005961","1",602322490,602344089,21599
"4434","ENSMODG00000005963","1",684603400,684641148,37748
"4435","ENSMODG00000005967","1",374969026,374970905,1879
"4436","ENSMODG00000005968","5",239699931,239791628,91697
"4437","ENSMODG00000005970","1",454093056,454110193,17137
"4438","ENSMODG00000005972","1",684550097,684590016,39919
"4439","ENSMODG00000005974","2",71782615,72151074,368459
"4440","ENSMODG00000005975","4",405016807,405053237,36430
"4441","ENSMODG00000005976","3",368212348,368338066,125718
"4442","ENSMODG00000005977","6",119233919,119311496,77577
"4443","ENSMODG00000005978","8",228870109,228902909,32800
"4444","ENSMODG00000005979","2",138130114,138147642,17528
"4445","ENSMODG00000005980","1",170365628,170367270,1642
"4446","ENSMODG00000005981","1",601919900,602315720,395820
"4447","ENSMODG00000005983","2",138269791,138278464,8673
"4448","ENSMODG00000005984","6",244323081,244387642,64561
"4449","ENSMODG00000005985","4",394840704,394863063,22359
"4450","ENSMODG00000005987","8",229015594,229024293,8699
"4451","ENSMODG00000005989","1",248338992,248381190,42198
"4452","ENSMODG00000005990","2",138417674,138470837,53163
"4453","ENSMODG00000005993","3",368158172,368196185,38013
"4454","ENSMODG00000005994","2",138532049,138539973,7924
"4455","ENSMODG00000005997","1",684539879,684548527,8648
"4456","ENSMODG00000005998","8",229064064,229069066,5002
"4457","ENSMODG00000005999","1",454166257,454178509,12252
"4458","ENSMODG00000006000","6",244673087,244674583,1496
"4459","ENSMODG00000006001","Un",80082329,80087380,5051
"4460","ENSMODG00000006002","1",248385902,248389963,4061
"4461","ENSMODG00000006005","3",145881440,145956046,74606
"4462","ENSMODG00000006007","1",374441341,374522865,81524
"4463","ENSMODG00000006008","7",93750952,93772206,21254
"4464","ENSMODG00000006009","4",173041264,173134687,93423
"4465","ENSMODG00000006010","3",367457588,367560446,102858
"4466","ENSMODG00000006013","2",255896038,255932246,36208
"4467","ENSMODG00000006014","1",248396812,248401578,4766
"4468","ENSMODG00000006015","8",15492297,15500075,7778
"4469","ENSMODG00000006016","X",42241063,42258310,17247
"4470","ENSMODG00000006018","5",240019051,240025222,6171
"4471","ENSMODG00000006020","1",684497139,684529275,32136
"4472","ENSMODG00000006021","X",42410480,42411103,623
"4473","ENSMODG00000006024","3",145958420,145968182,9762
"4474","ENSMODG00000006027","4",394812382,394840461,28079
"4475","ENSMODG00000006028","5",240039160,240054984,15824
"4476","ENSMODG00000006029","3",146022385,146022784,399
"4477","ENSMODG00000006031","1",601905377,601907218,1841
"4478","ENSMODG00000006032","2",72507693,72692668,184975
"4479","ENSMODG00000006033","2",138543599,138585868,42269
"4480","ENSMODG00000006034","8",15501436,15504677,3241
"4481","ENSMODG00000006036","1",374246389,374322865,76476
"4482","ENSMODG00000006037","1",248403967,248440178,36211
"4483","ENSMODG00000006040","6",119375790,119420819,45029
"4484","ENSMODG00000006041","2",72618861,72640838,21977
"4485","ENSMODG00000006043","6",244691865,244701309,9444
"4486","ENSMODG00000006045","3",146169248,146547386,378138
"4487","ENSMODG00000006046","1",684457668,684476906,19238
"4488","ENSMODG00000006047","1",373685227,373702238,17011
"4489","ENSMODG00000006048","3",367225004,367449748,224744
"4490","ENSMODG00000006049","Un",53122008,53129486,7478
"4491","ENSMODG00000006050","8",15527816,15544229,16413
"4492","ENSMODG00000006051","1",170272558,170273511,953
"4493","ENSMODG00000006053","2",72856588,72890861,34273
"4494","ENSMODG00000006054","3",366735199,366736473,1274
"4495","ENSMODG00000006055","3",147698442,147698941,499
"4496","ENSMODG00000006057","1",170212782,170213741,959
"4497","ENSMODG00000006058","1",684455339,684464098,8759
"4498","ENSMODG00000006059","2",255721185,255788582,67397
"4499","ENSMODG00000006061","1",248447824,248454908,7084
"4500","ENSMODG00000006062","2",452438348,452694661,256313
"4501","ENSMODG00000006063","1",684435919,684445964,10045
"4502","ENSMODG00000006064","3",430281777,430357602,75825
"4503","ENSMODG00000006067","5",240076690,240274145,197455
"4504","ENSMODG00000006068","1",170132650,170150697,18047
"4505","ENSMODG00000006070","8",15572157,15578004,5847
"4506","ENSMODG00000006071","1",248565201,248589064,23863
"4507","ENSMODG00000006072","6",119423339,119458325,34986
"4508","ENSMODG00000006073","2",72948624,72963763,15139
"4509","ENSMODG00000006074","4",386607094,386608038,944
"4510","ENSMODG00000006076","2",138708755,138770103,61348
"4511","ENSMODG00000006078","1",454244015,454284066,40051
"4512","ENSMODG00000006079","5",240290735,240311588,20853
"4513","ENSMODG00000006083","3",430277032,430283230,6198
"4514","ENSMODG00000006084","4",394692685,394805107,112422
"4515","ENSMODG00000006085","1",170100704,170123307,22603
"4516","ENSMODG00000006088","4",398433604,398434554,950
"4517","ENSMODG00000006089","1",601495491,601826240,330749
"4518","ENSMODG00000006090","2",72930036,73076520,146484
"4519","ENSMODG00000006091","3",430265502,430273695,8193
"4520","ENSMODG00000006093","1",248602058,248641642,39584
"4521","ENSMODG00000006094","4",398425621,398426518,897
"4522","ENSMODG00000006095","2",139169806,139338184,168378
"4523","ENSMODG00000006096","4",394683533,394686708,3175
"4524","ENSMODG00000006097","1",601449754,601450431,677
"4525","ENSMODG00000006099","5",240341775,240574909,233134
"4526","ENSMODG00000006102","6",57726533,57839485,112952
"4527","ENSMODG00000006103","X",4459482,4486904,27422
"4528","ENSMODG00000006104","3",430213845,430239025,25180
"4529","ENSMODG00000006105","2",255790492,255798935,8443
"4530","ENSMODG00000006106","8",15607990,15673396,65406
"4531","ENSMODG00000006107","2",451494662,451549567,54905
"4532","ENSMODG00000006108","X",4506141,4507581,1440
"4533","ENSMODG00000006110","8",16108260,16158325,50065
"4534","ENSMODG00000006111","2",451420274,451421995,1721
"4535","ENSMODG00000006112","2",255709064,255713262,4198
"4536","ENSMODG00000006113","1",170080552,170101452,20900
"4537","ENSMODG00000006114","2",139458126,139499252,41126
"4538","ENSMODG00000006115","6",58067900,58085167,17267
"4539","ENSMODG00000006120","2",451313780,451314739,959
"4540","ENSMODG00000006121","1",170060025,170080358,20333
"4541","ENSMODG00000006124","2",73232031,73289989,57958
"4542","ENSMODG00000006125","1",600689729,600691223,1494
"4543","ENSMODG00000006126","8",16198614,16225571,26957
"4544","ENSMODG00000006127","5",240707534,241153126,445592
"4545","ENSMODG00000006128","1",684428079,684435249,7170
"4546","ENSMODG00000006129","1",248645465,248669824,24359
"4547","ENSMODG00000006130","1",454284820,454325349,40529
"4548","ENSMODG00000006132","X",4514842,4559049,44207
"4549","ENSMODG00000006134","4",398333593,398335851,2258
"4550","ENSMODG00000006136","6",244741929,244961113,219184
"4551","ENSMODG00000006137","1",248689378,248693873,4495
"4552","ENSMODG00000006138","4",394627991,394682720,54729
"4553","ENSMODG00000006139","2",73341906,73500067,158161
"4554","ENSMODG00000006140","6",119459163,119498913,39750
"4555","ENSMODG00000006142","4",398316913,398317808,895
"4556","ENSMODG00000006143","2",451262038,451280657,18619
"4557","ENSMODG00000006144","7",148530430,148531496,1066
"4558","ENSMODG00000006145","6",244968263,245122381,154118
"4559","ENSMODG00000006146","1",373199305,373217399,18094
"4560","ENSMODG00000006147","6",58120495,58206727,86232
"4561","ENSMODG00000006149","4",394616619,394622743,6124
"4562","ENSMODG00000006150","1",684416794,684426488,9694
"4563","ENSMODG00000006151","2",139551241,139624188,72947
"4564","ENSMODG00000006153","6",245196205,245238168,41963
"4565","ENSMODG00000006154","1",373067392,373074544,7152
"4566","ENSMODG00000006156","2",73499928,73521991,22063
"4567","ENSMODG00000006158","3",366258435,366302588,44153
"4568","ENSMODG00000006159","6",245391748,245622134,230386
"4569","ENSMODG00000006160","X",4912412,4935494,23082
"4570","ENSMODG00000006161","2",255693801,255703123,9322
"4571","ENSMODG00000006162","3",151183148,151183644,496
"4572","ENSMODG00000006163","1",600378124,600477938,99814
"4573","ENSMODG00000006164","1",373005293,373023074,17781
"4574","ENSMODG00000006166","6",58305717,58312425,6708
"4575","ENSMODG00000006168","1",248718279,248774558,56279
"4576","ENSMODG00000006170","1",600367970,600369388,1418
"4577","ENSMODG00000006171","2",224625671,224743993,118322
"4578","ENSMODG00000006174","4",394356960,394388532,31572
"4579","ENSMODG00000006175","2",451107307,451158831,51524
"4580","ENSMODG00000006176","4",398130323,398145460,15137
"4581","ENSMODG00000006177","1",600244740,600246879,2139
"4582","ENSMODG00000006179","1",248805894,248843587,37693
"4583","ENSMODG00000006180","2",73536415,73594295,57880
"4584","ENSMODG00000006181","2",255671068,255675708,4640
"4585","ENSMODG00000006182","6",119501662,119507848,6186
"4586","ENSMODG00000006183","7",94036290,94049247,12957
"4587","ENSMODG00000006184","1",372944663,372991755,47092
"4588","ENSMODG00000006186","1",684406166,684414189,8023
"4589","ENSMODG00000006187","2",73756485,73765936,9451
"4590","ENSMODG00000006188","1",372874484,372909845,35361
"4591","ENSMODG00000006189","4",394291339,394300400,9061
"4592","ENSMODG00000006192","1",745518190,745523064,4874
"4593","ENSMODG00000006193","2",450992100,451034492,42392
"4594","ENSMODG00000006197","6",119511766,119522423,10657
"4595","ENSMODG00000006198","1",599967917,599978685,10768
"4596","ENSMODG00000006199","6",245580517,245598644,18127
"4597","ENSMODG00000006200","3",151431113,151460696,29583
"4598","ENSMODG00000006201","1",372858683,372862895,4212
"4599","ENSMODG00000006202","1",248842560,248873759,31199
"4600","ENSMODG00000006203","1",684394066,684399257,5191
"4601","ENSMODG00000006205","8",16270875,16367620,96745
"4602","ENSMODG00000006206","X",4991861,4992886,1025
"4603","ENSMODG00000006207","6",58317074,58389094,72020
"4604","ENSMODG00000006209","4",394270155,394286078,15923
"4605","ENSMODG00000006210","1",684380526,684382991,2465
"4606","ENSMODG00000006211","6",119530068,119534739,4671
"4607","ENSMODG00000006213","1",598803980,598806672,2692
"4608","ENSMODG00000006214","1",372746006,372831605,85599
"4609","ENSMODG00000006216","8",16372954,16401317,28363
"4610","ENSMODG00000006218","4",398001052,398002149,1097
"4611","ENSMODG00000006219","1",169999906,170045859,45953
"4612","ENSMODG00000006220","3",151517910,151560752,42842
"4613","ENSMODG00000006221","1",598108311,598110323,2012
"4614","ENSMODG00000006222","3",366000213,366015342,15129
"4615","ENSMODG00000006223","1",372591863,372596761,4898
"4616","ENSMODG00000006225","4",394249497,394262962,13465
"4617","ENSMODG00000006227","6",58427251,58525276,98025
"4618","ENSMODG00000006228","1",684355181,684364603,9422
"4619","ENSMODG00000006229","X",5036207,5071723,35516
"4620","ENSMODG00000006231","2",73765496,73805882,40386
"4621","ENSMODG00000006232","3",151576899,151612084,35185
"4622","ENSMODG00000006233","6",245788041,245980094,192053
"4623","ENSMODG00000006234","1",372370387,372441972,71585
"4624","ENSMODG00000006236","6",119591695,119607450,15755
"4625","ENSMODG00000006237","1",684347676,684351941,4265
"4626","ENSMODG00000006238","1",597541386,597593850,52464
"4627","ENSMODG00000006239","8",16471233,16504164,32931
"4628","ENSMODG00000006240","2",73835500,73840853,5353
"4629","ENSMODG00000006241","2",450386577,450668330,281753
"4630","ENSMODG00000006242","1",684332824,684336914,4090
"4631","ENSMODG00000006244","1",248978538,249184611,206073
"4632","ENSMODG00000006245","5",241676831,241677721,890
"4633","ENSMODG00000006246","2",139635431,139955313,319882
"4634","ENSMODG00000006247","Un",30145060,30145953,893
"4635","ENSMODG00000006248","1",249203370,249204278,908
"4636","ENSMODG00000006249","6",246057678,246092187,34509
"4637","ENSMODG00000006250","6",58536829,58558493,21664
"4638","ENSMODG00000006252","1",454349100,454399811,50711
"4639","ENSMODG00000006254","2",140262823,140263113,290
"4640","ENSMODG00000006256","8",16519410,16732231,212821
"4641","ENSMODG00000006257","3",459144833,459154661,9828
"4642","ENSMODG00000006258","3",439310187,439310700,513
"4643","ENSMODG00000006260","2",255587897,255597003,9106
"4644","ENSMODG00000006262","3",365853448,365945030,91582
"4645","ENSMODG00000006263","2",73855872,73891114,35242
"4646","ENSMODG00000006265","6",246095511,246103942,8431
"4647","ENSMODG00000006266","5",241899053,241899985,932
"4648","ENSMODG00000006267","2",450205196,450206182,986
"4649","ENSMODG00000006268","7",151774641,151776257,1616
"4650","ENSMODG00000006270","1",249205561,249295778,90217
"4651","ENSMODG00000006271","3",151641231,151682534,41303
"4652","ENSMODG00000006272","7",94053663,94144899,91236
"4653","ENSMODG00000006273","4",397977057,397979135,2078
"4654","ENSMODG00000006275","3",365795233,365838327,43094
"4655","ENSMODG00000006276","1",454394848,454443281,48433
"4656","ENSMODG00000006277","1",597483238,597529649,46411
"4657","ENSMODG00000006278","6",58559384,58593995,34611
"4658","ENSMODG00000006279","7",153069358,153075153,5795
"4659","ENSMODG00000006280","6",246126690,246142386,15696
"4660","ENSMODG00000006282","7",94977600,95227053,249453
"4661","ENSMODG00000006283","4",397951763,397952680,917
"4662","ENSMODG00000006287","3",430013920,430106134,92214
"4663","ENSMODG00000006288","3",365457496,365529312,71816
"4664","ENSMODG00000006289","1",597292412,597302025,9613
"4665","ENSMODG00000006290","2",103161650,103200293,38643
"4666","ENSMODG00000006291","7",153625496,153637612,12116
"4667","ENSMODG00000006292","2",314607074,314643003,35929
"4668","ENSMODG00000006293","1",596130110,596316873,186763
"4669","ENSMODG00000006294","4",394091779,394238585,146806
"4670","ENSMODG00000006295","X",42509651,42510655,1004
"4671","ENSMODG00000006296","2",103201345,103253994,52649
"4672","ENSMODG00000006297","2",223891419,224076734,185315
"4673","ENSMODG00000006300","1",595457353,595723678,266325
"4674","ENSMODG00000006302","3",459178042,459208148,30106
"4675","ENSMODG00000006303","4",405081227,405082164,937
"4676","ENSMODG00000006307","6",246142457,246173426,30969
"4677","ENSMODG00000006308","1",371923461,372082130,158669
"4678","ENSMODG00000006309","7",95233330,95651562,418232
"4679","ENSMODG00000006310","2",140354814,140454967,100153
"4680","ENSMODG00000006311","3",429928554,429967624,39070
"4681","ENSMODG00000006312","3",365315416,365321261,5845
"4682","ENSMODG00000006313","1",595413330,595444642,31312
"4683","ENSMODG00000006314","1",77868789,78031190,162401
"4684","ENSMODG00000006316","7",154197035,154360454,163419
"4685","ENSMODG00000006317","4",397936769,397938507,1738
"4686","ENSMODG00000006318","2",449946170,449962522,16352
"4687","ENSMODG00000006319","3",429902563,429917523,14960
"4688","ENSMODG00000006320","3",365279507,365306151,26644
"4689","ENSMODG00000006321","Un",55789330,55802580,13250
"4690","ENSMODG00000006322","2",449304404,449304822,418
"4691","ENSMODG00000006323","2",103219949,103230017,10068
"4692","ENSMODG00000006324","1",684248929,684322286,73357
"4693","ENSMODG00000006325","8",229120639,229216466,95827
"4694","ENSMODG00000006327","5",242120410,242241269,120859
"4695","ENSMODG00000006330","2",223557447,223739156,181709
"4696","ENSMODG00000006332","3",365081665,365252940,171275
"4697","ENSMODG00000006335","6",246446544,246476803,30259
"4698","ENSMODG00000006336","3",365051323,365053770,2447
"4699","ENSMODG00000006337","2",73906086,74100305,194219
"4700","ENSMODG00000006338","6",119647045,119695096,48051
"4701","ENSMODG00000006339","3",151767568,151792331,24763
"4702","ENSMODG00000006340","1",249361082,249363121,2039
"4703","ENSMODG00000006341","1",371820767,371873493,52726
"4704","ENSMODG00000006342","1",454483712,454491737,8025
"4705","ENSMODG00000006343","1",333016233,333018587,2354
"4706","ENSMODG00000006344","1",78243201,78247336,4135
"4707","ENSMODG00000006345","1",595303105,595392813,89708
"4708","ENSMODG00000006346","6",119690782,119709200,18418
"4709","ENSMODG00000006347","3",429874706,429894186,19480
"4710","ENSMODG00000006348","1",371804576,371808369,3793
"4711","ENSMODG00000006350","3",502044672,502077888,33216
"4712","ENSMODG00000006351","1",595251677,595258754,7077
"4713","ENSMODG00000006352","1",684116832,684222404,105572
"4714","ENSMODG00000006353","Un",65547498,65555620,8122
"4715","ENSMODG00000006354","5",242243941,242265419,21478
"4716","ENSMODG00000006355","2",448846588,449315261,468673
"4717","ENSMODG00000006356","2",140522947,140543179,20232
"4718","ENSMODG00000006358","3",459352418,459379462,27044
"4719","ENSMODG00000006359","8",229288771,229486200,197429
"4720","ENSMODG00000006360","2",74168346,74222238,53892
"4721","ENSMODG00000006362","2",507666570,507762517,95947
"4722","ENSMODG00000006363","7",154647817,154984640,336823
"4723","ENSMODG00000006364","5",242265486,242272053,6567
"4724","ENSMODG00000006366","1",684023780,684050057,26277
"4725","ENSMODG00000006367","2",448758788,448822673,63885
"4726","ENSMODG00000006369","1",249419829,249455013,35184
"4727","ENSMODG00000006371","2",74271612,74340202,68590
"4728","ENSMODG00000006372","2",140605227,140732342,127115
"4729","ENSMODG00000006373","5",242322157,242354327,32170
"4730","ENSMODG00000006374","1",249511182,249542690,31508
"4731","ENSMODG00000006375","1",595093717,595132296,38579
"4732","ENSMODG00000006377","6",246388381,246443328,54947
"4733","ENSMODG00000006378","4",397886891,397927955,41064
"4734","ENSMODG00000006379","2",140654136,140655060,924
"4735","ENSMODG00000006380","4",394035678,394083882,48204
"4736","ENSMODG00000006382","2",103231723,103245647,13924
"4737","ENSMODG00000006383","1",371665793,371802316,136523
"4738","ENSMODG00000006384","1",249810364,249909356,98992
"4739","ENSMODG00000006385","1",683913349,683947858,34509
"4740","ENSMODG00000006387","2",74333220,74558030,224810
"4741","ENSMODG00000006389","5",242367763,242455277,87514
"4742","ENSMODG00000006390","4",397854384,397855603,1219
"4743","ENSMODG00000006392","1",371718458,371719965,1507
"4744","ENSMODG00000006395","1",454509164,454526711,17547
"4745","ENSMODG00000006397","1",249649472,249784765,135293
"4746","ENSMODG00000006398","1",371625732,371627027,1295
"4747","ENSMODG00000006399","6",246479892,246490772,10880
"4748","ENSMODG00000006400","1",683648067,683659751,11684
"4749","ENSMODG00000006402","4",397843471,397844423,952
"4750","ENSMODG00000006403","2",507791816,507822810,30994
"4751","ENSMODG00000006404","2",141558492,141835667,277175
"4752","ENSMODG00000006405","1",683851281,683866021,14740
"4753","ENSMODG00000006406","4",173398066,173503469,105403
"4754","ENSMODG00000006407","1",454527900,454530199,2299
"4755","ENSMODG00000006409","7",157471446,157578282,106836
"4756","ENSMODG00000006410","5",242474637,242556245,81608
"4757","ENSMODG00000006411","4",397832805,397833767,962
"4758","ENSMODG00000006412","7",157671867,157672265,398
"4759","ENSMODG00000006413","2",103279989,103292567,12578
"4760","ENSMODG00000006414","2",221519886,221572564,52678
"4761","ENSMODG00000006415","3",363985583,365037513,1051930
"4762","ENSMODG00000006416","4",397802495,397805476,2981
"4763","ENSMODG00000006417","7",158030784,158031669,885
"4764","ENSMODG00000006419","4",397777883,397779067,1184
"4765","ENSMODG00000006420","2",141889145,142366108,476963
"4766","ENSMODG00000006421","3",363821574,363822239,665
"4767","ENSMODG00000006423","2",103315498,103317153,1655
"4768","ENSMODG00000006424","1",594975814,595054667,78853
"4769","ENSMODG00000006425","1",454533638,454554451,20813
"4770","ENSMODG00000006426","3",459405433,459413589,8156
"4771","ENSMODG00000006427","2",255571213,255585314,14101
"4772","ENSMODG00000006428","3",429802540,429868707,66167
"4773","ENSMODG00000006429","1",249785383,249804759,19376
"4774","ENSMODG00000006430","2",507835153,507878339,43186
"4775","ENSMODG00000006431","1",78268695,78470109,201414
"4776","ENSMODG00000006433","4",393716068,393886484,170416
"4777","ENSMODG00000006434","2",446288530,446469483,180953
"4778","ENSMODG00000006435","3",459409460,459423894,14434
"4779","ENSMODG00000006436","4",173647537,173746958,99421
"4780","ENSMODG00000006438","4",391684184,391943509,259325
"4781","ENSMODG00000006439","1",594828734,594967940,139206
"4782","ENSMODG00000006440","2",507939348,508078476,139128
"4783","ENSMODG00000006441","4",327241747,327840863,599116
"4784","ENSMODG00000006442","3",429837497,429839561,2064
"4785","ENSMODG00000006443","1",594791877,594822802,30925
"4786","ENSMODG00000006444","1",78640810,78651549,10739
"4787","ENSMODG00000006445","Un",14679317,14687073,7756
"4788","ENSMODG00000006446","4",391072552,391074161,1609
"4789","ENSMODG00000006447","2",74764878,75027514,262636
"4790","ENSMODG00000006450","3",459422971,459478396,55425
"4791","ENSMODG00000006451","1",454555333,454579331,23998
"4792","ENSMODG00000006452","4",173957793,174144200,186407
"4793","ENSMODG00000006453","3",429660919,429676776,15857
"4794","ENSMODG00000006454","3",459491634,459500869,9235
"4795","ENSMODG00000006456","4",390123828,390126910,3082
"4796","ENSMODG00000006458","1",454581045,454595571,14526
"4797","ENSMODG00000006460","4",397718968,397722624,3656
"4798","ENSMODG00000006461","1",454600720,454691955,91235
"4799","ENSMODG00000006462","6",246492876,246574686,81810
"4800","ENSMODG00000006463","3",429656151,429657730,1579
"4801","ENSMODG00000006464","1",371427556,371469636,42080
"4802","ENSMODG00000006466","3",526926607,526927614,1007
"4803","ENSMODG00000006467","1",78676152,78733566,57414
"4804","ENSMODG00000006468","2",75070997,75117377,46380
"4805","ENSMODG00000006471","4",174177973,174232555,54582
"4806","ENSMODG00000006474","3",363157198,363651172,493974
"4807","ENSMODG00000006475","Un",14839213,14840602,1389
"4808","ENSMODG00000006476","3",151931189,151938961,7772
"4809","ENSMODG00000006477","6",58607836,58724602,116766
"4810","ENSMODG00000006478","3",459504616,459546871,42255
"4811","ENSMODG00000006479","4",390236839,390245909,9070
"4812","ENSMODG00000006480","1",370701272,370750704,49432
"4813","ENSMODG00000006484","4",397699816,397708156,8340
"4814","ENSMODG00000006486","6",58729084,58753723,24639
"4815","ENSMODG00000006487","3",459550990,459560917,9927
"4816","ENSMODG00000006488","6",246612100,246620652,8552
"4817","ENSMODG00000006490","1",594665416,594786337,120921
"4818","ENSMODG00000006491","1",454695862,454916273,220411
"4819","ENSMODG00000006492","4",390195480,390231208,35728
"4820","ENSMODG00000006493","2",444143878,444571466,427588
"4821","ENSMODG00000006494","2",75142158,75191350,49192
"4822","ENSMODG00000006495","1",594583783,594594954,11171
"4823","ENSMODG00000006497","4",397639333,397648413,9080
"4824","ENSMODG00000006498","2",255550166,255558859,8693
"4825","ENSMODG00000006501","4",174362520,174466647,104127
"4826","ENSMODG00000006503","1",370684434,370697159,12725
"4827","ENSMODG00000006504","5",242621158,242621833,675
"4828","ENSMODG00000006505","3",429647550,429655263,7713
"4829","ENSMODG00000006506","4",397534742,397547567,12825
"4830","ENSMODG00000006507","2",508247316,508266559,19243
"4831","ENSMODG00000006508","1",370591618,370595575,3957
"4832","ENSMODG00000006509","5",242528572,242659582,131010
"4833","ENSMODG00000006510","3",151961398,151994078,32680
"4834","ENSMODG00000006511","3",429589017,429606197,17180
"4835","ENSMODG00000006514","Un",52631243,52653356,22113
"4836","ENSMODG00000006515","2",142860967,142871550,10583
"4837","ENSMODG00000006516","2",508271621,508315344,43723
"4838","ENSMODG00000006517","3",459648559,459682084,33525
"4839","ENSMODG00000006519","1",454747984,454768389,20405
"4840","ENSMODG00000006520","3",363105720,363107162,1442
"4841","ENSMODG00000006521","8",232410267,232505314,95047
"4842","ENSMODG00000006522","5",242661670,242677426,15756
"4843","ENSMODG00000006523","2",508481036,508484315,3279
"4844","ENSMODG00000006526","2",218841509,218847045,5536
"4845","ENSMODG00000006527","2",75213829,75243750,29921
"4846","ENSMODG00000006530","3",462470063,462475287,5224
"4847","ENSMODG00000006531","2",443281338,443462534,181196
"4848","ENSMODG00000006533","2",143033257,143116058,82801
"4849","ENSMODG00000006534","3",362768782,362903826,135044
"4850","ENSMODG00000006536","4",397480620,397493149,12529
"4851","ENSMODG00000006537","4",174523285,174659824,136539
"4852","ENSMODG00000006538","3",459746764,459752615,5851
"4853","ENSMODG00000006539","1",169967239,169993706,26467
"4854","ENSMODG00000006540","5",242708438,242745432,36994
"4855","ENSMODG00000006543","4",390147103,390186205,39102
"4856","ENSMODG00000006544","3",152214603,152220582,5979
"4857","ENSMODG00000006547","2",103319588,103334785,15197
"4858","ENSMODG00000006548","Un",71412249,71417584,5335
"4859","ENSMODG00000006549","3",459762478,459778146,15668
"4860","ENSMODG00000006552","1",249909130,249947924,38794
"4861","ENSMODG00000006553","2",255543031,255549326,6295
"4862","ENSMODG00000006554","4",390069632,390086231,16599
"4863","ENSMODG00000006555","2",103406535,103763099,356564
"4864","ENSMODG00000006556","3",460095765,460102977,7212
"4865","ENSMODG00000006557","3",429582776,429587983,5207
"4866","ENSMODG00000006558","3",152640725,152733882,93157
"4867","ENSMODG00000006559","2",143168012,143424050,256038
"4868","ENSMODG00000006560","3",459804881,459805465,584
"4869","ENSMODG00000006561","3",362667857,362702837,34980
"4870","ENSMODG00000006562","2",103418734,103428607,9873
"4871","ENSMODG00000006563","2",255537451,255541480,4029
"4872","ENSMODG00000006565","2",508384317,508408534,24217
"4873","ENSMODG00000006566","2",143424128,143458397,34269
"4874","ENSMODG00000006567","3",459816212,459821167,4955
"4875","ENSMODG00000006568","1",169921375,169966767,45392
"4876","ENSMODG00000006569","3",152875421,153228199,352778
"4877","ENSMODG00000006570","2",143835808,143837376,1568
"4878","ENSMODG00000006572","2",103456946,103472316,15370
"4879","ENSMODG00000006573","1",594553185,594574496,21311
"4880","ENSMODG00000006574","5",242744441,242811713,67272
"4881","ENSMODG00000006575","3",362650822,362668300,17478
"4882","ENSMODG00000006576","2",217379661,217396490,16829
"4883","ENSMODG00000006577","1",683827188,683845370,18182
"4884","ENSMODG00000006579","3",447882952,447902104,19152
"4885","ENSMODG00000006582","3",459832096,459846899,14803
"4886","ENSMODG00000006583","2",217359494,217380622,21128
"4887","ENSMODG00000006584","3",153435570,153495510,59940
"4888","ENSMODG00000006585","2",508415515,508444474,28959
"4889","ENSMODG00000006586","3",153599901,153600485,584
"4890","ENSMODG00000006587","4",174856045,174960660,104615
"4891","ENSMODG00000006588","2",255527078,255532827,5749
"4892","ENSMODG00000006589","2",217341125,217349886,8761
"4893","ENSMODG00000006591","8",232509457,232553513,44056
"4894","ENSMODG00000006592","1",249946337,249969561,23224
"4895","ENSMODG00000006593","1",594489123,594535940,46817
"4896","ENSMODG00000006594","2",443114845,443277930,163085
"4897","ENSMODG00000006595","4",390007003,390029364,22361
"4898","ENSMODG00000006596","6",119708759,119847014,138255
"4899","ENSMODG00000006597","3",459887734,459900639,12905
"4900","ENSMODG00000006599","1",594366944,594407271,40327
"4901","ENSMODG00000006600","4",175031613,175032726,1113
"4902","ENSMODG00000006601","3",429559593,429570498,10905
"4903","ENSMODG00000006602","1",249969807,249993479,23672
"4904","ENSMODG00000006603","2",103489257,103546159,56902
"4905","ENSMODG00000006605","2",508456428,508480529,24101
"4906","ENSMODG00000006606","1",169839236,169882118,42882
"4907","ENSMODG00000006608","3",459933909,459935225,1316
"4908","ENSMODG00000006609","2",255512851,255518266,5415
"4909","ENSMODG00000006611","1",454773239,454821285,48046
"4910","ENSMODG00000006612","1",594283224,594334095,50871
"4911","ENSMODG00000006613","3",153904857,154041590,136733
"4912","ENSMODG00000006616","2",103566095,103607250,41155
"4913","ENSMODG00000006618","6",120001551,120055083,53532
"4914","ENSMODG00000006619","3",429553340,429558226,4886
"4915","ENSMODG00000006620","1",169719247,169726755,7508
"4916","ENSMODG00000006621","3",154047438,154263119,215681
"4917","ENSMODG00000006622","1",249999908,250023165,23257
"4918","ENSMODG00000006623","4",389858020,389948660,90640
"4919","ENSMODG00000006624","1",593976403,594011844,35441
"4920","ENSMODG00000006625","1",683782669,683809267,26598
"4921","ENSMODG00000006626","2",144222572,144568537,345965
"4922","ENSMODG00000006628","6",58957828,58982983,25155
"4923","ENSMODG00000006630","1",78752407,78862056,109649
"4924","ENSMODG00000006632","1",454823472,454853411,29939
"4925","ENSMODG00000006633","6",120060402,120093414,33012
"4926","ENSMODG00000006634","2",508487874,508559025,71151
"4927","ENSMODG00000006635","2",75934411,75935853,1442
"4928","ENSMODG00000006637","6",59232371,59289612,57241
"4929","ENSMODG00000006639","1",78886802,78946164,59362
"4930","ENSMODG00000006640","1",250045857,250094737,48880
"4931","ENSMODG00000006641","3",429537283,429551963,14680
"4932","ENSMODG00000006642","2",144574142,144835605,261463
"4933","ENSMODG00000006643","3",460043370,460093013,49643
"4934","ENSMODG00000006644","2",508564676,508571511,6835
"4935","ENSMODG00000006645","6",59385093,59385541,448
"4936","ENSMODG00000006646","2",255494801,255501203,6402
"4937","ENSMODG00000006647","4",389682567,389728195,45628
"4938","ENSMODG00000006648","3",154516482,154521023,4541
"4939","ENSMODG00000006649","1",593876129,593912391,36262
"4940","ENSMODG00000006651","4",389674089,389680119,6030
"4941","ENSMODG00000006652","2",255415073,255416704,1631
"4942","ENSMODG00000006653","3",429520145,429532422,12277
"4943","ENSMODG00000006654","6",120138415,120161285,22870
"4944","ENSMODG00000006656","1",250354417,250393195,38778
"4945","ENSMODG00000006657","3",429499963,429506155,6192
"4946","ENSMODG00000006659","3",447908628,447923502,14874
"4947","ENSMODG00000006660","1",169700004,169725876,25872
"4948","ENSMODG00000006662","1",250398780,250458337,59557
"4949","ENSMODG00000006663","6",120156044,120193898,37854
"4950","ENSMODG00000006664","Un",53811180,53824618,13438
"4951","ENSMODG00000006665","2",216970272,217220511,250239
"4952","ENSMODG00000006666","1",593743540,593840901,97361
"4953","ENSMODG00000006668","2",255410513,255414093,3580
"4954","ENSMODG00000006669","6",59644443,59708821,64378
"4955","ENSMODG00000006670","1",454916487,454940375,23888
"4956","ENSMODG00000006671","3",154634075,154673654,39579
"4957","ENSMODG00000006672","3",429489460,429498879,9419
"4958","ENSMODG00000006673","1",78946440,79168008,221568
"4959","ENSMODG00000006674","1",17117832,17118723,891
"4960","ENSMODG00000006675","1",250462357,250477553,15196
"4961","ENSMODG00000006679","5",243220972,243241942,20970
"4962","ENSMODG00000006682","2",215569091,215574530,5439
"4963","ENSMODG00000006683","1",454974221,454983176,8955
"4964","ENSMODG00000006684","1",169623910,169624371,461
"4965","ENSMODG00000006686","1",250499928,250518691,18763
"4966","ENSMODG00000006688","3",429459030,429466368,7338
"4967","ENSMODG00000006689","1",169588791,169597637,8846
"4968","ENSMODG00000006691","3",429454868,429457424,2556
"4969","ENSMODG00000006692","2",442980962,443045164,64202
"4970","ENSMODG00000006693","6",120297473,120317695,20222
"4971","ENSMODG00000006694","2",509024067,509504732,480665
"4972","ENSMODG00000006695","3",155729099,155802010,72911
"4973","ENSMODG00000006696","6",59600676,59617622,16946
"4974","ENSMODG00000006697","1",79198019,79319564,121545
"4975","ENSMODG00000006698","4",341935171,342684142,748971
"4976","ENSMODG00000006700","3",155898652,155903479,4827
"4977","ENSMODG00000006701","2",144882787,145007932,125145
"4978","ENSMODG00000006702","8",233639962,233641181,1219
"4979","ENSMODG00000006703","4",342287999,342289102,1103
"4980","ENSMODG00000006704","5",243277599,243305300,27701
"4981","ENSMODG00000006705","3",429424989,429434088,9099
"4982","ENSMODG00000006706","1",454995613,455012403,16790
"4983","ENSMODG00000006707","1",593552063,593680246,128183
"4984","ENSMODG00000006708","2",215456406,215553062,96656
"4985","ENSMODG00000006709","1",79387049,79387924,875
"4986","ENSMODG00000006711","Un",54970356,54973503,3147
"4987","ENSMODG00000006712","Un",30212587,30217098,4511
"4988","ENSMODG00000006713","2",103753650,103763242,9592
"4989","ENSMODG00000006714","8",233724149,233735033,10884
"4990","ENSMODG00000006716","1",592578322,592623133,44811
"4991","ENSMODG00000006717","6",120317022,120352066,35044
"4992","ENSMODG00000006721","5",243322297,243585577,263280
"4993","ENSMODG00000006722","1",683713015,683734761,21746
"4994","ENSMODG00000006723","2",215367093,215442943,75850
"4995","ENSMODG00000006724","1",455013252,455047092,33840
"4996","ENSMODG00000006727","6",120357378,120372267,14889
"4997","ENSMODG00000006728","8",236239285,236240403,1118
"4998","ENSMODG00000006729","2",75480651,76241337,760686
"4999","ENSMODG00000006730","6",59619554,59637734,18180
"5000","ENSMODG00000006731","1",455062442,455063530,1088
"5001","ENSMODG00000006732","1",683677433,683683215,5782
"5002","ENSMODG00000006733","2",255395725,255410204,14479
"5003","ENSMODG00000006734","5",243595149,243674520,79371
"5004","ENSMODG00000006735","2",215269468,215354660,85192
"5005","ENSMODG00000006736","2",103771506,103780342,8836
"5006","ENSMODG00000006737","8",236916114,236918243,2129
"5007","ENSMODG00000006738","1",79429575,79491634,62059
"5008","ENSMODG00000006739","4",342405284,342454205,48921
"5009","ENSMODG00000006740","1",592035989,592516757,480768
"5010","ENSMODG00000006741","1",250685305,250878629,193324
"5011","ENSMODG00000006743","1",370201752,370581301,379549
"5012","ENSMODG00000006745","6",120372071,120390298,18227
"5013","ENSMODG00000006746","8",236948779,236956420,7641
"5014","ENSMODG00000006749","5",243688363,243691067,2704
"5015","ENSMODG00000006750","1",79662147,79668120,5973
"5016","ENSMODG00000006752","1",455787160,455797902,10742
"5017","ENSMODG00000006753","1",592483330,592484303,973
"5018","ENSMODG00000006754","6",120399735,120441752,42017
"5019","ENSMODG00000006756","4",342546854,342580170,33316
"5020","ENSMODG00000006758","8",16827603,16861659,34056
"5021","ENSMODG00000006759","3",429305534,429331791,26257
"5022","ENSMODG00000006761","1",455800409,455808613,8204
"5023","ENSMODG00000006764","8",236992150,237253985,261835
"5024","ENSMODG00000006765","2",145539334,145540288,954
"5025","ENSMODG00000006766","1",370057219,370094186,36967
"5026","ENSMODG00000006768","1",250881826,250973847,92021
"5027","ENSMODG00000006770","3",429304325,429305407,1082
"5028","ENSMODG00000006771","2",442821557,442978064,156507
"5029","ENSMODG00000006772","1",455898361,455964292,65931
"5030","ENSMODG00000006774","8",16906362,17147189,240827
"5031","ENSMODG00000006775","1",683587156,683626483,39327
"5032","ENSMODG00000006776","1",455979011,456012033,33022
"5033","ENSMODG00000006777","3",158717783,158921010,203227
"5034","ENSMODG00000006778","3",362602903,362608494,5591
"5035","ENSMODG00000006779","2",103779439,103825039,45600
"5036","ENSMODG00000006780","1",79802773,79929960,127187
"5037","ENSMODG00000006782","6",120449621,120500444,50823
"5038","ENSMODG00000006783","Un",54982286,55000099,17813
"5039","ENSMODG00000006785","3",429176551,429305895,129344
"5040","ENSMODG00000006787","2",76894030,76902388,8358
"5041","ENSMODG00000006788","1",683528242,683529861,1619
"5042","ENSMODG00000006789","1",456067741,456077062,9321
"5043","ENSMODG00000006790","8",17179240,17206407,27167
"5044","ENSMODG00000006791","5",243797185,243902268,105083
"5045","ENSMODG00000006792","1",251021638,251078636,56998
"5046","ENSMODG00000006795","2",103834058,103845973,11915
"5047","ENSMODG00000006797","2",77175047,77275261,100214
"5048","ENSMODG00000006798","1",80101154,80166799,65645
"5049","ENSMODG00000006799","Un",30306352,30310363,4011
"5050","ENSMODG00000006801","6",59722360,59770142,47782
"5051","ENSMODG00000006802","8",17206909,17211642,4733
"5052","ENSMODG00000006804","3",362563218,362567765,4547
"5053","ENSMODG00000006805","3",160377329,160402651,25322
"5054","ENSMODG00000006806","2",442667706,442715467,47761
"5055","ENSMODG00000006807","3",429298607,429301524,2917
"5056","ENSMODG00000006809","2",215261662,215275336,13674
"5057","ENSMODG00000006810","1",456079086,456086845,7759
"5058","ENSMODG00000006811","1",169571065,169581193,10128
"5059","ENSMODG00000006812","8",17217416,17222298,4882
"5060","ENSMODG00000006813","X",22773122,22773606,484
"5061","ENSMODG00000006814","4",342820867,342826459,5592
"5062","ENSMODG00000006815","Un",50821406,50821795,389
"5063","ENSMODG00000006816","1",683446097,683466519,20422
"5064","ENSMODG00000006817","2",145775632,146152679,377047
"5065","ENSMODG00000006818","2",215110276,215148207,37931
"5066","ENSMODG00000006819","6",120528806,120621751,92945
"5067","ENSMODG00000006820","1",251106776,251156338,49562
"5068","ENSMODG00000006821","1",369863940,369968591,104651
"5069","ENSMODG00000006823","3",448535109,448644960,109851
"5070","ENSMODG00000006825","6",120674100,120675004,904
"5071","ENSMODG00000006826","2",509803796,510312986,509190
"5072","ENSMODG00000006827","1",80527913,80539906,11993
"5073","ENSMODG00000006829","2",77311456,77339351,27895
"5074","ENSMODG00000006830","1",169564173,169566007,1834
"5075","ENSMODG00000006832","1",456093299,456099873,6574
"5076","ENSMODG00000006833","6",59804740,59835425,30685
"5077","ENSMODG00000006834","2",214952068,214963349,11281
"5078","ENSMODG00000006835","1",369431231,369443804,12573
"5079","ENSMODG00000006836","3",429289761,429293667,3906
"5080","ENSMODG00000006837","3",448664093,448691001,26908
"5081","ENSMODG00000006838","1",683374070,683423904,49834
"5082","ENSMODG00000006840","3",362351190,362551424,200234
"5083","ENSMODG00000006841","5",243930913,243983222,52309
"5084","ENSMODG00000006842","2",146250061,146274396,24335
"5085","ENSMODG00000006844","3",448727061,448768131,41070
"5086","ENSMODG00000006845","2",103846958,103979745,132787
"5087","ENSMODG00000006846","2",214914867,214924605,9738
"5088","ENSMODG00000006847","8",17277179,17291795,14616
"5089","ENSMODG00000006848","3",362214772,362317514,102742
"5090","ENSMODG00000006849","1",683099215,683350005,250790
"5091","ENSMODG00000006850","2",77355995,77362733,6738
"5092","ENSMODG00000006851","1",169552930,169562749,9819
"5093","ENSMODG00000006852","2",255369045,255387821,18776
"5094","ENSMODG00000006854","6",59863939,59911893,47954
"5095","ENSMODG00000006855","3",502140515,502176965,36450
"5096","ENSMODG00000006856","2",510556568,510671168,114600
"5097","ENSMODG00000006857","6",120757228,120786192,28964
"5098","ENSMODG00000006858","2",214886934,214911347,24413
"5099","ENSMODG00000006861","1",251225297,251289901,64604
"5100","ENSMODG00000006862","4",343077739,343139993,62254
"5101","ENSMODG00000006863","1",80548075,80575263,27188
"5102","ENSMODG00000006865","3",362071452,362139594,68142
"5103","ENSMODG00000006867","2",214877901,214883400,5499
"5104","ENSMODG00000006868","2",77415606,77481605,65999
"5105","ENSMODG00000006869","3",448771763,448780567,8804
"5106","ENSMODG00000006871","3",360769048,361461138,692090
"5107","ENSMODG00000006872","8",17405581,17464803,59222
"5108","ENSMODG00000006873","1",683250509,683295864,45355
"5109","ENSMODG00000006874","1",80587782,80670256,82474
"5110","ENSMODG00000006875","6",120903346,121051224,147878
"5111","ENSMODG00000006876","2",255294111,255307593,13482
"5112","ENSMODG00000006877","2",146299085,146339986,40901
"5113","ENSMODG00000006878","2",214789867,214878572,88705
"5114","ENSMODG00000006879","1",369179019,369258047,79028
"5115","ENSMODG00000006880","2",513681244,513707471,26227
"5116","ENSMODG00000006881","2",104006145,104062014,55869
"5117","ENSMODG00000006882","3",360606789,360737224,130435
"5118","ENSMODG00000006883","6",121553933,121709992,156059
"5119","ENSMODG00000006884","3",448781919,448786527,4608
"5120","ENSMODG00000006885","1",683135991,683199613,63622
"5121","ENSMODG00000006886","8",17511954,17512783,829
"5122","ENSMODG00000006887","3",161061551,161254937,193386
"5123","ENSMODG00000006888","3",429277057,429286330,9273
"5124","ENSMODG00000006889","1",251299757,251323742,23985
"5125","ENSMODG00000006890","1",368950032,368955049,5017
"5126","ENSMODG00000006892","2",513807010,513807945,935
"5127","ENSMODG00000006893","1",682804835,683120380,315545
"5128","ENSMODG00000006894","3",429271527,429273651,2124
"5129","ENSMODG00000006895","3",332167846,332168493,647
"5130","ENSMODG00000006897","3",448803759,448821318,17559
"5131","ENSMODG00000006898","6",122399037,122403315,4278
"5132","ENSMODG00000006899","Un",80363330,80364118,788
"5133","ENSMODG00000006900","8",237435512,237492307,56795
"5134","ENSMODG00000006901","2",77637273,77704121,66848
"5135","ENSMODG00000006902","3",161257485,161300589,43104
"5136","ENSMODG00000006903","1",2926120,3057520,131400
"5137","ENSMODG00000006905","1",682968565,682998805,30240
"5138","ENSMODG00000006906","1",3349040,3350913,1873
"5139","ENSMODG00000006907","2",513877249,513976946,99697
"5140","ENSMODG00000006908","1",169498857,169499300,443
"5141","ENSMODG00000006910","3",161737961,161738586,625
"5142","ENSMODG00000006911","1",3462313,3480918,18605
"5143","ENSMODG00000006913","3",429224189,429230980,6791
"5144","ENSMODG00000006914","8",17580064,17582793,2729
"5145","ENSMODG00000006915","2",214755106,214785400,30294
"5146","ENSMODG00000006916","1",456112733,456146566,33833
"5147","ENSMODG00000006917","6",122404897,122478511,73614
"5148","ENSMODG00000006918","2",442563452,442614654,51202
"5149","ENSMODG00000006919","3",448853795,448941311,87516
"5150","ENSMODG00000006921","2",513988471,514006130,17659
"5151","ENSMODG00000006922","2",255278882,255285979,7097
"5152","ENSMODG00000006925","Un",50120563,50402961,282398
"5153","ENSMODG00000006926","2",255206365,255207996,1631
"5154","ENSMODG00000006927","3",448946923,448972582,25659
"5155","ENSMODG00000006929","2",146367236,146586586,219350
"5156","ENSMODG00000006932","8",17516579,17579657,63078
"5157","ENSMODG00000006934","2",255198794,255204015,5221
"5158","ENSMODG00000006935","3",448990125,449122360,132235
"5159","ENSMODG00000006936","8",17582992,17585493,2501
"5160","ENSMODG00000006937","3",162031714,162065734,34020
"5161","ENSMODG00000006938","Un",49417111,49443484,26373
"5162","ENSMODG00000006939","6",122479914,122520877,40963
"5163","ENSMODG00000006940","3",360299692,360362097,62405
"5164","ENSMODG00000006941","1",3583080,3604733,21653
"5165","ENSMODG00000006942","2",214738526,214750023,11497
"5166","ENSMODG00000006943","2",146605414,146676297,70883
"5167","ENSMODG00000006944","8",237642293,237768017,125724
"5168","ENSMODG00000006945","4",343170764,343180115,9351
"5169","ENSMODG00000006946","1",591824364,591877513,53149
"5170","ENSMODG00000006947","6",122549851,122550665,814
"5171","ENSMODG00000006948","1",169189243,169189695,452
"5172","ENSMODG00000006950","3",162157865,162254789,96924
"5173","ENSMODG00000006951","2",255190199,255196263,6064
"5174","ENSMODG00000006952","2",514010360,514033965,23605
"5175","ENSMODG00000006953","1",3619840,3637397,17557
"5176","ENSMODG00000006955","2",77719530,77762539,43009
"5177","ENSMODG00000006956","1",682757432,682783072,25640
"5178","ENSMODG00000006958","3",162436586,162437029,443
"5179","ENSMODG00000006959","3",429206907,429218946,12039
"5180","ENSMODG00000006961","3",162532427,162539822,7395
"5181","ENSMODG00000006962","2",255169821,255189507,19686
"5182","ENSMODG00000006963","6",246644252,246869331,225079
"5183","ENSMODG00000006965","1",169072452,169072883,431
"5184","ENSMODG00000006966","3",360240739,360300176,59437
"5185","ENSMODG00000006968","4",405374555,405375953,1398
"5186","ENSMODG00000006970","3",162568351,162584455,16104
"5187","ENSMODG00000006971","6",59973490,59978658,5168
"5188","ENSMODG00000006972","1",169065256,169065738,482
"5189","ENSMODG00000006973","2",77770344,77959896,189552
"5190","ENSMODG00000006974","3",360216181,360228580,12399
"5191","ENSMODG00000006976","3",449214713,449309952,95239
"5192","ENSMODG00000006978","3",429184387,429188627,4240
"5193","ENSMODG00000006980","3",360027886,360084273,56387
"5194","ENSMODG00000006983","4",343142950,343157772,14822
"5195","ENSMODG00000006984","3",358822595,358853900,31305
"5196","ENSMODG00000006985","X",23023487,23024173,686
"5197","ENSMODG00000006986","3",449328776,449340606,11830
"5198","ENSMODG00000006987","6",246958753,247267648,308895
"5199","ENSMODG00000006988","3",358575794,358616686,40892
"5200","ENSMODG00000006989","2",146672873,146726004,53131
"5201","ENSMODG00000006990","X",23143527,23144747,1220
"5202","ENSMODG00000006993","8",17677552,17787820,110268
"5203","ENSMODG00000006995","5",244004688,244139106,134418
"5204","ENSMODG00000006996","1",680373392,680427419,54027
"5205","ENSMODG00000006997","3",429172733,429181784,9051
"5206","ENSMODG00000006998","1",456156765,456347250,190485
"5207","ENSMODG00000006999","Un",76789549,76798767,9218
"5208","ENSMODG00000007000","1",251863714,252100270,236556
"5209","ENSMODG00000007001","3",358450371,358454776,4405
"5210","ENSMODG00000007002","3",449342080,449353741,11661
"5211","ENSMODG00000007003","5",183719611,183883549,163938
"5212","ENSMODG00000007004","5",244145228,244146427,1199
"5213","ENSMODG00000007005","2",77960272,78127082,166810
"5214","ENSMODG00000007006","3",449347977,449353122,5145
"5215","ENSMODG00000007007","6",122554899,122572673,17774
"5216","ENSMODG00000007009","2",255132168,255164705,32537
"5217","ENSMODG00000007011","6",247434279,247458414,24135
"5218","ENSMODG00000007012","5",301645958,301661339,15381
"5219","ENSMODG00000007013","6",122604690,122605574,884
"5220","ENSMODG00000007014","2",146745041,146785406,40365
"5221","ENSMODG00000007015","5",244176566,244214063,37497
"5222","ENSMODG00000007016","6",59977206,60018139,40933
"5223","ENSMODG00000007018","6",247462496,247468835,6339
"5224","ENSMODG00000007020","2",214645958,214668651,22693
"5225","ENSMODG00000007021","4",343249569,343390458,140889
"5226","ENSMODG00000007022","2",514054704,514134344,79640
"5227","ENSMODG00000007023","6",122605834,122610255,4421
"5228","ENSMODG00000007024","8",17791401,17797002,5601
"5229","ENSMODG00000007025","3",358418499,358432137,13638
"5230","ENSMODG00000007027","2",147260987,147262203,1216
"5231","ENSMODG00000007030","8",17804586,17805767,1181
"5232","ENSMODG00000007031","4",343427383,343428549,1166
"5233","ENSMODG00000007032","6",60015894,60033771,17877
"5234","ENSMODG00000007034","1",168865082,168865552,470
"5235","ENSMODG00000007035","2",214595970,214608173,12203
"5236","ENSMODG00000007036","2",255063014,255074208,11194
"5237","ENSMODG00000007037","8",17809175,17809994,819
"5238","ENSMODG00000007038","2",514244134,514292456,48322
"5239","ENSMODG00000007039","2",78178509,78256787,78278
"5240","ENSMODG00000007041","1",456362023,456464864,102841
"5241","ENSMODG00000007044","Un",69032182,69046984,14802
"5242","ENSMODG00000007046","1",252946655,253140206,193551
"5243","ENSMODG00000007047","6",247477159,247578226,101067
"5244","ENSMODG00000007049","1",368378184,368937995,559811
"5245","ENSMODG00000007050","8",17818074,17821084,3010
"5246","ENSMODG00000007051","4",343499932,343601969,102037
"5247","ENSMODG00000007053","1",168735998,168740536,4538
"5248","ENSMODG00000007054","2",214582668,214592962,10294
"5249","ENSMODG00000007055","3",449478663,449507635,28972
"5250","ENSMODG00000007056","8",17826561,17833865,7304
"5251","ENSMODG00000007057","2",78259385,78483431,224046
"5252","ENSMODG00000007058","5",301680801,301713245,32444
"5253","ENSMODG00000007059","6",60033856,60078377,44521
"5254","ENSMODG00000007061","4",404520770,404686173,165403
"5255","ENSMODG00000007062","5",244353104,244453008,99904
"5256","ENSMODG00000007063","4",343673631,343674563,932
"5257","ENSMODG00000007065","1",368682787,368712810,30023
"5258","ENSMODG00000007066","1",456510077,456597688,87611
"5259","ENSMODG00000007067","2",255047450,255055119,7669
"5260","ENSMODG00000007068","Un",53293228,53293942,714
"5261","ENSMODG00000007069","8",237951408,238686285,734877
"5262","ENSMODG00000007070","6",60085376,60105367,19991
"5263","ENSMODG00000007071","4",343783672,343785488,1816
"5264","ENSMODG00000007072","4",34953142,34958002,4860
"5265","ENSMODG00000007075","2",214568792,214577112,8320
"5266","ENSMODG00000007076","6",60116320,60138902,22582
"5267","ENSMODG00000007077","3",449508795,449533184,24389
"5268","ENSMODG00000007078","5",244455828,244459910,4082
"5269","ENSMODG00000007081","4",343834885,343835838,953
"5270","ENSMODG00000007084","2",147310608,147703214,392606
"5271","ENSMODG00000007086","1",368332160,368351140,18980
"5272","ENSMODG00000007089","3",449536253,449586969,50716
"5273","ENSMODG00000007090","2",255039675,255044464,4789
"5274","ENSMODG00000007092","2",264670209,264798792,128583
"5275","ENSMODG00000007097","4",343863772,343864728,956
"5276","ENSMODG00000007098","Un",55476626,55476988,362
"5277","ENSMODG00000007099","3",358362575,358417689,55114
"5278","ENSMODG00000007100","2",442405648,442549561,143913
"5279","ENSMODG00000007102","2",148088638,148573010,484372
"5280","ENSMODG00000007103","1",253625621,253836428,210807
"5281","ENSMODG00000007108","1",168717940,168720763,2823
"5282","ENSMODG00000007109","3",524112433,524112906,473
"5283","ENSMODG00000007110","2",214535097,214564773,29676
"5284","ENSMODG00000007111","2",264633728,264665079,31351
"5285","ENSMODG00000007112","3",162930889,163181478,250589
"5286","ENSMODG00000007113","2",255036153,255039231,3078
"5287","ENSMODG00000007116","8",10415080,10440743,25663
"5288","ENSMODG00000007119","2",150334152,150335151,999
"5289","ENSMODG00000007121","2",214492511,214516794,24283
"5290","ENSMODG00000007122","2",264617724,264625503,7779
"5291","ENSMODG00000007123","8",26533721,26568340,34619
"5292","ENSMODG00000007124","3",163295827,163336602,40775
"5293","ENSMODG00000007125","1",168714174,168717049,2875
"5294","ENSMODG00000007126","2",214447831,214460906,13075
"5295","ENSMODG00000007130","4",343939243,343958789,19546
"5296","ENSMODG00000007131","6",247618614,247814852,196238
"5297","ENSMODG00000007132","8",10447519,10456665,9146
"5298","ENSMODG00000007134","2",255027874,255033387,5513
"5299","ENSMODG00000007135","2",264463080,264542181,79101
"5300","ENSMODG00000007136","3",163338509,163342767,4258
"5301","ENSMODG00000007137","2",214399655,214409246,9591
"5302","ENSMODG00000007138","5",244490871,244767494,276623
"5303","ENSMODG00000007139","2",78581815,78637060,55245
"5304","ENSMODG00000007140","8",26891178,26972532,81354
"5305","ENSMODG00000007141","3",524041552,524046781,5229
"5306","ENSMODG00000007142","1",168708291,168714513,6222
"5307","ENSMODG00000007143","2",264368961,264369724,763
"5308","ENSMODG00000007144","3",163574294,163634223,59929
"5309","ENSMODG00000007145","8",10507883,10512875,4992
"5310","ENSMODG00000007146","2",214377888,214400163,22275
"5311","ENSMODG00000007147","5",244776582,244795507,18925
"5312","ENSMODG00000007149","1",253942730,254064831,122101
"5313","ENSMODG00000007150","3",523783167,523793313,10146
"5314","ENSMODG00000007151","4",344000624,344088111,87487
"5315","ENSMODG00000007152","3",163783201,164048240,265039
"5316","ENSMODG00000007153","1",168683351,168691398,8047
"5317","ENSMODG00000007154","1",677642465,677698383,55918
"5318","ENSMODG00000007155","3",358289507,358344996,55489
"5319","ENSMODG00000007156","2",442150496,442163968,13472
"5320","ENSMODG00000007157","1",168488496,168495862,7366
"5321","ENSMODG00000007158","2",214348434,214376806,28372
"5322","ENSMODG00000007159","1",254151763,254207228,55465
"5323","ENSMODG00000007162","3",449587380,449667630,80250
"5324","ENSMODG00000007163","4",344106776,344241094,134318
"5325","ENSMODG00000007165","1",367164291,367513187,348896
"5326","ENSMODG00000007167","8",10517458,10533662,16204
"5327","ENSMODG00000007169","5",301769209,301886460,117251
"5328","ENSMODG00000007170","2",214287989,214302461,14472
"5329","ENSMODG00000007171","1",168604319,168623206,18887
"5330","ENSMODG00000007172","2",214250559,214286138,35579
"5331","ENSMODG00000007174","1",254330324,254353009,22685
"5332","ENSMODG00000007175","3",523958081,523965694,7613
"5333","ENSMODG00000007176","4",344306534,344394457,87923
"5334","ENSMODG00000007179","2",255016382,255023404,7022
"5335","ENSMODG00000007181","6",247987256,248117730,130474
"5336","ENSMODG00000007182","1",367061132,367076910,15778
"5337","ENSMODG00000007184","2",78637819,78677449,39630
"5338","ENSMODG00000007185","5",301923441,301924525,1084
"5339","ENSMODG00000007186","6",60189057,60428221,239164
"5340","ENSMODG00000007187","2",214248153,214249899,1746
"5341","ENSMODG00000007188","X",23731815,23750857,19042
"5342","ENSMODG00000007189","3",449792850,449933183,140333
"5343","ENSMODG00000007190","X",23797348,23800569,3221
"5344","ENSMODG00000007194","2",78707433,78716901,9468
"5345","ENSMODG00000007196","4",344492785,344564408,71623
"5346","ENSMODG00000007197","2",214230152,214245358,15206
"5347","ENSMODG00000007199","4",35342700,36497945,1155245
"5348","ENSMODG00000007200","1",168551510,168604505,52995
"5349","ENSMODG00000007201","3",449982166,449996993,14827
"5350","ENSMODG00000007202","4",344651441,344655012,3571
"5351","ENSMODG00000007203","X",24969613,24974282,4669
"5352","ENSMODG00000007204","1",591645339,591697975,52636
"5353","ENSMODG00000007205","1",81573166,81573706,540
"5354","ENSMODG00000007206","2",78726352,78727389,1037
"5355","ENSMODG00000007207","6",60448158,60657082,208924
"5356","ENSMODG00000007208","2",254919533,254924289,4756
"5357","ENSMODG00000007209","4",344689265,344689600,335
"5358","ENSMODG00000007211","X",24996463,24998565,2102
"5359","ENSMODG00000007212","3",450011374,450047828,36454
"5360","ENSMODG00000007213","1",254365503,254367626,2123
"5361","ENSMODG00000007215","3",164616516,164679636,63120
"5362","ENSMODG00000007217","4",37331195,37332147,952
"5363","ENSMODG00000007218","1",591580852,591624446,43594
"5364","ENSMODG00000007219","8",26990778,27018505,27727
"5365","ENSMODG00000007220","3",523886211,523894322,8111
"5366","ENSMODG00000007222","2",214167623,214180811,13188
"5367","ENSMODG00000007224","5",245026241,245537729,511488
"5368","ENSMODG00000007225","3",164891886,164896519,4633
"5369","ENSMODG00000007226","2",151417178,151419307,2129
"5370","ENSMODG00000007227","1",591437139,591479709,42570
"5371","ENSMODG00000007228","1",168421695,168440565,18870
"5372","ENSMODG00000007229","3",450049770,450072571,22801
"5373","ENSMODG00000007230","8",27039885,27051735,11850
"5374","ENSMODG00000007231","2",264201817,264309581,107764
"5375","ENSMODG00000007232","6",248470833,248663242,192409
"5376","ENSMODG00000007233","1",254403969,254406245,2276
"5377","ENSMODG00000007235","1",591364172,591399819,35647
"5378","ENSMODG00000007236","5",246433910,246612159,178249
"5379","ENSMODG00000007237","6",60486879,60503762,16883
"5380","ENSMODG00000007239","1",367032231,367043272,11041
"5381","ENSMODG00000007240","5",302037169,302176038,138869
"5382","ENSMODG00000007241","1",677557999,677560921,2922
"5383","ENSMODG00000007242","6",60509506,60528935,19429
"5384","ENSMODG00000007244","5",302200003,302201364,1361
"5385","ENSMODG00000007245","1",168405539,168420669,15130
"5386","ENSMODG00000007246","2",214027241,214047860,20619
"5387","ENSMODG00000007249","1",254512547,254716822,204275
"5388","ENSMODG00000007250","3",450324224,450325159,935
"5389","ENSMODG00000007251","5",246647077,246653403,6326
"5390","ENSMODG00000007252","4",385817954,385822957,5003
"5391","ENSMODG00000007253","8",10534597,10611720,77123
"5392","ENSMODG00000007259","6",60551368,60566076,14708
"5393","ENSMODG00000007260","1",676512625,676513791,1166
"5394","ENSMODG00000007262","6",122610996,122636540,25544
"5395","ENSMODG00000007263","1",676481324,676482010,686
"5396","ENSMODG00000007264","2",254896228,254902680,6452
"5397","ENSMODG00000007265","8",10611526,10640334,28808
"5398","ENSMODG00000007266","6",60613779,60923801,310022
"5399","ENSMODG00000007267","8",27066641,27112353,45712
"5400","ENSMODG00000007268","3",358183979,358284239,100260
"5401","ENSMODG00000007269","6",248682849,248806917,124068
"5402","ENSMODG00000007271","2",254791406,254894922,103516
"5403","ENSMODG00000007272","2",78909101,79074293,165192
"5404","ENSMODG00000007273","5",246670762,246684993,14231
"5405","ENSMODG00000007275","6",249365219,249430176,64957
"5406","ENSMODG00000007277","6",122637125,122642117,4992
"5407","ENSMODG00000007280","5",246685068,246870539,185471
"5408","ENSMODG00000007281","5",302257615,302258551,936
"5409","ENSMODG00000007282","2",214014458,214030624,16166
"5410","ENSMODG00000007283","1",81709815,81808714,98899
"5411","ENSMODG00000007284","8",10664859,10739275,74416
"5412","ENSMODG00000007285","2",264088192,264194209,106017
"5413","ENSMODG00000007286","3",165457073,165672010,214937
"5414","ENSMODG00000007288","5",246860267,246861264,997
"5415","ENSMODG00000007289","6",249378042,249409898,31856
"5416","ENSMODG00000007290","2",213994046,213998490,4444
"5417","ENSMODG00000007291","2",264141178,264141601,423
"5418","ENSMODG00000007292","1",366872400,366902474,30074
"5419","ENSMODG00000007296","1",254739854,254971277,231423
"5420","ENSMODG00000007297","3",166177091,166247556,70465
"5421","ENSMODG00000007299","2",79078887,79223803,144916
"5422","ENSMODG00000007300","6",60816967,60817549,582
"5423","ENSMODG00000007301","1",81918586,81994457,75871
"5424","ENSMODG00000007303","5",246993103,247006920,13817
"5425","ENSMODG00000007304","8",10768149,10853487,85338
"5426","ENSMODG00000007305","2",213989316,213992642,3326
"5427","ENSMODG00000007306","4",40421571,40422368,797
"5428","ENSMODG00000007310","1",255244645,255457959,213314
"5429","ENSMODG00000007311","4",41443089,41455543,12454
"5430","ENSMODG00000007312","1",674554240,675147046,592806
"5431","ENSMODG00000007313","6",249413215,249427710,14495
"5432","ENSMODG00000007315","2",263930355,263986910,56555
"5433","ENSMODG00000007316","3",166266667,166315630,48963
"5434","ENSMODG00000007319","6",249430297,249441664,11367
"5435","ENSMODG00000007320","3",358015670,358101166,85496
"5436","ENSMODG00000007321","1",366795899,366827174,31275
"5437","ENSMODG00000007323","8",27147589,27193873,46284
"5438","ENSMODG00000007327","8",10737649,11015181,277532
"5439","ENSMODG00000007328","2",213961519,213986361,24842
"5440","ENSMODG00000007330","3",357895188,357901696,6508
"5441","ENSMODG00000007331","1",591329669,591338507,8838
"5442","ENSMODG00000007332","2",79703455,79930047,226592
"5443","ENSMODG00000007333","8",11270239,11276607,6368
"5444","ENSMODG00000007334","1",255465118,255567575,102457
"5445","ENSMODG00000007335","5",247009820,247049091,39271
"5446","ENSMODG00000007336","4",344791738,344864415,72677
"5447","ENSMODG00000007337","8",27381993,27386986,4993
"5448","ENSMODG00000007340","5",302417778,302418977,1199
"5449","ENSMODG00000007342","2",213770552,213879222,108670
"5450","ENSMODG00000007343","3",357804112,357923978,119866
"5451","ENSMODG00000007344","5",302460393,302461397,1004
"5452","ENSMODG00000007346","7",95739319,96222611,483292
"5453","ENSMODG00000007348","3",357647228,357662357,15129
"5454","ENSMODG00000007350","1",82052721,82168934,116213
"5455","ENSMODG00000007352","1",255613097,255624192,11095
"5456","ENSMODG00000007353","1",294204217,294204946,729
"5457","ENSMODG00000007354","4",41462657,41808274,345617
"5458","ENSMODG00000007355","1",591245084,591268624,23540
"5459","ENSMODG00000007357","2",80019488,80083627,64139
"5460","ENSMODG00000007358","1",82205758,82218761,13003
"5461","ENSMODG00000007359","5",302563709,302564632,923
"5462","ENSMODG00000007360","5",247309114,247383394,74280
"5463","ENSMODG00000007361","2",442100405,442137347,36942
"5464","ENSMODG00000007363","2",254845674,254853253,7579
"5465","ENSMODG00000007364","5",302772004,302773926,1922
"5466","ENSMODG00000007365","8",11527801,11570901,43100
"5467","ENSMODG00000007366","2",80114224,80325283,211059
"5468","ENSMODG00000007369","6",249445689,249490080,44391
"5469","ENSMODG00000007370","5",302732564,302733969,1405
"5470","ENSMODG00000007371","5",247390802,247427984,37182
"5471","ENSMODG00000007372","2",263372065,263909490,537425
"5472","ENSMODG00000007375","3",523862074,523871375,9301
"5473","ENSMODG00000007376","3",166603286,166864218,260932
"5474","ENSMODG00000007377","2",442320359,442321336,977
"5475","ENSMODG00000007379","4",41862999,41961016,98017
"5476","ENSMODG00000007382","2",254835690,254842687,6997
"5477","ENSMODG00000007383","1",366633474,366790777,157303
"5478","ENSMODG00000007384","5",302743514,302765207,21693
"5479","ENSMODG00000007385","5",247507697,247580179,72482
"5480","ENSMODG00000007386","3",357511717,357583850,72133
"5481","ENSMODG00000007387","8",27532677,27535336,2659
"5482","ENSMODG00000007388","2",442243855,442244856,1001
"5483","ENSMODG00000007389","2",263676555,263686607,10052
"5484","ENSMODG00000007392","3",523814716,523838043,23327
"5485","ENSMODG00000007393","1",255620768,255663224,42456
"5486","ENSMODG00000007394","5",302798086,302825771,27685
"5487","ENSMODG00000007395","3",166906989,166923567,16578
"5488","ENSMODG00000007396","8",11606089,11632219,26130
"5489","ENSMODG00000007397","4",344881188,344940062,58874
"5490","ENSMODG00000007399","3",357278751,357289131,10380
"5491","ENSMODG00000007401","Un",15043299,15043767,468
"5492","ENSMODG00000007402","3",167275324,167276259,935
"5493","ENSMODG00000007405","2",213629383,213676080,46697
"5494","ENSMODG00000007406","3",504307669,504355872,48203
"5495","ENSMODG00000007407","1",82953215,83008605,55390
"5496","ENSMODG00000007409","Un",76814143,76819007,4864
"5497","ENSMODG00000007410","8",11643630,11656601,12971
"5498","ENSMODG00000007411","2",263194795,263372268,177473
"5499","ENSMODG00000007413","6",249518711,249580578,61867
"5500","ENSMODG00000007414","5",247772848,247989515,216667
"5501","ENSMODG00000007415","3",167174683,167350498,175815
"5502","ENSMODG00000007416","1",591301189,591306209,5020
"5503","ENSMODG00000007417","1",669830682,669844579,13897
"5504","ENSMODG00000007418","4",344944608,345001313,56705
"5505","ENSMODG00000007419","2",263095241,263157090,61849
"5506","ENSMODG00000007420","2",442196794,442225066,28272
"5507","ENSMODG00000007421","2",151715905,152253709,537804
"5508","ENSMODG00000007422","2",80273443,80423673,150230
"5509","ENSMODG00000007423","2",254621182,254770551,149369
"5510","ENSMODG00000007425","7",96728535,96808925,80390
"5511","ENSMODG00000007426","2",213607156,213628739,21583
"5512","ENSMODG00000007427","4",41990185,42139767,149582
"5513","ENSMODG00000007428","2",442189693,442191957,2264
"5514","ENSMODG00000007429","2",254593008,254593729,721
"5515","ENSMODG00000007430","6",122650901,122680085,29184
"5516","ENSMODG00000007431","3",357078923,357153292,74369
"5517","ENSMODG00000007432","7",96881919,96882389,470
"5518","ENSMODG00000007433","8",11657132,11662884,5752
"5519","ENSMODG00000007434","2",254590336,254591409,1073
"5520","ENSMODG00000007436","3",357038220,357040514,2294
"5521","ENSMODG00000007437","1",366092693,366610111,517418
"5522","ENSMODG00000007438","2",213588941,213604112,15171
"5523","ENSMODG00000007439","8",239566290,239744741,178451
"5524","ENSMODG00000007440","2",254583279,254589538,6259
"5525","ENSMODG00000007441","3",167363022,167459634,96612
"5526","ENSMODG00000007442","5",248146118,248264802,118684
"5527","ENSMODG00000007443","6",249613726,249650329,36603
"5528","ENSMODG00000007444","1",365587508,365587735,227
"5529","ENSMODG00000007446","1",669738928,669811619,72691
"5530","ENSMODG00000007447","3",356991581,357034258,42677
"5531","ENSMODG00000007448","4",345001159,345176507,175348
"5532","ENSMODG00000007452","6",249648651,249702399,53748
"5533","ENSMODG00000007454","2",80434542,80486335,51793
"5534","ENSMODG00000007455","8",11666957,11802059,135102
"5535","ENSMODG00000007456","2",41328377,41379437,51060
"5536","ENSMODG00000007458","2",534678693,534859976,181283
"5537","ENSMODG00000007459","2",152682288,152838647,156359
"5538","ENSMODG00000007461","4",345193475,345215879,22404
"5539","ENSMODG00000007462","X",10441164,10453698,12534
"5540","ENSMODG00000007463","6",122691098,122701873,10775
"5541","ENSMODG00000007471","8",11884066,11889223,5157
"5542","ENSMODG00000007472","2",80494585,80623270,128685
"5543","ENSMODG00000007474","2",535057454,535076978,19524
"5544","ENSMODG00000007476","5",303175769,303457772,282003
"5545","ENSMODG00000007477","2",213509274,213588161,78887
"5546","ENSMODG00000007478","2",442158814,442177261,18447
"5547","ENSMODG00000007480","5",248268629,248271975,3346
"5548","ENSMODG00000007482","Un",75191903,75195492,3589
"5549","ENSMODG00000007483","3",168602877,168853990,251113
"5550","ENSMODG00000007485","8",11904670,11912920,8250
"5551","ENSMODG00000007486","6",122703239,122711132,7893
"5552","ENSMODG00000007488","2",213444668,213472761,28093
"5553","ENSMODG00000007489","1",255692628,255789584,96956
"5554","ENSMODG00000007491","8",11922252,11923580,1328
"5555","ENSMODG00000007492","2",262952243,262975468,23225
"5556","ENSMODG00000007494","5",299671414,299690305,18891
"5557","ENSMODG00000007497","2",152866692,152913624,46932
"5558","ENSMODG00000007498","4",345240699,345244428,3729
"5559","ENSMODG00000007499","2",262874569,262917778,43209
"5560","ENSMODG00000007500","3",354759032,354933240,174208
"5561","ENSMODG00000007501","6",122727248,122732469,5221
"5562","ENSMODG00000007502","1",83267029,83533058,266029
"5563","ENSMODG00000007505","1",255794317,255839206,44889
"5564","ENSMODG00000007509","2",254524530,254549901,25371
"5565","ENSMODG00000007511","1",255847718,255863934,16216
"5566","ENSMODG00000007512","4",42453202,42516343,63141
"5567","ENSMODG00000007513","5",299718764,299736399,17635
"5568","ENSMODG00000007517","1",255976785,255978700,1915
"5569","ENSMODG00000007518","3",523802772,523803268,496
"5570","ENSMODG00000007519","2",535817109,536054250,237141
"5571","ENSMODG00000007520","3",524099105,524159723,60618
"5572","ENSMODG00000007521","2",442035911,442047652,11741
"5573","ENSMODG00000007522","X",10852503,10853425,922
"5574","ENSMODG00000007524","5",248279651,248349670,70019
"5575","ENSMODG00000007525","6",122775466,122785662,10196
"5576","ENSMODG00000007528","3",353758675,353941490,182815
"5577","ENSMODG00000007529","1",256007709,256077930,70221
"5578","ENSMODG00000007531","2",536175784,536179762,3978
"5579","ENSMODG00000007532","2",213403572,213447859,44287
"5580","ENSMODG00000007533","1",83605445,83646614,41169
"5581","ENSMODG00000007534","5",248584046,248600444,16398
"5582","ENSMODG00000007536","8",240074433,240105826,31393
"5583","ENSMODG00000007537","3",353565234,353709492,144258
"5584","ENSMODG00000007538","2",536230123,536278792,48669
"5585","ENSMODG00000007539","X",10898392,10919647,21255
"5586","ENSMODG00000007540","2",441422122,441537624,115502
"5587","ENSMODG00000007541","4",42648219,42663517,15298
"5588","ENSMODG00000007542","1",84451047,84479227,28180
"5589","ENSMODG00000007544","5",248611825,248635990,24165
"5590","ENSMODG00000007545","6",122786723,122793581,6858
"5591","ENSMODG00000007546","4",176199227,176343075,143848
"5592","ENSMODG00000007547","4",345248765,345263445,14680
"5593","ENSMODG00000007548","1",84485594,84500857,15263
"5594","ENSMODG00000007551","3",353529070,353546423,17353
"5595","ENSMODG00000007552","1",84504423,84508595,4172
"5596","ENSMODG00000007554","2",254501355,254511990,10635
"5597","ENSMODG00000007557","5",248645262,248675646,30384
"5598","ENSMODG00000007560","2",254493223,254499630,6407
"5599","ENSMODG00000007561","3",353377554,353475033,97479
"5600","ENSMODG00000007562","2",213348819,213404021,55202
"5601","ENSMODG00000007563","6",249816402,249816560,158
"5602","ENSMODG00000007565","3",504152358,504169243,16885
"5603","ENSMODG00000007566","4",177275797,177642930,367133
"5604","ENSMODG00000007568","2",80625061,80643189,18128
"5605","ENSMODG00000007569","4",345275506,345353418,77912
"5606","ENSMODG00000007570","3",353084135,353302205,218070
"5607","ENSMODG00000007571","5",299840301,299855052,14751
"5608","ENSMODG00000007572","5",248691684,248694923,3239
"5609","ENSMODG00000007573","6",122813248,122844562,31314
"5610","ENSMODG00000007574","2",262685122,262866237,181115
"5611","ENSMODG00000007576","4",345364766,345440829,76063
"5612","ENSMODG00000007579","5",248726170,248728838,2668
"5613","ENSMODG00000007582","5",299859978,299862151,2173
"5614","ENSMODG00000007585","2",254461146,254492192,31046
"5615","ENSMODG00000007587","8",11932149,11938078,5929
"5616","ENSMODG00000007588","2",262485327,262485722,395
"5617","ENSMODG00000007590","4",177698997,177699845,848
"5618","ENSMODG00000007591","8",11940130,11940678,548
"5619","ENSMODG00000007592","2",441219264,441356922,137658
"5620","ENSMODG00000007594","4",384514750,384529480,14730
"5621","ENSMODG00000007595","3",169024399,169440015,415616
"5622","ENSMODG00000007596","8",76255650,77368451,1112801
"5623","ENSMODG00000007597","4",384529243,384532013,2770
"5624","ENSMODG00000007600","4",345485515,345563783,78268
"5625","ENSMODG00000007601","5",300000008,300027868,27860
"5626","ENSMODG00000007603","6",250143648,250209748,66100
"5627","ENSMODG00000007604","8",240555042,240622975,67933
"5628","ENSMODG00000007605","2",213271343,213322439,51096
"5629","ENSMODG00000007606","6",122969361,123228698,259337
"5630","ENSMODG00000007607","3",352903675,352931834,28159
"5631","ENSMODG00000007608","4",345685937,345874916,188979
"5632","ENSMODG00000007609","1",360222444,360241056,18612
"5633","ENSMODG00000007612","3",352370221,352370618,397
"5634","ENSMODG00000007613","1",669731114,669732031,917
"5635","ENSMODG00000007615","8",11941103,11946763,5660
"5636","ENSMODG00000007616","5",300214679,300238041,23362
"5637","ENSMODG00000007617","2",441091259,441197774,106515
"5638","ENSMODG00000007619","1",669560402,669561352,950
"5639","ENSMODG00000007620","8",11966516,11977636,11120
"5640","ENSMODG00000007621","2",254427673,254453115,25442
"5641","ENSMODG00000007622","6",60965311,61201170,235859
"5642","ENSMODG00000007623","1",256228527,256415388,186861
"5643","ENSMODG00000007624","4",345890350,345951710,61360
"5644","ENSMODG00000007626","6",250229311,250305263,75952
"5645","ENSMODG00000007627","5",300363318,300399184,35866
"5646","ENSMODG00000007628","3",352163133,352200071,36938
"5647","ENSMODG00000007630","6",250319348,250386437,67089
"5648","ENSMODG00000007631","1",360192446,360213270,20824
"5649","ENSMODG00000007632","8",11995579,12007509,11930
"5650","ENSMODG00000007635","4",384537797,384581350,43553
"5651","ENSMODG00000007637","7",96884425,97456363,571938
"5652","ENSMODG00000007640","2",213236436,213237190,754
"5653","ENSMODG00000007641","1",360185134,360192573,7439
"5654","ENSMODG00000007642","2",440877296,440946081,68785
"5655","ENSMODG00000007644","3",352113834,352162646,48812
"5656","ENSMODG00000007645","6",61230162,61251644,21482
"5657","ENSMODG00000007647","2",440736093,440864434,128341
"5658","ENSMODG00000007648","1",256839645,256970228,130583
"5659","ENSMODG00000007649","4",384582633,384587380,4747
"5660","ENSMODG00000007651","1",360175214,360182148,6934
"5661","ENSMODG00000007652","6",61252430,61298929,46499
"5662","ENSMODG00000007653","4",345975214,346131365,156151
"5663","ENSMODG00000007654","2",440721302,440733835,12533
"5664","ENSMODG00000007656","6",61314531,61393283,78752
"5665","ENSMODG00000007657","8",12006962,12009090,2128
"5666","ENSMODG00000007659","4",346143784,346144561,777
"5667","ENSMODG00000007661","2",440601271,440716978,115707
"5668","ENSMODG00000007663","2",254376349,254394408,18059
"5669","ENSMODG00000007664","4",346319097,346332816,13719
"5670","ENSMODG00000007665","2",262234366,262345151,110785
"5671","ENSMODG00000007666","4",287921712,287953050,31338
"5672","ENSMODG00000007668","6",250458806,250493552,34746
"5673","ENSMODG00000007671","4",384603276,384612581,9305
"5674","ENSMODG00000007674","2",440305934,440565479,259545
"5675","ENSMODG00000007675","8",12007905,12012321,4416
"5676","ENSMODG00000007676","2",440114212,440119370,5158
"5677","ENSMODG00000007677","3",351999115,352045129,46014
"5678","ENSMODG00000007678","4",384612864,384615962,3098
"5679","ENSMODG00000007679","8",76136760,76220702,83942
"5680","ENSMODG00000007680","2",244669617,244670354,737
"5681","ENSMODG00000007681","6",61409361,61492739,83378
"5682","ENSMODG00000007683","8",12026827,12028574,1747
"5683","ENSMODG00000007684","2",213183446,213226252,42806
"5684","ENSMODG00000007685","6",123233453,123455448,221995
"5685","ENSMODG00000007690","3",351926401,351947555,21154
"5686","ENSMODG00000007691","5",300419607,300427054,7447
"5687","ENSMODG00000007694","4",177901296,178232211,330915
"5688","ENSMODG00000007695","1",358301079,358494912,193833
"5689","ENSMODG00000007696","4",42988003,42988852,849
"5690","ENSMODG00000007697","6",61508963,61534375,25412
"5691","ENSMODG00000007698","2",254337861,254363120,25259
"5692","ENSMODG00000007699","4",384617651,384625559,7908
"5693","ENSMODG00000007700","8",76104234,76134477,30243
"5694","ENSMODG00000007703","1",257237792,257346988,109196
"5695","ENSMODG00000007705","2",523355735,523397586,41851
"5696","ENSMODG00000007706","3",351718104,351756164,38060
"5697","ENSMODG00000007707","4",384651126,384656582,5456
"5698","ENSMODG00000007708","2",213156133,213181065,24932
"5699","ENSMODG00000007710","5",300431596,300439483,7887
"5700","ENSMODG00000007711","1",257659833,257672173,12340
"5701","ENSMODG00000007713","4",346577650,346927072,349422
"5702","ENSMODG00000007714","3",169983868,170104478,120610
"5703","ENSMODG00000007716","3",351639403,351690138,50735
"5704","ENSMODG00000007717","8",76091022,76101471,10449
"5705","ENSMODG00000007718","7",97598758,97607416,8658
"5706","ENSMODG00000007719","6",123639055,123642409,3354
"5707","ENSMODG00000007721","8",12069166,12072563,3397
"5708","ENSMODG00000007723","8",76036479,76067792,31313
"5709","ENSMODG00000007725","2",213140426,213153708,13282
"5710","ENSMODG00000007727","1",358038949,358127962,89013
"5711","ENSMODG00000007728","8",76013721,76014983,1262
"5712","ENSMODG00000007729","6",123646868,123653846,6978
"5713","ENSMODG00000007730","5",300440883,300449079,8196
"5714","ENSMODG00000007731","4",287988425,288014627,26202
"5715","ENSMODG00000007732","6",61555026,61625889,70863
"5716","ENSMODG00000007733","7",97617930,97626309,8379
"5717","ENSMODG00000007734","1",258141071,258174798,33727
"5718","ENSMODG00000007735","1",669425832,669426767,935
"5719","ENSMODG00000007736","2",440032740,440107346,74606
"5720","ENSMODG00000007737","5",248772016,248870706,98690
"5721","ENSMODG00000007738","4",288025818,288026272,454
"5722","ENSMODG00000007739","4",346932717,346955018,22301
"5723","ENSMODG00000007742","4",178245864,178339440,93576
"5724","ENSMODG00000007743","2",213113399,213121840,8441
"5725","ENSMODG00000007744","1",167556783,167557724,941
"5726","ENSMODG00000007745","2",523399318,523458526,59208
"5727","ENSMODG00000007746","7",97711210,98062436,351226
"5728","ENSMODG00000007747","4",43048921,43053396,4475
"5729","ENSMODG00000007748","6",123653913,123669978,16065
"5730","ENSMODG00000007749","1",258214890,258233975,19085
"5731","ENSMODG00000007750","1",669516736,669518050,1314
"5732","ENSMODG00000007751","2",523542878,523564795,21917
"5733","ENSMODG00000007752","6",61635624,61669519,33895
"5734","ENSMODG00000007753","4",178356462,178371383,14921
"5735","ENSMODG00000007754","4",346996501,347031638,35137
"5736","ENSMODG00000007755","1",258360808,258404602,43794
"5737","ENSMODG00000007756","2",213075910,213099491,23581
"5738","ENSMODG00000007759","6",123673119,123683195,10076
"5739","ENSMODG00000007760","8",240775154,240844357,69203
"5740","ENSMODG00000007761","6",61669654,61698618,28964
"5741","ENSMODG00000007762","1",258427296,258511838,84542
"5742","ENSMODG00000007766","6",61699203,61752535,53332
"5743","ENSMODG00000007767","8",12164446,12254163,89717
"5744","ENSMODG00000007768","4",43129257,43164514,35257
"5745","ENSMODG00000007769","2",254301714,254318142,16428
"5746","ENSMODG00000007770","5",300449966,300458153,8187
"5747","ENSMODG00000007771","2",213053485,213060401,6916
"5748","ENSMODG00000007772","3",170192230,170343636,151406
"5749","ENSMODG00000007773","4",384663251,384725215,61964
"5750","ENSMODG00000007774","6",61785165,61842737,57572
"5751","ENSMODG00000007777","8",12280969,12289285,8316
"5752","ENSMODG00000007778","1",84651334,84698678,47344
"5753","ENSMODG00000007781","1",357570652,357636376,65724
"5754","ENSMODG00000007782","1",258573432,258863080,289648
"5755","ENSMODG00000007783","2",439869733,440024774,155041
"5756","ENSMODG00000007785","5",300458913,300460245,1332
"5757","ENSMODG00000007786","7",98105513,98186243,80730
"5758","ENSMODG00000007789","6",61830252,61839260,9008
"5759","ENSMODG00000007790","5",248905259,249006081,100822
"5760","ENSMODG00000007791","8",12303438,12322171,18733
"5761","ENSMODG00000007792","2",254267099,254268834,1735
"5762","ENSMODG00000007794","8",74059499,74121653,62154
"5763","ENSMODG00000007796","7",98340074,98341954,1880
"5764","ENSMODG00000007797","8",12372967,12374790,1823
"5765","ENSMODG00000007798","2",254229912,254230541,629
"5766","ENSMODG00000007799","4",43168362,43182976,14614
"5767","ENSMODG00000007800","2",262161757,262211200,49443
"5768","ENSMODG00000007801","5",300460737,300463783,3046
"5769","ENSMODG00000007802","1",84710809,84740870,30061
"5770","ENSMODG00000007803","4",347035768,347140880,105112
"5771","ENSMODG00000007804","5",249045267,249089208,43941
"5772","ENSMODG00000007806","4",384726473,384733669,7196
"5773","ENSMODG00000007807","1",259005592,259134719,129127
"5774","ENSMODG00000007808","1",84739203,84751630,12427
"5775","ENSMODG00000007809","6",123685753,123707193,21440
"5776","ENSMODG00000007810","4",384826602,384834666,8064
"5777","ENSMODG00000007811","4",43534370,43593019,58649
"5778","ENSMODG00000007813","2",213013561,213040850,27289
"5779","ENSMODG00000007814","1",84783854,84814110,30256
"5780","ENSMODG00000007815","6",61866162,61954201,88039
"5781","ENSMODG00000007816","6",123760187,123773124,12937
"5782","ENSMODG00000007817","7",98366505,98686980,320475
"5783","ENSMODG00000007818","4",178449298,178560537,111239
"5784","ENSMODG00000007819","4",43979758,43980357,599
"5785","ENSMODG00000007820","1",259180373,259212983,32610
"5786","ENSMODG00000007821","8",240903765,241032316,128551
"5787","ENSMODG00000007822","2",212926553,213001966,75413
"5788","ENSMODG00000007823","8",73579746,73993051,413305
"5789","ENSMODG00000007824","3",170348449,170476591,128142
"5790","ENSMODG00000007827","4",288202094,288334902,132808
"5791","ENSMODG00000007829","2",254153238,254159477,6239
"5792","ENSMODG00000007831","8",12446080,12647432,201352
"5793","ENSMODG00000007832","6",61980760,62000377,19617
"5794","ENSMODG00000007833","6",251161811,251397932,236121
"5795","ENSMODG00000007835","2",212924056,212928973,4917
"5796","ENSMODG00000007836","5",249151712,249204564,52852
"5797","ENSMODG00000007837","8",73776675,73778696,2021
"5798","ENSMODG00000007838","3",170480002,170503023,23021
"5799","ENSMODG00000007839","1",259241126,259281853,40727
"5800","ENSMODG00000007842","8",12473499,12478411,4912
"5801","ENSMODG00000007843","6",123801238,123811074,9836
"5802","ENSMODG00000007847","8",241255026,241465972,210946
"5803","ENSMODG00000007851","2",262041833,262232927,191094
"5804","ENSMODG00000007852","4",384755152,384767776,12624
"5805","ENSMODG00000007853","3",170522021,170557669,35648
"5806","ENSMODG00000007857","4",288329269,288390256,60987
"5807","ENSMODG00000007858","8",12494023,12497750,3727
"5808","ENSMODG00000007859","8",241940208,241989349,49141
"5809","ENSMODG00000007860","1",357054250,357331008,276758
"5810","ENSMODG00000007861","4",45446022,45718385,272363
"5811","ENSMODG00000007863","1",84800076,84852154,52078
"5812","ENSMODG00000007864","6",251970270,251994770,24500
"5813","ENSMODG00000007865","6",124030508,124032151,1643
"5814","ENSMODG00000007869","5",300465564,300474309,8745
"5815","ENSMODG00000007870","4",347175330,347365967,190637
"5816","ENSMODG00000007871","2",254099113,254140993,41880
"5817","ENSMODG00000007872","8",242171668,242359112,187444
"5818","ENSMODG00000007873","7",98554508,98555575,1067
"5819","ENSMODG00000007874","3",170610419,170640696,30277
"5820","ENSMODG00000007877","3",523716507,523728592,12085
"5821","ENSMODG00000007878","6",62009868,62050609,40741
"5822","ENSMODG00000007879","5",300474405,300480120,5715
"5823","ENSMODG00000007881","1",259315832,259394247,78415
"5824","ENSMODG00000007884","8",12695337,12702804,7467
"5825","ENSMODG00000007885","4",347632461,347634159,1698
"5826","ENSMODG00000007886","4",384834988,384856926,21938
"5827","ENSMODG00000007887","5",300507917,300508648,731
"5828","ENSMODG00000007888","4",178623886,178636125,12239
"5829","ENSMODG00000007889","6",124087503,124103372,15869
"5830","ENSMODG00000007890","8",242831517,242833262,1745
"5831","ENSMODG00000007891","6",252035343,252050675,15332
"5832","ENSMODG00000007892","1",259409414,259420757,11343
"5833","ENSMODG00000007894","4",288389028,288505276,116248
"5834","ENSMODG00000007896","1",669229989,669255100,25111
"5835","ENSMODG00000007897","4",45747405,45812195,64790
"5836","ENSMODG00000007898","1",259421217,259423149,1932
"5837","ENSMODG00000007900","1",85127264,85129568,2304
"5838","ENSMODG00000007901","4",347619156,347662880,43724
"5839","ENSMODG00000007903","4",384859231,384865241,6010
"5840","ENSMODG00000007905","6",252053216,252095974,42758
"5841","ENSMODG00000007907","1",356178228,356333530,155302
"5842","ENSMODG00000007908","6",124104104,124110559,6455
"5843","ENSMODG00000007909","5",249242999,249273407,30408
"5844","ENSMODG00000007910","1",669103948,669114393,10445
"5845","ENSMODG00000007912","4",384874722,384878666,3944
"5846","ENSMODG00000007913","2",261879411,261899343,19932
"5847","ENSMODG00000007914","6",62061156,62115903,54747
"5848","ENSMODG00000007916","1",591006982,591012138,5156
"5849","ENSMODG00000007917","2",261758458,261777115,18657
"5850","ENSMODG00000007919","6",62179463,62180287,824
"5851","ENSMODG00000007920","3",170647242,170729425,82183
"5852","ENSMODG00000007922","5",300510082,300517847,7765
"5853","ENSMODG00000007924","8",243105725,243140340,34615
"5854","ENSMODG00000007925","6",124151108,124157049,5941
"5855","ENSMODG00000007926","4",45917104,45953783,36679
"5856","ENSMODG00000007927","3",170896394,170931331,34937
"5857","ENSMODG00000007928","2",254061301,254086364,25063
"5858","ENSMODG00000007929","5",300523453,300523939,486
"5859","ENSMODG00000007930","1",355935684,355965692,30008
"5860","ENSMODG00000007931","4",384888833,384890818,1985
"5861","ENSMODG00000007933","5",249310059,249325512,15453
"5862","ENSMODG00000007934","4",46025742,46064393,38651
"5863","ENSMODG00000007935","6",252099710,252115352,15642
"5864","ENSMODG00000007936","2",153069613,153126150,56537
"5865","ENSMODG00000007937","4",347742949,347949547,206598
"5866","ENSMODG00000007939","3",349524734,349897973,373239
"5867","ENSMODG00000007941","5",300527228,300536215,8987
"5868","ENSMODG00000007943","2",254039072,254047308,8236
"5869","ENSMODG00000007944","8",73331668,73408874,77206
"5870","ENSMODG00000007947","5",300538212,300547634,9422
"5871","ENSMODG00000007948","1",668880033,669055523,175490
"5872","ENSMODG00000007949","6",252128867,252305071,176204
"5873","ENSMODG00000007952","5",300549994,300550791,797
"5874","ENSMODG00000007953","6",124188302,124212741,24439
"5875","ENSMODG00000007954","8",243191741,243217368,25627
"5876","ENSMODG00000007955","6",252433880,252495224,61344
"5877","ENSMODG00000007957","8",73230106,73331465,101359
"5878","ENSMODG00000007958","5",300574748,300654862,80114
"5879","ENSMODG00000007959","2",439717381,439832553,115172
"5880","ENSMODG00000007961","6",124225849,124226343,494
"5881","ENSMODG00000007962","2",254037341,254042633,5292
"5882","ENSMODG00000007963","2",523631884,523648624,16740
"5883","ENSMODG00000007964","3",170943662,170994810,51148
"5884","ENSMODG00000007965","4",384896005,384903764,7759
"5885","ENSMODG00000007966","1",166299376,166313221,13845
"5886","ENSMODG00000007968","1",355896606,355946769,50163
"5887","ENSMODG00000007969","1",746330304,746331385,1081
"5888","ENSMODG00000007971","2",261629366,261645360,15994
"5889","ENSMODG00000007972","4",384937019,384945643,8624
"5890","ENSMODG00000007975","2",254014909,254021930,7021
"5891","ENSMODG00000007976","2",153139366,153164550,25184
"5892","ENSMODG00000007977","6",124323695,124375395,51700
"5893","ENSMODG00000007978","1",355857485,355873121,15636
"5894","ENSMODG00000007979","2",38476414,38542985,66571
"5895","ENSMODG00000007980","1",166255227,166289344,34117
"5896","ENSMODG00000007981","2",439240572,439566317,325745
"5897","ENSMODG00000007982","6",252644127,252665459,21332
"5898","ENSMODG00000007983","1",590904290,590931606,27316
"5899","ENSMODG00000007984","5",300500062,300686023,185961
"5900","ENSMODG00000007985","2",261670975,261672293,1318
"5901","ENSMODG00000007986","2",153200563,153274831,74268
"5902","ENSMODG00000007987","1",355794480,355848018,53538
"5903","ENSMODG00000007988","2",253953121,253961349,8228
"5904","ENSMODG00000007990","1",746331505,746337741,6236
"5905","ENSMODG00000007991","5",249385918,249463148,77230
"5906","ENSMODG00000007992","2",253914935,253915591,656
"5907","ENSMODG00000007993","4",385012288,385021773,9485
"5908","ENSMODG00000007995","4",288516313,288597453,81140
"5909","ENSMODG00000007996","4",178682001,178935035,253034
"5910","ENSMODG00000007997","8",73052028,73079014,26986
"5911","ENSMODG00000007998","5",300701134,300710046,8912
"5912","ENSMODG00000007999","1",166142211,166176318,34107
"5913","ENSMODG00000008000","1",355736512,355789886,53374
"5914","ENSMODG00000008001","4",46157684,46447752,290068
"5915","ENSMODG00000008002","4",347970531,348004939,34408
"5916","ENSMODG00000008003","5",300710522,300713138,2616
"5917","ENSMODG00000008004","1",355619526,355655374,35848
"5918","ENSMODG00000008005","3",171150972,171186802,35830
"5919","ENSMODG00000008007","1",590682196,590817499,135303
"5920","ENSMODG00000008008","5",300713295,300714069,774
"5921","ENSMODG00000008010","3",347666320,347840168,173848
"5922","ENSMODG00000008013","1",746350849,746362992,12143
"5923","ENSMODG00000008014","2",153360513,153410181,49668
"5924","ENSMODG00000008015","1",355534033,355597857,63824
"5925","ENSMODG00000008017","4",348008774,348014864,6090
"5926","ENSMODG00000008018","6",252693693,252730386,36693
"5927","ENSMODG00000008019","2",253741170,253807094,65924
"5928","ENSMODG00000008020","1",166101666,166145113,43447
"5929","ENSMODG00000008021","8",244168636,244178030,9394
"5930","ENSMODG00000008022","4",179084349,179134757,50408
"5931","ENSMODG00000008023","1",355365847,355488995,123148
"5932","ENSMODG00000008026","6",124424543,124733129,308586
"5933","ENSMODG00000008027","2",261422579,261513390,90811
"5934","ENSMODG00000008028","1",590637115,590645575,8460
"5935","ENSMODG00000008029","4",288615377,288699060,83683
"5936","ENSMODG00000008030","8",73007782,73046956,39174
"5937","ENSMODG00000008031","1",668982108,669016130,34022
"5938","ENSMODG00000008032","4",348055028,348064265,9237
"5939","ENSMODG00000008033","8",12602216,12630795,28579
"5940","ENSMODG00000008034","6",252760642,253120182,359540
"5941","ENSMODG00000008037","2",261225941,261420133,194192
"5942","ENSMODG00000008038","2",523675935,523724546,48611
"5943","ENSMODG00000008039","1",354721228,354728182,6954
"5944","ENSMODG00000008040","3",171499926,171584193,84267
"5945","ENSMODG00000008041","2",38603411,38639215,35804
"5946","ENSMODG00000008042","4",348068711,348078398,9687
"5947","ENSMODG00000008043","X",11000760,11014480,13720
"5948","ENSMODG00000008045","6",124734032,124828947,94915
"5949","ENSMODG00000008046","6",62235905,62394237,158332
"5950","ENSMODG00000008048","6",253372685,253384034,11349
"5951","ENSMODG00000008049","8",72956129,72984828,28699
"5952","ENSMODG00000008051","3",171609543,171673535,63992
"5953","ENSMODG00000008052","4",348175498,348180651,5153
"5954","ENSMODG00000008053","1",165990291,166065276,74985
"5955","ENSMODG00000008055","6",62394699,62442863,48164
"5956","ENSMODG00000008056","8",12683416,12687919,4503
"5957","ENSMODG00000008057","4",348183129,348185809,2680
"5958","ENSMODG00000008058","6",124834639,124890732,56093
"5959","ENSMODG00000008059","3",523466891,523488561,21670
"5960","ENSMODG00000008060","Un",79490045,79490374,329
"5961","ENSMODG00000008061","2",153418863,153524817,105954
"5962","ENSMODG00000008062","1",165940912,165964529,23617
"5963","ENSMODG00000008063","1",354654639,354672371,17732
"5964","ENSMODG00000008064","2",261074174,261180294,106120
"5965","ENSMODG00000008067","3",347592208,347649238,57030
"5966","ENSMODG00000008068","2",438367578,438925352,557774
"5967","ENSMODG00000008069","6",124900055,124900810,755
"5968","ENSMODG00000008070","1",668563691,668691979,128288
"5969","ENSMODG00000008071","2",523756717,523767125,10408
"5970","ENSMODG00000008073","4",179132070,179178682,46612
"5971","ENSMODG00000008074","4",348195141,348391263,196122
"5972","ENSMODG00000008075","6",124954269,124993579,39310
"5973","ENSMODG00000008076","8",12729811,12735127,5316
"5974","ENSMODG00000008077","8",72891490,72956791,65301
"5975","ENSMODG00000008078","1",165761703,165888573,126870
"5976","ENSMODG00000008079","6",253511895,253532236,20341
"5977","ENSMODG00000008083","5",249564007,249999948,435941
"5978","ENSMODG00000008084","8",12735634,12738249,2615
"5979","ENSMODG00000008085","5",300723017,300729936,6919
"5980","ENSMODG00000008086","4",48131578,48236714,105136
"5981","ENSMODG00000008087","4",348208657,348213931,5274
"5982","ENSMODG00000008088","1",590587163,590600163,13000
"5983","ENSMODG00000008089","1",668357326,668375054,17728
"5984","ENSMODG00000008090","1",259444551,259562807,118256
"5985","ENSMODG00000008091","8",72887759,72892364,4605
"5986","ENSMODG00000008092","4",288946493,289030382,83889
"5987","ENSMODG00000008093","1",354469595,354575371,105776
"5988","ENSMODG00000008094","6",125015316,125085875,70559
"5989","ENSMODG00000008095","6",253644003,253652249,8246
"5990","ENSMODG00000008096","5",250094674,250097450,2776
"5991","ENSMODG00000008097","5",300740152,300749623,9471
"5992","ENSMODG00000008099","6",62538358,62579360,41002
"5993","ENSMODG00000008100","3",347516324,347559832,43508
"5994","ENSMODG00000008101","3",464391790,464413404,21614
"5995","ENSMODG00000008102","1",668151722,668275655,123933
"5996","ENSMODG00000008103","4",289097245,289098633,1388
"5997","ENSMODG00000008105","6",62555878,62564354,8476
"5998","ENSMODG00000008106","1",590389798,590391135,1337
"5999","ENSMODG00000008107","2",260883178,261059003,175825
"6000","ENSMODG00000008108","8",72630742,72781227,150485
"6001","ENSMODG00000008109","1",668089257,668096183,6926
"6002","ENSMODG00000008110","4",179227429,179265743,38314
"6003","ENSMODG00000008111","4",289253781,289254233,452
"6004","ENSMODG00000008112","6",125091570,125117500,25930
"6005","ENSMODG00000008113","4",48326185,48326691,506
"6006","ENSMODG00000008117","4",376483748,376500582,16834
"6007","ENSMODG00000008118","8",12748541,12756579,8038
"6008","ENSMODG00000008119","2",153674539,153802069,127530
"6009","ENSMODG00000008120","5",300750395,300763224,12829
"6010","ENSMODG00000008121","1",165560695,165680556,119861
"6011","ENSMODG00000008122","6",125223928,125225027,1099
"6012","ENSMODG00000008123","3",172023063,172082402,59339
"6013","ENSMODG00000008124","1",667588206,668028609,440403
"6014","ENSMODG00000008125","2",38691009,38734175,43166
"6015","ENSMODG00000008126","8",72441099,72465761,24662
"6016","ENSMODG00000008128","6",62578030,62590394,12364
"6017","ENSMODG00000008129","6",125239696,125240349,653
"6018","ENSMODG00000008130","4",376504198,376511721,7523
"6019","ENSMODG00000008131","4",348277024,348324691,47667
"6020","ENSMODG00000008132","3",347357390,347535876,178486
"6021","ENSMODG00000008134","2",38851994,38890381,38387
"6022","ENSMODG00000008136","1",165285347,165465654,180307
"6023","ENSMODG00000008139","4",289491648,289705541,213893
"6024","ENSMODG00000008140","1",259695053,259696307,1254
"6025","ENSMODG00000008141","1",666284686,666299336,14650
"6026","ENSMODG00000008143","6",125364392,125461644,97252
"6027","ENSMODG00000008144","1",165126101,165178704,52603
"6028","ENSMODG00000008145","4",348339081,348443264,104183
"6029","ENSMODG00000008147","4",179300479,179377920,77441
"6030","ENSMODG00000008148","1",259738930,259751754,12824
"6031","ENSMODG00000008149","3",172094335,172134367,40032
"6032","ENSMODG00000008150","1",664835295,664850269,14974
"6033","ENSMODG00000008151","4",289741786,289742871,1085
"6034","ENSMODG00000008152","X",11153442,11247043,93601
"6035","ENSMODG00000008153","3",347106168,347149212,43044
"6036","ENSMODG00000008154","2",38891444,39100240,208796
"6037","ENSMODG00000008155","6",253675679,253676338,659
"6038","ENSMODG00000008156","5",300789421,300794499,5078
"6039","ENSMODG00000008157","8",244246816,244351891,105075
"6040","ENSMODG00000008158","4",48337432,48543580,206148
"6041","ENSMODG00000008159","3",347032091,347060180,28089
"6042","ENSMODG00000008160","8",12756846,12778583,21737
"6043","ENSMODG00000008161","3",523409861,523432116,22255
"6044","ENSMODG00000008162","4",376712420,376882124,169704
"6045","ENSMODG00000008163","2",39442291,39456713,14422
"6046","ENSMODG00000008164","5",300805925,300807316,1391
"6047","ENSMODG00000008165","1",165088233,165120915,32682
"6048","ENSMODG00000008167","2",494856488,494971842,115354
"6049","ENSMODG00000008168","3",172156191,172243060,86869
"6050","ENSMODG00000008169","2",436334215,436421179,86964
"6051","ENSMODG00000008170","1",85178217,85270431,92214
"6052","ENSMODG00000008171","5",250200869,250273187,72318
"6053","ENSMODG00000008172","8",12783043,12788049,5006
"6054","ENSMODG00000008173","8",72374112,72440091,65979
"6055","ENSMODG00000008174","X",11318475,11337680,19205
"6056","ENSMODG00000008177","4",48659509,48744278,84769
"6057","ENSMODG00000008178","6",62594671,62627798,33127
"6058","ENSMODG00000008179","1",664750137,664753635,3498
"6059","ENSMODG00000008180","2",253512405,253690470,178065
"6060","ENSMODG00000008181","6",125470981,125531166,60185
"6061","ENSMODG00000008182","6",253708298,253722687,14389
"6062","ENSMODG00000008183","4",179436985,179450521,13536
"6063","ENSMODG00000008185","2",260624757,260833039,208282
"6064","ENSMODG00000008186","8",12789939,12795866,5927
"6065","ENSMODG00000008187","2",524032984,524080043,47059
"6066","ENSMODG00000008189","3",502775176,502781227,6051
"6067","ENSMODG00000008191","5",250276360,250304388,28028
"6068","ENSMODG00000008192","X",11419766,11426208,6442
"6069","ENSMODG00000008193","3",346933662,346965649,31987
"6070","ENSMODG00000008194","8",72190506,72265316,74810
"6071","ENSMODG00000008195","8",244656031,244967239,311208
"6072","ENSMODG00000008196","4",289744895,289863400,118505
"6073","ENSMODG00000008197","3",346870435,346871053,618
"6074","ENSMODG00000008198","1",353948370,354399421,451051
"6075","ENSMODG00000008199","4",376891191,376936055,44864
"6076","ENSMODG00000008200","6",62622153,62691750,69597
"6077","ENSMODG00000008202","1",664578235,664657527,79292
"6078","ENSMODG00000008203","6",125657567,125815679,158112
"6079","ENSMODG00000008204","2",212822725,212865740,43015
"6080","ENSMODG00000008205","2",253360487,253376825,16338
"6081","ENSMODG00000008206","4",289877362,289900487,23125
"6082","ENSMODG00000008207","3",346760749,346856858,96109
"6083","ENSMODG00000008209","5",250316044,250342543,26499
"6084","ENSMODG00000008210","4",348452052,348496734,44682
"6085","ENSMODG00000008211","6",126226230,126227042,812
"6086","ENSMODG00000008212","4",376944383,376946301,1918
"6087","ENSMODG00000008213","2",253277387,253279249,1862
"6088","ENSMODG00000008215","4",385030981,385054196,23215
"6089","ENSMODG00000008216","4",289906767,289933451,26684
"6090","ENSMODG00000008217","3",173282690,173444252,161562
"6091","ENSMODG00000008220","4",377013575,377015555,1980
"6092","ENSMODG00000008221","1",260513575,260746753,233178
"6093","ENSMODG00000008222","2",212787808,212793115,5307
"6094","ENSMODG00000008223","1",164877441,165012384,134943
"6095","ENSMODG00000008224","6",126412255,126832372,420117
"6096","ENSMODG00000008225","6",62693603,62719297,25694
"6097","ENSMODG00000008226","4",348504317,348515436,11119
"6098","ENSMODG00000008227","4",179460320,179469763,9443
"6099","ENSMODG00000008228","3",173457599,173458789,1190
"6100","ENSMODG00000008231","8",72015684,72190409,174725
"6101","ENSMODG00000008232","8",245035796,245222820,187024
"6102","ENSMODG00000008234","4",348520045,348528870,8825
"6103","ENSMODG00000008235","1",85392806,85477409,84603
"6104","ENSMODG00000008236","4",179469826,179484143,14317
"6105","ENSMODG00000008238","4",377054081,377062333,8252
"6106","ENSMODG00000008239","6",62738212,62763395,25183
"6107","ENSMODG00000008241","1",260831377,260850709,19332
"6108","ENSMODG00000008243","8",12797851,12810059,12208
"6109","ENSMODG00000008244","8",245275374,245372417,97043
"6110","ENSMODG00000008245","4",179504703,179629135,124432
"6111","ENSMODG00000008246","4",348540267,348544569,4302
"6112","ENSMODG00000008247","2",253220159,253228106,7947
"6113","ENSMODG00000008248","5",250342547,250412965,70418
"6114","ENSMODG00000008249","6",62827106,62834571,7465
"6115","ENSMODG00000008251","2",153974915,154223651,248736
"6116","ENSMODG00000008252","1",664198811,664223340,24529
"6117","ENSMODG00000008253","8",245487976,245528532,40556
"6118","ENSMODG00000008254","2",436163262,436340436,177174
"6119","ENSMODG00000008255","3",175407698,175459782,52084
"6120","ENSMODG00000008256","6",62850443,62851128,685
"6121","ENSMODG00000008258","8",245627350,245647728,20378
"6122","ENSMODG00000008260","3",345384470,346195915,811445
"6123","ENSMODG00000008261","8",12813347,12829054,15707
"6124","ENSMODG00000008262","4",289943807,290064682,120875
"6125","ENSMODG00000008263","1",85512037,85596421,84384
"6126","ENSMODG00000008265","4",179631289,179843997,212708
"6127","ENSMODG00000008266","2",259835324,260069803,234479
"6128","ENSMODG00000008267","8",71913148,71995293,82145
"6129","ENSMODG00000008268","3",175530978,175582865,51887
"6130","ENSMODG00000008269","7",98922070,99165115,243045
"6131","ENSMODG00000008270","1",260850400,260875824,25424
"6132","ENSMODG00000008271","X",11470009,11480057,10048
"6133","ENSMODG00000008273","8",12853282,12857627,4345
"6134","ENSMODG00000008274","Un",65379102,65379927,825
"6135","ENSMODG00000008275","1",353573254,353574055,801
"6136","ENSMODG00000008276","6",62991798,63126517,134719
"6137","ENSMODG00000008277","8",71884543,71906872,22329
"6138","ENSMODG00000008278","4",290134519,290194222,59703
"6139","ENSMODG00000008283","6",63077810,63078310,500
"6140","ENSMODG00000008285","1",85671949,85798549,126600
"6141","ENSMODG00000008286","2",154406618,154444067,37449
"6142","ENSMODG00000008288","1",590331749,590334376,2627
"6143","ENSMODG00000008289","Un",63989384,63989718,334
"6144","ENSMODG00000008290","4",348566182,348668124,101942
"6145","ENSMODG00000008291","3",175619115,175657970,38855
"6146","ENSMODG00000008292","4",290386829,290392400,5571
"6147","ENSMODG00000008293","8",71362565,71497354,134789
"6148","ENSMODG00000008294","3",345346076,345347845,1769
"6149","ENSMODG00000008295","2",212765318,212786371,21053
"6150","ENSMODG00000008298","3",175707346,176120993,413647
"6151","ENSMODG00000008299","8",12857941,12862994,5053
"6152","ENSMODG00000008300","X",11486750,11513393,26643
"6153","ENSMODG00000008301","2",435703878,435892037,188159
"6154","ENSMODG00000008302","3",516431684,516435622,3938
"6155","ENSMODG00000008303","5",250577505,250606822,29317
"6156","ENSMODG00000008304","4",377080500,377148900,68400
"6157","ENSMODG00000008305","1",352769121,352832231,63110
"6158","ENSMODG00000008306","2",212690523,212694082,3559
"6159","ENSMODG00000008307","3",345100801,345107861,7060
"6160","ENSMODG00000008309","5",300844005,300890793,46788
"6161","ENSMODG00000008310","4",377154462,377227677,73215
"6162","ENSMODG00000008311","1",164094562,164689358,594796
"6163","ENSMODG00000008312","2",154442664,154570542,127878
"6164","ENSMODG00000008313","1",590229788,590247779,17991
"6165","ENSMODG00000008314","1",352709182,352751692,42510
"6166","ENSMODG00000008316","3",345018485,345020044,1559
"6167","ENSMODG00000008317","4",290597779,290777092,179313
"6168","ENSMODG00000008318","1",664084656,664195069,110413
"6169","ENSMODG00000008320","2",154620223,154637204,16981
"6170","ENSMODG00000008321","2",253091912,253102495,10583
"6171","ENSMODG00000008322","4",348669501,348701276,31775
"6172","ENSMODG00000008323","1",590186524,590199945,13421
"6173","ENSMODG00000008324","2",523811325,523856003,44678
"6174","ENSMODG00000008326","6",253726834,253749769,22935
"6175","ENSMODG00000008327","1",85802697,86122333,319636
"6176","ENSMODG00000008328","1",352668955,352705196,36241
"6177","ENSMODG00000008330","X",11515752,11538024,22272
"6178","ENSMODG00000008331","4",385132088,385143290,11202
"6179","ENSMODG00000008332","1",590181688,590185643,3955
"6180","ENSMODG00000008334","6",127247417,127381728,134311
"6181","ENSMODG00000008335","2",517017132,517052366,35234
"6182","ENSMODG00000008336","4",290881958,290926946,44988
"6183","ENSMODG00000008337","1",664022016,664042581,20565
"6184","ENSMODG00000008338","6",63156557,63235011,78454
"6185","ENSMODG00000008339","8",12908630,12914872,6242
"6186","ENSMODG00000008340","2",212523561,212683357,159796
"6187","ENSMODG00000008341","1",352639306,352665731,26425
"6188","ENSMODG00000008343","2",435273511,435405644,132133
"6189","ENSMODG00000008344","6",63278956,63316560,37604
"6190","ENSMODG00000008345","3",516683988,517038386,354398
"6191","ENSMODG00000008346","1",663676078,663676833,755
"6192","ENSMODG00000008347","4",348771318,349018494,247176
"6193","ENSMODG00000008348","2",252797600,252959560,161960
"6194","ENSMODG00000008349","8",12921303,12922769,1466
"6195","ENSMODG00000008351","3",177021432,177218715,197283
"6196","ENSMODG00000008352","2",212430589,212442236,11647
"6197","ENSMODG00000008354","1",178009857,178066806,56949
"6198","ENSMODG00000008355","8",12955355,12956677,1322
"6199","ENSMODG00000008356","4",348853823,348854095,272
"6200","ENSMODG00000008357","5",301077132,301103001,25869
"6201","ENSMODG00000008358","7",99238241,99298477,60236
"6202","ENSMODG00000008362","6",253826088,253845642,19554
"6203","ENSMODG00000008363","2",252715119,252780947,65828
"6204","ENSMODG00000008364","5",250643247,250651520,8273
"6205","ENSMODG00000008365","1",163728811,163922367,193556
"6206","ENSMODG00000008366","4",403615132,403616079,947
"6207","ENSMODG00000008367","3",343914336,344172223,257887
"6208","ENSMODG00000008368","2",434998234,435118790,120556
"6209","ENSMODG00000008369","4",293190379,293526255,335876
"6210","ENSMODG00000008370","7",179872718,179873220,502
"6211","ENSMODG00000008371","8",12973633,12981293,7660
"6212","ENSMODG00000008372","3",177213853,177435124,221271
"6213","ENSMODG00000008374","5",301139952,301175304,35352
"6214","ENSMODG00000008375","6",63317129,63467646,150517
"6215","ENSMODG00000008378","7",99530116,99624683,94567
"6216","ENSMODG00000008379","4",385146562,385172106,25544
"6217","ENSMODG00000008380","6",63578890,63579541,651
"6218","ENSMODG00000008381","1",745449241,745453730,4489
"6219","ENSMODG00000008382","2",434892652,434955823,63171
"6220","ENSMODG00000008383","3",343750968,343774408,23440
"6221","ENSMODG00000008385","3",517268113,517306503,38390
"6222","ENSMODG00000008386","1",352464340,352533028,68688
"6223","ENSMODG00000008387","6",253869268,253894352,25084
"6224","ENSMODG00000008388","3",343582470,343670631,88161
"6225","ENSMODG00000008389","8",245774681,245816804,42123
"6226","ENSMODG00000008390","6",63808168,63829454,21286
"6227","ENSMODG00000008391","4",349031169,349071542,40373
"6228","ENSMODG00000008392","2",523860716,523973020,112304
"6229","ENSMODG00000008394","4",385179944,385194228,14284
"6230","ENSMODG00000008396","4",180009224,180602735,593511
"6231","ENSMODG00000008397","3",517305984,517318592,12608
"6232","ENSMODG00000008398","4",403536224,403538992,2768
"6233","ENSMODG00000008399","1",352441888,352461481,19593
"6234","ENSMODG00000008402","6",127704268,127714656,10388
"6235","ENSMODG00000008403","6",253914262,253939457,25195
"6236","ENSMODG00000008405","1",86121338,86168045,46707
"6237","ENSMODG00000008406","3",517355181,517370055,14874
"6238","ENSMODG00000008407","X",11545236,11597568,52332
"6239","ENSMODG00000008408","4",293533043,293578841,45798
"6240","ENSMODG00000008409","1",352422129,352423424,1295
"6241","ENSMODG00000008410","6",254024645,254025181,536
"6242","ENSMODG00000008412","8",12983150,12987574,4424
"6243","ENSMODG00000008413","6",254039003,254140149,101146
"6244","ENSMODG00000008414","1",86183583,86184975,1392
"6245","ENSMODG00000008415","4",402109384,402141026,31642
"6246","ENSMODG00000008416","4",385281365,385291431,10066
"6247","ENSMODG00000008417","2",154659220,154860425,201205
"6248","ENSMODG00000008423","8",245879500,245913920,34420
"6249","ENSMODG00000008424","4",403529979,403531027,1048
"6250","ENSMODG00000008425","1",352231560,352486599,255039
"6251","ENSMODG00000008428","4",293793501,293868271,74770
"6252","ENSMODG00000008429","6",254203906,254221177,17271
"6253","ENSMODG00000008431","1",352063694,352224115,160421
"6254","ENSMODG00000008433","4",293716465,293716858,393
"6255","ENSMODG00000008434","1",86198919,86458019,259100
"6256","ENSMODG00000008436","2",154885362,154906139,20777
"6257","ENSMODG00000008437","1",163558231,163667264,109033
"6258","ENSMODG00000008440","5",251118057,251362746,244689
"6259","ENSMODG00000008441","8",13000178,13097621,97443
"6260","ENSMODG00000008445","1",261012446,261299317,286871
"6261","ENSMODG00000008446","4",180676903,180679182,2279
"6262","ENSMODG00000008447","1",86341061,86341789,728
"6263","ENSMODG00000008449","6",64468813,64654508,185695
"6264","ENSMODG00000008452","2",154916812,154932767,15955
"6265","ENSMODG00000008454","2",524001049,524159391,158342
"6266","ENSMODG00000008456","6",127786552,127897423,110871
"6267","ENSMODG00000008457","2",522019708,522040325,20617
"6268","ENSMODG00000008458","2",524023506,524031981,8475
"6269","ENSMODG00000008459","1",163476084,163503314,27230
"6270","ENSMODG00000008461","2",522098859,522104285,5426
"6271","ENSMODG00000008462","4",349132078,349133079,1001
"6272","ENSMODG00000008463","2",433180671,433380118,199447
"6273","ENSMODG00000008464","6",254233361,254281906,48545
"6274","ENSMODG00000008468","1",663205153,663266089,60936
"6275","ENSMODG00000008471","2",252399287,252707873,308586
"6276","ENSMODG00000008472","8",245923910,245962583,38673
"6277","ENSMODG00000008473","2",522118040,522137498,19458
"6278","ENSMODG00000008474","7",99630877,99908614,277737
"6279","ENSMODG00000008475","1",590140436,590179829,39393
"6280","ENSMODG00000008477","3",522530833,522555166,24333
"6281","ENSMODG00000008478","2",155808560,155816027,7467
"6282","ENSMODG00000008479","2",251984478,252375706,391228
"6283","ENSMODG00000008481","4",349162012,349162929,917
"6284","ENSMODG00000008482","4",293938620,294124301,185681
"6285","ENSMODG00000008484","1",590100420,590102078,1658
"6286","ENSMODG00000008485","5",301271683,301316515,44832
"6287","ENSMODG00000008486","1",663115286,663119014,3728
"6288","ENSMODG00000008487","2",433162625,433172155,9530
"6289","ENSMODG00000008488","3",177967039,178174765,207726
"6290","ENSMODG00000008489","2",524081312,524097099,15787
"6291","ENSMODG00000008490","8",13097778,13112991,15213
"6292","ENSMODG00000008491","4",385297650,385319210,21560
"6293","ENSMODG00000008492","4",294127083,294139810,12727
"6294","ENSMODG00000008493","3",343367858,343395798,27940
"6295","ENSMODG00000008494","5",251880439,251980740,100301
"6296","ENSMODG00000008495","1",352106593,352208874,102281
"6297","ENSMODG00000008497","8",13127346,13135033,7687
"6298","ENSMODG00000008498","6",66917379,67073641,156262
"6299","ENSMODG00000008499","8",245984789,246087802,103013
"6300","ENSMODG00000008500","6",127925603,127978594,52991
"6301","ENSMODG00000008501","2",433146034,433150055,4021
"6302","ENSMODG00000008502","2",524102497,524118135,15638
"6303","ENSMODG00000008503","7",252787253,252789802,2549
"6304","ENSMODG00000008504","2",156040142,156156786,116644
"6305","ENSMODG00000008505","3",343309951,343362280,52329
"6306","ENSMODG00000008507","4",403868493,403870678,2185
"6307","ENSMODG00000008508","1",590050617,590088452,37835
"6308","ENSMODG00000008510","2",156158590,156167011,8421
"6309","ENSMODG00000008511","2",432848808,432859524,10716
"6310","ENSMODG00000008512","3",343238296,343288099,49803
"6311","ENSMODG00000008513","5",251986405,252051954,65549
"6312","ENSMODG00000008514","6",254310279,254385678,75399
"6313","ENSMODG00000008516","2",522415838,522419467,3629
"6314","ENSMODG00000008517","6",68146302,68188516,42214
"6315","ENSMODG00000008518","2",432755187,432786096,30909
"6316","ENSMODG00000008519","5",301328657,301375145,46488
"6317","ENSMODG00000008520","7",100065466,100132271,66805
"6318","ENSMODG00000008525","1",86664719,86788014,123295
"6319","ENSMODG00000008526","2",156245051,156401292,156241
"6320","ENSMODG00000008527","1",423581707,423600457,18750
"6321","ENSMODG00000008529","4",180828210,180881248,53038
"6322","ENSMODG00000008530","2",251781827,251885392,103565
"6323","ENSMODG00000008531","4",48787947,49294797,506850
"6324","ENSMODG00000008532","2",522295782,522303361,7579
"6325","ENSMODG00000008533","8",246085900,246125344,39444
"6326","ENSMODG00000008535","7",253188835,253228620,39785
"6327","ENSMODG00000008537","1",351857109,351886908,29799
"6328","ENSMODG00000008538","4",385394752,385405554,10802
"6329","ENSMODG00000008540","2",251733120,251756752,23632
"6330","ENSMODG00000008541","2",157092638,157151762,59124
"6331","ENSMODG00000008542","7",253258123,253261943,3820
"6332","ENSMODG00000008543","7",100812372,100863987,51615
"6333","ENSMODG00000008546","4",265451201,265457974,6773
"6334","ENSMODG00000008547","1",351124442,351654034,529592
"6335","ENSMODG00000008548","4",294715695,294727437,11742
"6336","ENSMODG00000008550","3",503254359,503265891,11532
"6337","ENSMODG00000008553","2",157546759,157613088,66329
"6338","ENSMODG00000008556","3",178285811,178396118,110307
"6339","ENSMODG00000008558","6",128061658,128116359,54701
"6340","ENSMODG00000008560","5",252154589,252430482,275893
"6341","ENSMODG00000008561","1",349038652,349105410,66758
"6342","ENSMODG00000008563","7",253273638,253314724,41086
"6343","ENSMODG00000008565","1",261325830,261440966,115136
"6344","ENSMODG00000008566","7",100933671,101055860,122189
"6345","ENSMODG00000008567","4",294853205,294919862,66657
"6346","ENSMODG00000008568","X",11603841,11629500,25659
"6347","ENSMODG00000008569","6",128129899,128148017,18118
"6348","ENSMODG00000008571","3",178741007,178891487,150480
"6349","ENSMODG00000008572","6",68285970,68548247,262277
"6350","ENSMODG00000008573","4",409522854,409524038,1184
"6351","ENSMODG00000008575","2",251659763,251661037,1274
"6352","ENSMODG00000008576","7",101424591,101425604,1013
"6353","ENSMODG00000008577","3",522870705,522923506,52801
"6354","ENSMODG00000008578","1",261505902,261540035,34133
"6355","ENSMODG00000008580","3",517570542,517676958,106416
"6356","ENSMODG00000008581","X",11630750,11633443,2693
"6357","ENSMODG00000008582","6",68305912,68307006,1094
"6358","ENSMODG00000008583","8",246181370,246308440,127070
"6359","ENSMODG00000008585","1",662722615,662745822,23207
"6360","ENSMODG00000008586","5",252455957,252638214,182257
"6361","ENSMODG00000008587","1",261556564,261584533,27969
"6362","ENSMODG00000008590","2",157709474,158115068,405594
"6363","ENSMODG00000008591","7",253405863,253426513,20650
"6364","ENSMODG00000008592","4",385327806,385359696,31890
"6365","ENSMODG00000008593","1",589981513,590017386,35873
"6366","ENSMODG00000008594","5",252655783,252656168,385
"6367","ENSMODG00000008595","2",251513829,251562302,48473
"6368","ENSMODG00000008596","X",11638399,11678876,40477
"6369","ENSMODG00000008597","3",517677066,517682638,5572
"6370","ENSMODG00000008598","1",348993615,349037313,43698
"6371","ENSMODG00000008600","2",158133887,158170002,36115
"6372","ENSMODG00000008601","6",68577461,68658715,81254
"6373","ENSMODG00000008602","1",589909418,589915845,6427
"6374","ENSMODG00000008603","7",253453940,253517583,63643
"6375","ENSMODG00000008605","3",517775020,517812422,37402
"6376","ENSMODG00000008606","8",35967277,36008467,41190
"6377","ENSMODG00000008607","2",158426646,158429429,2783
"6378","ENSMODG00000008609","1",348881713,348992091,110378
"6379","ENSMODG00000008610","6",255227878,255419534,191656
"6380","ENSMODG00000008611","1",589777627,589785310,7683
"6381","ENSMODG00000008613","5",252799939,253125720,325781
"6382","ENSMODG00000008614","4",294923839,294983984,60145
"6383","ENSMODG00000008615","1",261687865,261746699,58834
"6384","ENSMODG00000008616","7",253559152,253582910,23758
"6385","ENSMODG00000008617","1",662345084,662398232,53148
"6386","ENSMODG00000008618","3",517812758,517827382,14624
"6387","ENSMODG00000008620","1",348924610,348950843,26233
"6388","ENSMODG00000008621","6",68718368,68795790,77422
"6389","ENSMODG00000008622","4",295042883,295050769,7886
"6390","ENSMODG00000008623","6",128237717,128582567,344850
"6391","ENSMODG00000008624","6",255500208,255539278,39070
"6392","ENSMODG00000008625","5",253198731,253200305,1574
"6393","ENSMODG00000008626","8",246460932,246541275,80343
"6394","ENSMODG00000008627","1",87549962,87653010,103048
"6395","ENSMODG00000008630","4",385367260,385372592,5332
"6396","ENSMODG00000008631","2",251241409,251241825,416
"6397","ENSMODG00000008634","1",87760616,87762148,1532
"6398","ENSMODG00000008635","4",385373908,385375144,1236
"6399","ENSMODG00000008636","1",662187612,662248104,60492
"6400","ENSMODG00000008637","1",589525117,589625527,100410
"6401","ENSMODG00000008639","7",253585669,253595073,9404
"6402","ENSMODG00000008640","1",262131294,262201906,70612
"6403","ENSMODG00000008641","1",163075716,163188264,112548
"6404","ENSMODG00000008642","4",385385640,385394693,9053
"6405","ENSMODG00000008643","6",68802060,68813394,11334
"6406","ENSMODG00000008644","1",88031885,88247183,215298
"6407","ENSMODG00000008646","1",262228587,262243076,14489
"6408","ENSMODG00000008647","6",255779058,255957466,178408
"6409","ENSMODG00000008648","1",589412721,589435590,22869
"6410","ENSMODG00000008649","7",253621751,253626740,4989
"6411","ENSMODG00000008650","4",385405654,385406847,1193
"6412","ENSMODG00000008652","4",181072677,181252606,179929
"6413","ENSMODG00000008656","1",589277501,589313953,36452
"6414","ENSMODG00000008657","1",262252808,262536395,283587
"6415","ENSMODG00000008658","7",253646451,253678998,32547
"6416","ENSMODG00000008659","6",256230192,256314168,83976
"6417","ENSMODG00000008662","1",162906716,162996225,89509
"6418","ENSMODG00000008663","1",348891962,348914748,22786
"6419","ENSMODG00000008664","1",262541485,262556631,15146
"6420","ENSMODG00000008665","4",181416514,181490560,74046
"6421","ENSMODG00000008666","4",385414919,385420873,5954
"6422","ENSMODG00000008667","6",68885743,69028313,142570
"6423","ENSMODG00000008668","2",251360246,251386903,26657
"6424","ENSMODG00000008669","1",662152882,662158959,6077
"6425","ENSMODG00000008673","4",385425203,385433140,7937
"6426","ENSMODG00000008674","4",295073492,295928157,854665
"6427","ENSMODG00000008675","1",589235402,589254283,18881
"6428","ENSMODG00000008677","X",11702779,11732653,29874
"6429","ENSMODG00000008678","1",348602580,348608594,6014
"6430","ENSMODG00000008679","3",517836467,517865045,28578
"6431","ENSMODG00000008681","Un",54527573,54535762,8189
"6432","ENSMODG00000008682","1",262555562,262637283,81721
"6433","ENSMODG00000008683","1",662126241,662127857,1616
"6434","ENSMODG00000008684","4",295453389,295454069,680
"6435","ENSMODG00000008685","1",88967824,89003385,35561
"6436","ENSMODG00000008686","6",27030225,27031239,1014
"6437","ENSMODG00000008687","8",246706484,246787778,81294
"6438","ENSMODG00000008689","1",162286243,162511185,224942
"6439","ENSMODG00000008690","1",662109718,662112772,3054
"6440","ENSMODG00000008691","1",589049561,589092779,43218
"6441","ENSMODG00000008693","1",348559521,348562076,2555
"6442","ENSMODG00000008695","4",295997575,296013770,16195
"6443","ENSMODG00000008696","6",256372223,256401451,29228
"6444","ENSMODG00000008701","1",588942434,589007367,64933
"6445","ENSMODG00000008702","1",348339653,348514936,175283
"6446","ENSMODG00000008705","6",69227423,69273881,46458
"6447","ENSMODG00000008706","1",263090431,263376832,286401
"6448","ENSMODG00000008707","1",348390291,348390965,674
"6449","ENSMODG00000008708","5",253645656,253728718,83062
"6450","ENSMODG00000008710","X",3105149,3141568,36419
"6451","ENSMODG00000008711","4",181518770,181555006,36236
"6452","ENSMODG00000008712","3",180349017,180712364,363347
"6453","ENSMODG00000008714","1",89017439,89049417,31978
"6454","ENSMODG00000008716","6",256458528,256482717,24189
"6455","ENSMODG00000008717","5",173859800,173862178,2378
"6456","ENSMODG00000008718","1",25582866,25655741,72875
"6457","ENSMODG00000008719","8",247699466,247700581,1115
"6458","ENSMODG00000008720","6",256646069,256651444,5375
"6459","ENSMODG00000008721","4",385520204,385532690,12486
"6460","ENSMODG00000008722","6",69301514,69302225,711
"6461","ENSMODG00000008724","8",247713987,247715360,1373
"6462","ENSMODG00000008725","2",251209623,251229712,20089
"6463","ENSMODG00000008726","1",588706576,588741267,34691
"6464","ENSMODG00000008728","5",253697400,253755889,58489
"6465","ENSMODG00000008729","4",181591095,181628206,37111
"6466","ENSMODG00000008730","8",247946323,247970573,24250
"6467","ENSMODG00000008731","X",3165122,3169073,3951
"6468","ENSMODG00000008732","3",517874260,517880333,6073
"6469","ENSMODG00000008733","8",34418021,34425136,7115
"6470","ENSMODG00000008735","1",162091036,162234623,143587
"6471","ENSMODG00000008736","3",517881527,517886143,4616
"6472","ENSMODG00000008737","4",349509381,349510298,917
"6473","ENSMODG00000008738","5",253818972,253822059,3087
"6474","ENSMODG00000008740","8",248035641,248138225,102584
"6475","ENSMODG00000008743","1",662030558,662077628,47070
"6476","ENSMODG00000008745","2",158709926,158984339,274413
"6477","ENSMODG00000008747","8",34441067,34449226,8159
"6478","ENSMODG00000008748","6",69543952,69544953,1001
"6479","ENSMODG00000008749","3",522610098,522614952,4854
"6480","ENSMODG00000008750","1",662003661,662006469,2808
"6481","ENSMODG00000008751","1",89050059,89160397,110338
"6482","ENSMODG00000008752","X",3167955,3173684,5729
"6483","ENSMODG00000008753","4",296125792,296179414,53622
"6484","ENSMODG00000008754","1",25390228,25548221,157993
"6485","ENSMODG00000008755","1",588578768,588679948,101180
"6486","ENSMODG00000008757","1",661909224,661950012,40788
"6487","ENSMODG00000008758","8",34462640,34479247,16607
"6488","ENSMODG00000008760","1",263594952,263635693,40741
"6489","ENSMODG00000008761","1",161901153,162055851,154698
"6490","ENSMODG00000008762","3",343040062,343336088,296026
"6491","ENSMODG00000008763","X",3188343,3197265,8922
"6492","ENSMODG00000008764","1",89269526,89305162,35636
"6493","ENSMODG00000008766","4",385560170,385562997,2827
"6494","ENSMODG00000008768","6",257170017,257357722,187705
"6495","ENSMODG00000008769","1",24784041,24879795,95754
"6496","ENSMODG00000008771","1",263655789,263696924,41135
"6497","ENSMODG00000008772","4",181825291,181882871,57580
"6498","ENSMODG00000008773","3",522485988,522507057,21069
"6499","ENSMODG00000008774","3",343047816,343063053,15237
"6500","ENSMODG00000008777","1",263876145,264042364,166219
"6501","ENSMODG00000008779","4",385638205,385667537,29332
"6502","ENSMODG00000008781","8",248224720,248422335,197615
"6503","ENSMODG00000008782","3",342765368,343040419,275051
"6504","ENSMODG00000008784","1",24776039,24872540,96501
"6505","ENSMODG00000008785","2",251975227,252141696,166469
"6506","ENSMODG00000008788","1",588302849,588459064,156215
"6507","ENSMODG00000008789","6",257447928,257590155,142227
"6508","ENSMODG00000008791","2",250987618,251003357,15739
"6509","ENSMODG00000008792","1",264082587,264125005,42418
"6510","ENSMODG00000008793","2",159566455,159993646,427191
"6511","ENSMODG00000008794","1",161829011,161870688,41677
"6512","ENSMODG00000008795","4",296371076,296572523,201447
"6513","ENSMODG00000008796","5",301481952,301514986,33034
"6514","ENSMODG00000008797","3",181022055,181104250,82195
"6515","ENSMODG00000008798","X",3274515,3280718,6203
"6516","ENSMODG00000008801","1",661794505,661874344,79839
"6517","ENSMODG00000008802","1",348184966,348194283,9317
"6518","ENSMODG00000008805","4",296693982,296694986,1004
"6519","ENSMODG00000008806","1",661576717,661626283,49566
"6520","ENSMODG00000008807","2",250877720,250878685,965
"6521","ENSMODG00000008808","1",24803665,24805275,1610
"6522","ENSMODG00000008812","2",160133013,160173145,40132
"6523","ENSMODG00000008814","8",36063499,36092677,29178
"6524","ENSMODG00000008815","1",24743893,24760141,16248
"6525","ENSMODG00000008816","6",69640594,69641724,1130
"6526","ENSMODG00000008817","4",385671064,385695677,24613
"6527","ENSMODG00000008819","3",181087965,181150425,62460
"6528","ENSMODG00000008820","6",69852113,69852376,263
"6529","ENSMODG00000008821","5",301545678,301563538,17860
"6530","ENSMODG00000008822","1",348145848,348178460,32612
"6531","ENSMODG00000008823","1",588013402,588317015,303613
"6532","ENSMODG00000008824","5",254070529,254117921,47392
"6533","ENSMODG00000008825","2",160264306,160338856,74550
"6534","ENSMODG00000008826","5",301569445,301573572,4127
"6535","ENSMODG00000008827","4",385696579,385700713,4134
"6536","ENSMODG00000008828","5",301594062,301594901,839
"6537","ENSMODG00000008829","1",161692519,161776677,84158
"6538","ENSMODG00000008830","1",24604269,24712904,108635
"6539","ENSMODG00000008832","6",257730334,257977411,247077
"6540","ENSMODG00000008834","2",160347943,160375061,27118
"6541","ENSMODG00000008835","7",102626285,102875021,248736
"6542","ENSMODG00000008837","1",24563650,24565164,1514
"6543","ENSMODG00000008838","2",160374722,160386052,11330
"6544","ENSMODG00000008839","3",522344892,522369681,24789
"6545","ENSMODG00000008841","2",522431156,522808885,377729
"6546","ENSMODG00000008842","6",258143705,258183903,40198
"6547","ENSMODG00000008843","6",70492976,70569849,76873
"6548","ENSMODG00000008847","4",181890755,182011470,120715
"6549","ENSMODG00000008848","2",160484468,160501817,17349
"6550","ENSMODG00000008850","4",385780076,385801757,21681
"6551","ENSMODG00000008851","X",3214503,3222766,8263
"6552","ENSMODG00000008852","1",24486911,24536941,50030
"6553","ENSMODG00000008853","4",349694352,349695293,941
"6554","ENSMODG00000008855","3",181238213,181250227,12014
"6555","ENSMODG00000008856","4",182028883,182029229,346
"6556","ENSMODG00000008857","4",385825485,385847670,22185
"6557","ENSMODG00000008860","3",522106775,522166922,60147
"6558","ENSMODG00000008861","3",517900617,517938843,38226
"6559","ENSMODG00000008862","1",161629561,161655439,25878
"6560","ENSMODG00000008864","3",522229081,522230040,959
"6561","ENSMODG00000008865","1",89360718,89379354,18636
"6562","ENSMODG00000008866","3",181333462,181365486,32024
"6563","ENSMODG00000008867","5",254186313,254196342,10029
"6564","ENSMODG00000008868","8",62682867,62708697,25830
"6565","ENSMODG00000008869","X",3263549,3274450,10901
"6566","ENSMODG00000008870","4",182052369,182138594,86225
"6567","ENSMODG00000008871","Un",62342610,62363396,20786
"6568","ENSMODG00000008872","2",161380588,161396468,15880
"6569","ENSMODG00000008873","1",24398459,24450165,51706
"6570","ENSMODG00000008874","4",297282500,297416609,134109
"6571","ENSMODG00000008876","1",89408755,89487306,78551
"6572","ENSMODG00000008877","6",258226541,258536111,309570
"6573","ENSMODG00000008878","1",587172226,587706695,534469
"6574","ENSMODG00000008879","4",349852250,349900104,47854
"6575","ENSMODG00000008880","8",62767858,62896254,128396
"6576","ENSMODG00000008883","1",587154864,587160373,5509
"6577","ENSMODG00000008884","2",250737186,250756158,18972
"6578","ENSMODG00000008885","8",62891268,63062465,171197
"6579","ENSMODG00000008886","1",161374168,161626127,251959
"6580","ENSMODG00000008887","1",586949997,586961614,11617
"6581","ENSMODG00000008888","4",182184541,182289333,104792
"6582","ENSMODG00000008889","6",258631005,258721152,90147
"6583","ENSMODG00000008891","1",586853791,586893672,39881
"6584","ENSMODG00000008892","4",182292747,182299523,6776
"6585","ENSMODG00000008893","8",63088438,63117800,29362
"6586","ENSMODG00000008894","4",349951341,349952310,969
"6587","ENSMODG00000008896","1",586785431,586791647,6216
"6588","ENSMODG00000008897","1",161242639,161322103,79464
"6589","ENSMODG00000008899","4",182308566,182314378,5812
"6590","ENSMODG00000008900","1",347632133,347977976,345843
"6591","ENSMODG00000008902","6",258741903,258789309,47406
"6592","ENSMODG00000008903","8",248471096,248871115,400019
"6593","ENSMODG00000008904","3",518164058,518284500,120442
"6594","ENSMODG00000008906","8",63132830,63223539,90709
"6595","ENSMODG00000008907","3",181717880,181719004,1124
"6596","ENSMODG00000008908","1",586687620,586757394,69774
"6597","ENSMODG00000008910","2",522653037,522682292,29255
"6598","ENSMODG00000008911","1",586556941,586588079,31138
"6599","ENSMODG00000008913","8",63260706,63320628,59922
"6600","ENSMODG00000008914","8",249829824,249831119,1295
"6601","ENSMODG00000008916","1",346408064,346431716,23652
"6602","ENSMODG00000008917","3",518013775,518023467,9692
"6603","ENSMODG00000008918","2",161542669,161548273,5604
"6604","ENSMODG00000008920","1",160970524,161179209,208685
"6605","ENSMODG00000008922","1",24310896,24349912,39016
"6606","ENSMODG00000008923","4",297488783,297494638,5855
"6607","ENSMODG00000008925","2",250658446,250661065,2619
"6608","ENSMODG00000008926","4",385855594,385872877,17283
"6609","ENSMODG00000008928","2",522706494,522785072,78578
"6610","ENSMODG00000008931","1",160187262,160565529,378267
"6611","ENSMODG00000008934","4",385889848,385895163,5315
"6612","ENSMODG00000008935","3",432622243,432629239,6996
"6613","ENSMODG00000008936","1",264882556,265424533,541977
"6614","ENSMODG00000008937","8",34816374,34853725,37351
"6615","ENSMODG00000008941","4",297534165,297537662,3497
"6616","ENSMODG00000008942","3",342277910,342338204,60294
"6617","ENSMODG00000008946","8",250081546,250083305,1759
"6618","ENSMODG00000008947","6",70636466,70696805,60339
"6619","ENSMODG00000008948","8",250144096,250160928,16832
"6620","ENSMODG00000008949","2",522890649,522904594,13945
"6621","ENSMODG00000008950","1",265570508,265704783,134275
"6622","ENSMODG00000008952","4",385911264,385962327,51063
"6623","ENSMODG00000008953","1",585963273,586010221,46948
"6624","ENSMODG00000008954","8",13150029,13248616,98587
"6625","ENSMODG00000008955","4",297825213,297846791,21578
"6626","ENSMODG00000008959","1",345918149,346020742,102593
"6627","ENSMODG00000008960","8",63361411,63422202,60791
"6628","ENSMODG00000008961","3",182847144,182902774,55630
"6629","ENSMODG00000008962","4",297843900,297860606,16706
"6630","ENSMODG00000008963","2",161564108,161651398,87290
"6631","ENSMODG00000008964","8",13249581,13250626,1045
"6632","ENSMODG00000008965","3",433454162,433490635,36473
"6633","ENSMODG00000008966","8",63676321,63695675,19354
"6634","ENSMODG00000008967","8",34959734,34998562,38828
"6635","ENSMODG00000008968","6",259154970,259210407,55437
"6636","ENSMODG00000008969","2",522916147,522954731,38584
"6637","ENSMODG00000008970","1",585888141,585910623,22482
"6638","ENSMODG00000008971","3",518038390,518063118,24728
"6639","ENSMODG00000008972","3",433577723,433796732,219009
"6640","ENSMODG00000008973","3",183663330,183672127,8797
"6641","ENSMODG00000008975","1",585843233,585844713,1480
"6642","ENSMODG00000008976","1",265866270,265980486,114216
"6643","ENSMODG00000008978","4",385982640,386021806,39166
"6644","ENSMODG00000008980","X",3318317,3341018,22701
"6645","ENSMODG00000008981","2",250547600,250548580,980
"6646","ENSMODG00000008982","1",266107064,266108254,1190
"6647","ENSMODG00000008983","3",433893929,433901667,7738
"6648","ENSMODG00000008985","7",102885478,102979107,93629
"6649","ENSMODG00000008986","5",254541367,254601148,59781
"6650","ENSMODG00000008987","X",65030446,65048845,18399
"6651","ENSMODG00000008989","4",298010943,298062765,51822
"6652","ENSMODG00000008990","1",24259800,24307828,48028
"6653","ENSMODG00000008992","8",63733381,63763165,29784
"6654","ENSMODG00000008993","1",345882643,345895294,12651
"6655","ENSMODG00000008994","8",250251180,250378698,127518
"6656","ENSMODG00000008995","3",518067167,518284500,217333
"6657","ENSMODG00000008997","X",3358958,3361741,2783
"6658","ENSMODG00000009001","4",298104368,298159978,55610
"6659","ENSMODG00000009002","1",24250544,24258573,8029
"6660","ENSMODG00000009003","6",70707986,70774460,66474
"6661","ENSMODG00000009004","8",63845975,63980577,134602
"6662","ENSMODG00000009005","1",345783613,345791817,8204
"6663","ENSMODG00000009006","X",3253212,3371074,117862
"6664","ENSMODG00000009007","3",518377724,518389943,12219
"6665","ENSMODG00000009008","X",65156475,65270051,113576
"6666","ENSMODG00000009009","4",182772774,182875306,102532
"6667","ENSMODG00000009011","5",254624357,254651773,27416
"6668","ENSMODG00000009013","6",70783070,70790315,7245
"6669","ENSMODG00000009016","X",3388515,3401188,12673
"6670","ENSMODG00000009017","1",159306721,159501077,194356
"6671","ENSMODG00000009018","1",24234609,24241730,7121
"6672","ENSMODG00000009020","4",49679676,49746841,67165
"6673","ENSMODG00000009021","4",298491304,298500675,9371
"6674","ENSMODG00000009022","1",159296448,159306088,9640
"6675","ENSMODG00000009023","6",70797731,70825230,27499
"6676","ENSMODG00000009024","3",518431217,518479407,48190
"6677","ENSMODG00000009027","6",70860154,70864881,4727
"6678","ENSMODG00000009028","1",345727222,345752516,25294
"6679","ENSMODG00000009029","5",254679947,254705229,25282
"6680","ENSMODG00000009032","8",250532463,250729699,197236
"6681","ENSMODG00000009033","6",259377659,259616684,239025
"6682","ENSMODG00000009034","1",159254105,159271335,17230
"6683","ENSMODG00000009035","4",182912357,182936501,24144
"6684","ENSMODG00000009037","6",128815157,128936220,121063
"6685","ENSMODG00000009039","6",259708622,259708915,293
"6686","ENSMODG00000009042","6",260028668,260035057,6389
"6687","ENSMODG00000009043","3",434116788,434119106,2318
"6688","ENSMODG00000009045","4",298533795,298631590,97795
"6689","ENSMODG00000009046","2",282740756,282741103,347
"6690","ENSMODG00000009047","8",13250429,13264762,14333
"6691","ENSMODG00000009048","6",260883618,260884098,480
"6692","ENSMODG00000009049","4",386055118,386060873,5755
"6693","ENSMODG00000009050","1",345548436,345630563,82127
"6694","ENSMODG00000009053","4",386061546,386077572,16026
"6695","ENSMODG00000009054","2",161288201,161289787,1586
"6696","ENSMODG00000009055","4",49748079,49773066,24987
"6697","ENSMODG00000009056","2",161673818,161796853,123035
"6698","ENSMODG00000009057","3",434255385,434272516,17131
"6699","ENSMODG00000009058","8",250906637,250985174,78537
"6700","ENSMODG00000009061","1",266142577,266189881,47304
"6701","ENSMODG00000009062","3",434275237,434279299,4062
"6702","ENSMODG00000009064","X",65797512,65799503,1991
"6703","ENSMODG00000009065","4",298753948,298904496,150548
"6704","ENSMODG00000009066","4",386105912,386190818,84906
"6705","ENSMODG00000009069","6",72445005,72450948,5943
"6706","ENSMODG00000009070","4",350087108,350088061,953
"6707","ENSMODG00000009072","5",255354196,255831241,477045
"6708","ENSMODG00000009074","8",13274116,13274793,677
"6709","ENSMODG00000009075","3",183699430,183742075,42645
"6710","ENSMODG00000009076","2",161797688,161849985,52297
"6711","ENSMODG00000009077","X",65905439,65906557,1118
"6712","ENSMODG00000009080","8",32148913,32192000,43087
"6713","ENSMODG00000009082","3",518591450,518701907,110457
"6714","ENSMODG00000009083","4",386143771,386277384,133613
"6715","ENSMODG00000009085","8",250999559,251007571,8012
"6716","ENSMODG00000009086","8",32216828,32233585,16757
"6717","ENSMODG00000009087","1",345503656,345539051,35395
"6718","ENSMODG00000009089","4",183282951,183575457,292506
"6719","ENSMODG00000009090","8",251014045,251090858,76813
"6720","ENSMODG00000009092","4",350224351,350225334,983
"6721","ENSMODG00000009093","1",585354555,585367546,12991
"6722","ENSMODG00000009095","3",183753066,183789084,36018
"6723","ENSMODG00000009096","8",32310544,32409148,98604
"6724","ENSMODG00000009097","1",661345080,661546777,201697
"6725","ENSMODG00000009098","3",518847228,518880931,33703
"6726","ENSMODG00000009100","8",251336742,251594719,257977
"6727","ENSMODG00000009101","5",256091587,256108334,16747
"6728","ENSMODG00000009102","3",434400416,434480565,80149
"6729","ENSMODG00000009103","6",262090192,262127517,37325
"6730","ENSMODG00000009105","3",518885439,518890024,4585
"6731","ENSMODG00000009106","3",183939670,183951886,12216
"6732","ENSMODG00000009107","8",32452943,32482363,29420
"6733","ENSMODG00000009108","4",386294687,386302336,7649
"6734","ENSMODG00000009113","6",263187612,263188978,1366
"6735","ENSMODG00000009114","3",184034445,184038464,4019
"6736","ENSMODG00000009116","1",345322391,345358935,36544
"6737","ENSMODG00000009117","6",263417713,263419032,1319
"6738","ENSMODG00000009119","1",660846052,660938940,92888
"6739","ENSMODG00000009120","3",160211388,160212578,1190
"6740","ENSMODG00000009121","8",13277396,13283909,6513
"6741","ENSMODG00000009124","5",256112783,256265718,152935
"6742","ENSMODG00000009125","2",212388434,212417639,29205
"6743","ENSMODG00000009128","4",298925832,299127239,201407
"6744","ENSMODG00000009129","1",660760368,660810428,50060
"6745","ENSMODG00000009130","X",3410543,3433592,23049
"6746","ENSMODG00000009131","2",250177564,250178953,1389
"6747","ENSMODG00000009132","8",13284987,13293148,8161
"6748","ENSMODG00000009133","1",159064373,159153178,88805
"6749","ENSMODG00000009134","4",183619427,183839361,219934
"6750","ENSMODG00000009136","4",386314004,386323210,9206
"6751","ENSMODG00000009138","8",251608618,251853000,244382
"6752","ENSMODG00000009139","4",299343865,299363074,19209
"6753","ENSMODG00000009142","3",184094589,184254331,159742
"6754","ENSMODG00000009143","8",32755121,32776698,21577
"6755","ENSMODG00000009145","2",250075360,250094014,18654
"6756","ENSMODG00000009146","8",13308611,13316725,8114
"6757","ENSMODG00000009147","8",251870497,251892653,22156
"6758","ENSMODG00000009152","4",299367988,299389409,21421
"6759","ENSMODG00000009153","5",256335687,256403430,67743
"6760","ENSMODG00000009154","X",3447262,3464473,17211
"6761","ENSMODG00000009155","2",162548695,162810769,262074
"6762","ENSMODG00000009156","1",24126706,24144616,17910
"6763","ENSMODG00000009157","1",659944998,660332145,387147
"6764","ENSMODG00000009160","8",13313860,13324296,10436
"6765","ENSMODG00000009161","3",434485508,434522316,36808
"6766","ENSMODG00000009162","4",183893110,183909817,16707
"6767","ENSMODG00000009164","1",23595161,23660644,65483
"6768","ENSMODG00000009165","Un",79059269,79062548,3279
"6769","ENSMODG00000009166","2",162861073,163007259,146186
"6770","ENSMODG00000009167","4",300117957,300232679,114722
"6771","ENSMODG00000009168","2",250031094,250043409,12315
"6772","ENSMODG00000009169","1",659864887,659866299,1412
"6773","ENSMODG00000009171","2",212259319,212298802,39483
"6774","ENSMODG00000009174","3",184349222,184398181,48959
"6775","ENSMODG00000009175","X",3470582,3518684,48102
"6776","ENSMODG00000009176","1",23573842,23592797,18955
"6777","ENSMODG00000009178","2",249966093,249977777,11684
"6778","ENSMODG00000009179","1",266452087,266809577,357490
"6779","ENSMODG00000009181","X",3518646,3533098,14452
"6780","ENSMODG00000009182","1",657745581,657758293,12712
"6781","ENSMODG00000009183","3",184407682,184438223,30541
"6782","ENSMODG00000009184","4",184653847,184701914,48067
"6783","ENSMODG00000009185","4",350497877,350498821,944
"6784","ENSMODG00000009187","2",249926395,249938002,11607
"6785","ENSMODG00000009188","3",185134977,185135807,830
"6786","ENSMODG00000009189","8",13327361,13336994,9633
"6787","ENSMODG00000009191","2",163215035,163296895,81860
"6788","ENSMODG00000009192","3",518932438,518943415,10977
"6789","ENSMODG00000009194","3",434530812,434543581,12769
"6790","ENSMODG00000009196","X",3627247,3628212,965
"6791","ENSMODG00000009198","4",300245480,300271885,26405
"6792","ENSMODG00000009200","1",158025512,158087306,61794
"6793","ENSMODG00000009201","2",163302987,163318850,15863
"6794","ENSMODG00000009203","4",300492873,300493609,736
"6795","ENSMODG00000009205","6",266301020,266646878,345858
"6796","ENSMODG00000009206","4",386364830,386369156,4326
"6797","ENSMODG00000009207","4",300570087,300666912,96825
"6798","ENSMODG00000009209","1",157049841,157052180,2339
"6799","ENSMODG00000009210","8",252542543,252690505,147962
"6800","ENSMODG00000009211","4",386388036,386392923,4887
"6801","ENSMODG00000009212","6",266968538,267178388,209850
"6802","ENSMODG00000009214","X",3680935,3681879,944
"6803","ENSMODG00000009216","1",585266444,585271707,5263
"6804","ENSMODG00000009217","2",212100857,212106178,5321
"6805","ENSMODG00000009218","1",157043441,157046911,3470
"6806","ENSMODG00000009220","4",301244442,301333459,89017
"6807","ENSMODG00000009221","3",518976974,519070499,93525
"6808","ENSMODG00000009222","4",386395199,386396596,1397
"6809","ENSMODG00000009224","1",23393266,23405256,11990
"6810","ENSMODG00000009225","X",3697922,3699969,2047
"6811","ENSMODG00000009228","4",386536555,386571762,35207
"6812","ENSMODG00000009229","1",585240455,585261727,21272
"6813","ENSMODG00000009230","3",519186760,519196884,10124
"6814","ENSMODG00000009233","8",253293779,253866970,573191
"6815","ENSMODG00000009234","4",433268531,433363597,95066
"6816","ENSMODG00000009235","1",584826987,585126161,299174
"6817","ENSMODG00000009236","X",3709354,3745975,36621
"6818","ENSMODG00000009237","5",256412064,257388530,976466
"6819","ENSMODG00000009238","4",301596598,301601950,5352
"6820","ENSMODG00000009240","1",266819850,266894373,74523
"6821","ENSMODG00000009241","2",163365319,163459373,94054
"6822","ENSMODG00000009242","1",157000897,157039519,38622
"6823","ENSMODG00000009243","X",3922570,3935259,12689
"6824","ENSMODG00000009244","1",345261210,345261675,465
"6825","ENSMODG00000009245","1",23383310,23392938,9628
"6826","ENSMODG00000009246","2",212013950,212100589,86639
"6827","ENSMODG00000009247","4",433410062,433471628,61566
"6828","ENSMODG00000009249","3",519340802,519354142,13340
"6829","ENSMODG00000009250","2",163539405,163593994,54589
"6830","ENSMODG00000009252","1",345173195,345197885,24690
"6831","ENSMODG00000009253","1",156889532,156978956,89424
"6832","ENSMODG00000009254","4",433597234,433634101,36867
"6833","ENSMODG00000009255","6",267212112,267334491,122379
"6834","ENSMODG00000009257","7",103155112,103202683,47571
"6835","ENSMODG00000009261","1",345099068,345112019,12951
"6836","ENSMODG00000009262","4",301860782,301895367,34585
"6837","ENSMODG00000009263","2",102285475,102429877,144402
"6838","ENSMODG00000009264","4",350714153,350715163,1010
"6839","ENSMODG00000009265","4",302005320,302042513,37193
"6840","ENSMODG00000009266","1",89594292,89922742,328450
"6841","ENSMODG00000009267","X",3929696,3978181,48485
"6842","ENSMODG00000009270","3",519408103,519430225,22122
"6843","ENSMODG00000009271","Un",60413805,60422164,8359
"6844","ENSMODG00000009273","1",23352212,23375173,22961
"6845","ENSMODG00000009274","6",267431038,267563038,132000
"6846","ENSMODG00000009275","3",509118146,509119657,1511
"6847","ENSMODG00000009276","Un",60423965,60425838,1873
"6848","ENSMODG00000009277","1",308603155,308604908,1753
"6849","ENSMODG00000009278","5",258075668,258211053,135385
"6850","ENSMODG00000009279","3",519429550,519466393,36843
"6851","ENSMODG00000009282","1",23338358,23350852,12494
"6852","ENSMODG00000009283","2",211913681,211977129,63448
"6853","ENSMODG00000009284","1",156752489,156797940,45451
"6854","ENSMODG00000009286","1",89947223,89955479,8256
"6855","ENSMODG00000009287","1",717623270,717647833,24563
"6856","ENSMODG00000009288","1",23313185,23323480,10295
"6857","ENSMODG00000009289","3",519461284,519464207,2923
"6858","ENSMODG00000009290","2",211856475,211876947,20472
"6859","ENSMODG00000009291","3",509527030,509536667,9637
"6860","ENSMODG00000009292","1",89999902,90025065,25163
"6861","ENSMODG00000009294","4",302294862,302398798,103936
"6862","ENSMODG00000009295","1",23272211,23300406,28195
"6863","ENSMODG00000009296","4",184885786,185181523,295737
"6864","ENSMODG00000009297","1",584705360,584732282,26922
"6865","ENSMODG00000009300","2",211752192,211810282,58090
"6866","ENSMODG00000009301","1",344997047,345057495,60448
"6867","ENSMODG00000009302","6",267906375,268005735,99360
"6868","ENSMODG00000009303","4",185285297,185289008,3711
"6869","ENSMODG00000009304","5",258262947,258325880,62933
"6870","ENSMODG00000009305","4",302495895,302621958,126063
"6871","ENSMODG00000009306","6",268035296,268254444,219148
"6872","ENSMODG00000009307","3",519483705,519504615,20910
"6873","ENSMODG00000009308","1",156360187,156397353,37166
"6874","ENSMODG00000009310","1",23260230,23270821,10591
"6875","ENSMODG00000009311","3",519508814,519511182,2368
"6876","ENSMODG00000009312","5",258625826,258806693,180867
"6877","ENSMODG00000009313","X",3995138,4064902,69764
"6878","ENSMODG00000009314","1",344914161,344969945,55784
"6879","ENSMODG00000009315","7",103528605,103749742,221137
"6880","ENSMODG00000009316","1",90043254,90076972,33718
"6881","ENSMODG00000009317","2",163659513,163762872,103359
"6882","ENSMODG00000009319","1",90085791,90086639,848
"6883","ENSMODG00000009321","7",104170869,104171693,824
"6884","ENSMODG00000009323","2",163761244,163780262,19018
"6885","ENSMODG00000009324","2",211508715,211615597,106882
"6886","ENSMODG00000009325","6",268661356,268661811,455
"6887","ENSMODG00000009326","4",185295285,185335254,39969
"6888","ENSMODG00000009327","2",163807419,163828962,21543
"6889","ENSMODG00000009328","1",584689223,584703003,13780
"6890","ENSMODG00000009329","4",433688125,433724537,36412
"6891","ENSMODG00000009333","1",344901088,344913258,12170
"6892","ENSMODG00000009335","1",717408558,717475558,67000
"6893","ENSMODG00000009336","7",104264417,104307194,42777
"6894","ENSMODG00000009337","4",185335138,185377329,42191
"6895","ENSMODG00000009341","1",584681107,584685274,4167
"6896","ENSMODG00000009342","1",90452560,90453363,803
"6897","ENSMODG00000009343","3",185833970,185851802,17832
"6898","ENSMODG00000009344","2",163953181,164018439,65258
"6899","ENSMODG00000009345","1",344300201,344829177,528976
"6900","ENSMODG00000009347","4",302643359,302674417,31058
"6901","ENSMODG00000009348","3",186031572,186035378,3806
"6902","ENSMODG00000009349","2",211327734,211454156,126422
"6903","ENSMODG00000009350","3",186278101,186279205,1104
"6904","ENSMODG00000009351","2",211302876,211315749,12873
"6905","ENSMODG00000009352","6",130658641,130773622,114981
"6906","ENSMODG00000009353","4",302704517,302851258,146741
"6907","ENSMODG00000009355","1",584645251,584660880,15629
"6908","ENSMODG00000009357","2",164065159,164099394,34235
"6909","ENSMODG00000009359","1",156044272,156101928,57656
"6910","ENSMODG00000009360","3",186470419,186483142,12723
"6911","ENSMODG00000009361","8",71177049,71296100,119051
"6912","ENSMODG00000009362","4",185382585,185435518,52933
"6913","ENSMODG00000009363","8",64033742,64200609,166867
"6914","ENSMODG00000009364","5",260509439,260510419,980
"6915","ENSMODG00000009365","1",90480006,90577030,97024
"6916","ENSMODG00000009366","4",185516016,185596117,80101
"6917","ENSMODG00000009367","3",186543303,186591441,48138
"6918","ENSMODG00000009368","1",584591879,584629522,37643
"6919","ENSMODG00000009370","1",90752556,90753569,1013
"6920","ENSMODG00000009371","1",155893712,156015221,121509
"6921","ENSMODG00000009372","1",717380210,717405205,24995
"6922","ENSMODG00000009373","7",104330444,104361251,30807
"6923","ENSMODG00000009374","8",64327869,64333779,5910
"6924","ENSMODG00000009375","2",164099709,164162731,63022
"6925","ENSMODG00000009376","5",261244567,261568965,324398
"6926","ENSMODG00000009377","1",343920538,343958580,38042
"6927","ENSMODG00000009378","1",91143617,91178134,34517
"6928","ENSMODG00000009380","8",64333913,64335815,1902
"6929","ENSMODG00000009382","4",303410406,303492534,82128
"6930","ENSMODG00000009383","1",23172044,23187564,15520
"6931","ENSMODG00000009384","2",164388807,164415382,26575
"6932","ENSMODG00000009385","1",91506782,91589174,82392
"6933","ENSMODG00000009386","1",717325662,717367583,41921
"6934","ENSMODG00000009388","1",92185295,92193607,8312
"6935","ENSMODG00000009389","3",186599159,186627566,28407
"6936","ENSMODG00000009390","4",433803705,433836707,33002
"6937","ENSMODG00000009391","8",64168922,64349896,180974
"6938","ENSMODG00000009393","1",717291789,717297533,5744
"6939","ENSMODG00000009394","1",92462862,92618862,156000
"6940","ENSMODG00000009395","7",104427855,104470709,42854
"6941","ENSMODG00000009396","1",746432924,746436120,3196
"6942","ENSMODG00000009397","2",164389016,164391058,2042
"6943","ENSMODG00000009398","3",186650950,186751169,100219
"6944","ENSMODG00000009399","7",104519881,104933895,414014
"6945","ENSMODG00000009400","1",746493456,746498388,4932
"6946","ENSMODG00000009401","2",164455992,164594936,138944
"6947","ENSMODG00000009402","1",717145629,717283983,138354
"6948","ENSMODG00000009404","7",105793629,105794592,963
"6949","ENSMODG00000009405","2",164786484,164827995,41511
"6950","ENSMODG00000009406","6",269679160,270109356,430196
"6951","ENSMODG00000009407","8",64544230,64611737,67507
"6952","ENSMODG00000009408","8",70933267,71176004,242737
"6953","ENSMODG00000009409","5",261584188,261623534,39346
"6954","ENSMODG00000009413","1",155311485,155537392,225907
"6955","ENSMODG00000009414","4",185745550,185772251,26701
"6956","ENSMODG00000009416","5",261862815,261863139,324
"6957","ENSMODG00000009417","6",270244132,270269270,25138
"6958","ENSMODG00000009418","7",107277671,108303489,1025818
"6959","ENSMODG00000009419","1",155294668,155306774,12106
"6960","ENSMODG00000009421","5",261912829,262001558,88729
"6961","ENSMODG00000009422","6",270314338,270428136,113798
"6962","ENSMODG00000009423","1",266942922,267002951,60029
"6963","ENSMODG00000009424","1",92624778,92674478,49700
"6964","ENSMODG00000009425","1",155203191,155218317,15126
"6965","ENSMODG00000009426","1",584515850,584573350,57500
"6966","ENSMODG00000009428","1",92801185,92806604,5419
"6967","ENSMODG00000009429","6",270377028,270433781,56753
"6968","ENSMODG00000009430","1",155176492,155193651,17159
"6969","ENSMODG00000009431","3",186838418,186922973,84555
"6970","ENSMODG00000009433","1",267145687,267164614,18927
"6971","ENSMODG00000009434","1",23140512,23149461,8949
"6972","ENSMODG00000009436","1",343905393,343917009,11616
"6973","ENSMODG00000009439","8",70310656,70591818,281162
"6974","ENSMODG00000009440","8",254007510,254989302,981792
"6975","ENSMODG00000009441","6",270450917,270477105,26188
"6976","ENSMODG00000009442","1",23062406,23126015,63609
"6977","ENSMODG00000009443","1",584442957,584455588,12631
"6978","ENSMODG00000009444","8",70179375,70182991,3616
"6979","ENSMODG00000009445","3",519547424,519563098,15674
"6980","ENSMODG00000009446","5",262287942,262408269,120327
"6981","ENSMODG00000009448","2",164960104,164981023,20919
"6982","ENSMODG00000009449","8",255363641,255406502,42861
"6983","ENSMODG00000009450","1",716933849,717018844,84995
"6984","ENSMODG00000009451","8",70005853,70059728,53875
"6985","ENSMODG00000009452","2",165024323,165026019,1696
"6986","ENSMODG00000009453","3",519627092,519804924,177832
"6987","ENSMODG00000009454","4",303592118,304088716,496598
"6988","ENSMODG00000009456","5",262437583,262454171,16588
"6989","ENSMODG00000009457","1",267028403,267110730,82327
"6990","ENSMODG00000009460","1",267123304,267124668,1364
"6991","ENSMODG00000009461","5",262664501,262670103,5602
"6992","ENSMODG00000009462","4",304089134,304102547,13413
"6993","ENSMODG00000009463","1",23042533,23058635,16102
"6994","ENSMODG00000009464","4",185829044,186105072,276028
"6995","ENSMODG00000009465","3",519669040,519836352,167312
"6996","ENSMODG00000009466","2",165252994,165268692,15698
"6997","ENSMODG00000009467","1",155009847,155171285,161438
"6998","ENSMODG00000009468","8",69971670,69993479,21809
"6999","ENSMODG00000009469","3",519755209,519790767,35558
"7000","ENSMODG00000009471","8",255432338,255472651,40313
"7001","ENSMODG00000009472","1",22922378,22980331,57953
"7002","ENSMODG00000009473","1",716894883,716931841,36958
"7003","ENSMODG00000009474","4",405963211,405968665,5454
"7004","ENSMODG00000009475","5",263084468,263181828,97360
"7005","ENSMODG00000009476","1",92966161,93083192,117031
"7006","ENSMODG00000009477","1",343795831,343839000,43169
"7007","ENSMODG00000009478","5",263196818,263468169,271351
"7008","ENSMODG00000009479","1",93038624,93039346,722
"7009","ENSMODG00000009480","1",716835506,716861966,26460
"7010","ENSMODG00000009482","1",584262347,584340653,78306
"7011","ENSMODG00000009483","3",519795549,519810066,14517
"7012","ENSMODG00000009484","1",22848633,22871643,23010
"7013","ENSMODG00000009485","1",343745531,343750680,5149
"7014","ENSMODG00000009486","1",93085447,93261399,175952
"7015","ENSMODG00000009487","1",267227182,267255252,28070
"7016","ENSMODG00000009488","8",69352687,69491376,138689
"7017","ENSMODG00000009489","1",716710817,716766774,55957
"7018","ENSMODG00000009490","3",519816102,519835758,19656
"7019","ENSMODG00000009491","1",584228109,584236663,8554
"7020","ENSMODG00000009492","8",69261852,69346244,84392
"7021","ENSMODG00000009494","3",519868674,519869240,566
"7022","ENSMODG00000009496","2",165341084,165363820,22736
"7023","ENSMODG00000009498","6",270895688,271377389,481701
"7024","ENSMODG00000009499","2",411983884,411985184,1300
"7025","ENSMODG00000009501","1",93303875,93396038,92163
"7026","ENSMODG00000009502","1",584187478,584191805,4327
"7027","ENSMODG00000009503","8",68516151,68636847,120696
"7028","ENSMODG00000009505","1",93401606,93413604,11998
"7029","ENSMODG00000009506","6",272034209,272034918,709
"7030","ENSMODG00000009507","2",102459035,102562893,103858
"7031","ENSMODG00000009510","3",187417514,187453863,36349
"7032","ENSMODG00000009511","3",520247561,520284950,37389
"7033","ENSMODG00000009513","1",716671734,716677051,5317
"7034","ENSMODG00000009514","4",186174410,186272724,98314
"7035","ENSMODG00000009516","4",304116271,304197558,81287
"7036","ENSMODG00000009519","1",93430247,93463464,33217
"7037","ENSMODG00000009520","4",186294355,186297521,3166
"7038","ENSMODG00000009521","4",433973028,433986377,13349
"7039","ENSMODG00000009522","6",273394526,273406799,12273
"7040","ENSMODG00000009523","5",265372890,265374865,1975
"7041","ENSMODG00000009524","4",304203517,304227444,23927
"7042","ENSMODG00000009526","5",265532530,265542057,9527
"7043","ENSMODG00000009527","1",154413267,154750072,336805
"7044","ENSMODG00000009529","5",265671036,265684608,13572
"7045","ENSMODG00000009530","1",716608305,716615924,7619
"7046","ENSMODG00000009531","4",304264872,304331896,67024
"7047","ENSMODG00000009534","8",13377188,13384304,7116
"7048","ENSMODG00000009536","4",187207801,187288859,81058
"7049","ENSMODG00000009537","6",273427349,273436480,9131
"7050","ENSMODG00000009538","1",343648606,343711006,62400
"7051","ENSMODG00000009539","8",64651488,64660984,9496
"7052","ENSMODG00000009540","1",584130478,584177585,47107
"7053","ENSMODG00000009541","8",13394959,13397683,2724
"7054","ENSMODG00000009542","6",133180373,133346024,165651
"7055","ENSMODG00000009543","1",93507381,93528824,21443
"7056","ENSMODG00000009545","1",343473818,343481736,7918
"7057","ENSMODG00000009546","4",187417681,187422136,4455
"7058","ENSMODG00000009547","8",13398885,13400121,1236
"7059","ENSMODG00000009548","5",265803048,266036437,233389
"7060","ENSMODG00000009549","2",165363357,165409554,46197
"7061","ENSMODG00000009552","1",716577407,716587974,10567
"7062","ENSMODG00000009553","1",584113560,584116208,2648
"7063","ENSMODG00000009554","1",343455779,343461646,5867
"7064","ENSMODG00000009557","3",520341138,520367546,26408
"7065","ENSMODG00000009558","8",64733714,64757318,23604
"7066","ENSMODG00000009560","5",266377328,266461306,83978
"7067","ENSMODG00000009561","1",267362925,267456385,93460
"7068","ENSMODG00000009563","4",434251978,434635214,383236
"7069","ENSMODG00000009565","4",187447938,187449905,1967
"7070","ENSMODG00000009566","1",154020381,154379192,358811
"7071","ENSMODG00000009567","5",266929553,267005356,75803
"7072","ENSMODG00000009568","8",64825612,64852440,26828
"7073","ENSMODG00000009571","2",165465038,165469658,4620
"7074","ENSMODG00000009573","3",187778625,187779650,1025
"7075","ENSMODG00000009574","1",343431456,343454069,22613
"7076","ENSMODG00000009575","8",64863091,64877716,14625
"7077","ENSMODG00000009577","4",187458099,187460859,2760
"7078","ENSMODG00000009578","1",716506826,716539416,32590
"7079","ENSMODG00000009579","4",434645145,434690885,45740
"7080","ENSMODG00000009580","5",267004280,267111186,106906
"7081","ENSMODG00000009581","8",13400563,13410639,10076
"7082","ENSMODG00000009582","1",584092941,584104791,11850
"7083","ENSMODG00000009583","1",93547153,93565140,17987
"7084","ENSMODG00000009584","8",64950261,64954434,4173
"7085","ENSMODG00000009585","1",153940655,154020984,80329
"7086","ENSMODG00000009586","4",435018415,435036050,17635
"7087","ENSMODG00000009587","1",716495810,716791073,295263
"7088","ENSMODG00000009589","1",93678659,93739042,60383
"7089","ENSMODG00000009591","4",187463911,187466684,2773
"7090","ENSMODG00000009592","1",584064335,584069096,4761
"7091","ENSMODG00000009593","4",187471806,187475249,3443
"7092","ENSMODG00000009595","4",435057258,435079521,22263
"7093","ENSMODG00000009596","5",267118538,267393854,275316
"7094","ENSMODG00000009597","8",64996737,65008916,12179
"7095","ENSMODG00000009598","4",187497377,187500060,2683
"7096","ENSMODG00000009601","1",716440919,716454744,13825
"7097","ENSMODG00000009603","8",13416231,13428319,12088
"7098","ENSMODG00000009604","4",187537162,187540762,3600
"7099","ENSMODG00000009606","1",93798710,94097237,298527
"7100","ENSMODG00000009608","4",369417058,369437611,20553
"7101","ENSMODG00000009609","1",153763820,153937277,173457
"7102","ENSMODG00000009610","3",512456311,512465135,8824
"7103","ENSMODG00000009611","5",267397420,267421295,23875
"7104","ENSMODG00000009612","3",188075341,188132595,57254
"7105","ENSMODG00000009613","8",65018904,65042470,23566
"7106","ENSMODG00000009614","1",584033642,584050578,16936
"7107","ENSMODG00000009615","1",343244849,343256921,12072
"7108","ENSMODG00000009617","4",187634711,187754907,120196
"7109","ENSMODG00000009618","8",255476524,255600750,124226
"7110","ENSMODG00000009619","1",583988706,583993780,5074
"7111","ENSMODG00000009620","1",153106920,153218927,112007
"7112","ENSMODG00000009621","2",165478730,165692718,213988
"7113","ENSMODG00000009622","3",512526374,512537094,10720
"7114","ENSMODG00000009623","2",514344527,514378883,34356
"7115","ENSMODG00000009624","4",189006269,189048229,41960
"7116","ENSMODG00000009625","5",267814117,267831781,17664
"7117","ENSMODG00000009626","8",13444138,13461400,17262
"7118","ENSMODG00000009627","8",65063515,65075122,11607
"7119","ENSMODG00000009629","2",165532351,165533879,1528
"7120","ENSMODG00000009630","4",304373699,304612530,238831
"7121","ENSMODG00000009632","1",152754310,152777976,23666
"7122","ENSMODG00000009633","8",65076594,65079558,2964
"7123","ENSMODG00000009635","3",188647165,188830950,183785
"7124","ENSMODG00000009636","4",304898244,304958895,60651
"7125","ENSMODG00000009637","8",255985258,256100720,115462
"7126","ENSMODG00000009638","8",65081779,65089812,8033
"7127","ENSMODG00000009640","1",94765900,95389049,623149
"7128","ENSMODG00000009641","8",65097154,65123685,26531
"7129","ENSMODG00000009642","1",583970750,583986035,15285
"7130","ENSMODG00000009643","1",716015054,716077959,62905
"7131","ENSMODG00000009644","2",165549519,165560872,11353
"7132","ENSMODG00000009645","3",189124215,189178511,54296
"7133","ENSMODG00000009646","5",268102831,268165744,62913
"7134","ENSMODG00000009647","8",13464943,13476652,11709
"7135","ENSMODG00000009648","1",152735150,152752507,17357
"7136","ENSMODG00000009649","1",715939393,715959236,19843
"7137","ENSMODG00000009650","1",343142888,343235495,92607
"7138","ENSMODG00000009651","3",512547017,512606767,59750
"7139","ENSMODG00000009654","8",67409968,67474419,64451
"7140","ENSMODG00000009655","8",65136837,65205284,68447
"7141","ENSMODG00000009657","1",152724015,152730883,6868
"7142","ENSMODG00000009658","1",267465395,267644911,179516
"7143","ENSMODG00000009659","8",13476695,13510401,33706
"7144","ENSMODG00000009660","1",583933596,583953601,20005
"7145","ENSMODG00000009661","2",514378630,514394347,15717
"7146","ENSMODG00000009664","1",267708538,267746868,38330
"7147","ENSMODG00000009665","8",13515577,13517419,1842
"7148","ENSMODG00000009667","8",67343547,67359684,16137
"7149","ENSMODG00000009668","1",267751915,267754845,2930
"7150","ENSMODG00000009669","8",67294023,67299865,5842
"7151","ENSMODG00000009670","1",583896948,583903537,6589
"7152","ENSMODG00000009671","3",512609818,512612754,2936
"7153","ENSMODG00000009674","3",512628373,512692214,63841
"7154","ENSMODG00000009675","1",267773494,267831429,57935
"7155","ENSMODG00000009676","1",95543715,95728550,184835
"7156","ENSMODG00000009677","1",583752934,584067383,314449
"7157","ENSMODG00000009678","5",268328681,268351848,23167
"7158","ENSMODG00000009679","2",514398572,514665282,266710
"7159","ENSMODG00000009680","1",21976482,22187432,210950
"7160","ENSMODG00000009681","8",65221561,65259917,38356
"7161","ENSMODG00000009682","8",67200831,67238757,37926
"7162","ENSMODG00000009684","1",443728238,444148929,420691
"7163","ENSMODG00000009685","1",583878775,583882966,4191
"7164","ENSMODG00000009686","4",189312792,189501728,188936
"7165","ENSMODG00000009687","8",65242023,65263721,21698
"7166","ENSMODG00000009689","1",22186464,22219572,33108
"7167","ENSMODG00000009690","5",268350590,268427838,77248
"7168","ENSMODG00000009691","4",305021621,305239343,217722
"7169","ENSMODG00000009694","1",21820191,21839986,19795
"7170","ENSMODG00000009695","8",256122634,256255573,132939
"7171","ENSMODG00000009698","3",512745756,512757649,11893
"7172","ENSMODG00000009701","1",267897884,267979925,82041
"7173","ENSMODG00000009702","4",189592570,189594567,1997
"7174","ENSMODG00000009703","1",343097916,343124565,26649
"7175","ENSMODG00000009706","5",268567148,268713303,146155
"7176","ENSMODG00000009707","X",72271982,72293345,21363
"7177","ENSMODG00000009708","1",343073402,343087442,14040
"7178","ENSMODG00000009712","1",267990250,268024905,34655
"7179","ENSMODG00000009713","1",95685187,95732104,46917
"7180","ENSMODG00000009714","3",521779334,521789303,9969
"7181","ENSMODG00000009715","1",152604649,152719404,114755
"7182","ENSMODG00000009717","8",13524416,13540077,15661
"7183","ENSMODG00000009718","5",268719980,268740154,20174
"7184","ENSMODG00000009719","8",256307983,256405649,97666
"7185","ENSMODG00000009722","8",256413070,256423225,10155
"7186","ENSMODG00000009724","1",152556749,152568148,11399
"7187","ENSMODG00000009726","Un",25403323,25458618,55295
"7188","ENSMODG00000009728","5",268744749,268796115,51366
"7189","ENSMODG00000009729","8",256547795,256670137,122342
"7190","ENSMODG00000009730","4",190024478,190124392,99914
"7191","ENSMODG00000009731","1",268695980,268951055,255075
"7192","ENSMODG00000009732","3",512766870,512820241,53371
"7193","ENSMODG00000009733","Un",25476384,25501458,25074
"7194","ENSMODG00000009735","2",211188695,211283728,95033
"7195","ENSMODG00000009737","1",342957445,343027442,69997
"7196","ENSMODG00000009738","Un",25590584,25591522,938
"7197","ENSMODG00000009741","1",583832875,583876371,43496
"7198","ENSMODG00000009742","4",190201002,190221690,20688
"7199","ENSMODG00000009743","1",21834557,21931423,96866
"7200","ENSMODG00000009745","5",268799430,268876645,77215
"7201","ENSMODG00000009747","1",583716027,583721239,5212
"7202","ENSMODG00000009748","1",21765170,21767317,2147
"7203","ENSMODG00000009749","1",95942709,96231421,288712
"7204","ENSMODG00000009751","8",13538581,13547061,8480
"7205","ENSMODG00000009754","6",72456593,72484749,28156
"7206","ENSMODG00000009755","1",746859047,746864562,5515
"7207","ENSMODG00000009756","3",341910124,341958234,48110
"7208","ENSMODG00000009758","3",512836414,512873336,36922
"7209","ENSMODG00000009759","1",342879191,342928355,49164
"7210","ENSMODG00000009760","1",152516368,152557491,41123
"7211","ENSMODG00000009761","1",96294019,96454384,160365
"7212","ENSMODG00000009763","1",746887501,746907267,19766
"7213","ENSMODG00000009764","4",306058100,306096054,37954
"7214","ENSMODG00000009765","X",72253722,72268150,14428
"7215","ENSMODG00000009766","1",269727816,269730713,2897
"7216","ENSMODG00000009767","1",152252735,152253302,567
"7217","ENSMODG00000009770","3",512874360,512928540,54180
"7218","ENSMODG00000009771","1",96454212,96487236,33024
"7219","ENSMODG00000009772","X",72240031,72241173,1142
"7220","ENSMODG00000009773","3",341879303,341903326,24023
"7221","ENSMODG00000009774","8",106093098,106291251,198153
"7222","ENSMODG00000009775","1",746983466,747000286,16820
"7223","ENSMODG00000009776","7",114374531,114377356,2825
"7224","ENSMODG00000009777","8",13642575,13653452,10877
"7225","ENSMODG00000009778","6",72554265,72584097,29832
"7226","ENSMODG00000009779","3",513015020,513023107,8087
"7227","ENSMODG00000009781","5",268981701,269074566,92865
"7228","ENSMODG00000009782","8",13662168,13665820,3652
"7229","ENSMODG00000009783","3",513025012,513026877,1865
"7230","ENSMODG00000009785","1",583431648,583547465,115817
"7231","ENSMODG00000009786","3",341760342,341802069,41727
"7232","ENSMODG00000009788","1",96522048,96586933,64885
"7233","ENSMODG00000009794","8",13673082,13685985,12903
"7234","ENSMODG00000009795","1",151972833,152464132,491299
"7235","ENSMODG00000009796","4",190463109,190587438,124329
"7236","ENSMODG00000009798","1",342826662,342876442,49780
"7237","ENSMODG00000009800","1",581322729,581330884,8155
"7238","ENSMODG00000009801","5",269299273,269475853,176580
"7239","ENSMODG00000009804","3",340477879,340664060,186181
"7240","ENSMODG00000009805","1",342814277,342815848,1571
"7241","ENSMODG00000009806","5",269497114,269510149,13035
"7242","ENSMODG00000009807","1",581255619,581256704,1085
"7243","ENSMODG00000009808","1",21660063,21709366,49303
"7244","ENSMODG00000009809","5",269460356,269536941,76585
"7245","ENSMODG00000009810","1",151944130,151965483,21353
"7246","ENSMODG00000009811","1",747036231,747095141,58910
"7247","ENSMODG00000009814","1",21635541,21660686,25145
"7248","ENSMODG00000009815","1",715565441,715902454,337013
"7249","ENSMODG00000009816","1",747208227,747210693,2466
"7250","ENSMODG00000009817","2",210981370,210999570,18200
"7251","ENSMODG00000009818","8",256729856,256743055,13199
"7252","ENSMODG00000009819","1",715429485,715430093,608
"7253","ENSMODG00000009820","1",342785990,342794150,8160
"7254","ENSMODG00000009821","1",96588556,96651503,62947
"7255","ENSMODG00000009822","1",21566326,21616326,50000
"7256","ENSMODG00000009823","4",190655613,190673645,18032
"7257","ENSMODG00000009825","1",581166974,581200576,33602
"7258","ENSMODG00000009826","3",340376589,340408706,32117
"7259","ENSMODG00000009827","2",211162115,211172458,10343
"7260","ENSMODG00000009829","5",269554058,269569792,15734
"7261","ENSMODG00000009832","3",501083343,501098364,15021
"7262","ENSMODG00000009833","2",211142509,211145130,2621
"7263","ENSMODG00000009834","1",96753327,96943496,190169
"7264","ENSMODG00000009835","1",715725567,715726178,611
"7265","ENSMODG00000009836","8",13709418,13730134,20716
"7266","ENSMODG00000009837","1",21385866,21410526,24660
"7267","ENSMODG00000009838","1",151655527,151829461,173934
"7268","ENSMODG00000009839","3",339312561,339906970,594409
"7269","ENSMODG00000009840","1",581110156,581136620,26464
"7270","ENSMODG00000009842","3",338998361,339190264,191903
"7271","ENSMODG00000009844","8",256781638,256843711,62073
"7272","ENSMODG00000009845","3",513096751,513201857,105106
"7273","ENSMODG00000009847","X",72193304,72212964,19660
"7274","ENSMODG00000009849","1",715123903,715124532,629
"7275","ENSMODG00000009852","1",96954896,97024101,69205
"7276","ENSMODG00000009854","4",190675663,190683949,8286
"7277","ENSMODG00000009856","3",513224126,513240943,16817
"7278","ENSMODG00000009857","2",211101476,211111657,10181
"7279","ENSMODG00000009859","2",514690760,514814399,123639
"7280","ENSMODG00000009860","X",72187223,72194515,7292
"7281","ENSMODG00000009861","1",151605041,151653718,48677
"7282","ENSMODG00000009862","4",190686836,190700963,14127
"7283","ENSMODG00000009863","3",189191999,189772886,580887
"7284","ENSMODG00000009864","2",165719272,165720571,1299
"7285","ENSMODG00000009865","1",20593118,20668111,74993
"7286","ENSMODG00000009867","5",269819383,269873916,54533
"7287","ENSMODG00000009868","2",514827609,514908861,81252
"7288","ENSMODG00000009869","1",20488211,20595372,107161
"7289","ENSMODG00000009870","1",270682786,271296195,613409
"7290","ENSMODG00000009871","4",190704924,190734385,29461
"7291","ENSMODG00000009872","1",97025261,97055176,29915
"7292","ENSMODG00000009873","2",211095253,211100457,5204
"7293","ENSMODG00000009874","8",65486571,65662130,175559
"7294","ENSMODG00000009876","1",151515002,151545515,30513
"7295","ENSMODG00000009877","3",338655742,338864592,208850
"7296","ENSMODG00000009878","3",338156054,338579782,423728
"7297","ENSMODG00000009879","1",342619553,342726241,106688
"7298","ENSMODG00000009881","1",97163896,97194490,30594
"7299","ENSMODG00000009882","8",65347960,65439658,91698
"7300","ENSMODG00000009883","1",20215050,20344486,129436
"7301","ENSMODG00000009884","2",514916131,514983329,67198
"7302","ENSMODG00000009885","8",13962203,14101565,139362
"7303","ENSMODG00000009886","1",271446896,271535902,89006
"7304","ENSMODG00000009887","1",97221973,97272875,50902
"7305","ENSMODG00000009888","1",580795573,580818319,22746
"7306","ENSMODG00000009889","8",65433518,65435597,2079
"7307","ENSMODG00000009890","5",269879432,269907285,27853
"7308","ENSMODG00000009891","1",342552079,342610056,57977
"7309","ENSMODG00000009892","3",337336871,337413644,76773
"7310","ENSMODG00000009893","1",151480394,151515769,35375
"7311","ENSMODG00000009894","X",72170730,72186944,16214
"7312","ENSMODG00000009895","1",342201356,342278695,77339
"7313","ENSMODG00000009896","1",271548706,271569579,20873
"7314","ENSMODG00000009897","1",579918674,580239342,320668
"7315","ENSMODG00000009899","X",72152920,72155775,2855
"7316","ENSMODG00000009901","2",211083070,211095577,12507
"7317","ENSMODG00000009904","Un",91075793,91076433,640
"7318","ENSMODG00000009905","8",256860317,257160037,299720
"7319","ENSMODG00000009906","1",579593975,579597247,3272
"7320","ENSMODG00000009907","3",190663894,191224878,560984
"7321","ENSMODG00000009909","2",514992987,515042135,49148
"7322","ENSMODG00000009910","X",72132275,72138172,5897
"7323","ENSMODG00000009911","1",271569305,271589173,19868
"7324","ENSMODG00000009912","5",269913900,269966856,52956
"7325","ENSMODG00000009913","4",370005149,370162072,156923
"7326","ENSMODG00000009914","4",307669218,308509086,839868
"7327","ENSMODG00000009915","3",513321608,513500369,178761
"7328","ENSMODG00000009916","7",117138427,117140032,1605
"7329","ENSMODG00000009917","2",211054675,211077550,22875
"7330","ENSMODG00000009919","2",515069894,515091592,21698
"7331","ENSMODG00000009920","1",579410215,579506829,96614
"7332","ENSMODG00000009921","3",520786309,520804280,17971
"7333","ENSMODG00000009924","1",19999028,20184964,185936
"7334","ENSMODG00000009925","X",72118685,72125158,6473
"7335","ENSMODG00000009926","1",271593452,271611627,18175
"7336","ENSMODG00000009927","3",525942863,525948962,6099
"7337","ENSMODG00000009929","7",118071949,118074474,2525
"7338","ENSMODG00000009931","7",118072539,118074536,1997
"7339","ENSMODG00000009932","1",579280492,579380898,100406
"7340","ENSMODG00000009937","1",342090385,342141481,51096
"7341","ENSMODG00000009938","2",515167311,515244262,76951
"7342","ENSMODG00000009939","3",337133650,337236263,102613
"7343","ENSMODG00000009940","2",211011676,211028778,17102
"7344","ENSMODG00000009941","1",19479577,19528953,49376
"7345","ENSMODG00000009942","8",257189074,257424898,235824
"7346","ENSMODG00000009944","1",342073477,342074135,658
"7347","ENSMODG00000009945","2",210965008,210966343,1335
"7348","ENSMODG00000009946","4",369943685,369971090,27405
"7349","ENSMODG00000009947","4",308639841,309047706,407865
"7350","ENSMODG00000009948","8",257508151,257515450,7299
"7351","ENSMODG00000009949","8",13776874,13795055,18181
"7352","ENSMODG00000009950","Un",47927771,47940455,12684
"7353","ENSMODG00000009951","1",19395719,19475983,80264
"7354","ENSMODG00000009952","1",271827979,271906755,78776
"7355","ENSMODG00000009955","2",515264024,515335536,71512
"7356","ENSMODG00000009956","5",270216028,270250327,34299
"7357","ENSMODG00000009958","2",165684255,165726911,42656
"7358","ENSMODG00000009959","2",515392047,515411579,19532
"7359","ENSMODG00000009960","8",257514563,257621206,106643
"7360","ENSMODG00000009961","1",271914008,271930252,16244
"7361","ENSMODG00000009962","1",578770727,578832139,61412
"7362","ENSMODG00000009963","4",369836397,369849575,13178
"7363","ENSMODG00000009964","3",337096266,337133719,37453
"7364","ENSMODG00000009965","4",309114009,309160059,46050
"7365","ENSMODG00000009966","1",19290592,19378284,87692
"7366","ENSMODG00000009967","2",515437297,515438904,1607
"7367","ENSMODG00000009970","4",370091204,370092138,934
"7368","ENSMODG00000009971","1",18257047,18364829,107782
"7369","ENSMODG00000009972","5",270259040,270324444,65404
"7370","ENSMODG00000009974","4",309205234,309305058,99824
"7371","ENSMODG00000009975","Un",47941349,47961775,20426
"7372","ENSMODG00000009976","2",165756069,165760815,4746
"7373","ENSMODG00000009978","1",271961638,272001435,39797
"7374","ENSMODG00000009980","4",309307604,309340236,32632
"7375","ENSMODG00000009981","1",578727935,578760684,32749
"7376","ENSMODG00000009982","3",336887346,336936959,49613
"7377","ENSMODG00000009983","2",210828866,210963868,135002
"7378","ENSMODG00000009985","1",578695774,578699547,3773
"7379","ENSMODG00000009987","1",17507198,17567351,60153
"7380","ENSMODG00000009988","2",165770117,165779880,9763
"7381","ENSMODG00000009989","5",270621874,270694867,72993
"7382","ENSMODG00000009990","2",210813345,210993387,180042
"7383","ENSMODG00000009991","2",165850564,165852246,1682
"7384","ENSMODG00000009992","1",272001852,272027177,25325
"7385","ENSMODG00000009993","4",309552037,309585441,33404
"7386","ENSMODG00000009994","2",210752297,210786621,34324
"7387","ENSMODG00000009995","4",310112083,310128351,16268
"7388","ENSMODG00000009996","3",336851686,336876540,24854
"7389","ENSMODG00000009997","5",270907506,270951409,43903
"7390","ENSMODG00000009998","1",272039248,272052931,13683
"7391","ENSMODG00000009999","1",341596951,341754231,157280
"7392","ENSMODG00000010000","1",17389880,17458828,68948
"7393","ENSMODG00000010001","2",515510426,515802755,292329
"7394","ENSMODG00000010002","1",715306635,715311393,4758
"7395","ENSMODG00000010003","1",578638197,578656531,18334
"7396","ENSMODG00000010004","3",513549701,513606417,56716
"7397","ENSMODG00000010005","2",210699624,210747945,48321
"7398","ENSMODG00000010006","1",272097593,272113070,15477
"7399","ENSMODG00000010008","1",17419425,17420111,686
"7400","ENSMODG00000010009","2",165939502,165945970,6468
"7401","ENSMODG00000010010","8",13914517,13940096,25579
"7402","ENSMODG00000010011","1",17366752,17368171,1419
"7403","ENSMODG00000010012","3",336448069,336663535,215466
"7404","ENSMODG00000010014","2",515808332,515816636,8304
"7405","ENSMODG00000010015","5",270950208,271037419,87211
"7406","ENSMODG00000010017","4",310146797,310238594,91797
"7407","ENSMODG00000010018","X",72110282,72118470,8188
"7408","ENSMODG00000010021","1",17310845,17311834,989
"7409","ENSMODG00000010022","3",336426321,336449946,23625
"7410","ENSMODG00000010023","4",370090308,370239827,149519
"7411","ENSMODG00000010024","2",165972092,165996800,24708
"7412","ENSMODG00000010025","2",515846172,516018691,172519
"7413","ENSMODG00000010026","3",336239634,336328284,88650
"7414","ENSMODG00000010028","3",513661944,513705389,43445
"7415","ENSMODG00000010029","2",516045245,516057814,12569
"7416","ENSMODG00000010030","3",336182606,336200178,17572
"7417","ENSMODG00000010032","2",165997821,166009513,11692
"7418","ENSMODG00000010033","X",72104366,72109281,4915
"7419","ENSMODG00000010034","8",258377129,258471742,94613
"7420","ENSMODG00000010036","3",513884540,513952829,68289
"7421","ENSMODG00000010037","X",72090713,72092433,1720
"7422","ENSMODG00000010038","2",516057248,516075697,18449
"7423","ENSMODG00000010039","2",166036566,166087101,50535
"7424","ENSMODG00000010040","3",514036459,514041469,5010
"7425","ENSMODG00000010041","1",341422334,341592812,170478
"7426","ENSMODG00000010043","4",310269644,310328222,58578
"7427","ENSMODG00000010044","3",335659401,335691420,32019
"7428","ENSMODG00000010045","8",14113978,14136402,22424
"7429","ENSMODG00000010046","2",166113603,166173862,60259
"7430","ENSMODG00000010047","2",516092474,516102891,10417
"7431","ENSMODG00000010048","X",72087869,72089691,1822
"7432","ENSMODG00000010049","Un",42304603,42322231,17628
"7433","ENSMODG00000010050","2",166167748,166186027,18279
"7434","ENSMODG00000010052","4",310329423,310346934,17511
"7435","ENSMODG00000010053","2",166292678,166294201,1523
"7436","ENSMODG00000010054","8",258509374,258741369,231995
"7437","ENSMODG00000010055","6",72586049,72710689,124640
"7438","ENSMODG00000010056","3",514062561,514144932,82371
"7439","ENSMODG00000010057","2",166331119,166332183,1064
"7440","ENSMODG00000010059","Un",42355980,42370338,14358
"7441","ENSMODG00000010060","2",166838388,166839341,953
"7442","ENSMODG00000010061","3",514167292,514168371,1079
"7443","ENSMODG00000010062","1",578471401,578588948,117547
"7444","ENSMODG00000010063","X",72083429,72085937,2508
"7445","ENSMODG00000010064","8",258927259,259110426,183167
"7446","ENSMODG00000010066","3",514172134,514187221,15087
"7447","ENSMODG00000010067","Un",42373418,42376056,2638
"7448","ENSMODG00000010068","8",14156028,14158746,2718
"7449","ENSMODG00000010069","X",72080833,72082741,1908
"7450","ENSMODG00000010070","3",514514348,514515577,1229
"7451","ENSMODG00000010073","2",166539782,166543570,3788
"7452","ENSMODG00000010074","1",97290034,97381064,91030
"7453","ENSMODG00000010075","2",210586472,210696290,109818
"7454","ENSMODG00000010077","1",272133925,272234871,100946
"7455","ENSMODG00000010078","3",514268304,514272655,4351
"7456","ENSMODG00000010083","8",259181521,259265599,84078
"7457","ENSMODG00000010085","4",310343410,310393488,50078
"7458","ENSMODG00000010087","2",210470783,210496515,25732
"7459","ENSMODG00000010088","8",14204890,14208880,3990
"7460","ENSMODG00000010089","1",97377945,97461325,83380
"7461","ENSMODG00000010090","1",578418829,578455531,36702
"7462","ENSMODG00000010091","8",14210188,14215379,5191
"7463","ENSMODG00000010092","X",72065949,72074312,8363
"7464","ENSMODG00000010093","1",578396183,578407188,11005
"7465","ENSMODG00000010094","1",747244806,747285246,40440
"7466","ENSMODG00000010095","8",14215366,14217664,2298
"7467","ENSMODG00000010096","1",340706340,341196649,490309
"7468","ENSMODG00000010097","1",747287536,747289620,2084
"7469","ENSMODG00000010098","8",259285670,259302615,16945
"7470","ENSMODG00000010099","X",72059364,72064094,4730
"7471","ENSMODG00000010101","1",340614163,340615413,1250
"7472","ENSMODG00000010102","2",210035550,210458360,422810
"7473","ENSMODG00000010106","8",259306530,259389344,82814
"7474","ENSMODG00000010107","3",514280128,514359580,79452
"7475","ENSMODG00000010108","8",14220604,14223956,3352
"7476","ENSMODG00000010111","X",71690718,71995910,305192
"7477","ENSMODG00000010114","1",272237973,272290385,52412
"7478","ENSMODG00000010115","2",209283156,209554647,271491
"7479","ENSMODG00000010118","4",190761681,191025497,263816
"7480","ENSMODG00000010119","8",14228456,14233695,5239
"7481","ENSMODG00000010120","1",578335952,578354141,18189
"7482","ENSMODG00000010122","1",273762102,273766170,4068
"7483","ENSMODG00000010123","8",14228706,14283422,54716
"7484","ENSMODG00000010124","1",340549647,340609906,60259
"7485","ENSMODG00000010126","X",72021533,72022598,1065
"7486","ENSMODG00000010127","2",516163274,516321894,158620
"7487","ENSMODG00000010128","1",578145678,578149624,3946
"7488","ENSMODG00000010129","8",259382996,259422060,39064
"7489","ENSMODG00000010133","1",97909018,98145814,236796
"7490","ENSMODG00000010134","8",14239005,14242501,3496
"7491","ENSMODG00000010135","3",514394966,514478431,83465
"7492","ENSMODG00000010136","Un",44498456,44544692,46236
"7493","ENSMODG00000010137","1",340435138,340436481,1343
"7494","ENSMODG00000010139","3",514517646,514519646,2000
"7495","ENSMODG00000010141","X",27301137,27335520,34383
"7496","ENSMODG00000010142","1",273801048,273802379,1331
"7497","ENSMODG00000010143","2",166715007,166839063,124056
"7498","ENSMODG00000010144","Un",44549473,44564819,15346
"7499","ENSMODG00000010145","4",311080898,311126510,45612
"7500","ENSMODG00000010146","2",516425165,516632006,206841
"7501","ENSMODG00000010149","3",514526200,514546915,20715
"7502","ENSMODG00000010152","2",209195548,209303017,107469
"7503","ENSMODG00000010153","4",191113288,191430449,317161
"7504","ENSMODG00000010157","2",516689924,516750386,60462
"7505","ENSMODG00000010158","8",259421285,259524026,102741
"7506","ENSMODG00000010160","2",166989547,167002547,13000
"7507","ENSMODG00000010161","1",98358208,98799790,441582
"7508","ENSMODG00000010162","3",514546921,514576947,30026
"7509","ENSMODG00000010165","X",27459520,27483460,23940
"7510","ENSMODG00000010166","X",71967503,71975542,8039
"7511","ENSMODG00000010167","4",311242990,311521852,278862
"7512","ENSMODG00000010168","3",192269365,192270894,1529
"7513","ENSMODG00000010169","2",167196345,167197277,932
"7514","ENSMODG00000010171","8",259621102,259651883,30781
"7515","ENSMODG00000010173","3",193384876,193389150,4274
"7516","ENSMODG00000010174","2",516765140,516803086,37946
"7517","ENSMODG00000010176","1",578019399,578060846,41447
"7518","ENSMODG00000010177","4",191460148,191603837,143689
"7519","ENSMODG00000010180","1",273875279,274002698,127419
"7520","ENSMODG00000010181","X",27793897,27802775,8878
"7521","ENSMODG00000010182","1",340258953,340335084,76131
"7522","ENSMODG00000010183","1",577903969,577907457,3488
"7523","ENSMODG00000010184","3",193691090,193706258,15168
"7524","ENSMODG00000010186","8",14262150,14268595,6445
"7525","ENSMODG00000010187","2",516857648,516878197,20549
"7526","ENSMODG00000010189","X",27905208,27953551,48343
"7527","ENSMODG00000010191","3",194584403,194653225,68822
"7528","ENSMODG00000010193","3",514625580,514740414,114834
"7529","ENSMODG00000010195","6",273548080,273908197,360117
"7530","ENSMODG00000010196","1",577871343,577902748,31405
"7531","ENSMODG00000010197","X",28005315,28022907,17592
"7532","ENSMODG00000010198","1",98802540,98824302,21762
"7533","ENSMODG00000010199","Un",74924662,74930723,6061
"7534","ENSMODG00000010200","8",14277614,14281371,3757
"7535","ENSMODG00000010201","4",191844319,192104126,259807
"7536","ENSMODG00000010202","4",312533295,312740890,207595
"7537","ENSMODG00000010203","1",26039110,26071731,32621
"7538","ENSMODG00000010204","1",17173083,17199563,26480
"7539","ENSMODG00000010205","8",14359226,14372666,13440
"7540","ENSMODG00000010207","1",26113612,26128190,14578
"7541","ENSMODG00000010208","1",151386824,151474552,87728
"7542","ENSMODG00000010209","X",28031442,28042532,11090
"7543","ENSMODG00000010210","Un",69029151,69082528,53377
"7544","ENSMODG00000010211","4",312765988,312792897,26909
"7545","ENSMODG00000010213","3",194759477,194787100,27623
"7546","ENSMODG00000010216","1",577784778,577858003,73225
"7547","ENSMODG00000010217","1",26136649,26178453,41804
"7548","ENSMODG00000010218","Un",69081966,69084615,2649
"7549","ENSMODG00000010219","1",274175499,274353345,177846
"7550","ENSMODG00000010220","Un",69085168,69091012,5844
"7551","ENSMODG00000010221","X",28087752,28428270,340518
"7552","ENSMODG00000010224","1",26236020,26328779,92759
"7553","ENSMODG00000010225","1",577658851,577680567,21716
"7554","ENSMODG00000010226","Un",69091494,69093459,1965
"7555","ENSMODG00000010227","8",259722963,259941484,218521
"7556","ENSMODG00000010228","1",274371856,274448813,76957
"7557","ENSMODG00000010231","1",340177330,340241155,63825
"7558","ENSMODG00000010232","X",28218523,28237558,19035
"7559","ENSMODG00000010233","4",192514542,192603166,88624
"7560","ENSMODG00000010236","X",71954800,71959577,4777
"7561","ENSMODG00000010238","1",274571178,274584901,13723
"7562","ENSMODG00000010239","1",340160192,340173675,13483
"7563","ENSMODG00000010240","4",312800321,312822822,22501
"7564","ENSMODG00000010241","2",208998090,209157879,159789
"7565","ENSMODG00000010243","6",274762514,274810135,47621
"7566","ENSMODG00000010244","1",151313842,151364330,50488
"7567","ENSMODG00000010245","X",28245848,28248241,2393
"7568","ENSMODG00000010246","3",194787187,194843206,56019
"7569","ENSMODG00000010247","1",17152086,17167266,15180
"7570","ENSMODG00000010248","X",71950858,71952105,1247
"7571","ENSMODG00000010249","2",167318531,167319490,959
"7572","ENSMODG00000010250","1",339975826,340154117,178291
"7573","ENSMODG00000010252","3",332592389,332815361,222972
"7574","ENSMODG00000010254","4",312824186,312835582,11396
"7575","ENSMODG00000010255","1",26330330,26352588,22258
"7576","ENSMODG00000010256","1",339765814,339855839,90025
"7577","ENSMODG00000010257","2",208905141,208932130,26989
"7578","ENSMODG00000010259","X",71943395,71949995,6600
"7579","ENSMODG00000010260","2",167337237,167338184,947
"7580","ENSMODG00000010261","1",577617524,577653085,35561
"7581","ENSMODG00000010262","1",98834471,98900137,65666
"7582","ENSMODG00000010263","2",516866762,517247354,380592
"7583","ENSMODG00000010264","2",167396193,167397149,956
"7584","ENSMODG00000010265","1",274793244,274926958,133714
"7585","ENSMODG00000010269","2",167434367,167435308,941
"7586","ENSMODG00000010271","1",151235723,151304895,69172
"7587","ENSMODG00000010272","8",259887543,260000100,112557
"7588","ENSMODG00000010274","1",275020299,275038445,18146
"7589","ENSMODG00000010275","1",745147700,745176704,29004
"7590","ENSMODG00000010276","1",337155161,337492837,337676
"7591","ENSMODG00000010280","2",208845817,208846575,758
"7592","ENSMODG00000010281","1",98907556,99001000,93444
"7593","ENSMODG00000010282","1",745086891,745130363,43472
"7594","ENSMODG00000010283","X",28377305,28460603,83298
"7595","ENSMODG00000010285","1",151170491,151198716,28225
"7596","ENSMODG00000010286","3",509796328,509815917,19589
"7597","ENSMODG00000010287","1",336981387,336994181,12794
"7598","ENSMODG00000010289","1",99006031,99143486,137455
"7599","ENSMODG00000010290","8",260006264,260049170,42906
"7600","ENSMODG00000010292","X",71931350,71935172,3822
"7601","ENSMODG00000010294","X",28479631,28515359,35728
"7602","ENSMODG00000010295","1",336880946,336905187,24241
"7603","ENSMODG00000010296","1",151079047,151104142,25095
"7604","ENSMODG00000010299","3",332006578,332032896,26318
"7605","ENSMODG00000010300","1",275039657,275085840,46183
"7606","ENSMODG00000010301","4",194072339,194179694,107355
"7607","ENSMODG00000010303","X",71865445,71885657,20212
"7608","ENSMODG00000010304","3",509762840,509778704,15864
"7609","ENSMODG00000010305","8",260077775,260096942,19167
"7610","ENSMODG00000010306","3",509861454,509923624,62170
"7611","ENSMODG00000010307","4",313484011,313637183,153172
"7612","ENSMODG00000010309","3",331630980,331699523,68543
"7613","ENSMODG00000010311","X",28543649,28568098,24449
"7614","ENSMODG00000010312","3",509934909,509950129,15220
"7615","ENSMODG00000010314","1",336860842,336872100,11258
"7616","ENSMODG00000010315","2",516940083,516984892,44809
"7617","ENSMODG00000010317","X",71925218,71929751,4533
"7618","ENSMODG00000010319","1",335491855,335643775,151920
"7619","ENSMODG00000010320","1",16846704,16847612,908
"7620","ENSMODG00000010321","3",509952827,509960591,7764
"7621","ENSMODG00000010322","3",331504439,331602452,98013
"7622","ENSMODG00000010324","X",71886356,71889357,3001
"7623","ENSMODG00000010326","1",99142507,99185988,43481
"7624","ENSMODG00000010327","2",516989314,517011002,21688
"7625","ENSMODG00000010328","1",577381057,577528138,147081
"7626","ENSMODG00000010329","1",100670848,100672164,1316
"7627","ENSMODG00000010331","2",167510480,167634364,123884
"7628","ENSMODG00000010333","1",577498542,577500945,2403
"7629","ENSMODG00000010334","3",509986148,510012615,26467
"7630","ENSMODG00000010335","1",17089516,17091241,1725
"7631","ENSMODG00000010338","8",260114278,260372830,258552
"7632","ENSMODG00000010339","3",331445404,331461270,15866
"7633","ENSMODG00000010342","4",314767393,314878239,110846
"7634","ENSMODG00000010343","1",744960746,745054974,94228
"7635","ENSMODG00000010344","3",510080265,510177301,97036
"7636","ENSMODG00000010345","X",28613339,28742614,129275
"7637","ENSMODG00000010347","4",314934023,314951960,17937
"7638","ENSMODG00000010348","1",150999937,151045237,45300
"7639","ENSMODG00000010350","1",744497886,744498851,965
"7640","ENSMODG00000010352","2",167638666,167640028,1362
"7641","ENSMODG00000010353","2",517098203,517389947,291744
"7642","ENSMODG00000010354","X",28716182,28726695,10513
"7643","ENSMODG00000010355","8",260381593,260401480,19887
"7644","ENSMODG00000010356","1",100707072,100811272,104200
"7645","ENSMODG00000010358","1",150988366,150999726,11360
"7646","ENSMODG00000010362","1",334850984,335424138,573154
"7647","ENSMODG00000010363","3",331358684,331420440,61756
"7648","ENSMODG00000010365","3",520885303,520888232,2929
"7649","ENSMODG00000010369","4",194907656,195001602,93946
"7650","ENSMODG00000010370","3",434633753,434813071,179318
"7651","ENSMODG00000010371","3",331294458,331304033,9575
"7652","ENSMODG00000010372","2",517132818,517146338,13520
"7653","ENSMODG00000010373","1",742340025,742371245,31220
"7654","ENSMODG00000010375","2",167707310,167715829,8519
"7655","ENSMODG00000010376","1",334222095,334266565,44470
"7656","ENSMODG00000010377","3",497575639,497740118,164479
"7657","ENSMODG00000010381","8",260444612,260451670,7058
"7658","ENSMODG00000010382","2",517149439,517151012,1573
"7659","ENSMODG00000010383","1",333994322,334048157,53835
"7660","ENSMODG00000010384","4",194999923,195177195,177272
"7661","ENSMODG00000010385","8",261073011,261073718,707
"7662","ENSMODG00000010387","1",16569591,16572456,2865
"7663","ENSMODG00000010388","3",497759765,497765410,5645
"7664","ENSMODG00000010389","8",261617440,261623725,6285
"7665","ENSMODG00000010390","1",100920682,100947635,26953
"7666","ENSMODG00000010391","4",315033034,315162133,129099
"7667","ENSMODG00000010392","4",195196218,195197288,1070
"7668","ENSMODG00000010393","3",434941968,434954469,12501
"7669","ENSMODG00000010398","1",333841801,333853020,11219
"7670","ENSMODG00000010399","1",100989636,101232215,242579
"7671","ENSMODG00000010404","1",150863794,150893100,29306
"7672","ENSMODG00000010405","4",315227766,315248323,20557
"7673","ENSMODG00000010406","8",262500029,262522727,22698
"7674","ENSMODG00000010407","3",434974593,434976866,2273
"7675","ENSMODG00000010408","6",51755911,51756998,1087
"7676","ENSMODG00000010410","1",150859204,150864000,4796
"7677","ENSMODG00000010411","3",435039137,435149289,110152
"7678","ENSMODG00000010414","1",26864082,26901483,37401
"7679","ENSMODG00000010415","1",741558291,741595615,37324
"7680","ENSMODG00000010417","8",262610748,262628597,17849
"7681","ENSMODG00000010418","1",150793273,150822543,29270
"7682","ENSMODG00000010419","1",26903324,26914058,10734
"7683","ENSMODG00000010420","4",315260484,315302457,41973
"7684","ENSMODG00000010421","4",195462710,195517180,54470
"7685","ENSMODG00000010422","X",71853665,71859936,6271
"7686","ENSMODG00000010423","2",520366985,520401264,34279
"7687","ENSMODG00000010425","4",195566476,195796013,229537
"7688","ENSMODG00000010428","1",16487669,16489363,1694
"7689","ENSMODG00000010429","X",71851287,71852212,925
"7690","ENSMODG00000010431","3",435156838,435205868,49030
"7691","ENSMODG00000010432","1",576983928,577072294,88366
"7692","ENSMODG00000010433","1",333814826,333879179,64353
"7693","ENSMODG00000010434","1",26916195,26944933,28738
"7694","ENSMODG00000010435","3",435208867,435218997,10130
"7695","ENSMODG00000010436","4",315316466,315338729,22263
"7696","ENSMODG00000010438","1",150752589,150775001,22412
"7697","ENSMODG00000010439","1",576960673,576965989,5316
"7698","ENSMODG00000010440","8",262639765,262721578,81813
"7699","ENSMODG00000010441","1",333791241,333808820,17579
"7700","ENSMODG00000010442","3",331068754,331207928,139174
"7701","ENSMODG00000010443","4",195820527,196157582,337055
"7702","ENSMODG00000010444","3",435221236,435230648,9412
"7703","ENSMODG00000010447","8",262761302,262763059,1757
"7704","ENSMODG00000010448","2",520461740,520587711,125971
"7705","ENSMODG00000010449","1",26946210,26953741,7531
"7706","ENSMODG00000010450","1",16418917,16439357,20440
"7707","ENSMODG00000010451","4",195865639,195866598,959
"7708","ENSMODG00000010452","1",150705455,150752813,47358
"7709","ENSMODG00000010453","8",262768955,262808628,39673
"7710","ENSMODG00000010454","8",262829955,262830689,734
"7711","ENSMODG00000010455","1",150662501,150664133,1632
"7712","ENSMODG00000010456","1",333774065,333786111,12046
"7713","ENSMODG00000010457","1",576910750,576929530,18780
"7714","ENSMODG00000010459","1",741347525,741394569,47044
"7715","ENSMODG00000010460","2",520608450,520613382,4932
"7716","ENSMODG00000010461","3",435241727,435390232,148505
"7717","ENSMODG00000010462","3",497779758,497789247,9489
"7718","ENSMODG00000010463","1",101321524,101365354,43830
"7719","ENSMODG00000010464","1",16399429,16410042,10613
"7720","ENSMODG00000010466","1",150621849,150622940,1091
"7721","ENSMODG00000010468","1",741336843,741341395,4552
"7722","ENSMODG00000010469","1",576850127,576865503,15376
"7723","ENSMODG00000010470","2",168166800,168185371,18571
"7724","ENSMODG00000010471","1",333698839,333713043,14204
"7725","ENSMODG00000010473","1",741286526,741300893,14367
"7726","ENSMODG00000010474","1",576789403,576807745,18342
"7727","ENSMODG00000010475","2",520678914,520731373,52459
"7728","ENSMODG00000010476","1",150545614,150563673,18059
"7729","ENSMODG00000010478","1",26954310,26982233,27923
"7730","ENSMODG00000010479","4",315524648,315539142,14494
"7731","ENSMODG00000010480","2",517151430,517169860,18430
"7732","ENSMODG00000010481","1",16372528,16395040,22512
"7733","ENSMODG00000010482","1",741276226,741277573,1347
"7734","ENSMODG00000010484","1",576476339,576554903,78564
"7735","ENSMODG00000010485","1",16315074,16358643,43569
"7736","ENSMODG00000010487","1",150427755,150487915,60160
"7737","ENSMODG00000010488","2",517199126,517201853,2727
"7738","ENSMODG00000010489","3",330998582,330999016,434
"7739","ENSMODG00000010490","2",168202367,168216187,13820
"7740","ENSMODG00000010491","3",435249981,435253116,3135
"7741","ENSMODG00000010492","1",576318900,576320768,1868
"7742","ENSMODG00000010493","1",16130282,16158936,28654
"7743","ENSMODG00000010496","1",150364695,150378025,13330
"7744","ENSMODG00000010497","8",262956185,263608963,652778
"7745","ENSMODG00000010498","1",741225659,741242851,17192
"7746","ENSMODG00000010499","1",575616996,575864324,247328
"7747","ENSMODG00000010500","4",315540386,315674748,134362
"7748","ENSMODG00000010501","2",517210896,517224160,13264
"7749","ENSMODG00000010502","3",435301499,435310667,9168
"7750","ENSMODG00000010504","1",15613732,15617137,3405
"7751","ENSMODG00000010505","8",263660064,263661758,1694
"7752","ENSMODG00000010506","1",574820328,574878074,57746
"7753","ENSMODG00000010507","4",196584855,196624845,39990
"7754","ENSMODG00000010510","1",150144175,150358267,214092
"7755","ENSMODG00000010511","1",741078717,741117042,38325
"7756","ENSMODG00000010513","3",194919321,194954658,35337
"7757","ENSMODG00000010514","3",435359628,435378588,18960
"7758","ENSMODG00000010515","2",517263387,517301399,38012
"7759","ENSMODG00000010516","3",497900266,498077232,176966
"7760","ENSMODG00000010517","1",574712956,574728012,15056
"7761","ENSMODG00000010518","1",27005724,27081563,75839
"7762","ENSMODG00000010519","4",196768993,196830999,62006
"7763","ENSMODG00000010521","1",741047425,741066661,19236
"7764","ENSMODG00000010522","3",435420953,435427434,6481
"7765","ENSMODG00000010523","1",101427964,101449197,21233
"7766","ENSMODG00000010524","7",64715291,64750886,35595
"7767","ENSMODG00000010525","3",194974200,194975267,1067
"7768","ENSMODG00000010526","3",330879664,330939875,60211
"7769","ENSMODG00000010527","3",498109552,498464846,355294
"7770","ENSMODG00000010528","4",315954192,316142428,188236
"7771","ENSMODG00000010529","1",574352863,574494433,141570
"7772","ENSMODG00000010531","3",435431404,435437475,6071
"7773","ENSMODG00000010532","6",274904415,274977903,73488
"7774","ENSMODG00000010533","1",333467295,333483545,16250
"7775","ENSMODG00000010534","X",71843964,71845573,1609
"7776","ENSMODG00000010535","1",574554402,574556185,1783
"7777","ENSMODG00000010536","3",194977502,195571020,593518
"7778","ENSMODG00000010537","2",517304895,517336022,31127
"7779","ENSMODG00000010538","1",27079623,27353000,273377
"7780","ENSMODG00000010540","6",275069662,275072800,3138
"7781","ENSMODG00000010542","1",101739669,101752981,13312
"7782","ENSMODG00000010543","1",15540063,15585935,45872
"7783","ENSMODG00000010545","1",574040213,574137611,97398
"7784","ENSMODG00000010546","1",101768601,101878453,109852
"7785","ENSMODG00000010547","3",329627428,329804908,177480
"7786","ENSMODG00000010549","2",517336086,517409927,73841
"7787","ENSMODG00000010552","2",520732283,520859603,127320
"7788","ENSMODG00000010553","2",517449760,517568063,118303
"7789","ENSMODG00000010554","1",574014812,574025431,10619
"7790","ENSMODG00000010555","X",71838634,71842937,4303
"7791","ENSMODG00000010556","4",196932601,197072056,139455
"7792","ENSMODG00000010557","1",27485655,27609722,124067
"7793","ENSMODG00000010558","X",71631453,71822707,191254
"7794","ENSMODG00000010559","1",741016894,741021747,4853
"7795","ENSMODG00000010560","2",270069791,270073953,4162
"7796","ENSMODG00000010561","2",520804202,520815150,10948
"7797","ENSMODG00000010562","1",28034181,28049342,15161
"7798","ENSMODG00000010565","3",435460017,435655384,195367
"7799","ENSMODG00000010566","4",197110420,197140818,30398
"7800","ENSMODG00000010567","3",329464464,329472630,8166
"7801","ENSMODG00000010568","6",275131884,275145264,13380
"7802","ENSMODG00000010571","3",498688002,498945236,257234
"7803","ENSMODG00000010572","1",15492955,15532190,39235
"7804","ENSMODG00000010573","2",520917711,520963099,45388
"7805","ENSMODG00000010574","2",515437312,515438904,1592
"7806","ENSMODG00000010575","2",517571516,517580358,8842
"7807","ENSMODG00000010576","2",521045982,521046932,950
"7808","ENSMODG00000010577","X",71808693,71810237,1544
"7809","ENSMODG00000010578","4",197158675,197210285,51610
"7810","ENSMODG00000010579","1",740993288,741003415,10127
"7811","ENSMODG00000010580","3",328142469,328602649,460180
"7812","ENSMODG00000010581","1",573991569,574011932,20363
"7813","ENSMODG00000010582","2",517580500,517581482,982
"7814","ENSMODG00000010583","2",521054561,521055493,932
"7815","ENSMODG00000010584","1",747623447,747795682,172235
"7816","ENSMODG00000010585","1",333457771,333465825,8054
"7817","ENSMODG00000010586","3",195852941,195961508,108567
"7818","ENSMODG00000010587","8",264332586,264520602,188016
"7819","ENSMODG00000010588","X",71806899,71808267,1368
"7820","ENSMODG00000010589","3",435649516,435718496,68980
"7821","ENSMODG00000010591","6",275150796,275167251,16455
"7822","ENSMODG00000010593","1",573952271,573982548,30277
"7823","ENSMODG00000010595","1",740968924,740974458,5534
"7824","ENSMODG00000010596","2",269726330,269728881,2551
"7825","ENSMODG00000010598","2",521114131,521115093,962
"7826","ENSMODG00000010599","2",269812699,269814665,1966
"7827","ENSMODG00000010602","4",199764828,199766552,1724
"7828","ENSMODG00000010603","1",333453700,333456757,3057
"7829","ENSMODG00000010604","2",168270912,168292467,21555
"7830","ENSMODG00000010605","4",200191163,200192599,1436
"7831","ENSMODG00000010607","6",275176629,275207902,31273
"7832","ENSMODG00000010608","2",270236005,270338190,102185
"7833","ENSMODG00000010610","8",264522198,264535698,13500
"7834","ENSMODG00000010611","2",521158330,521183206,24876
"7835","ENSMODG00000010614","1",15447975,15470790,22815
"7836","ENSMODG00000010616","3",429144262,429145317,1055
"7837","ENSMODG00000010617","3",328093915,328119150,25235
"7838","ENSMODG00000010620","1",573702312,573777826,75514
"7839","ENSMODG00000010621","8",264540928,264563472,22544
"7840","ENSMODG00000010622","2",517594275,517780649,186374
"7841","ENSMODG00000010623","1",101990468,102098754,108286
"7842","ENSMODG00000010624","2",168329695,168330642,947
"7843","ENSMODG00000010625","3",327869701,328012646,142945
"7844","ENSMODG00000010626","4",265648691,265650115,1424
"7845","ENSMODG00000010628","4",409004993,409026622,21629
"7846","ENSMODG00000010630","3",509708455,509711280,2825
"7847","ENSMODG00000010631","2",168478824,168492152,13328
"7848","ENSMODG00000010632","1",15381794,15396847,15053
"7849","ENSMODG00000010633","2",168701678,168713960,12282
"7850","ENSMODG00000010634","1",333445258,333452263,7005
"7851","ENSMODG00000010636","3",327732327,327769976,37649
"7852","ENSMODG00000010637","2",521229010,521298565,69555
"7853","ENSMODG00000010639","2",517780515,517790234,9719
"7854","ENSMODG00000010640","X",71778916,71793990,15074
"7855","ENSMODG00000010641","3",327722962,327729800,6838
"7856","ENSMODG00000010642","2",521379812,521384017,4205
"7857","ENSMODG00000010644","1",15252385,15286877,34492
"7858","ENSMODG00000010645","Un",17540639,17672074,131435
"7859","ENSMODG00000010646","4",409204786,409267639,62853
"7860","ENSMODG00000010647","1",573129785,573143827,14042
"7861","ENSMODG00000010648","4",316344444,316436836,92392
"7862","ENSMODG00000010650","6",275379104,275436774,57670
"7863","ENSMODG00000010653","4",202473484,202601025,127541
"7864","ENSMODG00000010654","1",573087476,573099291,11815
"7865","ENSMODG00000010655","4",366605079,366610936,5857
"7866","ENSMODG00000010656","3",327634776,327720211,85435
"7867","ENSMODG00000010658","2",517790007,517801975,11968
"7868","ENSMODG00000010659","6",275529649,275583039,53390
"7869","ENSMODG00000010660","4",366749969,366759809,9840
"7870","ENSMODG00000010661","Un",17793299,17820836,27537
"7871","ENSMODG00000010662","3",499026437,499046683,20246
"7872","ENSMODG00000010663","3",435718903,435773553,54650
"7873","ENSMODG00000010664","2",521400460,521424379,23919
"7874","ENSMODG00000010665","4",202636931,202725889,88958
"7875","ENSMODG00000010666","3",327526918,327549941,23023
"7876","ENSMODG00000010667","3",196244846,196601505,356659
"7877","ENSMODG00000010668","1",15118861,15186946,68085
"7878","ENSMODG00000010670","8",264578898,264614257,35359
"7879","ENSMODG00000010672","1",15087173,15099965,12792
"7880","ENSMODG00000010673","3",499226578,499243767,17189
"7881","ENSMODG00000010674","4",202765374,202799415,34041
"7882","ENSMODG00000010675","3",327379969,327382709,2740
"7883","ENSMODG00000010676","1",102280622,102353778,73156
"7884","ENSMODG00000010677","X",71765973,71772564,6591
"7885","ENSMODG00000010678","2",168804923,168822474,17551
"7886","ENSMODG00000010679","4",366772549,366792258,19709
"7887","ENSMODG00000010681","Un",17701530,17732336,30806
"7888","ENSMODG00000010682","3",435794340,435808455,14115
"7889","ENSMODG00000010683","3",326812361,326840614,28253
"7890","ENSMODG00000010684","1",333349203,333444575,95372
"7891","ENSMODG00000010685","3",521070510,521091046,20536
"7892","ENSMODG00000010686","8",264660318,264823884,163566
"7893","ENSMODG00000010687","4",203399947,203453632,53685
"7894","ENSMODG00000010688","3",499049848,499088386,38538
"7895","ENSMODG00000010689","3",435825522,435866018,40496
"7896","ENSMODG00000010690","4",288730848,288751792,20944
"7897","ENSMODG00000010691","1",572909811,573020870,111059
"7898","ENSMODG00000010692","4",203545658,203625850,80192
"7899","ENSMODG00000010694","4",409272089,409296635,24546
"7900","ENSMODG00000010695","4",366796924,366829435,32511
"7901","ENSMODG00000010697","3",499090429,499100564,10135
"7902","ENSMODG00000010698","3",435942135,435954358,12223
"7903","ENSMODG00000010700","Un",17750395,17779868,29473
"7904","ENSMODG00000010701","8",264835607,264840205,4598
"7905","ENSMODG00000010703","2",521583965,521680010,96045
"7906","ENSMODG00000010704","2",517803176,517878977,75801
"7907","ENSMODG00000010705","1",572899311,572903454,4143
"7908","ENSMODG00000010706","3",520861694,521003744,142050
"7909","ENSMODG00000010707","3",435964189,435968025,3836
"7910","ENSMODG00000010710","3",499099491,499120806,21315
"7911","ENSMODG00000010711","Un",17905468,17929777,24309
"7912","ENSMODG00000010712","4",205010665,205093752,83087
"7913","ENSMODG00000010713","2",517883230,517902837,19607
"7914","ENSMODG00000010714","1",572865919,572886353,20434
"7915","ENSMODG00000010715","8",264862372,264923472,61100
"7916","ENSMODG00000010716","3",499132043,499193743,61700
"7917","ENSMODG00000010717","1",333307283,333339521,32238
"7918","ENSMODG00000010718","4",366835513,366852870,17357
"7919","ENSMODG00000010719","3",436000499,436046644,46145
"7920","ENSMODG00000010720","2",521625299,521637848,12549
"7921","ENSMODG00000010723","1",572819989,572847937,27948
"7922","ENSMODG00000010724","1",333220918,333227863,6945
"7923","ENSMODG00000010726","X",71753763,71763904,10141
"7924","ENSMODG00000010727","Un",17933807,17953430,19623
"7925","ENSMODG00000010729","1",333151923,333154370,2447
"7926","ENSMODG00000010730","8",264923749,264940024,16275
"7927","ENSMODG00000010731","1",714787404,714872547,85143
"7928","ENSMODG00000010732","1",572803768,572819435,15667
"7929","ENSMODG00000010733","2",521711647,521741223,29576
"7930","ENSMODG00000010734","4",316586376,316690825,104449
"7931","ENSMODG00000010735","3",499215207,499229368,14161
"7932","ENSMODG00000010736","4",366942174,366955421,13247
"7933","ENSMODG00000010737","1",103867885,104200251,332366
"7934","ENSMODG00000010739","1",14930917,15042863,111946
"7935","ENSMODG00000010740","4",366970151,367130504,160353
"7936","ENSMODG00000010741","Un",17956125,17982549,26424
"7937","ENSMODG00000010742","4",409323511,409337608,14097
"7938","ENSMODG00000010743","1",150082305,150138535,56230
"7939","ENSMODG00000010745","4",365251642,365257378,5736
"7940","ENSMODG00000010746","3",325116486,325421575,305089
"7941","ENSMODG00000010747","Un",17995038,18006804,11766
"7942","ENSMODG00000010748","1",572759231,572768761,9530
"7943","ENSMODG00000010750","8",264932512,264950131,17619
"7944","ENSMODG00000010751","1",14841219,14929202,87983
"7945","ENSMODG00000010753","4",367036877,367051537,14660
"7946","ENSMODG00000010754","1",14587761,14737931,150170
"7947","ENSMODG00000010755","3",436043277,436065788,22511
"7948","ENSMODG00000010757","4",367132273,367140070,7797
"7949","ENSMODG00000010759","8",264952735,264980023,27288
"7950","ENSMODG00000010760","4",316846288,316933082,86794
"7951","ENSMODG00000010761","1",572733753,572754658,20905
"7952","ENSMODG00000010762","3",324906475,325115581,209106
"7953","ENSMODG00000010764","3",197053724,197489888,436164
"7954","ENSMODG00000010765","2",517915562,517970109,54547
"7955","ENSMODG00000010766","Un",21769583,21787111,17528
"7956","ENSMODG00000010767","X",71746874,71751350,4476
"7957","ENSMODG00000010768","1",572699165,572722049,22884
"7958","ENSMODG00000010769","3",436078629,436089529,10900
"7959","ENSMODG00000010770","1",14752968,14823585,70617
"7960","ENSMODG00000010771","3",436099576,436109046,9470
"7961","ENSMODG00000010772","8",264999907,265269381,269474
"7962","ENSMODG00000010773","1",572665473,572665962,489
"7963","ENSMODG00000010775","4",316979350,317060172,80822
"7964","ENSMODG00000010776","2",518133085,518168510,35425
"7965","ENSMODG00000010777","X",71724982,71727524,2542
"7966","ENSMODG00000010778","1",572625122,572626345,1223
"7967","ENSMODG00000010779","6",275686186,275873617,187431
"7968","ENSMODG00000010782","4",367144984,367256571,111587
"7969","ENSMODG00000010784","4",317150538,317183919,33381
"7970","ENSMODG00000010786","3",436144514,436156755,12241
"7971","ENSMODG00000010787","4",318235708,318240813,5105
"7972","ENSMODG00000010789","X",71717402,71720014,2612
"7973","ENSMODG00000010790","6",275885800,275973240,87440
"7974","ENSMODG00000010792","8",265797578,265883479,85901
"7975","ENSMODG00000010793","1",714607449,714682593,75144
"7976","ENSMODG00000010794","4",409450150,409472091,21941
"7977","ENSMODG00000010795","3",197642374,197878003,235629
"7978","ENSMODG00000010797","8",266086106,266087167,1061
"7979","ENSMODG00000010798","1",106079351,106803906,724555
"7980","ENSMODG00000010799","4",318311379,318341643,30264
"7981","ENSMODG00000010800","1",572593545,572601473,7928
"7982","ENSMODG00000010801","4",365268488,365293787,25299
"7983","ENSMODG00000010802","1",149794924,149926853,131929
"7984","ENSMODG00000010804","4",318321571,318322010,439
"7985","ENSMODG00000010806","3",324263009,324285776,22767
"7986","ENSMODG00000010807","2",518171732,518196178,24446
"7987","ENSMODG00000010808","3",199004715,199138461,133746
"7988","ENSMODG00000010809","Un",43736439,43754533,18094
"7989","ENSMODG00000010810","Un",49657667,49709875,52208
"7990","ENSMODG00000010811","4",205641166,205683455,42289
"7991","ENSMODG00000010812","8",265908309,265989123,80814
"7992","ENSMODG00000010813","1",572478216,572516341,38125
"7993","ENSMODG00000010814","Un",21807513,21886128,78615
"7994","ENSMODG00000010816","4",367383872,367414648,30776
"7995","ENSMODG00000010819","1",149778078,149786181,8103
"7996","ENSMODG00000010820","3",323992826,324074974,82148
"7997","ENSMODG00000010821","3",199527877,199672787,144910
"7998","ENSMODG00000010822","1",572460421,572463245,2824
"7999","ENSMODG00000010823","Un",67201832,67203655,1823
"8000","ENSMODG00000010824","Un",21931753,21940767,9014
"8001","ENSMODG00000010825","X",71350478,71709682,359204
"8002","ENSMODG00000010826","4",367419631,367423478,3847
"8003","ENSMODG00000010827","3",323965791,323984560,18769
"8004","ENSMODG00000010828","1",107005749,107125224,119475
"8005","ENSMODG00000010829","4",318546950,318645375,98425
"8006","ENSMODG00000010830","8",266020785,266021852,1067
"8007","ENSMODG00000010831","1",149773615,149777583,3968
"8008","ENSMODG00000010833","4",318660369,318704123,43754
"8009","ENSMODG00000010835","3",199879544,199915681,36137
"8010","ENSMODG00000010837","6",275998784,276072838,74054
"8011","ENSMODG00000010838","Un",21945318,21951973,6655
"8012","ENSMODG00000010839","1",107215386,107235241,19855
"8013","ENSMODG00000010841","Un",75980645,75980936,291
"8014","ENSMODG00000010843","2",518336774,518562143,225369
"8015","ENSMODG00000010844","Un",21952455,21954302,1847
"8016","ENSMODG00000010846","4",367435788,367462894,27106
"8017","ENSMODG00000010847","8",266224475,266227558,3083
"8018","ENSMODG00000010848","1",572396449,572457410,60961
"8019","ENSMODG00000010849","X",71705595,71707629,2034
"8020","ENSMODG00000010850","3",199990816,200035811,44995
"8021","ENSMODG00000010851","2",518549622,518611076,61454
"8022","ENSMODG00000010852","4",409538754,409564164,25410
"8023","ENSMODG00000010853","4",367515792,367520125,4333
"8024","ENSMODG00000010855","X",71694838,71697606,2768
"8025","ENSMODG00000010861","4",318796696,318842753,46057
"8026","ENSMODG00000010862","1",14505669,14558050,52381
"8027","ENSMODG00000010863","1",572336881,572349184,12303
"8028","ENSMODG00000010864","3",200081870,200114529,32659
"8029","ENSMODG00000010865","8",266275570,266294826,19256
"8030","ENSMODG00000010867","Un",28761821,28766834,5013
"8031","ENSMODG00000010868","1",704493957,704622677,128720
"8032","ENSMODG00000010869","X",71639844,71640856,1012
"8033","ENSMODG00000010870","2",518622788,518680164,57376
"8034","ENSMODG00000010871","3",436167384,436176443,9059
"8035","ENSMODG00000010872","2",208074573,208158700,84127
"8036","ENSMODG00000010874","3",200263559,200418232,154673
"8037","ENSMODG00000010875","8",266310869,266333590,22721
"8038","ENSMODG00000010877","X",71622088,71625371,3283
"8039","ENSMODG00000010878","4",409628959,409637889,8930
"8040","ENSMODG00000010880","4",365300076,365355112,55036
"8041","ENSMODG00000010881","1",107566946,107745054,178108
"8042","ENSMODG00000010882","8",266334885,266349142,14257
"8043","ENSMODG00000010883","X",71570697,71580736,10039
"8044","ENSMODG00000010884","4",367654533,367682690,28157
"8045","ENSMODG00000010885","3",525504130,525505389,1259
"8046","ENSMODG00000010886","3",322948879,322981685,32806
"8047","ENSMODG00000010887","2",207973595,208049928,76333
"8048","ENSMODG00000010888","X",71527369,71541853,14484
"8049","ENSMODG00000010889","1",572292053,572314872,22819
"8050","ENSMODG00000010893","3",436111182,436213858,102676
"8051","ENSMODG00000010894","1",572223735,572226777,3042
"8052","ENSMODG00000010895","X",70956056,71082714,126658
"8053","ENSMODG00000010896","1",107484259,107553868,69609
"8054","ENSMODG00000010897","4",365363534,365370278,6744
"8055","ENSMODG00000010898","1",149698256,149747540,49284
"8056","ENSMODG00000010899","3",322763792,322783380,19588
"8057","ENSMODG00000010901","4",367699573,367720522,20949
"8058","ENSMODG00000010902","1",107556066,107565708,9642
"8059","ENSMODG00000010906","4",365385101,365398007,12906
"8060","ENSMODG00000010908","2",207837062,207939594,102532
"8061","ENSMODG00000010909","1",149675479,149696377,20898
"8062","ENSMODG00000010910","1",14434463,14489543,55080
"8063","ENSMODG00000010911","Un",45170462,45383182,212720
"8064","ENSMODG00000010913","X",72453212,72456541,3329
"8065","ENSMODG00000010914","4",365451512,365453233,1721
"8066","ENSMODG00000010916","X",72443083,72446646,3563
"8067","ENSMODG00000010919","3",200532653,200633178,100525
"8068","ENSMODG00000010920","3",322515816,322678552,162736
"8069","ENSMODG00000010922","3",436228095,436235396,7301
"8070","ENSMODG00000010925","1",107566946,107709417,142471
"8071","ENSMODG00000010926","1",149462432,149636282,173850
"8072","ENSMODG00000010927","4",367734633,367750466,15833
"8073","ENSMODG00000010929","4",318900081,318953452,53371
"8074","ENSMODG00000010931","3",436278409,436280474,2065
"8075","ENSMODG00000010932","3",200672559,200679701,7142
"8076","ENSMODG00000010934","2",518736010,518828424,92414
"8077","ENSMODG00000010935","2",207580426,207718423,137997
"8078","ENSMODG00000010936","Un",45220004,45249735,29731
"8079","ENSMODG00000010938","4",367776032,367779811,3779
"8080","ENSMODG00000010941","3",436308278,436321460,13182
"8081","ENSMODG00000010942","Un",46236096,46247110,11014
"8082","ENSMODG00000010943","4",367780427,367799470,19043
"8083","ENSMODG00000010945","3",200748948,200783818,34870
"8084","ENSMODG00000010946","2",518892146,518909703,17557
"8085","ENSMODG00000010947","4",367833203,367872807,39604
"8086","ENSMODG00000010950","4",319028887,319122575,93688
"8087","ENSMODG00000010951","3",322353609,322404927,51318
"8088","ENSMODG00000010952","1",13561619,13667250,105631
"8089","ENSMODG00000010954","1",13438905,13439846,941
"8090","ENSMODG00000010956","2",518940206,518971914,31708
"8091","ENSMODG00000010958","2",207511438,207572620,61182
"8092","ENSMODG00000010960","3",436430530,436477290,46760
"8093","ENSMODG00000010961","1",107836365,107863537,27172
"8094","ENSMODG00000010962","4",365455381,365489722,34341
"8095","ENSMODG00000010963","2",207312366,207313955,1589
"8096","ENSMODG00000010964","1",704740792,704819365,78573
"8097","ENSMODG00000010967","8",266354976,266361082,6106
"8098","ENSMODG00000010968","3",75906748,75966692,59944
"8099","ENSMODG00000010970","1",333167038,333174164,7126
"8100","ENSMODG00000010971","1",149128452,149348780,220328
"8101","ENSMODG00000010972","3",75839532,75866771,27239
"8102","ENSMODG00000010973","4",367906172,367952471,46299
"8103","ENSMODG00000010974","3",436482849,436488096,5247
"8104","ENSMODG00000010976","4",365489576,365507703,18127
"8105","ENSMODG00000010978","2",519063345,519097661,34316
"8106","ENSMODG00000010979","1",149103373,149110421,7048
"8107","ENSMODG00000010980","1",569120016,569524548,404532
"8108","ENSMODG00000010982","2",207135004,207255378,120374
"8109","ENSMODG00000010983","3",436545693,436549767,4074
"8110","ENSMODG00000010985","1",107893612,107964921,71309
"8111","ENSMODG00000010987","8",266402860,266458882,56022
"8112","ENSMODG00000010988","Un",65119892,65122285,2393
"8113","ENSMODG00000010990","4",365561248,365569181,7933
"8114","ENSMODG00000010993","8",266605905,266606922,1017
"8115","ENSMODG00000010995","3",75747091,75804889,57798
"8116","ENSMODG00000010996","4",365597329,365636645,39316
"8117","ENSMODG00000010997","4",319137778,319199802,62024
"8118","ENSMODG00000011001","3",75604224,75627365,23141
"8119","ENSMODG00000011003","1",108008658,108069564,60906
"8120","ENSMODG00000011006","4",365635883,365666396,30513
"8121","ENSMODG00000011007","4",319227969,319231125,3156
"8122","ENSMODG00000011011","1",149040343,149102945,62602
"8123","ENSMODG00000011013","1",714539150,714578652,39502
"8124","ENSMODG00000011014","3",436548509,436591918,43409
"8125","ENSMODG00000011015","Un",46254529,46255689,1160
"8126","ENSMODG00000011016","1",108093886,108422565,328679
"8127","ENSMODG00000011019","4",367991633,368087924,96291
"8128","ENSMODG00000011020","1",108437631,108488179,50548
"8129","ENSMODG00000011021","8",266714078,266756693,42615
"8130","ENSMODG00000011022","3",436592067,436618094,26027
"8131","ENSMODG00000011023","4",365688946,365701804,12858
"8132","ENSMODG00000011024","Un",46263362,46281756,18394
"8133","ENSMODG00000011026","2",519028860,519137649,108789
"8134","ENSMODG00000011028","3",72664835,73634797,969962
"8135","ENSMODG00000011030","1",11612677,12191162,578485
"8136","ENSMODG00000011031","2",206535668,206751485,215817
"8137","ENSMODG00000011032","1",148702991,148787732,84741
"8138","ENSMODG00000011033","1",108591215,108594329,3114
"8139","ENSMODG00000011035","Un",46282465,46317392,34927
"8140","ENSMODG00000011038","4",368167834,368367964,200130
"8141","ENSMODG00000011039","2",519145211,519196743,51532
"8142","ENSMODG00000011040","1",108605845,108613768,7923
"8143","ENSMODG00000011041","3",71716606,71796532,79926
"8144","ENSMODG00000011042","3",200981232,201053388,72156
"8145","ENSMODG00000011044","4",368375714,368376661,947
"8146","ENSMODG00000011045","2",206509203,206530410,21207
"8147","ENSMODG00000011046","3",71611591,71645984,34393
"8148","ENSMODG00000011047","8",266996195,267440095,443900
"8149","ENSMODG00000011048","1",148562921,148646069,83148
"8150","ENSMODG00000011049","4",365714613,365725649,11036
"8151","ENSMODG00000011051","1",566205352,566207948,2596
"8152","ENSMODG00000011052","4",368137112,368439135,302023
"8153","ENSMODG00000011053","4",365727270,365739736,12466
"8154","ENSMODG00000011054","2",519207022,519270090,63068
"8155","ENSMODG00000011055","3",71571321,71609777,38456
"8156","ENSMODG00000011056","8",267509309,267517335,8026
"8157","ENSMODG00000011057","1",333088602,333090992,2390
"8158","ENSMODG00000011058","4",351315935,351316973,1038
"8159","ENSMODG00000011059","1",566166624,566173531,6907
"8160","ENSMODG00000011060","Un",47781208,47826469,45261
"8161","ENSMODG00000011062","8",267873191,267886055,12864
"8162","ENSMODG00000011065","1",333078631,333081015,2384
"8163","ENSMODG00000011066","4",368456847,368500406,43559
"8164","ENSMODG00000011068","4",365848485,365893170,44685
"8165","ENSMODG00000011069","2",206290965,206336145,45180
"8166","ENSMODG00000011070","X",72644743,72647343,2600
"8167","ENSMODG00000011071","Un",47836798,47850917,14119
"8168","ENSMODG00000011073","1",566113090,566130088,16998
"8169","ENSMODG00000011076","4",368507977,368586730,78753
"8170","ENSMODG00000011077","1",108615030,108652481,37451
"8171","ENSMODG00000011078","1",148500481,148501659,1178
"8172","ENSMODG00000011079","4",319245014,319439595,194581
"8173","ENSMODG00000011080","4",366182635,366189521,6886
"8174","ENSMODG00000011081","2",519325169,519672577,347408
"8175","ENSMODG00000011082","3",201261378,201298219,36841
"8176","ENSMODG00000011084","3",436726991,436736304,9313
"8177","ENSMODG00000011087","1",148478151,148481888,3737
"8178","ENSMODG00000011089","2",206162232,206199044,36812
"8179","ENSMODG00000011090","3",71463601,71465448,1847
"8180","ENSMODG00000011092","X",72722724,72787462,64738
"8181","ENSMODG00000011093","2",519742126,519795059,52933
"8182","ENSMODG00000011094","3",436785594,436791849,6255
"8183","ENSMODG00000011095","1",108654866,108676339,21473
"8184","ENSMODG00000011096","1",566103047,566114456,11409
"8185","ENSMODG00000011098","1",148447713,148465642,17929
"8186","ENSMODG00000011099","Un",46803708,46825637,21929
"8187","ENSMODG00000011100","3",436795490,436800029,4539
"8188","ENSMODG00000011101","2",206047276,206060875,13599
"8189","ENSMODG00000011102","1",10856137,10943732,87595
"8190","ENSMODG00000011103","3",201344795,201392005,47210
"8191","ENSMODG00000011104","X",72815288,72819985,4697
"8192","ENSMODG00000011106","4",409817041,409821698,4657
"8193","ENSMODG00000011107","2",519814978,519824408,9430
"8194","ENSMODG00000011108","5",302069721,302104914,35193
"8195","ENSMODG00000011110","2",205975626,206046921,71295
"8196","ENSMODG00000011111","8",267911743,268057266,145523
"8197","ENSMODG00000011112","Un",46820622,46831065,10443
"8198","ENSMODG00000011114","1",10685449,10793522,108073
"8199","ENSMODG00000011116","X",72848605,72976552,127947
"8200","ENSMODG00000011117","6",276041499,276129228,87729
"8201","ENSMODG00000011119","3",436864371,437150895,286524
"8202","ENSMODG00000011120","1",108679188,108706869,27681
"8203","ENSMODG00000011124","3",201434694,201490659,55965
"8204","ENSMODG00000011125","1",108729142,108747035,17893
"8205","ENSMODG00000011127","2",205909073,205954180,45107
"8206","ENSMODG00000011128","1",566036208,566047920,11712
"8207","ENSMODG00000011129","Un",46873521,46888073,14552
"8208","ENSMODG00000011130","3",437379176,437408406,29230
"8209","ENSMODG00000011133","3",202350143,202350783,640
"8210","ENSMODG00000011134","8",268239134,268893707,654573
"8211","ENSMODG00000011135","1",148319122,148349511,30389
"8212","ENSMODG00000011138","4",366195950,366309003,113053
"8213","ENSMODG00000011140","4",320005175,320041226,36051
"8214","ENSMODG00000011141","1",423445557,423462435,16878
"8215","ENSMODG00000011144","X",73032122,73169964,137842
"8216","ENSMODG00000011145","6",276142469,276213137,70668
"8217","ENSMODG00000011146","1",10543474,10666034,122560
"8218","ENSMODG00000011147","2",205834575,205896620,62045
"8219","ENSMODG00000011148","4",366234481,366243233,8752
"8220","ENSMODG00000011150","3",437518411,437536313,17902
"8221","ENSMODG00000011151","2",168889674,168916985,27311
"8222","ENSMODG00000011153","1",108810307,108929905,119598
"8223","ENSMODG00000011158","1",10359366,10446282,86916
"8224","ENSMODG00000011161","2",205593533,205661795,68262
"8225","ENSMODG00000011162","8",268689161,268692686,3525
"8226","ENSMODG00000011163","1",10308615,10354393,45778
"8227","ENSMODG00000011165","1",108943700,109117214,173514
"8228","ENSMODG00000011168","4",320051560,320209429,157869
"8229","ENSMODG00000011170","2",168943531,168948182,4651
"8230","ENSMODG00000011175","2",169055005,169056097,1092
"8231","ENSMODG00000011178","3",437567077,437616126,49049
"8232","ENSMODG00000011179","4",320116715,320117755,1040
"8233","ENSMODG00000011181","2",205529973,205593507,63534
"8234","ENSMODG00000011183","1",109170122,109178146,8024
"8235","ENSMODG00000011184","3",437575518,437576073,555
"8236","ENSMODG00000011185","2",205479812,205480888,1076
"8237","ENSMODG00000011187","1",565758702,565906441,147739
"8238","ENSMODG00000011188","1",704979745,704990809,11064
"8239","ENSMODG00000011189","4",320261158,320300204,39046
"8240","ENSMODG00000011190","2",205460499,205472867,12368
"8241","ENSMODG00000011191","3",437658465,437697774,39309
"8242","ENSMODG00000011192","8",268898671,268942535,43864
"8243","ENSMODG00000011194","4",366318243,366358823,40580
"8244","ENSMODG00000011196","6",276237676,276388790,151114
"8245","ENSMODG00000011198","2",519829153,519972922,143769
"8246","ENSMODG00000011199","6",276281541,276284994,3453
"8247","ENSMODG00000011200","1",705000326,705014942,14616
"8248","ENSMODG00000011201","8",269744851,269784913,40062
"8249","ENSMODG00000011202","4",366360124,366368226,8102
"8250","ENSMODG00000011203","3",437729738,437739013,9275
"8251","ENSMODG00000011205","1",109199272,109208337,9065
"8252","ENSMODG00000011206","1",705036732,705109155,72423
"8253","ENSMODG00000011207","3",437678845,437759725,80880
"8254","ENSMODG00000011208","2",520009342,520173991,164649
"8255","ENSMODG00000011210","4",320441328,320494574,53246
"8256","ENSMODG00000011211","1",109219773,109293044,73271
"8257","ENSMODG00000011213","2",520192595,520203140,10545
"8258","ENSMODG00000011214","1",332964249,332966708,2459
"8259","ENSMODG00000011215","4",320473403,320475196,1793
"8260","ENSMODG00000011216","1",109296830,109302135,5305
"8261","ENSMODG00000011217","4",366381824,366421353,39529
"8262","ENSMODG00000011218","4",352115168,352116115,947
"8263","ENSMODG00000011220","3",322065422,322302422,237000
"8264","ENSMODG00000011221","6",276286171,276304193,18022
"8265","ENSMODG00000011222","2",205425407,205446330,20923
"8266","ENSMODG00000011223","1",333046171,333048543,2372
"8267","ENSMODG00000011224","1",109314841,109346541,31700
"8268","ENSMODG00000011225","3",437773172,437792910,19738
"8269","ENSMODG00000011226","1",333022532,333035690,13158
"8270","ENSMODG00000011227","3",321906580,321907791,1211
"8271","ENSMODG00000011228","8",269783971,269852847,68876
"8272","ENSMODG00000011229","1",333009001,333011367,2366
"8273","ENSMODG00000011232","1",109373719,109388810,15091
"8274","ENSMODG00000011233","4",366423322,366431292,7970
"8275","ENSMODG00000011236","4",320561139,320613055,51916
"8276","ENSMODG00000011237","1",332997071,332999461,2390
"8277","ENSMODG00000011238","2",205369942,205439043,69101
"8278","ENSMODG00000011239","2",520316228,520347856,31628
"8279","ENSMODG00000011241","X",77661190,77663157,1967
"8280","ENSMODG00000011242","1",109401318,109575092,173774
"8281","ENSMODG00000011243","1",705093990,705106584,12594
"8282","ENSMODG00000011244","3",437802333,437816979,14646
"8283","ENSMODG00000011245","2",205315839,205370172,54333
"8284","ENSMODG00000011246","X",73171053,73184472,13419
"8285","ENSMODG00000011247","2",205231255,205241996,10741
"8286","ENSMODG00000011248","8",269933535,270000074,66539
"8287","ENSMODG00000011251","1",705136575,705169512,32937
"8288","ENSMODG00000011252","1",10060250,10087263,27013
"8289","ENSMODG00000011254","1",332830277,332830588,311
"8290","ENSMODG00000011256","1",109578902,109594918,16016
"8291","ENSMODG00000011257","6",276302452,276319224,16772
"8292","ENSMODG00000011261","8",270000362,270043988,43626
"8293","ENSMODG00000011263","2",205140740,205164456,23716
"8294","ENSMODG00000011265","X",73222467,73230632,8165
"8295","ENSMODG00000011266","X",77834102,78017012,182910
"8296","ENSMODG00000011267","8",270067306,270076282,8976
"8297","ENSMODG00000011268","1",564986450,565170423,183973
"8298","ENSMODG00000011269","1",332333304,332341799,8495
"8299","ENSMODG00000011270","3",321812859,321860377,47518
"8300","ENSMODG00000011271","1",109592731,109608435,15704
"8301","ENSMODG00000011273","1",147739187,148002437,263250
"8302","ENSMODG00000011274","4",322100011,322172972,72961
"8303","ENSMODG00000011276","1",109640916,109646369,5453
"8304","ENSMODG00000011277","1",332342683,332348494,5811
"8305","ENSMODG00000011278","1",564862183,564863601,1418
"8306","ENSMODG00000011279","3",437838031,437851161,13130
"8307","ENSMODG00000011280","1",109647091,109649975,2884
"8308","ENSMODG00000011281","X",78122826,78207179,84353
"8309","ENSMODG00000011282","3",71199152,71206058,6906
"8310","ENSMODG00000011283","1",147212616,147213956,1340
"8311","ENSMODG00000011284","1",564842316,564845941,3625
"8312","ENSMODG00000011288","8",270105023,270179560,74537
"8313","ENSMODG00000011289","2",10829763,10878296,48533
"8314","ENSMODG00000011290","4",322230133,322273320,43187
"8315","ENSMODG00000011291","3",321771737,321807666,35929
"8316","ENSMODG00000011297","3",437856794,437896866,40072
"8317","ENSMODG00000011300","3",437915208,437916018,810
"8318","ENSMODG00000011301","2",205103191,205116842,13651
"8319","ENSMODG00000011302","1",275106641,275143049,36408
"8320","ENSMODG00000011303","X",73294802,73386606,91804
"8321","ENSMODG00000011304","3",321513110,321637624,124514
"8322","ENSMODG00000011306","4",352238024,352241284,3260
"8323","ENSMODG00000011307","3",319827253,319828503,1250
"8324","ENSMODG00000011308","2",205092039,205095299,3260
"8325","ENSMODG00000011309","1",332303157,332319924,16767
"8326","ENSMODG00000011310","2",10906020,10910421,4401
"8327","ENSMODG00000011311","8",270480861,270690047,209186
"8328","ENSMODG00000011313","1",109652354,109671656,19302
"8329","ENSMODG00000011317","8",270741445,270821706,80261
"8330","ENSMODG00000011318","6",276319722,276463750,144028
"8331","ENSMODG00000011322","3",319373567,319501709,128142
"8332","ENSMODG00000011323","4",410050732,410052286,1554
"8333","ENSMODG00000011324","2",10971809,10973156,1347
"8334","ENSMODG00000011325","4",352263728,352266543,2815
"8335","ENSMODG00000011326","1",146778300,146901404,123104
"8336","ENSMODG00000011328","1",564714905,564790794,75889
"8337","ENSMODG00000011331","3",319092399,319177277,84878
"8338","ENSMODG00000011333","1",564505711,564509493,3782
"8339","ENSMODG00000011334","7",18641265,18641555,290
"8340","ENSMODG00000011335","1",332292316,332302750,10434
"8341","ENSMODG00000011336","1",10091387,10139519,48132
"8342","ENSMODG00000011337","X",73438234,73493920,55686
"8343","ENSMODG00000011338","3",317880462,317881964,1502
"8344","ENSMODG00000011341","6",276479762,276503329,23567
"8345","ENSMODG00000011344","3",317534966,317536814,1848
"8346","ENSMODG00000011345","4",352434041,352434995,954
"8347","ENSMODG00000011347","2",205030757,205087470,56713
"8348","ENSMODG00000011348","4",322281241,322505494,224253
"8349","ENSMODG00000011349","1",275215021,275217135,2114
"8350","ENSMODG00000011350","3",317151828,317161675,9847
"8351","ENSMODG00000011352","8",270848480,270891988,43508
"8352","ENSMODG00000011354","1",275266800,275375398,108598
"8353","ENSMODG00000011355","4",352469505,352470433,928
"8354","ENSMODG00000011356","4",352484881,352485765,884
"8355","ENSMODG00000011358","4",322668519,322706197,37678
"8356","ENSMODG00000011359","4",205699553,205883275,183722
"8357","ENSMODG00000011360","2",204978136,204979326,1190
"8358","ENSMODG00000011361","7",258848698,258855850,7152
"8359","ENSMODG00000011362","1",275452521,275456281,3760
"8360","ENSMODG00000011367","1",275463747,275511110,47363
"8361","ENSMODG00000011369","8",270902670,270949347,46677
"8362","ENSMODG00000011370","1",109681371,109824897,143526
"8363","ENSMODG00000011371","X",73610623,73627068,16445
"8364","ENSMODG00000011372","1",275565842,275568220,2378
"8365","ENSMODG00000011374","2",11010955,11037897,26942
"8366","ENSMODG00000011375","7",258949904,259037978,88074
"8367","ENSMODG00000011376","1",275607884,275608303,419
"8368","ENSMODG00000011377","2",11038501,11045257,6756
"8369","ENSMODG00000011378","1",109842469,109857648,15179
"8370","ENSMODG00000011382","X",73604473,73610455,5982
"8371","ENSMODG00000011383","1",275634953,275649269,14316
"8372","ENSMODG00000011385","3",437963516,438667331,703815
"8373","ENSMODG00000011388","7",260000580,260001518,938
"8374","ENSMODG00000011389","1",275714013,275715406,1393
"8375","ENSMODG00000011390","8",270971700,270997146,25446
"8376","ENSMODG00000011392","4",206165973,206204938,38965
"8377","ENSMODG00000011393","1",109855062,109859708,4646
"8378","ENSMODG00000011394","1",564302433,564361099,58666
"8379","ENSMODG00000011396","3",438505797,438524085,18288
"8380","ENSMODG00000011397","2",204911920,204946700,34780
"8381","ENSMODG00000011400","2",11076896,11141529,64633
"8382","ENSMODG00000011402","8",271058486,271059565,1079
"8383","ENSMODG00000011405","1",275717964,275854388,136424
"8384","ENSMODG00000011406","4",206349449,206368436,18987
"8385","ENSMODG00000011407","1",564269011,564290366,21355
"8386","ENSMODG00000011408","4",206488261,206492281,4020
"8387","ENSMODG00000011411","2",204813523,204824723,11200
"8388","ENSMODG00000011412","2",11141737,11148462,6725
"8389","ENSMODG00000011413","4",322896943,322956149,59206
"8390","ENSMODG00000011414","1",705610150,705616304,6154
"8391","ENSMODG00000011415","2",11149837,11154786,4949
"8392","ENSMODG00000011416","6",276504111,276565213,61102
"8393","ENSMODG00000011417","3",11370673,11371889,1216
"8394","ENSMODG00000011418","2",204791832,204811115,19283
"8395","ENSMODG00000011421","3",438634709,438685391,50682
"8396","ENSMODG00000011424","1",705690267,705693318,3051
"8397","ENSMODG00000011425","2",11156697,11171530,14833
"8398","ENSMODG00000011427","X",5158379,5232341,73962
"8399","ENSMODG00000011428","2",204641025,204642737,1712
"8400","ENSMODG00000011429","4",352678696,352679652,956
"8401","ENSMODG00000011432","8",271084344,271188962,104618
"8402","ENSMODG00000011433","1",332270446,332288865,18419
"8403","ENSMODG00000011434","1",109966547,109991128,24581
"8404","ENSMODG00000011435","3",314676679,314696404,19725
"8405","ENSMODG00000011436","4",352694784,352696385,1601
"8406","ENSMODG00000011437","1",275732314,275793242,60928
"8407","ENSMODG00000011438","7",260005125,260031406,26281
"8408","ENSMODG00000011440","4",206500850,206585154,84304
"8409","ENSMODG00000011441","1",705733016,705764634,31618
"8410","ENSMODG00000011442","2",204475064,204583618,108554
"8411","ENSMODG00000011443","Un",62807450,62808598,1148
"8412","ENSMODG00000011444","6",276574037,276604535,30498
"8413","ENSMODG00000011445","4",352719305,352721356,2051
"8414","ENSMODG00000011446","1",332268592,332269697,1105
"8415","ENSMODG00000011447","1",705840918,705859063,18145
"8416","ENSMODG00000011449","6",276641056,276648812,7756
"8417","ENSMODG00000011451","8",271269646,271270785,1139
"8418","ENSMODG00000011452","4",352757005,352779843,22838
"8419","ENSMODG00000011453","1",332261815,332268165,6350
"8420","ENSMODG00000011455","4",206594179,206604875,10696
"8421","ENSMODG00000011456","1",275824649,275873225,48576
"8422","ENSMODG00000011457","8",271339221,271340300,1079
"8423","ENSMODG00000011458","2",81170870,81683100,512230
"8424","ENSMODG00000011462","1",332231674,332238652,6978
"8425","ENSMODG00000011463","8",271476974,271478086,1112
"8426","ENSMODG00000011467","1",110002339,110209595,207256
"8427","ENSMODG00000011468","8",271573550,271574611,1061
"8428","ENSMODG00000011470","X",5421574,5467677,46103
"8429","ENSMODG00000011471","3",447554077,447557074,2997
"8430","ENSMODG00000011473","1",714419163,714419873,710
"8431","ENSMODG00000011474","4",352886682,352887614,932
"8432","ENSMODG00000011475","Un",66700678,66706787,6109
"8433","ENSMODG00000011476","6",276653887,276676949,23062
"8434","ENSMODG00000011477","4",352848924,352849823,899
"8435","ENSMODG00000011478","1",713243977,713244617,640
"8436","ENSMODG00000011479","4",411181914,411205643,23729
"8437","ENSMODG00000011480","X",5867855,5989805,121950
"8438","ENSMODG00000011481","1",564232992,564257581,24589
"8439","ENSMODG00000011483","3",447542083,447544942,2859
"8440","ENSMODG00000011485","6",276693139,276706460,13321
"8441","ENSMODG00000011488","1",563951078,564194421,243343
"8442","ENSMODG00000011489","1",10144824,10235314,90490
"8443","ENSMODG00000011490","1",332191424,332220291,28867
"8444","ENSMODG00000011491","3",447534879,447538279,3400
"8445","ENSMODG00000011492","X",6178316,6186186,7870
"8446","ENSMODG00000011495","3",483626025,483644419,18394
"8447","ENSMODG00000011500","1",110033603,110084740,51137
"8448","ENSMODG00000011502","1",714447543,714448214,671
"8449","ENSMODG00000011503","X",78232863,78476845,243982
"8450","ENSMODG00000011504","8",118359030,118359290,260
"8451","ENSMODG00000011505","1",563805990,563848257,42267
"8452","ENSMODG00000011507","X",6592975,6624094,31119
"8453","ENSMODG00000011508","3",447503783,447526679,22896
"8454","ENSMODG00000011510","3",447490700,447500534,9834
"8455","ENSMODG00000011511","4",353173636,353175657,2021
"8456","ENSMODG00000011512","1",110095146,110328176,233030
"8457","ENSMODG00000011514","3",483663828,483721738,57910
"8458","ENSMODG00000011515","1",563757477,563790969,33492
"8459","ENSMODG00000011516","2",204448493,204465333,16840
"8460","ENSMODG00000011517","1",9925571,9961182,35611
"8461","ENSMODG00000011518","3",314450249,314655360,205111
"8462","ENSMODG00000011519","3",447431716,447438256,6540
"8463","ENSMODG00000011521","6",276737836,276754176,16340
"8464","ENSMODG00000011522","1",563699429,563717199,17770
"8465","ENSMODG00000011524","3",483836888,483862442,25554
"8466","ENSMODG00000011525","X",78513947,78557197,43250
"8467","ENSMODG00000011526","X",14386052,14390561,4509
"8468","ENSMODG00000011528","1",563688090,563696312,8222
"8469","ENSMODG00000011529","2",204422110,204428510,6400
"8470","ENSMODG00000011530","3",447420921,447426409,5488
"8471","ENSMODG00000011531","X",78654970,78655617,647
"8472","ENSMODG00000011532","1",145015014,145112338,97324
"8473","ENSMODG00000011533","1",563673561,563683653,10092
"8474","ENSMODG00000011534","X",14399020,14411385,12365
"8475","ENSMODG00000011535","4",206657556,206755934,98378
"8476","ENSMODG00000011536","3",483897134,483949963,52829
"8477","ENSMODG00000011537","8",271669105,271724539,55434
"8478","ENSMODG00000011538","1",714441236,714441868,632
"8479","ENSMODG00000011539","3",447412298,447417192,4894
"8480","ENSMODG00000011540","1",9672728,9841769,169041
"8481","ENSMODG00000011542","X",78680522,78697162,16640
"8482","ENSMODG00000011543","2",204412668,204420638,7970
"8483","ENSMODG00000011545","3",447404385,447410433,6048
"8484","ENSMODG00000011547","X",14414974,14421612,6638
"8485","ENSMODG00000011549","3",483943936,483976838,32902
"8486","ENSMODG00000011550","4",207035098,207045102,10004
"8487","ENSMODG00000011552","3",447395296,447396529,1233
"8488","ENSMODG00000011553","4",207127705,207128514,809
"8489","ENSMODG00000011554","3",314352095,314395246,43151
"8490","ENSMODG00000011555","8",271762831,271774890,12059
"8491","ENSMODG00000011556","1",9525352,9628717,103365
"8492","ENSMODG00000011558","4",353247332,353248294,962
"8493","ENSMODG00000011559","3",484016189,484054364,38175
"8494","ENSMODG00000011560","X",14422165,14429038,6873
"8495","ENSMODG00000011561","2",204355389,204360958,5569
"8496","ENSMODG00000011562","1",563300867,563374871,74004
"8497","ENSMODG00000011563","3",484054372,484094140,39768
"8498","ENSMODG00000011564","8",271834757,271900873,66116
"8499","ENSMODG00000011565","1",275898017,275928604,30587
"8500","ENSMODG00000011566","4",207200746,207321005,120259
"8501","ENSMODG00000011567","4",353272607,353273557,950
"8502","ENSMODG00000011568","1",144899727,144979902,80175
"8503","ENSMODG00000011569","1",563034843,563037000,2157
"8504","ENSMODG00000011573","1",713884479,713885094,615
"8505","ENSMODG00000011574","1",144888603,144888930,327
"8506","ENSMODG00000011576","4",207371300,207419685,48385
"8507","ENSMODG00000011577","3",484098166,484110763,12597
"8508","ENSMODG00000011579","6",276754409,276899147,144738
"8509","ENSMODG00000011583","X",78733581,78761046,27465
"8510","ENSMODG00000011584","X",6694549,6913856,219307
"8511","ENSMODG00000011585","2",81804810,81835767,30957
"8512","ENSMODG00000011586","1",275904775,275997592,92817
"8513","ENSMODG00000011587","3",447272686,447347901,75215
"8514","ENSMODG00000011588","1",562874393,562909516,35123
"8515","ENSMODG00000011589","4",207485425,207543814,58389
"8516","ENSMODG00000011590","X",78782709,78790567,7858
"8517","ENSMODG00000011591","2",204327187,204356299,29112
"8518","ENSMODG00000011593","3",447257998,447261206,3208
"8519","ENSMODG00000011594","1",276039391,276059395,20004
"8520","ENSMODG00000011595","4",207552461,207587649,35188
"8521","ENSMODG00000011596","1",332072391,332195964,123573
"8522","ENSMODG00000011597","X",14439633,14467111,27478
"8523","ENSMODG00000011599","3",314225160,314299887,74727
"8524","ENSMODG00000011600","3",262263660,262265360,1700
"8525","ENSMODG00000011601","6",276953982,276962547,8565
"8526","ENSMODG00000011602","4",323164677,323169731,5054
"8527","ENSMODG00000011603","X",7055393,7119683,64290
"8528","ENSMODG00000011604","1",144821627,144878831,57204
"8529","ENSMODG00000011608","4",353528928,353537955,9027
"8530","ENSMODG00000011609","X",14759864,14798967,39103
"8531","ENSMODG00000011610","4",207758582,207821358,62776
"8532","ENSMODG00000011613","2",204261477,204289367,27890
"8533","ENSMODG00000011614","6",277014357,277033216,18859
"8534","ENSMODG00000011615","3",438806533,438817328,10795
"8535","ENSMODG00000011617","4",353554311,353568051,13740
"8536","ENSMODG00000011618","3",314181391,314226507,45116
"8537","ENSMODG00000011619","3",447244679,447250790,6111
"8538","ENSMODG00000011620","4",207897269,208009996,112727
"8539","ENSMODG00000011621","X",7119397,7140941,21544
"8540","ENSMODG00000011622","3",484128468,484148687,20219
"8541","ENSMODG00000011623","2",11462599,11538356,75757
"8542","ENSMODG00000011624","1",9444443,9472738,28295
"8543","ENSMODG00000011626","3",447226892,447243419,16527
"8544","ENSMODG00000011627","X",14510870,14527854,16984
"8545","ENSMODG00000011628","3",484156925,484163810,6885
"8546","ENSMODG00000011629","1",143928140,143958610,30470
"8547","ENSMODG00000011630","4",353588203,353590466,2263
"8548","ENSMODG00000011632","6",277037746,277046538,8792
"8549","ENSMODG00000011633","1",562720743,562771031,50288
"8550","ENSMODG00000011634","1",276065109,276095185,30076
"8551","ENSMODG00000011635","2",11537422,11551246,13824
"8552","ENSMODG00000011636","1",143905657,143918952,13295
"8553","ENSMODG00000011637","3",314033516,314175292,141776
"8554","ENSMODG00000011638","1",110337359,110368753,31394
"8555","ENSMODG00000011639","1",275925179,276135362,210183
"8556","ENSMODG00000011641","2",81825620,81913207,87587
"8557","ENSMODG00000011642","1",9388763,9407688,18925
"8558","ENSMODG00000011643","X",14544278,14616683,72405
"8559","ENSMODG00000011644","X",7237365,7337017,99652
"8560","ENSMODG00000011645","3",484179630,484206779,27149
"8561","ENSMODG00000011646","1",276146615,276200266,53651
"8562","ENSMODG00000011648","6",277066716,277087566,20850
"8563","ENSMODG00000011649","1",562401023,562584434,183411
"8564","ENSMODG00000011651","X",78798159,78960186,162027
"8565","ENSMODG00000011653","3",313987021,314012608,25587
"8566","ENSMODG00000011654","4",410436527,410460111,23584
"8567","ENSMODG00000011655","1",562425500,562433398,7898
"8568","ENSMODG00000011657","8",272652544,272707157,54613
"8569","ENSMODG00000011658","6",277089102,277092234,3132
"8570","ENSMODG00000011659","3",438949849,438976325,26476
"8571","ENSMODG00000011661","X",78829126,78832472,3346
"8572","ENSMODG00000011662","2",81919593,81956578,36985
"8573","ENSMODG00000011663","X",78832817,78846039,13222
"8574","ENSMODG00000011664","4",208104431,208188390,83959
"8575","ENSMODG00000011665","6",277123128,277126319,3191
"8576","ENSMODG00000011666","1",9277003,9386130,109127
"8577","ENSMODG00000011668","2",81972328,82008282,35954
"8578","ENSMODG00000011669","1",276448325,276598896,150571
"8579","ENSMODG00000011670","4",208139499,208140672,1173
"8580","ENSMODG00000011671","3",313962461,313974474,12013
"8581","ENSMODG00000011673","X",14723170,14749221,26051
"8582","ENSMODG00000011674","1",562311731,562337841,26110
"8583","ENSMODG00000011675","6",277142836,277157080,14244
"8584","ENSMODG00000011677","X",14801160,14802413,1253
"8585","ENSMODG00000011679","3",484207484,484266177,58693
"8586","ENSMODG00000011680","X",7386393,7537352,150959
"8587","ENSMODG00000011681","1",110385557,110412299,26742
"8588","ENSMODG00000011682","3",313869989,313884891,14902
"8589","ENSMODG00000011684","1",276672278,276740833,68555
"8590","ENSMODG00000011685","Un",22465036,22488837,23801
"8591","ENSMODG00000011688","1",9221389,9236619,15230
"8592","ENSMODG00000011689","1",110418106,110421088,2982
"8593","ENSMODG00000011690","1",562170529,562223330,52801
"8594","ENSMODG00000011691","X",78845370,78864341,18971
"8595","ENSMODG00000011692","X",7579125,7595203,16078
"8596","ENSMODG00000011693","Un",22531518,22534880,3362
"8597","ENSMODG00000011695","X",7626341,7774052,147711
"8598","ENSMODG00000011696","8",272708031,272794821,86790
"8599","ENSMODG00000011697","1",562095533,562108476,12943
"8600","ENSMODG00000011699","3",484352037,484433099,81062
"8601","ENSMODG00000011701","1",331989793,332008624,18831
"8602","ENSMODG00000011702","1",9197360,9217597,20237
"8603","ENSMODG00000011703","1",276776461,276866940,90479
"8604","ENSMODG00000011704","5",32793946,32847834,53888
"8605","ENSMODG00000011708","Un",10910032,10910944,912
"8606","ENSMODG00000011710","1",9132331,9141712,9381
"8607","ENSMODG00000011714","1",331863689,331925201,61512
"8608","ENSMODG00000011715","1",276946314,276961293,14979
"8609","ENSMODG00000011717","6",277236667,277381782,145115
"8610","ENSMODG00000011718","1",110428099,110435652,7553
"8611","ENSMODG00000011719","X",78878661,78913207,34546
"8612","ENSMODG00000011721","2",82223934,82234062,10128
"8613","ENSMODG00000011722","3",313763698,313820250,56552
"8614","ENSMODG00000011723","1",331690161,331691102,941
"8615","ENSMODG00000011724","8",272843388,272960820,117432
"8616","ENSMODG00000011726","3",484475100,484522336,47236
"8617","ENSMODG00000011727","1",8969155,8978059,8904
"8618","ENSMODG00000011729","1",143100076,143425859,325783
"8619","ENSMODG00000011732","1",110500848,110640804,139956
"8620","ENSMODG00000011733","1",562024991,562031356,6365
"8621","ENSMODG00000011734","1",277019692,277045761,26069
"8622","ENSMODG00000011736","6",277509484,277519223,9739
"8623","ENSMODG00000011737","1",331334477,331405022,70545
"8624","ENSMODG00000011738","1",562016060,562020277,4217
"8625","ENSMODG00000011739","1",284710657,284711868,1211
"8626","ENSMODG00000011740","1",142862540,142962350,99810
"8627","ENSMODG00000011741","6",277875373,277875702,329
"8628","ENSMODG00000011742","1",110638626,110663458,24832
"8629","ENSMODG00000011744","5",33064659,33132064,67405
"8630","ENSMODG00000011746","X",78951287,79005582,54295
"8631","ENSMODG00000011747","4",208199290,208254156,54866
"8632","ENSMODG00000011748","4",342151474,342152020,546
"8633","ENSMODG00000011749","3",446775772,447227150,451378
"8634","ENSMODG00000011751","2",204043382,204087959,44577
"8635","ENSMODG00000011752","X",79017631,79024278,6647
"8636","ENSMODG00000011755","3",446640582,446657289,16707
"8637","ENSMODG00000011756","8",273036205,273072456,36251
"8638","ENSMODG00000011757","1",110664999,110676287,11288
"8639","ENSMODG00000011758","X",79077556,79093312,15756
"8640","ENSMODG00000011762","5",33345669,33346142,473
"8641","ENSMODG00000011763","2",204157529,204158636,1107
"8642","ENSMODG00000011764","X",79150205,79150520,315
"8643","ENSMODG00000011765","1",331255920,331327835,71915
"8644","ENSMODG00000011766","3",313425045,313505945,80900
"8645","ENSMODG00000011767","4",208271882,208402301,130419
"8646","ENSMODG00000011768","1",9011540,9042898,31358
"8647","ENSMODG00000011769","4",402967846,402977654,9808
"8648","ENSMODG00000011771","6",277738705,277749453,10748
"8649","ENSMODG00000011772","1",331019396,331035662,16266
"8650","ENSMODG00000011773","3",313351616,313352884,1268
"8651","ENSMODG00000011774","2",204149728,204154279,4551
"8652","ENSMODG00000011775","1",8984094,9000075,15981
"8653","ENSMODG00000011776","1",142406998,142500161,93163
"8654","ENSMODG00000011777","1",561626795,561956401,329606
"8655","ENSMODG00000011778","1",277212083,277318788,106705
"8656","ENSMODG00000011779","5",33543316,33563295,19979
"8657","ENSMODG00000011780","6",277754122,277756550,2428
"8658","ENSMODG00000011782","6",277767435,277771393,3958
"8659","ENSMODG00000011783","1",330898799,330943084,44285
"8660","ENSMODG00000011784","1",142321367,142373294,51927
"8661","ENSMODG00000011785","X",79145732,79180207,34475
"8662","ENSMODG00000011786","3",439129335,439147750,18415
"8663","ENSMODG00000011787","2",11590293,11812301,222008
"8664","ENSMODG00000011788","1",110729945,110910947,181002
"8665","ENSMODG00000011789","2",204119783,204146353,26570
"8666","ENSMODG00000011790","6",277780217,277791095,10878
"8667","ENSMODG00000011791","2",82387808,82550047,162239
"8668","ENSMODG00000011792","1",330832325,330838003,5678
"8669","ENSMODG00000011793","1",456616421,456838020,221599
"8670","ENSMODG00000011794","5",33650370,33687399,37029
"8671","ENSMODG00000011795","1",142275100,142314745,39645
"8672","ENSMODG00000011796","1",561456740,561520601,63861
"8673","ENSMODG00000011798","X",79180115,79188313,8198
"8674","ENSMODG00000011802","2",11841989,11856601,14612
"8675","ENSMODG00000011803","1",142253146,142270203,17057
"8676","ENSMODG00000011804","2",204024615,204037660,13045
"8677","ENSMODG00000011805","1",561305226,561363886,58660
"8678","ENSMODG00000011806","1",142224529,142248544,24015
"8679","ENSMODG00000011807","6",277790442,277806127,15685
"8680","ENSMODG00000011808","X",79209283,79260488,51205
"8681","ENSMODG00000011809","2",203972035,204023192,51157
"8682","ENSMODG00000011812","2",11943474,12029642,86168
"8683","ENSMODG00000011813","1",330752960,330794219,41259
"8684","ENSMODG00000011815","6",277813052,277839036,25984
"8685","ENSMODG00000011816","1",330731848,330742824,10976
"8686","ENSMODG00000011819","1",561017415,561253548,236133
"8687","ENSMODG00000011821","1",277429705,277561165,131460
"8688","ENSMODG00000011825","5",33690480,33829242,138762
"8689","ENSMODG00000011826","2",12029487,12070049,40562
"8690","ENSMODG00000011827","6",277881172,277922659,41487
"8691","ENSMODG00000011828","2",12070787,12089586,18799
"8692","ENSMODG00000011829","4",208584819,208802275,217456
"8693","ENSMODG00000011830","8",273337998,273847804,509806
"8694","ENSMODG00000011832","2",203963205,203969272,6067
"8695","ENSMODG00000011833","1",277584175,277596388,12213
"8696","ENSMODG00000011835","1",141794279,141930799,136520
"8697","ENSMODG00000011836","5",33902166,33904694,2528
"8698","ENSMODG00000011837","X",79260164,79298776,38612
"8699","ENSMODG00000011838","3",217283411,217283938,527
"8700","ENSMODG00000011839","5",33926619,33927493,874
"8701","ENSMODG00000011840","1",278029762,278078208,48446
"8702","ENSMODG00000011844","3",446624005,446627448,3443
"8703","ENSMODG00000011845","1",141548955,141785822,236867
"8704","ENSMODG00000011848","2",203919970,203920647,677
"8705","ENSMODG00000011849","1",714139917,714141050,1133
"8706","ENSMODG00000011850","6",277928723,277973056,44333
"8707","ENSMODG00000011851","1",141660063,141660905,842
"8708","ENSMODG00000011852","1",560843681,560877849,34168
"8709","ENSMODG00000011853","5",34005094,34130618,125524
"8710","ENSMODG00000011855","2",12136561,12293539,156978
"8711","ENSMODG00000011857","1",8904588,8941370,36782
"8712","ENSMODG00000011858","2",203900532,203900720,188
"8713","ENSMODG00000011859","2",12296203,12297795,1592
"8714","ENSMODG00000011860","5",5455523,5456312,789
"8715","ENSMODG00000011862","4",209197914,209209988,12074
"8716","ENSMODG00000011863","3",446582534,446591159,8625
"8717","ENSMODG00000011864","2",203771344,203804931,33587
"8718","ENSMODG00000011865","X",79329324,79334758,5434
"8719","ENSMODG00000011866","2",12306177,12342750,36573
"8720","ENSMODG00000011868","4",209402657,209417325,14668
"8721","ENSMODG00000011870","3",446572050,446580468,8418
"8722","ENSMODG00000011871","2",203729888,203736241,6353
"8723","ENSMODG00000011873","8",273872107,273907722,35615
"8724","ENSMODG00000011874","2",87380432,87886526,506094
"8725","ENSMODG00000011876","3",446568446,446570839,2393
"8726","ENSMODG00000011879","3",312888981,313281160,392179
"8727","ENSMODG00000011880","5",34614286,34661931,47645
"8728","ENSMODG00000011882","1",560806214,560833599,27385
"8729","ENSMODG00000011883","1",8877645,8900012,22367
"8730","ENSMODG00000011885","1",140903148,140959001,55853
"8731","ENSMODG00000011886","1",330696206,330713905,17699
"8732","ENSMODG00000011888","1",111096843,111099574,2731
"8733","ENSMODG00000011890","6",278170791,278292735,121944
"8734","ENSMODG00000011891","1",8847731,8873277,25546
"8735","ENSMODG00000011892","1",278098804,278239897,141093
"8736","ENSMODG00000011893","2",12353961,12424543,70582
"8737","ENSMODG00000011894","2",88951774,88952872,1098
"8738","ENSMODG00000011895","1",330676794,330687992,11198
"8739","ENSMODG00000011897","3",312773193,312842033,68840
"8740","ENSMODG00000011898","5",34846674,34864139,17465
"8741","ENSMODG00000011902","3",446529905,446551086,21181
"8742","ENSMODG00000011903","6",278298779,278300437,1658
"8743","ENSMODG00000011905","5",34890593,34891220,627
"8744","ENSMODG00000011907","1",111321731,111328569,6838
"8745","ENSMODG00000011908","4",209592535,209888036,295501
"8746","ENSMODG00000011909","6",278307116,278317938,10822
"8747","ENSMODG00000011910","8",273990872,274282361,291489
"8748","ENSMODG00000011913","2",90291583,90309379,17796
"8749","ENSMODG00000011916","5",34901118,34905637,4519
"8750","ENSMODG00000011917","8",274285443,274295870,10427
"8751","ENSMODG00000011918","3",312354564,312515086,160522
"8752","ENSMODG00000011919","1",8643182,8715522,72340
"8753","ENSMODG00000011920","1",425468283,425486366,18083
"8754","ENSMODG00000011921","4",354163604,354164873,1269
"8755","ENSMODG00000011922","1",111371293,111383719,12426
"8756","ENSMODG00000011923","3",312317856,312327209,9353
"8757","ENSMODG00000011924","5",34906209,34957275,51066
"8758","ENSMODG00000011925","1",330653918,330670926,17008
"8759","ENSMODG00000011926","1",278263809,278274801,10992
"8760","ENSMODG00000011928","1",8614929,8634007,19078
"8761","ENSMODG00000011929","3",312259688,312309332,49644
"8762","ENSMODG00000011930","5",34980479,34997408,16929
"8763","ENSMODG00000011932","3",312045993,312046771,778
"8764","ENSMODG00000011934","1",425491240,425526803,35563
"8765","ENSMODG00000011935","3",311950507,311968139,17632
"8766","ENSMODG00000011936","1",8361360,8506217,144857
"8767","ENSMODG00000011937","1",111384753,111408799,24046
"8768","ENSMODG00000011938","1",560495912,560675567,179655
"8769","ENSMODG00000011939","1",425536071,425543889,7818
"8770","ENSMODG00000011941","1",140473634,140522164,48530
"8771","ENSMODG00000011942","Un",5921349,6060111,138762
"8772","ENSMODG00000011943","3",311924270,311936755,12485
"8773","ENSMODG00000011944","4",354261099,354262037,938
"8774","ENSMODG00000011945","2",203583451,203612112,28661
"8775","ENSMODG00000011946","1",278341279,278365213,23934
"8776","ENSMODG00000011948","1",560395348,560409704,14356
"8777","ENSMODG00000011949","3",446369355,446385001,15646
"8778","ENSMODG00000011950","Un",70094151,70096979,2828
"8779","ENSMODG00000011951","Un",6293891,6436098,142207
"8780","ENSMODG00000011953","1",560336940,560358328,21388
"8781","ENSMODG00000011954","6",278331474,278542455,210981
"8782","ENSMODG00000011955","1",111409936,111413793,3857
"8783","ENSMODG00000011956","1",140463449,140470044,6595
"8784","ENSMODG00000011957","3",270635885,270637324,1439
"8785","ENSMODG00000011958","3",311821738,311859805,38067
"8786","ENSMODG00000011960","Un",70099600,70106411,6811
"8787","ENSMODG00000011961","3",446227658,446379448,151790
"8788","ENSMODG00000011962","Un",6396659,6485092,88433
"8789","ENSMODG00000011965","3",311743618,311764096,20478
"8790","ENSMODG00000011966","1",111420483,111424319,3836
"8791","ENSMODG00000011967","1",8273180,8345543,72363
"8792","ENSMODG00000011968","6",205385158,205477963,92805
"8793","ENSMODG00000011969","2",203560353,203572296,11943
"8794","ENSMODG00000011974","6",205360001,205368429,8428
"8795","ENSMODG00000011975","1",111424825,111427428,2603
"8796","ENSMODG00000011977","3",446364382,446484587,120205
"8797","ENSMODG00000011978","3",311526660,311684069,157409
"8798","ENSMODG00000011979","1",330120068,330441861,321793
"8799","ENSMODG00000011980","1",425545034,425571337,26303
"8800","ENSMODG00000011982","1",8213027,8220566,7539
"8801","ENSMODG00000011983","5",35118796,35176352,57556
"8802","ENSMODG00000011984","6",205223710,205270345,46635
"8803","ENSMODG00000011985","1",560170712,560207388,36676
"8804","ENSMODG00000011988","3",311349822,311512561,162739
"8805","ENSMODG00000011989","6",205200987,205220371,19384
"8806","ENSMODG00000011991","8",274304306,274440426,136120
"8807","ENSMODG00000011993","1",111430644,111438749,8105
"8808","ENSMODG00000011994","1",278412763,278495586,82823
"8809","ENSMODG00000011995","3",311020765,311151796,131031
"8810","ENSMODG00000011996","2",12545619,12759349,213730
"8811","ENSMODG00000011997","1",559898131,559962870,64739
"8812","ENSMODG00000011998","3",493575202,493576155,953
"8813","ENSMODG00000011999","1",425593971,425682179,88208
"8814","ENSMODG00000012001","1",140009660,140268542,258882
"8815","ENSMODG00000012002","3",493297801,493550338,252537
"8816","ENSMODG00000012003","3",484618009,484654826,36817
"8817","ENSMODG00000012004","3",446339870,446347749,7879
"8818","ENSMODG00000012005","1",559848918,559857462,8544
"8819","ENSMODG00000012006","3",493511680,493512352,672
"8820","ENSMODG00000012009","1",278653157,278654320,1163
"8821","ENSMODG00000012010","2",203514895,203544228,29333
"8822","ENSMODG00000012011","3",484675586,484855698,180112
"8823","ENSMODG00000012013","1",111447788,111497700,49912
"8824","ENSMODG00000012015","3",493272434,493274284,1850
"8825","ENSMODG00000012017","8",274573589,274636825,63236
"8826","ENSMODG00000012018","3",310411522,310623081,211559
"8827","ENSMODG00000012019","1",278678096,279026662,348566
"8828","ENSMODG00000012020","1",139958127,139970255,12128
"8829","ENSMODG00000012022","1",559758341,559824453,66112
"8830","ENSMODG00000012026","2",203457594,203480537,22943
"8831","ENSMODG00000012028","3",484714623,484746124,31501
"8832","ENSMODG00000012029","1",559733258,559740173,6915
"8833","ENSMODG00000012030","1",279037243,279041866,4623
"8834","ENSMODG00000012032","1",139937343,139955203,17860
"8835","ENSMODG00000012034","1",425765285,425818358,53073
"8836","ENSMODG00000012035","2",12938644,12967539,28895
"8837","ENSMODG00000012036","1",559295923,559297078,1155
"8838","ENSMODG00000012037","1",139803501,139886052,82551
"8839","ENSMODG00000012038","1",426309289,426326700,17411
"8840","ENSMODG00000012039","3",484812629,484827569,14940
"8841","ENSMODG00000012040","Un",28596776,28598512,1736
"8842","ENSMODG00000012042","1",7792234,8205345,413111
"8843","ENSMODG00000012043","1",279223265,279695436,472171
"8844","ENSMODG00000012044","3",446325658,446339166,13508
"8845","ENSMODG00000012045","3",492832199,492892629,60430
"8846","ENSMODG00000012046","4",216609223,216660434,51211
"8847","ENSMODG00000012050","1",329984899,330111530,126631
"8848","ENSMODG00000012053","5",35177138,35267678,90540
"8849","ENSMODG00000012054","2",13387515,13497023,109508
"8850","ENSMODG00000012055","1",330041254,330048059,6805
"8851","ENSMODG00000012056","2",13716197,13930148,213951
"8852","ENSMODG00000012058","1",557362022,557395468,33446
"8853","ENSMODG00000012059","3",492502632,492700729,198097
"8854","ENSMODG00000012060","1",557351661,557352276,615
"8855","ENSMODG00000012062","2",90760468,90766488,6020
"8856","ENSMODG00000012063","6",204497283,204950320,453037
"8857","ENSMODG00000012064","2",14614310,14656965,42655
"8858","ENSMODG00000012065","3",484832363,484839522,7159
"8859","ENSMODG00000012066","3",446251481,446273341,21860
"8860","ENSMODG00000012068","1",139483507,139654207,170700
"8861","ENSMODG00000012069","6",204351477,204515189,163712
"8862","ENSMODG00000012072","6",204488008,204493413,5405
"8863","ENSMODG00000012073","2",14738889,14741453,2564
"8864","ENSMODG00000012074","1",557234990,557296361,61371
"8865","ENSMODG00000012075","3",446231454,446237174,5720
"8866","ENSMODG00000012076","2",15049257,15165688,116431
"8867","ENSMODG00000012077","6",204476501,204486006,9505
"8868","ENSMODG00000012079","2",15203384,15216689,13305
"8869","ENSMODG00000012080","1",7728043,7746510,18467
"8870","ENSMODG00000012083","1",329579025,329596774,17749
"8871","ENSMODG00000012084","2",90870614,90890116,19502
"8872","ENSMODG00000012085","3",484881789,485154935,273146
"8873","ENSMODG00000012086","1",556917822,556990290,72468
"8874","ENSMODG00000012087","3",446210758,446225924,15166
"8875","ENSMODG00000012089","1",7585625,7687013,101388
"8876","ENSMODG00000012090","2",203409563,203450033,40470
"8877","ENSMODG00000012091","3",485028598,485052287,23689
"8878","ENSMODG00000012092","1",556856513,556856674,161
"8879","ENSMODG00000012093","1",456845708,456932831,87123
"8880","ENSMODG00000012094","6",204475959,204488480,12521
"8881","ENSMODG00000012095","3",485057204,485062766,5562
"8882","ENSMODG00000012097","2",15380776,15401648,20872
"8883","ENSMODG00000012098","2",203297515,203302947,5432
"8884","ENSMODG00000012099","3",446196289,446203942,7653
"8885","ENSMODG00000012101","2",91074786,91080549,5763
"8886","ENSMODG00000012103","1",7539843,7569405,29562
"8887","ENSMODG00000012104","2",203256670,203266062,9392
"8888","ENSMODG00000012105","1",457047558,457119172,71614
"8889","ENSMODG00000012106","6",204462096,204475580,13484
"8890","ENSMODG00000012107","1",7448067,7500075,52008
"8891","ENSMODG00000012108","1",457153967,457172846,18879
"8892","ENSMODG00000012109","3",490522930,490972112,449182
"8893","ENSMODG00000012111","3",485126103,485174853,48750
"8894","ENSMODG00000012112","4",216663129,216957647,294518
"8895","ENSMODG00000012113","1",7155883,7228372,72489
"8896","ENSMODG00000012114","1",457190168,457208926,18758
"8897","ENSMODG00000012115","1",329522355,329559794,37439
"8898","ENSMODG00000012116","1",457278515,457278965,450
"8899","ENSMODG00000012117","3",485177053,485207672,30619
"8900","ENSMODG00000012118","1",329459376,329464716,5340
"8901","ENSMODG00000012120","5",1046636,1120535,73899
"8902","ENSMODG00000012121","4",217055305,217094492,39187
"8903","ENSMODG00000012122","1",426379324,426380339,1015
"8904","ENSMODG00000012124","1",329429363,329437218,7855
"8905","ENSMODG00000012126","1",457231811,457458688,226877
"8906","ENSMODG00000012128","5",1137316,1180752,43436
"8907","ENSMODG00000012129","2",91274085,91310376,36291
"8908","ENSMODG00000012130","6",204406659,204418764,12105
"8909","ENSMODG00000012131","3",485378160,485492345,114185
"8910","ENSMODG00000012132","1",457466366,457466776,410
"8911","ENSMODG00000012133","1",5931539,6042101,110562
"8912","ENSMODG00000012134","3",482320600,482322530,1930
"8913","ENSMODG00000012135","1",5870840,5879990,9150
"8914","ENSMODG00000012136","6",204395782,204401543,5761
"8915","ENSMODG00000012138","1",457486020,457547338,61318
"8916","ENSMODG00000012139","1",426747955,427023066,275111
"8917","ENSMODG00000012140","3",482377920,482381148,3228
"8918","ENSMODG00000012141","1",139416169,139474951,58782
"8919","ENSMODG00000012142","2",202943363,202976924,33561
"8920","ENSMODG00000012143","3",485286842,485304502,17660
"8921","ENSMODG00000012144","1",329358882,329422319,63437
"8922","ENSMODG00000012145","3",446136977,446177368,40391
"8923","ENSMODG00000012146","6",204359938,204371323,11385
"8924","ENSMODG00000012147","3",485360177,485374901,14724
"8925","ENSMODG00000012148","1",139094639,139122684,28045
"8926","ENSMODG00000012149","1",329345132,329356003,10871
"8927","ENSMODG00000012151","1",5816020,5855701,39681
"8928","ENSMODG00000012153","3",482414661,482467557,52896
"8929","ENSMODG00000012155","1",457684415,457806803,122388
"8930","ENSMODG00000012157","3",485510634,485550265,39631
"8931","ENSMODG00000012158","1",5728133,5730203,2070
"8932","ENSMODG00000012160","1",139053908,139061130,7222
"8933","ENSMODG00000012161","1",5696947,5718555,21608
"8934","ENSMODG00000012162","1",427167409,427168140,731
"8935","ENSMODG00000012163","1",5691854,5693289,1435
"8936","ENSMODG00000012164","6",204348106,204350411,2305
"8937","ENSMODG00000012165","1",138893062,139007499,114437
"8938","ENSMODG00000012166","2",202817129,202884680,67551
"8939","ENSMODG00000012167","1",457811769,457849670,37901
"8940","ENSMODG00000012168","1",138936691,138937207,516
"8941","ENSMODG00000012169","1",5643448,5660972,17524
"8942","ENSMODG00000012170","4",217137927,217454363,316436
"8943","ENSMODG00000012172","1",5609622,5627398,17776
"8944","ENSMODG00000012173","1",329342207,329343451,1244
"8945","ENSMODG00000012174","3",485602748,485684300,81552
"8946","ENSMODG00000012175","6",204335500,204348022,12522
"8947","ENSMODG00000012176","1",5572841,5601351,28510
"8948","ENSMODG00000012177","6",204332458,204333431,973
"8949","ENSMODG00000012179","1",329318031,329338468,20437
"8950","ENSMODG00000012182","3",485715300,485738817,23517
"8951","ENSMODG00000012183","4",217661332,217781309,119977
"8952","ENSMODG00000012187","1",329288926,329302084,13158
"8953","ENSMODG00000012189","3",482506303,482539080,32777
"8954","ENSMODG00000012190","1",5541002,5547732,6730
"8955","ENSMODG00000012192","3",485749712,485759288,9576
"8956","ENSMODG00000012193","2",202640978,202647046,6068
"8957","ENSMODG00000012194","6",204311914,204324641,12727
"8958","ENSMODG00000012195","1",5524152,5533029,8877
"8959","ENSMODG00000012196","4",217794570,217839297,44727
"8960","ENSMODG00000012197","1",329104595,329130727,26132
"8961","ENSMODG00000012199","3",482604857,482668831,63974
"8962","ENSMODG00000012200","2",202487503,202518340,30837
"8963","ENSMODG00000012201","1",5487322,5510162,22840
"8964","ENSMODG00000012202","1",427335984,427388439,52455
"8965","ENSMODG00000012203","2",91319661,91342678,23017
"8966","ENSMODG00000012204","3",439552812,439560157,7345
"8967","ENSMODG00000012205","1",329100646,329107803,7157
"8968","ENSMODG00000012206","3",482668443,482702981,34538
"8969","ENSMODG00000012207","1",5416629,5485594,68965
"8970","ENSMODG00000012209","1",427388487,427452509,64022
"8971","ENSMODG00000012210","2",202379774,202392856,13082
"8972","ENSMODG00000012211","1",427510245,427582657,72412
"8973","ENSMODG00000012212","2",91319619,91413073,93454
"8974","ENSMODG00000012214","4",217879784,217979005,99221
"8975","ENSMODG00000012215","2",202214162,202264835,50673
"8976","ENSMODG00000012216","3",309765165,310300038,534873
"8977","ENSMODG00000012217","2",202127594,202135310,7716
"8978","ENSMODG00000012219","3",485762868,485781993,19125
"8979","ENSMODG00000012220","1",5118937,5335257,216320
"8980","ENSMODG00000012221","3",482467742,482853738,385996
"8981","ENSMODG00000012222","2",91432558,91603169,170611
"8982","ENSMODG00000012223","1",329066802,329100945,34143
"8983","ENSMODG00000012224","6",278876223,278882468,6245
"8984","ENSMODG00000012225","1",4863819,4870833,7014
"8985","ENSMODG00000012226","1",427586880,427650233,63353
"8986","ENSMODG00000012227","3",482854380,482860964,6584
"8987","ENSMODG00000012228","1",4821871,4822533,662
"8988","ENSMODG00000012230","1",329047375,329065677,18302
"8989","ENSMODG00000012231","3",309572562,309595685,23123
"8990","ENSMODG00000012232","6",278888725,278921203,32478
"8991","ENSMODG00000012233","2",202111590,202125521,13931
"8992","ENSMODG00000012234","3",483012504,483013253,749
"8993","ENSMODG00000012236","2",96160835,96237263,76428
"8994","ENSMODG00000012237","1",4743469,4763145,19676
"8995","ENSMODG00000012238","4",218000449,218381223,380774
"8996","ENSMODG00000012239","2",202104547,202105294,747
"8997","ENSMODG00000012240","1",427676178,427761115,84937
"8998","ENSMODG00000012241","4",218419625,218420594,969
"8999","ENSMODG00000012242","2",201783916,202013688,229772
"9000","ENSMODG00000012243","1",427758742,427770776,12034
"9001","ENSMODG00000012245","Un",54570089,54571177,1088
"9002","ENSMODG00000012246","1",427770841,427957900,187059
"9003","ENSMODG00000012247","1",328777255,328850897,73642
"9004","ENSMODG00000012249","Un",52551158,52612784,61626
"9005","ENSMODG00000012251","6",278963889,278986598,22709
"9006","ENSMODG00000012253","3",485800524,485964509,163985
"9007","ENSMODG00000012254","3",483027719,483465162,437443
"9008","ENSMODG00000012255","2",96272128,96787364,515236
"9009","ENSMODG00000012256","1",427962467,428002144,39677
"9010","ENSMODG00000012257","5",1197666,1252669,55003
"9011","ENSMODG00000012258","1",328742335,328775145,32810
"9012","ENSMODG00000012262","1",328714956,328741482,26526
"9013","ENSMODG00000012263","5",1265801,1284329,18528
"9014","ENSMODG00000012264","3",486014775,486042346,27571
"9015","ENSMODG00000012268","2",201654721,201716921,62200
"9016","ENSMODG00000012269","3",486048722,486068716,19994
"9017","ENSMODG00000012271","5",1294345,1322909,28564
"9018","ENSMODG00000012273","6",204148638,204166409,17771
"9019","ENSMODG00000012274","5",1333519,1390789,57270
"9020","ENSMODG00000012275","4",218433651,218482616,48965
"9021","ENSMODG00000012276","2",201574457,201585161,10704
"9022","ENSMODG00000012279","6",204093930,204103691,9761
"9023","ENSMODG00000012281","4",218571096,218595366,24270
"9024","ENSMODG00000012282","3",306737697,306775666,37969
"9025","ENSMODG00000012283","6",204069448,204086508,17060
"9026","ENSMODG00000012284","2",96859085,96978404,119319
"9027","ENSMODG00000012285","2",201564415,201579448,15033
"9028","ENSMODG00000012286","1",428002769,428075768,72999
"9029","ENSMODG00000012288","1",428086974,428106116,19142
"9030","ENSMODG00000012289","4",218598183,218612586,14403
"9031","ENSMODG00000012290","2",15583325,15604645,21320
"9032","ENSMODG00000012291","3",306218895,306394808,175913
"9033","ENSMODG00000012292","3",486068826,486187511,118685
"9034","ENSMODG00000012295","4",218615461,218617886,2425
"9035","ENSMODG00000012296","2",201543235,201545530,2295
"9036","ENSMODG00000012297","3",486224264,486225349,1085
"9037","ENSMODG00000012298","Un",37591317,37593039,1722
"9038","ENSMODG00000012299","3",486244606,486245634,1028
"9039","ENSMODG00000012300","5",1431786,1506643,74857
"9040","ENSMODG00000012301","6",203844480,203873467,28987
"9041","ENSMODG00000012302","3",486295613,486322504,26891
"9042","ENSMODG00000012304","3",305966366,306210234,243868
"9043","ENSMODG00000012305","4",218666075,218687322,21247
"9044","ENSMODG00000012306","2",201484853,201497498,12645
"9045","ENSMODG00000012307","5",1562510,1589365,26855
"9046","ENSMODG00000012308","3",486329046,486384468,55422
"9047","ENSMODG00000012310","2",201363754,201365724,1970
"9048","ENSMODG00000012311","4",218715391,218799235,83844
"9049","ENSMODG00000012312","6",203745136,203839952,94816
"9050","ENSMODG00000012315","3",305242682,305335701,93019
"9051","ENSMODG00000012316","5",1693959,1722847,28888
"9052","ENSMODG00000012317","3",303552097,303625866,73769
"9053","ENSMODG00000012318","6",203696519,203712726,16207
"9054","ENSMODG00000012320","3",303521489,303530293,8804
"9055","ENSMODG00000012321","6",278990002,279068799,78797
"9056","ENSMODG00000012322","1",428157618,428253475,95857
"9057","ENSMODG00000012323","4",218848320,218910789,62469
"9058","ENSMODG00000012324","6",279136467,279139453,2986
"9059","ENSMODG00000012326","1",428285052,428293335,8283
"9060","ENSMODG00000012328","4",378559601,378774095,214494
"9061","ENSMODG00000012329","2",201204501,201208766,4265
"9062","ENSMODG00000012331","4",219310802,219392977,82175
"9063","ENSMODG00000012332","3",302673820,303305510,631690
"9064","ENSMODG00000012333","2",201187372,201192060,4688
"9065","ENSMODG00000012334","2",201175562,201185515,9953
"9066","ENSMODG00000012335","6",203647018,203679825,32807
"9067","ENSMODG00000012337","6",279187476,279262779,75303
"9068","ENSMODG00000012338","2",201170722,201172260,1538
"9069","ENSMODG00000012339","4",378802416,378804562,2146
"9070","ENSMODG00000012340","2",201152037,201155974,3937
"9071","ENSMODG00000012341","3",486417625,486466832,49207
"9072","ENSMODG00000012343","5",1743426,1804034,60608
"9073","ENSMODG00000012344","2",201123980,201130023,6043
"9074","ENSMODG00000012345","6",279534055,279555218,21163
"9075","ENSMODG00000012346","4",378940683,379091893,151210
"9076","ENSMODG00000012347","2",201115688,201118103,2415
"9077","ENSMODG00000012348","6",203559099,203575023,15924
"9078","ENSMODG00000012349","3",486466847,486491127,24280
"9079","ENSMODG00000012350","5",1890740,1893443,2703
"9080","ENSMODG00000012352","4",220799401,221030551,231150
"9081","ENSMODG00000012353","5",2067803,2073090,5287
"9082","ENSMODG00000012355","6",203504069,203553180,49111
"9083","ENSMODG00000012358","4",380082206,380082376,170
"9084","ENSMODG00000012360","2",200537268,200967804,430536
"9085","ENSMODG00000012361","1",428518309,428635146,116837
"9086","ENSMODG00000012362","4",380528674,380729088,200414
"9087","ENSMODG00000012363","2",200533232,200542766,9534
"9088","ENSMODG00000012364","1",328647384,328710949,63565
"9089","ENSMODG00000012365","6",279616099,279694870,78771
"9090","ENSMODG00000012366","3",302480636,302572690,92054
"9091","ENSMODG00000012367","1",428693526,428722749,29223
"9092","ENSMODG00000012368","2",200463835,200466849,3014
"9093","ENSMODG00000012371","3",302431077,302470649,39572
"9094","ENSMODG00000012373","5",2358855,2376169,17314
"9095","ENSMODG00000012375","2",200446594,200455690,9096
"9096","ENSMODG00000012376","2",15691716,15706478,14762
"9097","ENSMODG00000012377","6",279700415,279756922,56507
"9098","ENSMODG00000012378","3",302314881,302343436,28555
"9099","ENSMODG00000012379","4",380996810,381042808,45998
"9100","ENSMODG00000012380","4",221494413,221510765,16352
"9101","ENSMODG00000012381","4",221515610,221553543,37933
"9102","ENSMODG00000012382","4",381159963,381171321,11358
"9103","ENSMODG00000012384","3",302092644,302150121,57477
"9104","ENSMODG00000012386","3",302017185,302059761,42576
"9105","ENSMODG00000012387","4",381337267,381382147,44880
"9106","ENSMODG00000012388","2",15729350,15731315,1965
"9107","ENSMODG00000012389","4",221553872,221567206,13334
"9108","ENSMODG00000012390","1",430107190,430197299,90109
"9109","ENSMODG00000012391","1",328629191,328638211,9020
"9110","ENSMODG00000012392","6",279848750,280660074,811324
"9111","ENSMODG00000012393","3",301798061,301809499,11438
"9112","ENSMODG00000012394","6",203473969,203496709,22740
"9113","ENSMODG00000012395","5",2417351,2434495,17144
"9114","ENSMODG00000012396","1",457864484,457969280,104796
"9115","ENSMODG00000012397","1",328541105,328598171,57066
"9116","ENSMODG00000012398","3",486561794,486601713,39919
"9117","ENSMODG00000012399","3",301713861,301797047,83186
"9118","ENSMODG00000012401","6",280905076,280925534,20458
"9119","ENSMODG00000012402","1",457992917,458007712,14795
"9120","ENSMODG00000012404","1",458026963,458079300,52337
"9121","ENSMODG00000012406","3",299931348,299932131,783
"9122","ENSMODG00000012407","3",486627604,486636591,8987
"9123","ENSMODG00000012408","2",15753320,15802647,49327
"9124","ENSMODG00000012411","3",298799906,299137347,337441
"9125","ENSMODG00000012412","X",8100717,8307654,206937
"9126","ENSMODG00000012413","4",222021920,222266001,244081
"9127","ENSMODG00000012414","2",15834443,15886298,51855
"9128","ENSMODG00000012416","3",298737428,298738040,612
"9129","ENSMODG00000012418","3",298502512,298503048,536
"9130","ENSMODG00000012419","4",222275812,222299203,23391
"9131","ENSMODG00000012420","6",281396483,282436386,1039903
"9132","ENSMODG00000012421","4",222318762,222352068,33306
"9133","ENSMODG00000012422","6",281537459,281547665,10206
"9134","ENSMODG00000012423","2",15903290,16084985,181695
"9135","ENSMODG00000012424","2",200346048,200363850,17802
"9136","ENSMODG00000012427","6",134894273,134908126,13853
"9137","ENSMODG00000012428","1",458135553,458249125,113572
"9138","ENSMODG00000012431","1",328521643,328530507,8864
"9139","ENSMODG00000012432","3",486650710,486723060,72350
"9140","ENSMODG00000012439","2",200272123,200285389,13266
"9141","ENSMODG00000012440","X",9116587,9208123,91536
"9142","ENSMODG00000012441","3",486924558,486983232,58674
"9143","ENSMODG00000012443","4",381435415,381847008,411593
"9144","ENSMODG00000012444","3",486995771,486997197,1426
"9145","ENSMODG00000012445","X",9635064,9659974,24910
"9146","ENSMODG00000012446","2",200245878,200248613,2735
"9147","ENSMODG00000012447","6",135047446,135048408,962
"9148","ENSMODG00000012449","1",458250041,458290206,40165
"9149","ENSMODG00000012450","3",486999968,487002275,2307
"9150","ENSMODG00000012451","3",487004916,487023792,18876
"9151","ENSMODG00000012452","2",200227134,200235342,8208
"9152","ENSMODG00000012454","2",200127027,200128178,1151
"9153","ENSMODG00000012456","X",9819155,9878379,59224
"9154","ENSMODG00000012459","X",10041849,10063410,21561
"9155","ENSMODG00000012460","1",458282479,458299319,16840
"9156","ENSMODG00000012463","4",401195708,401197881,2173
"9157","ENSMODG00000012467","2",200114629,200119213,4584
"9158","ENSMODG00000012469","4",401097869,401101234,3365
"9159","ENSMODG00000012470","3",487061463,487109148,47685
"9160","ENSMODG00000012473","2",200109207,200114378,5171
"9161","ENSMODG00000012475","3",487142588,487160313,17725
"9162","ENSMODG00000012477","2",200101973,200109447,7474
"9163","ENSMODG00000012479","3",487179425,487301797,122372
"9164","ENSMODG00000012481","3",487213807,487214343,536
"9165","ENSMODG00000012485","4",222373708,222475686,101978
"9166","ENSMODG00000012486","3",524772806,524773302,496
"9167","ENSMODG00000012489","3",524786645,524787953,1308
"9168","ENSMODG00000012490","3",487217689,487273103,55414
"9169","ENSMODG00000012491","3",524858856,524859352,496
"9170","ENSMODG00000012492","1",458317583,458475859,158276
"9171","ENSMODG00000012493","3",524868804,524869300,496
"9172","ENSMODG00000012494","X",10202853,10280093,77240
"9173","ENSMODG00000012495","6",282719630,282725694,6064
"9174","ENSMODG00000012496","6",135086255,135089508,3253
"9175","ENSMODG00000012499","1",458704832,458984554,279722
"9176","ENSMODG00000012500","3",525013114,525013886,772
"9177","ENSMODG00000012505","2",199839528,199956876,117348
"9178","ENSMODG00000012508","6",282729780,282740579,10799
"9179","ENSMODG00000012510","6",135108076,135110223,2147
"9180","ENSMODG00000012511","1",459109122,459210431,101309
"9181","ENSMODG00000012512","2",522309979,522324734,14755
"9182","ENSMODG00000012514","3",525201764,525202428,664
"9183","ENSMODG00000012515","4",401000491,401125827,125336
"9184","ENSMODG00000012516","3",525216305,525216976,671
"9185","ENSMODG00000012517","6",282746246,282758862,12616
"9186","ENSMODG00000012518","2",200081929,200094240,12311
"9187","ENSMODG00000012519","3",487324531,487349232,24701
"9188","ENSMODG00000012521","4",400947704,400971325,23621
"9189","ENSMODG00000012523","6",282778786,282786690,7904
"9190","ENSMODG00000012525","3",487348625,487366146,17521
"9191","ENSMODG00000012526","2",199949591,199966847,17256
"9192","ENSMODG00000012527","4",400859671,400882540,22869
"9193","ENSMODG00000012530","6",135175996,135244915,68919
"9194","ENSMODG00000012531","1",328471215,328485410,14195
"9195","ENSMODG00000012532","4",400822043,400824230,2187
"9196","ENSMODG00000012533","Un",73324054,73324648,594
"9197","ENSMODG00000012535","1",459238263,459325847,87584
"9198","ENSMODG00000012537","6",135350782,135526007,175225
"9199","ENSMODG00000012538","1",459360907,459387397,26490
"9200","ENSMODG00000012539","1",328385924,328434231,48307
"9201","ENSMODG00000012542","1",328229544,328251607,22063
"9202","ENSMODG00000012543","6",135530769,135595019,64250
"9203","ENSMODG00000012544","1",459634731,459644324,9593
"9204","ENSMODG00000012545","3",487447859,487488971,41112
"9205","ENSMODG00000012546","6",282807753,283150968,343215
"9206","ENSMODG00000012547","6",135609990,135621846,11856
"9207","ENSMODG00000012548","2",182930588,183535597,605009
"9208","ENSMODG00000012553","6",135657727,135732002,74275
"9209","ENSMODG00000012554","6",283261523,283302544,41021
"9210","ENSMODG00000012555","1",459649458,459742218,92760
"9211","ENSMODG00000012556","3",487503515,487518514,14999
"9212","ENSMODG00000012557","2",199684891,199762312,77421
"9213","ENSMODG00000012558","2",183937636,183987437,49801
"9214","ENSMODG00000012559","1",459743186,459767217,24031
"9215","ENSMODG00000012560","2",199631269,199676023,44754
"9216","ENSMODG00000012561","1",459789895,459965513,175618
"9217","ENSMODG00000012562","6",135767474,135863828,96354
"9218","ENSMODG00000012563","6",135867158,135875482,8324
"9219","ENSMODG00000012564","2",199608115,199628344,20229
"9220","ENSMODG00000012565","1",459975545,459984344,8799
"9221","ENSMODG00000012566","2",199559275,199598677,39402
"9222","ENSMODG00000012570","2",199401769,199516594,114825
"9223","ENSMODG00000012572","2",183993246,184067520,74274
"9224","ENSMODG00000012573","6",283346086,283366058,19972
"9225","ENSMODG00000012575","1",328157916,328192247,34331
"9226","ENSMODG00000012577","2",199260340,199392275,131935
"9227","ENSMODG00000012580","2",184076307,184091759,15452
"9228","ENSMODG00000012581","6",283372734,283439027,66293
"9229","ENSMODG00000012582","2",199196633,199197871,1238
"9230","ENSMODG00000012583","1",328021260,328021623,363
"9231","ENSMODG00000012586","1",327985291,328079395,94104
"9232","ENSMODG00000012589","6",283475328,283562908,87580
"9233","ENSMODG00000012591","3",487530500,487682333,151833
"9234","ENSMODG00000012592","1",459990851,460012997,22146
"9235","ENSMODG00000012593","6",283575867,283588532,12665
"9236","ENSMODG00000012594","3",487683885,487727408,43523
"9237","ENSMODG00000012595","3",464229397,464247764,18367
"9238","ENSMODG00000012597","3",488060487,488083950,23463
"9239","ENSMODG00000012598","2",199148662,199164486,15824
"9240","ENSMODG00000012599","6",283583149,283615898,32749
"9241","ENSMODG00000012600","1",460061089,460083041,21952
"9242","ENSMODG00000012601","8",7743799,7828229,84430
"9243","ENSMODG00000012602","6",283790425,283841487,51062
"9244","ENSMODG00000012603","6",135889555,135972082,82527
"9245","ENSMODG00000012605","6",283847974,283872623,24649
"9246","ENSMODG00000012607","2",199119847,199135729,15882
"9247","ENSMODG00000012608","6",136020900,136035595,14695
"9248","ENSMODG00000012613","6",283906383,284139445,233062
"9249","ENSMODG00000012614","2",199096079,199102404,6325
"9250","ENSMODG00000012616","4",411379007,411385073,6066
"9251","ENSMODG00000012618","6",136112251,136177971,65720
"9252","ENSMODG00000012620","1",460131622,460150617,18995
"9253","ENSMODG00000012622","6",284214434,284361032,146598
"9254","ENSMODG00000012623","2",199055145,199091308,36163
"9255","ENSMODG00000012624","1",327342319,327426745,84426
"9256","ENSMODG00000012627","2",199029995,199052528,22533
"9257","ENSMODG00000012628","1",460155249,460224602,69353
"9258","ENSMODG00000012629","6",284557640,284956642,399002
"9259","ENSMODG00000012630","1",327063694,327233919,170225
"9260","ENSMODG00000012631","2",199006684,199010365,3681
"9261","ENSMODG00000012632","3",488100502,488279578,179076
"9262","ENSMODG00000012633","6",136175217,136407622,232405
"9263","ENSMODG00000012634","2",198998494,199005707,7213
"9264","ENSMODG00000012635","2",97345929,97379000,33071
"9265","ENSMODG00000012636","6",285037069,285040963,3894
"9266","ENSMODG00000012637","4",223140035,223140967,932
"9267","ENSMODG00000012638","Un",51725197,51744496,19299
"9268","ENSMODG00000012639","2",198988988,198990918,1930
"9269","ENSMODG00000012640","6",136406465,136527920,121455
"9270","ENSMODG00000012642","8",7862481,7909081,46600
"9271","ENSMODG00000012643","6",285111933,285114605,2672
"9272","ENSMODG00000012645","6",136561387,136693887,132500
"9273","ENSMODG00000012646","8",7953521,7959907,6386
"9274","ENSMODG00000012649","2",198915877,198982394,66517
"9275","ENSMODG00000012650","3",525413116,525413409,293
"9276","ENSMODG00000012651","2",198873101,198893506,20405
"9277","ENSMODG00000012652","3",525423484,525424024,540
"9278","ENSMODG00000012653","1",431160258,431299231,138973
"9279","ENSMODG00000012654","1",326739015,326943233,204218
"9280","ENSMODG00000012655","3",500497690,500505766,8076
"9281","ENSMODG00000012656","1",460173714,460274049,100335
"9282","ENSMODG00000012657","6",285183547,285295821,112274
"9283","ENSMODG00000012658","1",326656425,326690407,33982
"9284","ENSMODG00000012659","Un",101030214,101031211,997
"9285","ENSMODG00000012660","6",136784488,136815825,31337
"9286","ENSMODG00000012661","2",198678424,198785240,106816
"9287","ENSMODG00000012662","6",285309856,285487335,177479
"9288","ENSMODG00000012664","6",137964813,137970278,5465
"9289","ENSMODG00000012665","2",184191912,184408127,216215
"9290","ENSMODG00000012666","1",460277763,460298659,20896
"9291","ENSMODG00000012667","6",137971015,137981084,10069
"9292","ENSMODG00000012668","6",285451588,285452373,785
"9293","ENSMODG00000012671","2",97408501,97476336,67835
"9294","ENSMODG00000012672","2",184450908,184451644,736
"9295","ENSMODG00000012674","2",184660308,184671354,11046
"9296","ENSMODG00000012675","1",431871648,431938253,66605
"9297","ENSMODG00000012676","Un",50396467,50425703,29236
"9298","ENSMODG00000012677","1",288413752,288685406,271654
"9299","ENSMODG00000012678","2",184623429,184624481,1052
"9300","ENSMODG00000012679","6",138111094,138178968,67874
"9301","ENSMODG00000012680","1",432117446,432129239,11793
"9302","ENSMODG00000012681","1",288394742,288413340,18598
"9303","ENSMODG00000012682","8",7988345,8107366,119021
"9304","ENSMODG00000012683","1",288161713,288165057,3344
"9305","ENSMODG00000012684","2",97512311,97572997,60686
"9306","ENSMODG00000012685","8",8126686,8145408,18722
"9307","ENSMODG00000012687","2",198623622,198648197,24575
"9308","ENSMODG00000012689","1",460314100,460426547,112447
"9309","ENSMODG00000012690","8",8158569,8189917,31348
"9310","ENSMODG00000012693","2",198610557,198615544,4987
"9311","ENSMODG00000012694","2",97717045,97996464,279419
"9312","ENSMODG00000012696","1",432130925,432252979,122054
"9313","ENSMODG00000012697","8",8327503,8367596,40093
"9314","ENSMODG00000012698","1",287554670,287606747,52077
"9315","ENSMODG00000012699","2",98048410,98494348,445938
"9316","ENSMODG00000012702","1",460439486,460443080,3594
"9317","ENSMODG00000012703","1",432537140,432542993,5853
"9318","ENSMODG00000012704","2",198574526,198587294,12768
"9319","ENSMODG00000012706","2",285662108,285701239,39131
"9320","ENSMODG00000012709","1",433112700,433119132,6432
"9321","ENSMODG00000012711","2",184768816,184793001,24185
"9322","ENSMODG00000012713","1",138255306,138843854,588548
"9323","ENSMODG00000012714","1",286959170,287060777,101607
"9324","ENSMODG00000012716","1",138093585,138103746,10161
"9325","ENSMODG00000012717","8",8394650,8595485,200835
"9326","ENSMODG00000012720","1",325895369,325921209,25840
"9327","ENSMODG00000012722","8",8757280,8758335,1055
"9328","ENSMODG00000012723","2",198502094,198512873,10779
"9329","ENSMODG00000012725","1",137882303,138078001,195698
"9330","ENSMODG00000012727","2",184797796,184829023,31227
"9331","ENSMODG00000012729","1",137471071,137662220,191149
"9332","ENSMODG00000012730","2",184830452,184850853,20401
"9333","ENSMODG00000012734","1",137548961,137549928,967
"9334","ENSMODG00000012735","1",325636319,325685871,49552
"9335","ENSMODG00000012737","2",198406494,198493201,86707
"9336","ENSMODG00000012739","4",223177365,223200628,23263
"9337","ENSMODG00000012740","Un",67050282,67059682,9400
"9338","ENSMODG00000012741","1",137375040,137458904,83864
"9339","ENSMODG00000012742","8",8633503,8829865,196362
"9340","ENSMODG00000012744","1",460583982,460595019,11037
"9341","ENSMODG00000012745","Un",67060640,67062361,1721
"9342","ENSMODG00000012746","2",98632574,98657222,24648
"9343","ENSMODG00000012747","1",325600334,325601239,905
"9344","ENSMODG00000012748","1",460603625,460613849,10224
"9345","ENSMODG00000012749","1",434786253,434826120,39867
"9346","ENSMODG00000012750","1",286373983,286545794,171811
"9347","ENSMODG00000012752","1",137330096,137369244,39148
"9348","ENSMODG00000012753","6",138620036,138675366,55330
"9349","ENSMODG00000012754","1",460617519,460620171,2652
"9350","ENSMODG00000012756","2",198363301,198399029,35728
"9351","ENSMODG00000012757","Un",66683026,66686593,3567
"9352","ENSMODG00000012758","2",285334700,285350477,15777
"9353","ENSMODG00000012759","1",460621050,460626165,5115
"9354","ENSMODG00000012760","1",434897092,434911654,14562
"9355","ENSMODG00000012761","1",136784077,137155508,371431
"9356","ENSMODG00000012763","8",8876033,8943457,67424
"9357","ENSMODG00000012764","5",303460386,303469965,9579
"9358","ENSMODG00000012765","2",285253264,285255334,2070
"9359","ENSMODG00000012766","1",460626335,460668744,42409
"9360","ENSMODG00000012767","3",526340408,526353558,13150
"9361","ENSMODG00000012769","6",138700874,138777469,76595
"9362","ENSMODG00000012771","1",136674142,136770863,96721
"9363","ENSMODG00000012772","2",198289658,198346871,57213
"9364","ENSMODG00000012773","1",460637330,460654230,16900
"9365","ENSMODG00000012776","4",359836781,359856791,20010
"9366","ENSMODG00000012777","2",198219122,198225177,6055
"9367","ENSMODG00000012779","1",286018059,286333178,315119
"9368","ENSMODG00000012781","1",460657291,460659211,1920
"9369","ENSMODG00000012782","8",8955280,9056576,101296
"9370","ENSMODG00000012783","4",359889618,359892371,2753
"9371","ENSMODG00000012784","1",434911796,434947513,35717
"9372","ENSMODG00000012785","2",285196234,285221569,25335
"9373","ENSMODG00000012786","6",138986058,139313487,327429
"9374","ENSMODG00000012788","2",198177850,198191155,13305
"9375","ENSMODG00000012789","2",98914674,99133062,218388
"9376","ENSMODG00000012791","1",286014493,286016211,1718
"9377","ENSMODG00000012792","1",285844343,285844662,319
"9378","ENSMODG00000012794","2",99366726,99400057,33331
"9379","ENSMODG00000012795","1",434948148,434961776,13628
"9380","ENSMODG00000012796","1",135979830,135997267,17437
"9381","ENSMODG00000012797","2",285077762,285085364,7602
"9382","ENSMODG00000012799","6",139412038,139412696,658
"9383","ENSMODG00000012800","1",460656078,460710504,54426
"9384","ENSMODG00000012801","1",285747509,285754838,7329
"9385","ENSMODG00000012802","2",198151254,198173391,22137
"9386","ENSMODG00000012806","2",198148288,198149057,769
"9387","ENSMODG00000012807","1",285682492,285713266,30774
"9388","ENSMODG00000012808","2",285056494,285076406,19912
"9389","ENSMODG00000012810","1",133942158,133942779,621
"9390","ENSMODG00000012811","2",198142076,198145634,3558
"9391","ENSMODG00000012812","1",325434646,325568433,133787
"9392","ENSMODG00000012813","1",434965046,435016664,51618
"9393","ENSMODG00000012814","2",99547094,99690157,143063
"9394","ENSMODG00000012815","4",360004332,360026420,22088
"9395","ENSMODG00000012816","2",285034958,285054496,19538
"9396","ENSMODG00000012817","1",460705191,460718384,13193
"9397","ENSMODG00000012819","1",133712090,133720984,8894
"9398","ENSMODG00000012820","1",435094498,435107766,13268
"9399","ENSMODG00000012821","2",101063824,101064633,809
"9400","ENSMODG00000012822","1",285563310,285650070,86760
"9401","ENSMODG00000012823","1",325413504,325435627,22123
"9402","ENSMODG00000012824","2",198119422,198142057,22635
"9403","ENSMODG00000012825","4",223413384,223414364,980
"9404","ENSMODG00000012826","1",285462627,285506082,43455
"9405","ENSMODG00000012827","2",285006158,285008112,1954
"9406","ENSMODG00000012828","4",360037811,360045402,7591
"9407","ENSMODG00000012829","1",133029350,133030966,1616
"9408","ENSMODG00000012833","2",101204668,101381858,177190
"9409","ENSMODG00000012835","1",325260602,325407967,147365
"9410","ENSMODG00000012836","2",284871721,284881789,10068
"9411","ENSMODG00000012837","1",435185321,435241719,56398
"9412","ENSMODG00000012839","2",284837033,284862009,24976
"9413","ENSMODG00000012840","2",101647857,101650664,2807
"9414","ENSMODG00000012842","4",360072146,360091182,19036
"9415","ENSMODG00000012844","4",223514385,223515512,1127
"9416","ENSMODG00000012845","1",435264200,435284271,20071
"9417","ENSMODG00000012846","2",284820635,284833462,12827
"9418","ENSMODG00000012850","8",9252100,9387658,135558
"9419","ENSMODG00000012852","4",360113035,360121186,8151
"9420","ENSMODG00000012853","2",101817786,101892958,75172
"9421","ENSMODG00000012855","1",131099305,131360133,260828
"9422","ENSMODG00000012856","2",284767907,284777134,9227
"9423","ENSMODG00000012857","3",525791755,525792812,1057
"9424","ENSMODG00000012858","2",198066662,198106350,39688
"9425","ENSMODG00000012859","4",223680807,223682103,1296
"9426","ENSMODG00000012861","3",525807155,525807654,499
"9427","ENSMODG00000012862","4",223758206,223759156,950
"9428","ENSMODG00000012864","1",435461815,435498877,37062
"9429","ENSMODG00000012865","2",198065767,198082194,16427
"9430","ENSMODG00000012867","3",525827700,525828382,682
"9431","ENSMODG00000012869","3",525844338,525844838,500
"9432","ENSMODG00000012871","3",525851615,525852175,560
"9433","ENSMODG00000012872","4",360126941,360130796,3855
"9434","ENSMODG00000012873","2",101920970,101941920,20950
"9435","ENSMODG00000012875","2",198026917,198061749,34832
"9436","ENSMODG00000012879","4",360131992,360137050,5058
"9437","ENSMODG00000012880","8",9458630,9559990,101360
"9438","ENSMODG00000012881","2",198022251,198026430,4179
"9439","ENSMODG00000012882","1",129911582,129961186,49604
"9440","ENSMODG00000012883","1",435522741,435807504,284763
"9441","ENSMODG00000012884","3",525862297,525883973,21676
"9442","ENSMODG00000012885","8",9577229,9577872,643
"9443","ENSMODG00000012886","1",435655692,435656469,777
"9444","ENSMODG00000012887","1",325154881,325229159,74278
"9445","ENSMODG00000012889","2",102042809,102189673,146864
"9446","ENSMODG00000012891","4",360146175,360162375,16200
"9447","ENSMODG00000012892","4",223904162,223905701,1539
"9448","ENSMODG00000012893","2",102209172,102210252,1080
"9449","ENSMODG00000012897","1",325001385,325002633,1248
"9450","ENSMODG00000012900","1",435811642,436065743,254101
"9451","ENSMODG00000012901","2",197920112,198011356,91244
"9452","ENSMODG00000012902","6",139587409,139913591,326182
"9453","ENSMODG00000012903","6",203351268,203386605,35337
"9454","ENSMODG00000012904","1",324678003,324769095,91092
"9455","ENSMODG00000012905","1",285522927,285561385,38458
"9456","ENSMODG00000012909","2",197902174,197915616,13442
"9457","ENSMODG00000012910","2",284679064,284700000,20936
"9458","ENSMODG00000012912","2",197850153,197858415,8262
"9459","ENSMODG00000012913","1",323779986,323780948,962
"9460","ENSMODG00000012914","1",436577238,436645945,68707
"9461","ENSMODG00000012915","2",197834790,197846377,11587
"9462","ENSMODG00000012916","2",284584272,284642665,58393
"9463","ENSMODG00000012917","8",9595198,9598566,3368
"9464","ENSMODG00000012920","2",197778678,197794703,16025
"9465","ENSMODG00000012921","8",9610660,9622751,12091
"9466","ENSMODG00000012923","2",284447007,284476997,29990
"9467","ENSMODG00000012925","1",285411587,285452376,40789
"9468","ENSMODG00000012926","4",360258597,360285625,27028
"9469","ENSMODG00000012927","4",224088796,224107458,18662
"9470","ENSMODG00000012929","1",285319123,285374009,54886
"9471","ENSMODG00000012930","8",9626461,9633153,6692
"9472","ENSMODG00000012931","6",203212064,203346003,133939
"9473","ENSMODG00000012932","6",139916951,140228771,311820
"9474","ENSMODG00000012934","2",284304789,284550064,245275
"9475","ENSMODG00000012935","4",224252400,224270513,18113
"9476","ENSMODG00000012936","Un",73688941,73695958,7017
"9477","ENSMODG00000012937","8",9651417,9753487,102070
"9478","ENSMODG00000012942","2",283881188,283887939,6751
"9479","ENSMODG00000012943","6",140277172,140704351,427179
"9480","ENSMODG00000012944","6",203173160,203201972,28812
"9481","ENSMODG00000012946","1",285047551,285207852,160301
"9482","ENSMODG00000012947","4",224286418,224532475,246057
"9483","ENSMODG00000012949","1",285017075,285017807,732
"9484","ENSMODG00000012950","4",225003763,225019319,15556
"9485","ENSMODG00000012951","1",284307049,284311999,4950
"9486","ENSMODG00000012952","6",140947506,140985120,37614
"9487","ENSMODG00000012954","6",203156050,203173136,17086
"9488","ENSMODG00000012957","1",436758471,436895586,137115
"9489","ENSMODG00000012958","4",225031985,225036330,4345
"9490","ENSMODG00000012960","6",141008443,141074014,65571
"9491","ENSMODG00000012963","1",436898447,436909606,11159
"9492","ENSMODG00000012964","1",320412342,320553022,140680
"9493","ENSMODG00000012965","6",202898760,203131253,232493
"9494","ENSMODG00000012966","4",225165134,225332082,166948
"9495","ENSMODG00000012967","1",460733865,460781182,47317
"9496","ENSMODG00000012968","6",202727840,202814902,87062
"9497","ENSMODG00000012970","1",437158885,437223978,65093
"9498","ENSMODG00000012973","6",202602390,202620233,17843
"9499","ENSMODG00000012975","1",320032517,320119501,86984
"9500","ENSMODG00000012977","1",460783975,460803419,19444
"9501","ENSMODG00000012978","6",202589355,202599253,9898
"9502","ENSMODG00000012979","2",197597196,197604368,7172
"9503","ENSMODG00000012981","6",202516021,202574208,58187
"9504","ENSMODG00000012983","1",438088562,438090666,2104
"9505","ENSMODG00000012984","6",202503194,202505957,2763
"9506","ENSMODG00000012985","1",460808733,460821202,12469
"9507","ENSMODG00000012987","1",460893900,460913753,19853
"9508","ENSMODG00000012988","1",438382923,438822415,439492
"9509","ENSMODG00000012989","2",197581861,197591371,9510
"9510","ENSMODG00000012990","4",225344524,225378330,33806
"9511","ENSMODG00000012994","2",197551406,197554084,2678
"9512","ENSMODG00000012996","1",460935662,460990230,54568
"9513","ENSMODG00000012998","1",460992676,461055509,62833
"9514","ENSMODG00000012999","4",225395754,225576412,180658
"9515","ENSMODG00000013001","6",202405825,202480307,74482
"9516","ENSMODG00000013005","6",202396424,202399668,3244
"9517","ENSMODG00000013007","2",283574492,283584760,10268
"9518","ENSMODG00000013008","4",360172227,360328076,155849
"9519","ENSMODG00000013009","1",25401388,25403160,1772
"9520","ENSMODG00000013010","6",202317109,202373861,56752
"9521","ENSMODG00000013011","2",197497862,197526202,28340
"9522","ENSMODG00000013013","1",461120527,461175255,54728
"9523","ENSMODG00000013014","6",202288276,202304037,15761
"9524","ENSMODG00000013015","4",360449181,360449606,425
"9525","ENSMODG00000013016","1",283704473,283887893,183420
"9526","ENSMODG00000013018","2",197461766,197474011,12245
"9527","ENSMODG00000013019","1",439069450,439115447,45997
"9528","ENSMODG00000013020","4",360453296,360467291,13995
"9529","ENSMODG00000013022","6",202279894,202287545,7651
"9530","ENSMODG00000013023","4",360536312,360537653,1341
"9531","ENSMODG00000013024","4",226932556,227157771,225215
"9532","ENSMODG00000013026","1",439163442,439217263,53821
"9533","ENSMODG00000013027","6",202258636,202262785,4149
"9534","ENSMODG00000013028","4",227383417,227407460,24043
"9535","ENSMODG00000013029","Un",14720519,14793232,72713
"9536","ENSMODG00000013030","1",283523428,283653023,129595
"9537","ENSMODG00000013032","2",197454641,197461969,7328
"9538","ENSMODG00000013033","1",461188049,461334407,146358
"9539","ENSMODG00000013034","1",712756616,713325425,568809
"9540","ENSMODG00000013035","8",9845665,9849996,4331
"9541","ENSMODG00000013036","8",9886876,9920968,34092
"9542","ENSMODG00000013037","4",227525864,227615308,89444
"9543","ENSMODG00000013038","1",461353065,461520655,167590
"9544","ENSMODG00000013039","2",197424208,197435664,11456
"9545","ENSMODG00000013040","1",714428089,714434928,6839
"9546","ENSMODG00000013041","4",227631016,227662018,31002
"9547","ENSMODG00000013042","8",9928133,9946183,18050
"9548","ENSMODG00000013043","4",360539727,360628747,89020
"9549","ENSMODG00000013044","2",197406338,197420425,14087
"9550","ENSMODG00000013046","1",713208895,713209468,573
"9551","ENSMODG00000013047","1",439275187,439346699,71512
"9552","ENSMODG00000013048","1",713195897,713202501,6604
"9553","ENSMODG00000013049","4",360641183,360668234,27051
"9554","ENSMODG00000013050","1",713262892,713263462,570
"9555","ENSMODG00000013052","8",9946103,9980615,34512
"9556","ENSMODG00000013053","4",360676618,360693446,16828
"9557","ENSMODG00000013054","8",9986362,9995542,9180
"9558","ENSMODG00000013055","1",714238689,714618508,379819
"9559","ENSMODG00000013056","1",319962172,319996190,34018
"9560","ENSMODG00000013057","1",439350127,439395035,44908
"9561","ENSMODG00000013058","1",713026935,713027519,584
"9562","ENSMODG00000013059","1",712999060,712999671,611
"9563","ENSMODG00000013060","1",282623234,283423014,799780
"9564","ENSMODG00000013061","1",712971652,712972225,573
"9565","ENSMODG00000013062","1",712900821,712901435,614
"9566","ENSMODG00000013064","4",360896393,360951727,55334
"9567","ENSMODG00000013065","1",713069301,713070724,1423
"9568","ENSMODG00000013066","1",319716852,319718163,1311
"9569","ENSMODG00000013068","1",439648103,439772756,124653
"9570","ENSMODG00000013069","1",319529104,319627281,98177
"9571","ENSMODG00000013070","1",712831781,712832388,607
"9572","ENSMODG00000013071","1",439844143,439857758,13615
"9573","ENSMODG00000013072","1",713115854,713116401,547
"9574","ENSMODG00000013073","8",10057619,10151029,93410
"9575","ENSMODG00000013075","1",282741690,282742665,975
"9576","ENSMODG00000013076","4",360958740,361039731,80991
"9577","ENSMODG00000013077","1",712803629,712804236,607
"9578","ENSMODG00000013078","1",712756308,712756948,640
"9579","ENSMODG00000013079","4",227717903,228394982,677079
"9580","ENSMODG00000013081","1",712733801,712734327,526
"9581","ENSMODG00000013083","8",10196043,10203454,7411
"9582","ENSMODG00000013084","2",283472100,283497124,25024
"9583","ENSMODG00000013085","1",282355255,282463455,108200
"9584","ENSMODG00000013086","4",361049614,361118271,68657
"9585","ENSMODG00000013087","1",439867138,439917190,50052
"9586","ENSMODG00000013088","2",283458317,283466547,8230
"9587","ENSMODG00000013089","4",361127555,361159598,32043
"9588","ENSMODG00000013090","2",283438495,283455176,16681
"9589","ENSMODG00000013091","4",361244930,361251579,6649
"9590","ENSMODG00000013093","2",283424316,283427564,3248
"9591","ENSMODG00000013094","2",197386066,197403712,17646
"9592","ENSMODG00000013095","1",319114299,319280368,166069
"9593","ENSMODG00000013097","8",10241785,10262213,20428
"9594","ENSMODG00000013098","2",283378280,283421840,43560
"9595","ENSMODG00000013099","1",281990168,282094071,103903
"9596","ENSMODG00000013100","4",382052499,382074718,22219
"9597","ENSMODG00000013102","2",281926501,282069458,142957
"9598","ENSMODG00000013103","2",197292633,197378126,85493
"9599","ENSMODG00000013104","1",318811098,318945213,134115
"9600","ENSMODG00000013105","1",281887676,281989198,101522
"9601","ENSMODG00000013107","2",281217984,281251943,33959
"9602","ENSMODG00000013108","2",197274947,197285889,10942
"9603","ENSMODG00000013110","1",318698534,318817982,119448
"9604","ENSMODG00000013111","1",439929830,439993681,63851
"9605","ENSMODG00000013112","2",197211273,197241062,29789
"9606","ENSMODG00000013113","4",382151715,382223751,72036
"9607","ENSMODG00000013114","1",440460453,440476239,15786
"9608","ENSMODG00000013116","2",197205105,197206004,899
"9609","ENSMODG00000013117","4",382274288,382281823,7535
"9610","ENSMODG00000013118","1",442265257,442386833,121576
"9611","ENSMODG00000013121","1",461921788,461969774,47986
"9612","ENSMODG00000013122","1",443157292,443248755,91463
"9613","ENSMODG00000013124","1",318625138,318658458,33320
"9614","ENSMODG00000013125","2",281060084,281213022,152938
"9615","ENSMODG00000013126","4",382284085,382289268,5183
"9616","ENSMODG00000013127","2",281136844,281137821,977
"9617","ENSMODG00000013128","1",281631030,281814435,183405
"9618","ENSMODG00000013129","2",280387679,280949763,562084
"9619","ENSMODG00000013130","4",382330155,382334800,4645
"9620","ENSMODG00000013131","1",462023923,462048637,24714
"9621","ENSMODG00000013132","1",318575526,318605884,30358
"9622","ENSMODG00000013134","4",228530028,228757564,227536
"9623","ENSMODG00000013135","2",280373832,280382258,8426
"9624","ENSMODG00000013136","1",462522648,462696182,173534
"9625","ENSMODG00000013137","4",382386534,382432990,46456
"9626","ENSMODG00000013138","4",228766483,228768440,1957
"9627","ENSMODG00000013139","1",318470218,318483883,13665
"9628","ENSMODG00000013141","4",228782499,228803435,20936
"9629","ENSMODG00000013142","1",443268155,443357040,88885
"9630","ENSMODG00000013144","4",382468352,382497747,29395
"9631","ENSMODG00000013145","4",228892251,228922436,30185
"9632","ENSMODG00000013146","1",318391981,318429667,37686
"9633","ENSMODG00000013148","1",318122060,318376478,254418
"9634","ENSMODG00000013150","1",281432714,281603107,170393
"9635","ENSMODG00000013151","4",382536799,382545117,8318
"9636","ENSMODG00000013152","2",197121583,197147189,25606
"9637","ENSMODG00000013154","1",318003215,318105638,102423
"9638","ENSMODG00000013155","Un",68445656,68447143,1487
"9639","ENSMODG00000013156","X",29465795,29467702,1907
"9640","ENSMODG00000013158","1",129767059,129898662,131603
"9641","ENSMODG00000013159","X",30374740,30377328,2588
"9642","ENSMODG00000013160","1",281098320,281333499,235179
"9643","ENSMODG00000013161","2",197077801,197094269,16468
"9644","ENSMODG00000013164","4",382854601,382859122,4521
"9645","ENSMODG00000013167","1",443380254,443420667,40413
"9646","ENSMODG00000013168","2",280146866,280218507,71641
"9647","ENSMODG00000013169","1",317463760,317499168,35408
"9648","ENSMODG00000013170","2",279976491,279976769,278
"9649","ENSMODG00000013171","4",229062812,229115954,53142
"9650","ENSMODG00000013173","1",129529052,129560719,31667
"9651","ENSMODG00000013175","4",382562244,382569258,7014
"9652","ENSMODG00000013177","2",196986922,197009289,22367
"9653","ENSMODG00000013178","2",279880769,279954030,73261
"9654","ENSMODG00000013180","1",443592540,443724175,131635
"9655","ENSMODG00000013181","2",196867069,196884227,17158
"9656","ENSMODG00000013182","1",129346843,129441556,94713
"9657","ENSMODG00000013185","1",129236916,129237294,378
"9658","ENSMODG00000013186","4",229892145,229988394,96249
"9659","ENSMODG00000013187","X",30863583,31014574,150991
"9660","ENSMODG00000013188","4",230374336,230375947,1611
"9661","ENSMODG00000013190","4",382565782,382572198,6416
"9662","ENSMODG00000013191","2",196766168,196787667,21499
"9663","ENSMODG00000013192","1",444346341,444350756,4415
"9664","ENSMODG00000013193","1",128746966,129090668,343702
"9665","ENSMODG00000013194","2",196737376,196759169,21793
"9666","ENSMODG00000013196","1",280906365,280975158,68793
"9667","ENSMODG00000013199","X",31032868,31090441,57573
"9668","ENSMODG00000013202","1",445194003,445255350,61347
"9669","ENSMODG00000013204","X",31134688,31148738,14050
"9670","ENSMODG00000013205","8",274636898,274794702,157804
"9671","ENSMODG00000013206","1",463269338,463575134,305796
"9672","ENSMODG00000013207","1",280634102,280759110,125008
"9673","ENSMODG00000013209","8",274844806,274892484,47678
"9674","ENSMODG00000013210","1",445668294,445675595,7301
"9675","ENSMODG00000013211","1",280564847,280601009,36162
"9676","ENSMODG00000013212","1",463612840,463625944,13104
"9677","ENSMODG00000013213","4",230471640,230493056,21416
"9678","ENSMODG00000013214","1",445888165,445922153,33988
"9679","ENSMODG00000013215","4",230543141,230544676,1535
"9680","ENSMODG00000013216","X",31194467,31246603,52136
"9681","ENSMODG00000013217","4",230549126,230550102,976
"9682","ENSMODG00000013218","2",279363133,279846606,483473
"9683","ENSMODG00000013219","1",445922780,445993884,71104
"9684","ENSMODG00000013220","1",463890933,463949482,58549
"9685","ENSMODG00000013221","X",31255279,31272822,17543
"9686","ENSMODG00000013225","1",280406900,280565520,158620
"9687","ENSMODG00000013226","2",279352489,279358793,6304
"9688","ENSMODG00000013227","1",446088899,446147761,58862
"9689","ENSMODG00000013228","X",31280968,31321325,40357
"9690","ENSMODG00000013229","4",230606970,230626576,19606
"9691","ENSMODG00000013232","4",230626157,230718432,92275
"9692","ENSMODG00000013236","4",230756410,230759754,3344
"9693","ENSMODG00000013237","2",278934638,278953257,18619
"9694","ENSMODG00000013238","X",31347614,31372421,24807
"9695","ENSMODG00000013242","Un",56412985,56447064,34079
"9696","ENSMODG00000013243","4",230761152,230765134,3982
"9697","ENSMODG00000013247","Un",57659693,57663542,3849
"9698","ENSMODG00000013248","2",524276893,524303762,26869
"9699","ENSMODG00000013249","4",230767866,230787791,19925
"9700","ENSMODG00000013250","X",31464099,31506945,42846
"9701","ENSMODG00000013252","2",524325425,524351631,26206
"9702","ENSMODG00000013253","2",524397181,524414180,16999
"9703","ENSMODG00000013255","X",31516767,31571549,54782
"9704","ENSMODG00000013259","1",315357134,315574535,217401
"9705","ENSMODG00000013260","Un",57414916,57415494,578
"9706","ENSMODG00000013262","Un",58186934,58192762,5828
"9707","ENSMODG00000013263","4",230792934,230811060,18126
"9708","ENSMODG00000013264","Un",56669405,56690415,21010
"9709","ENSMODG00000013265","X",31601746,31812720,210974
"9710","ENSMODG00000013266","Un",57285968,57291870,5902
"9711","ENSMODG00000013267","4",230827352,230833481,6129
"9712","ENSMODG00000013269","X",31659376,31673180,13804
"9713","ENSMODG00000013272","6",470984,633670,162686
"9714","ENSMODG00000013273","2",524495410,524552596,57186
"9715","ENSMODG00000013274","6",286064785,286080639,15854
"9716","ENSMODG00000013275","2",196685290,196693077,7787
"9717","ENSMODG00000013278","6",501587,508054,6467
"9718","ENSMODG00000013280","4",230843121,230852371,9250
"9719","ENSMODG00000013281","6",537219,656703,119484
"9720","ENSMODG00000013282","4",382577711,382670496,92785
"9721","ENSMODG00000013284","6",286239532,286654646,415114
"9722","ENSMODG00000013285","4",230863114,230869535,6421
"9723","ENSMODG00000013286","6",286784024,286801097,17073
"9724","ENSMODG00000013288","6",202156565,202180282,23717
"9725","ENSMODG00000013289","4",412448563,412455323,6760
"9726","ENSMODG00000013290","1",315217798,315300194,82396
"9727","ENSMODG00000013291","2",525038027,525039283,1256
"9728","ENSMODG00000013292","4",230873060,230880569,7509
"9729","ENSMODG00000013294","1",315189757,315199103,9346
"9730","ENSMODG00000013295","2",525058282,525065691,7409
"9731","ENSMODG00000013296","6",201936635,201950040,13405
"9732","ENSMODG00000013297","6",286860629,287026276,165647
"9733","ENSMODG00000013298","2",525071157,525085513,14356
"9734","ENSMODG00000013299","6",287197601,287198614,1013
"9735","ENSMODG00000013300","4",230883499,230900413,16914
"9736","ENSMODG00000013302","1",315127514,315132769,5255
"9737","ENSMODG00000013303","6",287372307,287735078,362771
"9738","ENSMODG00000013304","1",712423844,712502816,78972
"9739","ENSMODG00000013305","6",202123017,202149809,26792
"9740","ENSMODG00000013307","2",525090175,525121426,31251
"9741","ENSMODG00000013308","4",382669438,382689307,19869
"9742","ENSMODG00000013309","1",127898735,127964126,65391
"9743","ENSMODG00000013310","6",202113063,202114546,1483
"9744","ENSMODG00000013311","4",412603539,412643046,39507
"9745","ENSMODG00000013312","1",314815112,314902182,87070
"9746","ENSMODG00000013313","2",525208957,525236981,28024
"9747","ENSMODG00000013314","4",382697346,382698931,1585
"9748","ENSMODG00000013315","6",287778865,287884625,105760
"9749","ENSMODG00000013316","6",728938,850281,121343
"9750","ENSMODG00000013317","2",278245852,278832228,586376
"9751","ENSMODG00000013318","4",230916736,230950685,33949
"9752","ENSMODG00000013319","1",314694038,314797126,103088
"9753","ENSMODG00000013320","1",314581232,314630931,49699
"9754","ENSMODG00000013321","6",202087636,202102735,15099
"9755","ENSMODG00000013322","2",277902682,278260647,357965
"9756","ENSMODG00000013323","1",314550553,314571502,20949
"9757","ENSMODG00000013324","1",446221932,446267423,45491
"9758","ENSMODG00000013325","4",412807877,412811923,4046
"9759","ENSMODG00000013326","6",287966555,288032774,66219
"9760","ENSMODG00000013328","4",230974759,230980310,5551
"9761","ENSMODG00000013329","6",881712,975842,94130
"9762","ENSMODG00000013330","4",230982033,230984383,2350
"9763","ENSMODG00000013332","1",314515851,314549786,33935
"9764","ENSMODG00000013333","6",202018522,202086417,67895
"9765","ENSMODG00000013334","4",230985173,230989852,4679
"9766","ENSMODG00000013335","1",314395863,314396768,905
"9767","ENSMODG00000013336","4",412688856,412694707,5851
"9768","ENSMODG00000013337","2",277606356,277637874,31518
"9769","ENSMODG00000013338","1",446229653,446230095,442
"9770","ENSMODG00000013339","4",412750756,412758083,7327
"9771","ENSMODG00000013340","1",446431058,446469777,38719
"9772","ENSMODG00000013342","4",230990127,230998911,8784
"9773","ENSMODG00000013343","6",1357175,1358816,1641
"9774","ENSMODG00000013344","4",412758615,412761659,3044
"9775","ENSMODG00000013345","1",446275736,446276523,787
"9776","ENSMODG00000013346","2",277284984,277311114,26130
"9777","ENSMODG00000013348","6",1544448,1617828,73380
"9778","ENSMODG00000013350","1",314007699,314145310,137611
"9779","ENSMODG00000013351","4",231043640,231061653,18013
"9780","ENSMODG00000013352","6",1647250,1649309,2059
"9781","ENSMODG00000013353","6",288041120,288069724,28604
"9782","ENSMODG00000013354","6",202009511,202015342,5831
"9783","ENSMODG00000013355","4",231072597,231074835,2238
"9784","ENSMODG00000013356","6",288069879,288071588,1709
"9785","ENSMODG00000013357","1",313588490,313651828,63338
"9786","ENSMODG00000013358","6",288086325,288101774,15449
"9787","ENSMODG00000013359","1",446984776,447251248,266472
"9788","ENSMODG00000013360","1",127236524,127651505,414981
"9789","ENSMODG00000013361","1",313462969,313543034,80065
"9790","ENSMODG00000013362","6",201955426,201964989,9563
"9791","ENSMODG00000013363","4",231131080,231141228,10148
"9792","ENSMODG00000013364","1",447256876,447321095,64219
"9793","ENSMODG00000013365","6",1654196,1706949,52753
"9794","ENSMODG00000013366","6",201902804,201933819,31015
"9795","ENSMODG00000013367","4",231145878,231164907,19029
"9796","ENSMODG00000013369","6",1712813,1717923,5110
"9797","ENSMODG00000013370","4",382712071,382793752,81681
"9798","ENSMODG00000013371","1",447328861,447343464,14603
"9799","ENSMODG00000013374","6",201857738,201897759,40021
"9800","ENSMODG00000013375","4",231288304,231327987,39683
"9801","ENSMODG00000013378","1",447343691,447363668,19977
"9802","ENSMODG00000013379","6",1793850,1942522,148672
"9803","ENSMODG00000013380","4",412790335,412795787,5452
"9804","ENSMODG00000013382","6",1965322,1966464,1142
"9805","ENSMODG00000013383","6",201729215,201777195,47980
"9806","ENSMODG00000013384","6",288151353,288305014,153661
"9807","ENSMODG00000013385","4",231348398,231361886,13488
"9808","ENSMODG00000013386","6",2293277,2314844,21567
"9809","ENSMODG00000013388","4",382792962,382801954,8992
"9810","ENSMODG00000013389","1",447371948,447409089,37141
"9811","ENSMODG00000013390","4",412796109,412803027,6918
"9812","ENSMODG00000013391","4",382839309,382842303,2994
"9813","ENSMODG00000013392","6",201564481,201713481,149000
"9814","ENSMODG00000013393","1",447460136,447461700,1564
"9815","ENSMODG00000013395","6",2364603,2416603,52000
"9816","ENSMODG00000013396","5",167837236,167837388,152
"9817","ENSMODG00000013399","8",18438087,18439077,990
"9818","ENSMODG00000013400","4",412804299,412807491,3192
"9819","ENSMODG00000013401","6",201482722,201494539,11817
"9820","ENSMODG00000013403","4",412814677,412819698,5021
"9821","ENSMODG00000013404","6",288328244,288425466,97222
"9822","ENSMODG00000013405","4",382847031,382854150,7119
"9823","ENSMODG00000013406","2",525412068,525421791,9723
"9824","ENSMODG00000013407","1",313271546,313459845,188299
"9825","ENSMODG00000013408","1",447694613,447803515,108902
"9826","ENSMODG00000013409","2",525438407,525449520,11113
"9827","ENSMODG00000013410","6",201403285,201431061,27776
"9828","ENSMODG00000013411","6",2826172,2920694,94522
"9829","ENSMODG00000013414","6",288504312,288623510,119198
"9830","ENSMODG00000013415","6",3142732,3291886,149154
"9831","ENSMODG00000013416","4",231361267,231423919,62652
"9832","ENSMODG00000013417","1",313075722,313158920,83198
"9833","ENSMODG00000013418","4",382860122,382874981,14859
"9834","ENSMODG00000013419","2",525801780,525809209,7429
"9835","ENSMODG00000013423","4",382877871,382886545,8674
"9836","ENSMODG00000013424","1",312866900,312872636,5736
"9837","ENSMODG00000013425","6",3373257,3426857,53600
"9838","ENSMODG00000013426","2",525850338,525892563,42225
"9839","ENSMODG00000013427","6",3412141,3622948,210807
"9840","ENSMODG00000013428","4",412813230,412823438,10208
"9841","ENSMODG00000013429","4",382897109,382900300,3191
"9842","ENSMODG00000013430","1",312973116,313005465,32349
"9843","ENSMODG00000013431","4",382915220,382919838,4618
"9844","ENSMODG00000013432","4",231429839,231469080,39241
"9845","ENSMODG00000013433","2",525955620,525998491,42871
"9846","ENSMODG00000013434","4",412972200,412974793,2593
"9847","ENSMODG00000013436","6",3670259,3739194,68935
"9848","ENSMODG00000013437","6",288725068,288775251,50183
"9849","ENSMODG00000013438","4",382924555,382925810,1255
"9850","ENSMODG00000013439","4",231470550,231500075,29525
"9851","ENSMODG00000013440","4",412855081,412861734,6653
"9852","ENSMODG00000013441","2",196566130,196613986,47856
"9853","ENSMODG00000013442","4",382932004,382935964,3960
"9854","ENSMODG00000013443","6",288778634,288797752,19118
"9855","ENSMODG00000013445","1",447818946,447885315,66369
"9856","ENSMODG00000013446","2",526010584,526120275,109691
"9857","ENSMODG00000013447","2",276877139,277274469,397330
"9858","ENSMODG00000013448","4",231499943,231506865,6922
"9859","ENSMODG00000013449","2",196581512,196594235,12723
"9860","ENSMODG00000013450","4",231508858,231523491,14633
"9861","ENSMODG00000013451","2",276909000,276909516,516
"9862","ENSMODG00000013453","4",382962446,382968537,6091
"9863","ENSMODG00000013454","2",276844700,276850714,6014
"9864","ENSMODG00000013455","2",196541571,196555001,13430
"9865","ENSMODG00000013456","4",382971861,382978717,6856
"9866","ENSMODG00000013457","2",526171408,526223928,52520
"9867","ENSMODG00000013458","4",382979215,382979658,443
"9868","ENSMODG00000013459","2",526219993,526237239,17246
"9869","ENSMODG00000013460","6",4029724,4255459,225735
"9870","ENSMODG00000013461","2",276611145,276659678,48533
"9871","ENSMODG00000013462","6",201311178,201386250,75072
"9872","ENSMODG00000013463","4",383028072,383038822,10750
"9873","ENSMODG00000013464","6",4334958,4338088,3130
"9874","ENSMODG00000013465","1",447913420,447928827,15407
"9875","ENSMODG00000013466","2",276537545,276552215,14670
"9876","ENSMODG00000013467","2",526247508,526373989,126481
"9877","ENSMODG00000013468","6",288796699,288839157,42458
"9878","ENSMODG00000013469","6",201262623,201264440,1817
"9879","ENSMODG00000013470","4",383042462,383048459,5997
"9880","ENSMODG00000013472","6",201195825,201197642,1817
"9881","ENSMODG00000013473","2",526379447,526532091,152644
"9882","ENSMODG00000013474","4",231524583,231605279,80696
"9883","ENSMODG00000013475","6",201148837,201174848,26011
"9884","ENSMODG00000013476","1",447942630,447970229,27599
"9885","ENSMODG00000013477","6",201131328,201133348,2020
"9886","ENSMODG00000013478","4",383047882,383077567,29685
"9887","ENSMODG00000013479","2",276561009,276587862,26853
"9888","ENSMODG00000013482","1",448022585,448093391,70806
"9889","ENSMODG00000013483","1",175229,203284,28055
"9890","ENSMODG00000013484","6",4548158,4557549,9391
"9891","ENSMODG00000013485","1",448140218,448244151,103933
"9892","ENSMODG00000013486","4",383026187,383083508,57321
"9893","ENSMODG00000013487","6",4564532,4666820,102288
"9894","ENSMODG00000013488","6",5674039,5873990,199951
"9895","ENSMODG00000013489","1",312562100,312699790,137690
"9896","ENSMODG00000013490","4",383083967,383088809,4842
"9897","ENSMODG00000013491","4",231661455,231709182,47727
"9898","ENSMODG00000013492","1",448255354,448281018,25664
"9899","ENSMODG00000013493","1",1401265,1747343,346078
"9900","ENSMODG00000013494","4",383094371,383098044,3673
"9901","ENSMODG00000013496","2",276470368,276510022,39654
"9902","ENSMODG00000013500","4",231719143,231725665,6522
"9903","ENSMODG00000013501","2",527596914,527598965,2051
"9904","ENSMODG00000013502","2",276445750,276463440,17690
"9905","ENSMODG00000013504","1",312514829,312526512,11683
"9906","ENSMODG00000013505","1",448312699,448375223,62524
"9907","ENSMODG00000013506","4",231728025,231744740,16715
"9908","ENSMODG00000013507","1",312463078,312505548,42470
"9909","ENSMODG00000013508","2",527750051,527792647,42596
"9910","ENSMODG00000013509","1",448469440,448504693,35253
"9911","ENSMODG00000013511","1",448455412,448464658,9246
"9912","ENSMODG00000013512","2",196513534,196518891,5357
"9913","ENSMODG00000013513","1",312249572,312294935,45363
"9914","ENSMODG00000013514","4",231755656,231765523,9867
"9915","ENSMODG00000013515","1",448585857,448595940,10083
"9916","ENSMODG00000013516","1",448613526,448637477,23951
"9917","ENSMODG00000013517","2",276204900,276404232,199332
"9918","ENSMODG00000013518","1",2629065,2667563,38498
"9919","ENSMODG00000013521","1",2697901,2757867,59966
"9920","ENSMODG00000013522","1",448705503,448710640,5137
"9921","ENSMODG00000013523","1",312089134,312123996,34862
"9922","ENSMODG00000013525","2",276116637,276169810,53173
"9923","ENSMODG00000013527","2",276078465,276091399,12934
"9924","ENSMODG00000013528","1",312055499,312081164,25665
"9925","ENSMODG00000013530","1",448718583,448729040,10457
"9926","ENSMODG00000013531","1",2773180,2835672,62492
"9927","ENSMODG00000013532","4",231822466,231828222,5756
"9928","ENSMODG00000013533","4",383102645,383110295,7650
"9929","ENSMODG00000013534","4",231828794,231863235,34441
"9930","ENSMODG00000013535","1",311974650,312021841,47191
"9931","ENSMODG00000013536","6",6720298,6856391,136093
"9932","ENSMODG00000013537","Un",71764673,71770976,6303
"9933","ENSMODG00000013539","2",275954259,275959330,5071
"9934","ENSMODG00000013540","1",448741201,448747319,6118
"9935","ENSMODG00000013541","6",6916044,6965730,49686
"9936","ENSMODG00000013542","2",196492859,196499840,6981
"9937","ENSMODG00000013543","4",231913505,231926582,13077
"9938","ENSMODG00000013544","4",231938941,231969994,31053
"9939","ENSMODG00000013545","4",383114159,383117737,3578
"9940","ENSMODG00000013546","1",311810506,311973682,163176
"9941","ENSMODG00000013547","1",448749678,448757049,7371
"9942","ENSMODG00000013548","2",196466251,196520400,54149
"9943","ENSMODG00000013549","1",311842879,311843777,898
"9944","ENSMODG00000013550","2",275832620,275861779,29159
"9945","ENSMODG00000013551","1",448791030,448815712,24682
"9946","ENSMODG00000013552","6",201087897,201126653,38756
"9947","ENSMODG00000013553","2",275755551,275818712,63161
"9948","ENSMODG00000013559","6",7056417,7234986,178569
"9949","ENSMODG00000013560","4",231987926,232076164,88238
"9950","ENSMODG00000013561","2",275677964,275705648,27684
"9951","ENSMODG00000013562","2",196381752,196396502,14750
"9952","ENSMODG00000013563","6",200859007,200936975,77968
"9953","ENSMODG00000013564","4",232184782,232202749,17967
"9954","ENSMODG00000013565","6",7311980,7412401,100421
"9955","ENSMODG00000013566","6",200769312,200773614,4302
"9956","ENSMODG00000013567","4",412902938,412906366,3428
"9957","ENSMODG00000013568","3",40050776,40622988,572212
"9958","ENSMODG00000013569","4",232275163,232324779,49616
"9959","ENSMODG00000013570","4",383136389,383148578,12189
"9960","ENSMODG00000013572","3",40520640,40526217,5577
"9961","ENSMODG00000013574","6",200646850,200701231,54381
"9962","ENSMODG00000013575","3",40695437,40713924,18487
"9963","ENSMODG00000013577","2",196273877,196304516,30639
"9964","ENSMODG00000013578","3",40879861,40898974,19113
"9965","ENSMODG00000013580","6",7536039,7536636,597
"9966","ENSMODG00000013581","2",528156144,528401321,245177
"9967","ENSMODG00000013582","6",200575058,200593016,17958
"9968","ENSMODG00000013584","4",383149936,383160055,10119
"9969","ENSMODG00000013585","6",200551467,200556967,5500
"9970","ENSMODG00000013586","2",275536217,275583511,47294
"9971","ENSMODG00000013587","Un",11065637,11068851,3214
"9972","ENSMODG00000013592","6",200509630,200536157,26527
"9973","ENSMODG00000013593","2",528504586,528534817,30231
"9974","ENSMODG00000013594","8",204320975,204335838,14863
"9975","ENSMODG00000013595","4",412908128,412912491,4363
"9976","ENSMODG00000013598","4",232698758,232734961,36203
"9977","ENSMODG00000013599","6",200389438,200500019,110581
"9978","ENSMODG00000013600","2",528585413,528593614,8201
"9979","ENSMODG00000013601","8",204274566,204294039,19473
"9980","ENSMODG00000013602","1",449124576,449125239,663
"9981","ENSMODG00000013603","4",412914233,412919016,4783
"9982","ENSMODG00000013604","2",528600494,528604604,4110
"9983","ENSMODG00000013605","6",200362998,200367366,4368
"9984","ENSMODG00000013606","8",204193778,204245698,51920
"9985","ENSMODG00000013607","6",200263478,200264505,1027
"9986","ENSMODG00000013609","1",311408236,311506700,98464
"9987","ENSMODG00000013610","8",204116116,204176437,60321
"9988","ENSMODG00000013611","4",412902869,412927639,24770
"9989","ENSMODG00000013612","2",528604884,528615694,10810
"9990","ENSMODG00000013613","4",412928003,412934090,6087
"9991","ENSMODG00000013614","6",10753409,10929249,175840
"9992","ENSMODG00000013615","1",311198283,311340305,142022
"9993","ENSMODG00000013616","8",203994515,204113605,119090
"9994","ENSMODG00000013617","2",528616373,528622131,5758
"9995","ENSMODG00000013618","6",11304595,11387177,82582
"9996","ENSMODG00000013620","4",412938780,412942739,3959
"9997","ENSMODG00000013621","8",203369881,203372911,3030
"9998","ENSMODG00000013624","2",268675089,268683159,8070
"9999","ENSMODG00000013627","2",528642518,528663053,20535
"10000","ENSMODG00000013629","4",412943556,412951938,8382
"10001","ENSMODG00000013630","2",528722843,528731884,9041
"10002","ENSMODG00000013633","6",11475724,11510005,34281
"10003","ENSMODG00000013635","2",528757844,528770451,12607
"10004","ENSMODG00000013636","1",310960835,310988905,28070
"10005","ENSMODG00000013637","8",203028035,203242460,214425
"10006","ENSMODG00000013640","8",203007837,203011388,3551
"10007","ENSMODG00000013641","6",11602179,11641117,38938
"10008","ENSMODG00000013642","1",309431164,309448025,16861
"10009","ENSMODG00000013643","2",528778490,528825995,47505
"10010","ENSMODG00000013644","6",200084825,200174636,89811
"10011","ENSMODG00000013645","8",202988806,203001312,12506
"10012","ENSMODG00000013647","1",309385310,309386254,944
"10013","ENSMODG00000013648","6",11687118,11697388,10270
"10014","ENSMODG00000013649","4",412809791,412955764,145973
"10015","ENSMODG00000013650","2",528873188,528887463,14275
"10016","ENSMODG00000013652","2",275412045,275442919,30874
"10017","ENSMODG00000013653","8",202690380,202713425,23045
"10018","ENSMODG00000013654","2",528912362,528931676,19314
"10019","ENSMODG00000013655","4",233070362,233205640,135278
"10020","ENSMODG00000013656","1",449374226,449397057,22831
"10021","ENSMODG00000013657","6",11723248,11736436,13188
"10022","ENSMODG00000013658","2",528972258,528994613,22355
"10023","ENSMODG00000013660","1",309172491,309218994,46503
"10024","ENSMODG00000013661","1",449399527,449403240,3713
"10025","ENSMODG00000013663","2",529056339,529061541,5202
"10026","ENSMODG00000013664","6",11924245,11970211,45966
"10027","ENSMODG00000013665","4",383161731,383167798,6067
"10028","ENSMODG00000013667","1",309073043,309158405,85362
"10029","ENSMODG00000013668","1",449404068,449410819,6751
"10030","ENSMODG00000013669","2",275324166,275348369,24203
"10031","ENSMODG00000013670","8",202836381,202939358,102977
"10032","ENSMODG00000013671","6",199805951,199921155,115204
"10033","ENSMODG00000013672","1",309052876,309067461,14585
"10034","ENSMODG00000013674","1",309051141,309051503,362
"10035","ENSMODG00000013675","1",449435811,449439821,4010
"10036","ENSMODG00000013676","4",412985246,412993607,8361
"10037","ENSMODG00000013677","6",199827636,200018007,190371
"10038","ENSMODG00000013678","4",233239183,233333114,93931
"10039","ENSMODG00000013679","1",449440474,449446649,6175
"10040","ENSMODG00000013680","2",529228082,529243733,15651
"10041","ENSMODG00000013681","1",449446423,449467863,21440
"10042","ENSMODG00000013682","6",12017257,12039999,22742
"10043","ENSMODG00000013683","4",412994388,412996833,2445
"10044","ENSMODG00000013685","1",449478387,449478869,482
"10045","ENSMODG00000013686","8",202742303,202779726,37423
"10046","ENSMODG00000013688","1",449480655,449482806,2151
"10047","ENSMODG00000013690","2",529247738,529322521,74783
"10048","ENSMODG00000013691","6",12057003,12087867,30864
"10049","ENSMODG00000013692","4",233340073,233371562,31489
"10050","ENSMODG00000013693","1",308874238,309005934,131696
"10051","ENSMODG00000013694","4",383224243,383228509,4266
"10052","ENSMODG00000013695","6",12092479,12096590,4111
"10053","ENSMODG00000013696","8",202638434,202686190,47756
"10054","ENSMODG00000013697","1",449483195,449488401,5206
"10055","ENSMODG00000013699","4",413011685,413016942,5257
"10056","ENSMODG00000013700","8",202472297,202472868,571
"10057","ENSMODG00000013701","1",308836213,308840080,3867
"10058","ENSMODG00000013702","4",383230799,383234813,4014
"10059","ENSMODG00000013703","2",529333435,529364974,31539
"10060","ENSMODG00000013704","2",275178486,275269590,91104
"10061","ENSMODG00000013707","2",529491368,529498238,6870
"10062","ENSMODG00000013708","4",383243949,383259626,15677
"10063","ENSMODG00000013709","8",202379770,202485928,106158
"10064","ENSMODG00000013711","1",449489004,449502168,13164
"10065","ENSMODG00000013712","4",413018019,413022378,4359
"10066","ENSMODG00000013713","8",202310601,202367926,57325
"10067","ENSMODG00000013714","1",449515870,449516594,724
"10068","ENSMODG00000013715","2",275011898,275159931,148033
"10069","ENSMODG00000013717","4",383311036,383317224,6188
"10070","ENSMODG00000013718","6",12110673,12143988,33315
"10071","ENSMODG00000013719","4",413023322,413025059,1737
"10072","ENSMODG00000013720","4",233376152,233394694,18542
"10073","ENSMODG00000013721","1",449534164,449543230,9066
"10074","ENSMODG00000013723","8",202036869,202302100,265231
"10075","ENSMODG00000013724","6",199734256,199768077,33821
"10076","ENSMODG00000013725","4",383390008,383400110,10102
"10077","ENSMODG00000013726","4",413039548,413040856,1308
"10078","ENSMODG00000013727","6",12144901,12212026,67125
"10079","ENSMODG00000013728","1",449544925,449567023,22098
"10080","ENSMODG00000013729","4",383404365,383412524,8159
"10081","ENSMODG00000013730","4",413042315,413043431,1116
"10082","ENSMODG00000013731","6",12261523,12292783,31260
"10083","ENSMODG00000013732","2",529752411,529792199,39788
"10084","ENSMODG00000013733","8",201720434,201949862,229428
"10085","ENSMODG00000013734","4",383420530,383430319,9789
"10086","ENSMODG00000013735","1",712317200,712318057,857
"10087","ENSMODG00000013737","8",201569232,201607220,37988
"10088","ENSMODG00000013739","4",233395285,233428621,33336
"10089","ENSMODG00000013740","2",274837808,274924559,86751
"10090","ENSMODG00000013741","1",449604034,449610513,6479
"10091","ENSMODG00000013742","4",413042561,413050614,8053
"10092","ENSMODG00000013743","2",274814083,274830267,16184
"10093","ENSMODG00000013744","4",233430554,233436938,6384
"10094","ENSMODG00000013745","4",383434967,383438480,3513
"10095","ENSMODG00000013746","2",529800397,529820735,20338
"10096","ENSMODG00000013748","8",201490640,201551284,60644
"10097","ENSMODG00000013749","1",712257005,712264070,7065
"10098","ENSMODG00000013750","8",201461452,201464809,3357
"10099","ENSMODG00000013751","1",712225828,712226172,344
"10100","ENSMODG00000013752","2",274758561,274772786,14225
"10101","ENSMODG00000013753","2",529816709,529822644,5935
"10102","ENSMODG00000013754","2",529833943,529861801,27858
"10103","ENSMODG00000013755","8",201281934,201407973,126039
"10104","ENSMODG00000013756","2",529927065,529928795,1730
"10105","ENSMODG00000013757","2",274522265,274695706,173441
"10106","ENSMODG00000013758","2",274464957,274476489,11532
"10107","ENSMODG00000013759","8",201186397,201255113,68716
"10108","ENSMODG00000013760","4",233443555,233466017,22462
"10109","ENSMODG00000013761","2",529931504,529995601,64097
"10110","ENSMODG00000013762","2",274424849,274444088,19239
"10111","ENSMODG00000013763","4",413051205,413060023,8818
"10112","ENSMODG00000013764","6",199336681,199603090,266409
"10113","ENSMODG00000013765","2",530009871,530019635,9764
"10114","ENSMODG00000013766","2",274409619,274414037,4418
"10115","ENSMODG00000013767","4",233479903,233490258,10355
"10116","ENSMODG00000013769","8",201024074,201124809,100735
"10117","ENSMODG00000013770","1",711926564,712012576,86012
"10118","ENSMODG00000013771","2",274386133,274405022,18889
"10119","ENSMODG00000013772","4",413062644,413063246,602
"10120","ENSMODG00000013773","6",199246763,199273591,26828
"10121","ENSMODG00000013774","1",308625398,308740896,115498
"10122","ENSMODG00000013775","2",530046401,530053090,6689
"10123","ENSMODG00000013776","4",413067658,413070160,2502
"10124","ENSMODG00000013777","4",383439147,383440869,1722
"10125","ENSMODG00000013778","2",274286786,274350315,63529
"10126","ENSMODG00000013779","6",199212515,199213948,1433
"10127","ENSMODG00000013780","1",711878960,711899199,20239
"10128","ENSMODG00000013781","1",308603905,308604951,1046
"10129","ENSMODG00000013782","8",200729146,200844360,115214
"10130","ENSMODG00000013783","2",530074392,530102859,28467
"10131","ENSMODG00000013784","4",233557064,233861581,304517
"10132","ENSMODG00000013785","4",383442941,383464508,21567
"10133","ENSMODG00000013786","2",530136943,530138716,1773
"10134","ENSMODG00000013787","1",711813664,711821171,7507
"10135","ENSMODG00000013788","1",308584603,308619428,34825
"10136","ENSMODG00000013789","2",274202663,274254342,51679
"10137","ENSMODG00000013790","6",199140243,199173706,33463
"10138","ENSMODG00000013791","1",711727993,711734393,6400
"10139","ENSMODG00000013792","4",233867325,233870525,3200
"10140","ENSMODG00000013793","6",199124057,199131931,7874
"10141","ENSMODG00000013796","4",233870546,233875209,4663
"10142","ENSMODG00000013800","2",530149005,530157815,8810
"10143","ENSMODG00000013801","1",308557943,308573031,15088
"10144","ENSMODG00000013802","4",233890153,233894397,4244
"10145","ENSMODG00000013803","1",711605330,711610049,4719
"10146","ENSMODG00000013804","6",199075390,199080736,5346
"10147","ENSMODG00000013805","8",200614594,200668588,53994
"10148","ENSMODG00000013806","2",274179662,274200695,21033
"10149","ENSMODG00000013807","4",233908272,233920354,12082
"10150","ENSMODG00000013808","1",711568052,711573178,5126
"10151","ENSMODG00000013809","1",308536088,308557444,21356
"10152","ENSMODG00000013810","6",198793100,198878185,85085
"10153","ENSMODG00000013812","4",383474260,383481776,7516
"10154","ENSMODG00000013814","8",200509225,200598591,89366
"10155","ENSMODG00000013815","1",711443945,711448870,4925
"10156","ENSMODG00000013816","4",233923210,233944846,21636
"10157","ENSMODG00000013817","4",413112058,413126330,14272
"10158","ENSMODG00000013820","6",198608040,198694385,86345
"10159","ENSMODG00000013821","1",711315114,711327330,12216
"10160","ENSMODG00000013823","1",308279012,308329150,50138
"10161","ENSMODG00000013824","2",530160250,530206134,45884
"10162","ENSMODG00000013825","4",233958349,233990256,31907
"10163","ENSMODG00000013826","8",200372246,200502560,130314
"10164","ENSMODG00000013827","1",308183205,308197650,14445
"10165","ENSMODG00000013831","2",274091822,274145655,53833
"10166","ENSMODG00000013832","4",383525200,383537396,12196
"10167","ENSMODG00000013833","2",530274795,530278488,3693
"10168","ENSMODG00000013834","2",273942394,273943820,1426
"10169","ENSMODG00000013835","2",530322377,530432458,110081
"10170","ENSMODG00000013836","2",530491918,530497020,5102
"10171","ENSMODG00000013839","2",273896689,273936880,40191
"10172","ENSMODG00000013840","4",413166743,413174088,7345
"10173","ENSMODG00000013841","6",198171790,198233621,61831
"10174","ENSMODG00000013842","1",308089646,308157600,67954
"10175","ENSMODG00000013843","4",383539183,383542128,2945
"10176","ENSMODG00000013844","6",197900126,197991777,91651
"10177","ENSMODG00000013845","4",413191301,413194828,3527
"10178","ENSMODG00000013846","2",530893002,530932268,39266
"10179","ENSMODG00000013847","1",307836732,308082979,246247
"10180","ENSMODG00000013849","1",308023883,308024563,680
"10181","ENSMODG00000013850","6",197876165,197900865,24700
"10182","ENSMODG00000013851","2",530967090,530996160,29070
"10183","ENSMODG00000013852","1",308012805,308016770,3965
"10184","ENSMODG00000013854","1",449619105,449652433,33328
"10185","ENSMODG00000013855","2",273609872,273892065,282193
"10186","ENSMODG00000013856","8",199908906,199961886,52980
"10187","ENSMODG00000013858","1",711280794,711282357,1563
"10188","ENSMODG00000013859","4",383548895,383559306,10411
"10189","ENSMODG00000013861","4",361312348,361351610,39262
"10190","ENSMODG00000013862","1",711241109,711253077,11968
"10191","ENSMODG00000013865","4",236041848,236335867,294019
"10192","ENSMODG00000013866","1",449657680,449684475,26795
"10193","ENSMODG00000013867","6",197820945,197877286,56341
"10194","ENSMODG00000013869","1",449695409,449696507,1098
"10195","ENSMODG00000013871","6",197756511,197799047,42536
"10196","ENSMODG00000013872","4",383576376,383587116,10740
"10197","ENSMODG00000013873","2",273572088,273582111,10023
"10198","ENSMODG00000013874","1",307941879,307942961,1082
"10199","ENSMODG00000013875","1",449673822,449814004,140182
"10200","ENSMODG00000013876","8",199671419,199837652,166233
"10201","ENSMODG00000013877","4",383599055,383599930,875
"10202","ENSMODG00000013878","4",237047544,237055499,7955
"10203","ENSMODG00000013879","8",199705523,199707205,1682
"10204","ENSMODG00000013880","4",383609475,383610461,986
"10205","ENSMODG00000013881","4",237251753,237257217,5464
"10206","ENSMODG00000013882","1",449865285,449920632,55347
"10207","ENSMODG00000013884","1",450062349,450075378,13029
"10208","ENSMODG00000013885","2",531082888,531191535,108647
"10209","ENSMODG00000013886","1",711189797,711202468,12671
"10210","ENSMODG00000013889","1",711138794,711139817,1023
"10211","ENSMODG00000013890","8",199005780,199619348,613568
"10212","ENSMODG00000013891","4",383690869,383697990,7121
"10213","ENSMODG00000013894","4",383719715,383724527,4812
"10214","ENSMODG00000013895","2",273495218,273567232,72014
"10215","ENSMODG00000013897","1",711009261,711037402,28141
"10216","ENSMODG00000013898","X",50767716,50770250,2534
"10217","ENSMODG00000013899","8",198810710,198840886,30176
"10218","ENSMODG00000013901","X",50054825,50055652,827
"10219","ENSMODG00000013902","4",383746895,383756979,10084
"10220","ENSMODG00000013903","8",197960118,198161964,201846
"10221","ENSMODG00000013904","2",273423508,273446047,22539
"10222","ENSMODG00000013906","1",710963071,710995736,32665
"10223","ENSMODG00000013907","X",49877418,49878051,633
"10224","ENSMODG00000013908","4",383758658,383760089,1431
"10225","ENSMODG00000013909","1",307850216,307873633,23417
"10226","ENSMODG00000013910","2",273203106,273319173,116067
"10227","ENSMODG00000013911","1",710953310,710961289,7979
"10228","ENSMODG00000013912","X",49547531,49550317,2786
"10229","ENSMODG00000013913","4",237634169,237642278,8109
"10230","ENSMODG00000013914","1",450086033,450143812,57779
"10231","ENSMODG00000013916","2",273072810,273126199,53389
"10232","ENSMODG00000013917","X",48532936,48546202,13266
"10233","ENSMODG00000013918","4",237687456,237697016,9560
"10234","ENSMODG00000013921","4",237864816,237874537,9721
"10235","ENSMODG00000013922","1",710937794,710950450,12656
"10236","ENSMODG00000013925","2",273051467,273064621,13154
"10237","ENSMODG00000013926","1",450191403,450226416,35013
"10238","ENSMODG00000013928","4",383766876,383780786,13910
"10239","ENSMODG00000013929","2",272885872,272901668,15796
"10240","ENSMODG00000013930","1",307760617,307811296,50679
"10241","ENSMODG00000013932","X",46390512,46391381,869
"10242","ENSMODG00000013933","2",272803643,272869925,66282
"10243","ENSMODG00000013934","6",197700196,197716479,16283
"10244","ENSMODG00000013936","6",197658857,197664508,5651
"10245","ENSMODG00000013938","2",272732190,272733694,1504
"10246","ENSMODG00000013939","4",361489443,361533751,44308
"10247","ENSMODG00000013940","2",272723665,272730149,6484
"10248","ENSMODG00000013941","4",361436422,361727892,291470
"10249","ENSMODG00000013942","1",450245258,450314890,69632
"10250","ENSMODG00000013943","6",197538004,197560027,22023
"10251","ENSMODG00000013944","5",224597784,224908408,310624
"10252","ENSMODG00000013946","1",450344998,450382836,37838
"10253","ENSMODG00000013947","1",307544769,307647662,102893
"10254","ENSMODG00000013948","1",450600313,450601023,710
"10255","ENSMODG00000013951","4",362091340,362105744,14404
"10256","ENSMODG00000013952","8",197577760,197583237,5477
"10257","ENSMODG00000013953","1",450734283,450747801,13518
"10258","ENSMODG00000013955","4",362108601,362114796,6195
"10259","ENSMODG00000013956","1",307529666,307531352,1686
"10260","ENSMODG00000013957","4",383842449,383849393,6944
"10261","ENSMODG00000013961","4",362120756,362146226,25470
"10262","ENSMODG00000013962","4",383866202,383867357,1155
"10263","ENSMODG00000013963","1",307229014,307241419,12405
"10264","ENSMODG00000013964","6",197323179,197403141,79962
"10265","ENSMODG00000013967","6",197160420,197254340,93920
"10266","ENSMODG00000013968","3",527464591,527465448,857
"10267","ENSMODG00000013969","3",527480568,527481114,546
"10268","ENSMODG00000013970","2",272295404,272598958,303554
"10269","ENSMODG00000013971","3",527502991,527503509,518
"10270","ENSMODG00000013972","3",527539467,527542313,2846
"10271","ENSMODG00000013975","4",383877534,383892845,15311
"10272","ENSMODG00000013976","1",307085342,307152760,67418
"10273","ENSMODG00000013977","8",196882914,196939177,56263
"10274","ENSMODG00000013978","8",196629734,196660489,30755
"10275","ENSMODG00000013979","1",306966870,307069074,102204
"10276","ENSMODG00000013980","4",383898134,383902965,4831
"10277","ENSMODG00000013982","4",362148049,362188044,39995
"10278","ENSMODG00000013983","2",271587885,271596365,8480
"10279","ENSMODG00000013984","1",306793081,306897904,104823
"10280","ENSMODG00000013985","4",362227468,362297381,69913
"10281","ENSMODG00000013986","1",306698384,306732397,34013
"10282","ENSMODG00000013987","2",271545452,271569938,24486
"10283","ENSMODG00000013989","8",196569026,196620046,51020
"10284","ENSMODG00000013990","4",362345823,362392866,47043
"10285","ENSMODG00000013991","X",45659533,45892104,232571
"10286","ENSMODG00000013993","2",271465685,271502983,37298
"10287","ENSMODG00000013994","4",383923074,383937354,14280
"10288","ENSMODG00000013995","6",196983112,197085631,102519
"10289","ENSMODG00000013996","2",271419047,271448845,29798
"10290","ENSMODG00000013998","4",383937722,383939255,1533
"10291","ENSMODG00000013999","4",362577755,362733456,155701
"10292","ENSMODG00000014000","1",450823878,450878556,54678
"10293","ENSMODG00000014001","1",710680460,710689056,8596
"10294","ENSMODG00000014002","6",196969734,196979933,10199
"10295","ENSMODG00000014003","4",383940195,383941833,1638
"10296","ENSMODG00000014006","4",383942313,383942916,603
"10297","ENSMODG00000014007","6",12305052,12433627,128575
"10298","ENSMODG00000014008","X",45485833,45558576,72743
"10299","ENSMODG00000014009","4",362969024,362992145,23121
"10300","ENSMODG00000014011","1",710553785,710569178,15393
"10301","ENSMODG00000014012","X",45426242,45477340,51098
"10302","ENSMODG00000014013","4",383944983,383947282,2299
"10303","ENSMODG00000014017","4",362998089,363016900,18811
"10304","ENSMODG00000014018","4",383947622,383948301,679
"10305","ENSMODG00000014019","X",44651915,44943365,291450
"10306","ENSMODG00000014020","4",363019968,363030867,10899
"10307","ENSMODG00000014021","1",710519288,710538080,18792
"10308","ENSMODG00000014024","2",195589909,195931629,341720
"10309","ENSMODG00000014027","4",363072570,363078730,6160
"10310","ENSMODG00000014028","Un",44079989,44098595,18606
"10311","ENSMODG00000014029","X",43801821,43808557,6736
"10312","ENSMODG00000014030","X",43368626,43370221,1595
"10313","ENSMODG00000014031","6",12460285,12484650,24365
"10314","ENSMODG00000014032","1",710460631,710496014,35383
"10315","ENSMODG00000014033","4",363119618,363151062,31444
"10316","ENSMODG00000014034","Un",44117115,44121930,4815
"10317","ENSMODG00000014035","1",306466168,306518533,52365
"10318","ENSMODG00000014036","6",12533880,12558808,24928
"10319","ENSMODG00000014037","1",710423137,710441724,18587
"10320","ENSMODG00000014038","4",383960346,383969557,9211
"10321","ENSMODG00000014039","X",43270912,43358642,87730
"10322","ENSMODG00000014040","4",363199843,363236784,36941
"10323","ENSMODG00000014041","6",12492831,12533156,40325
"10324","ENSMODG00000014043","6",196849943,196969470,119527
"10325","ENSMODG00000014045","6",12556742,12622353,65611
"10326","ENSMODG00000014046","4",383975896,383983969,8073
"10327","ENSMODG00000014047","1",710377862,710415620,37758
"10328","ENSMODG00000014049","Un",44134457,44136839,2382
"10329","ENSMODG00000014050","Un",44138522,44139061,539
"10330","ENSMODG00000014051","4",384007861,384012027,4166
"10331","ENSMODG00000014052","Un",44174427,44183291,8864
"10332","ENSMODG00000014053","1",552004539,552615667,611128
"10333","ENSMODG00000014054","X",43223530,43230777,7247
"10334","ENSMODG00000014055","4",384020456,384023643,3187
"10335","ENSMODG00000014057","4",384030227,384032028,1801
"10336","ENSMODG00000014058","4",384040555,384042812,2257
"10337","ENSMODG00000014059","Un",89784979,89786377,1398
"10338","ENSMODG00000014060","8",196441615,196543175,101560
"10339","ENSMODG00000014061","6",12661814,12829943,168129
"10340","ENSMODG00000014063","1",710206734,710260424,53690
"10341","ENSMODG00000014064","1",710127748,710135417,7669
"10342","ENSMODG00000014065","1",710111184,710112369,1185
"10343","ENSMODG00000014066","6",196650944,196710381,59437
"10344","ENSMODG00000014067","1",710093694,710100560,6866
"10345","ENSMODG00000014068","8",196177618,196281821,104203
"10346","ENSMODG00000014069","2",271269898,271417467,147569
"10347","ENSMODG00000014071","1",710058402,710067236,8834
"10348","ENSMODG00000014073","X",43067844,43187463,119619
"10349","ENSMODG00000014074","6",12895526,12924692,29166
"10350","ENSMODG00000014075","8",196077944,196124915,46971
"10351","ENSMODG00000014076","1",709950579,709963038,12459
"10352","ENSMODG00000014078","6",196557446,196634875,77429
"10353","ENSMODG00000014079","1",305873997,306046125,172128
"10354","ENSMODG00000014080","1",709895105,709926616,31511
"10355","ENSMODG00000014081","8",196062107,196078527,16420
"10356","ENSMODG00000014082","6",12936116,12945226,9110
"10357","ENSMODG00000014083","2",271204782,271225626,20844
"10358","ENSMODG00000014084","X",43044626,43060571,15945
"10359","ENSMODG00000014085","X",42939014,42948933,9919
"10360","ENSMODG00000014086","8",196019928,196020614,686
"10361","ENSMODG00000014087","X",42893720,42913592,19872
"10362","ENSMODG00000014088","Un",55899943,55905670,5727
"10363","ENSMODG00000014089","2",271187728,271201417,13689
"10364","ENSMODG00000014090","X",42854759,42862902,8143
"10365","ENSMODG00000014091","4",363235497,363354301,118804
"10366","ENSMODG00000014092","2",271105386,271106858,1472
"10367","ENSMODG00000014095","X",42739747,42800801,61054
"10368","ENSMODG00000014096","Un",55907976,55908932,956
"10369","ENSMODG00000014097","8",195993395,196018137,24742
"10370","ENSMODG00000014098","4",363272988,363380966,107978
"10371","ENSMODG00000014099","Un",55909618,55911221,1603
"10372","ENSMODG00000014100","8",195980101,195985182,5081
"10373","ENSMODG00000014101","4",363438501,363449302,10801
"10374","ENSMODG00000014102","8",195970789,195971349,560
"10375","ENSMODG00000014103","4",413198065,413235281,37216
"10376","ENSMODG00000014104","2",271082120,271097148,15028
"10377","ENSMODG00000014105","Un",55860344,55879326,18982
"10378","ENSMODG00000014106","Un",68775907,68776544,637
"10379","ENSMODG00000014107","8",310142023,310147275,5252
"10380","ENSMODG00000014108","Un",56009587,56012176,2589
"10381","ENSMODG00000014111","Un",56044383,56046355,1972
"10382","ENSMODG00000014112","1",305497077,305634206,137129
"10383","ENSMODG00000014114","8",310170583,310277675,107092
"10384","ENSMODG00000014115","2",169442033,169483858,41825
"10385","ENSMODG00000014116","1",305449484,305450442,958
"10386","ENSMODG00000014121","2",271060377,271064454,4077
"10387","ENSMODG00000014123","1",551932129,551943179,11050
"10388","ENSMODG00000014124","8",195704834,195785516,80682
"10389","ENSMODG00000014125","1",551054992,551055378,386
"10390","ENSMODG00000014127","8",195409249,195437202,27953
"10391","ENSMODG00000014128","2",169500503,169757179,256676
"10392","ENSMODG00000014129","4",384047999,384065362,17363
"10393","ENSMODG00000014130","4",237931398,238174870,243472
"10394","ENSMODG00000014131","1",305143257,305429333,286076
"10395","ENSMODG00000014132","2",271054067,271057960,3893
"10396","ENSMODG00000014133","6",196282087,196317277,35190
"10397","ENSMODG00000014135","4",363504169,363525060,20891
"10398","ENSMODG00000014137","2",169851838,169901032,49194
"10399","ENSMODG00000014138","1",709790798,709806838,16040
"10400","ENSMODG00000014139","1",304252747,305017935,765188
"10401","ENSMODG00000014140","1",709783383,709790308,6925
"10402","ENSMODG00000014141","4",384095876,384103724,7848
"10403","ENSMODG00000014142","2",169817330,169843111,25781
"10404","ENSMODG00000014145","1",709646986,709655910,8924
"10405","ENSMODG00000014146","2",270832382,270835473,3091
"10406","ENSMODG00000014147","1",303365184,303389755,24571
"10407","ENSMODG00000014148","8",195260361,195282378,22017
"10408","ENSMODG00000014151","4",363547296,363566418,19122
"10409","ENSMODG00000014152","2",270828679,270830322,1643
"10410","ENSMODG00000014153","8",195012525,195047783,35258
"10411","ENSMODG00000014154","8",195031524,195032191,667
"10412","ENSMODG00000014155","6",196198224,196280182,81958
"10413","ENSMODG00000014156","2",169963358,170016137,52779
"10414","ENSMODG00000014157","1",303337111,303359532,22421
"10415","ENSMODG00000014158","4",238276723,238289577,12854
"10416","ENSMODG00000014159","2",270822672,270827346,4674
"10417","ENSMODG00000014160","6",196123364,196141997,18633
"10418","ENSMODG00000014161","4",384114914,384151626,36712
"10419","ENSMODG00000014162","4",238331663,238359109,27446
"10420","ENSMODG00000014163","1",302981546,303101299,119753
"10421","ENSMODG00000014164","1",709481302,709496282,14980
"10422","ENSMODG00000014165","1",549583344,549733372,150028
"10423","ENSMODG00000014166","4",384152276,384153896,1620
"10424","ENSMODG00000014167","8",310390173,310751414,361241
"10425","ENSMODG00000014168","1",302961124,302969674,8550
"10426","ENSMODG00000014169","2",270699762,270703237,3475
"10427","ENSMODG00000014171","1",549498112,549500358,2246
"10428","ENSMODG00000014172","4",384154034,384155074,1040
"10429","ENSMODG00000014173","1",709456684,709461328,4644
"10430","ENSMODG00000014175","4",384156161,384165146,8985
"10431","ENSMODG00000014177","1",302904999,302930944,25945
"10432","ENSMODG00000014178","8",311071382,311072582,1200
"10433","ENSMODG00000014179","4",384168087,384175027,6940
"10434","ENSMODG00000014180","4",238404859,238571511,166652
"10435","ENSMODG00000014181","6",196025923,196042986,17063
"10436","ENSMODG00000014182","8",311097064,311109627,12563
"10437","ENSMODG00000014183","4",238476506,238477141,635
"10438","ENSMODG00000014184","8",311112343,311126731,14388
"10439","ENSMODG00000014185","2",270813363,270820625,7262
"10440","ENSMODG00000014186","4",363617658,363647222,29564
"10441","ENSMODG00000014187","2",170026857,170983894,957037
"10442","ENSMODG00000014188","8",311162181,311163077,896
"10443","ENSMODG00000014189","4",363648648,363649395,747
"10444","ENSMODG00000014191","2",270810339,270811783,1444
"10445","ENSMODG00000014192","4",238604973,238617959,12986
"10446","ENSMODG00000014194","1",549254039,549421925,167886
"10447","ENSMODG00000014196","4",238906562,239010556,103994
"10448","ENSMODG00000014198","1",549062490,549065606,3116
"10449","ENSMODG00000014199","1",709359358,709454549,95191
"10450","ENSMODG00000014200","4",363650152,363688508,38356
"10451","ENSMODG00000014201","1",302723483,302782239,58756
"10452","ENSMODG00000014202","2",270793634,270809659,16025
"10453","ENSMODG00000014204","2",171005611,171019208,13597
"10454","ENSMODG00000014205","4",239025661,239043525,17864
"10455","ENSMODG00000014207","6",195860329,196013579,153250
"10456","ENSMODG00000014208","4",384245899,384290015,44116
"10457","ENSMODG00000014209","1",302691897,302701960,10063
"10458","ENSMODG00000014210","2",270779765,270787116,7351
"10459","ENSMODG00000014211","8",311195166,311232437,37271
"10460","ENSMODG00000014213","1",709322179,709338248,16069
"10461","ENSMODG00000014214","1",302280571,302483224,202653
"10462","ENSMODG00000014216","2",171083231,171129192,45961
"10463","ENSMODG00000014217","2",195504016,195505284,1268
"10464","ENSMODG00000014218","2",109042975,109043865,890
"10465","ENSMODG00000014219","8",311255240,311255845,605
"10466","ENSMODG00000014223","8",311440738,311441313,575
"10467","ENSMODG00000014224","1",548721148,548933572,212424
"10468","ENSMODG00000014227","1",302141814,302157117,15303
"10469","ENSMODG00000014228","4",239070300,239125025,54725
"10470","ENSMODG00000014230","Un",62983161,62985195,2034
"10471","ENSMODG00000014231","4",363705422,363747549,42127
"10472","ENSMODG00000014232","2",270695310,270697211,1901
"10473","ENSMODG00000014233","1",547516926,547580808,63882
"10474","ENSMODG00000014234","1",709296915,709302703,5788
"10475","ENSMODG00000014236","4",363819924,363846968,27044
"10476","ENSMODG00000014237","8",18334140,18347194,13054
"10477","ENSMODG00000014238","1",547199314,547201801,2487
"10478","ENSMODG00000014239","2",270691632,270694493,2861
"10479","ENSMODG00000014241","2",195403198,195458971,55773
"10480","ENSMODG00000014242","3",527545069,527571807,26738
"10481","ENSMODG00000014243","1",302018027,302068456,50429
"10482","ENSMODG00000014244","8",18438390,18439617,1227
"10483","ENSMODG00000014246","4",363850053,363884711,34658
"10484","ENSMODG00000014247","1",547032890,547163367,130477
"10485","ENSMODG00000014248","8",18612369,18620902,8533
"10486","ENSMODG00000014249","2",270683291,270690889,7598
"10487","ENSMODG00000014251","1",301982166,302001204,19038
"10488","ENSMODG00000014252","1",546390441,546391631,1190
"10489","ENSMODG00000014253","2",195423386,195431655,8269
"10490","ENSMODG00000014254","8",18769546,18778120,8574
"10491","ENSMODG00000014256","1",709220558,709239612,19054
"10492","ENSMODG00000014258","2",171301502,171530369,228867
"10493","ENSMODG00000014260","1",545943454,545973777,30323
"10494","ENSMODG00000014261","8",312172258,312254497,82239
"10495","ENSMODG00000014262","1",709181366,709213043,31677
"10496","ENSMODG00000014263","1",545874655,545883369,8714
"10497","ENSMODG00000014265","8",312376608,312530048,153440
"10498","ENSMODG00000014267","1",709122520,709124814,2294
"10499","ENSMODG00000014269","8",21110482,21453896,343414
"10500","ENSMODG00000014270","1",708793250,709004829,211579
"10501","ENSMODG00000014272","3",527549909,527551723,1814
"10502","ENSMODG00000014273","2",171535206,171579704,44498
"10503","ENSMODG00000014274","3",527555194,527557020,1826
"10504","ENSMODG00000014275","2",195361789,195367153,5364
"10505","ENSMODG00000014277","X",51171856,51204719,32863
"10506","ENSMODG00000014278","3",527575298,527577123,1825
"10507","ENSMODG00000014279","X",52097385,52098416,1031
"10508","ENSMODG00000014280","X",52225816,52245113,19297
"10509","ENSMODG00000014282","3",527618742,527627703,8961
"10510","ENSMODG00000014283","4",363978621,364039371,60750
"10511","ENSMODG00000014284","1",544861871,545136763,274892
"10512","ENSMODG00000014285","6",195557862,195575323,17461
"10513","ENSMODG00000014286","2",270641536,270666296,24760
"10514","ENSMODG00000014290","3",527659061,527718201,59140
"10515","ENSMODG00000014291","8",21827347,21994135,166788
"10516","ENSMODG00000014292","1",543276217,544076434,800217
"10517","ENSMODG00000014293","2",171619329,171705991,86662
"10518","ENSMODG00000014294","6",195323325,195553680,230355
"10519","ENSMODG00000014295","2",270467737,270475885,8148
"10520","ENSMODG00000014296","1",543005227,543192421,187194
"10521","ENSMODG00000014298","1",708597646,708656675,59029
"10522","ENSMODG00000014300","3",527721793,527797628,75835
"10523","ENSMODG00000014301","2",172061504,172072567,11063
"10524","ENSMODG00000014302","X",52320635,52427342,106707
"10525","ENSMODG00000014304","1",542634730,542731533,96803
"10526","ENSMODG00000014305","3",527797973,527807916,9943
"10527","ENSMODG00000014306","6",195233239,195263152,29913
"10528","ENSMODG00000014307","X",52570813,52676999,106186
"10529","ENSMODG00000014308","1",708455984,708580616,124632
"10530","ENSMODG00000014310","2",270409294,270413828,4534
"10531","ENSMODG00000014312","6",195029250,195032177,2927
"10532","ENSMODG00000014313","2",172080802,172109982,29180
"10533","ENSMODG00000014314","4",239161791,239249717,87926
"10534","ENSMODG00000014316","2",270107974,270377989,270015
"10535","ENSMODG00000014317","X",52789136,53310455,521319
"10536","ENSMODG00000014318","8",22066371,22236090,169719
"10537","ENSMODG00000014319","1",708426925,708453667,26742
"10538","ENSMODG00000014320","6",194981110,195020393,39283
"10539","ENSMODG00000014321","3",527813098,527849409,36311
"10540","ENSMODG00000014322","1",708401540,708419961,18421
"10541","ENSMODG00000014323","2",172116353,172145266,28913
"10542","ENSMODG00000014324","3",527851690,527857394,5704
"10543","ENSMODG00000014325","8",22320394,22660801,340407
"10544","ENSMODG00000014329","7",173371026,173378345,7319
"10545","ENSMODG00000014330","X",53380135,53399121,18986
"10546","ENSMODG00000014331","1",301896244,301950603,54359
"10547","ENSMODG00000014333","6",194711923,194931719,219796
"10548","ENSMODG00000014334","8",22879672,22885434,5762
"10549","ENSMODG00000014335","X",53446058,53447806,1748
"10550","ENSMODG00000014336","2",270337113,270360292,23179
"10551","ENSMODG00000014339","2",172171392,172298149,126757
"10552","ENSMODG00000014340","3",527895742,527900330,4588
"10553","ENSMODG00000014342","6",194466920,194513129,46209
"10554","ENSMODG00000014344","1",301809351,301818586,9235
"10555","ENSMODG00000014345","2",270289574,270296681,7107
"10556","ENSMODG00000014346","X",53469661,53560186,90525
"10557","ENSMODG00000014348","1",301760532,301781121,20589
"10558","ENSMODG00000014349","4",240849543,240863554,14011
"10559","ENSMODG00000014350","6",194358142,194425935,67793
"10560","ENSMODG00000014351","1",301702110,301753696,51586
"10561","ENSMODG00000014352","2",270278678,270475190,196512
"10562","ENSMODG00000014353","3",527902174,527928645,26471
"10563","ENSMODG00000014355","6",194268359,194320738,52379
"10564","ENSMODG00000014356","4",400054449,400075310,20861
"10565","ENSMODG00000014357","1",301536123,301558507,22384
"10566","ENSMODG00000014358","3",527932720,527947321,14601
"10567","ENSMODG00000014359","6",194265435,194266127,692
"10568","ENSMODG00000014360","X",53601447,53841185,239738
"10569","ENSMODG00000014362","6",194246718,194263411,16693
"10570","ENSMODG00000014363","1",708251565,708289083,37518
"10571","ENSMODG00000014364","X",53898393,54193777,295384
"10572","ENSMODG00000014365","8",23218038,23218985,947
"10573","ENSMODG00000014366","2",270271776,270275521,3745
"10574","ENSMODG00000014368","6",194223788,194231938,8150
"10575","ENSMODG00000014369","4",240870984,240911302,40318
"10576","ENSMODG00000014370","X",54265795,54673438,407643
"10577","ENSMODG00000014372","8",23250794,23314722,63928
"10578","ENSMODG00000014373","8",194552666,195006110,453444
"10579","ENSMODG00000014377","8",23407365,23697326,289961
"10580","ENSMODG00000014378","1",542210801,542483414,272613
"10581","ENSMODG00000014379","X",55034837,55036819,1982
"10582","ENSMODG00000014380","4",364222532,364313101,90569
"10583","ENSMODG00000014381","4",241092356,241109240,16884
"10584","ENSMODG00000014382","8",23734750,23821211,86461
"10585","ENSMODG00000014383","4",370249798,370250862,1064
"10586","ENSMODG00000014384","6",194134565,194207282,72717
"10587","ENSMODG00000014387","1",708216084,708249832,33748
"10588","ENSMODG00000014388","4",241152531,241160001,7470
"10589","ENSMODG00000014390","4",241160223,241161567,1344
"10590","ENSMODG00000014391","4",364495719,364498831,3112
"10591","ENSMODG00000014392","1",708201955,708214023,12068
"10592","ENSMODG00000014393","4",241164211,241170622,6411
"10593","ENSMODG00000014394","6",193237403,193574687,337284
"10594","ENSMODG00000014396","2",195294879,195309626,14747
"10595","ENSMODG00000014397","1",300753253,300841551,88298
"10596","ENSMODG00000014398","8",23829375,23956648,127273
"10597","ENSMODG00000014399","4",364328692,364345881,17189
"10598","ENSMODG00000014400","6",193158057,193225867,67810
"10599","ENSMODG00000014401","4",241172552,241177249,4697
"10600","ENSMODG00000014404","8",24009219,24009562,343
"10601","ENSMODG00000014405","7",36497350,36497985,635
"10602","ENSMODG00000014406","4",364354689,364390183,35494
"10603","ENSMODG00000014408","1",708124853,708138387,13534
"10604","ENSMODG00000014409","8",24049112,24049507,395
"10605","ENSMODG00000014410","6",193130111,193153802,23691
"10606","ENSMODG00000014411","8",193866515,194736871,870356
"10607","ENSMODG00000014412","4",364416253,364422750,6497
"10608","ENSMODG00000014414","8",24772248,25238890,466642
"10609","ENSMODG00000014415","4",241177752,241208100,30348
"10610","ENSMODG00000014416","8",193255856,193610940,355084
"10611","ENSMODG00000014417","4",364423814,364437739,13925
"10612","ENSMODG00000014418","6",193007526,193080621,73095
"10613","ENSMODG00000014419","8",25599554,25612788,13234
"10614","ENSMODG00000014420","4",364469630,364474989,5359
"10615","ENSMODG00000014421","8",25878640,25903378,24738
"10616","ENSMODG00000014422","4",364498998,364504308,5310
"10617","ENSMODG00000014423","4",364568744,364569451,707
"10618","ENSMODG00000014424","8",25919492,26007796,88304
"10619","ENSMODG00000014425","3",478188427,478274527,86100
"10620","ENSMODG00000014427","4",364593294,364603411,10117
"10621","ENSMODG00000014431","2",172331819,172402809,70990
"10622","ENSMODG00000014433","8",192802329,192834986,32657
"10623","ENSMODG00000014435","6",192924944,192952712,27768
"10624","ENSMODG00000014436","4",364653824,364723166,69342
"10625","ENSMODG00000014437","8",26020871,26111062,90191
"10626","ENSMODG00000014440","8",26121599,26172926,51327
"10627","ENSMODG00000014441","4",241224526,241312141,87615
"10628","ENSMODG00000014442","6",192691102,192924829,233727
"10629","ENSMODG00000014444","1",539930177,540202569,272392
"10630","ENSMODG00000014445","4",364825319,364892575,67256
"10631","ENSMODG00000014448","4",241316336,241317549,1213
"10632","ENSMODG00000014449","4",364908248,364921382,13134
"10633","ENSMODG00000014450","2",270106252,270110736,4484
"10634","ENSMODG00000014453","4",241318873,241322341,3468
"10635","ENSMODG00000014456","8",192251005,192521618,270613
"10636","ENSMODG00000014458","1",300346645,300347199,554
"10637","ENSMODG00000014459","4",241371751,241376357,4606
"10638","ENSMODG00000014461","4",364923042,364935538,12496
"10639","ENSMODG00000014463","1",300252452,300268414,15962
"10640","ENSMODG00000014467","3",477253314,477254204,890
"10641","ENSMODG00000014468","2",172460558,172512101,51543
"10642","ENSMODG00000014469","3",477261343,477262281,938
"10643","ENSMODG00000014470","1",299721424,299790163,68739
"10644","ENSMODG00000014471","4",241402902,241520149,117247
"10645","ENSMODG00000014473","1",299636340,299773814,137474
"10646","ENSMODG00000014474","8",191046542,191284586,238044
"10647","ENSMODG00000014475","4",241558276,241587124,28848
"10648","ENSMODG00000014476","8",190890859,190891965,1106
"10649","ENSMODG00000014477","1",299487934,299618409,130475
"10650","ENSMODG00000014478","1",539741723,539902827,161104
"10651","ENSMODG00000014479","4",364936017,364951421,15404
"10652","ENSMODG00000014481","3",477266634,477286265,19631
"10653","ENSMODG00000014482","3",2119095,2195860,76765
"10654","ENSMODG00000014483","1",299381244,299471637,90393
"10655","ENSMODG00000014484","1",539615205,539630711,15506
"10656","ENSMODG00000014485","3",477299018,477319470,20452
"10657","ENSMODG00000014486","4",364958428,364968842,10414
"10658","ENSMODG00000014487","3",477342429,477349250,6821
"10659","ENSMODG00000014488","4",364987920,364992362,4442
"10660","ENSMODG00000014489","4",241602305,241764251,161946
"10661","ENSMODG00000014490","4",365026493,365027440,947
"10662","ENSMODG00000014491","1",539533217,539569083,35866
"10663","ENSMODG00000014492","1",299246354,299371696,125342
"10664","ENSMODG00000014493","4",241809983,241838889,28906
"10665","ENSMODG00000014494","1",707964277,707987468,23191
"10666","ENSMODG00000014495","1",539499516,539510134,10618
"10667","ENSMODG00000014496","4",241901212,241904395,3183
"10668","ENSMODG00000014497","3",477389683,477390675,992
"10669","ENSMODG00000014499","8",190465238,190512697,47459
"10670","ENSMODG00000014500","1",299198293,299235354,37061
"10671","ENSMODG00000014503","4",365071057,365151631,80574
"10672","ENSMODG00000014504","4",242052597,242060907,8310
"10673","ENSMODG00000014505","1",298979075,299154479,175404
"10674","ENSMODG00000014506","4",242167394,242237176,69782
"10675","ENSMODG00000014507","6",191520491,191520714,223
"10676","ENSMODG00000014508","3",477431115,477436178,5063
"10677","ENSMODG00000014510","2",195273455,195280313,6858
"10678","ENSMODG00000014511","1",539405079,539465658,60579
"10679","ENSMODG00000014514","X",19854035,19855711,1676
"10680","ENSMODG00000014515","8",275091241,275189449,98208
"10681","ENSMODG00000014516","8",190436310,190466534,30224
"10682","ENSMODG00000014517","1",298977098,299045203,68105
"10683","ENSMODG00000014518","1",707920554,707947476,26922
"10684","ENSMODG00000014519","3",477437642,477447424,9782
"10685","ENSMODG00000014520","1",539322049,539371545,49496
"10686","ENSMODG00000014521","4",242888770,243046980,158210
"10687","ENSMODG00000014523","1",707916494,707917361,867
"10688","ENSMODG00000014524","8",275275481,275321412,45931
"10689","ENSMODG00000014525","1",298912054,298941078,29024
"10690","ENSMODG00000014526","8",190406063,190434433,28370
"10691","ENSMODG00000014528","1",298797818,298801849,4031
"10692","ENSMODG00000014529","2",195246373,195252033,5660
"10693","ENSMODG00000014530","4",243212319,243228709,16390
"10694","ENSMODG00000014532","8",275324797,275409911,85114
"10695","ENSMODG00000014536","8",275477222,275490940,13718
"10696","ENSMODG00000014539","2",269578173,269587305,9132
"10697","ENSMODG00000014540","3",477582725,477612416,29691
"10698","ENSMODG00000014543","8",275492309,275502017,9708
"10699","ENSMODG00000014544","3",477652028,477658140,6112
"10700","ENSMODG00000014545","1",298598964,298599900,936
"10701","ENSMODG00000014548","8",190341578,190371651,30073
"10702","ENSMODG00000014549","4",243422228,243510393,88165
"10703","ENSMODG00000014551","1",298525803,298526474,671
"10704","ENSMODG00000014554","8",190295767,190328160,32393
"10705","ENSMODG00000014555","4",243554630,243637768,83138
"10706","ENSMODG00000014556","3",30211498,30212213,715
"10707","ENSMODG00000014557","8",275514555,275561591,47036
"10708","ENSMODG00000014558","3",477659968,477780380,120412
"10709","ENSMODG00000014561","8",190215442,190228512,13070
"10710","ENSMODG00000014564","1",707868485,707892858,24373
"10711","ENSMODG00000014565","6",188581052,188582107,1055
"10712","ENSMODG00000014566","8",275625969,275662297,36328
"10713","ENSMODG00000014569","6",186492058,186497640,5582
"10714","ENSMODG00000014571","8",275678258,275686303,8045
"10715","ENSMODG00000014573","3",477839347,477896155,56808
"10716","ENSMODG00000014575","1",535915321,535916682,1361
"10717","ENSMODG00000014576","1",298273730,298274410,680
"10718","ENSMODG00000014577","1",298200956,298202178,1222
"10719","ENSMODG00000014578","1",534244052,534266161,22109
"10720","ENSMODG00000014579","6",186199640,186284052,84412
"10721","ENSMODG00000014580","1",297865849,298201950,336101
"10722","ENSMODG00000014581","3",477897491,477920208,22717
"10723","ENSMODG00000014582","8",275703106,275835964,132858
"10724","ENSMODG00000014583","1",534215009,534382821,167812
"10725","ENSMODG00000014584","X",57820194,57821372,1178
"10726","ENSMODG00000014585","2",172713885,172838482,124597
"10727","ENSMODG00000014586","1",534028752,534105838,77086
"10728","ENSMODG00000014587","2",194995235,195004461,9226
"10729","ENSMODG00000014588","1",298111355,298112614,1259
"10730","ENSMODG00000014589","3",477920196,477959931,39735
"10731","ENSMODG00000014590","1",534002053,534003447,1394
"10732","ENSMODG00000014591","8",276161084,276169542,8458
"10733","ENSMODG00000014592","1",298046745,298047488,743
"10734","ENSMODG00000014594","3",477964750,477971410,6660
"10735","ENSMODG00000014595","8",276262433,276290206,27773
"10736","ENSMODG00000014596","1",297971907,297972350,443
"10737","ENSMODG00000014597","6",185653753,185815639,161886
"10738","ENSMODG00000014598","2",172857684,172919134,61450
"10739","ENSMODG00000014600","4",245288545,245655122,366577
"10740","ENSMODG00000014601","8",276315504,276376616,61112
"10741","ENSMODG00000014602","1",297946596,297947253,657
"10742","ENSMODG00000014603","8",190179528,190212363,32835
"10743","ENSMODG00000014604","1",707801989,707836540,34551
"10744","ENSMODG00000014605","2",172926166,172932572,6406
"10745","ENSMODG00000014607","8",276386137,276568591,182454
"10746","ENSMODG00000014608","2",195225574,195231112,5538
"10747","ENSMODG00000014610","3",478002822,478008583,5761
"10748","ENSMODG00000014611","4",245742332,245853336,111004
"10749","ENSMODG00000014612","1",533260571,533262160,1589
"10750","ENSMODG00000014614","1",297642011,297661583,19572
"10751","ENSMODG00000014615","4",245910474,245949447,38973
"10752","ENSMODG00000014616","8",190079370,190142491,63121
"10753","ENSMODG00000014618","1",531431034,531431806,772
"10754","ENSMODG00000014619","2",172979551,173024421,44870
"10755","ENSMODG00000014620","2",195188158,195195034,6876
"10756","ENSMODG00000014622","3",478123178,478168031,44853
"10757","ENSMODG00000014624","2",269512870,269556412,43542
"10758","ENSMODG00000014625","2",195096840,195115721,18881
"10759","ENSMODG00000014626","1",297388025,297391225,3200
"10760","ENSMODG00000014627","1",297352689,297362232,9543
"10761","ENSMODG00000014628","2",195050738,195058132,7394
"10762","ENSMODG00000014629","1",707589469,707756111,166642
"10763","ENSMODG00000014630","8",190000056,190028750,28694
"10764","ENSMODG00000014631","1",297186132,297294198,108066
"10765","ENSMODG00000014632","2",173113201,173247073,133872
"10766","ENSMODG00000014633","1",297115538,297118696,3158
"10767","ENSMODG00000014635","1",707519291,707563536,44245
"10768","ENSMODG00000014636","8",189771573,189841775,70202
"10769","ENSMODG00000014637","2",173246266,173461003,214737
"10770","ENSMODG00000014639","4",245957592,246118851,161259
"10771","ENSMODG00000014640","1",707364780,707445168,80388
"10772","ENSMODG00000014642","1",296896626,297079744,183118
"10773","ENSMODG00000014643","2",173527357,173595922,68565
"10774","ENSMODG00000014644","6",184223241,184291621,68380
"10775","ENSMODG00000014645","8",189505543,189632419,126876
"10776","ENSMODG00000014646","6",184047103,184118253,71150
"10777","ENSMODG00000014647","2",194983030,194992762,9732
"10778","ENSMODG00000014648","4",246122648,246167825,45177
"10779","ENSMODG00000014649","2",173687325,173808546,121221
"10780","ENSMODG00000014650","6",183937126,184026784,89658
"10781","ENSMODG00000014651","2",194867961,194870695,2734
"10782","ENSMODG00000014652","6",184009700,184010819,1119
"10783","ENSMODG00000014653","4",246169991,246209940,39949
"10784","ENSMODG00000014654","2",173814686,173823911,9225
"10785","ENSMODG00000014656","2",194839143,194840174,1031
"10786","ENSMODG00000014657","2",173871007,173929200,58193
"10787","ENSMODG00000014658","1",707160474,707222041,61567
"10788","ENSMODG00000014659","2",194806648,194834856,28208
"10789","ENSMODG00000014660","1",531213375,531368183,154808
"10790","ENSMODG00000014661","6",183795222,183827536,32314
"10791","ENSMODG00000014663","1",296836000,297026385,190385
"10792","ENSMODG00000014664","8",189280147,189364363,84216
"10793","ENSMODG00000014666","4",246225617,246323799,98182
"10794","ENSMODG00000014667","1",531023429,531192251,168822
"10795","ENSMODG00000014668","1",296802726,296803817,1091
"10796","ENSMODG00000014669","1",296322184,296726710,404526
"10797","ENSMODG00000014670","4",246385272,246413277,28005
"10798","ENSMODG00000014671","1",707025814,707035980,10166
"10799","ENSMODG00000014672","8",189106673,189259740,153067
"10800","ENSMODG00000014674","3",476836748,476871336,34588
"10801","ENSMODG00000014675","6",183757957,183791385,33428
"10802","ENSMODG00000014676","6",183637140,183748682,111542
"10803","ENSMODG00000014677","4",246453459,246538404,84945
"10804","ENSMODG00000014679","1",707016717,707022055,5338
"10805","ENSMODG00000014680","8",189078336,189095077,16741
"10806","ENSMODG00000014681","2",194750872,194766618,15746
"10807","ENSMODG00000014682","3",478315873,478359679,43806
"10808","ENSMODG00000014683","6",183223504,183608319,384815
"10809","ENSMODG00000014684","8",189046774,189070398,23624
"10810","ENSMODG00000014685","1",530412255,530674222,261967
"10811","ENSMODG00000014686","2",269410741,269417099,6358
"10812","ENSMODG00000014687","2",269387468,269390320,2852
"10813","ENSMODG00000014688","1",706989483,706994705,5222
"10814","ENSMODG00000014689","4",246895379,247035707,140328
"10815","ENSMODG00000014690","1",295999926,296198167,198241
"10816","ENSMODG00000014691","1",530398355,530412666,14311
"10817","ENSMODG00000014692","2",269282904,269286147,3243
"10818","ENSMODG00000014693","1",296116820,296123496,6676
"10819","ENSMODG00000014695","2",194653137,194660473,7336
"10820","ENSMODG00000014697","2",173937275,173955192,17917
"10821","ENSMODG00000014700","8",188835472,188961642,126170
"10822","ENSMODG00000014701","2",173966364,173999523,33159
"10823","ENSMODG00000014702","2",194699881,194721737,21856
"10824","ENSMODG00000014703","1",530327719,530389338,61619
"10825","ENSMODG00000014705","4",246683559,246754747,71188
"10826","ENSMODG00000014706","1",530304442,530322237,17795
"10827","ENSMODG00000014707","1",295476377,295631027,154650
"10828","ENSMODG00000014708","Un",58893235,58902273,9038
"10829","ENSMODG00000014710","8",188808236,188833450,25214
"10830","ENSMODG00000014711","1",295176457,295177494,1037
"10831","ENSMODG00000014712","2",174003110,174106315,103205
"10832","ENSMODG00000014713","2",269169718,269174490,4772
"10833","ENSMODG00000014714","Un",59867409,59886778,19369
"10834","ENSMODG00000014715","1",294978853,294979602,749
"10835","ENSMODG00000014716","2",194681566,194698589,17023
"10836","ENSMODG00000014717","3",478413894,478437550,23656
"10837","ENSMODG00000014719","1",294929032,294929844,812
"10838","ENSMODG00000014720","1",294894139,294895244,1105
"10839","ENSMODG00000014721","4",246789124,246845450,56326
"10840","ENSMODG00000014722","2",269111369,269119144,7775
"10841","ENSMODG00000014723","2",194660658,194682183,21525
"10842","ENSMODG00000014724","4",247489223,247790922,301699
"10843","ENSMODG00000014725","2",194644144,194648790,4646
"10844","ENSMODG00000014726","1",530249276,530308357,59081
"10845","ENSMODG00000014727","7",163809178,163818545,9367
"10846","ENSMODG00000014728","2",268959819,269058895,99076
"10847","ENSMODG00000014729","4",248544289,248599026,54737
"10848","ENSMODG00000014730","8",276637036,276657634,20598
"10849","ENSMODG00000014731","4",248607965,248615501,7536
"10850","ENSMODG00000014734","2",174137594,174183040,45446
"10851","ENSMODG00000014735","7",164085396,164124022,38626
"10852","ENSMODG00000014736","8",276836455,277053164,216709
"10853","ENSMODG00000014737","2",174202812,174213722,10910
"10854","ENSMODG00000014738","2",194576037,194629601,53564
"10855","ENSMODG00000014739","7",164388942,164394731,5789
"10856","ENSMODG00000014740","1",530148220,530179607,31387
"10857","ENSMODG00000014741","2",194518955,194564286,45331
"10858","ENSMODG00000014742","2",194490967,194499349,8382
"10859","ENSMODG00000014743","7",164532505,164551486,18981
"10860","ENSMODG00000014744","2",174221546,174248555,27009
"10861","ENSMODG00000014746","4",248751854,249043740,291886
"10862","ENSMODG00000014747","1",529595441,529695586,100145
"10863","ENSMODG00000014748","7",164572081,164895709,323628
"10864","ENSMODG00000014749","2",174336856,174357875,21019
"10865","ENSMODG00000014750","8",277144442,277536210,391768
"10866","ENSMODG00000014752","4",250130013,250142302,12289
"10867","ENSMODG00000014753","1",529487684,529562407,74723
"10868","ENSMODG00000014754","3",478508055,478539023,30968
"10869","ENSMODG00000014755","2",174359679,174373939,14260
"10870","ENSMODG00000014756","7",164668351,164716187,47836
"10871","ENSMODG00000014758","1",529381382,529396764,15382
"10872","ENSMODG00000014760","2",194453275,194488087,34812
"10873","ENSMODG00000014761","7",164815676,164847902,32226
"10874","ENSMODG00000014762","4",250103436,250113716,10280
"10875","ENSMODG00000014763","1",529231758,529242569,10811
"10876","ENSMODG00000014765","8",278473761,278570569,96808
"10877","ENSMODG00000014766","2",194442937,194455749,12812
"10878","ENSMODG00000014767","2",268842891,268853391,10500
"10879","ENSMODG00000014770","1",528454359,528553616,99257
"10880","ENSMODG00000014772","7",164901445,164924357,22912
"10881","ENSMODG00000014773","2",174726917,174729924,3007
"10882","ENSMODG00000014774","2",194436825,194442986,6161
"10883","ENSMODG00000014776","2",275495260,275502649,7389
"10884","ENSMODG00000014778","2",174854634,174867816,13182
"10885","ENSMODG00000014779","1",528427872,528432556,4684
"10886","ENSMODG00000014781","2",174829236,174831349,2113
"10887","ENSMODG00000014782","2",194331046,194346470,15424
"10888","ENSMODG00000014783","2",174926034,175010861,84827
"10889","ENSMODG00000014784","1",527969021,528110137,141116
"10890","ENSMODG00000014786","8",279447951,279838289,390338
"10891","ENSMODG00000014788","2",194319308,194329629,10321
"10892","ENSMODG00000014789","8",280081189,280126970,45781
"10893","ENSMODG00000014790","2",175142850,175788792,645942
"10894","ENSMODG00000014792","2",194268149,194314437,46288
"10895","ENSMODG00000014793","8",280156968,280193180,36212
"10896","ENSMODG00000014795","8",280192525,280223959,31434
"10897","ENSMODG00000014796","2",194233395,194262094,28699
"10898","ENSMODG00000014797","2",176053616,176056247,2631
"10899","ENSMODG00000014798","2",194229811,194231018,1207
"10900","ENSMODG00000014799","7",164930817,165030387,99570
"10901","ENSMODG00000014802","2",194222958,194227487,4529
"10902","ENSMODG00000014803","1",527860353,527923188,62835
"10903","ENSMODG00000014805","7",165080546,165100753,20207
"10904","ENSMODG00000014806","8",280245203,280365395,120192
"10905","ENSMODG00000014808","2",176171639,176217103,45464
"10906","ENSMODG00000014809","7",165138382,165139208,826
"10907","ENSMODG00000014810","2",176219768,176240587,20819
"10908","ENSMODG00000014811","1",527825577,527862008,36431
"10909","ENSMODG00000014812","8",280367003,280384045,17042
"10910","ENSMODG00000014813","2",268793883,268801722,7839
"10911","ENSMODG00000014814","2",176276300,176308270,31970
"10912","ENSMODG00000014816","2",194111894,194184231,72337
"10913","ENSMODG00000014817","1",527601166,527602641,1475
"10914","ENSMODG00000014818","2",176333012,176364384,31372
"10915","ENSMODG00000014819","2",176711212,176711910,698
"10916","ENSMODG00000014821","1",527250065,527251009,944
"10917","ENSMODG00000014823","7",165207027,165649417,442390
"10918","ENSMODG00000014824","1",527216722,527217669,947
"10919","ENSMODG00000014826","2",176850838,177041923,191085
"10920","ENSMODG00000014827","8",281617790,282013050,395260
"10921","ENSMODG00000014829","2",268717217,268726191,8974
"10922","ENSMODG00000014831","2",268578533,268617728,39195
"10923","ENSMODG00000014836","2",194111110,194214386,103276
"10924","ENSMODG00000014839","2",268510012,268513216,3204
"10925","ENSMODG00000014840","2",177839737,177902597,62860
"10926","ENSMODG00000014843","1",526833995,526862061,28066
"10927","ENSMODG00000014844","7",165765958,166008745,242787
"10928","ENSMODG00000014847","2",178246117,178273854,27737
"10929","ENSMODG00000014848","7",166043030,166102452,59422
"10930","ENSMODG00000014850","6",182068961,182307647,238686
"10931","ENSMODG00000014851","2",178367360,178442465,75105
"10932","ENSMODG00000014852","7",166204025,166205285,1260
"10933","ENSMODG00000014855","2",178882036,178896132,14096
"10934","ENSMODG00000014856","7",166433468,166492706,59238
"10935","ENSMODG00000014859","2",193999394,194012982,13588
"10936","ENSMODG00000014860","6",181421283,181933896,512613
"10937","ENSMODG00000014862","2",193982611,193983034,423
"10938","ENSMODG00000014863","2",178573221,178882896,309675
"10939","ENSMODG00000014864","2",268428479,268458668,30189
"10940","ENSMODG00000014867","2",268424183,268425570,1387
"10941","ENSMODG00000014869","2",178891868,178951782,59914
"10942","ENSMODG00000014871","2",180095737,180097940,2203
"10943","ENSMODG00000014872","8",283745768,283815590,69822
"10944","ENSMODG00000014873","2",268416906,268423049,6143
"10945","ENSMODG00000014874","2",180369277,180371283,2006
"10946","ENSMODG00000014875","7",166945464,167035736,90272
"10947","ENSMODG00000014876","8",283979217,284064963,85746
"10948","ENSMODG00000014879","8",284066408,284071376,4968
"10949","ENSMODG00000014880","8",284074628,284078492,3864
"10950","ENSMODG00000014881","2",268413240,268416146,2906
"10951","ENSMODG00000014882","3",479231065,479259796,28731
"10952","ENSMODG00000014883","2",193809136,193894046,84910
"10953","ENSMODG00000014885","7",167217915,167527795,309880
"10954","ENSMODG00000014886","2",268408788,268412459,3671
"10955","ENSMODG00000014887","2",181914286,181915297,1011
"10956","ENSMODG00000014888","3",479270545,479302248,31703
"10957","ENSMODG00000014889","7",167997108,168022003,24895
"10958","ENSMODG00000014891","2",268395876,268402145,6269
"10959","ENSMODG00000014892","8",284115845,284182569,66724
"10960","ENSMODG00000014893","7",168027713,168053764,26051
"10961","ENSMODG00000014894","3",479330124,479365365,35241
"10962","ENSMODG00000014898","2",268394164,268398404,4240
"10963","ENSMODG00000014899","3",479375489,479394441,18952
"10964","ENSMODG00000014900","6",180575663,180915940,340277
"10965","ENSMODG00000014901","7",168737616,168872614,134998
"10966","ENSMODG00000014903","8",284255337,284420003,164666
"10967","ENSMODG00000014904","3",479402197,479407424,5227
"10968","ENSMODG00000014906","X",17646067,18377042,730975
"10969","ENSMODG00000014907","2",268388458,268391632,3174
"10970","ENSMODG00000014908","3",479419239,479450227,30988
"10971","ENSMODG00000014909","2",193770135,193772571,2436
"10972","ENSMODG00000014910","2",268377203,268378906,1703
"10973","ENSMODG00000014911","3",479609518,479611234,1716
"10974","ENSMODG00000014912","2",268340562,268341618,1056
"10975","ENSMODG00000014913","6",179447176,179990322,543146
"10976","ENSMODG00000014917","3",479626672,479757241,130569
"10977","ENSMODG00000014918","2",193752576,193759464,6888
"10978","ENSMODG00000014919","7",168902323,169055836,153513
"10979","ENSMODG00000014920","2",268325946,268337606,11660
"10980","ENSMODG00000014922","3",479801761,479836677,34916
"10981","ENSMODG00000014923","2",193748488,193755222,6734
"10982","ENSMODG00000014924","7",169496513,169543609,47096
"10983","ENSMODG00000014926","8",285692448,285891432,198984
"10984","ENSMODG00000014928","Un",55413300,55418080,4780
"10985","ENSMODG00000014929","3",479836787,479861661,24874
"10986","ENSMODG00000014930","7",169543272,169578318,35046
"10987","ENSMODG00000014931","X",17785720,17940356,154636
"10988","ENSMODG00000014932","2",193722323,193745735,23412
"10989","ENSMODG00000014933","Un",55932687,55956189,23502
"10990","ENSMODG00000014934","Un",55957493,55957858,365
"10991","ENSMODG00000014936","2",268243811,268317920,74109
"10992","ENSMODG00000014937","Un",55958854,55959421,567
"10993","ENSMODG00000014938","3",479865471,479894617,29146
"10994","ENSMODG00000014939","Un",58147646,58160481,12835
"10995","ENSMODG00000014940","7",169966418,169972822,6404
"10996","ENSMODG00000014941","Un",57252980,57271521,18541
"10997","ENSMODG00000014942","3",479897032,479913290,16258
"10998","ENSMODG00000014943","6",179390800,179420780,29980
"10999","ENSMODG00000014944","3",479919469,479930742,11273
"11000","ENSMODG00000014945","7",170051648,170076767,25119
"11001","ENSMODG00000014946","3",480103217,480126828,23611
"11002","ENSMODG00000014947","Un",54509060,54520560,11500
"11003","ENSMODG00000014949","3",480145947,480170154,24207
"11004","ENSMODG00000014950","2",268238202,268242434,4232
"11005","ENSMODG00000014951","3",480194727,480253378,58651
"11006","ENSMODG00000014952","7",170113485,170180157,66672
"11007","ENSMODG00000014954","8",285891596,285981410,89814
"11008","ENSMODG00000014955","7",170353479,170389617,36138
"11009","ENSMODG00000014956","6",179361897,179387750,25853
"11010","ENSMODG00000014957","X",17572033,17691066,119033
"11011","ENSMODG00000014958","7",170480910,170578687,97777
"11012","ENSMODG00000014960","3",462758272,462770691,12419
"11013","ENSMODG00000014961","8",286015630,286062771,47141
"11014","ENSMODG00000014962","3",462782234,462787234,5000
"11015","ENSMODG00000014963","8",286075001,286082961,7960
"11016","ENSMODG00000014964","3",462813299,462816181,2882
"11017","ENSMODG00000014967","6",179081144,179234434,153290
"11018","ENSMODG00000014969","7",170729152,170831248,102096
"11019","ENSMODG00000014970","X",17494487,17525908,31421
"11020","ENSMODG00000014971","2",193714768,193721906,7138
"11021","ENSMODG00000014974","Un",38606800,38607339,539
"11022","ENSMODG00000014975","7",170834833,170885803,50970
"11023","ENSMODG00000014976","3",462820126,462891686,71560
"11024","ENSMODG00000014977","Un",38672129,38672623,494
"11025","ENSMODG00000014978","8",287296885,287580687,283802
"11026","ENSMODG00000014979","2",268205002,268222321,17319
"11027","ENSMODG00000014981","2",193621723,193634007,12284
"11028","ENSMODG00000014982","3",463000015,463012080,12065
"11029","ENSMODG00000014983","Un",45356775,45362977,6202
"11030","ENSMODG00000014984","X",17322996,17411879,88883
"11031","ENSMODG00000014985","3",463088038,463096613,8575
"11032","ENSMODG00000014986","6",178762229,178931732,169503
"11033","ENSMODG00000014987","2",193616869,193618684,1815
"11034","ENSMODG00000014989","1",294668651,294862591,193940
"11035","ENSMODG00000014990","7",170940864,171067684,126820
"11036","ENSMODG00000014991","6",178740625,178743283,2658
"11037","ENSMODG00000014992","3",480278557,480349677,71120
"11038","ENSMODG00000014993","6",178664051,178712011,47960
"11039","ENSMODG00000014994","3",480431281,480434562,3281
"11040","ENSMODG00000014995","Un",45367312,45374196,6884
"11041","ENSMODG00000014998","Un",45375130,45378758,3628
"11042","ENSMODG00000014999","6",178065580,178329380,263800
"11043","ENSMODG00000015000","7",171088333,171101602,13269
"11044","ENSMODG00000015002","3",463159907,463175929,16022
"11045","ENSMODG00000015003","X",17051785,17266098,214313
"11046","ENSMODG00000015005","8",188728456,188730658,2202
"11047","ENSMODG00000015006","3",480402090,480596937,194847
"11048","ENSMODG00000015007","X",16798682,16966704,168022
"11049","ENSMODG00000015009","Un",45390869,45407190,16321
"11050","ENSMODG00000015010","3",459794282,459794794,512
"11051","ENSMODG00000015011","2",268094675,268100488,5813
"11052","ENSMODG00000015012","3",463179948,463186395,6447
"11053","ENSMODG00000015016","Un",91830296,91834944,4648
"11054","ENSMODG00000015017","2",193599486,193616563,17077
"11055","ENSMODG00000015018","2",268200284,268204131,3847
"11056","ENSMODG00000015019","Un",96058580,96060412,1832
"11057","ENSMODG00000015021","3",480753443,480784448,31005
"11058","ENSMODG00000015022","3",463190549,463201803,11254
"11059","ENSMODG00000015024","X",15040216,15042123,1907
"11060","ENSMODG00000015025","7",171107490,171117998,10508
"11061","ENSMODG00000015026","1",294699863,294701327,1464
"11062","ENSMODG00000015027","2",268196535,268199420,2885
"11063","ENSMODG00000015028","1",712646675,712689751,43076
"11064","ENSMODG00000015029","1",525203275,526292664,1089389
"11065","ENSMODG00000015030","8",287583308,287720803,137495
"11066","ENSMODG00000015032","1",294051359,294345287,293928
"11067","ENSMODG00000015033","2",193542028,193596551,54523
"11068","ENSMODG00000015034","3",463203142,463215944,12802
"11069","ENSMODG00000015035","1",293409102,293810116,401014
"11070","ENSMODG00000015036","3",480810555,480939957,129402
"11071","ENSMODG00000015037","7",171124389,171144745,20356
"11072","ENSMODG00000015038","2",193464123,193469910,5787
"11073","ENSMODG00000015039","3",480946024,480965374,19350
"11074","ENSMODG00000015040","Un",67211090,67221515,10425
"11075","ENSMODG00000015041","3",480972827,480984630,11803
"11076","ENSMODG00000015042","6",176753642,176944417,190775
"11077","ENSMODG00000015043","7",172999831,173026431,26600
"11078","ENSMODG00000015044","Un",67501848,67510445,8597
"11079","ENSMODG00000015045","3",480995235,481008425,13190
"11080","ENSMODG00000015046","6",176395470,176447666,52196
"11081","ENSMODG00000015047","3",481001858,481161913,160055
"11082","ENSMODG00000015048","8",188675965,188716767,40802
"11083","ENSMODG00000015049","3",481007477,481025504,18027
"11084","ENSMODG00000015050","7",258515748,258776575,260827
"11085","ENSMODG00000015051","2",193436852,193451393,14541
"11086","ENSMODG00000015052","2",268186032,268197101,11069
"11087","ENSMODG00000015053","7",257993174,258167882,174708
"11088","ENSMODG00000015054","6",176277093,176301811,24718
"11089","ENSMODG00000015055","2",193433493,193434963,1470
"11090","ENSMODG00000015056","7",171146144,171171455,25311
"11091","ENSMODG00000015057","8",287917524,287921369,3845
"11092","ENSMODG00000015058","7",173043212,173059222,16010
"11093","ENSMODG00000015060","7",257439417,257677029,237612
"11094","ENSMODG00000015061","3",481043766,481088419,44653
"11095","ENSMODG00000015062","8",288390564,288482180,91616
"11096","ENSMODG00000015063","2",268177650,268184585,6935
"11097","ENSMODG00000015064","2",193417967,193431591,13624
"11098","ENSMODG00000015065","8",188639847,188672075,32228
"11099","ENSMODG00000015066","3",463233859,463288456,54597
"11100","ENSMODG00000015068","7",171176509,171236517,60008
"11101","ENSMODG00000015070","3",481099948,481108467,8519
"11102","ENSMODG00000015071","8",188614210,188617867,3657
"11103","ENSMODG00000015072","7",173073828,173097440,23612
"11104","ENSMODG00000015073","7",257223465,257362746,139281
"11105","ENSMODG00000015075","8",288495599,288546227,50628
"11106","ENSMODG00000015076","3",481110568,481116328,5760
"11107","ENSMODG00000015077","3",481118618,481122587,3969
"11108","ENSMODG00000015078","7",173125100,173130968,5868
"11109","ENSMODG00000015079","2",193330626,193414814,84188
"11110","ENSMODG00000015080","8",188588929,188610680,21751
"11111","ENSMODG00000015081","7",257053293,257075247,21954
"11112","ENSMODG00000015082","3",481188963,481196815,7852
"11113","ENSMODG00000015084","3",463288538,463295327,6789
"11114","ENSMODG00000015085","6",174744837,174746309,1472
"11115","ENSMODG00000015086","7",171278866,171367328,88462
"11116","ENSMODG00000015088","7",256914766,256957207,42441
"11117","ENSMODG00000015090","7",171368045,171374844,6799
"11118","ENSMODG00000015091","8",188539907,188563233,23326
"11119","ENSMODG00000015093","2",268155059,268177354,22295
"11120","ENSMODG00000015094","3",481204516,481229342,24826
"11121","ENSMODG00000015095","7",256647549,256793891,146342
"11122","ENSMODG00000015096","2",268107289,268111403,4114
"11123","ENSMODG00000015097","7",171396300,171458579,62279
"11124","ENSMODG00000015098","3",481236308,481243048,6740
"11125","ENSMODG00000015099","7",256401302,256415008,13706
"11126","ENSMODG00000015101","3",463493965,463653153,159188
"11127","ENSMODG00000015103","7",255932897,255967096,34199
"11128","ENSMODG00000015106","7",171489540,171525636,36096
"11129","ENSMODG00000015109","2",193265338,193285148,19810
"11130","ENSMODG00000015111","3",463316081,463338018,21937
"11131","ENSMODG00000015112","7",255780367,255852501,72134
"11132","ENSMODG00000015114","3",509048097,509060862,12765
"11133","ENSMODG00000015116","7",254786021,255022911,236890
"11134","ENSMODG00000015117","3",463349441,463371584,22143
"11135","ENSMODG00000015119","7",254319719,254353046,33327
"11136","ENSMODG00000015121","2",193255994,193264432,8438
"11137","ENSMODG00000015123","7",254100799,254127559,26760
"11138","ENSMODG00000015125","8",289660339,290411085,750746
"11139","ENSMODG00000015127","3",463420677,463430247,9570
"11140","ENSMODG00000015128","2",193246115,193250691,4576
"11141","ENSMODG00000015131","1",524303658,524315281,11623
"11142","ENSMODG00000015132","2",193235138,193238946,3808
"11143","ENSMODG00000015135","1",293177586,293178978,1392
"11144","ENSMODG00000015136","2",193221627,193237696,16069
"11145","ENSMODG00000015137","7",253904325,254009443,105118
"11146","ENSMODG00000015138","2",268065854,268082186,16332
"11147","ENSMODG00000015139","3",463754275,463790405,36130
"11148","ENSMODG00000015140","8",188310679,188335978,25299
"11149","ENSMODG00000015141","2",193211128,193218033,6905
"11150","ENSMODG00000015142","1",292505534,292926524,420990
"11151","ENSMODG00000015149","2",268055684,268065564,9880
"11152","ENSMODG00000015150","2",193078131,193152196,74065
"11153","ENSMODG00000015151","8",188214501,188258934,44433
"11154","ENSMODG00000015152","1",292311874,292324003,12129
"11155","ENSMODG00000015153","8",188148046,188169344,21298
"11156","ENSMODG00000015154","3",463904555,463916327,11772
"11157","ENSMODG00000015155","8",290921352,291007892,86540
"11158","ENSMODG00000015156","7",253807985,253871942,63957
"11159","ENSMODG00000015157","2",193045775,193068521,22746
"11160","ENSMODG00000015159","8",291029957,291245015,215058
"11161","ENSMODG00000015160","2",193034959,193043122,8163
"11162","ENSMODG00000015162","1",292124698,292213748,89050
"11163","ENSMODG00000015163","1",524107368,524195706,88338
"11164","ENSMODG00000015164","8",291896194,291923271,27077
"11165","ENSMODG00000015165","7",173143095,173226428,83333
"11166","ENSMODG00000015166","8",291899889,292172557,272668
"11167","ENSMODG00000015168","X",36362178,36432641,70463
"11168","ENSMODG00000015169","1",524002961,524015815,12854
"11169","ENSMODG00000015171","3",463910354,463991955,81601
"11170","ENSMODG00000015173","2",267985147,267987078,1931
"11171","ENSMODG00000015175","1",291883720,291889095,5375
"11172","ENSMODG00000015176","3",463939621,464010597,70976
"11173","ENSMODG00000015177","2",267971091,267975306,4215
"11174","ENSMODG00000015178","X",36104942,36139965,35023
"11175","ENSMODG00000015179","3",464028369,464036687,8318
"11176","ENSMODG00000015180","7",173230817,173244089,13272
"11177","ENSMODG00000015181","2",192883223,192908354,25131
"11178","ENSMODG00000015182","8",187324097,187875478,551381
"11179","ENSMODG00000015183","7",171635121,171687760,52639
"11180","ENSMODG00000015185","X",36032598,36053789,21191
"11181","ENSMODG00000015186","8",292251651,292316434,64783
"11182","ENSMODG00000015187","2",192860787,192878605,17818
"11183","ENSMODG00000015188","7",171697970,171745726,47756
"11184","ENSMODG00000015190","2",192706093,192737985,31892
"11185","ENSMODG00000015192","6",170357788,170820547,462759
"11186","ENSMODG00000015193","7",173306094,173313856,7762
"11187","ENSMODG00000015194","8",187791491,187793443,1952
"11188","ENSMODG00000015195","X",35982925,36028744,45819
"11189","ENSMODG00000015196","1",523811442,523994397,182955
"11190","ENSMODG00000015197","2",192524576,192902606,378030
"11191","ENSMODG00000015198","8",292395168,292414847,19679
"11192","ENSMODG00000015199","3",464044286,464095180,50894
"11193","ENSMODG00000015201","3",509033606,509041269,7663
"11194","ENSMODG00000015202","2",192489383,192505296,15913
"11195","ENSMODG00000015203","6",169945943,169946628,685
"11196","ENSMODG00000015204","2",267939959,267957002,17043
"11197","ENSMODG00000015205","6",169695463,169695705,242
"11198","ENSMODG00000015206","Un",36666524,36675277,8753
"11199","ENSMODG00000015207","7",171756246,171818071,61825
"11200","ENSMODG00000015208","1",523480138,523761000,280862
"11201","ENSMODG00000015210","8",292426101,292471376,45275
"11202","ENSMODG00000015211","1",523608093,523608837,744
"11203","ENSMODG00000015212","2",192429418,192472459,43041
"11204","ENSMODG00000015213","6",168560590,169018196,457606
"11205","ENSMODG00000015214","1",523331034,523393975,62941
"11206","ENSMODG00000015215","2",267927543,267938815,11272
"11207","ENSMODG00000015216","7",171841711,171864300,22589
"11208","ENSMODG00000015217","1",523230405,523304756,74351
"11209","ENSMODG00000015219","7",171879212,171891769,12557
"11210","ENSMODG00000015221","3",508963145,509034129,70984
"11211","ENSMODG00000015222","8",292568973,292640549,71576
"11212","ENSMODG00000015223","3",526144328,526152765,8437
"11213","ENSMODG00000015224","8",187232646,187239914,7268
"11214","ENSMODG00000015225","6",168322851,168441328,118477
"11215","ENSMODG00000015226","3",508920913,508936028,15115
"11216","ENSMODG00000015227","8",292764113,292792743,28630
"11217","ENSMODG00000015228","1",523091586,523227337,135751
"11218","ENSMODG00000015229","8",187226902,187230594,3692
"11219","ENSMODG00000015230","2",267908788,267924657,15869
"11220","ENSMODG00000015231","3",508763936,508904849,140913
"11221","ENSMODG00000015233","8",187219644,187224214,4570
"11222","ENSMODG00000015235","8",186992597,187019453,26856
"11223","ENSMODG00000015236","7",173318298,173338696,20398
"11224","ENSMODG00000015238","6",168138839,168314257,175418
"11225","ENSMODG00000015240","2",267897897,267903480,5583
"11226","ENSMODG00000015241","8",293448643,293487734,39091
"11227","ENSMODG00000015242","1",388245416,388246453,1037
"11228","ENSMODG00000015244","2",267894195,267896040,1845
"11229","ENSMODG00000015245","8",293657724,293854257,196533
"11230","ENSMODG00000015246","8",185814745,186837921,1023176
"11231","ENSMODG00000015247","X",35567216,35817827,250611
"11232","ENSMODG00000015248","8",293877241,293898601,21360
"11233","ENSMODG00000015249","7",173342760,173352226,9466
"11234","ENSMODG00000015250","8",293939558,294169187,229629
"11235","ENSMODG00000015252","2",267741427,267893686,152259
"11236","ENSMODG00000015255","8",294204219,294262907,58688
"11237","ENSMODG00000015256","2",267888708,267891130,2422
"11238","ENSMODG00000015257","3",508441009,508615259,174250
"11239","ENSMODG00000015258","7",172028535,172059945,31410
"11240","ENSMODG00000015259","X",35482452,35518447,35995
"11241","ENSMODG00000015260","7",173383669,173393173,9504
"11242","ENSMODG00000015261","1",523003602,523039961,36359
"11243","ENSMODG00000015262","8",294297645,294305192,7547
"11244","ENSMODG00000015263","3",464584802,464626610,41808
"11245","ENSMODG00000015264","X",35286978,35288237,1259
"11246","ENSMODG00000015265","2",267876281,267886839,10558
"11247","ENSMODG00000015266","1",522975137,522988104,12967
"11248","ENSMODG00000015268","X",34349023,34781668,432645
"11249","ENSMODG00000015269","3",508415143,508426076,10933
"11250","ENSMODG00000015270","8",294316988,294346034,29046
"11251","ENSMODG00000015271","1",522924889,522965927,41038
"11252","ENSMODG00000015272","3",464643703,464682970,39267
"11253","ENSMODG00000015273","8",294428816,294433570,4754
"11254","ENSMODG00000015274","3",508205555,508278348,72793
"11255","ENSMODG00000015275","8",294436101,294473151,37050
"11256","ENSMODG00000015276","7",173394002,173399844,5842
"11257","ENSMODG00000015277","2",267844632,267859454,14822
"11258","ENSMODG00000015278","1",522841064,522858637,17573
"11259","ENSMODG00000015279","3",507855146,507878537,23391
"11260","ENSMODG00000015281","3",464780994,464802418,21424
"11261","ENSMODG00000015283","3",507581645,507824849,243204
"11262","ENSMODG00000015284","8",294496993,294515922,18929
"11263","ENSMODG00000015285","7",173400668,173405085,4417
"11264","ENSMODG00000015286","1",522753106,522823137,70031
"11265","ENSMODG00000015287","2",267804739,267817191,12452
"11266","ENSMODG00000015289","1",522712629,522734124,21495
"11267","ENSMODG00000015290","8",294676404,294701152,24748
"11268","ENSMODG00000015291","2",267802317,267804655,2338
"11269","ENSMODG00000015293","6",167667672,167734216,66544
"11270","ENSMODG00000015294","2",267755254,267756159,905
"11271","ENSMODG00000015295","X",34087355,34224886,137531
"11272","ENSMODG00000015296","6",167585847,167657995,72148
"11273","ENSMODG00000015297","X",33499929,33780788,280859
"11274","ENSMODG00000015298","2",267752199,267754389,2190
"11275","ENSMODG00000015300","7",172060705,172074933,14228
"11276","ENSMODG00000015302","7",173407526,173412729,5203
"11277","ENSMODG00000015303","8",294739849,294772135,32286
"11278","ENSMODG00000015304","X",33132078,33233381,101303
"11279","ENSMODG00000015306","8",294776256,294785263,9007
"11280","ENSMODG00000015307","Un",60585795,60603433,17638
"11281","ENSMODG00000015308","X",32969333,32990393,21060
"11282","ENSMODG00000015309","3",506780198,506827003,46805
"11283","ENSMODG00000015310","8",294794018,294836902,42884
"11284","ENSMODG00000015311","8",294848812,294920568,71756
"11285","ENSMODG00000015312","8",183231284,183355993,124709
"11286","ENSMODG00000015313","7",173414215,173425929,11714
"11287","ENSMODG00000015316","8",183088620,183112645,24025
"11288","ENSMODG00000015317","2",267735175,267748357,13182
"11289","ENSMODG00000015320","X",32829986,32887286,57300
"11290","ENSMODG00000015321","8",295060577,295190163,129586
"11291","ENSMODG00000015322","7",173450140,173456629,6489
"11292","ENSMODG00000015323","X",32790565,32854622,64057
"11293","ENSMODG00000015324","6",167499934,167561239,61305
"11294","ENSMODG00000015328","7",173458220,173462235,4015
"11295","ENSMODG00000015330","8",295437572,295544537,106965
"11296","ENSMODG00000015333","3",465938299,466168584,230285
"11297","ENSMODG00000015334","7",173463765,173470238,6473
"11298","ENSMODG00000015335","8",295740844,296234971,494127
"11299","ENSMODG00000015336","X",32624341,32625267,926
"11300","ENSMODG00000015337","3",506527731,506670964,143233
"11301","ENSMODG00000015338","7",173470561,173605168,134607
"11302","ENSMODG00000015339","7",173621785,173630734,8949
"11303","ENSMODG00000015340","1",727326021,727332130,6109
"11304","ENSMODG00000015342","3",466428522,466437753,9231
"11305","ENSMODG00000015344","6",167317046,167500046,183000
"11306","ENSMODG00000015345","1",727317949,727319706,1757
"11307","ENSMODG00000015346","3",506520625,506531984,11359
"11308","ENSMODG00000015347","1",727234595,727236038,1443
"11309","ENSMODG00000015348","7",173682906,173724090,41184
"11310","ENSMODG00000015349","6",167163886,167221527,57641
"11311","ENSMODG00000015350","3",506443117,506465484,22367
"11312","ENSMODG00000015352","6",167082640,167119085,36445
"11313","ENSMODG00000015353","6",166966477,167017407,50930
"11314","ENSMODG00000015354","7",173751916,173756622,4706
"11315","ENSMODG00000015355","3",466442141,466454445,12304
"11316","ENSMODG00000015356","3",506398479,506433310,34831
"11317","ENSMODG00000015357","6",166920204,166934583,14379
"11318","ENSMODG00000015359","7",173790899,173791978,1079
"11319","ENSMODG00000015360","3",506383995,506396391,12396
"11320","ENSMODG00000015361","7",173825605,173850069,24464
"11321","ENSMODG00000015362","3",505694334,506042224,347890
"11322","ENSMODG00000015364","7",173857282,173887036,29754
"11323","ENSMODG00000015367","1",522564410,522710840,146430
"11324","ENSMODG00000015369","7",173906929,173918837,11908
"11325","ENSMODG00000015370","8",181971036,181983855,12819
"11326","ENSMODG00000015371","8",181920805,181928465,7660
"11327","ENSMODG00000015372","7",173926961,173963838,36877
"11328","ENSMODG00000015373","6",166784920,166909591,124671
"11329","ENSMODG00000015374","8",181895011,181895838,827
"11330","ENSMODG00000015375","7",173983750,174012229,28479
"11331","ENSMODG00000015376","1",522397466,522557451,159985
"11332","ENSMODG00000015377","6",166610152,166721841,111689
"11333","ENSMODG00000015378","8",181720054,181821008,100954
"11334","ENSMODG00000015379","8",181676661,181692929,16268
"11335","ENSMODG00000015380","3",505378169,505523356,145187
"11336","ENSMODG00000015381","6",166457760,166490165,32405
"11337","ENSMODG00000015382","1",522183780,522363697,179917
"11338","ENSMODG00000015383","8",181624119,181658546,34427
"11339","ENSMODG00000015384","8",181579661,181589655,9994
"11340","ENSMODG00000015385","6",166422856,166452542,29686
"11341","ENSMODG00000015386","3",505217964,505357128,139164
"11342","ENSMODG00000015388","7",174037116,174056625,19509
"11343","ENSMODG00000015389","8",181461048,181545198,84150
"11344","ENSMODG00000015390","1",522019592,522095596,76004
"11345","ENSMODG00000015392","3",505098195,505212317,114122
"11346","ENSMODG00000015393","X",32318912,32325565,6653
"11347","ENSMODG00000015395","1",521777581,522014200,236619
"11348","ENSMODG00000015396","X",32026607,32027998,1391
"11349","ENSMODG00000015397","7",174057514,174064258,6744
"11350","ENSMODG00000015399","6",166183619,166287914,104295
"11351","ENSMODG00000015400","3",504950579,505037763,87184
"11352","ENSMODG00000015401","7",174062029,174068087,6058
"11353","ENSMODG00000015402","3",504932849,504946500,13651
"11354","ENSMODG00000015403","6",165384406,166065651,681245
"11355","ENSMODG00000015404","7",174069520,174085971,16451
"11356","ENSMODG00000015406","8",181009391,181114745,105354
"11357","ENSMODG00000015407","7",174084928,174101234,16306
"11358","ENSMODG00000015410","6",164615797,164876499,260702
"11359","ENSMODG00000015412","6",164177059,164500661,323602
"11360","ENSMODG00000015414","7",174115496,174139392,23896
"11361","ENSMODG00000015416","X",31734323,32129100,394777
"11362","ENSMODG00000015417","6",164082820,164129640,46820
"11363","ENSMODG00000015419","Un",67263458,67275369,11911
"11364","ENSMODG00000015420","6",163718446,164057563,339117
"11365","ENSMODG00000015421","7",174145822,174210225,64403
"11366","ENSMODG00000015425","6",164015106,164016077,971
"11367","ENSMODG00000015426","X",8533359,8534316,957
"11368","ENSMODG00000015428","7",174215747,174241748,26001
"11369","ENSMODG00000015429","1",517101128,517327476,226348
"11370","ENSMODG00000015431","7",174294642,174300595,5953
"11371","ENSMODG00000015432","6",163678245,163686820,8575
"11372","ENSMODG00000015433","1",517200220,517281956,81736
"11373","ENSMODG00000015434","6",163642421,163648129,5708
"11374","ENSMODG00000015435","1",516619017,517077086,458069
"11375","ENSMODG00000015436","6",163596431,163631769,35338
"11376","ENSMODG00000015438","8",179991092,180731778,740686
"11377","ENSMODG00000015439","6",163561620,163570220,8600
"11378","ENSMODG00000015440","1",516140064,516372322,232258
"11379","ENSMODG00000015441","1",727144085,727164763,20678
"11380","ENSMODG00000015442","1",727117025,727128867,11842
"11381","ENSMODG00000015443","6",163551219,163560507,9288
"11382","ENSMODG00000015447","6",163307477,163343326,35849
"11383","ENSMODG00000015448","8",180507805,180508878,1073
"11384","ENSMODG00000015449","1",726794257,726802969,8712
"11385","ENSMODG00000015450","1",726706152,726780638,74486
"11386","ENSMODG00000015452","6",163267476,163289719,22243
"11387","ENSMODG00000015453","1",724592780,724594354,1574
"11388","ENSMODG00000015454","6",162777789,162778528,739
"11389","ENSMODG00000015456","1",724089365,725447708,1358343
"11390","ENSMODG00000015458","8",179965989,179969575,3586
"11391","ENSMODG00000015460","6",160805995,160832760,26765
"11392","ENSMODG00000015461","8",179728601,179804836,76235
"11393","ENSMODG00000015462","1",515813727,516099905,286178
"11394","ENSMODG00000015463","6",160742415,160804949,62534
"11395","ENSMODG00000015468","1",515663545,515693221,29676
"11396","ENSMODG00000015469","6",160472912,160518370,45458
"11397","ENSMODG00000015471","8",179468650,179717764,249114
"11398","ENSMODG00000015474","1",515528338,515575868,47530
"11399","ENSMODG00000015477","1",722189177,722189512,335
"11400","ENSMODG00000015478","8",178727924,178762975,35051
"11401","ENSMODG00000015479","1",515395937,515498274,102337
"11402","ENSMODG00000015480","8",178707812,178721492,13680
"11403","ENSMODG00000015481","1",515299989,515309229,9240
"11404","ENSMODG00000015482","7",174309056,174342192,33136
"11405","ENSMODG00000015483","1",515155036,515293194,138158
"11406","ENSMODG00000015484","6",160319120,160461084,141964
"11407","ENSMODG00000015485","1",719313942,719348505,34563
"11408","ENSMODG00000015486","8",178221955,178658361,436406
"11409","ENSMODG00000015487","3",466457853,466701222,243369
"11410","ENSMODG00000015489","1",515104579,515106171,1592
"11411","ENSMODG00000015490","8",178148819,178197039,48220
"11412","ENSMODG00000015492","1",514726154,514803834,77680
"11413","ENSMODG00000015494","7",174343643,174348935,5292
"11414","ENSMODG00000015495","8",177928558,178054498,125940
"11415","ENSMODG00000015496","6",160097460,160319685,222225
"11416","ENSMODG00000015497","7",174361182,174370012,8830
"11417","ENSMODG00000015499","6",159661771,159963545,301774
"11418","ENSMODG00000015500","1",514516291,514580109,63818
"11419","ENSMODG00000015501","7",174457296,174468339,11043
"11420","ENSMODG00000015503","7",174470777,174473238,2461
"11421","ENSMODG00000015504","8",174674089,174691536,17447
"11422","ENSMODG00000015505","1",514332309,514386243,53934
"11423","ENSMODG00000015506","7",174473680,174478408,4728
"11424","ENSMODG00000015507","7",174486863,174533261,46398
"11425","ENSMODG00000015508","7",174561207,174568889,7682
"11426","ENSMODG00000015510","7",174597910,174598998,1088
"11427","ENSMODG00000015511","8",174527119,174649301,122182
"11428","ENSMODG00000015512","7",174621565,174644814,23249
"11429","ENSMODG00000015513","1",514223615,514250293,26678
"11430","ENSMODG00000015514","1",513754077,514119092,365015
"11431","ENSMODG00000015515","1",513652235,513653494,1259
"11432","ENSMODG00000015516","6",159400201,159510230,110029
"11433","ENSMODG00000015518","6",159198496,159202102,3606
"11434","ENSMODG00000015519","1",513413302,513533405,120103
"11435","ENSMODG00000015521","6",159125000,159130202,5202
"11436","ENSMODG00000015522","1",513121396,513257818,136422
"11437","ENSMODG00000015523","1",512757926,512791556,33630
"11438","ENSMODG00000015524","1",512656794,512664120,7326
"11439","ENSMODG00000015525","8",174387843,174491208,103365
"11440","ENSMODG00000015526","1",577936131,577948497,12366
"11441","ENSMODG00000015527","6",159117660,159123756,6096
"11442","ENSMODG00000015529","7",174644051,174983776,339725
"11443","ENSMODG00000015531","1",511192311,511390553,198242
"11444","ENSMODG00000015533","7",176326201,176584861,258660
"11445","ENSMODG00000015535","1",511118721,511205863,87142
"11446","ENSMODG00000015536","7",176420021,176449717,29696
"11447","ENSMODG00000015537","6",159064730,159066843,2113
"11448","ENSMODG00000015538","1",511026866,511039407,12541
"11449","ENSMODG00000015539","1",510927452,511009049,81597
"11450","ENSMODG00000015540","7",176458515,176496540,38025
"11451","ENSMODG00000015541","6",159038662,159048665,10003
"11452","ENSMODG00000015542","3",52027306,52153410,126104
"11453","ENSMODG00000015544","7",176694148,176770737,76589
"11454","ENSMODG00000015545","1",510813736,510863338,49602
"11455","ENSMODG00000015546","7",176807008,176939975,132967
"11456","ENSMODG00000015547","3",52234892,52300953,66061
"11457","ENSMODG00000015548","3",52331088,52350569,19481
"11458","ENSMODG00000015551","3",466751211,466775501,24290
"11459","ENSMODG00000015555","1",719063888,719281881,217993
"11460","ENSMODG00000015556","7",176991950,177118235,126285
"11461","ENSMODG00000015558","6",159021444,159091953,70509
"11462","ENSMODG00000015559","1",510682194,510754133,71939
"11463","ENSMODG00000015560","1",718997621,719054224,56603
"11464","ENSMODG00000015561","1",718899402,718952044,52642
"11465","ENSMODG00000015562","7",177185449,177226475,41026
"11466","ENSMODG00000015563","7",177311474,177320562,9088
"11467","ENSMODG00000015564","6",158996002,158999950,3948
"11468","ENSMODG00000015566","3",466822147,466884415,62268
"11469","ENSMODG00000015567","1",718730327,718864510,134183
"11470","ENSMODG00000015568","7",177331883,177347015,15132
"11471","ENSMODG00000015570","6",158971300,158981387,10087
"11472","ENSMODG00000015571","7",177429336,177515678,86342
"11473","ENSMODG00000015572","1",510134952,510470981,336029
"11474","ENSMODG00000015573","1",718436299,718640281,203982
"11475","ENSMODG00000015575","1",510067759,510096498,28739
"11476","ENSMODG00000015576","3",466909861,466979124,69263
"11477","ENSMODG00000015579","6",158934772,158948458,13686
"11478","ENSMODG00000015580","1",509346727,509940656,593929
"11479","ENSMODG00000015581","3",467015723,467132934,117211
"11480","ENSMODG00000015583","8",174406621,174453006,46385
"11481","ENSMODG00000015586","1",509225351,509341511,116160
"11482","ENSMODG00000015587","1",509220074,509223343,3269
"11483","ENSMODG00000015589","1",509022507,509057358,34851
"11484","ENSMODG00000015590","1",509008798,509018554,9756
"11485","ENSMODG00000015591","3",468555646,469058261,502615
"11486","ENSMODG00000015592","1",508974098,509002423,28325
"11487","ENSMODG00000015593","1",718130919,718150414,19495
"11488","ENSMODG00000015594","3",53159066,53161482,2416
"11489","ENSMODG00000015595","1",718107192,718126127,18935
"11490","ENSMODG00000015598","3",469190440,469243730,53290
"11491","ENSMODG00000015599","1",718075301,718090039,14738
"11492","ENSMODG00000015600","1",508950769,508964768,13999
"11493","ENSMODG00000015601","3",469144933,469150770,5837
"11494","ENSMODG00000015602","6",158917548,158927291,9743
"11495","ENSMODG00000015603","3",469486287,469846134,359847
"11496","ENSMODG00000015604","1",717917259,717922319,5060
"11497","ENSMODG00000015605","7",178092901,178180591,87690
"11498","ENSMODG00000015606","1",717901304,717913696,12392
"11499","ENSMODG00000015607","1",717881728,717883056,1328
"11500","ENSMODG00000015608","1",508848619,508873322,24703
"11501","ENSMODG00000015610","1",508830522,508832605,2083
"11502","ENSMODG00000015612","7",178193999,178223339,29340
"11503","ENSMODG00000015616","1",717826074,717827998,1924
"11504","ENSMODG00000015617","1",508783893,508826128,42235
"11505","ENSMODG00000015619","3",469925728,469969617,43889
"11506","ENSMODG00000015620","1",508782190,508783989,1799
"11507","ENSMODG00000015621","3",54130251,54164657,34406
"11508","ENSMODG00000015622","1",717821246,717824549,3303
"11509","ENSMODG00000015624","1",717805915,717808969,3054
"11510","ENSMODG00000015625","3",470257846,470259501,1655
"11511","ENSMODG00000015627","6",158905023,158906401,1378
"11512","ENSMODG00000015628","7",178428270,178669666,241396
"11513","ENSMODG00000015629","3",54248667,54546281,297614
"11514","ENSMODG00000015631","7",178778544,178919994,141450
"11515","ENSMODG00000015632","1",717769554,717802674,33120
"11516","ENSMODG00000015633","7",179241924,179242319,395
"11517","ENSMODG00000015634","3",471826063,471922966,96903
"11518","ENSMODG00000015635","6",158893170,158898991,5821
"11519","ENSMODG00000015636","3",54569644,54630240,60596
"11520","ENSMODG00000015637","1",508772132,508781556,9424
"11521","ENSMODG00000015638","6",158868751,158870004,1253
"11522","ENSMODG00000015640","3",54663441,54717867,54426
"11523","ENSMODG00000015641","3",470664544,471721951,1057407
"11524","ENSMODG00000015642","6",158847062,158860277,13215
"11525","ENSMODG00000015643","1",717748135,717759711,11576
"11526","ENSMODG00000015644","3",54728237,54749206,20969
"11527","ENSMODG00000015645","3",472006342,472099400,93058
"11528","ENSMODG00000015646","1",508699794,508734872,35078
"11529","ENSMODG00000015647","Un",59940242,59943661,3419
"11530","ENSMODG00000015648","3",472158473,472718556,560083
"11531","ENSMODG00000015649","1",508690287,508698175,7888
"11532","ENSMODG00000015650","6",158843345,158846622,3277
"11533","ENSMODG00000015652","3",54891910,54943977,52067
"11534","ENSMODG00000015653","3",472897304,472899850,2546
"11535","ENSMODG00000015654","3",55066432,55066948,516
"11536","ENSMODG00000015656","6",158829249,158832056,2807
"11537","ENSMODG00000015657","3",474348346,474929947,581601
"11538","ENSMODG00000015658","6",158828158,158828663,505
"11539","ENSMODG00000015659","Un",60459304,60465937,6633
"11540","ENSMODG00000015661","1",508687944,508693582,5638
"11541","ENSMODG00000015662","3",54992940,55196615,203675
"11542","ENSMODG00000015663","7",180519162,180520939,1777
"11543","ENSMODG00000015664","3",55216333,55258177,41844
"11544","ENSMODG00000015665","6",158818188,158823674,5486
"11545","ENSMODG00000015669","1",508682665,508687182,4517
"11546","ENSMODG00000015670","6",158770803,158776907,6104
"11547","ENSMODG00000015671","3",55430539,55510309,79770
"11548","ENSMODG00000015672","3",475170422,475259717,89295
"11549","ENSMODG00000015673","7",243223716,243262133,38417
"11550","ENSMODG00000015674","6",158764113,158768231,4118
"11551","ENSMODG00000015676","1",508612484,508622866,10382
"11552","ENSMODG00000015677","7",243236733,243241681,4948
"11553","ENSMODG00000015678","1",508596824,508610438,13614
"11554","ENSMODG00000015679","6",158760512,158762650,2138
"11555","ENSMODG00000015680","7",243272989,243309875,36886
"11556","ENSMODG00000015681","3",475336309,475366835,30526
"11557","ENSMODG00000015682","6",158753652,158758629,4977
"11558","ENSMODG00000015683","7",180922519,181121883,199364
"11559","ENSMODG00000015684","7",243337907,243750496,412589
"11560","ENSMODG00000015685","1",508553677,508595096,41419
"11561","ENSMODG00000015687","1",508549601,508550467,866
"11562","ENSMODG00000015688","3",475428162,475518705,90543
"11563","ENSMODG00000015689","7",244382999,244696463,313464
"11564","ENSMODG00000015690","7",244430495,244438056,7561
"11565","ENSMODG00000015692","6",158745770,158753188,7418
"11566","ENSMODG00000015693","1",508476607,508529018,52411
"11567","ENSMODG00000015695","2",267719052,267734650,15598
"11568","ENSMODG00000015696","6",158739668,158742533,2865
"11569","ENSMODG00000015698","Un",5204255,5335091,130836
"11570","ENSMODG00000015699","6",158721332,158736644,15312
"11571","ENSMODG00000015701","3",55616504,55817938,201434
"11572","ENSMODG00000015702","6",158693223,158700744,7521
"11573","ENSMODG00000015703","7",244699218,244712965,13747
"11574","ENSMODG00000015704","Un",56099694,56121489,21795
"11575","ENSMODG00000015705","3",55901367,55966842,65475
"11576","ENSMODG00000015706","6",158659706,158669081,9375
"11577","ENSMODG00000015707","3",56021472,56021819,347
"11578","ENSMODG00000015709","6",158653511,158658871,5360
"11579","ENSMODG00000015710","Un",56843229,56847225,3996
"11580","ENSMODG00000015711","1",508455949,508464145,8196
"11581","ENSMODG00000015712","3",56068011,56134007,65996
"11582","ENSMODG00000015713","6",158640325,158651196,10871
"11583","ENSMODG00000015714","1",508448017,508452566,4549
"11584","ENSMODG00000015716","3",56141069,56170971,29902
"11585","ENSMODG00000015717","6",158631179,158635102,3923
"11586","ENSMODG00000015718","1",508387472,508391187,3715
"11587","ENSMODG00000015719","3",56243505,56294193,50688
"11588","ENSMODG00000015720","Un",56692697,56883944,191247
"11589","ENSMODG00000015721","6",158595904,158599839,3935
"11590","ENSMODG00000015722","1",508370845,508386213,15368
"11591","ENSMODG00000015723","6",158516701,158594703,78002
"11592","ENSMODG00000015724","3",56334267,56384813,50546
"11593","ENSMODG00000015725","1",508364341,508366308,1967
"11594","ENSMODG00000015726","1",508350775,508361794,11019
"11595","ENSMODG00000015728","3",56391896,56489444,97548
"11596","ENSMODG00000015729","8",174004536,174058565,54029
"11597","ENSMODG00000015730","1",508339349,508351281,11932
"11598","ENSMODG00000015733","7",230387494,230400939,13445
"11599","ENSMODG00000015734","3",56444541,56446433,1892
"11600","ENSMODG00000015735","8",173996673,173997181,508
"11601","ENSMODG00000015736","3",56573433,56596333,22900
"11602","ENSMODG00000015738","1",508302288,508319090,16802
"11603","ENSMODG00000015739","3",56628242,56796899,168657
"11604","ENSMODG00000015742","8",2999931,3007426,7495
"11605","ENSMODG00000015743","7",244854861,244921934,67073
"11606","ENSMODG00000015744","7",245186191,245246617,60426
"11607","ENSMODG00000015745","7",230579344,230720696,141352
"11608","ENSMODG00000015746","8",3027545,3080156,52611
"11609","ENSMODG00000015747","7",245355023,245363404,8381
"11610","ENSMODG00000015748","6",158576571,158771687,195116
"11611","ENSMODG00000015750","1",508275308,508285126,9818
"11612","ENSMODG00000015751","6",158567120,158569760,2640
"11613","ENSMODG00000015752","8",3128503,3507544,379041
"11614","ENSMODG00000015753","1",508262632,508266491,3859
"11615","ENSMODG00000015754","8",173390941,173572523,181582
"11616","ENSMODG00000015755","7",182498647,183153758,655111
"11617","ENSMODG00000015756","6",158532127,158565888,33761
"11618","ENSMODG00000015758","7",245369974,245682898,312924
"11619","ENSMODG00000015760","8",6649111,6649932,821
"11620","ENSMODG00000015761","1",508081120,508163262,82142
"11621","ENSMODG00000015762","6",158529215,158531996,2781
"11622","ENSMODG00000015763","8",7208429,7208897,468
"11623","ENSMODG00000015765","6",158501988,158516391,14403
"11624","ENSMODG00000015766","7",245844083,245908291,64208
"11625","ENSMODG00000015767","1",507906260,507929150,22890
"11626","ENSMODG00000015768","6",158493761,158494913,1152
"11627","ENSMODG00000015769","1",507723954,507782314,58360
"11628","ENSMODG00000015770","7",245937154,245988427,51273
"11629","ENSMODG00000015771","8",173124766,173329501,204735
"11630","ENSMODG00000015772","8",7276552,7347413,70861
"11631","ENSMODG00000015773","1",507554818,507666440,111622
"11632","ENSMODG00000015774","2",267650401,267652422,2021
"11633","ENSMODG00000015775","7",246061804,246083284,21480
"11634","ENSMODG00000015776","1",507524061,507548268,24207
"11635","ENSMODG00000015778","6",158409159,158442357,33198
"11636","ENSMODG00000015779","7",246093040,246109914,16874
"11637","ENSMODG00000015780","2",267643210,267644862,1652
"11638","ENSMODG00000015781","6",158235029,158367682,132653
"11639","ENSMODG00000015782","2",267640518,267641368,850
"11640","ENSMODG00000015783","6",158331185,158331608,423
"11641","ENSMODG00000015784","8",172959660,173060978,101318
"11642","ENSMODG00000015785","2",267628535,267632739,4204
"11643","ENSMODG00000015787","2",267624580,267625680,1100
"11644","ENSMODG00000015788","1",507318950,507476898,157948
"11645","ENSMODG00000015789","8",7391581,7460784,69203
"11646","ENSMODG00000015790","7",246174578,246372798,198220
"11647","ENSMODG00000015791","2",267612687,267620287,7600
"11648","ENSMODG00000015792","8",172856029,172944267,88238
"11649","ENSMODG00000015793","7",184151334,184300444,149110
"11650","ENSMODG00000015794","2",267610864,267611896,1032
"11651","ENSMODG00000015795","8",7529161,7535200,6039
"11652","ENSMODG00000015796","2",267557192,267558003,811
"11653","ENSMODG00000015797","1",507269227,507315824,46597
"11654","ENSMODG00000015798","2",267518869,267520166,1297
"11655","ENSMODG00000015800","1",507211289,507253978,42689
"11656","ENSMODG00000015801","2",267513065,267513939,874
"11657","ENSMODG00000015803","1",507127339,507138621,11282
"11658","ENSMODG00000015804","7",184419704,184465494,45790
"11659","ENSMODG00000015805","7",246631038,246772277,141239
"11660","ENSMODG00000015806","8",172487696,172793881,306185
"11661","ENSMODG00000015807","7",184577574,184596931,19357
"11662","ENSMODG00000015808","7",247550668,247641943,91275
"11663","ENSMODG00000015809","1",507084064,507118537,34473
"11664","ENSMODG00000015810","2",267432261,267439029,6768
"11665","ENSMODG00000015811","2",267419431,267422270,2839
"11666","ENSMODG00000015812","8",172366687,172419641,52954
"11667","ENSMODG00000015813","2",267405348,267410941,5593
"11668","ENSMODG00000015815","1",507010135,507074808,64673
"11669","ENSMODG00000015817","1",506992917,507006437,13520
"11670","ENSMODG00000015819","7",184667005,184713808,46803
"11671","ENSMODG00000015820","7",247665283,247716771,51488
"11672","ENSMODG00000015821","1",506841258,506940746,99488
"11673","ENSMODG00000015822","8",172096414,172258641,162227
"11674","ENSMODG00000015823","7",184731594,184858720,127126
"11675","ENSMODG00000015824","1",506680104,506741538,61434
"11676","ENSMODG00000015825","6",158202942,158226156,23214
"11677","ENSMODG00000015826","8",171889057,171934067,45010
"11678","ENSMODG00000015827","7",184862196,184880378,18182
"11679","ENSMODG00000015829","2",267387663,267402606,14943
"11680","ENSMODG00000015830","7",247719101,247875371,156270
"11681","ENSMODG00000015831","7",249184822,249185916,1094
"11682","ENSMODG00000015832","1",506449680,506612228,162548
"11683","ENSMODG00000015833","7",249490398,249493253,2855
"11684","ENSMODG00000015834","2",267384103,267385894,1791
"11685","ENSMODG00000015837","2",267200634,267202629,1995
"11686","ENSMODG00000015838","7",249570827,249755342,184515
"11687","ENSMODG00000015840","8",171398841,171484134,85293
"11688","ENSMODG00000015841","7",250265880,250269930,4050
"11689","ENSMODG00000015842","4",359555885,359698341,142456
"11690","ENSMODG00000015843","6",157749705,157885861,136156
"11691","ENSMODG00000015845","8",171090991,171186909,95918
"11692","ENSMODG00000015846","1",506034111,506373465,339354
"11693","ENSMODG00000015848","2",267141691,267154932,13241
"11694","ENSMODG00000015849","7",184898221,184985516,87295
"11695","ENSMODG00000015850","1",505710442,505778779,68337
"11696","ENSMODG00000015851","2",267132983,267139062,6079
"11697","ENSMODG00000015852","7",184999925,185133268,133343
"11698","ENSMODG00000015853","1",505581577,505594424,12847
"11699","ENSMODG00000015855","8",170143974,170151500,7526
"11700","ENSMODG00000015856","8",169709853,169831841,121988
"11701","ENSMODG00000015857","1",505434017,505559552,125535
"11702","ENSMODG00000015858","7",250271583,250397477,125894
"11703","ENSMODG00000015859","7",185158613,185326114,167501
"11704","ENSMODG00000015860","2",267103204,267117050,13846
"11705","ENSMODG00000015861","7",185863808,185864556,748
"11706","ENSMODG00000015862","2",266969736,266971159,1423
"11707","ENSMODG00000015863","8",169027034,169372822,345788
"11708","ENSMODG00000015864","7",250432346,250450048,17702
"11709","ENSMODG00000015865","2",266960557,266966849,6292
"11710","ENSMODG00000015866","4",359474451,359512560,38109
"11711","ENSMODG00000015868","7",250524568,250564633,40065
"11712","ENSMODG00000015869","1",505297146,505362187,65041
"11713","ENSMODG00000015871","8",168406209,168473679,67470
"11714","ENSMODG00000015872","7",185928323,186077946,149623
"11715","ENSMODG00000015873","2",266936869,266944631,7762
"11716","ENSMODG00000015874","4",359465991,359475158,9167
"11717","ENSMODG00000015875","2",266932914,266936599,3685
"11718","ENSMODG00000015877","7",250574185,250589172,14987
"11719","ENSMODG00000015878","2",266921183,266931353,10170
"11720","ENSMODG00000015881","4",359427861,359462549,34688
"11721","ENSMODG00000015882","7",109534476,109535277,801
"11722","ENSMODG00000015883","7",186018763,186020335,1572
"11723","ENSMODG00000015885","4",359407221,359428813,21592
"11724","ENSMODG00000015886","7",250616534,250642450,25916
"11725","ENSMODG00000015887","1",505120726,505266118,145392
"11726","ENSMODG00000015888","4",359306150,359390960,84810
"11727","ENSMODG00000015890","2",266896320,266916675,20355
"11728","ENSMODG00000015891","6",157713736,157724452,10716
"11729","ENSMODG00000015892","6",157676236,157686812,10576
"11730","ENSMODG00000015893","1",505099412,505121519,22107
"11731","ENSMODG00000015894","8",166846669,166916003,69334
"11732","ENSMODG00000015895","1",505093684,505098734,5050
"11733","ENSMODG00000015898","2",266886956,266899459,12503
"11734","ENSMODG00000015899","8",166786300,166821398,35098
"11735","ENSMODG00000015900","4",358951985,359015843,63858
"11736","ENSMODG00000015901","7",250694804,250698445,3641
"11737","ENSMODG00000015903","6",157668433,157672913,4480
"11738","ENSMODG00000015904","4",358834639,358855067,20428
"11739","ENSMODG00000015905","7",250713911,250731865,17954
"11740","ENSMODG00000015906","4",358475944,358476795,851
"11741","ENSMODG00000015907","1",504914781,505084522,169741
"11742","ENSMODG00000015908","7",250735517,250738488,2971
"11743","ENSMODG00000015909","7",250746896,250753264,6368
"11744","ENSMODG00000015910","4",358779722,358781882,2160
"11745","ENSMODG00000015911","1",504668931,504676230,7299
"11746","ENSMODG00000015912","6",157648765,157666926,18161
"11747","ENSMODG00000015913","7",250783490,250801527,18037
"11748","ENSMODG00000015914","1",504577979,504612022,34043
"11749","ENSMODG00000015916","8",166367147,166389486,22339
"11750","ENSMODG00000015917","6",157616826,157618229,1403
"11751","ENSMODG00000015918","7",186491299,186617042,125743
"11752","ENSMODG00000015919","8",166392981,166422528,29547
"11753","ENSMODG00000015920","6",157611055,157612989,1934
"11754","ENSMODG00000015921","7",250894083,250930062,35979
"11755","ENSMODG00000015922","8",166084502,166250591,166089
"11756","ENSMODG00000015923","4",358517105,358529051,11946
"11757","ENSMODG00000015924","6",157586556,157611189,24633
"11758","ENSMODG00000015925","7",250805313,250847864,42551
"11759","ENSMODG00000015926","2",266877253,266885743,8490
"11760","ENSMODG00000015927","7",250854457,250854806,349
"11761","ENSMODG00000015928","7",186616132,186666111,49979
"11762","ENSMODG00000015929","4",358492245,358501686,9441
"11763","ENSMODG00000015930","4",358161323,358321649,160326
"11764","ENSMODG00000015931","7",250859965,250872953,12988
"11765","ENSMODG00000015932","1",504381842,504457783,75941
"11766","ENSMODG00000015933","2",266867372,266876568,9196
"11767","ENSMODG00000015934","6",157499868,157514084,14216
"11768","ENSMODG00000015936","7",250879373,250893765,14392
"11769","ENSMODG00000015937","7",186735408,186783303,47895
"11770","ENSMODG00000015938","7",186783431,186786683,3252
"11771","ENSMODG00000015939","7",186800209,186801890,1681
"11772","ENSMODG00000015940","1",504365707,504382041,16334
"11773","ENSMODG00000015941","2",266850838,266866502,15664
"11774","ENSMODG00000015943","6",157464085,157495708,31623
"11775","ENSMODG00000015948","1",504243283,504333440,90157
"11776","ENSMODG00000015949","7",187263069,187264847,1778
"11777","ENSMODG00000015950","6",157405063,157431108,26045
"11778","ENSMODG00000015951","1",504289553,504290269,716
"11779","ENSMODG00000015953","2",266827962,266839812,11850
"11780","ENSMODG00000015954","7",187278027,187343071,65044
"11781","ENSMODG00000015955","4",357943972,357956228,12256
"11782","ENSMODG00000015956","4",357873305,357874093,788
"11783","ENSMODG00000015957","1",504173559,504231043,57484
"11784","ENSMODG00000015958","4",357785621,357812015,26394
"11785","ENSMODG00000015959","7",187436671,187460617,23946
"11786","ENSMODG00000015960","1",504043530,504144580,101050
"11787","ENSMODG00000015961","4",357718413,357742530,24117
"11788","ENSMODG00000015962","4",357627974,357721119,93145
"11789","ENSMODG00000015963","7",250948694,251128964,180270
"11790","ENSMODG00000015964","2",266810322,266822064,11742
"11791","ENSMODG00000015965","1",504013054,504048372,35318
"11792","ENSMODG00000015966","4",357647575,357715545,67970
"11793","ENSMODG00000015967","2",266781933,266783090,1157
"11794","ENSMODG00000015968","4",357628744,357645875,17131
"11795","ENSMODG00000015969","7",251192538,251214849,22311
"11796","ENSMODG00000015970","7",187473832,187568056,94224
"11797","ENSMODG00000015971","8",165601353,166085076,483723
"11798","ENSMODG00000015973","7",251237421,251265544,28123
"11799","ENSMODG00000015974","4",357572247,357598017,25770
"11800","ENSMODG00000015975","7",251267666,251319850,52184
"11801","ENSMODG00000015976","1",503828419,503880473,52054
"11802","ENSMODG00000015977","2",266772003,266779070,7067
"11803","ENSMODG00000015979","8",165086050,165086740,690
"11804","ENSMODG00000015980","8",164740789,164743176,2387
"11805","ENSMODG00000015982","7",188086933,188188780,101847
"11806","ENSMODG00000015983","7",251354042,251486104,132062
"11807","ENSMODG00000015984","1",503797824,503823673,25849
"11808","ENSMODG00000015986","1",503749489,503781566,32077
"11809","ENSMODG00000015987","7",188303709,188334868,31159
"11810","ENSMODG00000015988","4",357281452,357551416,269964
"11811","ENSMODG00000015989","7",230848784,231290090,441306
"11812","ENSMODG00000015990","1",503536620,503683641,147021
"11813","ENSMODG00000015991","7",188429747,188430459,712
"11814","ENSMODG00000015992","1",503404477,503499843,95366
"11815","ENSMODG00000015993","2",266547725,266589130,41405
"11816","ENSMODG00000015995","7",251512082,251591357,79275
"11817","ENSMODG00000015996","1",503336539,503373689,37150
"11818","ENSMODG00000015997","7",188517055,188551644,34589
"11819","ENSMODG00000015998","7",251591887,251592727,840
"11820","ENSMODG00000016000","4",356928435,357120046,191611
"11821","ENSMODG00000016001","7",188560129,188592940,32811
"11822","ENSMODG00000016002","7",251595717,251673939,78222
"11823","ENSMODG00000016004","2",266506355,266522733,16378
"11824","ENSMODG00000016005","7",188741137,188984847,243710
"11825","ENSMODG00000016006","4",356739191,356796535,57344
"11826","ENSMODG00000016009","7",189317518,189318309,791
"11827","ENSMODG00000016010","4",356694968,356711743,16775
"11828","ENSMODG00000016011","8",160665529,160696844,31315
"11829","ENSMODG00000016012","7",189338930,189342428,3498
"11830","ENSMODG00000016014","6",157169197,157232622,63425
"11831","ENSMODG00000016015","8",160596833,160647833,51000
"11832","ENSMODG00000016016","1",503229393,503301169,71776
"11833","ENSMODG00000016017","2",266487127,266499319,12192
"11834","ENSMODG00000016018","8",160488464,160542412,53948
"11835","ENSMODG00000016019","7",189342707,189373371,30664
"11836","ENSMODG00000016020","7",251692956,251800075,107119
"11837","ENSMODG00000016021","2",266391307,266393466,2159
"11838","ENSMODG00000016022","1",503202143,503229604,27461
"11839","ENSMODG00000016023","2",266383065,266384340,1275
"11840","ENSMODG00000016024","2",266366847,266368234,1387
"11841","ENSMODG00000016025","4",356499620,356570992,71372
"11842","ENSMODG00000016026","1",503104653,503161801,57148
"11843","ENSMODG00000016027","7",189424356,189483576,59220
"11844","ENSMODG00000016028","7",189672798,189674336,1538
"11845","ENSMODG00000016029","7",231315861,231348992,33131
"11846","ENSMODG00000016030","2",266311039,266330541,19502
"11847","ENSMODG00000016031","1",502836379,503035423,199044
"11848","ENSMODG00000016032","7",231393258,231429676,36418
"11849","ENSMODG00000016033","7",251806227,251851552,45325
"11850","ENSMODG00000016034","6",157242799,157367164,124365
"11851","ENSMODG00000016036","2",266262071,266286714,24643
"11852","ENSMODG00000016037","6",157236939,157240426,3487
"11853","ENSMODG00000016038","6",157151691,157169530,17839
"11854","ENSMODG00000016039","1",503076115,503098412,22297
"11855","ENSMODG00000016040","8",160115137,160341535,226398
"11856","ENSMODG00000016041","7",251908532,251919505,10973
"11857","ENSMODG00000016042","6",156756565,157097621,341056
"11858","ENSMODG00000016044","7",251948070,252025910,77840
"11859","ENSMODG00000016045","2",266210634,266211208,574
"11860","ENSMODG00000016047","1",503068241,503072288,4047
"11861","ENSMODG00000016051","4",356360432,356467480,107048
"11862","ENSMODG00000016052","7",189781596,189934324,152728
"11863","ENSMODG00000016054","6",157117533,157147906,30373
"11864","ENSMODG00000016055","8",159958333,160076643,118310
"11865","ENSMODG00000016056","1",503042095,503057652,15557
"11866","ENSMODG00000016058","2",266140558,266141848,1290
"11867","ENSMODG00000016059","7",231732749,231892253,159504
"11868","ENSMODG00000016060","1",502795343,502797066,1723
"11869","ENSMODG00000016061","7",231871391,231872210,819
"11870","ENSMODG00000016062","7",231871433,231872201,768
"11871","ENSMODG00000016063","6",157020893,157056253,35360
"11872","ENSMODG00000016064","2",266111494,266112471,977
"11873","ENSMODG00000016065","7",231911793,231933646,21853
"11874","ENSMODG00000016066","6",157005879,157015289,9410
"11875","ENSMODG00000016067","1",502781926,502791589,9663
"11876","ENSMODG00000016068","6",156994014,156998008,3994
"11877","ENSMODG00000016070","7",231946429,231972919,26490
"11878","ENSMODG00000016071","1",502711809,502712690,881
"11879","ENSMODG00000016073","2",266090535,266091497,962
"11880","ENSMODG00000016075","7",252090929,252120526,29597
"11881","ENSMODG00000016076","7",232048645,232105442,56797
"11882","ENSMODG00000016077","6",156921083,156924066,2983
"11883","ENSMODG00000016078","4",356124602,356174849,50247
"11884","ENSMODG00000016079","7",252130788,252133689,2901
"11885","ENSMODG00000016081","1",502657001,502687896,30895
"11886","ENSMODG00000016082","4",356070725,356087686,16961
"11887","ENSMODG00000016083","1",48608377,48651423,43046
"11888","ENSMODG00000016086","7",232131213,232186310,55097
"11889","ENSMODG00000016088","7",232197994,232198995,1001
"11890","ENSMODG00000016089","1",502617573,502622660,5087
"11891","ENSMODG00000016090","2",266017425,266018450,1025
"11892","ENSMODG00000016091","6",156934180,156943596,9416
"11893","ENSMODG00000016092","4",355487476,355543219,55743
"11894","ENSMODG00000016093","6",156929788,156931183,1395
"11895","ENSMODG00000016095","6",156916985,156920842,3857
"11896","ENSMODG00000016096","7",232236718,232279443,42725
"11897","ENSMODG00000016098","7",232321693,232335624,13931
"11898","ENSMODG00000016099","1",502554613,502575578,20965
"11899","ENSMODG00000016100","6",156905238,156911826,6588
"11900","ENSMODG00000016101","4",355369870,355430840,60970
"11901","ENSMODG00000016102","7",232396755,232411723,14968
"11902","ENSMODG00000016103","7",232421629,232441092,19463
"11903","ENSMODG00000016104","1",48271544,48373925,102381
"11904","ENSMODG00000016105","4",355261794,355269546,7752
"11905","ENSMODG00000016106","6",156511948,156579432,67484
"11906","ENSMODG00000016107","7",232444993,232460313,15320
"11907","ENSMODG00000016108","6",156460228,156462060,1832
"11908","ENSMODG00000016110","6",156497558,156498241,683
"11909","ENSMODG00000016111","2",265793149,265794120,971
"11910","ENSMODG00000016112","1",48195729,48272587,76858
"11911","ENSMODG00000016114","4",354855549,355083354,227805
"11912","ENSMODG00000016115","6",156477272,156492828,15556
"11913","ENSMODG00000016119","6",156433990,156457312,23322
"11914","ENSMODG00000016120","7",232487803,232512243,24440
"11915","ENSMODG00000016121","1",502403026,502511678,108652
"11916","ENSMODG00000016122","7",232522351,232529511,7160
"11917","ENSMODG00000016123","6",156415629,156433525,17896
"11918","ENSMODG00000016125","1",47546861,47761473,214612
"11919","ENSMODG00000016127","1",47434223,47446429,12206
"11920","ENSMODG00000016129","1",502379700,502386823,7123
"11921","ENSMODG00000016131","6",156407874,156414249,6375
"11922","ENSMODG00000016132","1",47222444,47291982,69538
"11923","ENSMODG00000016133","7",233334639,233418338,83699
"11924","ENSMODG00000016134","6",156405554,156407659,2105
"11925","ENSMODG00000016135","1",47300688,47323750,23062
"11926","ENSMODG00000016137","1",502356377,502375436,19059
"11927","ENSMODG00000016138","4",354693765,354778193,84428
"11928","ENSMODG00000016140","6",156399145,156400212,1067
"11929","ENSMODG00000016141","7",233585791,233762582,176791
"11930","ENSMODG00000016143","4",354681528,354688999,7471
"11931","ENSMODG00000016144","4",354369793,354398219,28426
"11932","ENSMODG00000016145","4",354348836,354353644,4808
"11933","ENSMODG00000016146","4",354308906,354337510,28604
"11934","ENSMODG00000016148","1",502280104,502326125,46021
"11935","ENSMODG00000016149","6",156309342,156396489,87147
"11936","ENSMODG00000016152","1",502115826,502269795,153969
"11937","ENSMODG00000016153","6",156287326,156299570,12244
"11938","ENSMODG00000016154","6",156154945,156284364,129419
"11939","ENSMODG00000016155","2",265260750,265262004,1254
"11940","ENSMODG00000016160","6",155925075,156151656,226581
"11941","ENSMODG00000016162","1",501676299,501978798,302499
"11942","ENSMODG00000016163","6",155950096,156011065,60969
"11943","ENSMODG00000016164","6",155892879,155925693,32814
"11944","ENSMODG00000016165","1",501648762,501665565,16803
"11945","ENSMODG00000016166","Un",54180648,54212381,31733
"11946","ENSMODG00000016167","1",501542926,501577541,34615
"11947","ENSMODG00000016168","1",501519203,501526089,6886
"11948","ENSMODG00000016171","Un",50634563,50636816,2253
"11949","ENSMODG00000016172","1",501493475,501506676,13201
"11950","ENSMODG00000016174","6",155835269,155841161,5892
"11951","ENSMODG00000016175","6",155811883,155816774,4891
"11952","ENSMODG00000016176","1",501473699,501495987,22288
"11953","ENSMODG00000016177","1",501374999,501387594,12595
"11954","ENSMODG00000016178","1",501312324,501321675,9351
"11955","ENSMODG00000016179","6",155741763,155788820,47057
"11956","ENSMODG00000016180","1",501248691,501281333,32642
"11957","ENSMODG00000016181","1",501262061,501264398,2337
"11958","ENSMODG00000016183","6",155716431,155728004,11573
"11959","ENSMODG00000016185","6",155671255,155671793,538
"11960","ENSMODG00000016186","1",501182670,501191419,8749
"11961","ENSMODG00000016187","1",501098126,501113339,15213
"11962","ENSMODG00000016188","6",155524426,155669054,144628
"11963","ENSMODG00000016189","1",501088345,501098690,10345
"11964","ENSMODG00000016190","1",500942573,500951447,8874
"11965","ENSMODG00000016191","1",500924831,500932987,8156
"11966","ENSMODG00000016192","6",155510433,155519744,9311
"11967","ENSMODG00000016193","6",155507384,155511115,3731
"11968","ENSMODG00000016194","1",500781456,500915748,134292
"11969","ENSMODG00000016195","6",155429388,155508276,78888
"11970","ENSMODG00000016196","1",500758992,500776211,17219
"11971","ENSMODG00000016198","1",500729292,500755017,25725
"11972","ENSMODG00000016199","6",155386083,155402937,16854
"11973","ENSMODG00000016200","1",500702891,500722759,19868
"11974","ENSMODG00000016201","6",155279105,155292611,13506
"11975","ENSMODG00000016202","1",500539413,500602855,63442
"11976","ENSMODG00000016203","1",500521550,500525457,3907
"11977","ENSMODG00000016205","1",500479013,500497290,18277
"11978","ENSMODG00000016206","1",500417532,500418665,1133
"11979","ENSMODG00000016207","1",500211521,500384826,173305
"11980","ENSMODG00000016208","6",155218166,155223256,5090
"11981","ENSMODG00000016209","1",500364975,500365544,569
"11982","ENSMODG00000016210","1",500243294,500276138,32844
"11983","ENSMODG00000016211","1",500220639,500233053,12414
"11984","ENSMODG00000016212","7",234539197,234663073,123876
"11985","ENSMODG00000016213","7",190022245,191132194,1109949
"11986","ENSMODG00000016214","Un",50592819,50601299,8480
"11987","ENSMODG00000016215","7",234738031,234757046,19015
"11988","ENSMODG00000016216","1",500143609,500386608,242999
"11989","ENSMODG00000016217","Un",50315370,50339993,24623
"11990","ENSMODG00000016218","Un",50352557,50356053,3496
"11991","ENSMODG00000016219","1",500106311,500119851,13540
"11992","ENSMODG00000016220","1",500056469,500059623,3154
"11993","ENSMODG00000016221","1",500022625,500044027,21402
"11994","ENSMODG00000016222","7",234887840,234918151,30311
"11995","ENSMODG00000016223","1",499967390,499979050,11660
"11996","ENSMODG00000016224","1",499901914,499963950,62036
"11997","ENSMODG00000016225","1",499877963,499883723,5760
"11998","ENSMODG00000016226","7",235012258,235049602,37344
"11999","ENSMODG00000016227","1",499851210,499853397,2187
"12000","ENSMODG00000016228","1",499759119,499834010,74891
"12001","ENSMODG00000016230","7",192248040,192350169,102129
"12002","ENSMODG00000016232","1",499695394,499702521,7127
"12003","ENSMODG00000016233","1",499168273,499400939,232666
"12004","ENSMODG00000016234","7",192401580,192443649,42069
"12005","ENSMODG00000016237","7",192733312,192842750,109438
"12006","ENSMODG00000016238","1",499040534,499159583,119049
"12007","ENSMODG00000016240","6",141413907,141416243,2336
"12008","ENSMODG00000016241","6",141427474,141428418,944
"12009","ENSMODG00000016242","6",141452465,141453403,938
"12010","ENSMODG00000016243","1",498638022,498681989,43967
"12011","ENSMODG00000016244","7",192841823,192967138,125315
"12012","ENSMODG00000016246","8",159833412,159928549,95137
"12013","ENSMODG00000016247","1",498495466,498632525,137059
"12014","ENSMODG00000016248","7",235167357,235284791,117434
"12015","ENSMODG00000016251","6",141794603,141795968,1365
"12016","ENSMODG00000016253","2",432131909,432701119,569210
"12017","ENSMODG00000016254","6",141815619,141816560,941
"12018","ENSMODG00000016255","7",193047974,193124330,76356
"12019","ENSMODG00000016256","6",141967351,141968313,962
"12020","ENSMODG00000016257","6",141992633,142007982,15349
"12021","ENSMODG00000016258","1",497495601,497706364,210763
"12022","ENSMODG00000016259","7",235298644,235332332,33688
"12023","ENSMODG00000016264","7",237122139,237229046,106907
"12024","ENSMODG00000016265","7",237739590,237742490,2900
"12025","ENSMODG00000016266","6",142009528,142162329,152801
"12026","ENSMODG00000016267","1",497258992,497379358,120366
"12027","ENSMODG00000016268","7",193165553,193335588,170035
"12028","ENSMODG00000016269","1",497132713,497207762,75049
"12029","ENSMODG00000016271","6",142436838,142439104,2266
"12030","ENSMODG00000016272","7",193441410,193510439,69029
"12031","ENSMODG00000016273","7",237850947,237951197,100250
"12032","ENSMODG00000016274","6",142620538,142847600,227062
"12033","ENSMODG00000016275","7",193516246,193546388,30142
"12034","ENSMODG00000016276","1",497064265,497126489,62224
"12035","ENSMODG00000016277","6",142961773,142982905,21132
"12036","ENSMODG00000016278","6",142986812,143050300,63488
"12037","ENSMODG00000016279","7",193576117,193616088,39971
"12038","ENSMODG00000016281","6",143009996,143011514,1518
"12039","ENSMODG00000016282","6",143076106,143255519,179413
"12040","ENSMODG00000016284","7",193624492,193739352,114860
"12041","ENSMODG00000016285","1",497025478,497043257,17779
"12042","ENSMODG00000016286","7",241901432,241919831,18399
"12043","ENSMODG00000016287","7",193828740,194037603,208863
"12044","ENSMODG00000016289","6",143274718,143331446,56728
"12045","ENSMODG00000016290","1",497009952,497027413,17461
"12046","ENSMODG00000016292","1",496905751,496942694,36943
"12047","ENSMODG00000016293","6",143296070,143296695,625
"12048","ENSMODG00000016294","7",194104252,194136286,32034
"12049","ENSMODG00000016295","1",496741894,496868672,126778
"12050","ENSMODG00000016296","7",242146531,242172945,26414
"12051","ENSMODG00000016297","7",242280522,242461717,181195
"12052","ENSMODG00000016298","1",496667852,496720738,52886
"12053","ENSMODG00000016299","7",194186293,194227426,41133
"12054","ENSMODG00000016300","6",143348772,143469844,121072
"12055","ENSMODG00000016301","1",496405637,496508854,103217
"12056","ENSMODG00000016303","6",143487424,143590938,103514
"12057","ENSMODG00000016304","1",496147556,496290408,142852
"12058","ENSMODG00000016305","6",143648527,143694853,46326
"12059","ENSMODG00000016307","1",496118951,496138258,19307
"12060","ENSMODG00000016308","1",496070499,496085252,14753
"12061","ENSMODG00000016309","1",496042069,496050216,8147
"12062","ENSMODG00000016310","7",194414625,194416340,1715
"12063","ENSMODG00000016311","6",144076457,144533891,457434
"12064","ENSMODG00000016312","1",495810595,495850624,40029
"12065","ENSMODG00000016313","7",242418923,242428156,9233
"12066","ENSMODG00000016314","1",495759520,495759924,404
"12067","ENSMODG00000016315","6",144582755,144716896,134141
"12068","ENSMODG00000016316","8",159801276,159836502,35226
"12069","ENSMODG00000016318","6",145031037,145070715,39678
"12070","ENSMODG00000016320","7",242602404,242674051,71647
"12071","ENSMODG00000016323","Un",92465284,92466453,1169
"12072","ENSMODG00000016324","7",242784579,242785748,1169
"12073","ENSMODG00000016325","7",242831678,242833021,1343
"12074","ENSMODG00000016326","7",194631404,194728620,97216
"12075","ENSMODG00000016327","1",495217320,495235421,18101
"12076","ENSMODG00000016329","7",194779976,194876640,96664
"12077","ENSMODG00000016330","8",159646083,159678975,32892
"12078","ENSMODG00000016332","7",194891725,194901734,10009
"12079","ENSMODG00000016334","7",242859415,243021928,162513
"12080","ENSMODG00000016335","1",495067931,495143944,76013
"12081","ENSMODG00000016340","Un",43355979,43356525,546
"12082","ENSMODG00000016342","8",159615734,159630041,14307
"12083","ENSMODG00000016344","4",408917002,409050182,133180
"12084","ENSMODG00000016345","1",495007521,495067827,60306
"12085","ENSMODG00000016347","1",494894875,494911600,16725
"12086","ENSMODG00000016348","6",145136768,145440912,304144
"12087","ENSMODG00000016350","1",494610152,494757025,146873
"12088","ENSMODG00000016351","1",42491982,43619299,1127317
"12089","ENSMODG00000016352","6",145451904,145460851,8947
"12090","ENSMODG00000016353","8",159517389,159577470,60081
"12091","ENSMODG00000016355","6",145465765,145482040,16275
"12092","ENSMODG00000016356","1",494696670,494720977,24307
"12093","ENSMODG00000016357","6",145491981,145531895,39914
"12094","ENSMODG00000016358","1",494575692,494597443,21751
"12095","ENSMODG00000016359","8",159407424,159429818,22394
"12096","ENSMODG00000016361","8",159386458,159404189,17731
"12097","ENSMODG00000016363","1",493818687,493975880,157193
"12098","ENSMODG00000016364","6",145558751,145680236,121485
"12099","ENSMODG00000016367","8",158954982,159387220,432238
"12100","ENSMODG00000016368","8",159267866,159269219,1353
"12101","ENSMODG00000016370","8",159135994,159136314,320
"12102","ENSMODG00000016371","6",145611275,145613296,2021
"12103","ENSMODG00000016372","Un",2617998,2856045,238047
"12104","ENSMODG00000016373","6",145687710,145690121,2411
"12105","ENSMODG00000016375","6",145694300,145738138,43838
"12106","ENSMODG00000016376","8",158922528,158954918,32390
"12107","ENSMODG00000016377","6",145775157,145797417,22260
"12108","ENSMODG00000016378","8",158710879,158876670,165791
"12109","ENSMODG00000016379","Un",48558417,48562752,4335
"12110","ENSMODG00000016380","6",145810354,145870748,60394
"12111","ENSMODG00000016381","1",493591313,493735552,144239
"12112","ENSMODG00000016382","6",145960165,146145636,185471
"12113","ENSMODG00000016383","Un",48585275,48600742,15467
"12114","ENSMODG00000016386","8",158518716,158565198,46482
"12115","ENSMODG00000016387","1",493537180,493554982,17802
"12116","ENSMODG00000016388","8",158313605,158314444,839
"12117","ENSMODG00000016390","1",493177781,493201285,23504
"12118","ENSMODG00000016391","1",492081470,492140827,59357
"12119","ENSMODG00000016392","1",491752186,491771271,19085
"12120","ENSMODG00000016393","Un",48601701,48622868,21167
"12121","ENSMODG00000016394","2",520270488,520272777,2289
"12122","ENSMODG00000016396","6",146232133,146397071,164938
"12123","ENSMODG00000016400","1",491134495,491156903,22408
"12124","ENSMODG00000016401","1",491062027,491131871,69844
"12125","ENSMODG00000016402","6",146480363,146542205,61842
"12126","ENSMODG00000016405","1",490610820,490791965,181145
"12127","ENSMODG00000016406","6",146544766,146553388,8622
"12128","ENSMODG00000016407","1",489124564,489125341,777
"12129","ENSMODG00000016410","1",488431466,488438452,6986
"12130","ENSMODG00000016412","6",146612698,146670076,57378
"12131","ENSMODG00000016414","6",146718807,146761886,43079
"12132","ENSMODG00000016415","4",237532412,237532882,470
"12133","ENSMODG00000016417","Un",42694087,42722945,28858
"12134","ENSMODG00000016420","6",146766462,146814812,48350
"12135","ENSMODG00000016421","1",41981798,41986954,5156
"12136","ENSMODG00000016422","6",146856963,146909600,52637
"12137","ENSMODG00000016424","Un",47472774,47486807,14033
"12138","ENSMODG00000016425","6",146984101,147002294,18193
"12139","ENSMODG00000016428","6",147067767,147068711,944
"12140","ENSMODG00000016430","1",488142241,488143636,1395
"12141","ENSMODG00000016431","6",147196608,147198268,1660
"12142","ENSMODG00000016432","1",487967702,488246697,278995
"12143","ENSMODG00000016433","4",388834946,388846218,11272
"12144","ENSMODG00000016434","Un",44205776,44219779,14003
"12145","ENSMODG00000016435","1",487920642,487940853,20211
"12146","ENSMODG00000016436","1",487912092,487921327,9235
"12147","ENSMODG00000016437","4",388901735,388916309,14574
"12148","ENSMODG00000016438","4",389220339,389260617,40278
"12149","ENSMODG00000016439","1",487833893,487876029,42136
"12150","ENSMODG00000016441","1",487791517,487799334,7817
"12151","ENSMODG00000016442","1",487734866,487825558,90692
"12152","ENSMODG00000016443","6",147225440,147233245,7805
"12153","ENSMODG00000016444","4",389290413,389301542,11129
"12154","ENSMODG00000016445","1",487628482,487637957,9475
"12155","ENSMODG00000016447","4",389351978,389352566,588
"12156","ENSMODG00000016448","1",486733745,486836956,103211
"12157","ENSMODG00000016449","4",389372597,389408866,36269
"12158","ENSMODG00000016450","4",389418756,389419628,872
"12159","ENSMODG00000016452","4",389519959,389533595,13636
"12160","ENSMODG00000016453","6",147292177,147318338,26161
"12161","ENSMODG00000016454","1",486537345,486581114,43769
"12162","ENSMODG00000016457","6",147388593,147389309,716
"12163","ENSMODG00000016458","1",486450289,486486040,35751
"12164","ENSMODG00000016459","Un",27416047,27423102,7055
"12165","ENSMODG00000016461","6",147533721,147543912,10191
"12166","ENSMODG00000016462","6",147648765,147665261,16496
"12167","ENSMODG00000016463","Un",44273774,44274927,1153
"12168","ENSMODG00000016465","Un",44283327,44301282,17955
"12169","ENSMODG00000016466","6",147710498,147719592,9094
"12170","ENSMODG00000016467","Un",27561346,27595375,34029
"12171","ENSMODG00000016468","Un",27652055,27655775,3720
"12172","ENSMODG00000016469","Un",27666744,27668466,1722
"12173","ENSMODG00000016470","6",147729143,147738321,9178
"12174","ENSMODG00000016471","1",41500419,41958787,458368
"12175","ENSMODG00000016472","4",400387507,400410861,23354
"12176","ENSMODG00000016473","6",147737233,147742160,4927
"12177","ENSMODG00000016474","1",40714847,40808474,93627
"12178","ENSMODG00000016476","Un",83563516,83570269,6753
"12179","ENSMODG00000016477","1",40609013,40609282,269
"12180","ENSMODG00000016478","1",40396758,40493384,96626
"12181","ENSMODG00000016480","6",147745001,147748483,3482
"12182","ENSMODG00000016481","6",147756051,147756704,653
"12183","ENSMODG00000016484","Un",37717903,37730540,12637
"12184","ENSMODG00000016485","Un",37750043,37750557,514
"12185","ENSMODG00000016486","1",40297139,40348864,51725
"12186","ENSMODG00000016487","Un",37754275,37783965,29690
"12187","ENSMODG00000016488","7",242885476,243277184,391708
"12188","ENSMODG00000016489","1",40227306,40257578,30272
"12189","ENSMODG00000016490","1",486246718,486269180,22462
"12190","ENSMODG00000016492","1",39881032,39915657,34625
"12191","ENSMODG00000016493","Un",37787502,37842776,55274
"12192","ENSMODG00000016494","1",39729218,39786926,57708
"12193","ENSMODG00000016495","Un",23067928,23077954,10026
"12194","ENSMODG00000016498","Un",37852487,37871900,19413
"12195","ENSMODG00000016499","1",39559315,39641677,82362
"12196","ENSMODG00000016501","Un",23121027,23155642,34615
"12197","ENSMODG00000016502","Un",90139405,90145818,6413
"12198","ENSMODG00000016503","1",39698342,39724786,26444
"12199","ENSMODG00000016504","Un",91718968,91721341,2373
"12200","ENSMODG00000016507","1",39124585,39353103,228518
"12201","ENSMODG00000016509","Un",42464832,42487467,22635
"12202","ENSMODG00000016510","Un",42499978,42502467,2489
"12203","ENSMODG00000016511","Un",23282300,23283441,1141
"12204","ENSMODG00000016512","1",486167113,486175249,8136
"12205","ENSMODG00000016513","Un",23318426,23430009,111583
"12206","ENSMODG00000016514","Un",48349812,48376939,27127
"12207","ENSMODG00000016515","1",486028153,486028704,551
"12208","ENSMODG00000016516","Un",23310389,23313429,3040
"12209","ENSMODG00000016519","1",39090987,39122130,31143
"12210","ENSMODG00000016520","Un",23318961,23339136,20175
"12211","ENSMODG00000016521","1",485883387,485974243,90856
"12212","ENSMODG00000016522","Un",23346908,23354477,7569
"12213","ENSMODG00000016524","6",147832804,147841163,8359
"12214","ENSMODG00000016525","Un",23362927,23387569,24642
"12215","ENSMODG00000016528","6",147839876,147847665,7789
"12216","ENSMODG00000016529","Un",91197440,91203962,6522
"12217","ENSMODG00000016532","Un",34247435,34271765,24330
"12218","ENSMODG00000016533","6",148003765,148017398,13633
"12219","ENSMODG00000016535","2",226461611,226665384,203773
"12220","ENSMODG00000016536","6",148020499,148023188,2689
"12221","ENSMODG00000016538","Un",37553322,37651826,98504
"12222","ENSMODG00000016539","1",484848126,484878585,30459
"12223","ENSMODG00000016543","6",265716415,265717537,1122
"12224","ENSMODG00000016544","1",484799993,484819792,19799
"12225","ENSMODG00000016546","Un",28012605,28036992,24387
"12226","ENSMODG00000016547","Un",28048936,28054296,5360
"12227","ENSMODG00000016548","8",125506627,125636136,129509
"12228","ENSMODG00000016549","1",484725261,484788913,63652
"12229","ENSMODG00000016550","1",484654503,484715253,60750
"12230","ENSMODG00000016551","8",125699553,125705748,6195
"12231","ENSMODG00000016552","Un",28074436,28075700,1264
"12232","ENSMODG00000016554","8",125865403,125954701,89298
"12233","ENSMODG00000016556","Un",28087450,28092713,5263
"12234","ENSMODG00000016557","1",38814624,38836234,21610
"12235","ENSMODG00000016558","1",484388801,484410056,21255
"12236","ENSMODG00000016560","Un",28093200,28119299,26099
"12237","ENSMODG00000016561","1",38626286,38652401,26115
"12238","ENSMODG00000016562","1",484361132,484381143,20011
"12239","ENSMODG00000016563","Un",28120076,28127241,7165
"12240","ENSMODG00000016564","1",38539270,38581274,42004
"12241","ENSMODG00000016565","Un",28138938,28141130,2192
"12242","ENSMODG00000016566","1",484303169,484357348,54179
"12243","ENSMODG00000016567","1",38462755,38483575,20820
"12244","ENSMODG00000016568","6",148038427,148042371,3944
"12245","ENSMODG00000016570","7",243047850,243049013,1163
"12246","ENSMODG00000016572","1",38441901,38452645,10744
"12247","ENSMODG00000016574","Un",28142295,28148930,6635
"12248","ENSMODG00000016575","Un",52399928,52415222,15294
"12249","ENSMODG00000016576","6",148086547,148091953,5406
"12250","ENSMODG00000016577","Un",28161343,28174894,13551
"12251","ENSMODG00000016578","6",148095495,148100886,5391
"12252","ENSMODG00000016579","1",38038613,38054532,15919
"12253","ENSMODG00000016580","Un",58025976,58042947,16971
"12254","ENSMODG00000016583","1",38006653,38013944,7291
"12255","ENSMODG00000016585","Un",58026467,58032354,5887
"12256","ENSMODG00000016588","1",37961539,37997380,35841
"12257","ENSMODG00000016589","Un",28177734,28188458,10724
"12258","ENSMODG00000016590","6",148605194,148612615,7421
"12259","ENSMODG00000016591","8",126093598,126635795,542197
"12260","ENSMODG00000016593","6",148679066,148686548,7482
"12261","ENSMODG00000016594","Un",57935777,57948209,12432
"12262","ENSMODG00000016595","1",483863859,484051250,187391
"12263","ENSMODG00000016596","6",148694258,148798106,103848
"12264","ENSMODG00000016597","Un",60177902,60181822,3920
"12265","ENSMODG00000016598","1",483832749,483851326,18577
"12266","ENSMODG00000016599","Un",28200770,28267864,67094
"12267","ENSMODG00000016600","6",148805035,148915978,110943
"12268","ENSMODG00000016601","1",483828937,483834940,6003
"12269","ENSMODG00000016602","6",148962149,148968371,6222
"12270","ENSMODG00000016603","1",483783251,483789818,6567
"12271","ENSMODG00000016605","1",483767148,483771477,4329
"12272","ENSMODG00000016607","8",126402799,126406500,3701
"12273","ENSMODG00000016608","1",483755996,483763144,7148
"12274","ENSMODG00000016609","6",149109226,149112978,3752
"12275","ENSMODG00000016610","1",483522190,483571587,49397
"12276","ENSMODG00000016611","1",483415710,483448981,33271
"12277","ENSMODG00000016612","Un",28280114,28300511,20397
"12278","ENSMODG00000016614","8",126705666,126741246,35580
"12279","ENSMODG00000016615","1",482794097,482933874,139777
"12280","ENSMODG00000016617","1",482673830,482767441,93611
"12281","ENSMODG00000016618","8",126753248,126778452,25204
"12282","ENSMODG00000016619","6",149094853,149132408,37555
"12283","ENSMODG00000016620","7",260159423,260175792,16369
"12284","ENSMODG00000016621","8",126782925,126821352,38427
"12285","ENSMODG00000016623","6",149224561,149224983,422
"12286","ENSMODG00000016624","6",149149519,149280055,130536
"12287","ENSMODG00000016625","8",126835898,126848053,12155
"12288","ENSMODG00000016626","Un",60188712,60200430,11718
"12289","ENSMODG00000016627","6",149278880,149352922,74042
"12290","ENSMODG00000016628","7",260283377,260290461,7084
"12291","ENSMODG00000016629","1",482389499,482494595,105096
"12292","ENSMODG00000016631","6",149396422,149399266,2844
"12293","ENSMODG00000016633","6",149404705,149406733,2028
"12294","ENSMODG00000016635","6",149372272,149425873,53601
"12295","ENSMODG00000016636","8",127053000,127084037,31037
"12296","ENSMODG00000016637","6",149445798,149447414,1616
"12297","ENSMODG00000016639","7",260343172,260367270,24098
"12298","ENSMODG00000016640","7",260448208,260448816,608
"12299","ENSMODG00000016642","Un",54447419,54492239,44820
"12300","ENSMODG00000016643","7",260451244,260454118,2874
"12301","ENSMODG00000016644","6",149455517,149500131,44614
"12302","ENSMODG00000016647","1",301567256,301568052,796
"12303","ENSMODG00000016648","8",127235041,127281687,46646
"12304","ENSMODG00000016649","7",260468653,260474779,6126
"12305","ENSMODG00000016651","6",149542774,149634493,91719
"12306","ENSMODG00000016652","7",260481961,260485009,3048
"12307","ENSMODG00000016654","8",127388180,127440441,52261
"12308","ENSMODG00000016655","6",149636861,149659608,22747
"12309","ENSMODG00000016657","6",149675108,149695843,20735
"12310","ENSMODG00000016660","7",260485752,260527893,42141
"12311","ENSMODG00000016661","Un",58289194,58306513,17319
"12312","ENSMODG00000016662","6",149695932,149706294,10362
"12313","ENSMODG00000016663","8",127651248,127851342,200094
"12314","ENSMODG00000016664","2",192022270,192383310,361040
"12315","ENSMODG00000016665","6",149708115,149897336,189221
"12316","ENSMODG00000016666","6",149959692,149966747,7055
"12317","ENSMODG00000016667","2",192212349,192213674,1325
"12318","ENSMODG00000016669","6",149972847,149994419,21572
"12319","ENSMODG00000016671","1",732394263,732395822,1559
"12320","ENSMODG00000016672","6",150025911,150041989,16078
"12321","ENSMODG00000016673","1",735530402,735643313,112911
"12322","ENSMODG00000016674","6",150084790,150122508,37718
"12323","ENSMODG00000016675","1",478468829,478930706,461877
"12324","ENSMODG00000016676","2",192098116,192261964,163848
"12325","ENSMODG00000016677","8",128683100,128967807,284707
"12326","ENSMODG00000016678","6",150258839,150344169,85330
"12327","ENSMODG00000016680","1",735804899,735911285,106386
"12328","ENSMODG00000016682","6",150406352,150482271,75919
"12329","ENSMODG00000016683","2",192084026,192093875,9849
"12330","ENSMODG00000016684","1",478204105,478330084,125979
"12331","ENSMODG00000016685","1",736042095,736063458,21363
"12332","ENSMODG00000016686","6",150551668,150571577,19909
"12333","ENSMODG00000016687","8",129230897,129323709,92812
"12334","ENSMODG00000016688","6",150576215,150633368,57153
"12335","ENSMODG00000016690","1",478138280,478146636,8356
"12336","ENSMODG00000016691","1",736103048,736180955,77907
"12337","ENSMODG00000016692","1",478121810,478133669,11859
"12338","ENSMODG00000016694","2",192036225,192082389,46164
"12339","ENSMODG00000016695","1",30,9522,9492
"12340","ENSMODG00000016696","7",260605739,260640085,34346
"12341","ENSMODG00000016697","1",478057740,478121740,64000
"12342","ENSMODG00000016698","1",478037232,478049406,12174
"12343","ENSMODG00000016699","1",478011884,478025438,13554
"12344","ENSMODG00000016700","6",150666230,150769808,103578
"12345","ENSMODG00000016702","1",736401982,736668360,266378
"12346","ENSMODG00000016703","2",191987520,192022257,34737
"12347","ENSMODG00000016704","6",150774802,150779739,4937
"12348","ENSMODG00000016705","1",477976549,477984562,8013
"12349","ENSMODG00000016706","1",737025865,737052139,26274
"12350","ENSMODG00000016707","6",150780119,150786630,6511
"12351","ENSMODG00000016708","6",150838586,150867385,28799
"12352","ENSMODG00000016709","1",477741292,477881800,140508
"12353","ENSMODG00000016710","8",129385182,129431385,46203
"12354","ENSMODG00000016711","1",737084817,737098968,14151
"12355","ENSMODG00000016712","2",191952601,191983677,31076
"12356","ENSMODG00000016713","1",737118242,737122342,4100
"12357","ENSMODG00000016715","1",477709780,477717479,7699
"12358","ENSMODG00000016717","8",129441422,129484458,43036
"12359","ENSMODG00000016718","Un",84197637,84198734,1097
"12360","ENSMODG00000016719","2",431626284,432109353,483069
"12361","ENSMODG00000016720","8",129484743,129556515,71772
"12362","ENSMODG00000016721","1",737143674,737263368,119694
"12363","ENSMODG00000016722","Un",20755339,20799247,43908
"12364","ENSMODG00000016724","6",150932667,150951877,19210
"12365","ENSMODG00000016725","Un",20811443,20820837,9394
"12366","ENSMODG00000016726","8",129541831,129825776,283945
"12367","ENSMODG00000016728","2",431353858,431552703,198845
"12368","ENSMODG00000016729","8",129758713,129759913,1200
"12369","ENSMODG00000016731","1",737606142,737611041,4899
"12370","ENSMODG00000016732","Un",20832369,20848845,16476
"12371","ENSMODG00000016734","6",150954447,150969159,14712
"12372","ENSMODG00000016735","8",129851157,129885724,34567
"12373","ENSMODG00000016736","8",130110729,130111950,1221
"12374","ENSMODG00000016737","8",131432392,131432932,540
"12375","ENSMODG00000016739","6",150960554,150964446,3892
"12376","ENSMODG00000016740","1",737635109,737640540,5431
"12377","ENSMODG00000016745","6",150965318,150970950,5632
"12378","ENSMODG00000016748","6",150971766,150973203,1437
"12379","ENSMODG00000016749","2",191924997,191944958,19961
"12380","ENSMODG00000016750","2",431180894,431240393,59499
"12381","ENSMODG00000016751","Un",21021032,21031517,10485
"12382","ENSMODG00000016752","6",150974599,150987011,12412
"12383","ENSMODG00000016753","1",477575281,477714071,138790
"12384","ENSMODG00000016755","1",738252380,738298158,45778
"12385","ENSMODG00000016756","6",151009054,151017531,8477
"12386","ENSMODG00000016757","2",431136009,431144960,8951
"12387","ENSMODG00000016758","1",745213361,745215442,2081
"12388","ENSMODG00000016759","2",431114048,431121940,7892
"12389","ENSMODG00000016760","6",151084148,151093625,9477
"12390","ENSMODG00000016762","1",738384510,738406900,22390
"12391","ENSMODG00000016763","8",134881589,135023170,141581
"12392","ENSMODG00000016765","2",430622350,430839899,217549
"12393","ENSMODG00000016766","8",135206595,135376082,169487
"12394","ENSMODG00000016767","1",738462903,738514097,51194
"12395","ENSMODG00000016769","1",477393171,477395655,2484
"12396","ENSMODG00000016770","8",135527371,135566314,38943
"12397","ENSMODG00000016771","2",430507559,430620051,112492
"12398","ENSMODG00000016772","2",191895789,191907324,11535
"12399","ENSMODG00000016773","8",135603746,135604743,997
"12400","ENSMODG00000016774","1",477084949,477115236,30287
"12401","ENSMODG00000016777","6",151104453,151110380,5927
"12402","ENSMODG00000016778","8",135641229,135706273,65044
"12403","ENSMODG00000016779","2",191851050,191887614,36564
"12404","ENSMODG00000016780","1",739086525,739087391,866
"12405","ENSMODG00000016781","2",430000809,430031536,30727
"12406","ENSMODG00000016782","1",739116689,739126822,10133
"12407","ENSMODG00000016783","1",476312438,476387874,75436
"12408","ENSMODG00000016785","6",151111173,151134177,23004
"12409","ENSMODG00000016787","2",429722960,429847497,124537
"12410","ENSMODG00000016788","1",739261608,739265826,4218
"12411","ENSMODG00000016789","1",739304436,739307126,2690
"12412","ENSMODG00000016790","2",191789761,191794850,5089
"12413","ENSMODG00000016791","1",739441933,739448241,6308
"12414","ENSMODG00000016792","2",429501368,429598640,97272
"12415","ENSMODG00000016793","6",151120639,151159770,39131
"12416","ENSMODG00000016794","8",135794722,135906913,112191
"12417","ENSMODG00000016796","2",191783694,191789231,5537
"12418","ENSMODG00000016797","2",191774351,191779849,5498
"12419","ENSMODG00000016798","1",476049491,476196448,146957
"12420","ENSMODG00000016799","1",739581789,739597969,16180
"12421","ENSMODG00000016800","1",475926081,475927333,1252
"12422","ENSMODG00000016801","2",191740757,191751885,11128
"12423","ENSMODG00000016802","8",135916758,135975244,58486
"12424","ENSMODG00000016803","1",475824463,475831874,7411
"12425","ENSMODG00000016804","2",429434624,429490022,55398
"12426","ENSMODG00000016805","6",151162478,151193039,30561
"12427","ENSMODG00000016806","1",739646347,739755226,108879
"12428","ENSMODG00000016807","2",191671220,191680653,9433
"12429","ENSMODG00000016808","2",429401882,429422071,20189
"12430","ENSMODG00000016809","1",739767570,739778150,10580
"12431","ENSMODG00000016810","1",739815398,739824474,9076
"12432","ENSMODG00000016811","7",808091,1081760,273669
"12433","ENSMODG00000016812","2",429352735,429388134,35399
"12434","ENSMODG00000016813","6",151342446,151381529,39083
"12435","ENSMODG00000016814","1",739842306,739886863,44557
"12436","ENSMODG00000016815","2",191610548,191635599,25051
"12437","ENSMODG00000016816","1",475781737,475791599,9862
"12438","ENSMODG00000016817","2",191603480,191606256,2776
"12439","ENSMODG00000016818","2",191567312,191578048,10736
"12440","ENSMODG00000016819","2",429297318,429332265,34947
"12441","ENSMODG00000016820","8",135979120,136013798,34678
"12442","ENSMODG00000016821","2",191566495,191568886,2391
"12443","ENSMODG00000016822","2",429274365,429300240,25875
"12444","ENSMODG00000016823","1",475705401,475760397,54996
"12445","ENSMODG00000016824","8",136052921,136080545,27624
"12446","ENSMODG00000016825","2",429236864,429267595,30731
"12447","ENSMODG00000016826","8",136079932,136194496,114564
"12448","ENSMODG00000016827","1",475685223,475705255,20032
"12449","ENSMODG00000016829","2",429164971,429205514,40543
"12450","ENSMODG00000016830","2",191556382,191558531,2149
"12451","ENSMODG00000016831","2",428994984,429103214,108230
"12452","ENSMODG00000016832","1",475636399,475679766,43367
"12453","ENSMODG00000016833","8",136342879,136846817,503938
"12454","ENSMODG00000016835","1",475596414,475606192,9778
"12455","ENSMODG00000016836","2",428270333,428661992,391659
"12456","ENSMODG00000016837","8",136890379,137040684,150305
"12457","ENSMODG00000016838","1",475539019,475587768,48749
"12458","ENSMODG00000016841","8",137136904,137174532,37628
"12459","ENSMODG00000016842","1",474777907,474785470,7563
"12460","ENSMODG00000016844","1",474691312,474701329,10017
"12461","ENSMODG00000016845","1",474523737,474687015,163278
"12462","ENSMODG00000016846","1",739965393,739974000,8607
"12463","ENSMODG00000016847","2",427815703,428033961,218258
"12464","ENSMODG00000016848","1",474457126,474482769,25643
"12465","ENSMODG00000016849","2",191494587,191551161,56574
"12466","ENSMODG00000016851","8",137182471,137240241,57770
"12467","ENSMODG00000016852","1",740000462,740022014,21552
"12468","ENSMODG00000016854","8",137244866,137262713,17847
"12469","ENSMODG00000016855","1",474314634,474382877,68243
"12470","ENSMODG00000016857","7",1826286,2153793,327507
"12471","ENSMODG00000016858","8",137308622,137325701,17079
"12472","ENSMODG00000016859","6",151382432,151461413,78981
"12473","ENSMODG00000016860","1",474237498,474299621,62123
"12474","ENSMODG00000016861","2",191392370,191409742,17372
"12475","ENSMODG00000016862","2",426581238,426792792,211554
"12476","ENSMODG00000016863","1",473874905,474044037,169132
"12477","ENSMODG00000016864","8",137375414,137415255,39841
"12478","ENSMODG00000016867","2",191209986,191274733,64747
"12479","ENSMODG00000016868","1",473806819,473828239,21420
"12480","ENSMODG00000016871","1",473727854,473729605,1751
"12481","ENSMODG00000016872","2",191222436,191224192,1756
"12482","ENSMODG00000016874","2",425593492,425900386,306894
"12483","ENSMODG00000016875","8",137693538,137832229,138691
"12484","ENSMODG00000016876","7",4116175,4352123,235948
"12485","ENSMODG00000016879","2",425465909,425519760,53851
"12486","ENSMODG00000016881","1",473705923,473724141,18218
"12487","ENSMODG00000016882","6",151485553,151498355,12802
"12488","ENSMODG00000016883","2",191146137,191205748,59611
"12489","ENSMODG00000016884","2",424882583,425317812,435229
"12490","ENSMODG00000016885","7",4960029,4961593,1564
"12491","ENSMODG00000016887","1",473616008,473687248,71240
"12492","ENSMODG00000016888","2",191178384,191184184,5800
"12493","ENSMODG00000016889","1",473612481,473612962,481
"12494","ENSMODG00000016890","6",151498235,151558584,60349
"12495","ENSMODG00000016891","7",5241073,5242568,1495
"12496","ENSMODG00000016892","2",191173258,191181053,7795
"12497","ENSMODG00000016895","6",151559362,151562914,3552
"12498","ENSMODG00000016897","6",151919397,152461265,541868
"12499","ENSMODG00000016898","1",740091880,740094256,2376
"12500","ENSMODG00000016900","2",424695527,424812908,117381
"12501","ENSMODG00000016901","2",191149289,191172264,22975
"12502","ENSMODG00000016902","8",137916657,137976918,60261
"12503","ENSMODG00000016904","1",473608162,473611064,2902
"12504","ENSMODG00000016905","6",152880868,152889741,8873
"12505","ENSMODG00000016906","6",153472943,153473971,1028
"12506","ENSMODG00000016907","6",153661882,153677910,16028
"12507","ENSMODG00000016910","2",191127564,191137743,10179
"12508","ENSMODG00000016911","2",424593332,424610340,17008
"12509","ENSMODG00000016913","6",153855597,153909920,54323
"12510","ENSMODG00000016914","2",191124678,191125996,1318
"12511","ENSMODG00000016915","2",424316798,424488756,171958
"12512","ENSMODG00000016916","8",137997110,138329952,332842
"12513","ENSMODG00000016917","2",424201235,424202962,1727
"12514","ENSMODG00000016918","2",191090690,191122032,31342
"12515","ENSMODG00000016919","8",138991810,139303309,311499
"12516","ENSMODG00000016920","8",139356065,139371950,15885
"12517","ENSMODG00000016921","2",191079869,191087964,8095
"12518","ENSMODG00000016922","7",8373695,8735864,362169
"12519","ENSMODG00000016926","8",139372488,139401355,28867
"12520","ENSMODG00000016927","6",154580818,154581509,691
"12521","ENSMODG00000016928","2",191012040,191040131,28091
"12522","ENSMODG00000016929","8",139375991,139377622,1631
"12523","ENSMODG00000016930","8",139405064,139421290,16226
"12524","ENSMODG00000016932","8",139433635,139475785,42150
"12525","ENSMODG00000016933","6",154854610,155023306,168696
"12526","ENSMODG00000016934","7",9914273,9977030,62757
"12527","ENSMODG00000016936","8",139490470,139493235,2765
"12528","ENSMODG00000016937","8",139538880,139562359,23479
"12529","ENSMODG00000016939","7",10366321,10390440,24119
"12530","ENSMODG00000016940","7",10405166,10432667,27501
"12531","ENSMODG00000016943","7",11231544,11333658,102114
"12532","ENSMODG00000016944","1",740145077,740147794,2717
"12533","ENSMODG00000016945","6",155062071,155066071,4000
"12534","ENSMODG00000016946","2",190977095,191002709,25614
"12535","ENSMODG00000016947","7",11132188,11133336,1148
"12536","ENSMODG00000016949","7",11370264,11380725,10461
"12537","ENSMODG00000016950","1",740201507,740204690,3183
"12538","ENSMODG00000016951","1",740225953,740226624,671
"12539","ENSMODG00000016952","6",155120096,155122439,2343
"12540","ENSMODG00000016953","8",139562161,139621155,58994
"12541","ENSMODG00000016954","2",190928198,190937396,9198
"12542","ENSMODG00000016955","2",190908673,190927995,19322
"12543","ENSMODG00000016956","8",139911097,140026317,115220
"12544","ENSMODG00000016959","2",190904192,190907204,3012
"12545","ENSMODG00000016960","8",140032961,140339167,306206
"12546","ENSMODG00000016961","2",190889466,190902201,12735
"12547","ENSMODG00000016964","2",190870879,190877581,6702
"12548","ENSMODG00000016965","1",740446235,740450991,4756
"12549","ENSMODG00000016966","1",473540911,473577328,36417
"12550","ENSMODG00000016967","1",740575726,740590892,15166
"12551","ENSMODG00000016968","1",740772506,740774706,2200
"12552","ENSMODG00000016969","1",740803027,740821134,18107
"12553","ENSMODG00000016970","2",190820644,190834952,14308
"12554","ENSMODG00000016972","7",12624613,13023099,398486
"12555","ENSMODG00000016974","1",473438090,473490330,52240
"12556","ENSMODG00000016975","8",142789407,143026646,237239
"12557","ENSMODG00000016978","1",473394594,473422570,27976
"12558","ENSMODG00000016980","8",143584123,143586419,2296
"12559","ENSMODG00000016981","2",190765401,190783943,18542
"12560","ENSMODG00000016982","7",14138513,14221361,82848
"12561","ENSMODG00000016983","8",143957569,144263826,306257
"12562","ENSMODG00000016985","Un",60027601,60036725,9124
"12563","ENSMODG00000016986","7",14197198,14198462,1264
"12564","ENSMODG00000016988","7",14229770,14299745,69975
"12565","ENSMODG00000016989","2",190755421,190762801,7380
"12566","ENSMODG00000016990","8",145005410,145200950,195540
"12567","ENSMODG00000016991","Un",58961900,58974258,12358
"12568","ENSMODG00000016992","7",14314502,14335450,20948
"12569","ENSMODG00000016994","2",190703434,190737795,34361
"12570","ENSMODG00000016995","7",15111168,15111546,378
"12571","ENSMODG00000016998","7",15707734,15712936,5202
"12572","ENSMODG00000016999","Un",60643705,60645075,1370
"12573","ENSMODG00000017000","8",145551612,146180764,629152
"12574","ENSMODG00000017001","7",16488197,16490094,1897
"12575","ENSMODG00000017003","1",473245481,473421867,176386
"12576","ENSMODG00000017005","7",17327957,17598140,270183
"12577","ENSMODG00000017006","2",190570197,190702092,131895
"12578","ENSMODG00000017007","7",18108160,18539923,431763
"12579","ENSMODG00000017008","1",473275880,473276427,547
"12580","ENSMODG00000017010","7",18562785,18593998,31213
"12581","ENSMODG00000017011","1",473214036,473225284,11248
"12582","ENSMODG00000017013","3",501134328,501134927,599
"12583","ENSMODG00000017014","7",18697531,18756986,59455
"12584","ENSMODG00000017015","2",190565858,190574192,8334
"12585","ENSMODG00000017016","1",473195840,473210044,14204
"12586","ENSMODG00000017017","7",18759375,18792132,32757
"12587","ENSMODG00000017019","1",37905551,37946739,41188
"12588","ENSMODG00000017020","1",473097777,473181705,83928
"12589","ENSMODG00000017022","8",146676639,147343610,666971
"12590","ENSMODG00000017024","2",190421195,190447595,26400
"12591","ENSMODG00000017025","1",472888951,472918000,29049
"12592","ENSMODG00000017028","1",472837056,472883462,46406
"12593","ENSMODG00000017029","8",147583874,147686642,102768
"12594","ENSMODG00000017030","7",18810636,18867383,56747
"12595","ENSMODG00000017033","2",190132578,190324786,192208
"12596","ENSMODG00000017035","Un",100772598,100773272,674
"12597","ENSMODG00000017036","1",472771593,472795906,24313
"12598","ENSMODG00000017041","Un",51658050,51659369,1319
"12599","ENSMODG00000017043","1",472730579,472752073,21494
"12600","ENSMODG00000017044","2",190077119,190083947,6828
"12601","ENSMODG00000017045","1",472693643,472710449,16806
"12602","ENSMODG00000017050","4",431579949,431612143,32194
"12603","ENSMODG00000017051","1",472621592,472663541,41949
"12604","ENSMODG00000017052","1",472535811,472539322,3511
"12605","ENSMODG00000017053","2",189975785,189986077,10292
"12606","ENSMODG00000017054","4",431475098,431542965,67867
"12607","ENSMODG00000017056","4",431314274,431378599,64325
"12608","ENSMODG00000017058","1",472474513,472508981,34468
"12609","ENSMODG00000017060","2",189964695,189973220,8525
"12610","ENSMODG00000017062","1",472378348,472467386,89038
"12611","ENSMODG00000017064","7",19233877,19265315,31438
"12612","ENSMODG00000017065","7",19327439,19341293,13854
"12613","ENSMODG00000017066","2",189948718,189958940,10222
"12614","ENSMODG00000017067","4",431093920,431256465,162545
"12615","ENSMODG00000017068","1",472354610,472408735,54125
"12616","ENSMODG00000017070","1",472322030,472323100,1070
"12617","ENSMODG00000017073","2",189942802,189947741,4939
"12618","ENSMODG00000017074","4",430875260,431008725,133465
"12619","ENSMODG00000017075","8",148779349,148958870,179521
"12620","ENSMODG00000017076","1",471861106,472062488,201382
"12621","ENSMODG00000017077","2",189933756,189942097,8341
"12622","ENSMODG00000017078","4",430792136,430845415,53279
"12623","ENSMODG00000017079","1",37531384,37809033,277649
"12624","ENSMODG00000017081","1",471798788,471824241,25453
"12625","ENSMODG00000017082","4",430739726,430777885,38159
"12626","ENSMODG00000017083","8",149041135,149076558,35423
"12627","ENSMODG00000017084","7",19825546,19944815,119269
"12628","ENSMODG00000017085","2",189909723,189914462,4739
"12629","ENSMODG00000017086","1",471749739,471764130,14391
"12630","ENSMODG00000017087","4",430726838,430740604,13766
"12631","ENSMODG00000017088","8",149299355,149375729,76374
"12632","ENSMODG00000017089","2",189904080,189909077,4997
"12633","ENSMODG00000017090","4",430614137,430652497,38360
"12634","ENSMODG00000017091","1",37005919,37019364,13445
"12635","ENSMODG00000017093","2",189892283,189903145,10862
"12636","ENSMODG00000017094","4",430509698,430609197,99499
"12637","ENSMODG00000017095","2",189866081,189874363,8282
"12638","ENSMODG00000017096","4",430366621,430398589,31968
"12639","ENSMODG00000017097","1",36882140,36938345,56205
"12640","ENSMODG00000017098","1",36284013,36339396,55383
"12641","ENSMODG00000017099","1",35897967,36066122,168155
"12642","ENSMODG00000017100","2",189855358,189861057,5699
"12643","ENSMODG00000017101","1",471458423,471720073,261650
"12644","ENSMODG00000017102","1",35527852,35735050,207198
"12645","ENSMODG00000017103","2",189849515,189854437,4922
"12646","ENSMODG00000017104","1",35400625,35468799,68174
"12647","ENSMODG00000017105","X",24038699,24040606,1907
"12648","ENSMODG00000017106","2",189793803,189796572,2769
"12649","ENSMODG00000017107","1",35284627,35322043,37416
"12650","ENSMODG00000017108","1",34804037,34808542,4505
"12651","ENSMODG00000017109","7",19954191,20051266,97075
"12652","ENSMODG00000017110","1",34795431,34800864,5433
"12653","ENSMODG00000017111","2",189783850,189791667,7817
"12654","ENSMODG00000017112","2",189692919,189702646,9727
"12655","ENSMODG00000017113","1",471276086,471439388,163302
"12656","ENSMODG00000017114","4",430204695,430332057,127362
"12657","ENSMODG00000017115","2",189676882,189681096,4214
"12658","ENSMODG00000017116","8",149731741,149812505,80764
"12659","ENSMODG00000017118","1",471106443,471119055,12612
"12660","ENSMODG00000017119","8",150948062,150948376,314
"12661","ENSMODG00000017121","2",189663728,189675374,11646
"12662","ENSMODG00000017122","1",471071767,471084637,12870
"12663","ENSMODG00000017124","2",189643275,189662906,19631
"12664","ENSMODG00000017125","2",189629649,189644295,14646
"12665","ENSMODG00000017127","2",189625358,189629094,3736
"12666","ENSMODG00000017128","1",471026925,471059911,32986
"12667","ENSMODG00000017129","4",430054212,430083338,29126
"12668","ENSMODG00000017131","2",189600003,189605457,5454
"12669","ENSMODG00000017132","4",430031677,430047965,16288
"12670","ENSMODG00000017133","2",189592769,189597035,4266
"12671","ENSMODG00000017134","7",20123407,20332157,208750
"12672","ENSMODG00000017135","4",429876073,429877053,980
"12673","ENSMODG00000017136","7",20380835,20394102,13267
"12674","ENSMODG00000017138","4",429771965,429772741,776
"12675","ENSMODG00000017139","2",189580274,189587919,7645
"12676","ENSMODG00000017140","7",20403325,20678866,275541
"12677","ENSMODG00000017141","4",429586355,429594993,8638
"12678","ENSMODG00000017142","2",189572157,189575585,3428
"12679","ENSMODG00000017143","8",151768064,152666897,898833
"12680","ENSMODG00000017144","7",20784012,20926056,142044
"12681","ENSMODG00000017145","7",21000766,21002484,1718
"12682","ENSMODG00000017146","2",189554732,189565049,10317
"12683","ENSMODG00000017147","7",21678016,21814666,136650
"12684","ENSMODG00000017148","4",429367670,429394563,26893
"12685","ENSMODG00000017149","7",22445644,22696293,250649
"12686","ENSMODG00000017150","2",189516531,189534522,17991
"12687","ENSMODG00000017151","8",152759521,152900822,141301
"12688","ENSMODG00000017152","1",470724770,471024530,299760
"12689","ENSMODG00000017153","4",429326352,429342882,16530
"12690","ENSMODG00000017154","8",152958116,153009232,51116
"12691","ENSMODG00000017155","2",189047567,189359930,312363
"12692","ENSMODG00000017156","4",429306838,429312840,6002
"12693","ENSMODG00000017157","7",22832193,22852711,20518
"12694","ENSMODG00000017159","4",429270618,429278013,7395
"12695","ENSMODG00000017160","2",188958184,188975956,17772
"12696","ENSMODG00000017161","8",153101359,153206472,105113
"12697","ENSMODG00000017162","7",22854593,22901405,46812
"12698","ENSMODG00000017165","2",188931445,188950445,19000
"12699","ENSMODG00000017167","1",470712717,470713361,644
"12700","ENSMODG00000017168","7",22928370,22964192,35822
"12701","ENSMODG00000017169","8",153404654,153514088,109434
"12702","ENSMODG00000017170","1",470694758,470710487,15729
"12703","ENSMODG00000017171","4",429251851,429269494,17643
"12704","ENSMODG00000017172","1",470680096,470690736,10640
"12705","ENSMODG00000017174","4",429217603,429232973,15370
"12706","ENSMODG00000017175","8",153518022,153677636,159614
"12707","ENSMODG00000017176","7",22966350,23100223,133873
"12708","ENSMODG00000017178","8",153650863,153660527,9664
"12709","ENSMODG00000017179","8",153712910,153817943,105033
"12710","ENSMODG00000017180","7",23039919,23043569,3650
"12711","ENSMODG00000017181","1",470589713,470630283,40570
"12712","ENSMODG00000017183","1",34484311,34512614,28303
"12713","ENSMODG00000017184","1",470588630,470589726,1096
"12714","ENSMODG00000017185","2",188914196,188924572,10376
"12715","ENSMODG00000017187","1",470551138,470576490,25352
"12716","ENSMODG00000017189","1",470549349,470550868,1519
"12717","ENSMODG00000017190","2",188866990,188909512,42522
"12718","ENSMODG00000017191","7",23615020,23670570,55550
"12719","ENSMODG00000017192","1",470512116,470546759,34643
"12720","ENSMODG00000017193","2",188653407,188655854,2447
"12721","ENSMODG00000017194","1",470508566,470509378,812
"12722","ENSMODG00000017195","2",188784975,188866443,81468
"12723","ENSMODG00000017196","1",34309305,34470548,161243
"12724","ENSMODG00000017197","7",24197669,24227704,30035
"12725","ENSMODG00000017198","2",188751440,188819512,68072
"12726","ENSMODG00000017199","1",34170227,34245079,74852
"12727","ENSMODG00000017200","1",470492668,470507705,15037
"12728","ENSMODG00000017202","7",24227504,24254659,27155
"12729","ENSMODG00000017204","2",188658648,188683997,25349
"12730","ENSMODG00000017206","1",470425210,470454363,29153
"12731","ENSMODG00000017209","7",24269874,24307472,37598
"12732","ENSMODG00000017210","2",422596547,423250600,654053
"12733","ENSMODG00000017211","8",153998857,154046244,47387
"12734","ENSMODG00000017212","7",24359885,24455565,95680
"12735","ENSMODG00000017214","4",429147390,429177997,30607
"12736","ENSMODG00000017215","2",188596724,188599586,2862
"12737","ENSMODG00000017216","8",154163943,154191140,27197
"12738","ENSMODG00000017217","1",470402331,470412702,10371
"12739","ENSMODG00000017218","1",470394995,470400505,5510
"12740","ENSMODG00000017219","8",154186730,154261951,75221
"12741","ENSMODG00000017220","1",470353241,470376103,22862
"12742","ENSMODG00000017221","1",470334227,470335504,1277
"12743","ENSMODG00000017222","7",24505075,24571837,66762
"12744","ENSMODG00000017223","1",469787944,470021897,233953
"12745","ENSMODG00000017224","8",154337141,154370658,33517
"12746","ENSMODG00000017225","1",469740415,469789134,48719
"12747","ENSMODG00000017226","4",429127044,429136145,9101
"12748","ENSMODG00000017227","2",188553416,188594138,40722
"12749","ENSMODG00000017228","7",24578410,24660964,82554
"12750","ENSMODG00000017229","8",154368612,154409453,40841
"12751","ENSMODG00000017230","4",429025780,429090343,64563
"12752","ENSMODG00000017231","1",469730439,469737323,6884
"12753","ENSMODG00000017232","7",24670881,24769501,98620
"12754","ENSMODG00000017233","1",30178268,31264377,1086109
"12755","ENSMODG00000017234","7",24769780,24831078,61298
"12756","ENSMODG00000017235","1",469616109,469658766,42657
"12757","ENSMODG00000017236","7",24851376,24869309,17933
"12758","ENSMODG00000017237","2",188544425,188548669,4244
"12759","ENSMODG00000017238","8",154421939,154436957,15018
"12760","ENSMODG00000017239","1",469580893,469597056,16163
"12761","ENSMODG00000017240","7",24889815,24940376,50561
"12762","ENSMODG00000017241","2",188540943,188543340,2397
"12763","ENSMODG00000017242","1",469585542,469588696,3154
"12764","ENSMODG00000017244","1",469493654,469580821,87167
"12765","ENSMODG00000017245","8",154441254,154499827,58573
"12766","ENSMODG00000017246","1",29893144,29998880,105736
"12767","ENSMODG00000017247","1",28966584,29002177,35593
"12768","ENSMODG00000017248","1",28910206,28940923,30717
"12769","ENSMODG00000017250","2",422110909,422129064,18155
"12770","ENSMODG00000017251","1",469464462,469477747,13285
"12771","ENSMODG00000017252","2",422086483,422107897,21414
"12772","ENSMODG00000017253","2",188512598,188531179,18581
"12773","ENSMODG00000017254","2",422067883,422081396,13513
"12774","ENSMODG00000017255","2",421768628,422051783,283155
"12775","ENSMODG00000017256","1",469426380,469448012,21632
"12776","ENSMODG00000017259","8",154526446,154981271,454825
"12777","ENSMODG00000017260","2",421584378,421597958,13580
"12778","ENSMODG00000017262","2",421467365,421535226,67861
"12779","ENSMODG00000017263","2",421425445,421467834,42389
"12780","ENSMODG00000017264","7",25002822,25022744,19922
"12781","ENSMODG00000017265","1",28793379,28907871,114492
"12782","ENSMODG00000017266","7",25136377,25136869,492
"12783","ENSMODG00000017267","2",420983300,421299889,316589
"12784","ENSMODG00000017268","2",420524099,420555161,31062
"12785","ENSMODG00000017269","1",469389193,469422029,32836
"12786","ENSMODG00000017270","7",25635047,25681199,46152
"12787","ENSMODG00000017272","1",469374338,469376234,1896
"12788","ENSMODG00000017273","2",419833968,420033094,199126
"12789","ENSMODG00000017275","1",28678799,28774572,95773
"12790","ENSMODG00000017276","7",25688073,25714207,26134
"12791","ENSMODG00000017277","2",188334961,188498390,163429
"12792","ENSMODG00000017279","2",419582096,419691278,109182
"12793","ENSMODG00000017280","1",28662441,28662896,455
"12794","ENSMODG00000017282","2",419487074,419517302,30228
"12795","ENSMODG00000017283","1",28588246,28598694,10448
"12796","ENSMODG00000017285","2",415358179,415419189,61010
"12797","ENSMODG00000017287","2",415250515,415300890,50375
"12798","ENSMODG00000017288","2",188333457,188334646,1189
"12799","ENSMODG00000017289","1",469274676,469350746,76070
"12800","ENSMODG00000017290","2",415111229,415143723,32494
"12801","ENSMODG00000017291","8",155213201,155303879,90678
"12802","ENSMODG00000017293","1",28550523,28584399,33876
"12803","ENSMODG00000017294","7",25803309,26146592,343283
"12804","ENSMODG00000017295","2",188314039,188320207,6168
"12805","ENSMODG00000017296","2",188306055,188306840,785
"12806","ENSMODG00000017297","7",26977034,26997798,20764
"12807","ENSMODG00000017298","1",469266934,469273312,6378
"12808","ENSMODG00000017299","2",188297944,188305372,7428
"12809","ENSMODG00000017300","1",469263091,469268877,5786
"12810","ENSMODG00000017302","1",28509409,28549068,39659
"12811","ENSMODG00000017303","2",188284363,188286458,2095
"12812","ENSMODG00000017304","7",27227303,27284424,57121
"12813","ENSMODG00000017305","1",28463876,28492768,28892
"12814","ENSMODG00000017307","1",469229305,469237270,7965
"12815","ENSMODG00000017308","7",27291282,27332098,40816
"12816","ENSMODG00000017309","4",428949206,428961115,11909
"12817","ENSMODG00000017310","1",28257552,28431325,173773
"12818","ENSMODG00000017311","4",428917043,428948927,31884
"12819","ENSMODG00000017312","7",27342611,27384914,42303
"12820","ENSMODG00000017313","1",469199165,469214221,15056
"12821","ENSMODG00000017314","2",188272907,188282818,9911
"12822","ENSMODG00000017315","4",428843230,428907138,63908
"12823","ENSMODG00000017316","2",414921145,414983208,62063
"12824","ENSMODG00000017317","1",469163420,469172267,8847
"12825","ENSMODG00000017319","1",469150043,469159377,9334
"12826","ENSMODG00000017320","4",428579337,428729268,149931
"12827","ENSMODG00000017321","3",109203179,109205305,2126
"12828","ENSMODG00000017322","4",428537612,428541602,3990
"12829","ENSMODG00000017323","7",27359215,27553029,193814
"12830","ENSMODG00000017324","4",428513858,428517188,3330
"12831","ENSMODG00000017325","1",469080257,469145243,64986
"12832","ENSMODG00000017326","7",28385814,28386554,740
"12833","ENSMODG00000017327","2",188255534,188269248,13714
"12834","ENSMODG00000017328","7",28428057,28452642,24585
"12835","ENSMODG00000017329","1",469015615,469022538,6923
"12836","ENSMODG00000017330","4",427739926,427831720,91794
"12837","ENSMODG00000017331","7",28494864,28498030,3166
"12838","ENSMODG00000017333","4",427458117,427486410,28293
"12839","ENSMODG00000017334","7",28574170,28608336,34166
"12840","ENSMODG00000017335","1",468997556,469013541,15985
"12841","ENSMODG00000017336","2",188147762,188242528,94766
"12842","ENSMODG00000017337","4",426999185,427508060,508875
"12843","ENSMODG00000017338","1",468988035,468992294,4259
"12844","ENSMODG00000017339","2",188127676,188142033,14357
"12845","ENSMODG00000017340","4",427131886,427154896,23010
"12846","ENSMODG00000017341","1",468978802,468981804,3002
"12847","ENSMODG00000017342","7",28711174,28988590,277416
"12848","ENSMODG00000017345","2",188108218,188113470,5252
"12849","ENSMODG00000017346","4",427087081,427128418,41337
"12850","ENSMODG00000017347","8",156366513,156428374,61861
"12851","ENSMODG00000017349","1",468908932,468965244,56312
"12852","ENSMODG00000017350","7",30037137,30064703,27566
"12853","ENSMODG00000017353","1",468859516,468880864,21348
"12854","ENSMODG00000017354","2",188066396,188105880,39484
"12855","ENSMODG00000017355","2",414901422,414921077,19655
"12856","ENSMODG00000017357","4",426563659,426603409,39750
"12857","ENSMODG00000017358","1",28183486,28232992,49506
"12858","ENSMODG00000017359","1",468819791,468834847,15056
"12859","ENSMODG00000017361","8",156434150,156822701,388551
"12860","ENSMODG00000017362","2",188009864,188015667,5803
"12861","ENSMODG00000017363","4",426472187,426497555,25368
"12862","ENSMODG00000017364","1",468793176,468807866,14690
"12863","ENSMODG00000017367","8",156830984,156865043,34059
"12864","ENSMODG00000017368","2",187950053,187951689,1636
"12865","ENSMODG00000017370","7",30712142,30715587,3445
"12866","ENSMODG00000017371","7",30596150,30899495,303345
"12867","ENSMODG00000017372","8",156867772,156876773,9001
"12868","ENSMODG00000017373","4",426385016,426408642,23626
"12869","ENSMODG00000017375","7",30928806,30950084,21278
"12870","ENSMODG00000017376","2",187996247,188004568,8321
"12871","ENSMODG00000017377","7",31292411,31293022,611
"12872","ENSMODG00000017379","8",156907839,156969933,62094
"12873","ENSMODG00000017380","4",426365179,426370275,5096
"12874","ENSMODG00000017381","2",187993563,187998111,4548
"12875","ENSMODG00000017383","2",414871772,414892207,20435
"12876","ENSMODG00000017384","2",187953643,187963023,9380
"12877","ENSMODG00000017386","2",414789719,414810460,20741
"12878","ENSMODG00000017387","2",187867071,187946230,79159
"12879","ENSMODG00000017388","4",426355745,426362709,6964
"12880","ENSMODG00000017389","8",157333765,157425143,91378
"12881","ENSMODG00000017390","2",187929086,187932539,3453
"12882","ENSMODG00000017391","2",187918881,187919666,785
"12883","ENSMODG00000017392","4",426313378,426316293,2915
"12884","ENSMODG00000017393","2",414441707,414603184,161477
"12885","ENSMODG00000017394","8",157518128,157553668,35540
"12886","ENSMODG00000017396","4",426271268,426295056,23788
"12887","ENSMODG00000017397","2",187864578,187865727,1149
"12888","ENSMODG00000017398","2",414434264,414440624,6360
"12889","ENSMODG00000017399","7",31710362,31852377,142015
"12890","ENSMODG00000017400","2",187846539,187848831,2292
"12891","ENSMODG00000017401","8",157724263,157761941,37678
"12892","ENSMODG00000017403","2",187727543,187728740,1197
"12893","ENSMODG00000017404","4",426240386,426264821,24435
"12894","ENSMODG00000017406","2",187687578,187692267,4689
"12895","ENSMODG00000017407","Un",92515371,92516828,1457
"12896","ENSMODG00000017408","4",426197730,426239222,41492
"12897","ENSMODG00000017409","2",414157789,414372589,214800
"12898","ENSMODG00000017410","2",187668840,187671749,2909
"12899","ENSMODG00000017411","4",426115635,426128624,12989
"12900","ENSMODG00000017412","4",426124378,426125071,693
"12901","ENSMODG00000017413","2",187614639,187626129,11490
"12902","ENSMODG00000017414","2",414042692,414063606,20914
"12903","ENSMODG00000017415","4",426089937,426107675,17738
"12904","ENSMODG00000017417","2",413811776,413832155,20379
"12905","ENSMODG00000017418","2",413372387,413373202,815
"12906","ENSMODG00000017419","4",426074797,426089106,14309
"12907","ENSMODG00000017421","2",412960828,412997574,36746
"12908","ENSMODG00000017422","4",425968485,425969607,1122
"12909","ENSMODG00000017423","X",59756629,59758224,1595
"12910","ENSMODG00000017424","4",425878064,425939098,61034
"12911","ENSMODG00000017425","7",32197184,32303109,105925
"12912","ENSMODG00000017426","2",412916768,412937981,21213
"12913","ENSMODG00000017428","4",425804702,425831689,26987
"12914","ENSMODG00000017429","2",412753809,412810004,56195
"12915","ENSMODG00000017430","4",425731038,425772402,41364
"12916","ENSMODG00000017431","2",412618755,412622496,3741
"12917","ENSMODG00000017432","4",425727306,425729407,2101
"12918","ENSMODG00000017434","2",412522161,412604055,81894
"12919","ENSMODG00000017435","Un",44429988,44444423,14435
"12920","ENSMODG00000017436","2",411902839,412477736,574897
"12921","ENSMODG00000017437","7",32325447,32532211,206764
"12922","ENSMODG00000017440","4",425725932,425726544,612
"12923","ENSMODG00000017446","7",32610321,32610935,614
"12924","ENSMODG00000017447","2",411774802,411793409,18607
"12925","ENSMODG00000017449","7",32685864,32914765,228901
"12926","ENSMODG00000017451","Un",43799661,43800212,551
"12927","ENSMODG00000017452","7",32947332,33002066,54734
"12928","ENSMODG00000017453","2",411695240,411757509,62269
"12929","ENSMODG00000017455","4",425669914,425692137,22223
"12930","ENSMODG00000017456","8",93023673,93106988,83315
"12931","ENSMODG00000017458","8",93295129,93333679,38550
"12932","ENSMODG00000017460","8",93338457,93338801,344
"12933","ENSMODG00000017462","X",61910068,61912516,2448
"12934","ENSMODG00000017463","2",411512705,411693019,180314
"12935","ENSMODG00000017464","4",425628394,425663093,34699
"12936","ENSMODG00000017465","X",62545710,62548031,2321
"12937","ENSMODG00000017466","8",93345285,93429559,84274
"12938","ENSMODG00000017467","7",33041509,33112211,70702
"12939","ENSMODG00000017468","1",468160960,468165783,4823
"12940","ENSMODG00000017470","4",425624068,425625842,1774
"12941","ENSMODG00000017472","8",93429919,93495718,65799
"12942","ENSMODG00000017473","X",63188355,63717438,529083
"12943","ENSMODG00000017474","4",425612946,425621371,8425
"12944","ENSMODG00000017475","7",34571808,34798015,226207
"12945","ENSMODG00000017476","2",410434544,410709297,274753
"12946","ENSMODG00000017480","X",63737392,63738633,1241
"12947","ENSMODG00000017481","4",425607919,425612818,4899
"12948","ENSMODG00000017482","X",63973298,63975466,2168
"12949","ENSMODG00000017483","4",425604519,425607330,2811
"12950","ENSMODG00000017486","X",64277001,64277943,942
"12951","ENSMODG00000017487","4",425592590,425594716,2126
"12952","ENSMODG00000017488","2",410311076,410350949,39873
"12953","ENSMODG00000017489","X",64493648,64494661,1013
"12954","ENSMODG00000017490","X",64516971,64518232,1261
"12955","ENSMODG00000017491","4",425572150,425581953,9803
"12956","ENSMODG00000017492","1",468037181,468042980,5799
"12957","ENSMODG00000017494","Un",55164785,55169111,4326
"12958","ENSMODG00000017497","7",35911791,35914408,2617
"12959","ENSMODG00000017498","1",467662934,467690244,27310
"12960","ENSMODG00000017499","2",409941599,410078696,137097
"12961","ENSMODG00000017500","7",35931432,36006992,75560
"12962","ENSMODG00000017502","7",36469743,36470638,895
"12963","ENSMODG00000017503","7",37024418,37125870,101452
"12964","ENSMODG00000017504","2",409872814,409919603,46789
"12965","ENSMODG00000017505","7",37196280,37370969,174689
"12966","ENSMODG00000017506","1",467508646,467518321,9675
"12967","ENSMODG00000017508","1",467429076,467439548,10472
"12968","ENSMODG00000017509","2",408941632,408947742,6110
"12969","ENSMODG00000017510","1",467263248,467264526,1278
"12970","ENSMODG00000017512","2",408734121,408807336,73215
"12971","ENSMODG00000017515","2",408724140,408734424,10284
"12972","ENSMODG00000017516","2",408616428,408651785,35357
"12973","ENSMODG00000017518","2",407755485,408134660,379175
"12974","ENSMODG00000017519","7",38806814,39215395,408581
"12975","ENSMODG00000017520","2",407248910,407252981,4071
"12976","ENSMODG00000017522","2",407206958,407242078,35120
"12977","ENSMODG00000017524","7",40863586,40864022,436
"12978","ENSMODG00000017525","2",407160581,407176398,15817
"12979","ENSMODG00000017526","7",41048394,41055745,7351
"12980","ENSMODG00000017527","Un",55186950,55188817,1867
"12981","ENSMODG00000017528","4",425531004,425555030,24026
"12982","ENSMODG00000017529","2",407136967,407156109,19142
"12983","ENSMODG00000017530","2",407094705,407095724,1019
"12984","ENSMODG00000017531","1",466915041,466995350,80309
"12985","ENSMODG00000017532","2",407016970,407029879,12909
"12986","ENSMODG00000017535","1",466807459,466909025,101566
"12987","ENSMODG00000017538","2",406713166,406729709,16543
"12988","ENSMODG00000017540","1",466633506,466670881,37375
"12989","ENSMODG00000017541","2",406777770,406778840,1070
"12990","ENSMODG00000017542","1",211551833,211553341,1508
"12991","ENSMODG00000017545","4",425269274,425472063,202789
"12992","ENSMODG00000017546","1",466320227,466445758,125531
"12993","ENSMODG00000017547","1",210710632,210711463,831
"12994","ENSMODG00000017548","1",210691763,210692325,562
"12995","ENSMODG00000017549","1",465998521,466012603,14082
"12996","ENSMODG00000017550","2",406599657,406666750,67093
"12997","ENSMODG00000017551","4",425414306,425432417,18111
"12998","ENSMODG00000017552","1",210045751,210288298,242547
"12999","ENSMODG00000017553","2",406416889,406546197,129308
"13000","ENSMODG00000017554","4",425251598,425277731,26133
"13001","ENSMODG00000017555","1",465921177,465991981,70804
"13002","ENSMODG00000017556","4",425154057,425204183,50126
"13003","ENSMODG00000017557","1",208892737,208971472,78735
"13004","ENSMODG00000017558","2",405866050,405869989,3939
"13005","ENSMODG00000017559","1",465593820,465682427,88607
"13006","ENSMODG00000017560","1",465561020,465591618,30598
"13007","ENSMODG00000017561","4",425055367,425084679,29312
"13008","ENSMODG00000017562","1",465528224,465551819,23595
"13009","ENSMODG00000017563","1",208700574,208855787,155213
"13010","ENSMODG00000017564","2",405689947,405802829,112882
"13011","ENSMODG00000017566","1",465465673,465510403,44730
"13012","ENSMODG00000017567","1",208469471,208487396,17925
"13013","ENSMODG00000017568","1",465438011,465446942,8931
"13014","ENSMODG00000017569","2",405477271,405599271,122000
"13015","ENSMODG00000017570","4",424914702,424992530,77828
"13016","ENSMODG00000017571","1",208367112,208464997,97885
"13017","ENSMODG00000017572","1",465423991,465437943,13952
"13018","ENSMODG00000017573","4",424889438,424899144,9706
"13019","ENSMODG00000017574","1",465375872,465400026,24154
"13020","ENSMODG00000017575","1",208456271,208457805,1534
"13021","ENSMODG00000017576","1",208403642,208404046,404
"13022","ENSMODG00000017578","2",405373707,405440449,66742
"13023","ENSMODG00000017579","1",208292591,208354124,61533
"13024","ENSMODG00000017582","4",424760973,424835944,74971
"13025","ENSMODG00000017583","1",465323024,465374557,51533
"13026","ENSMODG00000017584","2",405350298,405370961,20663
"13027","ENSMODG00000017585","4",424700539,424738255,37716
"13028","ENSMODG00000017586","2",404835605,405003983,168378
"13029","ENSMODG00000017587","4",424553233,424584401,31168
"13030","ENSMODG00000017589","Un",12556586,12751080,194494
"13031","ENSMODG00000017590","1",208180221,208288437,108216
"13032","ENSMODG00000017591","1",465164951,465241340,76389
"13033","ENSMODG00000017592","Un",12841700,12842100,400
"13034","ENSMODG00000017594","Un",12915216,12916507,1291
"13035","ENSMODG00000017595","Un",12920066,12923944,3878
"13036","ENSMODG00000017596","Un",86988201,86995528,7327
"13037","ENSMODG00000017597","4",424491125,424542987,51862
"13038","ENSMODG00000017598","1",464873684,464900452,26768
"13039","ENSMODG00000017599","Un",35547523,35564562,17039
"13040","ENSMODG00000017600","1",207915366,208103615,188249
"13041","ENSMODG00000017601","1",464842797,464864929,22132
"13042","ENSMODG00000017602","2",404500982,404701179,200197
"13043","ENSMODG00000017603","Un",35745915,35801878,55963
"13044","ENSMODG00000017604","1",464674310,464715954,41644
"13045","ENSMODG00000017606","3",510459139,510547179,88040
"13046","ENSMODG00000017607","1",207869057,207881571,12514
"13047","ENSMODG00000017608","1",464648946,464657851,8905
"13048","ENSMODG00000017609","2",404006929,404027932,21003
"13049","ENSMODG00000017610","1",464620544,464624371,3827
"13050","ENSMODG00000017612","3",510547949,510558940,10991
"13051","ENSMODG00000017613","1",206938838,207023272,84434
"13052","ENSMODG00000017614","1",464552599,464562023,9424
"13053","ENSMODG00000017615","2",403524874,403595147,70273
"13054","ENSMODG00000017617","4",424421193,424451907,30714
"13055","ENSMODG00000017618","1",206089650,206715081,625431
"13056","ENSMODG00000017619","1",206042066,206042736,670
"13057","ENSMODG00000017620","1",204804596,204983315,178719
"13058","ENSMODG00000017621","3",510564276,510575825,11549
"13059","ENSMODG00000017622","1",204803580,204804397,817
"13060","ENSMODG00000017623","2",403338171,403514814,176643
"13061","ENSMODG00000017624","4",424350923,424414672,63749
"13062","ENSMODG00000017625","1",204637329,204675142,37813
"13063","ENSMODG00000017626","4",424330179,424338684,8505
"13064","ENSMODG00000017627","1",203891692,203968262,76570
"13065","ENSMODG00000017628","1",203866672,203881244,14572
"13066","ENSMODG00000017629","2",402765372,402953975,188603
"13067","ENSMODG00000017630","1",203731678,203766632,34954
"13068","ENSMODG00000017631","4",424213710,424325635,111925
"13069","ENSMODG00000017634","1",203554977,203573167,18190
"13070","ENSMODG00000017638","4",424124846,424155472,30626
"13071","ENSMODG00000017639","3",510655317,510683530,28213
"13072","ENSMODG00000017640","1",203448414,203470568,22154
"13073","ENSMODG00000017641","3",510705872,510730345,24473
"13074","ENSMODG00000017643","4",424098055,424122760,24705
"13075","ENSMODG00000017644","1",203268960,203392904,123944
"13076","ENSMODG00000017645","1",203074039,203180590,106551
"13077","ENSMODG00000017646","4",423988665,424013010,24345
"13078","ENSMODG00000017647","4",423880923,423892077,11154
"13079","ENSMODG00000017648","3",510729277,510846317,117040
"13080","ENSMODG00000017650","4",423778121,423858031,79910
"13081","ENSMODG00000017651","2",401788685,402771399,982714
"13082","ENSMODG00000017652","4",423725368,423756792,31424
"13083","ENSMODG00000017653","4",423594968,423605699,10731
"13084","ENSMODG00000017654","3",510788393,510802405,14012
"13085","ENSMODG00000017655","1",249738583,249738891,308
"13086","ENSMODG00000017657","4",423548404,423564234,15830
"13087","ENSMODG00000017659","4",423521429,423541987,20558
"13088","ENSMODG00000017660","1",203108107,203165940,57833
"13089","ENSMODG00000017661","2",400414862,401139431,724569
"13090","ENSMODG00000017662","3",510862213,510864054,1841
"13091","ENSMODG00000017663","3",510924455,510929473,5018
"13092","ENSMODG00000017664","4",423445992,423491510,45518
"13093","ENSMODG00000017665","3",510968113,511022102,53989
"13094","ENSMODG00000017667","3",511032759,511038192,5433
"13095","ENSMODG00000017668","2",400065410,400314115,248705
"13096","ENSMODG00000017669","2",400016499,400107359,90860
"13097","ENSMODG00000017670","1",203080418,203097737,17319
"13098","ENSMODG00000017671","1",203074774,203079424,4650
"13099","ENSMODG00000017672","2",399897598,399898589,991
"13100","ENSMODG00000017673","2",399774349,399816843,42494
"13101","ENSMODG00000017674","2",399736207,399748372,12165
"13102","ENSMODG00000017676","2",399550589,399631858,81269
"13103","ENSMODG00000017677","2",399323189,399437879,114690
"13104","ENSMODG00000017679","2",397796879,397867865,70986
"13105","ENSMODG00000017680","1",203042567,203072949,30382
"13106","ENSMODG00000017682","2",397749876,397770002,20126
"13107","ENSMODG00000017683","1",202914189,202983566,69377
"13108","ENSMODG00000017684","1",202790707,202814867,24160
"13109","ENSMODG00000017685","3",511066607,511073138,6531
"13110","ENSMODG00000017686","1",202735053,202781521,46468
"13111","ENSMODG00000017687","2",397519859,397719802,199943
"13112","ENSMODG00000017688","1",202719414,202732335,12921
"13113","ENSMODG00000017689","4",423043920,423439565,395645
"13114","ENSMODG00000017690","1",202685918,202697861,11943
"13115","ENSMODG00000017691","8",93664061,93752664,88603
"13116","ENSMODG00000017693","1",202593445,202685063,91618
"13117","ENSMODG00000017695","1",532227461,532227969,508
"13118","ENSMODG00000017698","3",511097168,511102873,5705
"13119","ENSMODG00000017699","4",423355340,423358393,3053
"13120","ENSMODG00000017700","4",422988837,422993521,4684
"13121","ENSMODG00000017701","2",397444981,397457615,12634
"13122","ENSMODG00000017702","3",511137175,511167219,30044
"13123","ENSMODG00000017703","4",422934565,422972733,38168
"13124","ENSMODG00000017704","8",94905289,95397753,492464
"13125","ENSMODG00000017705","4",422873955,422922074,48119
"13126","ENSMODG00000017706","4",396795792,396796582,790
"13127","ENSMODG00000017709","1",202476074,202534764,58690
"13128","ENSMODG00000017710","4",422658426,422856101,197675
"13129","ENSMODG00000017711","8",96360741,96407854,47113
"13130","ENSMODG00000017712","2",396796784,396812920,16136
"13131","ENSMODG00000017713","4",421718660,421719997,1337
"13132","ENSMODG00000017714","2",396594460,396791526,197066
"13133","ENSMODG00000017715","3",511172424,511198248,25824
"13134","ENSMODG00000017716","2",396374655,396535203,160548
"13135","ENSMODG00000017717","4",421679860,421694309,14449
"13136","ENSMODG00000017718","8",96455374,96620750,165376
"13137","ENSMODG00000017719","4",421657940,421660743,2803
"13138","ENSMODG00000017721","1",202300972,202407400,106428
"13139","ENSMODG00000017722","3",511232543,511310546,78003
"13140","ENSMODG00000017725","2",394053207,394598880,545673
"13141","ENSMODG00000017726","8",96693699,96808035,114336
"13142","ENSMODG00000017728","2",393695559,393790395,94836
"13143","ENSMODG00000017729","4",421634209,421651821,17612
"13144","ENSMODG00000017730","2",393451768,393457167,5399
"13145","ENSMODG00000017731","8",96735629,96736211,582
"13146","ENSMODG00000017732","2",393459703,393492506,32803
"13147","ENSMODG00000017733","1",201801874,201874169,72295
"13148","ENSMODG00000017735","2",393164531,393166133,1602
"13149","ENSMODG00000017736","4",421528332,421607990,79658
"13150","ENSMODG00000017737","2",393111554,393112843,1289
"13151","ENSMODG00000017738","1",201751764,201797981,46217
"13152","ENSMODG00000017741","1",201728484,201741636,13152
"13153","ENSMODG00000017742","8",96884678,96926176,41498
"13154","ENSMODG00000017743","2",393082889,393102791,19902
"13155","ENSMODG00000017744","1",201726312,201729228,2916
"13156","ENSMODG00000017745","4",421489714,421517585,27871
"13157","ENSMODG00000017747","1",201718539,201724929,6390
"13158","ENSMODG00000017748","8",96956116,96957793,1677
"13159","ENSMODG00000017750","4",421473454,421481242,7788
"13160","ENSMODG00000017753","2",393034310,393076027,41717
"13161","ENSMODG00000017755","1",201707217,201710738,3521
"13162","ENSMODG00000017756","4",421462956,421470245,7289
"13163","ENSMODG00000017758","2",391690062,391691220,1158
"13164","ENSMODG00000017759","4",421337105,421374248,37143
"13165","ENSMODG00000017760","1",201684187,201705612,21425
"13166","ENSMODG00000017762","4",421297523,421319951,22428
"13167","ENSMODG00000017763","1",201670208,201684416,14208
"13168","ENSMODG00000017765","4",421273763,421298214,24451
"13169","ENSMODG00000017766","2",391325901,391582542,256641
"13170","ENSMODG00000017770","1",201606197,201622339,16142
"13171","ENSMODG00000017771","8",96977770,97172889,195119
"13172","ENSMODG00000017772","2",390397863,390612878,215015
"13173","ENSMODG00000017773","4",421079195,421105745,26550
"13174","ENSMODG00000017776","1",201599067,201609390,10323
"13175","ENSMODG00000017777","4",420998008,421084093,86085
"13176","ENSMODG00000017778","4",421042023,421053289,11266
"13177","ENSMODG00000017780","2",387963425,388128822,165397
"13178","ENSMODG00000017781","2",387803001,387803669,668
"13179","ENSMODG00000017782","8",97211044,97223191,12147
"13180","ENSMODG00000017783","2",387627698,387767239,139541
"13181","ENSMODG00000017786","8",97334139,97362369,28230
"13182","ENSMODG00000017787","4",421003606,421034831,31225
"13183","ENSMODG00000017788","1",201556817,201592151,35334
"13184","ENSMODG00000017789","2",387536193,387555397,19204
"13185","ENSMODG00000017791","2",387442098,387604898,162800
"13186","ENSMODG00000017792","2",387099511,387256197,156686
"13187","ENSMODG00000017794","4",420919344,420994401,75057
"13188","ENSMODG00000017795","2",386669669,386903502,233833
"13189","ENSMODG00000017796","8",97379052,97436784,57732
"13190","ENSMODG00000017797","1",201531852,201556330,24478
"13191","ENSMODG00000017799","2",386026958,386066739,39781
"13192","ENSMODG00000017801","8",97477189,97494096,16907
"13193","ENSMODG00000017802","4",420044891,420380884,335993
"13194","ENSMODG00000017803","2",385862948,385918233,55285
"13195","ENSMODG00000017805","8",97501224,97518389,17165
"13196","ENSMODG00000017806","1",201321808,201451493,129685
"13197","ENSMODG00000017807","2",385737790,385846761,108971
"13198","ENSMODG00000017809","2",385499059,385509981,10922
"13199","ENSMODG00000017810","4",419478707,419500636,21929
"13200","ENSMODG00000017811","8",97522962,97544124,21162
"13201","ENSMODG00000017812","8",97581053,97587024,5971
"13202","ENSMODG00000017813","4",419443000,419456328,13328
"13203","ENSMODG00000017816","1",201285251,201319834,34583
"13204","ENSMODG00000017817","4",419403028,419437924,34896
"13205","ENSMODG00000017819","2",385004915,385030777,25862
"13206","ENSMODG00000017820","1",201269715,201283703,13988
"13207","ENSMODG00000017821","8",97655840,97701729,45889
"13208","ENSMODG00000017822","1",201253484,201269380,15896
"13209","ENSMODG00000017824","4",419314275,419358259,43984
"13210","ENSMODG00000017825","1",201239949,201242018,2069
"13211","ENSMODG00000017826","2",384905980,384956480,50500
"13212","ENSMODG00000017827","4",419306390,419308494,2104
"13213","ENSMODG00000017828","4",419302963,419303222,259
"13214","ENSMODG00000017829","8",97839748,97899851,60103
"13215","ENSMODG00000017831","2",384873472,384903530,30058
"13216","ENSMODG00000017834","4",419282107,419298667,16560
"13217","ENSMODG00000017836","2",384843278,384863907,20629
"13218","ENSMODG00000017837","2",384802172,384822975,20803
"13219","ENSMODG00000017838","2",384748322,384751672,3350
"13220","ENSMODG00000017840","2",384657328,384670894,13566
"13221","ENSMODG00000017841","2",384624468,384628753,4285
"13222","ENSMODG00000017842","2",384574059,384577207,3148
"13223","ENSMODG00000017844","4",419130762,419161241,30479
"13224","ENSMODG00000017846","2",384461407,384545252,83845
"13225","ENSMODG00000017847","1",200908630,200934398,25768
"13226","ENSMODG00000017848","4",419086902,419098199,11297
"13227","ENSMODG00000017849","2",384187247,384454808,267561
"13228","ENSMODG00000017850","2",384219368,384229022,9654
"13229","ENSMODG00000017851","1",200896220,200905235,9015
"13230","ENSMODG00000017852","2",383941555,384097725,156170
"13231","ENSMODG00000017853","1",200827888,200895475,67587
"13232","ENSMODG00000017856","2",381488701,381659765,171064
"13233","ENSMODG00000017858","1",200629456,200768802,139346
"13234","ENSMODG00000017859","8",98117022,98458307,341285
"13235","ENSMODG00000017860","2",381249673,381316457,66784
"13236","ENSMODG00000017861","1",200597058,200609629,12571
"13237","ENSMODG00000017867","8",99188033,99222476,34443
"13238","ENSMODG00000017868","1",200299827,200549991,250164
"13239","ENSMODG00000017869","4",418849602,418970094,120492
"13240","ENSMODG00000017870","1",200406888,200407716,828
"13241","ENSMODG00000017872","8",99255795,99435552,179757
"13242","ENSMODG00000017873","1",200279883,200291325,11442
"13243","ENSMODG00000017875","1",200102684,200277170,174486
"13244","ENSMODG00000017877","4",419024805,419062102,37297
"13245","ENSMODG00000017880","4",419017092,419023345,6253
"13246","ENSMODG00000017881","2",378396846,378598763,201917
"13247","ENSMODG00000017882","1",200063083,200092417,29334
"13248","ENSMODG00000017883","4",419004810,419013453,8643
"13249","ENSMODG00000017884","1",200049434,200063434,14000
"13250","ENSMODG00000017885","8",99825224,99826123,899
"13251","ENSMODG00000017886","2",378389949,378390790,841
"13252","ENSMODG00000017887","2",378347804,378385610,37806
"13253","ENSMODG00000017888","4",418687168,418737944,50776
"13254","ENSMODG00000017889","1",200007992,200048203,40211
"13255","ENSMODG00000017890","8",99826858,99912414,85556
"13256","ENSMODG00000017891","2",378330214,378348463,18249
"13257","ENSMODG00000017895","4",418540679,418582106,41427
"13258","ENSMODG00000017897","8",102027632,102096287,68655
"13259","ENSMODG00000017898","8",102404368,102432585,28217
"13260","ENSMODG00000017899","4",418517269,418518057,788
"13261","ENSMODG00000017900","1",199879102,199957620,78518
"13262","ENSMODG00000017901","8",102564544,102701455,136911
"13263","ENSMODG00000017902","4",418328740,418366558,37818
"13264","ENSMODG00000017903","8",102841300,102982208,140908
"13265","ENSMODG00000017904","4",418267371,418315597,48226
"13266","ENSMODG00000017905","2",377721153,377977300,256147
"13267","ENSMODG00000017906","4",418250455,418262010,11555
"13268","ENSMODG00000017907","2",377591428,377670782,79354
"13269","ENSMODG00000017908","2",377415131,377415271,140
"13270","ENSMODG00000017909","1",199788495,199874292,85797
"13271","ENSMODG00000017910","2",377201651,377457384,255733
"13272","ENSMODG00000017913","8",102989999,103010691,20692
"13273","ENSMODG00000017914","2",377020421,377142495,122074
"13274","ENSMODG00000017915","1",199707034,199780653,73619
"13275","ENSMODG00000017916","4",418112895,418247855,134960
"13276","ENSMODG00000017917","1",199711158,199713057,1899
"13277","ENSMODG00000017919","2",376892616,376940343,47727
"13278","ENSMODG00000017923","1",199663893,199704616,40723
"13279","ENSMODG00000017924","2",376777015,376878448,101433
"13280","ENSMODG00000017925","8",103257030,103366668,109638
"13281","ENSMODG00000017926","2",376506570,376715137,208567
"13282","ENSMODG00000017927","4",418009497,418103766,94269
"13283","ENSMODG00000017928","1",199599465,199662011,62546
"13284","ENSMODG00000017929","2",376265028,376296267,31239
"13285","ENSMODG00000017930","4",417584933,417585721,788
"13286","ENSMODG00000017932","2",376162452,376253966,91514
"13287","ENSMODG00000017933","8",103397714,103532784,135070
"13288","ENSMODG00000017934","2",375954592,376162229,207637
"13289","ENSMODG00000017935","1",199522848,199551397,28549
"13290","ENSMODG00000017937","4",417856480,417870754,14274
"13291","ENSMODG00000017938","8",103717749,103841901,124152
"13292","ENSMODG00000017939","2",375873304,375934089,60785
"13293","ENSMODG00000017940","8",103952788,103962244,9456
"13294","ENSMODG00000017941","8",104011068,104031704,20636
"13295","ENSMODG00000017942","1",199334643,199483010,148367
"13296","ENSMODG00000017943","4",417790456,417792245,1789
"13297","ENSMODG00000017944","8",104108347,104114127,5780
"13298","ENSMODG00000017945","2",375742745,375809665,66920
"13299","ENSMODG00000017946","1",199219482,199327135,107653
"13300","ENSMODG00000017948","4",417697913,417779902,81989
"13301","ENSMODG00000017949","8",104207224,104223756,16532
"13302","ENSMODG00000017951","2",375200941,375353790,152849
"13303","ENSMODG00000017952","4",417636568,417637638,1070
"13304","ENSMODG00000017954","4",417590406,417591200,794
"13305","ENSMODG00000017956","2",375035879,375196918,161039
"13306","ENSMODG00000017960","1",199103463,199208706,105243
"13307","ENSMODG00000017966","2",375010557,375028283,17726
"13308","ENSMODG00000017968","2",374966358,375005503,39145
"13309","ENSMODG00000017969","4",416789426,416867777,78351
"13310","ENSMODG00000017970","8",104396902,104408000,11098
"13311","ENSMODG00000017971","2",374964001,374969841,5840
"13312","ENSMODG00000017972","8",104441186,104442622,1436
"13313","ENSMODG00000017973","2",374884082,374963674,79592
"13314","ENSMODG00000017974","8",104446786,104483051,36265
"13315","ENSMODG00000017976","8",104571681,104583767,12086
"13316","ENSMODG00000017977","Un",57371100,57376505,5405
"13317","ENSMODG00000017978","2",374848819,374859396,10577
"13318","ENSMODG00000017979","8",104628273,104648421,20148
"13319","ENSMODG00000017981","Un",56822582,56824819,2237
"13320","ENSMODG00000017983","2",374730402,374847809,117407
"13321","ENSMODG00000017985","2",374433396,374999562,566166
"13322","ENSMODG00000017988","8",104682602,104771610,89008
"13323","ENSMODG00000017989","2",374569452,374603604,34152
"13324","ENSMODG00000017990","2",374406771,374431481,24710
"13325","ENSMODG00000017991","8",104814941,104821045,6104
"13326","ENSMODG00000017993","2",374256891,374408215,151324
"13327","ENSMODG00000017994","2",373785565,373917542,131977
"13328","ENSMODG00000017995","8",104819445,104838359,18914
"13329","ENSMODG00000017996","2",373476396,373715121,238725
"13330","ENSMODG00000017997","8",104932756,105011275,78519
"13331","ENSMODG00000017999","2",373343951,373384931,40980
"13332","ENSMODG00000018000","8",105106376,105130618,24242
"13333","ENSMODG00000018002","8",105169817,105176826,7009
"13334","ENSMODG00000018003","8",36367466,36368381,915
"13335","ENSMODG00000018004","8",105213203,105222916,9713
"13336","ENSMODG00000018005","2",373269012,373301236,32224
"13337","ENSMODG00000018006","8",105231539,105243167,11628
"13338","ENSMODG00000018007","8",105296785,105298413,1628
"13339","ENSMODG00000018010","2",373133825,373152646,18821
"13340","ENSMODG00000018011","8",106490743,106491549,806
"13341","ENSMODG00000018012","2",372963141,373046230,83089
"13342","ENSMODG00000018013","2",372662889,372868961,206072
"13343","ENSMODG00000018014","2",372350046,372585891,235845
"13344","ENSMODG00000018016","2",371922827,372351686,428859
"13345","ENSMODG00000018017","8",106615959,107146813,530854
"13346","ENSMODG00000018019","2",371817510,371885048,67538
"13347","ENSMODG00000018020","2",371794660,371808016,13356
"13348","ENSMODG00000018021","2",371778656,371779174,518
"13349","ENSMODG00000018023","2",371269619,371305343,35724
"13350","ENSMODG00000018024","2",371210897,371270014,59117
"13351","ENSMODG00000018026","2",370941774,370942260,486
"13352","ENSMODG00000018027","2",370768469,370937860,169391
"13353","ENSMODG00000018028","8",36443906,36458138,14232
"13354","ENSMODG00000018029","2",370616655,370642265,25610
"13355","ENSMODG00000018030","2",370133807,370134403,596
"13356","ENSMODG00000018031","2",369395370,369562131,166761
"13357","ENSMODG00000018033","2",369226598,369265423,38825
"13358","ENSMODG00000018034","2",369135575,369203972,68397
"13359","ENSMODG00000018035","2",368965068,369100073,135005
"13360","ENSMODG00000018036","2",368753091,368861726,108635
"13361","ENSMODG00000018038","Un",28330921,28331810,889
"13362","ENSMODG00000018040","Un",87162911,87164093,1182
"13363","ENSMODG00000018043","8",186966065,186966876,811
"13364","ENSMODG00000018045","4",67433493,67516487,82994
"13365","ENSMODG00000018047","4",67632408,67716092,83684
"13366","ENSMODG00000018048","8",107029036,107420688,391652
"13367","ENSMODG00000018051","2",246651423,246703069,51646
"13368","ENSMODG00000018053","8",107524596,107577528,52932
"13369","ENSMODG00000018054","8",107638540,107656506,17966
"13370","ENSMODG00000018056","8",107654952,107674220,19268
"13371","ENSMODG00000018058","8",107709918,107837746,127828
"13372","ENSMODG00000018059","8",107757606,107763404,5798
"13373","ENSMODG00000018060","8",107823695,107826401,2706
"13374","ENSMODG00000018063","8",107870110,107871331,1221
"13375","ENSMODG00000018064","8",107871281,107912706,41425
"13376","ENSMODG00000018065","2",363704534,364529182,824648
"13377","ENSMODG00000018066","8",107920659,107922687,2028
"13378","ENSMODG00000018067","8",107922813,107938910,16097
"13379","ENSMODG00000018068","2",364227186,364228095,909
"13380","ENSMODG00000018069","2",364215399,364226715,11316
"13381","ENSMODG00000018070","4",68016638,68184252,167614
"13382","ENSMODG00000018072","4",68433306,68485685,52379
"13383","ENSMODG00000018074","4",68636528,68643121,6593
"13384","ENSMODG00000018075","4",68770894,68771689,795
"13385","ENSMODG00000018077","8",107939118,107950808,11690
"13386","ENSMODG00000018078","4",68771614,68882812,111198
"13387","ENSMODG00000018079","4",68985787,69025715,39928
"13388","ENSMODG00000018082","2",362618138,362993879,375741
"13389","ENSMODG00000018083","4",69527977,69531789,3812
"13390","ENSMODG00000018084","4",71797100,71868239,71139
"13391","ENSMODG00000018085","4",72422675,72564821,142146
"13392","ENSMODG00000018086","4",72596514,72680294,83780
"13393","ENSMODG00000018087","2",362478359,362554537,76178
"13394","ENSMODG00000018088","2",361864635,361925817,61182
"13395","ENSMODG00000018089","2",361536364,361545561,9197
"13396","ENSMODG00000018090","4",72909131,73042862,133731
"13397","ENSMODG00000018091","2",361486513,361507183,20670
"13398","ENSMODG00000018092","6",136653096,136653798,702
"13399","ENSMODG00000018094","8",107954153,107981472,27319
"13400","ENSMODG00000018095","4",73061703,73081005,19302
"13401","ENSMODG00000018096","4",73154114,73179630,25516
"13402","ENSMODG00000018097","4",73223735,73403294,179559
"13403","ENSMODG00000018098","2",361357724,361445476,87752
"13404","ENSMODG00000018099","8",108004468,108005844,1376
"13405","ENSMODG00000018101","8",108011988,108027223,15235
"13406","ENSMODG00000018103","8",108029493,108034565,5072
"13407","ENSMODG00000018104","4",73475827,73574774,98947
"13408","ENSMODG00000018105","8",108039450,108056249,16799
"13409","ENSMODG00000018107","8",108084100,108087208,3108
"13410","ENSMODG00000018109","4",73753604,73754456,852
"13411","ENSMODG00000018110","8",108099719,108116964,17245
"13412","ENSMODG00000018112","4",73906970,73933244,26274
"13413","ENSMODG00000018113","8",108129056,108132398,3342
"13414","ENSMODG00000018114","4",73942661,73969668,27007
"13415","ENSMODG00000018115","2",361266747,361313597,46850
"13416","ENSMODG00000018116","2",361217829,361249063,31234
"13417","ENSMODG00000018117","4",73978298,73987329,9031
"13418","ENSMODG00000018118","4",73988299,74028286,39987
"13419","ENSMODG00000018119","2",361123742,361201198,77456
"13420","ENSMODG00000018120","4",74236978,74356684,119706
"13421","ENSMODG00000018121","2",360530522,360605710,75188
"13422","ENSMODG00000018122","2",360487968,360489303,1335
"13423","ENSMODG00000018124","2",359665431,359666975,1544
"13424","ENSMODG00000018127","2",357968416,358126190,157774
"13425","ENSMODG00000018129","2",357623468,357965554,342086
"13426","ENSMODG00000018130","4",74415230,74431225,15995
"13427","ENSMODG00000018131","2",357580119,357601104,20985
"13428","ENSMODG00000018132","2",357435032,357436333,1301
"13429","ENSMODG00000018133","4",74440110,74452880,12770
"13430","ENSMODG00000018134","2",357191633,357237267,45634
"13431","ENSMODG00000018136","8",108172191,108179976,7785
"13432","ENSMODG00000018137","2",357100887,357139075,38188
"13433","ENSMODG00000018139","2",356969433,356971014,1581
"13434","ENSMODG00000018140","4",74768149,74873697,105548
"13435","ENSMODG00000018141","8",108274231,108286212,11981
"13436","ENSMODG00000018142","2",355875737,356014654,138917
"13437","ENSMODG00000018145","8",108288540,108293602,5062
"13438","ENSMODG00000018146","8",108306091,108308548,2457
"13439","ENSMODG00000018147","4",74873473,75045363,171890
"13440","ENSMODG00000018148","8",108309718,108323875,14157
"13441","ENSMODG00000018150","2",351969325,352188211,218886
"13442","ENSMODG00000018151","8",108325653,108328442,2789
"13443","ENSMODG00000018152","4",75051374,75123447,72073
"13444","ENSMODG00000018153","8",108400413,108407837,7424
"13445","ENSMODG00000018154","8",108411282,108417681,6399
"13446","ENSMODG00000018156","8",108438809,108460403,21594
"13447","ENSMODG00000018157","4",75129885,75311746,181861
"13448","ENSMODG00000018158","4",75329097,75354303,25206
"13449","ENSMODG00000018159","8",108475460,108484312,8852
"13450","ENSMODG00000018160","4",75382096,75403121,21025
"13451","ENSMODG00000018161","8",108484145,108495202,11057
"13452","ENSMODG00000018163","8",108491988,108524614,32626
"13453","ENSMODG00000018164","4",75432286,75457292,25006
"13454","ENSMODG00000018165","2",348744684,348745976,1292
"13455","ENSMODG00000018166","4",75533565,75694737,161172
"13456","ENSMODG00000018167","8",108535844,108550497,14653
"13457","ENSMODG00000018168","4",75697768,75713415,15647
"13458","ENSMODG00000018169","4",75720694,75839700,119006
"13459","ENSMODG00000018170","2",348255902,348339569,83667
"13460","ENSMODG00000018171","8",108576219,108590376,14157
"13461","ENSMODG00000018172","4",75855270,75888780,33510
"13462","ENSMODG00000018173","4",75920283,75991790,71507
"13463","ENSMODG00000018176","2",347484937,347573197,88260
"13464","ENSMODG00000018178","2",347442309,347443781,1472
"13465","ENSMODG00000018179","4",415713937,416167720,453783
"13466","ENSMODG00000018180","2",347358495,347427618,69123
"13467","ENSMODG00000018181","4",76189809,76253779,63970
"13468","ENSMODG00000018182","8",108694549,108720938,26389
"13469","ENSMODG00000018184","4",78052576,78187677,135101
"13470","ENSMODG00000018185","4",78320651,78800890,480239
"13471","ENSMODG00000018186","4",82328352,82536779,208427
"13472","ENSMODG00000018187","8",108748713,108782486,33773
"13473","ENSMODG00000018189","4",82687132,82723496,36364
"13474","ENSMODG00000018190","4",82734448,82779052,44604
"13475","ENSMODG00000018191","4",82864589,83044980,180391
"13476","ENSMODG00000018192","4",83052777,83083199,30422
"13477","ENSMODG00000018193","8",108839805,108920501,80696
"13478","ENSMODG00000018194","8",108831623,108832633,1010
"13479","ENSMODG00000018195","4",83101572,83130215,28643
"13480","ENSMODG00000018196","8",109002541,109104375,101834
"13481","ENSMODG00000018197","4",83130757,83161522,30765
"13482","ENSMODG00000018198","8",109149941,109282336,132395
"13483","ENSMODG00000018199","4",83182915,83223549,40634
"13484","ENSMODG00000018200","4",83286258,83309798,23540
"13485","ENSMODG00000018202","4",83314414,83367691,53277
"13486","ENSMODG00000018204","8",110106804,110376150,269346
"13487","ENSMODG00000018205","4",83393959,83418098,24139
"13488","ENSMODG00000018206","4",83397277,83435225,37948
"13489","ENSMODG00000018208","4",83442772,83514828,72056
"13490","ENSMODG00000018211","8",110968941,110998103,29162
"13491","ENSMODG00000018212","4",83572472,83605454,32982
"13492","ENSMODG00000018213","2",347074422,347289156,214734
"13493","ENSMODG00000018214","8",111209653,111227953,18300
"13494","ENSMODG00000018215","8",111232520,111267060,34540
"13495","ENSMODG00000018216","4",83633575,83868092,234517
"13496","ENSMODG00000018218","8",111306914,111329442,22528
"13497","ENSMODG00000018219","8",111348962,111358604,9642
"13498","ENSMODG00000018220","8",111410379,111432847,22468
"13499","ENSMODG00000018221","4",84011261,84131715,120454
"13500","ENSMODG00000018222","4",84206943,84224069,17126
"13501","ENSMODG00000018223","8",111463388,111484713,21325
"13502","ENSMODG00000018225","8",111601887,111607702,5815
"13503","ENSMODG00000018226","8",111666797,111668043,1246
"13504","ENSMODG00000018227","4",84271422,84387950,116528
"13505","ENSMODG00000018229","4",84541201,84556464,15263
"13506","ENSMODG00000018230","4",84576863,84665330,88467
"13507","ENSMODG00000018231","8",111848833,111895179,46346
"13508","ENSMODG00000018232","4",84676687,84742662,65975
"13509","ENSMODG00000018233","4",84742195,84771615,29420
"13510","ENSMODG00000018234","8",111903848,111988547,84699
"13511","ENSMODG00000018236","4",85162980,85163907,927
"13512","ENSMODG00000018237","8",112075047,112200859,125812
"13513","ENSMODG00000018238","8",112388320,112707173,318853
"13514","ENSMODG00000018243","4",85220520,85488230,267710
"13515","ENSMODG00000018247","8",113231483,113232079,596
"13516","ENSMODG00000018248","8",113356493,113385257,28764
"13517","ENSMODG00000018249","8",113426497,113462067,35570
"13518","ENSMODG00000018250","4",416244678,416245304,626
"13519","ENSMODG00000018252","4",85505081,85637770,132689
"13520","ENSMODG00000018255","8",113593486,113603738,10252
"13521","ENSMODG00000018256","8",113635373,113656845,21472
"13522","ENSMODG00000018257","4",415222153,415622470,400317
"13523","ENSMODG00000018258","8",113687817,113724800,36983
"13524","ENSMODG00000018259","8",113745105,113768967,23862
"13525","ENSMODG00000018260","4",415270529,415319430,48901
"13526","ENSMODG00000018261","8",113840104,113849610,9506
"13527","ENSMODG00000018264","4",415111149,415118447,7298
"13528","ENSMODG00000018265","8",113876132,113889728,13596
"13529","ENSMODG00000018266","4",415047068,415049713,2645
"13530","ENSMODG00000018267","4",414964978,414976147,11169
"13531","ENSMODG00000018269","4",85774009,85818116,44107
"13532","ENSMODG00000018270","2",347063796,347065809,2013
"13533","ENSMODG00000018271","4",85834475,85905439,70964
"13534","ENSMODG00000018272","4",85905286,85991474,86188
"13535","ENSMODG00000018273","2",347002107,347057432,55325
"13536","ENSMODG00000018274","4",86011578,86087766,76188
"13537","ENSMODG00000018275","2",346723604,346782975,59371
"13538","ENSMODG00000018276","8",114051241,114079478,28237
"13539","ENSMODG00000018277","2",346632763,346672822,40059
"13540","ENSMODG00000018278","2",346573030,346623930,50900
"13541","ENSMODG00000018279","2",346430324,346464578,34254
"13542","ENSMODG00000018280","4",86096620,86154191,57571
"13543","ENSMODG00000018281","2",346404104,346426769,22665
"13544","ENSMODG00000018282","2",346338650,346351391,12741
"13545","ENSMODG00000018283","8",113909522,113942164,32642
"13546","ENSMODG00000018284","2",346314928,346319102,4174
"13547","ENSMODG00000018285","8",113951214,113975233,24019
"13548","ENSMODG00000018286","4",86161677,86194558,32881
"13549","ENSMODG00000018287","8",113975982,114013863,37881
"13550","ENSMODG00000018288","4",86222548,86288365,65817
"13551","ENSMODG00000018289","2",345845353,346180055,334702
"13552","ENSMODG00000018290","2",345196530,345197951,1421
"13553","ENSMODG00000018291","4",86437378,86583156,145778
"13554","ENSMODG00000018292","2",344866717,345007025,140308
"13555","ENSMODG00000018294","2",344602475,344602786,311
"13556","ENSMODG00000018295","4",86687828,86695757,7929
"13557","ENSMODG00000018296","4",86720014,86727367,7353
"13558","ENSMODG00000018297","2",344305766,344333998,28232
"13559","ENSMODG00000018298","4",86803377,86833209,29832
"13560","ENSMODG00000018299","8",114079494,114135747,56253
"13561","ENSMODG00000018300","4",86839052,86877978,38926
"13562","ENSMODG00000018302","8",114146633,114284130,137497
"13563","ENSMODG00000018303","8",114298537,114324171,25634
"13564","ENSMODG00000018304","2",344180238,344297636,117398
"13565","ENSMODG00000018305","8",114343643,114344404,761
"13566","ENSMODG00000018306","4",86913819,86962434,48615
"13567","ENSMODG00000018307","2",344098697,344180626,81929
"13568","ENSMODG00000018308","4",87086018,87211868,125850
"13569","ENSMODG00000018310","2",344035061,344098625,63564
"13570","ENSMODG00000018311","4",87218579,87246382,27803
"13571","ENSMODG00000018312","8",114355999,114393800,37801
"13572","ENSMODG00000018313","4",87267527,87307538,40011
"13573","ENSMODG00000018314","2",343974107,344031929,57822
"13574","ENSMODG00000018316","2",343907372,343946236,38864
"13575","ENSMODG00000018317","2",343882683,343898565,15882
"13576","ENSMODG00000018318","4",87306996,87377997,71001
"13577","ENSMODG00000018319","2",343703808,343797238,93430
"13578","ENSMODG00000018320","4",87410347,87473582,63235
"13579","ENSMODG00000018321","2",343608826,343634237,25411
"13580","ENSMODG00000018322","4",87474941,87625462,150521
"13581","ENSMODG00000018324","8",114897201,114929989,32788
"13582","ENSMODG00000018325","4",87665235,87819823,154588
"13583","ENSMODG00000018326","8",115109416,115229070,119654
"13584","ENSMODG00000018328","4",87983953,88180314,196361
"13585","ENSMODG00000018329","8",115297890,115398711,100821
"13586","ENSMODG00000018331","4",88258638,88313821,55183
"13587","ENSMODG00000018332","8",115660299,115848982,188683
"13588","ENSMODG00000018333","4",88335439,88599412,263973
"13589","ENSMODG00000018335","8",115872525,116103188,230663
"13590","ENSMODG00000018338","4",88700273,88810797,110524
"13591","ENSMODG00000018340","8",116144402,116191320,46918
"13592","ENSMODG00000018341","4",88820211,89166628,346417
"13593","ENSMODG00000018342","8",116251427,116304853,53426
"13594","ENSMODG00000018344","8",116306186,116310879,4693
"13595","ENSMODG00000018345","2",342039918,342070930,31012
"13596","ENSMODG00000018346","4",89340816,89345400,4584
"13597","ENSMODG00000018347","4",89397441,89418159,20718
"13598","ENSMODG00000018349","8",116310560,116330044,19484
"13599","ENSMODG00000018350","4",89593101,90538674,945573
"13600","ENSMODG00000018351","8",116359173,116376179,17006
"13601","ENSMODG00000018352","8",116375008,116401339,26331
"13602","ENSMODG00000018353","4",90549436,90561602,12166
"13603","ENSMODG00000018354","8",116409258,116416287,7029
"13604","ENSMODG00000018355","2",341895301,342011630,116329
"13605","ENSMODG00000018357","2",341792428,341869878,77450
"13606","ENSMODG00000018360","4",90570130,90769347,199217
"13607","ENSMODG00000018361","2",340796981,340836125,39144
"13608","ENSMODG00000018362","2",340032291,340152165,119874
"13609","ENSMODG00000018364","2",339992071,340024731,32660
"13610","ENSMODG00000018366","2",339748968,339845463,96495
"13611","ENSMODG00000018367","4",90872329,90904627,32298
"13612","ENSMODG00000018368","4",90940839,91059405,118566
"13613","ENSMODG00000018370","8",116550799,116620916,70117
"13614","ENSMODG00000018371","4",91086248,91257252,171004
"13615","ENSMODG00000018373","8",116622416,116642578,20162
"13616","ENSMODG00000018374","4",91286781,91383899,97118
"13617","ENSMODG00000018375","8",116714976,116866272,151296
"13618","ENSMODG00000018376","2",339341902,339452398,110496
"13619","ENSMODG00000018377","4",91565828,91662184,96356
"13620","ENSMODG00000018378","8",116894546,116939187,44641
"13621","ENSMODG00000018379","4",105621365,105621939,574
"13622","ENSMODG00000018380","4",91675354,91776891,101537
"13623","ENSMODG00000018381","2",339295977,339297215,1238
"13624","ENSMODG00000018382","2",338865537,339167441,301904
"13625","ENSMODG00000018383","2",338811815,338820800,8985
"13626","ENSMODG00000018384","8",116955285,116995280,39995
"13627","ENSMODG00000018385","4",91829240,91882644,53404
"13628","ENSMODG00000018386","2",338781290,338809610,28320
"13629","ENSMODG00000018387","4",91906968,91958084,51116
"13630","ENSMODG00000018388","4",91973321,91976419,3098
"13631","ENSMODG00000018389","4",91977823,92039596,61773
"13632","ENSMODG00000018390","8",117004157,117137385,133228
"13633","ENSMODG00000018391","2",338670592,338776916,106324
"13634","ENSMODG00000018392","4",92046252,92208687,162435
"13635","ENSMODG00000018393","4",92218478,92265235,46757
"13636","ENSMODG00000018394","8",117166945,117211128,44183
"13637","ENSMODG00000018395","2",338453181,338659866,206685
"13638","ENSMODG00000018397","8",117245200,117392170,146970
"13639","ENSMODG00000018399","8",117394313,117546541,152228
"13640","ENSMODG00000018400","2",337574114,337682395,108281
"13641","ENSMODG00000018401","8",117661910,117841471,179561
"13642","ENSMODG00000018402","4",92318599,92345546,26947
"13643","ENSMODG00000018403","2",337815435,337816742,1307
"13644","ENSMODG00000018405","2",336921103,336928609,7506
"13645","ENSMODG00000018406","8",117846258,117869024,22766
"13646","ENSMODG00000018407","8",117976964,118302650,325686
"13647","ENSMODG00000018409","4",92351228,92383085,31857
"13648","ENSMODG00000018410","8",118086848,118087157,309
"13649","ENSMODG00000018411","8",118162470,118163699,1229
"13650","ENSMODG00000018412","2",335309912,335312056,2144
"13651","ENSMODG00000018413","8",118473874,118475076,1202
"13652","ENSMODG00000018414","2",334772588,335078021,305433
"13653","ENSMODG00000018415","8",118448806,118535270,86464
"13654","ENSMODG00000018416","8",118656741,118710711,53970
"13655","ENSMODG00000018417","4",92423623,92476380,52757
"13656","ENSMODG00000018418","2",334600394,334651547,51153
"13657","ENSMODG00000018419","8",118715663,118878992,163329
"13658","ENSMODG00000018420","2",334498673,334579187,80514
"13659","ENSMODG00000018421","8",118783367,118804787,21420
"13660","ENSMODG00000018423","4",92685548,92716431,30883
"13661","ENSMODG00000018424","8",118902250,118978597,76347
"13662","ENSMODG00000018425","2",333823918,333873466,49548
"13663","ENSMODG00000018427","4",92808431,92903359,94928
"13664","ENSMODG00000018428","2",333408900,333482149,73249
"13665","ENSMODG00000018429","4",92951916,92971607,19691
"13666","ENSMODG00000018430","4",92983212,93010870,27658
"13667","ENSMODG00000018432","4",93014534,93134020,119486
"13668","ENSMODG00000018433","8",119762502,119927119,164617
"13669","ENSMODG00000018434","4",93132184,93139166,6982
"13670","ENSMODG00000018435","2",332980351,333171299,190948
"13671","ENSMODG00000018436","8",120000720,120025001,24281
"13672","ENSMODG00000018437","4",93174172,93226726,52554
"13673","ENSMODG00000018438","8",120034106,120035878,1772
"13674","ENSMODG00000018439","8",120075646,120107875,32229
"13675","ENSMODG00000018440","8",120114455,120114881,426
"13676","ENSMODG00000018442","4",93256719,93284015,27296
"13677","ENSMODG00000018443","8",120119843,120158809,38966
"13678","ENSMODG00000018444","2",332878801,332905929,27128
"13679","ENSMODG00000018445","4",93329969,93336507,6538
"13680","ENSMODG00000018446","4",93342595,93357516,14921
"13681","ENSMODG00000018447","4",93470411,93504458,34047
"13682","ENSMODG00000018448","8",120282054,120430594,148540
"13683","ENSMODG00000018449","8",120456476,120464699,8223
"13684","ENSMODG00000018451","4",93517735,93519280,1545
"13685","ENSMODG00000018452","8",120466535,120489426,22891
"13686","ENSMODG00000018453","4",93589547,93594824,5277
"13687","ENSMODG00000018455","4",93596441,93779703,183262
"13688","ENSMODG00000018456","8",120499963,120586549,86586
"13689","ENSMODG00000018457","8",120593063,120645205,52142
"13690","ENSMODG00000018459","4",93667910,93718869,50959
"13691","ENSMODG00000018460","4",93715389,93767724,52335
"13692","ENSMODG00000018462","4",93773789,93782699,8910
"13693","ENSMODG00000018463","8",120718125,120941939,223814
"13694","ENSMODG00000018466","8",121092731,121109270,16539
"13695","ENSMODG00000018468","2",332471755,332472723,968
"13696","ENSMODG00000018469","8",121120315,121156795,36480
"13697","ENSMODG00000018470","2",332455675,332456634,959
"13698","ENSMODG00000018471","2",332402050,332402997,947
"13699","ENSMODG00000018475","4",414868936,414931803,62867
"13700","ENSMODG00000018476","2",331292186,331292706,520
"13701","ENSMODG00000018477","2",330835952,331191893,355941
"13702","ENSMODG00000018479","4",93927755,93956562,28807
"13703","ENSMODG00000018480","2",330490545,330689786,199241
"13704","ENSMODG00000018481","8",121178199,121272501,94302
"13705","ENSMODG00000018487","2",328528626,328668724,140098
"13706","ENSMODG00000018489","2",328320238,328518727,198489
"13707","ENSMODG00000018490","8",121319077,121320244,1167
"13708","ENSMODG00000018491","4",94213621,94215030,1409
"13709","ENSMODG00000018492","8",121321250,121358533,37283
"13710","ENSMODG00000018493","4",94218280,94247757,29477
"13711","ENSMODG00000018494","4",94280298,94446626,166328
"13712","ENSMODG00000018495","2",328195533,328299306,103773
"13713","ENSMODG00000018497","2",327687405,327997662,310257
"13714","ENSMODG00000018498","4",94497732,94656738,159006
"13715","ENSMODG00000018499","8",121443209,121443718,509
"13716","ENSMODG00000018500","8",121476359,121543756,67397
"13717","ENSMODG00000018501","8",121761906,121843123,81217
"13718","ENSMODG00000018502","2",327601127,327650120,48993
"13719","ENSMODG00000018503","2",327579360,327586257,6897
"13720","ENSMODG00000018504","8",121899565,121939591,40026
"13721","ENSMODG00000018505","4",94825765,94925589,99824
"13722","ENSMODG00000018506","8",121937340,121977392,40052
"13723","ENSMODG00000018507","2",327391750,327533413,141663
"13724","ENSMODG00000018508","4",95111565,95142155,30590
"13725","ENSMODG00000018509","8",122017142,122038747,21605
"13726","ENSMODG00000018510","4",95302225,95305307,3082
"13727","ENSMODG00000018511","4",95305949,95356009,50060
"13728","ENSMODG00000018512","2",327272569,327273670,1101
"13729","ENSMODG00000018514","4",95422776,95532267,109491
"13730","ENSMODG00000018516","8",122037507,122121965,84458
"13731","ENSMODG00000018517","8",122166901,122170867,3966
"13732","ENSMODG00000018518","4",96076015,96580563,504548
"13733","ENSMODG00000018519","8",122487463,122531520,44057
"13734","ENSMODG00000018520","2",325647063,325829548,182485
"13735","ENSMODG00000018521","8",122737298,122748002,10704
"13736","ENSMODG00000018522","2",325537921,325594259,56338
"13737","ENSMODG00000018524","4",97949761,97951367,1606
"13738","ENSMODG00000018525","8",122974221,123029257,55036
"13739","ENSMODG00000018526","4",98096047,98147896,51849
"13740","ENSMODG00000018527","8",123043975,123279615,235640
"13741","ENSMODG00000018530","8",123283038,123520425,237387
"13742","ENSMODG00000018531","8",123547304,123678069,130765
"13743","ENSMODG00000018532","8",123671421,123671803,382
"13744","ENSMODG00000018533","2",325452048,325456981,4933
"13745","ENSMODG00000018534","8",123700217,123833130,132913
"13746","ENSMODG00000018535","8",123893184,123932030,38846
"13747","ENSMODG00000018536","8",123945252,123970678,25426
"13748","ENSMODG00000018537","4",98192809,98422915,230106
"13749","ENSMODG00000018538","8",124010062,124115389,105327
"13750","ENSMODG00000018540","4",98739290,98807669,68379
"13751","ENSMODG00000018541","4",98827231,98854183,26952
"13752","ENSMODG00000018543","2",325405240,325439238,33998
"13753","ENSMODG00000018544","8",124271044,124372734,101690
"13754","ENSMODG00000018545","2",325348484,325388630,40146
"13755","ENSMODG00000018546","2",325341491,325359489,17998
"13756","ENSMODG00000018548","2",325006534,325258808,252274
"13757","ENSMODG00000018549","4",100145252,100178058,32806
"13758","ENSMODG00000018550","8",124435102,124518276,83174
"13759","ENSMODG00000018551","4",100215831,100265720,49889
"13760","ENSMODG00000018552","8",124621363,124758718,137355
"13761","ENSMODG00000018553","4",100276055,100280714,4659
"13762","ENSMODG00000018554","4",100337545,100354306,16761
"13763","ENSMODG00000018556","8",124784170,124971434,187264
"13764","ENSMODG00000018557","2",323441084,324181477,740393
"13765","ENSMODG00000018559","4",100398401,100516787,118386
"13766","ENSMODG00000018560","2",322488400,322570015,81615
"13767","ENSMODG00000018561","2",321972786,322061236,88450
"13768","ENSMODG00000018563","2",321691140,321971475,280335
"13769","ENSMODG00000018564","4",100524491,100562324,37833
"13770","ENSMODG00000018565","4",100610322,100723603,113281
"13771","ENSMODG00000018566","4",414861769,414867148,5379
"13772","ENSMODG00000018567","2",321479926,321697040,217114
"13773","ENSMODG00000018568","4",414857265,414858469,1204
"13774","ENSMODG00000018569","4",100748988,100834647,85659
"13775","ENSMODG00000018570","4",414847185,414856901,9716
"13776","ENSMODG00000018571","2",321591389,321614267,22878
"13777","ENSMODG00000018573","4",100837314,100873655,36341
"13778","ENSMODG00000018574","4",414719513,414824556,105043
"13779","ENSMODG00000018576","4",100899276,100955017,55741
"13780","ENSMODG00000018577","4",414648538,414687267,38729
"13781","ENSMODG00000018578","4",414569198,414571136,1938
"13782","ENSMODG00000018579","2",321116019,321243020,127001
"13783","ENSMODG00000018580","4",414561514,414568413,6899
"13784","ENSMODG00000018581","4",100978966,101179777,200811
"13785","ENSMODG00000018582","4",414510369,414517313,6944
"13786","ENSMODG00000018583","4",414446200,414454923,8723
"13787","ENSMODG00000018584","2",320670552,321103803,433251
"13788","ENSMODG00000018585","4",414386684,414405255,18571
"13789","ENSMODG00000018586","2",320321898,320539117,217219
"13790","ENSMODG00000018587","4",414379333,414386563,7230
"13791","ENSMODG00000018588","4",414294781,414301283,6502
"13792","ENSMODG00000018592","4",414238868,414246882,8014
"13793","ENSMODG00000018593","4",414213789,414229871,16082
"13794","ENSMODG00000018594","4",414211554,414213279,1725
"13795","ENSMODG00000018595","4",414124205,414125025,820
"13796","ENSMODG00000018597","4",101386250,101387395,1145
"13797","ENSMODG00000018598","4",101888107,101906964,18857
"13798","ENSMODG00000018599","4",101910214,101947981,37767
"13799","ENSMODG00000018603","4",102168981,102216894,47913
"13800","ENSMODG00000018604","4",102275747,102368810,93063
"13801","ENSMODG00000018605","Un",98262850,98263816,966
"13802","ENSMODG00000018607","4",102486324,102487159,835
"13803","ENSMODG00000018608","2",319406692,319970903,564211
"13804","ENSMODG00000018610","4",103734556,103983106,248550
"13805","ENSMODG00000018611","Un",49815389,49824912,9523
"13806","ENSMODG00000018612","2",317355426,317356290,864
"13807","ENSMODG00000018613","4",104102819,104160736,57917
"13808","ENSMODG00000018618","Un",53514230,53527628,13398
"13809","ENSMODG00000018619","Un",49285938,49332531,46593
"13810","ENSMODG00000018620","4",104487233,104529376,42143
"13811","ENSMODG00000018624","4",104562052,104698862,136810
"13812","ENSMODG00000018625","4",105141366,105177248,35882
"13813","ENSMODG00000018626","4",105305812,105308745,2933
"13814","ENSMODG00000018630","7",242746147,242746920,773
"13815","ENSMODG00000018631","4",105441255,105955037,513782
"13816","ENSMODG00000018633","4",105985176,106012076,26900
"13817","ENSMODG00000018634","4",106121523,106172685,51162
"13818","ENSMODG00000018639","4",109325989,109628682,302693
"13819","ENSMODG00000018641","Un",42524052,42540968,16916
"13820","ENSMODG00000018642","4",109717293,109832128,114835
"13821","ENSMODG00000018643","Un",42548697,42549715,1018
"13822","ENSMODG00000018645","Un",42559224,42572871,13647
"13823","ENSMODG00000018646","Un",42574817,42577923,3106
"13824","ENSMODG00000018647","Un",42638182,42640562,2380
"13825","ENSMODG00000018648","4",109936611,109984757,48146
"13826","ENSMODG00000018651","4",110010425,110033405,22980
"13827","ENSMODG00000018653","4",110042866,110050275,7409
"13828","ENSMODG00000018655","4",110152110,110153121,1011
"13829","ENSMODG00000018656","Un",42878878,42907244,28366
"13830","ENSMODG00000018658","Un",43057180,43135434,78254
"13831","ENSMODG00000018659","4",110133260,110242348,109088
"13832","ENSMODG00000018662","4",110260490,110344272,83782
"13833","ENSMODG00000018664","4",110350458,110429056,78598
"13834","ENSMODG00000018665","Un",47973093,47999464,26371
"13835","ENSMODG00000018676","Un",38144031,38160069,16038
"13836","ENSMODG00000018677","4",110430557,110472563,42006
"13837","ENSMODG00000018680","4",110516605,110568516,51911
"13838","ENSMODG00000018682","Un",53601341,53619459,18118
"13839","ENSMODG00000018683","4",110616405,110642873,26468
"13840","ENSMODG00000018685","2",492024700,492044598,19898
"13841","ENSMODG00000018687","2",314010207,314023250,13043
"13842","ENSMODG00000018688","2",492154073,492209924,55851
"13843","ENSMODG00000018689","2",313838028,313839154,1126
"13844","ENSMODG00000018690","4",110697431,110796501,99070
"13845","ENSMODG00000018691","2",313775208,313775889,681
"13846","ENSMODG00000018692","2",492228750,492230867,2117
"13847","ENSMODG00000018694","2",492268621,492270894,2273
"13848","ENSMODG00000018695","4",110814269,110868000,53731
"13849","ENSMODG00000018697","2",312522955,312524139,1184
"13850","ENSMODG00000018698","4",110919408,110942494,23086
"13851","ENSMODG00000018699","2",312408616,312515387,106771
"13852","ENSMODG00000018700","2",492297623,492472070,174447
"13853","ENSMODG00000018701","2",312291189,312303900,12711
"13854","ENSMODG00000018705","2",492584249,492609943,25694
"13855","ENSMODG00000018706","2",311827897,311835634,7737
"13856","ENSMODG00000018708","2",492668783,492936104,267321
"13857","ENSMODG00000018710","2",492943598,492960838,17240
"13858","ENSMODG00000018713","2",492986973,493018663,31690
"13859","ENSMODG00000018714","2",309336419,310142196,805777
"13860","ENSMODG00000018715","2",307861625,308254513,392888
"13861","ENSMODG00000018717","2",493050506,493113750,63244
"13862","ENSMODG00000018719","4",111030381,111172853,142472
"13863","ENSMODG00000018720","2",307683398,307719139,35741
"13864","ENSMODG00000018721","2",307625856,307679205,53349
"13865","ENSMODG00000018722","2",307499927,307614281,114354
"13866","ENSMODG00000018724","2",307401998,307476926,74928
"13867","ENSMODG00000018728","Un",33591132,33639749,48617
"13868","ENSMODG00000018730","Un",33655426,33709712,54286
"13869","ENSMODG00000018732","Un",33710717,33730640,19923
"13870","ENSMODG00000018735","Un",33770831,33807848,37017
"13871","ENSMODG00000018736","2",493629709,493656521,26812
"13872","ENSMODG00000018737","Un",33810089,33830853,20764
"13873","ENSMODG00000018738","2",493689641,493706629,16988
"13874","ENSMODG00000018739","2",493813155,493814225,1070
"13875","ENSMODG00000018741","2",494224401,494274394,49993
"13876","ENSMODG00000018742","2",494086959,494129659,42700
"13877","ENSMODG00000018744","2",494129742,494171642,41900
"13878","ENSMODG00000018745","2",494273732,494284515,10783
"13879","ENSMODG00000018746","2",494288846,494296865,8019
"13880","ENSMODG00000018747","2",494292998,494298635,5637
"13881","ENSMODG00000018748","2",494306094,494321426,15332
"13882","ENSMODG00000018749","2",494342560,494364190,21630
"13883","ENSMODG00000018750","2",494365659,494373610,7951
"13884","ENSMODG00000018751","2",494373663,494379767,6104
"13885","ENSMODG00000018752","2",494375867,494381661,5794
"13886","ENSMODG00000018753","2",494387444,494401445,14001
"13887","ENSMODG00000018754","2",494411476,494414760,3284
"13888","ENSMODG00000018755","2",494437477,494441774,4297
"13889","ENSMODG00000018756","2",494457092,494463653,6561
"13890","ENSMODG00000018760","2",494949039,495081469,132430
"13891","ENSMODG00000018761","2",494949020,494971094,22074
"13892","ENSMODG00000018764","6",253703287,253703694,407
"13893","ENSMODG00000018766","2",495021672,495034321,12649
"13894","ENSMODG00000018767","2",495042680,495047853,5173
"13895","ENSMODG00000018769","2",495050215,495060300,10085
"13896","ENSMODG00000018770","2",495062648,495155430,92782
"13897","ENSMODG00000018771","2",495244559,495316750,72191
"13898","ENSMODG00000018772","2",495345054,495350307,5253
"13899","ENSMODG00000018774","2",495461315,495551878,90563
"13900","ENSMODG00000018775","2",306764543,307378447,613904
"13901","ENSMODG00000018776","2",495451332,495481418,30086
"13902","ENSMODG00000018777","2",306154560,306299441,144881
"13903","ENSMODG00000018778","2",495481622,495485234,3612
"13904","ENSMODG00000018780","2",495488312,495495524,7212
"13905","ENSMODG00000018781","2",495499928,495505473,5545
"13906","ENSMODG00000018782","2",305637774,305913046,275272
"13907","ENSMODG00000018783","2",495507676,495519000,11324
"13908","ENSMODG00000018784","2",305211184,305460776,249592
"13909","ENSMODG00000018785","2",305044735,305083025,38290
"13910","ENSMODG00000018786","2",495555797,495635696,79899
"13911","ENSMODG00000018787","2",304861037,305014537,153500
"13912","ENSMODG00000018788","2",304359569,304470432,110863
"13913","ENSMODG00000018789","2",303727656,303728125,469
"13914","ENSMODG00000018790","2",303512791,303724185,211394
"13915","ENSMODG00000018791","2",303072178,303465024,392846
"13916","ENSMODG00000018792","2",495638291,495653622,15331
"13917","ENSMODG00000018794","2",302818292,302940541,122249
"13918","ENSMODG00000018795","2",302530187,302591760,61573
"13919","ENSMODG00000018796","2",495654031,495659765,5734
"13920","ENSMODG00000018798","2",302505845,302516024,10179
"13921","ENSMODG00000018799","2",495719571,495731108,11537
"13922","ENSMODG00000018800","2",302214489,302285788,71299
"13923","ENSMODG00000018801","2",495755027,495757022,1995
"13924","ENSMODG00000018802","2",301863455,301954524,91069
"13925","ENSMODG00000018803","2",301719951,301758110,38159
"13926","ENSMODG00000018804","2",495805918,495813617,7699
"13927","ENSMODG00000018805","2",495842731,495866826,24095
"13928","ENSMODG00000018806","2",301666617,301699360,32743
"13929","ENSMODG00000018807","2",495873647,495901975,28328
"13930","ENSMODG00000018808","2",301562631,301627277,64646
"13931","ENSMODG00000018809","2",495916736,495931989,15253
"13932","ENSMODG00000018810","2",301530362,301548920,18558
"13933","ENSMODG00000018811","2",495950338,495980140,29802
"13934","ENSMODG00000018812","2",301476489,301513817,37328
"13935","ENSMODG00000018813","2",301442604,301451589,8985
"13936","ENSMODG00000018814","2",495986162,496043319,57157
"13937","ENSMODG00000018815","2",301326777,301422373,95596
"13938","ENSMODG00000018816","2",301314002,301325427,11425
"13939","ENSMODG00000018818","2",301025149,301068284,43135
"13940","ENSMODG00000018819","2",300934702,301017870,83168
"13941","ENSMODG00000018821","2",496097569,496125635,28066
"13942","ENSMODG00000018822","2",300686477,300721247,34770
"13943","ENSMODG00000018823","2",300626004,300629878,3874
"13944","ENSMODG00000018825","2",496123691,496136630,12939
"13945","ENSMODG00000018826","2",496142537,496163642,21105
"13946","ENSMODG00000018827","2",496156935,496165754,8819
"13947","ENSMODG00000018828","2",299648104,300417111,769007
"13948","ENSMODG00000018829","2",496174855,496244247,69392
"13949","ENSMODG00000018831","2",298599774,298632399,32625
"13950","ENSMODG00000018832","2",496249100,496252093,2993
"13951","ENSMODG00000018833","2",496257059,496258346,1287
"13952","ENSMODG00000018834","2",298460628,298539391,78763
"13953","ENSMODG00000018836","2",496272453,496297733,25280
"13954","ENSMODG00000018837","1",188039837,188040778,941
"13955","ENSMODG00000018838","2",296930933,296969034,38101
"13956","ENSMODG00000018839","2",496304251,496319957,15706
"13957","ENSMODG00000018841","2",496360037,496363552,3515
"13958","ENSMODG00000018842","2",496364122,496373629,9507
"13959","ENSMODG00000018845","2",496368287,496521637,153350
"13960","ENSMODG00000018846","2",296539218,296600694,61476
"13961","ENSMODG00000018847","Un",36602960,36616033,13073
"13962","ENSMODG00000018848","2",496374963,496385898,10935
"13963","ENSMODG00000018849","2",296450766,296486397,35631
"13964","ENSMODG00000018850","2",296416059,296449417,33358
"13965","ENSMODG00000018852","2",296285440,296356078,70638
"13966","ENSMODG00000018853","Un",94465802,94470496,4694
"13967","ENSMODG00000018854","2",496391641,496440896,49255
"13968","ENSMODG00000018855","2",296171116,296214305,43189
"13969","ENSMODG00000018856","2",295875235,295875979,744
"13970","ENSMODG00000018857","2",496461344,496470911,9567
"13971","ENSMODG00000018858","2",294699977,294700662,685
"13972","ENSMODG00000018859","2",294184559,294231222,46663
"13973","ENSMODG00000018861","2",294066986,294102847,35861
"13974","ENSMODG00000018862","2",496472214,496498281,26067
"13975","ENSMODG00000018863","2",293990380,294044411,54031
"13976","ENSMODG00000018866","2",496519243,496523018,3775
"13977","ENSMODG00000018869","2",496533601,496539568,5967
"13978","ENSMODG00000018870","2",293778167,293947350,169183
"13979","ENSMODG00000018871","2",496593621,496595272,1651
"13980","ENSMODG00000018875","2",496599285,496657330,58045
"13981","ENSMODG00000018876","2",293397672,293501765,104093
"13982","ENSMODG00000018877","5",3925676,4164947,239271
"13983","ENSMODG00000018879","2",496796605,496856551,59946
"13984","ENSMODG00000018880","2",293127944,293190788,62844
"13985","ENSMODG00000018882","2",292884473,292988909,104436
"13986","ENSMODG00000018884","2",292804813,292840263,35450
"13987","ENSMODG00000018886","2",292662304,292695379,33075
"13988","ENSMODG00000018887","5",4939246,4998563,59317
"13989","ENSMODG00000018889","2",292648197,292659030,10833
"13990","ENSMODG00000018890","5",6504469,6505458,989
"13991","ENSMODG00000018893","2",496906032,496986756,80724
"13992","ENSMODG00000018894","2",292483967,292578659,94692
"13993","ENSMODG00000018895","5",6581105,6748773,167668
"13994","ENSMODG00000018896","2",291987715,292377139,389424
"13995","ENSMODG00000018898","5",6752694,6793166,40472
"13996","ENSMODG00000018899","5",6793530,6850419,56889
"13997","ENSMODG00000018900","2",497032218,497045081,12863
"13998","ENSMODG00000018901","5",6923726,6931610,7884
"13999","ENSMODG00000018903","5",7034081,7044688,10607
"14000","ENSMODG00000018904","2",497052674,497054734,2060
"14001","ENSMODG00000018906","2",497057542,497081461,23919
"14002","ENSMODG00000018907","2",291809088,291815400,6312
"14003","ENSMODG00000018908","2",497105841,497107622,1781
"14004","ENSMODG00000018909","2",291786877,291796656,9779
"14005","ENSMODG00000018910","2",291543420,291626083,82663
"14006","ENSMODG00000018911","2",497109868,497147176,37308
"14007","ENSMODG00000018912","2",290551935,290825152,273217
"14008","ENSMODG00000018913","5",7310199,7586043,275844
"14009","ENSMODG00000018917","2",497172335,497186491,14156
"14010","ENSMODG00000018918","5",7214677,7278880,64203
"14011","ENSMODG00000018919","2",497256742,497275184,18442
"14012","ENSMODG00000018920","2",497312546,497331243,18697
"14013","ENSMODG00000018921","2",290054002,290297286,243284
"14014","ENSMODG00000018923","2",289399371,289457650,58279
"14015","ENSMODG00000018925","5",7757590,7866827,109237
"14016","ENSMODG00000018926","2",289296155,289313357,17202
"14017","ENSMODG00000018927","5",7871887,7956225,84338
"14018","ENSMODG00000018928","2",289272977,289282889,9912
"14019","ENSMODG00000018929","2",289254092,289263952,9860
"14020","ENSMODG00000018930","2",289247083,289250786,3703
"14021","ENSMODG00000018931","5",7958474,7963501,5027
"14022","ENSMODG00000018933","2",289242866,289246023,3157
"14023","ENSMODG00000018934","5",7961611,7982809,21198
"14024","ENSMODG00000018935","2",289175723,289210755,35032
"14025","ENSMODG00000018936","5",8064851,8112209,47358
"14026","ENSMODG00000018937","5",8184236,8184739,503
"14027","ENSMODG00000018938","5",8235960,8236703,743
"14028","ENSMODG00000018939","5",8390706,8466383,75677
"14029","ENSMODG00000018940","5",8845385,8860701,15316
"14030","ENSMODG00000018941","2",289008885,289043970,35085
"14031","ENSMODG00000018942","5",8968535,9238929,270394
"14032","ENSMODG00000018943","5",9636079,9636879,800
"14033","ENSMODG00000018944","5",10111736,10123490,11754
"14034","ENSMODG00000018945","2",288924685,288982520,57835
"14035","ENSMODG00000018947","5",10220886,10391515,170629
"14036","ENSMODG00000018948","5",10401189,10401851,662
"14037","ENSMODG00000018949","5",10430799,10437014,6215
"14038","ENSMODG00000018950","2",288140495,288164919,24424
"14039","ENSMODG00000018951","5",10464299,10517925,53626
"14040","ENSMODG00000018952","2",287952602,287974231,21629
"14041","ENSMODG00000018953","5",10563344,10616388,53044
"14042","ENSMODG00000018954","2",287910200,287951688,41488
"14043","ENSMODG00000018955","5",10665434,10865161,199727
"14044","ENSMODG00000018956","2",287892172,287902431,10259
"14045","ENSMODG00000018957","2",497358802,497360094,1292
"14046","ENSMODG00000018959","2",287882803,288041844,159041
"14047","ENSMODG00000018960","5",10960317,11085644,125327
"14048","ENSMODG00000018961","2",287796352,287877156,80804
"14049","ENSMODG00000018962","5",11089103,11112049,22946
"14050","ENSMODG00000018963","2",287764961,287822228,57267
"14051","ENSMODG00000018964","2",287764663,287778044,13381
"14052","ENSMODG00000018965","2",497394602,497398205,3603
"14053","ENSMODG00000018967","2",287757265,287763996,6731
"14054","ENSMODG00000018968","Un",36287107,36346042,58935
"14055","ENSMODG00000018969","2",287749698,287753397,3699
"14056","ENSMODG00000018970","2",287742281,287750383,8102
"14057","ENSMODG00000018972","2",287695867,287700807,4940
"14058","ENSMODG00000018973","2",287657935,287697929,39994
"14059","ENSMODG00000018974","2",287590347,287613212,22865
"14060","ENSMODG00000018975","2",287513103,287528251,15148
"14061","ENSMODG00000018976","5",11174805,11256154,81349
"14062","ENSMODG00000018977","2",287528408,287535326,6918
"14063","ENSMODG00000018978","2",287427965,287500075,72110
"14064","ENSMODG00000018979","2",287392848,287396053,3205
"14065","ENSMODG00000018980","2",287339105,287375465,36360
"14066","ENSMODG00000018981","2",287325469,287337444,11975
"14067","ENSMODG00000018983","2",287220902,287313552,92650
"14068","ENSMODG00000018984","5",11279587,11296471,16884
"14069","ENSMODG00000018985","5",11359896,11360732,836
"14070","ENSMODG00000018986","5",11965019,11965514,495
"14071","ENSMODG00000018987","2",286880829,286881941,1112
"14072","ENSMODG00000018988","2",287206146,287219011,12865
"14073","ENSMODG00000018989","2",287194700,287203047,8347
"14074","ENSMODG00000018990","2",287170439,287193236,22797
"14075","ENSMODG00000018991","5",12000463,12227690,227227
"14076","ENSMODG00000018992","5",12207982,12211347,3365
"14077","ENSMODG00000018997","5",13423096,13562938,139842
"14078","ENSMODG00000018998","5",13564439,13565476,1037
"14079","ENSMODG00000018999","5",13650977,13676033,25056
"14080","ENSMODG00000019001","5",13701157,13746727,45570
"14081","ENSMODG00000019003","5",13755066,13774546,19480
"14082","ENSMODG00000019004","5",13776742,13804107,27365
"14083","ENSMODG00000019005","5",13811979,13909803,97824
"14084","ENSMODG00000019006","5",13925239,14052832,127593
"14085","ENSMODG00000019007","2",287129950,287151525,21575
"14086","ENSMODG00000019008","5",14080740,14081550,810
"14087","ENSMODG00000019009","5",14151381,14444963,293582
"14088","ENSMODG00000019010","5",14151106,14167472,16366
"14089","ENSMODG00000019011","5",14183691,14215296,31605
"14090","ENSMODG00000019012","2",497484381,497488086,3705
"14091","ENSMODG00000019013","5",14239972,14251801,11829
"14092","ENSMODG00000019014","2",287099736,287120444,20708
"14093","ENSMODG00000019016","Un",36360550,36361470,920
"14094","ENSMODG00000019017","5",14453319,14664022,210703
"14095","ENSMODG00000019018","2",287092440,287098305,5865
"14096","ENSMODG00000019019","Un",36409779,36431167,21388
"14097","ENSMODG00000019022","2",287080083,287089274,9191
"14098","ENSMODG00000019023","5",14909940,14910797,857
"14099","ENSMODG00000019026","5",14971103,14995150,24047
"14100","ENSMODG00000019027","5",15068106,15109538,41432
"14101","ENSMODG00000019028","2",286987770,287000075,12305
"14102","ENSMODG00000019030","2",286941356,286977075,35719
"14103","ENSMODG00000019031","5",15127617,15146114,18497
"14104","ENSMODG00000019032","2",286833130,286863383,30253
"14105","ENSMODG00000019036","5",15157960,15204883,46923
"14106","ENSMODG00000019037","2",286662317,286831294,168977
"14107","ENSMODG00000019038","Un",25668939,25670360,1421
"14108","ENSMODG00000019039","5",15248959,15339043,90084
"14109","ENSMODG00000019042","2",286226570,286388049,161479
"14110","ENSMODG00000019044","5",15370727,15384492,13765
"14111","ENSMODG00000019045","2",286191816,286207930,16114
"14112","ENSMODG00000019046","5",15495559,15528959,33400
"14113","ENSMODG00000019049","5",15531722,15586634,54912
"14114","ENSMODG00000019050","5",15599289,15633048,33759
"14115","ENSMODG00000019051","5",15756354,15874112,117758
"14116","ENSMODG00000019053","5",15880004,15910879,30875
"14117","ENSMODG00000019054","4",388061958,388063091,1133
"14118","ENSMODG00000019055","5",15910788,15931917,21129
"14119","ENSMODG00000019056","5",15940238,15985597,45359
"14120","ENSMODG00000019057","4",388544847,388801160,256313
"14121","ENSMODG00000019058","5",16037224,16119944,82720
"14122","ENSMODG00000019059","5",16134761,16146051,11290
"14123","ENSMODG00000019060","Un",86468820,86473096,4276
"14124","ENSMODG00000019061","5",16754181,16802614,48433
"14125","ENSMODG00000019062","Un",35866759,35881152,14393
"14126","ENSMODG00000019063","Un",35889762,35900197,10435
"14127","ENSMODG00000019064","Un",35902017,35905319,3302
"14128","ENSMODG00000019065","5",17024186,17094621,70435
"14129","ENSMODG00000019066","Un",35909109,35927660,18551
"14130","ENSMODG00000019067","5",17659178,17803443,144265
"14131","ENSMODG00000019068","Un",35956324,35970189,13865
"14132","ENSMODG00000019070","5",17918315,18126524,208209
"14133","ENSMODG00000019071","Un",35991531,36009565,18034
"14134","ENSMODG00000019073","Un",36020937,36026127,5190
"14135","ENSMODG00000019074","Un",36031977,36048578,16601
"14136","ENSMODG00000019076","5",18211499,18212074,575
"14137","ENSMODG00000019077","5",18231919,18236571,4652
"14138","ENSMODG00000019078","2",923071,926875,3804
"14139","ENSMODG00000019079","5",18277816,18335972,58156
"14140","ENSMODG00000019080","5",18499501,18517063,17562
"14141","ENSMODG00000019082","2",928202,941492,13290
"14142","ENSMODG00000019083","5",18525677,18545943,20266
"14143","ENSMODG00000019084","5",18562477,18563883,1406
"14144","ENSMODG00000019085","2",1130370,1145573,15203
"14145","ENSMODG00000019086","2",1189902,1276253,86351
"14146","ENSMODG00000019087","5",18609403,18704745,95342
"14147","ENSMODG00000019088","5",18728408,18742463,14055
"14148","ENSMODG00000019089","2",1460996,1472296,11300
"14149","ENSMODG00000019090","5",18851092,18895465,44373
"14150","ENSMODG00000019091","2",1473522,1478255,4733
"14151","ENSMODG00000019092","5",18920646,18957280,36634
"14152","ENSMODG00000019094","2",1478470,1540881,62411
"14153","ENSMODG00000019095","2",1549285,1559829,10544
"14154","ENSMODG00000019096","Un",87976318,87983405,7087
"14155","ENSMODG00000019098","5",19158503,19517611,359108
"14156","ENSMODG00000019099","2",497807659,497812400,4741
"14157","ENSMODG00000019104","Un",89029482,89035086,5604
"14158","ENSMODG00000019105","5",19853661,19920069,66408
"14159","ENSMODG00000019107","2",197540636,197549123,8487
"14160","ENSMODG00000019108","2",498527902,498617059,89157
"14161","ENSMODG00000019110","8",116230967,116232909,1942
"14162","ENSMODG00000019111","2",498759750,498809347,49597
"14163","ENSMODG00000019113","2",498864656,498866604,1948
"14164","ENSMODG00000019114","2",498888589,498890558,1969
"14165","ENSMODG00000019115","5",20068440,20075584,7144
"14166","ENSMODG00000019120","2",498926994,498929249,2255
"14167","ENSMODG00000019121","2",499016161,499020992,4831
"14168","ENSMODG00000019123","2",499074347,499101230,26883
"14169","ENSMODG00000019124","2",499123900,499156115,32215
"14170","ENSMODG00000019125","2",499174541,499184870,10329
"14171","ENSMODG00000019126","2",499187806,499196448,8642
"14172","ENSMODG00000019128","2",499202345,499333096,130751
"14173","ENSMODG00000019129","2",499348003,499352565,4562
"14174","ENSMODG00000019130","2",499406095,499426107,20012
"14175","ENSMODG00000019131","5",20081879,20368952,287073
"14176","ENSMODG00000019132","2",499465373,499471931,6558
"14177","ENSMODG00000019133","2",499486755,499512136,25381
"14178","ENSMODG00000019137","2",499517624,499531250,13626
"14179","ENSMODG00000019140","3",475886870,475899086,12216
"14180","ENSMODG00000019141","2",499547075,499565821,18746
"14181","ENSMODG00000019142","3",475944106,476023331,79225
"14182","ENSMODG00000019143","2",499604451,499650863,46412
"14183","ENSMODG00000019144","3",476052454,476065035,12581
"14184","ENSMODG00000019145","3",476072196,476073311,1115
"14185","ENSMODG00000019146","5",20189380,20189779,399
"14186","ENSMODG00000019147","2",499655691,499676981,21290
"14187","ENSMODG00000019148","5",20666930,20678918,11988
"14188","ENSMODG00000019149","3",476091637,476132727,41090
"14189","ENSMODG00000019150","2",499705148,499706227,1079
"14190","ENSMODG00000019151","3",476250823,476281019,30196
"14191","ENSMODG00000019152","2",499705604,499749945,44341
"14192","ENSMODG00000019153","3",476316367,476333803,17436
"14193","ENSMODG00000019154","5",20685599,20838491,152892
"14194","ENSMODG00000019155","2",500327551,500343424,15873
"14195","ENSMODG00000019157","2",500917520,500921085,3565
"14196","ENSMODG00000019158","3",476428635,476431353,2718
"14197","ENSMODG00000019159","2",500966074,500968992,2918
"14198","ENSMODG00000019160","3",476436875,476439291,2416
"14199","ENSMODG00000019162","2",500991018,500993124,2106
"14200","ENSMODG00000019163","2",501124907,501125464,557
"14201","ENSMODG00000019164","5",20924861,20946745,21884
"14202","ENSMODG00000019165","3",476475195,476516762,41567
"14203","ENSMODG00000019166","2",502334092,502729338,395246
"14204","ENSMODG00000019167","3",476536932,476548576,11644
"14205","ENSMODG00000019168","3",476703360,476727951,24591
"14206","ENSMODG00000019170","3",476747056,476777561,30505
"14207","ENSMODG00000019171","2",502844231,502867007,22776
"14208","ENSMODG00000019174","1",728712347,729001395,289048
"14209","ENSMODG00000019176","1",729133909,729138092,4183
"14210","ENSMODG00000019177","2",502913778,503298874,385096
"14211","ENSMODG00000019178","5",21015505,21038281,22776
"14212","ENSMODG00000019180","2",503455464,503525520,70056
"14213","ENSMODG00000019181","5",21072374,21127739,55365
"14214","ENSMODG00000019182","5",21251775,21257091,5316
"14215","ENSMODG00000019183","2",503314274,503339974,25700
"14216","ENSMODG00000019184","5",21327456,21330596,3140
"14217","ENSMODG00000019185","2",503388163,503404159,15996
"14218","ENSMODG00000019186","1",729296542,729797444,500902
"14219","ENSMODG00000019187","2",503416323,503441927,25604
"14220","ENSMODG00000019188","5",21394236,21396257,2021
"14221","ENSMODG00000019189","2",503589509,503665995,76486
"14222","ENSMODG00000019190","5",21515250,21622328,107078
"14223","ENSMODG00000019191","5",21642603,21653442,10839
"14224","ENSMODG00000019192","5",21685155,21685601,446
"14225","ENSMODG00000019193","5",21774965,21806695,31730
"14226","ENSMODG00000019194","5",21864200,21874879,10679
"14227","ENSMODG00000019195","5",22185012,22315739,130727
"14228","ENSMODG00000019196","2",503693428,503729605,36177
"14229","ENSMODG00000019197","5",22615657,22644684,29027
"14230","ENSMODG00000019198","5",22643786,22650150,6364
"14231","ENSMODG00000019199","2",503762451,503768631,6180
"14232","ENSMODG00000019200","2",503782902,503813396,30494
"14233","ENSMODG00000019201","5",22657775,22737463,79688
"14234","ENSMODG00000019203","2",503824820,503866563,41743
"14235","ENSMODG00000019204","2",503871951,503909974,38023
"14236","ENSMODG00000019205","5",22778879,22838108,59229
"14237","ENSMODG00000019206","2",503946339,503970271,23932
"14238","ENSMODG00000019208","5",22921835,22995864,74029
"14239","ENSMODG00000019209","2",504352226,504544079,191853
"14240","ENSMODG00000019210","5",23013736,23055727,41991
"14241","ENSMODG00000019212","Un",27713955,27753060,39105
"14242","ENSMODG00000019213","Un",27787084,27788499,1415
"14243","ENSMODG00000019214","5",23139478,23173853,34375
"14244","ENSMODG00000019215","2",504565678,504761427,195749
"14245","ENSMODG00000019217","3",177557,234220,56663
"14246","ENSMODG00000019218","2",504614489,504615181,692
"14247","ENSMODG00000019219","5",23186599,23222139,35540
"14248","ENSMODG00000019220","2",504625351,504626796,1445
"14249","ENSMODG00000019221","2",505011555,505025661,14106
"14250","ENSMODG00000019222","3",391922,457853,65931
"14251","ENSMODG00000019223","5",23381472,23383049,1577
"14252","ENSMODG00000019224","2",505352665,505410678,58013
"14253","ENSMODG00000019225","2",505438048,505438782,734
"14254","ENSMODG00000019226","5",23422213,23530498,108285
"14255","ENSMODG00000019227","2",505448037,505477524,29487
"14256","ENSMODG00000019228","2",505499404,505545455,46051
"14257","ENSMODG00000019229","5",23545827,23669649,123822
"14258","ENSMODG00000019231","2",505951057,506093776,142719
"14259","ENSMODG00000019232","2",506101815,506107269,5454
"14260","ENSMODG00000019233","2",506109217,506112708,3491
"14261","ENSMODG00000019234","5",23738905,23742157,3252
"14262","ENSMODG00000019235","2",506123104,506131290,8186
"14263","ENSMODG00000019236","5",23748313,23824619,76306
"14264","ENSMODG00000019237","2",506130810,506137975,7165
"14265","ENSMODG00000019238","3",492927,675060,182133
"14266","ENSMODG00000019239","2",506138196,506145350,7154
"14267","ENSMODG00000019240","3",834905,932153,97248
"14268","ENSMODG00000019241","5",23850349,23867605,17256
"14269","ENSMODG00000019242","2",506145391,506148471,3080
"14270","ENSMODG00000019244","2",506153715,506159772,6057
"14271","ENSMODG00000019246","2",506169036,506187087,18051
"14272","ENSMODG00000019248","2",506190670,506202924,12254
"14273","ENSMODG00000019249","2",506299658,506343415,43757
"14274","ENSMODG00000019251","2",506386670,506417093,30423
"14275","ENSMODG00000019252","2",506426826,506428392,1566
"14276","ENSMODG00000019254","5",25434719,25451108,16389
"14277","ENSMODG00000019256","2",506439290,506453864,14574
"14278","ENSMODG00000019259","2",506471827,506477067,5240
"14279","ENSMODG00000019260","5",27262865,27666480,403615
"14280","ENSMODG00000019261","2",506484036,506505983,21947
"14281","ENSMODG00000019262","5",27726167,27957552,231385
"14282","ENSMODG00000019263","3",1095502,1201575,106073
"14283","ENSMODG00000019264","5",28379702,28579894,200192
"14284","ENSMODG00000019265","5",28733542,28787581,54039
"14285","ENSMODG00000019266","3",1360702,1388495,27793
"14286","ENSMODG00000019268","5",28789728,28888040,98312
"14287","ENSMODG00000019270","5",29351892,29353031,1139
"14288","ENSMODG00000019271","3",1530373,1531587,1214
"14289","ENSMODG00000019272","3",1882848,1901162,18314
"14290","ENSMODG00000019273","5",29436298,31007970,1571672
"14291","ENSMODG00000019274","3",2436569,2437190,621
"14292","ENSMODG00000019275","3",2526269,2548771,22502
"14293","ENSMODG00000019277","3",2869641,2985300,115659
"14294","ENSMODG00000019279","3",4036966,4162810,125844
"14295","ENSMODG00000019281","3",4220002,4324823,104821
"14296","ENSMODG00000019282","2",506547127,506583950,36823
"14297","ENSMODG00000019284","3",4677734,5020182,342448
"14298","ENSMODG00000019288","3",5052212,5095395,43183
"14299","ENSMODG00000019289","2",506588688,506594037,5349
"14300","ENSMODG00000019291","2",506593938,506633034,39096
"14301","ENSMODG00000019292","3",5118682,5203664,84982
"14302","ENSMODG00000019293","5",31845484,31871906,26422
"14303","ENSMODG00000019294","5",32043350,32149414,106064
"14304","ENSMODG00000019295","2",506638529,506642993,4464
"14305","ENSMODG00000019296","5",31880842,31902472,21630
"14306","ENSMODG00000019297","2",506646887,506650456,3569
"14307","ENSMODG00000019298","5",31916847,31975527,58680
"14308","ENSMODG00000019299","2",506651799,506653845,2046
"14309","ENSMODG00000019302","2",506678676,506684055,5379
"14310","ENSMODG00000019303","2",506690182,506690819,637
"14311","ENSMODG00000019304","5",32324485,32364662,40177
"14312","ENSMODG00000019305","2",506770024,506776918,6894
"14313","ENSMODG00000019307","5",32192693,32299878,107185
"14314","ENSMODG00000019308","5",32402214,32434774,32560
"14315","ENSMODG00000019309","5",32582710,32593137,10427
"14316","ENSMODG00000019310","2",506790807,506814974,24167
"14317","ENSMODG00000019311","5",32595008,32626940,31932
"14318","ENSMODG00000019312","2",506815003,506820226,5223
"14319","ENSMODG00000019313","2",506822554,506857163,34609
"14320","ENSMODG00000019314","5",32645714,32729283,83569
"14321","ENSMODG00000019316","Un",37414257,37420277,6020
"14322","ENSMODG00000019317","2",506861603,506897320,35717
"14323","ENSMODG00000019321","Un",37500093,37508398,8305
"14324","ENSMODG00000019322","2",507017107,507045688,28581
"14325","ENSMODG00000019323","2",507111191,507228930,117739
"14326","ENSMODG00000019325","2",507302974,507315304,12330
"14327","ENSMODG00000019326","3",5508583,5649767,141184
"14328","ENSMODG00000019327","2",507312744,507349635,36891
"14329","ENSMODG00000019328","3",5662340,5688824,26484
"14330","ENSMODG00000019329","2",507551937,507626946,75009
"14331","ENSMODG00000019332","2",507643911,507649915,6004
"14332","ENSMODG00000019333","4",400339241,400350051,10810
"14333","ENSMODG00000019334","3",10453433,10510978,57545
"14334","ENSMODG00000019338","Un",39904198,39906471,2273
"14335","ENSMODG00000019339","Un",97703432,97707842,4410
"14336","ENSMODG00000019340","Un",39731072,39750766,19694
"14337","ENSMODG00000019345","Un",39771669,39774144,2475
"14338","ENSMODG00000019346","Un",39883002,39885264,2262
"14339","ENSMODG00000019347","Un",39908242,39914586,6344
"14340","ENSMODG00000019348","Un",40930487,40959780,29293
"14341","ENSMODG00000019350","Un",40999929,41008777,8848
"14342","ENSMODG00000019351","Un",41019387,41022914,3527
"14343","ENSMODG00000019352","Un",41024937,41049427,24490
"14344","ENSMODG00000019353","1",111651665,111758416,106751
"14345","ENSMODG00000019354","1",112114927,112140854,25927
"14346","ENSMODG00000019355","1",111968359,111982048,13689
"14347","ENSMODG00000019356","1",111990646,111999060,8414
"14348","ENSMODG00000019357","1",112002512,112033136,30624
"14349","ENSMODG00000019359","1",112147464,112157820,10356
"14350","ENSMODG00000019360","1",112165961,112184683,18722
"14351","ENSMODG00000019361","1",112190299,112192136,1837
"14352","ENSMODG00000019362","Un",48288519,48300707,12188
"14353","ENSMODG00000019364","1",112234619,112272396,37777
"14354","ENSMODG00000019365","1",112335851,112364297,28446
"14355","ENSMODG00000019366","1",112378940,112425675,46735
"14356","ENSMODG00000019367","1",112441835,112485447,43612
"14357","ENSMODG00000019368","1",112631317,112900654,269337
"14358","ENSMODG00000019370","1",112945242,113018182,72940
"14359","ENSMODG00000019371","1",113027323,113054220,26897
"14360","ENSMODG00000019372","1",113098551,113256358,157807
"14361","ENSMODG00000019373","1",113326521,113328270,1749
"14362","ENSMODG00000019374","1",113426960,113441854,14894
"14363","ENSMODG00000019376","1",113447221,113487640,40419
"14364","ENSMODG00000019377","1",113507599,113548370,40771
"14365","ENSMODG00000019379","1",113545514,113638118,92604
"14366","ENSMODG00000019380","1",113724530,113910150,185620
"14367","ENSMODG00000019381","1",114044887,114191060,146173
"14368","ENSMODG00000019384","1",114503373,114829809,326436
"14369","ENSMODG00000019385","1",114836548,114843899,7351
"14370","ENSMODG00000019386","1",114881164,115142740,261576
"14371","ENSMODG00000019387","1",115397810,115401856,4046
"14372","ENSMODG00000019388","1",449755314,449755937,623
"14373","ENSMODG00000019390","1",116991366,117058338,66972
"14374","ENSMODG00000019392","1",117065248,117090365,25117
"14375","ENSMODG00000019395","1",117091143,117255831,164688
"14376","ENSMODG00000019396","Un",36867746,36877610,9864
"14377","ENSMODG00000019397","1",117149674,117152729,3055
"14378","ENSMODG00000019398","Un",36913123,36926905,13782
"14379","ENSMODG00000019400","Un",36946928,36964661,17733
"14380","ENSMODG00000019401","1",117316914,117401683,84769
"14381","ENSMODG00000019402","1",117592821,117611112,18291
"14382","ENSMODG00000019403","1",117637075,117900476,263401
"14383","ENSMODG00000019406","1",117951242,118025190,73948
"14384","ENSMODG00000019407","1",118055265,118056677,1412
"14385","ENSMODG00000019409","Un",36977131,36989177,12046
"14386","ENSMODG00000019410","Un",37020860,37025875,5015
"14387","ENSMODG00000019411","Un",37023601,37044246,20645
"14388","ENSMODG00000019412","Un",45720816,45724199,3383
"14389","ENSMODG00000019413","3",11053044,11500072,447028
"14390","ENSMODG00000019414","Un",93719324,93720256,932
"14391","ENSMODG00000019416","1",118189716,118451316,261600
"14392","ENSMODG00000019417","3",11643161,11696081,52920
"14393","ENSMODG00000019419","3",11648681,11766800,118119
"14394","ENSMODG00000019420","3",11767608,11791341,23733
"14395","ENSMODG00000019421","3",11791792,11799601,7809
"14396","ENSMODG00000019422","Un",44798509,44812565,14056
"14397","ENSMODG00000019423","3",11821972,11854967,32995
"14398","ENSMODG00000019425","3",11878427,11954715,76288
"14399","ENSMODG00000019426","3",11958463,12011556,53093
"14400","ENSMODG00000019427","1",118721894,118774542,52648
"14401","ENSMODG00000019428","1",118791630,118886195,94565
"14402","ENSMODG00000019429","1",119005262,119013444,8182
"14403","ENSMODG00000019430","1",119018133,119118825,100692
"14404","ENSMODG00000019431","1",119858342,119892966,34624
"14405","ENSMODG00000019432","Un",44846085,44861685,15600
"14406","ENSMODG00000019434","1",120286954,120293548,6594
"14407","ENSMODG00000019435","1",120306119,120307717,1598
"14408","ENSMODG00000019436","3",12138882,12414306,275424
"14409","ENSMODG00000019438","1",120873474,121090120,216646
"14410","ENSMODG00000019439","3",13070333,13083821,13488
"14411","ENSMODG00000019444","1",121187073,121234794,47721
"14412","ENSMODG00000019445","1",400510791,400538056,27265
"14413","ENSMODG00000019446","1",121263337,121264388,1051
"14414","ENSMODG00000019447","1",400549963,400612481,62518
"14415","ENSMODG00000019448","3",14917710,15100868,183158
"14416","ENSMODG00000019449","1",121282775,121350125,67350
"14417","ENSMODG00000019450","1",400671546,400700527,28981
"14418","ENSMODG00000019452","1",121452848,121466525,13677
"14419","ENSMODG00000019454","3",15143726,15265877,122151
"14420","ENSMODG00000019455","1",400801217,401017410,216193
"14421","ENSMODG00000019456","1",121476502,121661100,184598
"14422","ENSMODG00000019457","1",401025496,401083244,57748
"14423","ENSMODG00000019459","3",15276211,15288364,12153
"14424","ENSMODG00000019460","1",401139130,401164751,25621
"14425","ENSMODG00000019461","1",121501017,121525855,24838
"14426","ENSMODG00000019462","1",401236906,401253360,16454
"14427","ENSMODG00000019463","3",15752151,15759632,7481
"14428","ENSMODG00000019464","1",401253430,401266776,13346
"14429","ENSMODG00000019465","3",15825221,15945282,120061
"14430","ENSMODG00000019466","3",15931860,15933487,1627
"14431","ENSMODG00000019467","3",16107539,16589330,481791
"14432","ENSMODG00000019469","1",401290665,401361418,70753
"14433","ENSMODG00000019470","3",16799201,16837043,37842
"14434","ENSMODG00000019471","1",401380029,401423855,43826
"14435","ENSMODG00000019472","3",17149994,17214520,64526
"14436","ENSMODG00000019473","3",17360862,17373345,12483
"14437","ENSMODG00000019474","1",401444737,401473226,28489
"14438","ENSMODG00000019475","3",17478948,17488832,9884
"14439","ENSMODG00000019476","1",121533211,121572376,39165
"14440","ENSMODG00000019477","1",401484445,401501961,17516
"14441","ENSMODG00000019478","3",17496669,17553273,56604
"14442","ENSMODG00000019479","3",17537848,17545477,7629
"14443","ENSMODG00000019480","1",401519993,401525502,5509
"14444","ENSMODG00000019481","3",17641668,17649327,7659
"14445","ENSMODG00000019482","1",401576445,401590900,14455
"14446","ENSMODG00000019483","1",401605630,401615703,10073
"14447","ENSMODG00000019485","1",401618448,401619641,1193
"14448","ENSMODG00000019486","1",401647467,401674143,26676
"14449","ENSMODG00000019487","3",17696401,17769277,72876
"14450","ENSMODG00000019488","1",121582502,121600414,17912
"14451","ENSMODG00000019489","1",401718177,401777600,59423
"14452","ENSMODG00000019490","1",401806035,401852990,46955
"14453","ENSMODG00000019491","1",401851521,401861236,9715
"14454","ENSMODG00000019493","1",401861632,401882483,20851
"14455","ENSMODG00000019494","3",17769358,17852790,83432
"14456","ENSMODG00000019495","1",121643272,121665507,22235
"14457","ENSMODG00000019496","1",401900576,401901780,1204
"14458","ENSMODG00000019497","1",401932986,401966209,33223
"14459","ENSMODG00000019498","1",121669347,121694502,25155
"14460","ENSMODG00000019499","3",17853180,17972894,119714
"14461","ENSMODG00000019500","1",401996502,402002122,5620
"14462","ENSMODG00000019501","1",121696146,121697251,1105
"14463","ENSMODG00000019503","1",121717136,121848253,131117
"14464","ENSMODG00000019504","1",402681538,402710310,28772
"14465","ENSMODG00000019505","3",18075518,18189594,114076
"14466","ENSMODG00000019506","1",121733230,121734026,796
"14467","ENSMODG00000019507","1",402776854,402777807,953
"14468","ENSMODG00000019508","1",402790761,402792723,1962
"14469","ENSMODG00000019509","1",402840476,402850137,9661
"14470","ENSMODG00000019510","1",121738183,121741449,3266
"14471","ENSMODG00000019511","3",18218192,18278510,60318
"14472","ENSMODG00000019512","1",402867053,402888201,21148
"14473","ENSMODG00000019513","1",121743480,121782581,39101
"14474","ENSMODG00000019514","1",402906155,402948859,42704
"14475","ENSMODG00000019515","3",18337333,18386250,48917
"14476","ENSMODG00000019516","1",121841921,121865594,23673
"14477","ENSMODG00000019517","3",18412119,18464806,52687
"14478","ENSMODG00000019518","1",121881965,121957602,75637
"14479","ENSMODG00000019519","1",122007613,122029225,21612
"14480","ENSMODG00000019520","3",18648336,18794514,146178
"14481","ENSMODG00000019522","1",122038752,122090180,51428
"14482","ENSMODG00000019523","1",402966046,403034863,68817
"14483","ENSMODG00000019524","3",19567438,19641206,73768
"14484","ENSMODG00000019525","3",19663266,19698018,34752
"14485","ENSMODG00000019526","1",403100088,403110454,10366
"14486","ENSMODG00000019527","1",403142592,403147296,4704
"14487","ENSMODG00000019528","1",403159093,403174504,15411
"14488","ENSMODG00000019529","3",19694267,19726086,31819
"14489","ENSMODG00000019531","1",403283749,403284823,1074
"14490","ENSMODG00000019532","1",403395058,403396074,1016
"14491","ENSMODG00000019534","1",122183571,122206922,23351
"14492","ENSMODG00000019535","1",403443474,403497372,53898
"14493","ENSMODG00000019536","1",403522159,403522515,356
"14494","ENSMODG00000019538","1",122268100,122270079,1979
"14495","ENSMODG00000019540","3",20006634,20062622,55988
"14496","ENSMODG00000019541","1",403810540,403835866,25326
"14497","ENSMODG00000019542","1",122286609,122338894,52285
"14498","ENSMODG00000019543","1",403852147,403852899,752
"14499","ENSMODG00000019544","1",122344764,122375129,30365
"14500","ENSMODG00000019545","1",403914222,403952833,38611
"14501","ENSMODG00000019546","1",122377288,122380992,3704
"14502","ENSMODG00000019547","1",404015495,404026363,10868
"14503","ENSMODG00000019548","1",122390939,122417224,26285
"14504","ENSMODG00000019549","1",404028843,404055400,26557
"14505","ENSMODG00000019552","1",404060869,404061810,941
"14506","ENSMODG00000019554","1",404126662,404146975,20313
"14507","ENSMODG00000019555","1",122526817,122555765,28948
"14508","ENSMODG00000019556","1",404157978,404213233,55255
"14509","ENSMODG00000019559","1",404213179,404305643,92464
"14510","ENSMODG00000019560","3",21804993,21812727,7734
"14511","ENSMODG00000019562","1",404401017,404439451,38434
"14512","ENSMODG00000019563","3",21860145,21860627,482
"14513","ENSMODG00000019564","1",122789192,122824765,35573
"14514","ENSMODG00000019566","3",21939819,22278215,338396
"14515","ENSMODG00000019567","1",404594348,404664878,70530
"14516","ENSMODG00000019568","1",122818879,122889882,71003
"14517","ENSMODG00000019569","3",22443970,22778959,334989
"14518","ENSMODG00000019571","1",122908794,122925578,16784
"14519","ENSMODG00000019572","1",404677684,404823629,145945
"14520","ENSMODG00000019573","1",122937727,123053843,116116
"14521","ENSMODG00000019574","1",404907970,404916828,8858
"14522","ENSMODG00000019575","1",123153054,123178278,25224
"14523","ENSMODG00000019577","1",123190487,123203935,13448
"14524","ENSMODG00000019578","1",404938322,404961339,23017
"14525","ENSMODG00000019579","1",405152393,405188178,35785
"14526","ENSMODG00000019580","1",405352673,405396885,44212
"14527","ENSMODG00000019581","1",123202296,123296907,94611
"14528","ENSMODG00000019582","3",24425958,24536443,110485
"14529","ENSMODG00000019583","1",123498003,123511355,13352
"14530","ENSMODG00000019584","1",123516527,123524259,7732
"14531","ENSMODG00000019585","3",24576655,24706926,130271
"14532","ENSMODG00000019586","3",24867961,25091455,223494
"14533","ENSMODG00000019587","1",123616337,123626118,9781
"14534","ENSMODG00000019588","3",24783264,24784290,1026
"14535","ENSMODG00000019589","1",123649608,123660162,10554
"14536","ENSMODG00000019590","3",24791256,24868817,77561
"14537","ENSMODG00000019591","1",123660448,123682329,21881
"14538","ENSMODG00000019592","1",405505487,405622138,116651
"14539","ENSMODG00000019593","1",123899457,124344493,445036
"14540","ENSMODG00000019594","3",25520949,25594916,73967
"14541","ENSMODG00000019596","1",406131100,406132098,998
"14542","ENSMODG00000019598","1",406022274,406022810,536
"14543","ENSMODG00000019600","1",406882194,407165718,283524
"14544","ENSMODG00000019602","1",126066176,126785918,719742
"14545","ENSMODG00000019604","1",407206581,408352182,1145601
"14546","ENSMODG00000019605","3",26607347,26720045,112698
"14547","ENSMODG00000019606","Un",53879706,53887655,7949
"14548","ENSMODG00000019607","Un",55421578,55422848,1270
"14549","ENSMODG00000019608","1",407579929,407581812,1883
"14550","ENSMODG00000019611","Un",53677797,53702398,24601
"14551","ENSMODG00000019612","3",26744122,26941577,197455
"14552","ENSMODG00000019614","1",408777904,408791437,13533
"14553","ENSMODG00000019618","1",411282954,411459099,176145
"14554","ENSMODG00000019619","3",28739680,28740960,1280
"14555","ENSMODG00000019621","3",29010266,29250080,239814
"14556","ENSMODG00000019624","3",29267213,29347184,79971
"14557","ENSMODG00000019625","3",29428970,29554715,125745
"14558","ENSMODG00000019628","3",29679102,29717954,38852
"14559","ENSMODG00000019629","1",412891997,413071557,179560
"14560","ENSMODG00000019630","1",413127114,413253073,125959
"14561","ENSMODG00000019633","1",413393645,413423821,30176
"14562","ENSMODG00000019635","1",413426035,413444080,18045
"14563","ENSMODG00000019636","1",413422536,413489066,66530
"14564","ENSMODG00000019637","1",413521328,413557632,36304
"14565","ENSMODG00000019638","3",29771158,30129600,358442
"14566","ENSMODG00000019639","1",413590404,413618960,28556
"14567","ENSMODG00000019641","1",413687600,413800850,113250
"14568","ENSMODG00000019642","3",30324866,30668693,343827
"14569","ENSMODG00000019643","1",413869412,413976394,106982
"14570","ENSMODG00000019644","Un",54895656,54915851,20195
"14571","ENSMODG00000019645","3",30721802,30770232,48430
"14572","ENSMODG00000019646","Un",53009337,53045132,35795
"14573","ENSMODG00000019647","3",30769740,30806050,36310
"14574","ENSMODG00000019648","Un",53056197,53057705,1508
"14575","ENSMODG00000019649","1",413980527,414004641,24114
"14576","ENSMODG00000019651","3",30812389,30858593,46204
"14577","ENSMODG00000019652","1",414102992,414146659,43667
"14578","ENSMODG00000019654","1",414153530,414203912,50382
"14579","ENSMODG00000019655","Un",50544285,50557246,12961
"14580","ENSMODG00000019656","3",30859178,30927996,68818
"14581","ENSMODG00000019659","3",30898433,30902464,4031
"14582","ENSMODG00000019660","2",40932402,40932890,488
"14583","ENSMODG00000019661","3",30973870,31123974,150104
"14584","ENSMODG00000019662","1",414580343,414625167,44824
"14585","ENSMODG00000019664","3",31341517,31427900,86383
"14586","ENSMODG00000019665","3",31482214,31525081,42867
"14587","ENSMODG00000019666","Un",54361054,54366894,5840
"14588","ENSMODG00000019667","1",415106849,415152985,46136
"14589","ENSMODG00000019669","Un",54367280,54369638,2358
"14590","ENSMODG00000019670","3",32042173,32436595,394422
"14591","ENSMODG00000019671","1",415252450,415483795,231345
"14592","ENSMODG00000019672","3",32527038,32792860,265822
"14593","ENSMODG00000019674","Un",52951445,52970961,19516
"14594","ENSMODG00000019675","3",32814795,32859367,44572
"14595","ENSMODG00000019676","Un",52979116,52997871,18755
"14596","ENSMODG00000019678","Un",52123146,52137051,13905
"14597","ENSMODG00000019680","1",415511263,415538612,27349
"14598","ENSMODG00000019681","Un",52144301,52152450,8149
"14599","ENSMODG00000019682","1",415612660,415627047,14387
"14600","ENSMODG00000019683","1",415627330,415697172,69842
"14601","ENSMODG00000019685","3",34148849,34232240,83391
"14602","ENSMODG00000019686","1",415700570,415739125,38555
"14603","ENSMODG00000019688","1",415761399,415785123,23724
"14604","ENSMODG00000019689","Un",49129017,49135010,5993
"14605","ENSMODG00000019691","Un",49136109,49141124,5015
"14606","ENSMODG00000019692","1",415906570,415959438,52868
"14607","ENSMODG00000019694","Un",49153318,49157341,4023
"14608","ENSMODG00000019697","3",35338735,35395099,56364
"14609","ENSMODG00000019699","3",35424349,35435735,11386
"14610","ENSMODG00000019701","3",35474707,35489265,14558
"14611","ENSMODG00000019702","3",35494767,35529777,35010
"14612","ENSMODG00000019704","3",35653064,35719966,66902
"14613","ENSMODG00000019706","3",35761936,35837545,75609
"14614","ENSMODG00000019709","3",35924640,35935912,11272
"14615","ENSMODG00000019711","3",36185917,36264911,78994
"14616","ENSMODG00000019716","3",36335461,36425304,89843
"14617","ENSMODG00000019718","1",416660014,416662076,2062
"14618","ENSMODG00000019719","3",36494075,36659332,165257
"14619","ENSMODG00000019720","3",62966380,62968036,1656
"14620","ENSMODG00000019721","1",416682778,416683704,926
"14621","ENSMODG00000019723","3",36734316,36834626,100310
"14622","ENSMODG00000019725","1",416716052,416792026,75974
"14623","ENSMODG00000019726","3",36920809,36935461,14652
"14624","ENSMODG00000019727","3",36982289,37096680,114391
"14625","ENSMODG00000019728","3",37109032,37355129,246097
"14626","ENSMODG00000019729","1",416830916,417053174,222258
"14627","ENSMODG00000019730","3",37758833,37797524,38691
"14628","ENSMODG00000019731","3",37810167,37960584,150417
"14629","ENSMODG00000019732","1",417078079,417129582,51503
"14630","ENSMODG00000019733","3",38050135,38411768,361633
"14631","ENSMODG00000019734","1",417353401,417395311,41910
"14632","ENSMODG00000019735","3",38696837,38792205,95368
"14633","ENSMODG00000019736","3",38877464,38886629,9165
"14634","ENSMODG00000019737","1",417402998,418148396,745398
"14635","ENSMODG00000019738","3",39029716,39111332,81616
"14636","ENSMODG00000019739","1",418280309,418306303,25994
"14637","ENSMODG00000019740","3",39117831,39227596,109765
"14638","ENSMODG00000019741","1",418504151,418632968,128817
"14639","ENSMODG00000019742","1",418623205,418722773,99568
"14640","ENSMODG00000019743","3",39740113,39818300,78187
"14641","ENSMODG00000019744","1",418817818,418875264,57446
"14642","ENSMODG00000019745","3",39929793,39942736,12943
"14643","ENSMODG00000019746","1",418886908,418937948,51040
"14644","ENSMODG00000019747","3",40003360,40006269,2909
"14645","ENSMODG00000019748","1",418965970,419223265,257295
"14646","ENSMODG00000019750","1",419257702,419282606,24904
"14647","ENSMODG00000019752","1",419411532,419431829,20297
"14648","ENSMODG00000019753","1",419430184,419434990,4806
"14649","ENSMODG00000019755","1",419438642,419451027,12385
"14650","ENSMODG00000019757","Un",19050690,19070049,19359
"14651","ENSMODG00000019758","1",419455428,419513767,58339
"14652","ENSMODG00000019760","1",419536093,419722925,186832
"14653","ENSMODG00000019761","1",419725893,419766434,40541
"14654","ENSMODG00000019763","1",419775576,419792044,16468
"14655","ENSMODG00000019764","1",419798693,419804585,5892
"14656","ENSMODG00000019765","Un",19092261,19189015,96754
"14657","ENSMODG00000019766","Un",19210521,19338857,128336
"14658","ENSMODG00000019768","Un",19351773,19514549,162776
"14659","ENSMODG00000019772","1",419840100,419924891,84791
"14660","ENSMODG00000019773","5",100437787,100445238,7451
"14661","ENSMODG00000019775","1",420156550,420487494,330944
"14662","ENSMODG00000019776","5",101316902,101322689,5787
"14663","ENSMODG00000019779","1",420863774,420864294,520
"14664","ENSMODG00000019784","2",109519,431119,321600
"14665","ENSMODG00000019785","1",420674679,420959947,285268
"14666","ENSMODG00000019787","1",421520840,421782744,261904
"14667","ENSMODG00000019789","1",421976344,422160219,183875
"14668","ENSMODG00000019790","1",422367952,422369367,1415
"14669","ENSMODG00000019791","1",422419686,422421200,1514
"14670","ENSMODG00000019794","1",422486678,423135863,649185
"14671","ENSMODG00000019795","Un",35351829,35373183,21354
"14672","ENSMODG00000019796","1",422806485,422846345,39860
"14673","ENSMODG00000019798","Un",35387241,35402838,15597
"14674","ENSMODG00000019799","Un",35407630,35416068,8438
"14675","ENSMODG00000019800","Un",35432305,35458899,26594
"14676","ENSMODG00000019801","Un",35485634,35486632,998
"14677","ENSMODG00000019802","Un",35503054,35538210,35156
"14678","ENSMODG00000019803","Un",83766372,83770704,4332
"14679","ENSMODG00000019804","Un",8480497,8484407,3910
"14680","ENSMODG00000019805","Un",8495311,8508957,13646
"14681","ENSMODG00000019806","1",423173993,423383599,209606
"14682","ENSMODG00000019807","Un",8534151,8642207,108056
"14683","ENSMODG00000019809","1",423396839,423414469,17630
"14684","ENSMODG00000019810","3",509745058,509796426,51368
"14685","ENSMODG00000019811","1",423616632,423682146,65514
"14686","ENSMODG00000019812","1",423757491,423780386,22895
"14687","ENSMODG00000019813","1",423857986,423869484,11498
"14688","ENSMODG00000019815","1",423897722,423907912,10190
"14689","ENSMODG00000019817","1",424121464,424130221,8757
"14690","ENSMODG00000019818","1",424156127,424157524,1397
"14691","ENSMODG00000019822","5",271204348,271302402,98054
"14692","ENSMODG00000019823","5",271337014,271502599,165585
"14693","ENSMODG00000019824","Un",8776774,8777315,541
"14694","ENSMODG00000019826","Un",8874496,8992922,118426
"14695","ENSMODG00000019828","Un",8887534,8895146,7612
"14696","ENSMODG00000019829","5",271513753,271629732,115979
"14697","ENSMODG00000019830","Un",8962401,9010036,47635
"14698","ENSMODG00000019831","5",271804748,271991638,186890
"14699","ENSMODG00000019832","5",272194572,272502545,307973
"14700","ENSMODG00000019833","Un",9176005,9179346,3341
"14701","ENSMODG00000019834","5",272556650,272567731,11081
"14702","ENSMODG00000019835","5",272626204,272672559,46355
"14703","ENSMODG00000019837","5",272689286,272708440,19154
"14704","ENSMODG00000019838","5",272778841,272859251,80410
"14705","ENSMODG00000019840","Un",24630320,24636738,6418
"14706","ENSMODG00000019843","Un",24639139,24651123,11984
"14707","ENSMODG00000019844","Un",24651164,24937450,286286
"14708","ENSMODG00000019845","Un",24667656,24841510,173854
"14709","ENSMODG00000019847","5",274763592,274777610,14018
"14710","ENSMODG00000019852","2",167959880,168125941,166061
"14711","ENSMODG00000019853","Un",30342845,30348937,6092
"14712","ENSMODG00000019854","5",279719385,279752429,33044
"14713","ENSMODG00000019855","Un",30352053,30398800,46747
"14714","ENSMODG00000019856","Un",30458187,30467146,8959
"14715","ENSMODG00000019857","Un",30623835,30648529,24694
"14716","ENSMODG00000019858","5",279765915,279889680,123765
"14717","ENSMODG00000019861","Un",5248343,5248735,392
"14718","ENSMODG00000019862","5",280106123,280255707,149584
"14719","ENSMODG00000019863","5",280260415,280312551,52136
"14720","ENSMODG00000019865","5",280499930,280524362,24432
"14721","ENSMODG00000019866","5",280397364,280398001,637
"14722","ENSMODG00000019867","5",280531005,280549700,18695
"14723","ENSMODG00000019868","5",280553654,280745474,191820
"14724","ENSMODG00000019869","5",280774305,280830437,56132
"14725","ENSMODG00000019870","5",281152698,281242539,89841
"14726","ENSMODG00000019871","5",281610109,281634542,24433
"14727","ENSMODG00000019873","5",281641079,281666677,25598
"14728","ENSMODG00000019874","5",282045146,282089395,44249
"14729","ENSMODG00000019875","5",282118648,282147463,28815
"14730","ENSMODG00000019876","5",282669579,282669845,266
"14731","ENSMODG00000019877","5",282828628,282975799,147171
"14732","ENSMODG00000019878","5",282862781,282869608,6827
"14733","ENSMODG00000019879","Un",5380511,5395592,15081
"14734","ENSMODG00000019880","Un",5445307,5715017,269710
"14735","ENSMODG00000019881","5",282924043,282941830,17787
"14736","ENSMODG00000019882","5",282976472,282977158,686
"14737","ENSMODG00000019884","5",282984467,282998161,13694
"14738","ENSMODG00000019885","5",283003699,283008180,4481
"14739","ENSMODG00000019887","5",283012856,283191414,178558
"14740","ENSMODG00000019888","5",283360248,283413655,53407
"14741","ENSMODG00000019889","5",283467815,283469268,1453
"14742","ENSMODG00000019891","5",283476620,283619206,142586
"14743","ENSMODG00000019892","5",283660872,283677808,16936
"14744","ENSMODG00000019893","5",283679848,283714878,35030
"14745","ENSMODG00000019894","5",283714928,283735792,20864
"14746","ENSMODG00000019895","5",283745885,283752368,6483
"14747","ENSMODG00000019896","5",283760833,283769515,8682
"14748","ENSMODG00000019897","5",283771144,283840842,69698
"14749","ENSMODG00000019898","5",283767126,283934169,167043
"14750","ENSMODG00000019899","5",283954502,284128294,173792
"14751","ENSMODG00000019900","5",283985707,283987242,1535
"14752","ENSMODG00000019901","5",284127764,284135749,7985
"14753","ENSMODG00000019903","5",284139001,284142401,3400
"14754","ENSMODG00000019904","5",284173156,284186606,13450
"14755","ENSMODG00000019905","5",284187688,284191180,3492
"14756","ENSMODG00000019906","5",284201149,284210971,9822
"14757","ENSMODG00000019907","5",284217388,284251041,33653
"14758","ENSMODG00000019908","5",284254624,284277716,23092
"14759","ENSMODG00000019909","5",284283730,284305106,21376
"14760","ENSMODG00000019910","5",284340404,284347184,6780
"14761","ENSMODG00000019911","5",284351234,284365586,14352
"14762","ENSMODG00000019913","5",284374821,284419426,44605
"14763","ENSMODG00000019914","5",284493932,284503015,9083
"14764","ENSMODG00000019916","5",284503342,284509275,5933
"14765","ENSMODG00000019919","5",284533768,284554892,21124
"14766","ENSMODG00000019920","5",284563072,284643008,79936
"14767","ENSMODG00000019921","5",284646987,284677892,30905
"14768","ENSMODG00000019923","5",284683372,284724325,40953
"14769","ENSMODG00000019925","5",284949774,284984068,34294
"14770","ENSMODG00000019926","5",285022991,285023938,947
"14771","ENSMODG00000019927","5",285144826,285146259,1433
"14772","ENSMODG00000019933","5",285308603,285309490,887
"14773","ENSMODG00000019944","5",286167419,286168318,899
"14774","ENSMODG00000019945","5",286190954,286191886,932
"14775","ENSMODG00000019947","5",286219573,286220502,929
"14776","ENSMODG00000019966","5",286832264,286833169,905
"14777","ENSMODG00000019984","5",287521206,287522198,992
"14778","ENSMODG00000020069","5",290713101,290714045,944
"14779","ENSMODG00000020072","3",204093290,204145137,51847
"14780","ENSMODG00000020074","5",290891408,290892352,944
"14781","ENSMODG00000020075","3",204182001,204222664,40663
"14782","ENSMODG00000020076","5",290933095,290934060,965
"14783","ENSMODG00000020079","3",204687767,204744024,56257
"14784","ENSMODG00000020081","5",291283933,291289935,6002
"14785","ENSMODG00000020082","3",204822724,204823147,423
"14786","ENSMODG00000020083","5",291359199,291360338,1139
"14787","ENSMODG00000020085","5",291425385,291444467,19082
"14788","ENSMODG00000020086","3",205564216,205670245,106029
"14789","ENSMODG00000020088","5",291447036,291460255,13219
"14790","ENSMODG00000020089","3",205814511,205918290,103779
"14791","ENSMODG00000020090","3",205972901,205989874,16973
"14792","ENSMODG00000020091","3",206013946,206014923,977
"14793","ENSMODG00000020092","3",206022591,206033686,11095
"14794","ENSMODG00000020093","3",206041239,206058477,17238
"14795","ENSMODG00000020094","5",291468976,291523931,54955
"14796","ENSMODG00000020096","5",291541637,291545418,3781
"14797","ENSMODG00000020099","3",206082320,206155037,72717
"14798","ENSMODG00000020100","5",291591808,291616688,24880
"14799","ENSMODG00000020101","5",291714102,291739292,25190
"14800","ENSMODG00000020102","5",291741512,291742459,947
"14801","ENSMODG00000020103","5",291758212,291767831,9619
"14802","ENSMODG00000020104","5",291638264,291833621,195357
"14803","ENSMODG00000020105","5",291848312,291850607,2295
"14804","ENSMODG00000020106","3",206169118,206291984,122866
"14805","ENSMODG00000020107","5",291867355,292012717,145362
"14806","ENSMODG00000020108","5",291878906,291896069,17163
"14807","ENSMODG00000020109","3",206312387,206417443,105056
"14808","ENSMODG00000020110","5",291898890,291906582,7692
"14809","ENSMODG00000020112","5",291907049,291915738,8689
"14810","ENSMODG00000020113","3",206706647,206707161,514
"14811","ENSMODG00000020116","5",291943634,291993839,50205
"14812","ENSMODG00000020118","5",292011868,292012827,959
"14813","ENSMODG00000020119","5",292067053,292068006,953
"14814","ENSMODG00000020120","5",292087535,292097248,9713
"14815","ENSMODG00000020121","3",206881363,207383956,502593
"14816","ENSMODG00000020122","5",292112835,292113788,953
"14817","ENSMODG00000020124","3",207392495,207508932,116437
"14818","ENSMODG00000020126","5",292147272,292232292,85020
"14819","ENSMODG00000020128","3",207507747,207822428,314681
"14820","ENSMODG00000020130","5",292194664,292195641,977
"14821","ENSMODG00000020131","3",208163798,208724485,560687
"14822","ENSMODG00000020132","3",208748566,208757049,8483
"14823","ENSMODG00000020136","1",380074436,380177446,103010
"14824","ENSMODG00000020138","5",292288514,292299188,10674
"14825","ENSMODG00000020159","3",211454975,211455308,333
"14826","ENSMODG00000020163","3",211983379,212000365,16986
"14827","ENSMODG00000020169","5",293570109,293572041,1932
"14828","ENSMODG00000020170","5",293619499,293620431,932
"14829","ENSMODG00000020172","5",293668559,293693211,24652
"14830","ENSMODG00000020173","5",293697472,293733265,35793
"14831","ENSMODG00000020175","5",293762778,293773245,10467
"14832","ENSMODG00000020176","5",293837481,293877577,40096
"14833","ENSMODG00000020179","5",293955699,293967049,11350
"14834","ENSMODG00000020180","5",294038147,294068881,30734
"14835","ENSMODG00000020181","5",294114781,294116534,1753
"14836","ENSMODG00000020182","5",294146117,294164397,18280
"14837","ENSMODG00000020183","5",294166315,294168495,2180
"14838","ENSMODG00000020186","5",294452182,294453009,827
"14839","ENSMODG00000020189","5",294526979,294527938,959
"14840","ENSMODG00000020194","5",294788933,294792766,3833
"14841","ENSMODG00000020195","5",294813897,294847118,33221
"14842","ENSMODG00000020196","3",212317796,213021245,703449
"14843","ENSMODG00000020200","5",295000171,295033306,33135
"14844","ENSMODG00000020201","5",295063888,295104594,40706
"14845","ENSMODG00000020202","5",295133849,295134901,1052
"14846","ENSMODG00000020203","5",295186342,295187335,993
"14847","ENSMODG00000020204","5",295204255,295259473,55218
"14848","ENSMODG00000020205","5",295265900,295270131,4231
"14849","ENSMODG00000020206","5",295273525,295289489,15964
"14850","ENSMODG00000020208","5",295510310,295520228,9918
"14851","ENSMODG00000020215","5",295688444,295739148,50704
"14852","ENSMODG00000020216","5",295789449,295805976,16527
"14853","ENSMODG00000020218","3",213150184,213201584,51400
"14854","ENSMODG00000020220","3",213122155,213133309,11154
"14855","ENSMODG00000020221","3",213225492,213239390,13898
"14856","ENSMODG00000020222","3",213332491,213364865,32374
"14857","ENSMODG00000020223","3",215439614,215643877,204263
"14858","ENSMODG00000020224","5",297275455,297290836,15381
"14859","ENSMODG00000020225","3",216104254,216104832,578
"14860","ENSMODG00000020226","3",216217167,216335199,118032
"14861","ENSMODG00000020228","3",217240315,217267839,27524
"14862","ENSMODG00000020234","5",296434018,296435376,1358
"14863","ENSMODG00000020235","3",217283835,217388564,104729
"14864","ENSMODG00000020240","5",297562440,297587650,25210
"14865","ENSMODG00000020241","3",218136382,218139123,2741
"14866","ENSMODG00000020245","5",297174269,297189462,15193
"14867","ENSMODG00000020246","3",222471775,223010927,539152
"14868","ENSMODG00000020248","5",296962142,296963062,920
"14869","ENSMODG00000020249","3",223492343,223530687,38344
"14870","ENSMODG00000020251","5",297042856,297071904,29048
"14871","ENSMODG00000020252","3",223616244,223756358,140114
"14872","ENSMODG00000020253","3",223871304,224303752,432448
"14873","ENSMODG00000020254","3",225319639,225354064,34425
"14874","ENSMODG00000020255","3",225375790,225379400,3610
"14875","ENSMODG00000020258","3",226142847,226530173,387326
"14876","ENSMODG00000020259","3",226697041,226748958,51917
"14877","ENSMODG00000020260","3",226570612,226645640,75028
"14878","ENSMODG00000020261","3",226652347,226667270,14923
"14879","ENSMODG00000020263","3",226768464,227099331,330867
"14880","ENSMODG00000020264","3",227195760,227410050,214290
"14881","ENSMODG00000020265","3",227615664,227655623,39959
"14882","ENSMODG00000020267","3",228400387,228697446,297059
"14883","ENSMODG00000020268","3",229515011,229525135,10124
"14884","ENSMODG00000020270","3",11562018,11562386,368
"14885","ENSMODG00000020271","3",229990334,230092026,101692
"14886","ENSMODG00000020272","5",296506798,296526972,20174
"14887","ENSMODG00000020273","5",297317161,297327649,10488
"14888","ENSMODG00000020274","5",297342931,297343309,378
"14889","ENSMODG00000020275","3",230863972,230957535,93563
"14890","ENSMODG00000020276","3",231015559,231056100,40541
"14891","ENSMODG00000020277","3",231064511,231092688,28177
"14892","ENSMODG00000020279","3",231254443,231285422,30979
"14893","ENSMODG00000020280","3",231292013,231311778,19765
"14894","ENSMODG00000020281","3",231392672,231427774,35102
"14895","ENSMODG00000020284","3",231753269,231937246,183977
"14896","ENSMODG00000020286","3",232700024,232722952,22928
"14897","ENSMODG00000020288","3",232724473,232748163,23690
"14898","ENSMODG00000020289","3",232791294,232966491,175197
"14899","ENSMODG00000020290","3",233292266,233502763,210497
"14900","ENSMODG00000020291","3",233609195,233671329,62134
"14901","ENSMODG00000020292","5",297921935,297928480,6545
"14902","ENSMODG00000020293","5",295889049,295892846,3797
"14903","ENSMODG00000020294","3",233765259,233860659,95400
"14904","ENSMODG00000020296","5",297722044,297731371,9327
"14905","ENSMODG00000020299","3",233882435,233955299,72864
"14906","ENSMODG00000020300","3",233998905,234011873,12968
"14907","ENSMODG00000020301","3",234015516,234019178,3662
"14908","ENSMODG00000020303","3",234052181,234116128,63947
"14909","ENSMODG00000020305","3",234133851,234158942,25091
"14910","ENSMODG00000020306","3",234173477,234185791,12314
"14911","ENSMODG00000020307","3",234373431,234376177,2746
"14912","ENSMODG00000020308","3",236007037,236035550,28513
"14913","ENSMODG00000020310","3",236051056,236131859,80803
"14914","ENSMODG00000020311","3",236103837,236105345,1508
"14915","ENSMODG00000020313","3",236235710,236374184,138474
"14916","ENSMODG00000020315","3",236500782,236561139,60357
"14917","ENSMODG00000020316","5",297655663,297751756,96093
"14918","ENSMODG00000020318","3",236568451,236657923,89472
"14919","ENSMODG00000020323","5",298652414,298661915,9501
"14920","ENSMODG00000020324","5",298685316,298704230,18914
"14921","ENSMODG00000020327","3",237096665,237177485,80820
"14922","ENSMODG00000020328","5",298761336,298795965,34629
"14923","ENSMODG00000020329","3",237213731,237488276,274545
"14924","ENSMODG00000020331","5",298904463,298909490,5027
"14925","ENSMODG00000020332","3",238157103,238196298,39195
"14926","ENSMODG00000020334","5",298970484,298974077,3593
"14927","ENSMODG00000020335","3",238242295,238602411,360116
"14928","ENSMODG00000020336","5",298974830,298975804,974
"14929","ENSMODG00000020337","5",298989501,298996619,7118
"14930","ENSMODG00000020338","5",299001271,299010280,9009
"14931","ENSMODG00000020339","5",299025423,299032951,7528
"14932","ENSMODG00000020340","3",238652114,238729958,77844
"14933","ENSMODG00000020341","5",299110179,299121065,10886
"14934","ENSMODG00000020343","5",299256940,299278700,21760
"14935","ENSMODG00000020345","3",238747712,238852291,104579
"14936","ENSMODG00000020348","3",238863084,238899055,35971
"14937","ENSMODG00000020350","5",299364726,299388630,23904
"14938","ENSMODG00000020351","3",238964300,239096992,132692
"14939","ENSMODG00000020352","3",239553896,239666704,112808
"14940","ENSMODG00000020353","5",299398190,299420583,22393
"14941","ENSMODG00000020355","3",240062067,240129617,67550
"14942","ENSMODG00000020356","5",299423014,299433960,10946
"14943","ENSMODG00000020357","3",240148446,240204185,55739
"14944","ENSMODG00000020358","5",299436677,299438859,2182
"14945","ENSMODG00000020359","3",240200460,240201300,840
"14946","ENSMODG00000020360","5",299442173,299450246,8073
"14947","ENSMODG00000020361","3",240215166,240248149,32983
"14948","ENSMODG00000020362","5",299452704,299456780,4076
"14949","ENSMODG00000020363","3",240247320,240300945,53625
"14950","ENSMODG00000020364","5",299463426,299478279,14853
"14951","ENSMODG00000020365","3",240316223,240364041,47818
"14952","ENSMODG00000020366","5",299483855,299486864,3009
"14953","ENSMODG00000020367","3",240375023,240406742,31719
"14954","ENSMODG00000020368","5",299520766,299530512,9746
"14955","ENSMODG00000020369","5",299563876,299564953,1077
"14956","ENSMODG00000020370","3",240501499,240776527,275028
"14957","ENSMODG00000020372","3",240912844,240913395,551
"14958","ENSMODG00000020374","2",536415212,536426216,11004
"14959","ENSMODG00000020376","3",241538810,241627653,88843
"14960","ENSMODG00000020377","8",36661361,36681881,20520
"14961","ENSMODG00000020378","8",36887207,36904338,17131
"14962","ENSMODG00000020379","3",241661641,241715709,54068
"14963","ENSMODG00000020380","8",36911539,36932509,20970
"14964","ENSMODG00000020381","8",36977933,37024461,46528
"14965","ENSMODG00000020382","3",241772011,241800076,28065
"14966","ENSMODG00000020383","8",37086988,37126142,39154
"14967","ENSMODG00000020385","8",37191649,37318902,127253
"14968","ENSMODG00000020386","3",241808990,241825320,16330
"14969","ENSMODG00000020387","8",37733108,37855649,122541
"14970","ENSMODG00000020388","8",37871010,37981992,110982
"14971","ENSMODG00000020389","3",241824992,241836007,11015
"14972","ENSMODG00000020391","3",241838913,241892701,53788
"14973","ENSMODG00000020392","8",38023041,38140729,117688
"14974","ENSMODG00000020393","8",38196208,38555574,359366
"14975","ENSMODG00000020394","3",241898305,242084207,185902
"14976","ENSMODG00000020396","8",38783176,38815200,32024
"14977","ENSMODG00000020398","3",242462824,242491720,28896
"14978","ENSMODG00000020399","3",242451247,242452638,1391
"14979","ENSMODG00000020400","3",242493934,242547393,53459
"14980","ENSMODG00000020402","3",242566966,242568089,1123
"14981","ENSMODG00000020404","3",242624406,243184661,560255
"14982","ENSMODG00000020405","3",243262340,243314924,52584
"14983","ENSMODG00000020406","8",39052702,39248628,195926
"14984","ENSMODG00000020407","3",243365367,243437215,71848
"14985","ENSMODG00000020408","8",39277100,39338224,61124
"14986","ENSMODG00000020409","1",287087418,287099259,11841
"14987","ENSMODG00000020410","3",244187499,244211330,23831
"14988","ENSMODG00000020412","3",244365643,244442581,76938
"14989","ENSMODG00000020414","8",39381033,39408679,27646
"14990","ENSMODG00000020416","3",244500188,244595330,95142
"14991","ENSMODG00000020417","8",39490905,39827199,336294
"14992","ENSMODG00000020418","3",244656388,244712330,55942
"14993","ENSMODG00000020419","3",244986960,244987433,473
"14994","ENSMODG00000020420","3",245309620,245339766,30146
"14995","ENSMODG00000020423","3",245668412,246045902,377490
"14996","ENSMODG00000020424","3",246130037,246174721,44684
"14997","ENSMODG00000020425","8",40093202,40550029,456827
"14998","ENSMODG00000020426","3",246190712,246220090,29378
"14999","ENSMODG00000020427","3",246425389,246448051,22662
"15000","ENSMODG00000020429","3",246243805,246252089,8284
"15001","ENSMODG00000020430","3",246594068,246656141,62073
"15002","ENSMODG00000020432","8",42293240,42294427,1187
"15003","ENSMODG00000020433","3",246692675,246772867,80192
"15004","ENSMODG00000020434","3",246986776,247075077,88301
"15005","ENSMODG00000020435","3",247132279,247324405,192126
"15006","ENSMODG00000020439","3",247481612,247918689,437077
"15007","ENSMODG00000020440","8",43738681,44036179,297498
"15008","ENSMODG00000020442","8",44094656,44156195,61539
"15009","ENSMODG00000020443","3",248302426,248437762,135336
"15010","ENSMODG00000020444","8",44181571,44199180,17609
"15011","ENSMODG00000020445","3",248473107,248499226,26119
"15012","ENSMODG00000020447","3",248512600,248564252,51652
"15013","ENSMODG00000020448","3",248651954,248712872,60918
"15014","ENSMODG00000020449","3",248861731,248871042,9311
"15015","ENSMODG00000020450","8",44314501,44329217,14716
"15016","ENSMODG00000020451","8",44332364,44344291,11927
"15017","ENSMODG00000020452","3",249356102,249896688,540586
"15018","ENSMODG00000020453","8",45041906,45043010,1104
"15019","ENSMODG00000020454","3",249927696,249999782,72086
"15020","ENSMODG00000020455","3",251459685,251894628,434943
"15021","ENSMODG00000020456","8",45055872,45071541,15669
"15022","ENSMODG00000020457","3",252261982,252320050,58068
"15023","ENSMODG00000020458","8",45395995,45402080,6085
"15024","ENSMODG00000020459","8",45403215,45553376,150161
"15025","ENSMODG00000020460","3",252327309,252421624,94315
"15026","ENSMODG00000020461","8",45639043,45639367,324
"15027","ENSMODG00000020462","8",45820262,45934415,114153
"15028","ENSMODG00000020464","8",45938484,45945413,6929
"15029","ENSMODG00000020465","8",46078800,46117517,38717
"15030","ENSMODG00000020466","8",47181400,47643694,462294
"15031","ENSMODG00000020467","8",48952799,49241350,288551
"15032","ENSMODG00000020468","8",49376621,49514708,138087
"15033","ENSMODG00000020469","2",350222633,350223430,797
"15034","ENSMODG00000020471","8",49627453,49741993,114540
"15035","ENSMODG00000020473","8",50142029,50364635,222606
"15036","ENSMODG00000020475","Un",26274688,26289276,14588
"15037","ENSMODG00000020476","8",50434482,50722459,287977
"15038","ENSMODG00000020477","8",50790735,50796309,5574
"15039","ENSMODG00000020478","8",50802743,50805935,3192
"15040","ENSMODG00000020479","8",50912079,51052099,140020
"15041","ENSMODG00000020480","8",51389229,51649197,259968
"15042","ENSMODG00000020481","8",51654108,52017505,363397
"15043","ENSMODG00000020484","8",53066548,53076930,10382
"15044","ENSMODG00000020485","8",53076396,53234387,157991
"15045","ENSMODG00000020486","8",53154505,53155630,1125
"15046","ENSMODG00000020487","8",53691599,54043797,352198
"15047","ENSMODG00000020488","8",53809729,53810236,507
"15048","ENSMODG00000020492","8",56448715,56499440,50725
"15049","ENSMODG00000020493","8",56763961,56837458,73497
"15050","ENSMODG00000020494","8",57080792,57113987,33195
"15051","ENSMODG00000020495","Un",26291710,26304072,12362
"15052","ENSMODG00000020496","8",57874302,57922266,47964
"15053","ENSMODG00000020497","8",57896075,57980252,84177
"15054","ENSMODG00000020498","8",58045577,58069256,23679
"15055","ENSMODG00000020501","Un",26340077,26365435,25358
"15056","ENSMODG00000020503","8",60651938,60653548,1610
"15057","ENSMODG00000020504","Un",26389404,26408600,19196
"15058","ENSMODG00000020505","8",60750279,60791074,40795
"15059","ENSMODG00000020506","Un",19542747,19550773,8026
"15060","ENSMODG00000020507","8",60795447,60818553,23106
"15061","ENSMODG00000020509","Un",19564217,19605196,40979
"15062","ENSMODG00000020510","8",60816220,60927094,110874
"15063","ENSMODG00000020511","Un",19616541,19629043,12502
"15064","ENSMODG00000020512","Un",19646026,19887855,241829
"15065","ENSMODG00000020513","8",60950735,61003080,52345
"15066","ENSMODG00000020514","Un",19939760,19958195,18435
"15067","ENSMODG00000020515","8",61403762,61531816,128054
"15068","ENSMODG00000020516","8",62627544,62632462,4918
"15069","ENSMODG00000020517","Un",45980590,46014426,33836
"15070","ENSMODG00000020518","5",188634079,188860331,226252
"15071","ENSMODG00000020520","5",188504729,188620673,115944
"15072","ENSMODG00000020525","5",187132391,187232449,100058
"15073","ENSMODG00000020526","5",187046359,187115010,68651
"15074","ENSMODG00000020527","5",186851595,186877520,25925
"15075","ENSMODG00000020529","5",186493890,186805852,311962
"15076","ENSMODG00000020530","5",185852427,185893635,41208
"15077","ENSMODG00000020531","5",185816715,185819145,2430
"15078","ENSMODG00000020532","5",185788282,185790693,2411
"15079","ENSMODG00000020533","5",185691495,185789543,98048
"15080","ENSMODG00000020538","5",185434836,185527336,92500
"15081","ENSMODG00000020543","5",185250256,185434095,183839
"15082","ENSMODG00000020546","5",185150455,185251301,100846
"15083","ENSMODG00000020548","5",185056272,185148726,92454
"15084","ENSMODG00000020549","5",184950356,184966198,15842
"15085","ENSMODG00000020550","5",185008518,185043721,35203
"15086","ENSMODG00000020553","5",184997081,185001580,4499
"15087","ENSMODG00000020554","5",184972048,184996175,24127
"15088","ENSMODG00000020555","5",184857542,184929106,71564
"15089","ENSMODG00000020556","5",184679130,184761771,82641
"15090","ENSMODG00000020557","5",184552245,184657710,105465
"15091","ENSMODG00000020559","5",184340582,184342064,1482
"15092","ENSMODG00000020560","5",183953355,183962545,9190
"15093","ENSMODG00000020561","X",23545515,23547266,1751
"15094","ENSMODG00000020564","5",183441227,183546105,104878
"15095","ENSMODG00000020565","5",183471694,183472644,950
"15096","ENSMODG00000020566","5",183229062,183434004,204942
"15097","ENSMODG00000020568","5",182942656,182955311,12655
"15098","ENSMODG00000020570","5",182475235,182585004,109769
"15099","ENSMODG00000020572","Un",40015921,40038823,22902
"15100","ENSMODG00000020573","5",182423486,182428917,5431
"15101","ENSMODG00000020574","5",182187455,182218483,31028
"15102","ENSMODG00000020576","Un",46337440,46342217,4777
"15103","ENSMODG00000020577","5",182079052,182148308,69256
"15104","ENSMODG00000020578","Un",46343458,46368012,24554
"15105","ENSMODG00000020579","5",181991612,182036222,44610
"15106","ENSMODG00000020580","5",181781785,181786426,4641
"15107","ENSMODG00000020581","Un",38444777,38480034,35257
"15108","ENSMODG00000020582","Un",38487619,38500063,12444
"15109","ENSMODG00000020583","5",181493753,181771690,277937
"15110","ENSMODG00000020584","Un",38499927,38558738,58811
"15111","ENSMODG00000020587","5",38281457,38373490,92033
"15112","ENSMODG00000020589","5",179283261,179703786,420525
"15113","ENSMODG00000020591","5",179200641,179232107,31466
"15114","ENSMODG00000020592","5",179118812,179159011,40199
"15115","ENSMODG00000020593","5",179086584,179118360,31776
"15116","ENSMODG00000020594","5",38835333,39112626,277293
"15117","ENSMODG00000020596","5",177447873,177562459,114586
"15118","ENSMODG00000020597","5",39175444,39204713,29269
"15119","ENSMODG00000020598","5",177018704,177144338,125634
"15120","ENSMODG00000020599","5",39328220,39344398,16178
"15121","ENSMODG00000020600","5",177047181,177047794,613
"15122","ENSMODG00000020601","5",39353608,39362405,8797
"15123","ENSMODG00000020603","5",39897521,40075464,177943
"15124","ENSMODG00000020605","5",40095029,40164978,69949
"15125","ENSMODG00000020606","5",176209396,176313609,104213
"15126","ENSMODG00000020607","5",40209514,40243850,34336
"15127","ENSMODG00000020608","5",176094652,176095307,655
"15128","ENSMODG00000020609","5",40305849,40429451,123602
"15129","ENSMODG00000020610","5",40595163,40718780,123617
"15130","ENSMODG00000020612","5",41414099,41564050,149951
"15131","ENSMODG00000020613","5",42212888,42259344,46456
"15132","ENSMODG00000020614","5",175670776,176138533,467757
"15133","ENSMODG00000020615","5",42259114,42494514,235400
"15134","ENSMODG00000020616","5",175657197,175662620,5423
"15135","ENSMODG00000020617","5",175516572,175619597,103025
"15136","ENSMODG00000020619","5",175287901,175512161,224260
"15137","ENSMODG00000020620","5",42632104,42754068,121964
"15138","ENSMODG00000020621","5",175206559,175276649,70090
"15139","ENSMODG00000020622","5",175158438,175175193,16755
"15140","ENSMODG00000020624","5",175079182,175107810,28628
"15141","ENSMODG00000020625","5",175002455,175079115,76660
"15142","ENSMODG00000020626","5",42841588,43051520,209932
"15143","ENSMODG00000020627","5",43050511,43084160,33649
"15144","ENSMODG00000020628","5",174856735,174988899,132164
"15145","ENSMODG00000020629","5",43095393,43234592,139199
"15146","ENSMODG00000020631","5",174704433,174777196,72763
"15147","ENSMODG00000020633","5",174642021,174647933,5912
"15148","ENSMODG00000020634","5",174637004,174725539,88535
"15149","ENSMODG00000020635","5",43323971,43452012,128041
"15150","ENSMODG00000020637","5",43585559,43687720,102161
"15151","ENSMODG00000020638","5",174366906,174630927,264021
"15152","ENSMODG00000020640","5",174205252,174273834,68582
"15153","ENSMODG00000020643","5",173937394,174018793,81399
"15154","ENSMODG00000020644","5",173778966,173802263,23297
"15155","ENSMODG00000020645","5",173732896,173779152,46256
"15156","ENSMODG00000020647","5",173258117,173328275,70158
"15157","ENSMODG00000020648","5",173086167,173092638,6471
"15158","ENSMODG00000020649","5",172583929,172888148,304219
"15159","ENSMODG00000020651","5",44710867,44735105,24238
"15160","ENSMODG00000020652","5",46072071,46179742,107671
"15161","ENSMODG00000020653","5",46332712,46333691,979
"15162","ENSMODG00000020654","5",172487930,172581877,93947
"15163","ENSMODG00000020656","5",46633017,46714757,81740
"15164","ENSMODG00000020657","5",46728664,46772415,43751
"15165","ENSMODG00000020658","5",46800244,46865557,65313
"15166","ENSMODG00000020659","5",172233041,172488440,255399
"15167","ENSMODG00000020661","5",47019534,47039575,20041
"15168","ENSMODG00000020663","5",171957888,171959193,1305
"15169","ENSMODG00000020667","5",171758797,171808408,49611
"15170","ENSMODG00000020668","5",171708210,171710989,2779
"15171","ENSMODG00000020669","5",47129508,47318420,188912
"15172","ENSMODG00000020670","5",171557576,171604856,47280
"15173","ENSMODG00000020671","5",170983874,171081733,97859
"15174","ENSMODG00000020672","5",47344095,47513861,169766
"15175","ENSMODG00000020673","5",170630458,170681684,51226
"15176","ENSMODG00000020674","5",47757314,47832064,74750
"15177","ENSMODG00000020675","5",48049923,48480111,430188
"15178","ENSMODG00000020676","5",170419215,170444612,25397
"15179","ENSMODG00000020677","5",170378374,170399480,21106
"15180","ENSMODG00000020678","5",170250235,170369698,119463
"15181","ENSMODG00000020679","5",49208973,49629330,420357
"15182","ENSMODG00000020680","5",170193348,170212753,19405
"15183","ENSMODG00000020684","5",169902926,169957827,54901
"15184","ENSMODG00000020685","5",50679351,50770840,91489
"15185","ENSMODG00000020686","5",51007418,51011588,4170
"15186","ENSMODG00000020687","5",51012696,51094856,82160
"15187","ENSMODG00000020688","5",51116346,51129848,13502
"15188","ENSMODG00000020689","5",169737235,169860266,123031
"15189","ENSMODG00000020690","5",51137413,51209547,72134
"15190","ENSMODG00000020691","5",169418179,169473256,55077
"15191","ENSMODG00000020692","5",169379690,169418620,38930
"15192","ENSMODG00000020693","5",169298755,169379677,80922
"15193","ENSMODG00000020695","5",169275783,169289187,13404
"15194","ENSMODG00000020696","5",169254782,169256155,1373
"15195","ENSMODG00000020697","5",169201140,169241503,40363
"15196","ENSMODG00000020698","5",51372974,51377533,4559
"15197","ENSMODG00000020699","5",169185980,169192753,6773
"15198","ENSMODG00000020701","5",169030536,169072775,42239
"15199","ENSMODG00000020702","5",168737445,168770149,32704
"15200","ENSMODG00000020703","5",168688604,168700467,11863
"15201","ENSMODG00000020704","5",168650197,168688694,38497
"15202","ENSMODG00000020705","5",51408972,51494402,85430
"15203","ENSMODG00000020706","5",168559854,168649818,89964
"15204","ENSMODG00000020708","5",51493098,51528621,35523
"15205","ENSMODG00000020709","5",51560775,51599489,38714
"15206","ENSMODG00000020710","5",51618231,51660712,42481
"15207","ENSMODG00000020713","5",51902827,51926773,23946
"15208","ENSMODG00000020714","5",51966706,51982996,16290
"15209","ENSMODG00000020715","5",52101121,52195234,94113
"15210","ENSMODG00000020716","5",52226037,52287492,61455
"15211","ENSMODG00000020718","5",52587116,52805897,218781
"15212","ENSMODG00000020720","5",52815346,53092545,277199
"15213","ENSMODG00000020721","5",53194920,53195493,573
"15214","ENSMODG00000020722","5",165386315,165387163,848
"15215","ENSMODG00000020723","5",53313347,53413332,99985
"15216","ENSMODG00000020724","5",162773010,163545812,772802
"15217","ENSMODG00000020725","5",53421431,53490136,68705
"15218","ENSMODG00000020727","5",159732122,159876145,144023
"15219","ENSMODG00000020728","5",53519005,53528465,9460
"15220","ENSMODG00000020729","5",53618668,53633990,15322
"15221","ENSMODG00000020730","5",158217527,158724608,507081
"15222","ENSMODG00000020731","5",53647245,53657980,10735
"15223","ENSMODG00000020734","5",53751107,53760763,9656
"15224","ENSMODG00000020735","5",156004514,156066736,62222
"15225","ENSMODG00000020736","5",53776229,53778935,2706
"15226","ENSMODG00000020737","5",155904288,155997689,93401
"15227","ENSMODG00000020738","5",53845659,53887504,41845
"15228","ENSMODG00000020739","5",53929232,53980108,50876
"15229","ENSMODG00000020740","5",155836805,155901186,64381
"15230","ENSMODG00000020741","5",54030159,54111561,81402
"15231","ENSMODG00000020742","5",155810077,155826905,16828
"15232","ENSMODG00000020743","5",155696085,155795041,98956
"15233","ENSMODG00000020744","5",155616384,155658614,42230
"15234","ENSMODG00000020745","5",54139227,54354112,214885
"15235","ENSMODG00000020746","5",155517511,155567365,49854
"15236","ENSMODG00000020747","5",54410256,54417048,6792
"15237","ENSMODG00000020748","5",54469533,54497608,28075
"15238","ENSMODG00000020749","5",155423513,155477444,53931
"15239","ENSMODG00000020751","5",155178084,155198410,20326
"15240","ENSMODG00000020752","5",155075565,155138860,63295
"15241","ENSMODG00000020753","5",154800994,154896226,95232
"15242","ENSMODG00000020754","5",154905096,154937604,32508
"15243","ENSMODG00000020758","5",154346102,154347175,1073
"15244","ENSMODG00000020759","5",154097398,154188149,90751
"15245","ENSMODG00000020760","5",153880817,154082982,202165
"15246","ENSMODG00000020761","5",153807786,153863533,55747
"15247","ENSMODG00000020762","5",54505311,54732836,227525
"15248","ENSMODG00000020768","5",148459943,148534168,74225
"15249","ENSMODG00000020770","5",54862593,54988556,125963
"15250","ENSMODG00000020772","5",55070198,55070696,498
"15251","ENSMODG00000020773","5",55200931,55206452,5521
"15252","ENSMODG00000020774","5",55142345,55200588,58243
"15253","ENSMODG00000020775","5",55207504,55227026,19522
"15254","ENSMODG00000020776","5",55233522,55318012,84490
"15255","ENSMODG00000020778","5",56623864,56632817,8953
"15256","ENSMODG00000020781","5",56842734,56921195,78461
"15257","ENSMODG00000020782","5",56954328,57239771,285443
"15258","ENSMODG00000020783","5",57500013,57620982,120969
"15259","ENSMODG00000020784","5",57636846,57675917,39071
"15260","ENSMODG00000020786","5",57718722,58248754,530032
"15261","ENSMODG00000020788","5",58347540,58373723,26183
"15262","ENSMODG00000020789","5",58519261,58751264,232003
"15263","ENSMODG00000020794","5",58726087,58970605,244518
"15264","ENSMODG00000020795","5",58895628,58898113,2485
"15265","ENSMODG00000020799","Un",3994963,4012690,17727
"15266","ENSMODG00000020801","Un",4091652,4131947,40295
"15267","ENSMODG00000020802","Un",4019514,4036345,16831
"15268","ENSMODG00000020804","Un",4040758,4063315,22557
"15269","ENSMODG00000020805","5",61017726,61034310,16584
"15270","ENSMODG00000020806","Un",4079979,4085182,5203
"15271","ENSMODG00000020807","5",61041475,61158053,116578
"15272","ENSMODG00000020809","5",61369504,61451420,81916
"15273","ENSMODG00000020810","6",268256087,268357490,101403
"15274","ENSMODG00000020811","5",61487868,62135725,647857
"15275","ENSMODG00000020813","2",539877272,540006642,129370
"15276","ENSMODG00000020814","4",377465346,377472064,6718
"15277","ENSMODG00000020815","4",377479949,377483012,3063
"15278","ENSMODG00000020816","4",377489877,377498085,8208
"15279","ENSMODG00000020817","4",377505661,377524545,18884
"15280","ENSMODG00000020818","4",377574302,377601715,27413
"15281","ENSMODG00000020819","4",377725010,377728150,3140
"15282","ENSMODG00000020820","4",377682365,377683536,1171
"15283","ENSMODG00000020821","4",377706972,377715919,8947
"15284","ENSMODG00000020822","4",377717496,377723076,5580
"15285","ENSMODG00000020823","4",377744219,377749768,5549
"15286","ENSMODG00000020825","4",377859304,377870204,10900
"15287","ENSMODG00000020826","4",378011808,378012294,486
"15288","ENSMODG00000020827","4",378013811,378022965,9154
"15289","ENSMODG00000020828","4",378038333,378039277,944
"15290","ENSMODG00000020829","4",378120405,378144006,23601
"15291","ENSMODG00000020830","4",378176928,378204636,27708
"15292","ENSMODG00000020831","4",378219431,378222925,3494
"15293","ENSMODG00000020832","4",378388694,378399501,10807
"15294","ENSMODG00000020833","4",378409037,378435620,26583
"15295","ENSMODG00000020835","4",378488873,378495741,6868
"15296","ENSMODG00000020836","4",378499382,378500131,749
"15297","ENSMODG00000020838","X",26245143,26483756,238613
"15298","ENSMODG00000020840","X",26391953,26397034,5081
"15299","ENSMODG00000020842","X",26626197,26780872,154675
"15300","ENSMODG00000020843","X",26871842,27108055,236213
"15301","ENSMODG00000020848","3",481761076,482051720,290644
"15302","ENSMODG00000020850","4",370948847,370951589,2742
"15303","ENSMODG00000020852","4",370789878,370942005,152127
"15304","ENSMODG00000020853","4",370888173,370889713,1540
"15305","ENSMODG00000020854","4",370875196,370887291,12095
"15306","ENSMODG00000020855","4",370843317,370861340,18023
"15307","ENSMODG00000020856","4",370816819,370842449,25630
"15308","ENSMODG00000020858","4",370769815,370772408,2593
"15309","ENSMODG00000020859","4",370774367,370775683,1316
"15310","ENSMODG00000020860","4",370762538,370767417,4879
"15311","ENSMODG00000020862","4",370673741,370681862,8121
"15312","ENSMODG00000020863","4",370635256,370640062,4806
"15313","ENSMODG00000020864","4",370619736,370628267,8531
"15314","ENSMODG00000020865","4",370594335,370604921,10586
"15315","ENSMODG00000020867","4",370524068,370570073,46005
"15316","ENSMODG00000020869","Un",81331704,81338880,7176
"15317","ENSMODG00000020870","Un",32535623,32604348,68725
"15318","ENSMODG00000020872","Un",13497817,13619782,121965
"15319","ENSMODG00000020873","Un",13719846,13733341,13495
"15320","ENSMODG00000020874","Un",13668392,13669054,662
"15321","ENSMODG00000020875","Un",13875195,13896203,21008
"15322","ENSMODG00000020876","Un",13921231,13962370,41139
"15323","ENSMODG00000020877","Un",13962725,13982066,19341
"15324","ENSMODG00000020885","Un",29795672,29878005,82333
"15325","ENSMODG00000020887","Un",30037705,30070214,32509
"15326","ENSMODG00000020888","Un",23491935,23498481,6546
"15327","ENSMODG00000020889","Un",23490183,23498481,8298
"15328","ENSMODG00000020890","Un",23502348,23612745,110397
"15329","ENSMODG00000020891","Un",23619164,23641762,22598
"15330","ENSMODG00000020892","Un",23644210,23668517,24307
"15331","ENSMODG00000020893","Un",23671390,23723369,51979
"15332","ENSMODG00000020894","Un",23738545,23742846,4301
"15333","ENSMODG00000020895","Un",23741963,23752157,10194
"15334","ENSMODG00000020896","Un",23796952,23820641,23689
"15335","ENSMODG00000020898","Un",9889087,9902562,13475
"15336","ENSMODG00000020899","Un",9911033,9921016,9983
"15337","ENSMODG00000020900","Un",9922571,9929296,6725
"15338","ENSMODG00000020901","Un",9931202,9943908,12706
"15339","ENSMODG00000020902","Un",10047392,10095574,48182
"15340","ENSMODG00000020903","Un",10081851,10086927,5076
"15341","ENSMODG00000020904","Un",10108042,10115964,7922
"15342","ENSMODG00000020906","Un",10131621,10180408,48787
"15343","ENSMODG00000020907","Un",10186221,10202905,16684
"15344","ENSMODG00000020908","Un",10210772,10223774,13002
"15345","ENSMODG00000020909","Un",10238962,10324842,85880
"15346","ENSMODG00000020910","Un",10397592,10405505,7913
"15347","ENSMODG00000020911","Un",29457976,29481760,23784
"15348","ENSMODG00000020912","Un",29492921,29498942,6021
"15349","ENSMODG00000020914","Un",14143250,14286228,142978
"15350","ENSMODG00000020916","Un",14439684,14641434,201750
"15351","ENSMODG00000020917","Un",83600321,83608558,8237
"15352","ENSMODG00000020919","8",31571888,31574036,2148
"15353","ENSMODG00000020932","8",32061458,32085624,24166
"15354","ENSMODG00000020933","8",32136564,32139733,3169
"15355","ENSMODG00000020935","Un",26618413,26720559,102146
"15356","ENSMODG00000020936","Un",26701439,26748834,47395
"15357","ENSMODG00000020938","Un",26970340,26979843,9503
"15358","ENSMODG00000020939","Un",7933799,7934702,903
"15359","ENSMODG00000020941","Un",8019879,8021552,1673
"15360","ENSMODG00000020945","Un",8213435,8214331,896
"15361","ENSMODG00000020948","Un",8398623,8420254,21631
"15362","ENSMODG00000020949","4",62560,86487,23927
"15363","ENSMODG00000020950","4",113257,263929,150672
"15364","ENSMODG00000020951","4",335790,338969,3179
"15365","ENSMODG00000020954","4",784240,922451,138211
"15366","ENSMODG00000020956","4",1142672,1163761,21089
"15367","ENSMODG00000020957","4",1233687,1236836,3149
"15368","ENSMODG00000020958","4",1266691,1311929,45238
"15369","ENSMODG00000020959","4",1384131,1512450,128319
"15370","ENSMODG00000020960","4",1562150,1609069,46919
"15371","ENSMODG00000020961","4",1688435,1755902,67467
"15372","ENSMODG00000020962","4",1769141,1825701,56560
"15373","ENSMODG00000020963","4",1846066,1953677,107611
"15374","ENSMODG00000020964","4",1903452,1904813,1361
"15375","ENSMODG00000020965","4",2102662,2943704,841042
"15376","ENSMODG00000020968","4",3001290,3052541,51251
"15377","ENSMODG00000020969","4",3081729,3142799,61070
"15378","ENSMODG00000020970","4",3150020,3222887,72867
"15379","ENSMODG00000020971","4",3233821,3259768,25947
"15380","ENSMODG00000020972","4",3260845,3265943,5098
"15381","ENSMODG00000020973","4",3311877,3449282,137405
"15382","ENSMODG00000020974","4",3358448,3359137,689
"15383","ENSMODG00000020976","4",3515717,3546853,31136
"15384","ENSMODG00000020977","4",3580581,3664524,83943
"15385","ENSMODG00000020978","4",3745434,3765711,20277
"15386","ENSMODG00000020979","4",3835536,3865443,29907
"15387","ENSMODG00000020980","4",4020639,4094973,74334
"15388","ENSMODG00000020981","4",4350013,4480661,130648
"15389","ENSMODG00000020982","4",4526845,4669446,142601
"15390","ENSMODG00000020983","4",4838018,4874282,36264
"15391","ENSMODG00000020986","4",4907402,4999266,91864
"15392","ENSMODG00000020987","4",5001337,5080444,79107
"15393","ENSMODG00000020988","4",5080103,5095321,15218
"15394","ENSMODG00000020989","4",5100952,5121980,21028
"15395","ENSMODG00000020990","4",5244260,5261871,17611
"15396","ENSMODG00000020992","4",5597812,5845865,248053
"15397","ENSMODG00000020993","4",5856838,5871387,14549
"15398","ENSMODG00000020994","4",5872910,5904058,31148
"15399","ENSMODG00000020995","4",5935377,5939442,4065
"15400","ENSMODG00000020996","4",5953394,6070659,117265
"15401","ENSMODG00000020997","4",6009987,6083780,73793
"15402","ENSMODG00000020998","4",6229411,6309882,80471
"15403","ENSMODG00000021000","4",6363518,6374624,11106
"15404","ENSMODG00000021001","4",6492226,6628924,136698
"15405","ENSMODG00000021002","4",6639250,6763113,123863
"15406","ENSMODG00000021004","4",6788804,6882043,93239
"15407","ENSMODG00000021005","4",6892678,6927526,34848
"15408","ENSMODG00000021006","4",6957945,6958652,707
"15409","ENSMODG00000021008","4",7208206,7297279,89073
"15410","ENSMODG00000021009","4",7301853,7452213,150360
"15411","ENSMODG00000021010","4",7467232,7534928,67696
"15412","ENSMODG00000021011","4",7538493,7550194,11701
"15413","ENSMODG00000021012","4",7564121,7676079,111958
"15414","ENSMODG00000021013","4",7688339,7714884,26545
"15415","ENSMODG00000021015","1",107280419,107478072,197653
"15416","ENSMODG00000021016","4",8229715,8312530,82815
"15417","ENSMODG00000021017","4",8347357,8348401,1044
"15418","ENSMODG00000021019","4",8456451,8463955,7504
"15419","ENSMODG00000021020","4",8488913,8542629,53716
"15420","ENSMODG00000021021","4",8551246,8685411,134165
"15421","ENSMODG00000021023","4",8702144,8883117,180973
"15422","ENSMODG00000021024","4",9085013,9124266,39253
"15423","ENSMODG00000021025","4",9161727,9187139,25412
"15424","ENSMODG00000021026","4",9197138,9338418,141280
"15425","ENSMODG00000021028","4",9345685,9392782,47097
"15426","ENSMODG00000021030","4",9526323,9532076,5753
"15427","ENSMODG00000021031","4",9616701,9630720,14019
"15428","ENSMODG00000021032","4",9764036,9867003,102967
"15429","ENSMODG00000021033","4",9882867,9921780,38913
"15430","ENSMODG00000021034","4",9963165,10064117,100952
"15431","ENSMODG00000021035","4",10077222,10081685,4463
"15432","ENSMODG00000021036","4",10107697,10149082,41385
"15433","ENSMODG00000021037","4",10239695,10356177,116482
"15434","ENSMODG00000021039","4",10419744,10549174,129430
"15435","ENSMODG00000021040","4",10626850,10738389,111539
"15436","ENSMODG00000021041","4",10741350,10754547,13197
"15437","ENSMODG00000021043","4",11003646,11126524,122878
"15438","ENSMODG00000021044","4",11131637,11139380,7743
"15439","ENSMODG00000021045","4",11153142,11154099,957
"15440","ENSMODG00000021047","4",11163747,11191037,27290
"15441","ENSMODG00000021048","4",11194936,11229804,34868
"15442","ENSMODG00000021051","4",12512402,12639312,126910
"15443","ENSMODG00000021052","4",12718628,12804674,86046
"15444","ENSMODG00000021053","4",12889133,13017047,127914
"15445","ENSMODG00000021054","4",13501805,13506207,4402
"15446","ENSMODG00000021055","4",13532150,13534285,2135
"15447","ENSMODG00000021057","4",13772246,13786735,14489
"15448","ENSMODG00000021058","4",13808618,14087343,278725
"15449","ENSMODG00000021059","4",14115578,14151580,36002
"15450","ENSMODG00000021060","4",14152607,14170194,17587
"15451","ENSMODG00000021061","4",14168430,14200379,31949
"15452","ENSMODG00000021062","4",14204963,14241211,36248
"15453","ENSMODG00000021064","4",14256166,14257329,1163
"15454","ENSMODG00000021065","4",14308175,14321885,13710
"15455","ENSMODG00000021066","4",14326433,14355573,29140
"15456","ENSMODG00000021067","4",14420849,14470407,49558
"15457","ENSMODG00000021068","4",14481499,14546078,64579
"15458","ENSMODG00000021069","4",14551585,14586665,35080
"15459","ENSMODG00000021070","4",14833079,14833726,647
"15460","ENSMODG00000021071","4",15245655,15246841,1186
"15461","ENSMODG00000021072","4",15265957,15298217,32260
"15462","ENSMODG00000021073","4",15321138,15445380,124242
"15463","ENSMODG00000021074","4",15456080,15482476,26396
"15464","ENSMODG00000021075","4",15634893,15717956,83063
"15465","ENSMODG00000021076","4",15764062,15877266,113204
"15466","ENSMODG00000021079","4",15970499,16011928,41429
"15467","ENSMODG00000021080","4",16159772,16291181,131409
"15468","ENSMODG00000021081","4",16370208,16411155,40947
"15469","ENSMODG00000021082","4",16412623,16440654,28031
"15470","ENSMODG00000021084","4",16647734,16693603,45869
"15471","ENSMODG00000021086","4",17747108,17843404,96296
"15472","ENSMODG00000021087","4",17890564,18145796,255232
"15473","ENSMODG00000021088","4",18501958,18533558,31600
"15474","ENSMODG00000021090","4",18684704,18905804,221100
"15475","ENSMODG00000021091","4",19180684,19247212,66528
"15476","ENSMODG00000021092","4",19328224,19446381,118157
"15477","ENSMODG00000021093","4",19481755,19625495,143740
"15478","ENSMODG00000021094","4",19912864,19913392,528
"15479","ENSMODG00000021095","4",21633652,22098059,464407
"15480","ENSMODG00000021097","4",22331869,22343917,12048
"15481","ENSMODG00000021098","4",22456254,22624380,168126
"15482","ENSMODG00000021099","4",23123843,23204620,80777
"15483","ENSMODG00000021100","4",23211750,23237079,25329
"15484","ENSMODG00000021101","4",23288971,23317469,28498
"15485","ENSMODG00000021102","4",24014221,24051498,37277
"15486","ENSMODG00000021103","4",26203518,26332577,129059
"15487","ENSMODG00000021104","4",26440237,26524170,83933
"15488","ENSMODG00000021106","4",26560513,26660104,99591
"15489","ENSMODG00000021107","4",26715064,26815414,100350
"15490","ENSMODG00000021108","4",26835854,26980954,145100
"15491","ENSMODG00000021109","4",27132640,27150612,17972
"15492","ENSMODG00000021110","4",27201500,27252842,51342
"15493","ENSMODG00000021111","4",27313211,27368316,55105
"15494","ENSMODG00000021112","4",27386122,27488639,102517
"15495","ENSMODG00000021113","4",27590291,27722672,132381
"15496","ENSMODG00000021114","4",27833457,27954489,121032
"15497","ENSMODG00000021118","4",27963606,28716437,752831
"15498","ENSMODG00000021120","4",29172854,29173886,1032
"15499","ENSMODG00000021121","4",29936683,29977858,41175
"15500","ENSMODG00000021123","4",31596781,33039977,1443196
"15501","ENSMODG00000021126","4",33155032,33877914,722882
"15502","ENSMODG00000021127","4",34223433,34283437,60004
"15503","ENSMODG00000021128","4",34391424,34402831,11407
"15504","ENSMODG00000021132","Un",55044097,55044558,461
"15505","ENSMODG00000021137","4",386595653,386596606,953
"15506","ENSMODG00000021138","Un",59598119,59608777,10658
"15507","ENSMODG00000021139","Un",81304996,81305805,809
"15508","ENSMODG00000021142","X",25965632,25968527,2895
"15509","ENSMODG00000021143","Un",31392492,31497198,104706
"15510","ENSMODG00000021145","Un",31537252,31571053,33801
"15511","ENSMODG00000021146","Un",31603427,31613696,10269
"15512","ENSMODG00000021147","Un",31625625,31645319,19694
"15513","ENSMODG00000021148","8",31035556,31050648,15092
"15514","ENSMODG00000021150","8",31135241,31180299,45058
"15515","ENSMODG00000021154","8",31254659,31256256,1597
"15516","ENSMODG00000021155","8",31311958,31313246,1288
"15517","ENSMODG00000021156","8",31312505,31324919,12414
"15518","ENSMODG00000021157","8",31372926,31406002,33076
"15519","ENSMODG00000021158","8",31422133,31434594,12461
"15520","ENSMODG00000021159","Un",34693386,34694453,1067
"15521","ENSMODG00000021160","Un",34804972,34807212,2240
"15522","ENSMODG00000021161","Un",81090754,81098161,7407
"15523","ENSMODG00000021162","6",288852393,288911086,58693
"15524","ENSMODG00000021163","6",288922600,288925755,3155
"15525","ENSMODG00000021164","6",289079753,289163092,83339
"15526","ENSMODG00000021165","6",289163606,289170909,7303
"15527","ENSMODG00000021166","6",289179944,289195417,15473
"15528","ENSMODG00000021167","6",289255382,289335925,80543
"15529","ENSMODG00000021168","6",289402381,289422830,20449
"15530","ENSMODG00000021169","6",289453257,289480263,27006
"15531","ENSMODG00000021170","6",289479665,289497915,18250
"15532","ENSMODG00000021171","6",289512173,289616460,104287
"15533","ENSMODG00000021173","Un",84704191,84705162,971
"15534","ENSMODG00000021175","Un",28936013,29084242,148229
"15535","ENSMODG00000021176","Un",29120886,29142633,21747
"15536","ENSMODG00000021177","Un",24113931,24167843,53912
"15537","ENSMODG00000021178","Un",25734248,25759081,24833
"15538","ENSMODG00000021179","Un",25759378,26119915,360537
"15539","ENSMODG00000021181","Un",15859335,15859975,640
"15540","ENSMODG00000021182","Un",15867735,15873406,5671
"15541","ENSMODG00000021183","Un",15873308,15897280,23972
"15542","ENSMODG00000021184","Un",15902150,15902680,530
"15543","ENSMODG00000021189","7",228354059,228511345,157286
"15544","ENSMODG00000021190","7",227510168,227624998,114830
"15545","ENSMODG00000021191","7",227240478,227389404,148926
"15546","ENSMODG00000021192","7",227144079,227234325,90246
"15547","ENSMODG00000021193","7",227086472,227119560,33088
"15548","ENSMODG00000021195","7",226753472,226836544,83072
"15549","ENSMODG00000021196","7",226643542,226644054,512
"15550","ENSMODG00000021197","7",225998968,226000842,1874
"15551","ENSMODG00000021198","7",225725690,225808860,83170
"15552","ENSMODG00000021199","7",225617266,225690907,73641
"15553","ENSMODG00000021200","7",225591064,225603541,12477
"15554","ENSMODG00000021201","7",225520922,225578445,57523
"15555","ENSMODG00000021203","7",225255338,225265386,10048
"15556","ENSMODG00000021204","7",225086748,225192003,105255
"15557","ENSMODG00000021205","7",224571920,224852859,280939
"15558","ENSMODG00000021206","7",223646992,223996914,349922
"15559","ENSMODG00000021208","7",222318466,222322197,3731
"15560","ENSMODG00000021209","7",222136099,222263646,127547
"15561","ENSMODG00000021210","7",221947507,222078625,131118
"15562","ENSMODG00000021211","7",221761615,221931334,169719
"15563","ENSMODG00000021212","7",221710608,221746123,35515
"15564","ENSMODG00000021213","7",221670774,221706414,35640
"15565","ENSMODG00000021214","7",221486513,221599682,113169
"15566","ENSMODG00000021216","7",221280085,221321500,41415
"15567","ENSMODG00000021218","7",221043369,221099293,55924
"15568","ENSMODG00000021219","7",220841849,221001674,159825
"15569","ENSMODG00000021220","7",220462724,220488100,25376
"15570","ENSMODG00000021221","7",219855587,220004763,149176
"15571","ENSMODG00000021223","7",219145170,219577300,432130
"15572","ENSMODG00000021224","7",218979732,219078428,98696
"15573","ENSMODG00000021225","7",218816064,218913872,97808
"15574","ENSMODG00000021226","7",218758476,218814150,55674
"15575","ENSMODG00000021228","7",218521046,218571100,50054
"15576","ENSMODG00000021230","7",218325459,218484096,158637
"15577","ENSMODG00000021231","7",218281849,218296347,14498
"15578","ENSMODG00000021232","7",218229011,218238046,9035
"15579","ENSMODG00000021233","7",218056330,218213745,157415
"15580","ENSMODG00000021234","7",217936907,218021023,84116
"15581","ENSMODG00000021235","7",217785151,217823650,38499
"15582","ENSMODG00000021236","7",217640765,217730679,89914
"15583","ENSMODG00000021237","7",217509754,217638819,129065
"15584","ENSMODG00000021238","7",217353147,217398062,44915
"15585","ENSMODG00000021239","7",217261992,217320654,58662
"15586","ENSMODG00000021240","7",217158292,217255336,97044
"15587","ENSMODG00000021241","7",217066489,217067619,1130
"15588","ENSMODG00000021242","7",216930196,217006850,76654
"15589","ENSMODG00000021243","7",216846454,216848082,1628
"15590","ENSMODG00000021244","7",215947913,216695687,747774
"15591","ENSMODG00000021245","7",215739070,215771363,32293
"15592","ENSMODG00000021246","7",213057239,213166713,109474
"15593","ENSMODG00000021247","7",212855272,212919738,64466
"15594","ENSMODG00000021248","7",212766124,212830667,64543
"15595","ENSMODG00000021249","7",212616950,212642647,25697
"15596","ENSMODG00000021250","7",211749756,211765872,16116
"15597","ENSMODG00000021251","7",211738093,211741609,3516
"15598","ENSMODG00000021252","1",46524837,46525717,880
"15599","ENSMODG00000021255","7",210095056,210138083,43027
"15600","ENSMODG00000021256","7",210052534,210085984,33450
"15601","ENSMODG00000021257","7",209905007,209951062,46055
"15602","ENSMODG00000021258","7",209859213,209896283,37070
"15603","ENSMODG00000021259","7",209794338,209838765,44427
"15604","ENSMODG00000021261","7",209734814,209941180,206366
"15605","ENSMODG00000021262","7",209679613,209727942,48329
"15606","ENSMODG00000021263","7",209614476,209640400,25924
"15607","ENSMODG00000021264","7",209568350,209581742,13392
"15608","ENSMODG00000021265","7",209516965,209534909,17944
"15609","ENSMODG00000021266","7",209316157,209512519,196362
"15610","ENSMODG00000021267","7",209188279,209203003,14724
"15611","ENSMODG00000021268","7",208965683,209117150,151467
"15612","ENSMODG00000021269","7",208952646,208960531,7885
"15613","ENSMODG00000021271","7",208342977,208388955,45978
"15614","ENSMODG00000021272","7",208272242,208274084,1842
"15615","ENSMODG00000021273","7",208193030,208213863,20833
"15616","ENSMODG00000021274","7",208122448,208166623,44175
"15617","ENSMODG00000021275","7",208028436,208069216,40780
"15618","ENSMODG00000021277","7",207796256,207850099,53843
"15619","ENSMODG00000021278","7",207249165,207647110,397945
"15620","ENSMODG00000021279","7",207491476,207492495,1019
"15621","ENSMODG00000021280","7",207375899,207403303,27404
"15622","ENSMODG00000021281","7",207210967,207249333,38366
"15623","ENSMODG00000021282","7",207017023,207034826,17803
"15624","ENSMODG00000021283","7",206915090,206939030,23940
"15625","ENSMODG00000021284","7",206766654,206773455,6801
"15626","ENSMODG00000021285","7",206750997,206766463,15466
"15627","ENSMODG00000021286","7",206386857,206728578,341721
"15628","ENSMODG00000021287","7",206328168,206358548,30380
"15629","ENSMODG00000021288","7",206190018,206322614,132596
"15630","ENSMODG00000021291","7",206046639,206167099,120460
"15631","ENSMODG00000021292","7",204853958,204855001,1043
"15632","ENSMODG00000021293","7",204144707,204151828,7121
"15633","ENSMODG00000021294","7",204089320,204122832,33512
"15634","ENSMODG00000021295","7",203774178,203824932,50754
"15635","ENSMODG00000021296","7",203754640,203773902,19262
"15636","ENSMODG00000021298","7",202917669,203203684,286015
"15637","ENSMODG00000021299","7",202756157,202894548,138391
"15638","ENSMODG00000021300","7",202700838,202716011,15173
"15639","ENSMODG00000021301","7",202680056,202697417,17361
"15640","ENSMODG00000021302","7",202482225,202683901,201676
"15641","ENSMODG00000021303","7",202509485,202532097,22612
"15642","ENSMODG00000021304","7",202469939,202502630,32691
"15643","ENSMODG00000021305","7",202274767,202343395,68628
"15644","ENSMODG00000021306","7",202432446,202436540,4094
"15645","ENSMODG00000021307","7",202351763,202364508,12745
"15646","ENSMODG00000021308","7",202164967,202215221,50254
"15647","ENSMODG00000021309","7",201965932,201998154,32222
"15648","ENSMODG00000021312","7",200083101,200115593,32492
"15649","ENSMODG00000021313","7",199325242,199326183,941
"15650","ENSMODG00000021314","7",197936569,198949233,1012664
"15651","ENSMODG00000021315","7",196571339,197358122,786783
"15652","ENSMODG00000021318","7",195739491,196061122,321631
"15653","ENSMODG00000021319","7",195597282,195659499,62217
"15654","ENSMODG00000021320","7",195497927,195561021,63094
"15655","ENSMODG00000021321","7",195424157,195440969,16812
"15656","ENSMODG00000021322","7",195376439,195381327,4888
"15657","ENSMODG00000021323","7",195071362,195341000,269638
"15658","ENSMODG00000021324","Un",7192251,7252887,60636
"15659","ENSMODG00000021325","Un",7302951,7331233,28282
"15660","ENSMODG00000021327","Un",7483611,7534720,51109
"15661","ENSMODG00000021328","Un",7610045,7610925,880
"15662","ENSMODG00000021329","Un",7567431,7590128,22697
"15663","ENSMODG00000021330","Un",7591861,7602534,10673
"15664","ENSMODG00000021331","Un",7615100,7643137,28037
"15665","ENSMODG00000021332","Un",7655080,7668460,13380
"15666","ENSMODG00000021334","Un",7747867,7753696,5829
"15667","ENSMODG00000021335","Un",7564622,7887684,323062
"15668","ENSMODG00000021336","Un",7776012,7779367,3355
"15669","ENSMODG00000021337","Un",7796324,7798398,2074
"15670","ENSMODG00000021338","Un",7833273,7839219,5946
"15671","ENSMODG00000021339","Un",7844152,7845960,1808
"15672","ENSMODG00000021342","Un",35230407,35235614,5207
"15673","ENSMODG00000021343","X",12835647,12841817,6170
"15674","ENSMODG00000021344","X",12995689,12997287,1598
"15675","ENSMODG00000021345","Un",31883087,31893644,10557
"15676","ENSMODG00000021346","Un",31964117,31974248,10131
"15677","ENSMODG00000021347","Un",32023018,32093565,70547
"15678","ENSMODG00000021348","Un",32030341,32035852,5511
"15679","ENSMODG00000021349","Un",32037071,32040834,3763
"15680","ENSMODG00000021350","Un",32042205,32058324,16119
"15681","ENSMODG00000021351","Un",32058489,32073337,14848
"15682","ENSMODG00000021352","Un",32068889,32089007,20118
"15683","ENSMODG00000021353","Un",32095945,32101609,5664
"15684","ENSMODG00000021354","Un",32240313,32257344,17031
"15685","ENSMODG00000021356","Un",18176370,18207827,31457
"15686","ENSMODG00000021357","Un",18214959,18226866,11907
"15687","ENSMODG00000021358","Un",18278328,18285969,7641
"15688","ENSMODG00000021359","Un",18277260,18293641,16381
"15689","ENSMODG00000021362","Un",18361717,18385120,23403
"15690","ENSMODG00000021363","Un",18391717,18432206,40489
"15691","ENSMODG00000021364","Un",18512742,18534259,21517
"15692","ENSMODG00000021365","Un",18541308,18550859,9551
"15693","ENSMODG00000021377","Un",70279302,70291271,11969
"15694","ENSMODG00000021382","Un",3609877,3942947,333070
"15695","ENSMODG00000021392","3",297749338,297750124,786
"15696","ENSMODG00000021394","8",122709600,122710019,419
"15697","ENSMODG00000021396","3",294710456,294712063,1607
"15698","ENSMODG00000021397","3",294518209,294520259,2050
"15699","ENSMODG00000021398","3",294178607,294452269,273662
"15700","ENSMODG00000021399","3",293988755,294088544,99789
"15701","ENSMODG00000021401","3",292021967,292466393,444426
"15702","ENSMODG00000021402","3",291652937,291780796,127859
"15703","ENSMODG00000021403","3",291507349,291508653,1304
"15704","ENSMODG00000021407","3",289610938,289613528,2590
"15705","ENSMODG00000021408","3",287566796,287745683,178887
"15706","ENSMODG00000021410","3",285958368,286143572,185204
"15707","ENSMODG00000021414","3",282199347,282200324,977
"15708","ENSMODG00000021415","3",282096056,282134156,38100
"15709","ENSMODG00000021416","3",282050777,282079921,29144
"15710","ENSMODG00000021417","3",281647118,282029796,382678
"15711","ENSMODG00000021418","3",281163802,281325095,161293
"15712","ENSMODG00000021421","3",281136456,281153987,17531
"15713","ENSMODG00000021422","3",280897565,281006123,108558
"15714","ENSMODG00000021423","3",280821557,280840615,19058
"15715","ENSMODG00000021424","3",280797595,280821983,24388
"15716","ENSMODG00000021426","3",280461099,280749378,288279
"15717","ENSMODG00000021427","3",280408115,280477996,69881
"15718","ENSMODG00000021428","3",280342836,280392731,49895
"15719","ENSMODG00000021430","3",280218398,280247821,29423
"15720","ENSMODG00000021431","3",280085290,280161140,75850
"15721","ENSMODG00000021432","3",280025571,280028010,2439
"15722","ENSMODG00000021433","3",279947636,279964512,16876
"15723","ENSMODG00000021434","3",279695323,279947248,251925
"15724","ENSMODG00000021439","3",278061465,278103115,41650
"15725","ENSMODG00000021440","3",277977043,278027615,50572
"15726","ENSMODG00000021441","3",277765330,277766452,1122
"15727","ENSMODG00000021442","3",277124138,277206105,81967
"15728","ENSMODG00000021443","3",276870390,277053482,183092
"15729","ENSMODG00000021444","3",276717131,276794841,77710
"15730","ENSMODG00000021445","3",276674042,276708247,34205
"15731","ENSMODG00000021446","3",276505524,276564583,59059
"15732","ENSMODG00000021447","3",276358463,276492528,134065
"15733","ENSMODG00000021448","3",276221735,276274807,53072
"15734","ENSMODG00000021451","3",275709149,275874288,165139
"15735","ENSMODG00000021452","3",275558032,275607807,49775
"15736","ENSMODG00000021453","3",274542947,275340320,797373
"15737","ENSMODG00000021454","3",273560918,273716661,155743
"15738","ENSMODG00000021455","3",273355718,273555310,199592
"15739","ENSMODG00000021457","3",272285101,272831516,546415
"15740","ENSMODG00000021459","3",271426818,271538115,111297
"15741","ENSMODG00000021460","3",271309352,271397126,87774
"15742","ENSMODG00000021461","3",269128236,269881561,753325
"15743","ENSMODG00000021462","3",269077724,269085993,8269
"15744","ENSMODG00000021463","1",312170244,312170762,518
"15745","ENSMODG00000021464","3",268818152,268846678,28526
"15746","ENSMODG00000021465","3",268573875,268754007,180132
"15747","ENSMODG00000021466","3",268363582,268447091,83509
"15748","ENSMODG00000021467","3",268287350,268360262,72912
"15749","ENSMODG00000021469","3",267961345,268155541,194196
"15750","ENSMODG00000021471","3",267845096,267919178,74082
"15751","ENSMODG00000021472","3",267798370,267844996,46626
"15752","ENSMODG00000021476","3",265487149,265495565,8416
"15753","ENSMODG00000021477","3",265214079,265257872,43793
"15754","ENSMODG00000021479","3",265117049,265130545,13496
"15755","ENSMODG00000021480","3",265071395,265102713,31318
"15756","ENSMODG00000021481","3",264690434,264934325,243891
"15757","ENSMODG00000021482","3",264536485,264598209,61724
"15758","ENSMODG00000021483","3",264494850,264533341,38491
"15759","ENSMODG00000021484","3",264276041,264401763,125722
"15760","ENSMODG00000021485","3",263756547,263977175,220628
"15761","ENSMODG00000021486","3",263707964,263755746,47782
"15762","ENSMODG00000021487","3",263654463,263670197,15734
"15763","ENSMODG00000021489","3",263529370,263583736,54366
"15764","ENSMODG00000021490","3",263306748,263474691,167943
"15765","ENSMODG00000021491","3",263187741,263188093,352
"15766","ENSMODG00000021492","3",262895315,262940943,45628
"15767","ENSMODG00000021493","3",261808731,261891999,83268
"15768","ENSMODG00000021495","3",261515933,261668167,152234
"15769","ENSMODG00000021496","3",261239814,261264328,24514
"15770","ENSMODG00000021497","3",261201876,261235771,33895
"15771","ENSMODG00000021498","3",261124182,261206245,82063
"15772","ENSMODG00000021499","3",261028024,261086638,58614
"15773","ENSMODG00000021501","3",260876625,260878001,1376
"15774","ENSMODG00000021502","3",260612750,260971097,358347
"15775","ENSMODG00000021503","3",260429837,260539244,109407
"15776","ENSMODG00000021504","3",260397088,260421665,24577
"15777","ENSMODG00000021505","3",260055994,260386965,330971
"15778","ENSMODG00000021509","3",258760176,259107886,347710
"15779","ENSMODG00000021510","3",257808037,257907353,99316
"15780","ENSMODG00000021511","3",257720824,257765401,44577
"15781","ENSMODG00000021512","3",257502886,257700867,197981
"15782","ENSMODG00000021513","3",257252080,257372109,120029
"15783","ENSMODG00000021514","3",256824194,256831864,7670
"15784","ENSMODG00000021515","3",256394573,256761146,366573
"15785","ENSMODG00000021517","3",255120066,255194248,74182
"15786","ENSMODG00000021519","4",396676716,396698886,22170
"15787","ENSMODG00000021523","6",29649915,29657703,7788
"15788","ENSMODG00000021527","4",397050406,397051920,1514
"15789","ENSMODG00000021528","4",397052569,397057936,5367
"15790","ENSMODG00000021529","4",397026726,397160844,134118
"15791","ENSMODG00000021531","4",397144157,397146392,2235
"15792","ENSMODG00000021532","4",397149431,397151218,1787
"15793","ENSMODG00000021533","4",397159419,397169087,9668
"15794","ENSMODG00000021534","4",397180629,397201007,20378
"15795","ENSMODG00000021535","4",397203166,397208160,4994
"15796","ENSMODG00000021538","4",397247732,397254786,7054
"15797","ENSMODG00000021539","4",397262075,397262665,590
"15798","ENSMODG00000021540","4",397269891,397276999,7108
"15799","ENSMODG00000021541","4",397284238,397307543,23305
"15800","ENSMODG00000021542","4",397322788,397331164,8376
"15801","ENSMODG00000021544","4",397351004,397362328,11324
"15802","ENSMODG00000021545","4",397365257,397375558,10301
"15803","ENSMODG00000021546","4",397432647,397442005,9358
"15804","ENSMODG00000021547","4",397440799,397443954,3155
"15805","ENSMODG00000021548","4",397450470,397458425,7955
"15806","ENSMODG00000021549","4",397461602,397474278,12676
"15807","ENSMODG00000021550","6",291524057,291591686,67629
"15808","ENSMODG00000021551","6",291597825,291624281,26456
"15809","ENSMODG00000021555","6",291823692,291852852,29160
"15810","ENSMODG00000021556","6",291857900,291883258,25358
"15811","ENSMODG00000021558","MT",1,70,69
"15812","ENSMODG00000021559","MT",71,1026,955
"15813","ENSMODG00000021560","MT",1099,2677,1578
"15814","ENSMODG00000021562","MT",2755,3711,956
"15815","ENSMODG00000021566","MT",3916,4959,1043
"15816","ENSMODG00000021572","MT",5406,6947,1541
"15817","ENSMODG00000021573","MT",6950,7018,68
"15818","ENSMODG00000021574","MT",7021,7089,68
"15819","ENSMODG00000021575","MT",7091,7775,684
"15820","ENSMODG00000021577","MT",7836,8045,209
"15821","ENSMODG00000021578","MT",8000,8680,680
"15822","ENSMODG00000021579","MT",8680,9463,783
"15823","ENSMODG00000021580","MT",9464,9531,67
"15824","ENSMODG00000021581","MT",9529,9879,350
"15825","ENSMODG00000021582","MT",9878,9946,68
"15826","ENSMODG00000021583","MT",9947,10243,296
"15827","ENSMODG00000021584","MT",10237,11614,1377
"15828","ENSMODG00000021585","MT",11615,11683,68
"15829","ENSMODG00000021587","MT",11742,11812,70
"15830","ENSMODG00000021588","MT",11813,13639,1826
"15831","ENSMODG00000021589","MT",13616,14116,500
"15832","ENSMODG00000021590","MT",14114,14182,68
"15833","ENSMODG00000021591","MT",14185,15333,1148
"15834","ENSMODG00000021595","2",305298720,305298829,109
"15835","ENSMODG00000021603","4",104835015,104835205,190
"15836","ENSMODG00000021607","3",458211786,458211892,106
"15837","ENSMODG00000021609","4",379531315,379531417,102
"15838","ENSMODG00000021610","3",377022132,377022250,118
"15839","ENSMODG00000021614","2",267616833,267616911,78
"15840","ENSMODG00000021616","8",122623325,122623425,100
"15841","ENSMODG00000021618","8",135820295,135820413,118
"15842","ENSMODG00000021621","1",473129848,473129954,106
"15843","ENSMODG00000021624","3",225591618,225591736,118
"15844","ENSMODG00000021625","6",192470210,192470316,106
"15845","ENSMODG00000021629","4",367695903,367696100,197
"15846","ENSMODG00000021634","1",594721933,594722039,106
"15847","ENSMODG00000021641","6",14120671,14120777,106
"15848","ENSMODG00000021645","X",71732788,71732894,106
"15849","ENSMODG00000021648","4",359093880,359094013,133
"15850","ENSMODG00000021650","3",331164666,331164772,106
"15851","ENSMODG00000021670","4",62104139,62104273,134
"15852","ENSMODG00000021673","6",275138713,275138849,136
"15853","ENSMODG00000021679","2",301549193,301549515,322
"15854","ENSMODG00000021682","4",86857472,86857578,106
"15855","ENSMODG00000021691","2",257958299,257958366,67
"15856","ENSMODG00000021693","1",395299862,395299964,102
"15857","ENSMODG00000021698","1",460619167,460619228,61
"15858","ENSMODG00000021699","1",460617866,460617941,75
"15859","ENSMODG00000021702","1",657272232,657272369,137
"15860","ENSMODG00000021703","4",104797114,104797277,163
"15861","ENSMODG00000021706","7",206769552,206769686,134
"15862","ENSMODG00000021708","1",464662148,464662293,145
"15863","ENSMODG00000021712","1",697433737,697433821,84
"15864","ENSMODG00000021713","2",192227423,192227541,118
"15865","ENSMODG00000021717","1",397733566,397733699,133
"15866","ENSMODG00000021725","7",189340232,189340304,72
"15867","ENSMODG00000021731","1",460618663,460618754,91
"15868","ENSMODG00000021733","8",31369677,31369813,136
"15869","ENSMODG00000021736","2",257963417,257963484,67
"15870","ENSMODG00000021749","4",265462698,265462831,133
"15871","ENSMODG00000021750","1",464661678,464661811,133
"15872","ENSMODG00000021752","8",213204134,213204231,97
"15873","ENSMODG00000021776","7",189339817,189339951,134
"15874","ENSMODG00000021777","6",99810319,99810426,107
"15875","ENSMODG00000021779","2",536433019,536433097,78
"15876","ENSMODG00000021780","1",697433288,697433376,88
"15877","ENSMODG00000021786","X",27845729,27845831,102
"15878","ENSMODG00000021788","2",66320915,66320992,77
"15879","ENSMODG00000021796","2",1475235,1475317,82
"15880","ENSMODG00000021798","6",275142875,275143012,137
"15881","ENSMODG00000021800","2",9660787,9660858,71
"15882","ENSMODG00000021802","1",274099064,274099170,106
"15883","ENSMODG00000021804","4",104806934,104807124,190
"15884","ENSMODG00000021810","Un",67405782,67405937,155
"15885","ENSMODG00000021817","4",104995998,104996161,163
"15886","ENSMODG00000021823","1",497118098,497118203,105
"15887","ENSMODG00000021825","2",334282944,334283050,106
"15888","ENSMODG00000021831","1",207103658,207103759,101
"15889","ENSMODG00000021832","1",452988890,452989021,131
"15890","ENSMODG00000021835","2",209111570,209111679,109
"15891","ENSMODG00000021838","1",90064438,90064570,132
"15892","ENSMODG00000021843","2",508394748,508394881,133
"15893","ENSMODG00000021851","2",9613367,9613482,115
"15894","ENSMODG00000021854","2",342123003,342123074,71
"15895","ENSMODG00000021856","3",218137804,218137865,61
"15896","ENSMODG00000021859","4",265460499,265460635,136
"15897","ENSMODG00000021862","6",93915018,93915124,106
"15898","ENSMODG00000021863","1",460618347,460618419,72
"15899","ENSMODG00000021865","2",12696092,12696198,106
"15900","ENSMODG00000021866","2",66317749,66317829,80
"15901","ENSMODG00000021868","4",104846407,104846597,190
"15902","ENSMODG00000021881","4",343177035,343177181,146
"15903","ENSMODG00000021887","4",333012714,333012820,106
"15904","ENSMODG00000021889","3",69314625,69314691,66
"15905","ENSMODG00000021891","8",213216473,213216574,101
"15906","ENSMODG00000021893","4",105053867,105054030,163
"15907","ENSMODG00000021897","3",69314265,69314330,65
"15908","ENSMODG00000021917","4",367695231,367695430,199
"15909","ENSMODG00000021922","6",123328888,123328994,106
"15910","ENSMODG00000021926","3",312134492,312134594,102
"15911","ENSMODG00000021943","4",265462309,265462430,121
"15912","ENSMODG00000021948","1",68321081,68321187,106
"15913","ENSMODG00000021953","2",134581757,134581862,105
"15914","ENSMODG00000021967","4",428160919,428161025,106
"15915","ENSMODG00000021968","4",104748481,104748644,163
"15916","ENSMODG00000021970","3",263891910,263892016,106
"15917","ENSMODG00000021972","3",457888239,457888345,106
"15918","ENSMODG00000021974","5",228712667,228712768,101
"15919","ENSMODG00000021977","1",709417880,709418015,135
"15920","ENSMODG00000021979","2",9725726,9725842,116
"15921","ENSMODG00000021990","6",86692972,86693078,106
"15922","ENSMODG00000021993","8",266356375,266356529,154
"15923","ENSMODG00000021994","7",206770493,206770623,130
"15924","ENSMODG00000021998","2",520355674,520355747,73
"15925","ENSMODG00000021999","4",104785608,104785771,163
"15926","ENSMODG00000022006","3",458220823,458220929,106
"15927","ENSMODG00000022009","3",393393648,393393797,149
"15928","ENSMODG00000022012","1",114348121,114348227,106
"15929","ENSMODG00000022014","2",1474106,1474188,82
"15930","ENSMODG00000022017","4",225035369,225035465,96
"15931","ENSMODG00000022020","X",12210709,12210815,106
"15932","ENSMODG00000022027","4",177887686,177887798,112
"15933","ENSMODG00000022037","2",267618889,267618964,75
"15934","ENSMODG00000022038","4",225034551,225034639,88
"15935","ENSMODG00000022044","4",104989108,104989298,190
"15936","ENSMODG00000022054","7",167879072,167879178,106
"15937","ENSMODG00000022055","2",407252572,407252698,126
"15938","ENSMODG00000022062","6",82968530,82968712,182
"15939","ENSMODG00000022064","5",300774586,300774654,68
"15940","ENSMODG00000022071","2",173835845,173836060,215
"15941","ENSMODG00000022072","5",237929510,237929580,70
"15942","ENSMODG00000022092","4",299869130,299869237,107
"15943","ENSMODG00000022094","2",439384186,439384485,299
"15944","ENSMODG00000022095","5",249240927,249241010,83
"15945","ENSMODG00000022099","1",170008050,170008159,109
"15946","ENSMODG00000022102","4",104945503,104945666,163
"15947","ENSMODG00000022109","4",105050527,105050717,190
"15948","ENSMODG00000022118","4",130235307,130235413,106
"15949","ENSMODG00000022123","5",11269627,11269757,130
"15950","ENSMODG00000022126","4",343174163,343174307,144
"15951","ENSMODG00000022127","Un",30346281,30346353,72
"15952","ENSMODG00000022141","1",5683216,5683322,106
"15953","ENSMODG00000022142","3",328594287,328594404,117
"15954","ENSMODG00000022148","3",447749816,447749952,136
"15955","ENSMODG00000022155","2",127283526,127283645,119
"15956","ENSMODG00000022160","4",367696285,367696484,199
"15957","ENSMODG00000022164","6",200043231,200043337,106
"15958","ENSMODG00000022166","2",479018955,479019333,378
"15959","ENSMODG00000022169","7",168851080,168851181,101
"15960","ENSMODG00000022178","4",229852375,229852479,104
"15961","ENSMODG00000022179","3",431748573,431748683,110
"15962","ENSMODG00000022182","3",196653337,196653440,103
"15963","ENSMODG00000022185","2",9661318,9661390,72
"15964","ENSMODG00000022190","4",13516036,13516142,106
"15965","ENSMODG00000022200","8",290276560,290276677,117
"15966","ENSMODG00000022203","3",218134085,218134147,62
"15967","ENSMODG00000022211","2",190024348,190024448,100
"15968","ENSMODG00000022215","2",211816967,211817039,72
"15969","ENSMODG00000022223","4",167559036,167559156,120
"15970","ENSMODG00000022224","3",362563568,362563701,133
"15971","ENSMODG00000022226","2",506650228,506650296,68
"15972","ENSMODG00000022240","4",225035917,225036009,92
"15973","ENSMODG00000022245","2",173833662,173833877,215
"15974","ENSMODG00000022247","2",226837945,226838136,191
"15975","ENSMODG00000022249","1",90067354,90067484,130
"15976","ENSMODG00000022250","1",83329015,83329133,118
"15977","ENSMODG00000022259","3",146991419,146991518,99
"15978","ENSMODG00000022268","8",266358896,266359051,155
"15979","ENSMODG00000022270","7",63641539,63641642,103
"15980","ENSMODG00000022272","4",104807708,104807871,163
"15981","ENSMODG00000022274","4",104890242,104890405,163
"15982","ENSMODG00000022278","8",213233339,213233451,112
"15983","ENSMODG00000022294","X",3927450,3927578,128
"15984","ENSMODG00000022325","1",656676896,656677002,106
"15985","ENSMODG00000022328","3",154267111,154267211,100
"15986","ENSMODG00000022330","5",57330988,57331106,118
"15987","ENSMODG00000022341","2",342122627,342122698,71
"15988","ENSMODG00000022344","4",265461739,265461810,71
"15989","ENSMODG00000022349","5",245204583,245204701,118
"15990","ENSMODG00000022359","2",126222649,126222752,103
"15991","ENSMODG00000022361","1",472724184,472724302,118
"15992","ENSMODG00000022364","2",64374155,64374262,107
"15993","ENSMODG00000022371","1",699870957,699871026,69
"15994","ENSMODG00000022374","1",587846264,587846348,84
"15995","ENSMODG00000022379","4",241888499,241888578,79
"15996","ENSMODG00000022382","6",201968551,201968635,84
"15997","ENSMODG00000022384","8",297346795,297346880,85
"15998","ENSMODG00000022387","1",727148312,727148395,83
"15999","ENSMODG00000022390","3",87606200,87606280,80
"16000","ENSMODG00000022392","6",127713720,127713796,76
"16001","ENSMODG00000022393","4",17427280,17427353,73
"16002","ENSMODG00000022395","2",463982402,463982474,72
"16003","ENSMODG00000022396","1",454138610,454138700,90
"16004","ENSMODG00000022399","2",111348471,111348570,99
"16005","ENSMODG00000022403","5",208287227,208287335,108
"16006","ENSMODG00000022409","1",81981106,81981189,83
"16007","ENSMODG00000022410","6",17696090,17696186,96
"16008","ENSMODG00000022414","3",247368064,247368137,73
"16009","ENSMODG00000022415","1",476650600,476650701,101
"16010","ENSMODG00000022420","3",263368065,263368151,86
"16011","ENSMODG00000022422","6",277022689,277022776,87
"16012","ENSMODG00000022424","3",414610848,414610928,80
"16013","ENSMODG00000022425","2",20448567,20448634,67
"16014","ENSMODG00000022426","4",433575257,433575367,110
"16015","ENSMODG00000022434","3",215711846,215711932,86
"16016","ENSMODG00000022436","6",290241098,290241181,83
"16017","ENSMODG00000022440","6",17696508,17696564,56
"16018","ENSMODG00000022444","2",257690280,257690362,82
"16019","ENSMODG00000022446","2",517586549,517586614,65
"16020","ENSMODG00000022452","6",256412444,256412530,86
"16021","ENSMODG00000022453","1",447811941,447812023,82
"16022","ENSMODG00000022458","4",241889186,241889269,83
"16023","ENSMODG00000022461","8",74872640,74872739,99
"16024","ENSMODG00000022464","2",172169920,172169993,73
"16025","ENSMODG00000022465","1",474834580,474834647,67
"16026","ENSMODG00000022467","4",187496024,187496134,110
"16027","ENSMODG00000022469","X",35202828,35202933,105
"16028","ENSMODG00000022471","1",453998859,453998947,88
"16029","ENSMODG00000022472","1",464882831,464882899,68
"16030","ENSMODG00000022474","4",1003541,1003622,81
"16031","ENSMODG00000022475","6",256413193,256413284,91
"16032","ENSMODG00000022479","2",99872867,99872953,86
"16033","ENSMODG00000022480","8",22252146,22252230,84
"16034","ENSMODG00000022481","3",446525826,446525898,72
"16035","ENSMODG00000022482","4",225033385,225033475,90
"16036","ENSMODG00000022487","4",84783855,84783961,106
"16037","ENSMODG00000022503","Un",101828189,101828575,386
"16038","ENSMODG00000022505","Un",101172451,101173767,1316
"16039","ENSMODG00000022511","Un",99462300,99463274,974
"16040","ENSMODG00000022514","Un",98725764,98726816,1052
"16041","ENSMODG00000022518","Un",98151149,98156061,4912
"16042","ENSMODG00000022528","Un",95905995,95906582,587
"16043","ENSMODG00000022536","Un",92893042,92893890,848
"16044","ENSMODG00000022537","Un",92553547,92555542,1995
"16045","ENSMODG00000022543","Un",91933284,91933436,152
"16046","ENSMODG00000022545","Un",91111994,91112134,140
"16047","ENSMODG00000022546","Un",91110786,91110921,135
"16048","ENSMODG00000022558","Un",87082106,87082273,167
"16049","ENSMODG00000022559","Un",86857688,86860171,2483
"16050","ENSMODG00000022560","Un",86717969,86718163,194
"16051","ENSMODG00000022567","Un",83558777,83559784,1007
"16052","ENSMODG00000022568","Un",83484465,83485427,962
"16053","ENSMODG00000022569","Un",83381319,83382463,1144
"16054","ENSMODG00000022579","Un",80520974,80522380,1406
"16055","ENSMODG00000022581","Un",79397185,79397732,547
"16056","ENSMODG00000022582","Un",79101013,79104780,3767
"16057","ENSMODG00000022587","Un",77456472,77458118,1646
"16058","ENSMODG00000022588","Un",76975781,76976746,965
"16059","ENSMODG00000022589","Un",76532130,76533182,1052
"16060","ENSMODG00000022593","Un",74966830,74972999,6169
"16061","ENSMODG00000022594","Un",74769540,74770443,903
"16062","ENSMODG00000022596","Un",74373244,74376116,2872
"16063","ENSMODG00000022598","Un",73835007,73835773,766
"16064","ENSMODG00000022599","Un",73657860,73659014,1154
"16065","ENSMODG00000022601","Un",73324258,73324646,388
"16066","ENSMODG00000022604","Un",73160528,73161706,1178
"16067","ENSMODG00000022606","Un",72127418,72127570,152
"16068","ENSMODG00000022611","Un",70981784,70981936,152
"16069","ENSMODG00000022616","Un",69521257,69522387,1130
"16070","ENSMODG00000022617","Un",69073593,69074626,1033
"16071","ENSMODG00000022623","Un",68117912,68118064,152
"16072","ENSMODG00000022637","Un",66603656,66604726,1070
"16073","ENSMODG00000022639","Un",66330748,66335068,4320
"16074","ENSMODG00000022642","Un",65903634,65904545,911
"16075","ENSMODG00000022645","Un",65323211,65324428,1217
"16076","ENSMODG00000022646","Un",65082128,65082613,485
"16077","ENSMODG00000022647","Un",64851865,64853616,1751
"16078","ENSMODG00000022648","Un",64396353,64406630,10277
"16079","ENSMODG00000022650","Un",63152255,63153652,1397
"16080","ENSMODG00000022654","Un",62430835,62448654,17819
"16081","ENSMODG00000022657","Un",61412222,61413175,953
"16082","ENSMODG00000022666","Un",59400787,59409797,9010
"16083","ENSMODG00000022667","Un",59027487,59038404,10917
"16084","ENSMODG00000022671","Un",58328215,58346103,17888
"16085","ENSMODG00000022672","Un",58258843,58260123,1280
"16086","ENSMODG00000022682","Un",55924554,55929628,5074
"16087","ENSMODG00000022692","Un",53620954,53622096,1142
"16088","ENSMODG00000022693","Un",53395001,53428189,33188
"16089","ENSMODG00000022694","Un",53298384,53298877,493
"16090","ENSMODG00000022695","Un",53120805,53121599,794
"16091","ENSMODG00000022696","Un",53118090,53119829,1739
"16092","ENSMODG00000022697","Un",52686329,52707703,21374
"16093","ENSMODG00000022700","Un",52402209,52402905,696
"16094","ENSMODG00000022701","Un",51701771,51717333,15562
"16095","ENSMODG00000022703","Un",50683898,50690903,7005
"16096","ENSMODG00000022704","Un",50656506,50661167,4661
"16097","ENSMODG00000022705","Un",50633512,50634305,793
"16098","ENSMODG00000022706","Un",50577336,50621203,43867
"16099","ENSMODG00000022707","Un",50142862,50154186,11324
"16100","ENSMODG00000022720","Un",49249264,49250299,1035
"16101","ENSMODG00000022721","Un",49216362,49217327,965
"16102","ENSMODG00000022722","Un",48583753,48584172,419
"16103","ENSMODG00000022723","Un",48319077,48320365,1288
"16104","ENSMODG00000022724","Un",48318992,48320353,1361
"16105","ENSMODG00000022725","Un",47428604,47440878,12274
"16106","ENSMODG00000022734","Un",44140398,44140886,488
"16107","ENSMODG00000022736","Un",43370094,43404580,34486
"16108","ENSMODG00000022737","Un",43298894,43299450,556
"16109","ENSMODG00000022738","Un",42777606,42828687,51081
"16110","ENSMODG00000022739","Un",42574476,42574878,402
"16111","ENSMODG00000022740","Un",41477616,41494299,16683
"16112","ENSMODG00000022741","Un",41439657,41458987,19330
"16113","ENSMODG00000022744","Un",40343376,40344783,1407
"16114","ENSMODG00000022754","Un",83278669,83279710,1041
"16115","ENSMODG00000022759","Un",36901929,36904073,2144
"16116","ENSMODG00000022760","Un",36894110,36895228,1118
"16117","ENSMODG00000022774","Un",35853343,35853970,627
"16118","ENSMODG00000022776","Un",33088283,33324278,235995
"16119","ENSMODG00000022777","Un",32661188,32661691,503
"16120","ENSMODG00000022780","Un",31032263,31033278,1015
"16121","ENSMODG00000022783","Un",30656377,30657652,1275
"16122","ENSMODG00000022784","Un",30327277,30332289,5012
"16123","ENSMODG00000022785","Un",30189979,30191050,1071
"16124","ENSMODG00000022786","Un",28382109,28382465,356
"16125","ENSMODG00000022787","Un",27291086,27333713,42627
"16126","ENSMODG00000022790","Un",26900104,26928712,28608
"16127","ENSMODG00000022791","Un",26520323,26520559,236
"16128","ENSMODG00000022792","Un",25089042,25102558,13516
"16129","ENSMODG00000022793","Un",24979210,24986437,7227
"16130","ENSMODG00000022794","Un",24912628,24930200,17572
"16131","ENSMODG00000022795","Un",24748100,24759126,11026
"16132","ENSMODG00000022796","Un",24236162,24237136,974
"16133","ENSMODG00000022797","Un",23989576,23990181,605
"16134","ENSMODG00000022798","Un",23882937,23883707,770
"16135","ENSMODG00000022799","Un",23021245,23069567,48322
"16136","ENSMODG00000022800","Un",22449061,22452399,3338
"16137","ENSMODG00000022805","Un",20939342,21099727,160385
"16138","ENSMODG00000022806","Un",19004540,19006090,1550
"16139","ENSMODG00000022807","Un",18462160,18485064,22904
"16140","ENSMODG00000022808","Un",17898844,17901104,2260
"16141","ENSMODG00000022818","Un",16918807,16923637,4830
"16142","ENSMODG00000022820","Un",16593547,16620816,27269
"16143","ENSMODG00000022821","Un",16561761,16563014,1253
"16144","ENSMODG00000022822","Un",16085009,16150909,65900
"16145","ENSMODG00000022823","Un",15863145,15864573,1428
"16146","ENSMODG00000022824","Un",15558021,15566599,8578
"16147","ENSMODG00000022825","Un",15063086,15129643,66557
"16148","ENSMODG00000022826","Un",10741616,10775420,33804
"16149","ENSMODG00000022827","Un",9690577,9708734,18157
"16150","ENSMODG00000022828","Un",9636772,9644041,7269
"16151","ENSMODG00000022829","Un",9539982,9550733,10751
"16152","ENSMODG00000022830","Un",9502265,9526049,23784
"16153","ENSMODG00000022831","Un",9346176,9500052,153876
"16154","ENSMODG00000022832","Un",9292150,9311472,19322
"16155","ENSMODG00000022833","Un",9246779,9253600,6821
"16156","ENSMODG00000022834","Un",9212806,9213258,452
"16157","ENSMODG00000022835","Un",8453745,8470407,16662
"16158","ENSMODG00000022836","Un",8196128,8196504,376
"16159","ENSMODG00000022837","Un",8188660,8191931,3271
"16160","ENSMODG00000022838","Un",8288068,8293931,5863
"16161","ENSMODG00000022839","Un",7595889,7598320,2431
"16162","ENSMODG00000022840","Un",6365363,6369017,3654
"16163","ENSMODG00000022841","Un",5808290,5870502,62212
"16164","ENSMODG00000022842","Un",4361513,4401127,39614
"16165","ENSMODG00000022843","Un",4169406,4204771,35365
"16166","ENSMODG00000022844","X",12338801,12340139,1338
"16167","ENSMODG00000022846","X",72472185,72474299,2114
"16168","ENSMODG00000022847","X",10978141,10979598,1457
"16169","ENSMODG00000022848","X",10886315,10887040,725
"16170","ENSMODG00000022849","X",10738312,10739430,1118
"16171","ENSMODG00000022854","3",459990491,460005901,15410
"16172","ENSMODG00000022855","3",458751907,458938973,187066
"16173","ENSMODG00000022856","3",458663711,458664865,1154
"16174","ENSMODG00000022857","3",458322209,458322712,503
"16175","ENSMODG00000022858","Un",777017,782261,5244
"16176","ENSMODG00000022859","Un",259557,260450,893
"16177","ENSMODG00000022860","Un",231287,232210,923
"16178","ENSMODG00000022861","X",58888719,58910557,21838
"16179","ENSMODG00000022862","X",58865234,58866142,908
"16180","ENSMODG00000022863","X",57107815,57108936,1121
"16181","ENSMODG00000022865","X",56979376,56980401,1025
"16182","ENSMODG00000022866","X",56844517,56845581,1064
"16183","ENSMODG00000022867","X",56799419,56799841,422
"16184","ENSMODG00000022868","4",354225199,354226176,977
"16185","ENSMODG00000022875","4",353919081,353920028,947
"16186","ENSMODG00000022885","4",353630694,353631659,965
"16187","ENSMODG00000022886","4",353619502,353620687,1185
"16188","ENSMODG00000022890","4",353388300,353620275,231975
"16189","ENSMODG00000022894","4",353262646,353263623,977
"16190","ENSMODG00000022895","4",353147378,353148298,920
"16191","ENSMODG00000022902","4",352789323,352936398,147075
"16192","ENSMODG00000022903","4",352752150,352753915,1765
"16193","ENSMODG00000022913","4",352280102,352281043,941
"16194","ENSMODG00000022917","4",352154414,352155085,671
"16195","ENSMODG00000022918","4",352148073,352149017,944
"16196","ENSMODG00000022919","4",352096133,352097086,953
"16197","ENSMODG00000022921","4",351999319,352000272,953
"16198","ENSMODG00000022925","4",351499382,351500326,944
"16199","ENSMODG00000022930","4",351243187,351244134,947
"16200","ENSMODG00000022936","4",351118989,351119927,938
"16201","ENSMODG00000022940","4",351009274,351010224,950
"16202","ENSMODG00000022941","4",350994846,351023974,29128
"16203","ENSMODG00000022944","4",350869635,350870591,956
"16204","ENSMODG00000022945","4",350818611,350819558,947
"16205","ENSMODG00000022947","X",52846147,52846638,491
"16206","ENSMODG00000022948","6",157616877,157618220,1343
"16207","ENSMODG00000022949","6",158472276,158472929,653
"16208","ENSMODG00000022950","6",158670306,158679896,9590
"16209","ENSMODG00000022951","6",159010200,159015102,4902
"16210","ENSMODG00000022952","6",160608962,160672997,64035
"16211","ENSMODG00000022953","6",166406217,166407137,920
"16212","ENSMODG00000022954","6",168075210,168075551,341
"16213","ENSMODG00000022955","6",169041455,169041914,459
"16214","ENSMODG00000022957","6",184167068,184167391,323
"16215","ENSMODG00000022958","6",189034281,189034712,431
"16216","ENSMODG00000022960","6",193088666,193089085,419
"16217","ENSMODG00000022961","6",193180536,193181735,1199
"16218","ENSMODG00000022962","6",196709700,196751432,41732
"16219","ENSMODG00000022963","6",198356668,198357645,977
"16220","ENSMODG00000022964","6",200232362,200233888,1526
"16221","ENSMODG00000022965","6",200781452,200822367,40915
"16222","ENSMODG00000022966","6",202004173,202007023,2850
"16223","ENSMODG00000022967","6",202234900,202236024,1124
"16224","ENSMODG00000022968","6",202605519,202631726,26207
"16225","ENSMODG00000022969","6",203334509,203336008,1499
"16226","ENSMODG00000022970","6",203596045,203597109,1064
"16227","ENSMODG00000022971","6",204355788,204356832,1044
"16228","ENSMODG00000022975","1",203612030,203612111,81
"16229","ENSMODG00000022982","5",249188880,249189062,182
"16230","ENSMODG00000022983","5",249187964,249188146,182
"16231","ENSMODG00000022984","7",242919043,242919133,90
"16232","ENSMODG00000022985","7",219817643,219817748,105
"16233","ENSMODG00000022995","2",376588206,376588312,106
"16234","ENSMODG00000023007","2",173739347,173739562,215
"16235","ENSMODG00000023016","4",105043908,105044071,163
"16236","ENSMODG00000023017","4",105039585,105039748,163
"16237","ENSMODG00000023018","4",104976592,104976782,190
"16238","ENSMODG00000023019","4",104968822,104969012,190
"16239","ENSMODG00000023020","4",104936022,104936185,163
"16240","ENSMODG00000023021","3",69315863,69315929,66
"16241","ENSMODG00000023022","3",69315318,69315384,66
"16242","ENSMODG00000023023","2",9609916,9610031,115
"16243","ENSMODG00000023024","2",9609300,9609415,115
"16244","ENSMODG00000023025","1",746311753,746316101,4348
"16245","ENSMODG00000023026","1",746265215,746266189,974
"16246","ENSMODG00000023027","1",746205874,746211807,5933
"16247","ENSMODG00000023028","1",746099944,746142710,42766
"16248","ENSMODG00000023029","1",746047916,746056659,8743
"16249","ENSMODG00000023030","1",745654881,745682828,27947
"16250","ENSMODG00000023031","1",745583264,745588149,4885
"16251","ENSMODG00000023032","1",745353523,745360836,7313
"16252","ENSMODG00000023033","1",745406873,745415210,8337
"16253","ENSMODG00000023034","1",740258036,740258704,668
"16254","ENSMODG00000023035","1",739960170,739960841,671
"16255","ENSMODG00000023036","1",724593223,724594800,1577
"16256","ENSMODG00000023037","1",718257732,718314318,56586
"16257","ENSMODG00000023038","1",718189042,718197982,8940
"16258","ENSMODG00000023039","1",715768009,715768616,607
"16259","ENSMODG00000023040","1",715754024,715754608,584
"16260","ENSMODG00000023041","1",715687704,715688312,608
"16261","ENSMODG00000023043","1",715611676,715612226,550
"16262","ENSMODG00000023044","1",715510562,715511127,565
"16263","ENSMODG00000023047","1",715338304,715379022,40718
"16264","ENSMODG00000023048","1",715088939,715094838,5899
"16265","ENSMODG00000023049","1",714937039,714951215,14176
"16266","ENSMODG00000023050","1",714345278,714352592,7314
"16267","ENSMODG00000023051","1",714292696,714293219,523
"16268","ENSMODG00000023052","1",714128911,714196634,67723
"16269","ENSMODG00000023053","1",713944545,713951621,7076
"16270","ENSMODG00000023054","1",713764993,713865756,100763
"16271","ENSMODG00000023055","1",713592925,713668691,75766
"16272","ENSMODG00000023056","1",713340479,713388331,47852
"16273","ENSMODG00000023057","1",713287528,713295224,7696
"16274","ENSMODG00000023058","1",713196186,713611821,415635
"16275","ENSMODG00000023059","1",713140437,713141114,677
"16276","ENSMODG00000023060","1",713134176,713134850,674
"16277","ENSMODG00000023061","1",712388602,712689562,300960
"16278","ENSMODG00000023062","1",711120830,711123434,2604
"16279","ENSMODG00000023064","1",710149633,710161966,12333
"16280","ENSMODG00000023065","1",710110865,710112352,1487
"16281","ENSMODG00000023066","1",708733722,708748102,14380
"16282","ENSMODG00000023067","1",708684263,708707424,23161
"16283","ENSMODG00000023068","1",705429402,705434596,5194
"16284","ENSMODG00000023070","1",658699599,658700525,926
"16285","ENSMODG00000023071","1",659159720,659160511,791
"16286","ENSMODG00000023072","1",661737118,661738023,905
"16287","ENSMODG00000023073","1",661902214,661902765,551
"16288","ENSMODG00000023074","1",664227268,664253246,25978
"16289","ENSMODG00000023075","1",668458938,668459396,458
"16290","ENSMODG00000023076","1",669175597,669176244,647
"16291","ENSMODG00000023077","1",669264751,669265680,929
"16292","ENSMODG00000023080","1",669623450,669624400,950
"16293","ENSMODG00000023083","1",671081540,671083599,2059
"16294","ENSMODG00000023084","1",683679664,683683197,3533
"16295","ENSMODG00000023085","1",684326389,684327576,1187
"16296","ENSMODG00000023086","1",684902051,684903085,1034
"16297","ENSMODG00000023087","1",689813987,689814214,227
"16298","ENSMODG00000023088","1",694999748,695002174,2426
"16299","ENSMODG00000023090","2",540314551,540314911,360
"16300","ENSMODG00000023091","2",539663495,539675640,12145
"16301","ENSMODG00000023092","1",698314962,698334048,19086
"16302","ENSMODG00000023093","2",539589690,539737288,147598
"16303","ENSMODG00000023094","1",698645070,698687766,42696
"16304","ENSMODG00000023095","2",539417876,539461339,43463
"16305","ENSMODG00000023096","2",539264581,539674219,409638
"16306","ENSMODG00000023098","1",703523979,703525127,1148
"16307","ENSMODG00000023099","2",538668295,538678412,10117
"16308","ENSMODG00000023100","1",703644693,703645841,1148
"16309","ENSMODG00000023101","2",538590131,538598526,8395
"16310","ENSMODG00000023102","2",538198109,538264001,65892
"16311","ENSMODG00000023103","1",652466860,652467207,347
"16312","ENSMODG00000023104","1",651022908,651024527,1619
"16313","ENSMODG00000023105","1",649712262,649712783,521
"16314","ENSMODG00000023106","1",645113587,645114357,770
"16315","ENSMODG00000023107","1",641096426,641098039,1613
"16316","ENSMODG00000023108","2",535722855,535723943,1088
"16317","ENSMODG00000023112","2",533258257,533258835,578
"16318","ENSMODG00000023113","2",532431371,532433991,2620
"16319","ENSMODG00000023114","2",532186072,532290326,104254
"16320","ENSMODG00000023115","1",636735744,636736220,476
"16321","ENSMODG00000023116","2",532113153,532123865,10712
"16322","ENSMODG00000023117","2",532076152,532092502,16350
"16323","ENSMODG00000023119","1",631255939,631256595,656
"16324","ENSMODG00000023120","2",530486788,530638906,152118
"16325","ENSMODG00000023121","2",530435193,530435998,805
"16326","ENSMODG00000023124","2",530148116,530148775,659
"16327","ENSMODG00000023125","1",630157031,630158221,1190
"16328","ENSMODG00000023126","1",627370041,627370976,935
"16329","ENSMODG00000023127","2",528555405,528562559,7154
"16330","ENSMODG00000023128","1",622442123,622443518,1395
"16331","ENSMODG00000023129","1",621214145,621214852,707
"16332","ENSMODG00000023131","2",525487505,525770716,283211
"16333","ENSMODG00000023132","2",524608595,524912577,303982
"16334","ENSMODG00000023133","1",614086451,614086838,387
"16335","ENSMODG00000023134","1",610710109,610710489,380
"16336","ENSMODG00000023136","1",604520353,604521570,1217
"16337","ENSMODG00000023137","1",603989545,603990030,485
"16338","ENSMODG00000023138","1",598184727,598185914,1187
"16339","ENSMODG00000023139","1",598165412,598167088,1676
"16340","ENSMODG00000023140","2",522368770,522387500,18730
"16341","ENSMODG00000023141","2",522187405,522418094,230689
"16342","ENSMODG00000023142","2",522163627,522188295,24668
"16343","ENSMODG00000023143","2",522020193,522297007,276814
"16344","ENSMODG00000023144","1",594141677,594145181,3504
"16345","ENSMODG00000023145","1",591205644,591230015,24371
"16346","ENSMODG00000023146","1",591094993,591134137,39144
"16347","ENSMODG00000023147","1",591065787,591074126,8339
"16348","ENSMODG00000023148","2",521865436,521879675,14239
"16349","ENSMODG00000023149","2",521805003,521817486,12483
"16350","ENSMODG00000023150","2",521526472,521527986,1514
"16351","ENSMODG00000023152","2",520443801,520444809,1008
"16352","ENSMODG00000023153","2",519743073,519794383,51310
"16353","ENSMODG00000023154","1",588271637,588275016,3379
"16354","ENSMODG00000023160","1",585454779,585471963,17184
"16355","ENSMODG00000023161","1",585454779,585471963,17184
"16356","ENSMODG00000023162","1",584798631,584799838,1207
"16357","ENSMODG00000023163","2",518577292,518592332,15040
"16358","ENSMODG00000023164","2",518227838,518228587,749
"16359","ENSMODG00000023165","1",584501176,584501526,350
"16360","ENSMODG00000023167","1",581322899,581330884,7985
"16361","ENSMODG00000023169","1",580319434,580367190,47756
"16362","ENSMODG00000023170","2",516081932,516090198,8266
"16363","ENSMODG00000023171","2",516078302,516078565,263
"16364","ENSMODG00000023172","2",515144389,515144838,449
"16365","ENSMODG00000023173","2",515113267,515144838,31571
"16366","ENSMODG00000023174","2",515113265,515113714,449
"16367","ENSMODG00000023175","2",511528939,511529151,212
"16368","ENSMODG00000023176","1",575023176,575023496,320
"16369","ENSMODG00000023177","2",509528347,509528487,140
"16370","ENSMODG00000023178","1",573755447,573756577,1130
"16371","ENSMODG00000023179","2",508358737,508359045,308
"16372","ENSMODG00000023181","2",507882102,507899753,17651
"16373","ENSMODG00000023182","2",507091849,507092460,611
"16374","ENSMODG00000023183","2",506691030,506703756,12726
"16375","ENSMODG00000023184","1",567174022,567174726,704
"16376","ENSMODG00000023187","1",562960190,562960726,536
"16377","ENSMODG00000023188","2",505716021,505724503,8482
"16378","ENSMODG00000023189","2",505481305,505499653,18348
"16379","ENSMODG00000023190","1",561268631,561269308,677
"16380","ENSMODG00000023191","1",557071639,557071875,236
"16381","ENSMODG00000023192","1",556740100,556741290,1190
"16382","ENSMODG00000023193","2",503306255,503307175,920
"16383","ENSMODG00000023195","1",550921060,550921911,851
"16384","ENSMODG00000023196","1",539314828,539315115,287
"16385","ENSMODG00000023198","2",498915065,498916624,1559
"16386","ENSMODG00000023199","2",498322721,498497121,174400
"16387","ENSMODG00000023202","2",498099102,498100226,1124
"16388","ENSMODG00000023205","1",524278307,524279176,869
"16389","ENSMODG00000023206","2",496357861,496358415,554
"16390","ENSMODG00000023207","2",496269737,496270012,275
"16391","ENSMODG00000023211","1",513293391,513293720,329
"16392","ENSMODG00000023212","1",511736380,511736583,203
"16393","ENSMODG00000023213","2",494848178,494921787,73609
"16394","ENSMODG00000023214","2",494709416,494856822,147406
"16395","ENSMODG00000023215","2",494698051,494848544,150493
"16396","ENSMODG00000023216","2",494403721,494405211,1490
"16397","ENSMODG00000023217","1",508970902,508971726,824
"16398","ENSMODG00000023224","2",493197216,493198982,1766
"16399","ENSMODG00000023225","1",508596337,508596729,392
"16400","ENSMODG00000023227","2",489750703,489751896,1193
"16401","ENSMODG00000023228","2",487236376,487236783,407
"16402","ENSMODG00000023229","2",486913831,486951976,38145
"16403","ENSMODG00000023230","1",504952945,504953175,230
"16404","ENSMODG00000023231","1",503052784,503178834,126050
"16405","ENSMODG00000023233","2",481646925,481662379,15454
"16406","ENSMODG00000023234","1",502240098,502240562,464
"16407","ENSMODG00000023235","2",481262962,481272081,9119
"16408","ENSMODG00000023236","2",480916902,481393629,476727
"16409","ENSMODG00000023237","1",501323125,501341336,18211
"16410","ENSMODG00000023238","2",480480195,480481926,1731
"16411","ENSMODG00000023239","2",480349404,480350903,1499
"16412","ENSMODG00000023240","2",480171926,480173464,1538
"16413","ENSMODG00000023241","2",479961490,479974288,12798
"16414","ENSMODG00000023242","2",479023681,479024521,840
"16415","ENSMODG00000023243","2",478583089,478584570,1481
"16416","ENSMODG00000023246","1",494694991,494696361,1370
"16417","ENSMODG00000023247","2",468285495,468286030,535
"16418","ENSMODG00000023248","2",468126756,468127901,1145
"16419","ENSMODG00000023249","2",467355075,467356238,1163
"16420","ENSMODG00000023252","1",487741414,487743240,1826
"16421","ENSMODG00000023253","1",486598659,486612065,13406
"16422","ENSMODG00000023254","1",484981376,484994332,12956
"16423","ENSMODG00000023255","1",484885944,484894227,8283
"16424","ENSMODG00000023256","2",462555046,462555576,530
"16425","ENSMODG00000023257","2",462554620,462555024,404
"16426","ENSMODG00000023258","1",484697552,484699414,1862
"16427","ENSMODG00000023259","2",460431586,460445497,13911
"16428","ENSMODG00000023260","1",482665269,482666171,902
"16429","ENSMODG00000023261","1",482655129,482663660,8531
"16430","ENSMODG00000023262","2",458672387,458764930,92543
"16431","ENSMODG00000023263","2",457639766,457640264,498
"16432","ENSMODG00000023264","1",477351095,477393756,42661
"16433","ENSMODG00000023265","1",477286647,477326195,39548
"16434","ENSMODG00000023267","1",475463630,475464301,671
"16435","ENSMODG00000023271","2",450094141,450341261,247120
"16436","ENSMODG00000023272","1",472961034,472962467,1433
"16437","ENSMODG00000023273","2",445500448,446147962,647514
"16438","ENSMODG00000023274","2",444888386,444888625,239
"16439","ENSMODG00000023275","2",442252804,442253745,941
"16440","ENSMODG00000023276","2",441398578,441399048,470
"16441","ENSMODG00000023277","2",439103812,439162878,59066
"16442","ENSMODG00000023278","2",436368018,436368677,659
"16443","ENSMODG00000023279","1",470723198,470723602,404
"16444","ENSMODG00000023281","1",470485328,470485840,512
"16445","ENSMODG00000023282","1",470466790,470467008,218
"16446","ENSMODG00000023283","1",470456823,470457321,498
"16447","ENSMODG00000023284","1",470277346,470277872,526
"16448","ENSMODG00000023285","4",433779315,433797584,18269
"16449","ENSMODG00000023290","2",422443715,422444578,863
"16450","ENSMODG00000023291","2",422310600,422329814,19214
"16451","ENSMODG00000023293","4",429837014,429837958,944
"16452","ENSMODG00000023294","1",467804340,467805410,1070
"16453","ENSMODG00000023297","1",467258647,467261141,2494
"16454","ENSMODG00000023298","2",415502837,415503574,737
"16455","ENSMODG00000023299","1",466579788,466580609,821
"16456","ENSMODG00000023300","4",426913393,426913980,587
"16457","ENSMODG00000023301","4",426848168,426860368,12200
"16458","ENSMODG00000023302","4",426739720,426740211,491
"16459","ENSMODG00000023304","2",414142646,414143899,1253
"16460","ENSMODG00000023305","1",464634420,464643228,8808
"16461","ENSMODG00000023309","4",425597845,425598126,281
"16462","ENSMODG00000023310","4",425540024,425540590,566
"16463","ENSMODG00000023312","2",407115274,407116293,1019
"16464","ENSMODG00000023314","2",406967819,406968859,1040
"16465","ENSMODG00000023316","2",406909541,406910617,1076
"16466","ENSMODG00000023318","2",406861305,406862345,1040
"16467","ENSMODG00000023321","2",403871254,403872765,1511
"16468","ENSMODG00000023323","3",518356519,518364656,8137
"16469","ENSMODG00000023325","2",397790610,397791026,416
"16470","ENSMODG00000023326","4",421153037,421163751,10714
"16471","ENSMODG00000023328","4",419393340,419393711,371
"16472","ENSMODG00000023329","2",387187570,387187725,155
"16473","ENSMODG00000023330","1",455795122,455796749,1627
"16474","ENSMODG00000023331","3",517376836,517674315,297479
"16475","ENSMODG00000023333","3",517205205,517205459,254
"16476","ENSMODG00000023335","4",418807061,418837054,29993
"16477","ENSMODG00000023336","3",527870895,527878629,7734
"16478","ENSMODG00000023337","1",454808263,454810240,1977
"16479","ENSMODG00000023338","2",384652897,384735811,82914
"16480","ENSMODG00000023340","2",384586040,384586891,851
"16481","ENSMODG00000023341","2",384242529,384243858,1329
"16482","ENSMODG00000023342","1",454771073,454820642,49569
"16483","ENSMODG00000023346","2",378848479,378849837,1358
"16484","ENSMODG00000023348","4",417691156,417691434,278
"16485","ENSMODG00000023349","4",417624722,417625543,821
"16486","ENSMODG00000023350","2",377170768,377189116,18348
"16487","ENSMODG00000023352","2",375572719,375573798,1079
"16488","ENSMODG00000023353","1",454114130,454135019,20889
"16489","ENSMODG00000023354","4",415181643,415188923,7280
"16490","ENSMODG00000023355","2",374618232,374625396,7164
"16491","ENSMODG00000023357","2",370964635,371206940,242305
"16492","ENSMODG00000023358","4",414155192,414156175,983
"16493","ENSMODG00000023359","2",370124322,370125749,1427
"16494","ENSMODG00000023360","4",339550805,339551470,665
"16495","ENSMODG00000023361","2",365873598,365907759,34161
"16496","ENSMODG00000023362","3",527305332,527306276,944
"16497","ENSMODG00000023363","2",364537560,364754917,217357
"16498","ENSMODG00000023365","3",527161035,527198345,37310
"16499","ENSMODG00000023366","3",527002112,527012867,10755
"16500","ENSMODG00000023367","3",526956420,526995175,38755
"16501","ENSMODG00000023368","3",526830220,526847732,17512
"16502","ENSMODG00000023369","1",452830272,452834796,4524
"16503","ENSMODG00000023370","1",452777589,452778161,572
"16504","ENSMODG00000023373","1",452709981,452710727,746
"16505","ENSMODG00000023376","3",526728778,526796925,68147
"16506","ENSMODG00000023380","3",526586803,526678544,91741
"16507","ENSMODG00000023381","4",413083488,413087863,4375
"16508","ENSMODG00000023383","3",526514267,526524156,9889
"16509","ENSMODG00000023384","2",356738665,356739791,1126
"16510","ENSMODG00000023385","2",355842992,355844245,1253
"16511","ENSMODG00000023386","3",526281729,526310608,28879
"16512","ENSMODG00000023387","2",348425116,348426039,923
"16513","ENSMODG00000023388","3",526237061,526429747,192686
"16514","ENSMODG00000023389","3",526206077,526207345,1268
"16515","ENSMODG00000023390","3",526045751,526067304,21553
"16516","ENSMODG00000023391","4",412977674,412982371,4697
"16517","ENSMODG00000023392","1",449755401,449755919,518
"16518","ENSMODG00000023393","1",449695512,449696513,1001
"16519","ENSMODG00000023395","3",525678842,525703570,24728
"16520","ENSMODG00000023396","4",412916753,412924545,7792
"16521","ENSMODG00000023397","3",525301485,525356736,55251
"16522","ENSMODG00000023399","3",525055358,525096924,41566
"16523","ENSMODG00000023400","3",524982024,524987518,5494
"16524","ENSMODG00000023403","3",524575061,524724623,149562
"16525","ENSMODG00000023404","3",524512502,524629859,117357
"16526","ENSMODG00000023406","3",524525315,524525811,496
"16527","ENSMODG00000023407","2",346318657,346318900,243
"16528","ENSMODG00000023408","3",524502829,524512986,10157
"16529","ENSMODG00000023409","3",524473795,524474592,797
"16530","ENSMODG00000023410","3",524440965,524441461,496
"16531","ENSMODG00000023411","3",524120249,524165200,44951
"16532","ENSMODG00000023414","3",524385270,524386282,1012
"16533","ENSMODG00000023415","3",524316384,524317062,678
"16534","ENSMODG00000023416","Un",53316637,53317321,684
"16535","ENSMODG00000023417","4",412802715,413168887,366172
"16536","ENSMODG00000023418","3",524283513,524284477,964
"16537","ENSMODG00000023419","3",524148191,524148919,728
"16538","ENSMODG00000023420","3",524138189,524138934,745
"16539","ENSMODG00000023421","3",524251367,524263257,11890
"16540","ENSMODG00000023422","4",412663627,412664732,1105
"16541","ENSMODG00000023423","2",343889018,343890193,1175
"16542","ENSMODG00000023424","2",343816354,343817022,668
"16543","ENSMODG00000023425","1",449476117,449477493,1376
"16544","ENSMODG00000023426","4",412379803,412382286,2483
"16545","ENSMODG00000023428","2",343476976,343477778,802
"16546","ENSMODG00000023429","2",343441992,343443089,1097
"16547","ENSMODG00000023430","4",412217230,412256431,39201
"16548","ENSMODG00000023431","4",411836105,411959441,123336
"16549","ENSMODG00000023432","4",411588506,411601915,13409
"16550","ENSMODG00000023433","4",411420654,411483163,62509
"16551","ENSMODG00000023434","4",411286806,411299084,12278
"16552","ENSMODG00000023435","4",411280877,411303488,22611
"16553","ENSMODG00000023436","3",523666273,523690825,24552
"16554","ENSMODG00000023437","3",523577108,523593422,16314
"16555","ENSMODG00000023439","3",523514783,523533894,19111
"16556","ENSMODG00000023441","4",411234214,411256785,22571
"16557","ENSMODG00000023442","1",446852053,446852712,659
"16558","ENSMODG00000023443","3",523235735,523267984,32249
"16559","ENSMODG00000023444","2",336925396,336927636,2240
"16560","ENSMODG00000023447","3",523012164,523060910,48746
"16561","ENSMODG00000023449","4",411000893,411110140,109247
"16562","ENSMODG00000023450","3",522733398,522741011,7613
"16563","ENSMODG00000023451","4",410784517,410786043,1526
"16564","ENSMODG00000023452","4",410587740,410599107,11367
"16565","ENSMODG00000023453","4",410507273,410518989,11716
"16566","ENSMODG00000023454","4",410496785,410497419,634
"16567","ENSMODG00000023455","4",410275623,410364144,88521
"16568","ENSMODG00000023456","4",410208061,410220847,12786
"16569","ENSMODG00000023457","4",410164934,410190777,25843
"16570","ENSMODG00000023458","4",410069361,410088354,18993
"16571","ENSMODG00000023459","3",522632319,522659263,26944
"16572","ENSMODG00000023460","4",409998689,410024071,25382
"16573","ENSMODG00000023461","2",332658961,332659890,929
"16574","ENSMODG00000023465","3",522058848,522079885,21037
"16575","ENSMODG00000023467","3",521947571,521974030,26459
"16576","ENSMODG00000023469","4",409901594,409924042,22448
"16577","ENSMODG00000023470","2",330545020,330546186,1166
"16578","ENSMODG00000023471","2",330091115,330092021,906
"16579","ENSMODG00000023472","3",521829396,521871164,41768
"16580","ENSMODG00000023473","3",521494848,521645184,150336
"16581","ENSMODG00000023474","4",409651459,409668710,17251
"16582","ENSMODG00000023475","3",521370748,521377224,6476
"16583","ENSMODG00000023477","3",521156491,521157301,810
"16584","ENSMODG00000023478","1",442558345,442558845,500
"16585","ENSMODG00000023482","4",407546981,407548659,1678
"16586","ENSMODG00000023483","4",405311979,405319552,7573
"16587","ENSMODG00000023484","3",521045264,521058764,13500
"16588","ENSMODG00000023485","4",405121752,405178928,57176
"16589","ENSMODG00000023486","1",435444326,435445144,818
"16590","ENSMODG00000023487","1",433284423,433284926,503
"16591","ENSMODG00000023488","1",432299781,432300638,857
"16592","ENSMODG00000023489","2",319014206,319014745,539
"16593","ENSMODG00000023490","1",428155078,428155791,713
"16594","ENSMODG00000023491","4",404878432,405035207,156775
"16595","ENSMODG00000023492","1",427995524,427996377,853
"16596","ENSMODG00000023493","2",307317498,307318477,979
"16597","ENSMODG00000023494","1",427039549,427040001,452
"16598","ENSMODG00000023495","3",514161395,514162513,1118
"16599","ENSMODG00000023498","1",424881367,425081159,199792
"16600","ENSMODG00000023500","1",424728685,424730326,1641
"16601","ENSMODG00000023502","1",424370990,424372204,1214
"16602","ENSMODG00000023503","1",424286415,424287260,845
"16603","ENSMODG00000023505","2",306758353,306763969,5616
"16604","ENSMODG00000023507","3",512577889,512691882,113993
"16605","ENSMODG00000023509","4",404856843,404865037,8194
"16606","ENSMODG00000023510","1",401529563,401573076,43513
"16607","ENSMODG00000023511","4",404738644,404766201,27557
"16608","ENSMODG00000023512","4",404678744,404686290,7546
"16609","ENSMODG00000023513","4",404499875,404525846,25971
"16610","ENSMODG00000023514","1",401793535,401793891,356
"16611","ENSMODG00000023515","1",401793746,401852329,58583
"16612","ENSMODG00000023516","3",512313591,512325160,11569
"16613","ENSMODG00000023517","4",404472799,404492242,19443
"16614","ENSMODG00000023518","2",300900287,300901351,1064
"16615","ENSMODG00000023520","1",403246037,403250789,4752
"16616","ENSMODG00000023521","1",404080984,404094470,13486
"16617","ENSMODG00000023522","2",294351685,294353217,1532
"16618","ENSMODG00000023523","3",511042337,511043718,1381
"16619","ENSMODG00000023524","4",404109246,404208316,99070
"16620","ENSMODG00000023525","4",403952847,403954486,1639
"16621","ENSMODG00000023526","4",403930959,403933143,2184
"16622","ENSMODG00000023527","4",403886402,403888480,2078
"16623","ENSMODG00000023528","3",510558018,510674685,116667
"16624","ENSMODG00000023529","1",408579942,408580412,470
"16625","ENSMODG00000023530","4",403851237,403852169,932
"16626","ENSMODG00000023532","2",289283621,289288070,4449
"16627","ENSMODG00000023534","4",407306810,407307058,248
"16628","ENSMODG00000023535","4",407297310,407298251,941
"16629","ENSMODG00000023537","2",289148526,289148802,276
"16630","ENSMODG00000023538","4",407162758,407163693,935
"16631","ENSMODG00000023540","4",406416825,406418528,1703
"16632","ENSMODG00000023541","4",406171114,406172292,1178
"16633","ENSMODG00000023542","4",406018515,406019549,1034
"16634","ENSMODG00000023543","4",405808093,406000648,192555
"16635","ENSMODG00000023544","4",405879353,405910024,30671
"16636","ENSMODG00000023545","4",405810537,405818056,7519
"16637","ENSMODG00000023547","4",400805309,400807270,1961
"16638","ENSMODG00000023549","3",509036693,509037305,612
"16639","ENSMODG00000023551","1",416806371,416807651,1280
"16640","ENSMODG00000023552","1",416816337,416817695,1358
"16641","ENSMODG00000023553","3",508702465,508703850,1385
"16642","ENSMODG00000023554","4",401337461,401337914,453
"16643","ENSMODG00000023555","4",401365828,401373468,7640
"16644","ENSMODG00000023556","1",418165739,418166890,1151
"16645","ENSMODG00000023558","4",405122277,405160325,38048
"16646","ENSMODG00000023559","4",401589993,401776270,186277
"16647","ENSMODG00000023560","2",287035400,287156579,121179
"16648","ENSMODG00000023561","4",401698636,401836188,137552
"16649","ENSMODG00000023562","4",401855662,401873675,18013
"16650","ENSMODG00000023566","2",250044811,250046439,1628
"16651","ENSMODG00000023570","4",402050501,402072470,21969
"16652","ENSMODG00000023571","1",422442359,422442733,374
"16653","ENSMODG00000023572","3",505071989,505072282,293
"16654","ENSMODG00000023573","4",402290216,402290599,383
"16655","ENSMODG00000023576","4",402675031,402675291,260
"16656","ENSMODG00000023577","2",251200497,251206467,5970
"16657","ENSMODG00000023578","3",504372176,504402709,30533
"16658","ENSMODG00000023579","4",402695647,402770085,74438
"16659","ENSMODG00000023580","2",251239203,251239619,416
"16660","ENSMODG00000023581","2",251239207,251249122,9915
"16661","ENSMODG00000023582","2",251294442,251295026,584
"16662","ENSMODG00000023583","2",251266465,251443205,176740
"16663","ENSMODG00000023584","2",251266459,251443205,176746
"16664","ENSMODG00000023585","2",251390258,251406847,16589
"16665","ENSMODG00000023586","4",402999926,403026680,26754
"16666","ENSMODG00000023587","2",251507981,251509732,1751
"16667","ENSMODG00000023588","2",251293197,251406865,113668
"16668","ENSMODG00000023589","3",504027601,504242793,215192
"16669","ENSMODG00000023590","4",403044436,403059974,15538
"16670","ENSMODG00000023591","2",251513878,251616950,103072
"16671","ENSMODG00000023592","1",423581797,423798271,216474
"16672","ENSMODG00000023594","4",403072854,403088029,15175
"16673","ENSMODG00000023595","3",503895428,503959581,64153
"16674","ENSMODG00000023596","3",503829412,503839676,10264
"16675","ENSMODG00000023597","3",503791221,503993350,202129
"16676","ENSMODG00000023598","4",403111637,403151170,39533
"16677","ENSMODG00000023599","3",503616740,503774102,157362
"16678","ENSMODG00000023601","3",503602861,503609809,6948
"16679","ENSMODG00000023603","4",403360710,403377873,17163
"16680","ENSMODG00000023604","2",253299436,253299974,538
"16681","ENSMODG00000023606","4",403697639,403698571,932
"16682","ENSMODG00000023608","4",403778615,403779535,920
"16683","ENSMODG00000023609","1",398229804,398230064,260
"16684","ENSMODG00000023610","3",503483634,503497754,14120
"16685","ENSMODG00000023611","4",398077244,398078197,953
"16686","ENSMODG00000023612","4",398211601,398233886,22285
"16687","ENSMODG00000023614","3",503228303,503238572,10269
"16688","ENSMODG00000023616","4",398357677,398368745,11068
"16689","ENSMODG00000023618","4",398640862,398653708,12846
"16690","ENSMODG00000023619","4",398673583,398739648,66065
"16691","ENSMODG00000023624","4",398960023,398984415,24392
"16692","ENSMODG00000023625","3",503132515,503133447,932
"16693","ENSMODG00000023626","4",399098666,399099514,848
"16694","ENSMODG00000023628","3",503107106,503125848,18742
"16695","ENSMODG00000023629","4",399260380,399273011,12631
"16696","ENSMODG00000023630","3",503071696,503087868,16172
"16697","ENSMODG00000023631","4",399282000,399297209,15209
"16698","ENSMODG00000023632","3",503010163,503036441,26278
"16699","ENSMODG00000023633","4",399301362,399314032,12670
"16700","ENSMODG00000023634","3",502957325,502983758,26433
"16701","ENSMODG00000023635","4",399324390,399335903,11513
"16702","ENSMODG00000023636","3",502931849,502944565,12716
"16703","ENSMODG00000023638","4",399499930,399522369,22439
"16704","ENSMODG00000023639","3",502608828,502617610,8782
"16705","ENSMODG00000023640","4",399663716,399700754,37038
"16706","ENSMODG00000023641","2",255365870,255366652,782
"16707","ENSMODG00000023642","4",399925468,399936097,10629
"16708","ENSMODG00000023643","3",502305507,502561971,256464
"16709","ENSMODG00000023645","3",502311655,502323901,12246
"16710","ENSMODG00000023646","3",502236181,502237425,1244
"16711","ENSMODG00000023647","3",502010509,502025554,15045
"16712","ENSMODG00000023648","3",501986992,501994568,7576
"16713","ENSMODG00000023649","3",501620590,501666486,45896
"16714","ENSMODG00000023650","4",400235381,400256421,21040
"16715","ENSMODG00000023651","3",501569415,501574426,5011
"16716","ENSMODG00000023652","4",399502587,400275456,772869
"16717","ENSMODG00000023654","3",501402894,501441767,38873
"16718","ENSMODG00000023655","4",400270738,400290400,19662
"16719","ENSMODG00000023656","4",400365820,400366869,1049
"16720","ENSMODG00000023657","4",399967646,400367986,400340
"16721","ENSMODG00000023658","4",400664122,400697498,33376
"16722","ENSMODG00000023660","3",501256131,501268948,12817
"16723","ENSMODG00000023661","4",397316756,397317824,1068
"16724","ENSMODG00000023662","2",257063274,257063702,428
"16725","ENSMODG00000023663","3",500946697,500967695,20998
"16726","ENSMODG00000023664","1",383440997,383441347,350
"16727","ENSMODG00000023665","3",500846460,500853883,7423
"16728","ENSMODG00000023667","3",500766253,500767182,929
"16729","ENSMODG00000023668","3",500755287,500756117,830
"16730","ENSMODG00000023669","3",500665764,500684880,19116
"16731","ENSMODG00000023670","4",396863927,396877423,13496
"16732","ENSMODG00000023671","4",396721539,397007119,285580
"16733","ENSMODG00000023673","2",258165184,258166149,965
"16734","ENSMODG00000023674","2",258189591,258209141,19550
"16735","ENSMODG00000023677","2",258245476,258245916,440
"16736","ENSMODG00000023679","4",394393694,394525180,131486
"16737","ENSMODG00000023680","1",380254655,380255643,988
"16738","ENSMODG00000023681","1",378855620,378857299,1679
"16739","ENSMODG00000023682","3",500330520,500341573,11053
"16740","ENSMODG00000023683","1",376709157,376710500,1343
"16741","ENSMODG00000023684","3",500237757,500287464,49707
"16742","ENSMODG00000023685","4",389587845,389591486,3641
"16743","ENSMODG00000023686","4",389576076,389584116,8040
"16744","ENSMODG00000023689","3",500320491,500905840,585349
"16745","ENSMODG00000023690","4",388059305,388060417,1112
"16746","ENSMODG00000023691","3",499815455,499838257,22802
"16747","ENSMODG00000023692","2",258444401,258450957,6556
"16748","ENSMODG00000023693","2",258485676,258486383,707
"16749","ENSMODG00000023696","2",258817350,258818332,982
"16750","ENSMODG00000023697","4",387475453,387501409,25956
"16751","ENSMODG00000023700","2",259222110,259223021,911
"16752","ENSMODG00000023703","2",259386895,259387854,959
"16753","ENSMODG00000023705","4",387231056,387232945,1889
"16754","ENSMODG00000023709","3",499583269,499592561,9292
"16755","ENSMODG00000023710","1",359624103,359624372,269
"16756","ENSMODG00000023711","2",284734893,284783656,48763
"16757","ENSMODG00000023712","2",284713789,284751833,38044
"16758","ENSMODG00000023713","3",499709540,500498975,789435
"16759","ENSMODG00000023714","4",386303363,386304859,1496
"16760","ENSMODG00000023715","4",385762691,385763642,951
"16761","ENSMODG00000023716","4",385703851,385706536,2685
"16762","ENSMODG00000023717","1",352330929,352331489,560
"16763","ENSMODG00000023718","1",348583963,348584854,891
"16764","ENSMODG00000023719","3",489069138,489070253,1115
"16765","ENSMODG00000023720","2",276185633,276186343,710
"16766","ENSMODG00000023721","3",488492076,488493050,974
"16767","ENSMODG00000023722","1",345730586,345731093,507
"16768","ENSMODG00000023723","2",275456385,275456981,596
"16769","ENSMODG00000023724","1",345642564,345642827,263
"16770","ENSMODG00000023725","4",385116404,385116583,179
"16771","ENSMODG00000023726","1",345379572,345381250,1678
"16772","ENSMODG00000023727","4",384866735,384870849,4114
"16773","ENSMODG00000023728","3",487371847,487381757,9910
"16774","ENSMODG00000023729","4",384640145,384640810,665
"16775","ENSMODG00000023732","1",343327660,343327842,182
"16776","ENSMODG00000023733","X",78586188,78587108,920
"16777","ENSMODG00000023734","3",485236472,485276145,39673
"16778","ENSMODG00000023735","3",484553184,484553618,434
"16779","ENSMODG00000023736","X",78075540,78110216,34676
"16780","ENSMODG00000023737","4",384340051,384360561,20510
"16781","ENSMODG00000023738","2",270788660,270789781,1121
"16782","ENSMODG00000023740","1",339899874,339914249,14375
"16783","ENSMODG00000023742","1",337076492,337417292,340800
"16784","ENSMODG00000023743","2",270249114,270249476,362
"16785","ENSMODG00000023744","2",270236652,270237040,388
"16786","ENSMODG00000023745","3",493260854,493262395,1541
"16787","ENSMODG00000023746","3",493777264,493793217,15953
"16788","ENSMODG00000023747","3",493855313,493856287,974
"16789","ENSMODG00000023748","3",494100966,494101874,908
"16790","ENSMODG00000023750","3",494721842,494722666,824
"16791","ENSMODG00000023751","3",494788630,494789598,968
"16792","ENSMODG00000023752","3",494833669,494834637,968
"16793","ENSMODG00000023754","4",384085554,384089521,3967
"16794","ENSMODG00000023755","4",384075678,384075923,245
"16795","ENSMODG00000023756","1",334208957,334209895,938
"16796","ENSMODG00000023759","4",384012588,384019380,6792
"16797","ENSMODG00000023761","1",333233775,333245182,11407
"16798","ENSMODG00000023762","1",333207766,333210192,2426
"16799","ENSMODG00000023763","1",333192879,333195314,2435
"16800","ENSMODG00000023764","1",333162094,333164364,2270
"16801","ENSMODG00000023765","3",496195451,496223163,27712
"16802","ENSMODG00000023768","3",496353510,496354466,956
"16803","ENSMODG00000023769","4",383758818,383759672,854
"16804","ENSMODG00000023770","2",268661466,268661930,464
"16805","ENSMODG00000023771","4",383653760,383654404,644
"16806","ENSMODG00000023772","4",383601653,383602519,866
"16807","ENSMODG00000023773","1",332239935,332241062,1127
"16808","ENSMODG00000023774","1",332223565,332224527,962
"16809","ENSMODG00000023775","1",332220890,332223057,2167
"16810","ENSMODG00000023776","4",383518290,383525660,7370
"16811","ENSMODG00000023777","4",383489273,383492570,3297
"16812","ENSMODG00000023778","1",331591185,331591654,469
"16813","ENSMODG00000023779","3",450601305,450602243,938
"16814","ENSMODG00000023780","3",450542195,450543133,938
"16815","ENSMODG00000023781","3",450488540,450489487,947
"16816","ENSMODG00000023784","4",383317023,383351231,34208
"16817","ENSMODG00000023786","3",450276867,450299920,23053
"16818","ENSMODG00000023787","3",449981801,449982616,815
"16819","ENSMODG00000023788","1",330726213,330729296,3083
"16820","ENSMODG00000023791","3",448815394,448820038,4644
"16821","ENSMODG00000023793","3",448068947,448069954,1007
"16822","ENSMODG00000023794","3",447952069,448179722,227653
"16823","ENSMODG00000023795","3",447852445,447852663,218
"16824","ENSMODG00000023798","4",382251718,382255361,3643
"16825","ENSMODG00000023799","2",267332670,267333677,1007
"16826","ENSMODG00000023800","4",378075850,378076923,1073
"16827","ENSMODG00000023801","4",377904201,377926814,22613
"16828","ENSMODG00000023802","1",327577199,327578422,1223
"16829","ENSMODG00000023803","4",377531232,377550910,19678
"16830","ENSMODG00000023804","1",327335825,327336617,792
"16831","ENSMODG00000023805","2",266954371,266958288,3917
"16832","ENSMODG00000023806","3",479201502,479202470,968
"16833","ENSMODG00000023810","3",479051587,479052516,929
"16834","ENSMODG00000023813","3",478948056,478949045,989
"16835","ENSMODG00000023815","3",478852618,478881392,28774
"16836","ENSMODG00000023818","1",319766083,319955924,189841
"16837","ENSMODG00000023819","2",266662138,266663235,1097
"16838","ENSMODG00000023820","2",266651259,266655695,4436
"16839","ENSMODG00000023822","3",478411627,478413101,1474
"16840","ENSMODG00000023825","1",315861106,315861963,857
"16841","ENSMODG00000023826","1",315315480,315315734,254
"16842","ENSMODG00000023827","1",314821334,314902230,80896
"16843","ENSMODG00000023828","2",266449169,266455904,6735
"16844","ENSMODG00000023829","4",374328470,374368912,40442
"16845","ENSMODG00000023831","2",265988240,265989181,941
"16846","ENSMODG00000023833","2",265930104,265931046,942
"16847","ENSMODG00000023834","1",312295228,312299453,4225
"16848","ENSMODG00000023849","2",264980216,264981157,941
"16849","ENSMODG00000023852","2",261852780,261853504,724
"16850","ENSMODG00000023854","2",261529864,261614601,84737
"16851","ENSMODG00000023856","4",370474534,370495961,21427
"16852","ENSMODG00000023857","2",260855816,260863329,7513
"16853","ENSMODG00000023858","4",370426150,370455045,28895
"16854","ENSMODG00000023859","3",464432504,464506719,74215
"16855","ENSMODG00000023860","2",246095495,246096113,618
"16856","ENSMODG00000023861","3",464444015,464473201,29186
"16857","ENSMODG00000023862","4",369503379,369549803,46424
"16858","ENSMODG00000023865","4",368913842,368919007,5165
"16859","ENSMODG00000023866","4",368816003,369162905,346902
"16860","ENSMODG00000023867","2",244274880,244275293,413
"16861","ENSMODG00000023868","2",244061939,244097789,35850
"16862","ENSMODG00000023869","4",368687282,368732747,45465
"16863","ENSMODG00000023870","3",464174578,464194072,19494
"16864","ENSMODG00000023871","3",464110005,464138402,28397
"16865","ENSMODG00000023872","4",367911353,367950215,38862
"16866","ENSMODG00000023873","4",367759495,367770021,10526
"16867","ENSMODG00000023874","3",463795187,463796956,1769
"16868","ENSMODG00000023875","4",367347801,367348838,1037
"16869","ENSMODG00000023877","1",302653250,302655520,2270
"16870","ENSMODG00000023878","4",366965784,366966154,370
"16871","ENSMODG00000023879","3",463103504,463104070,566
"16872","ENSMODG00000023880","2",242271398,242272352,954
"16873","ENSMODG00000023881","2",242057846,242058190,344
"16874","ENSMODG00000023883","2",241389546,241389794,248
"16875","ENSMODG00000023884","3",462728229,462729485,1256
"16876","ENSMODG00000023885","1",300561690,300582793,21103
"16877","ENSMODG00000023886","1",298683560,298719799,36239
"16878","ENSMODG00000023887","1",298771252,298771689,437
"16879","ENSMODG00000023888","1",298549576,298563527,13951
"16880","ENSMODG00000023889","1",298550422,298551280,858
"16881","ENSMODG00000023890","1",298417211,298417782,571
"16882","ENSMODG00000023892","1",297964884,298018316,53432
"16883","ENSMODG00000023893","1",297319712,297320689,977
"16884","ENSMODG00000023894","1",296802715,296913159,110444
"16885","ENSMODG00000023895","1",294955559,294956688,1129
"16886","ENSMODG00000023896","1",294954739,294956670,1931
"16887","ENSMODG00000023897","1",294893212,294893597,385
"16888","ENSMODG00000023898","1",293179265,293180116,851
"16889","ENSMODG00000023899","2",235577947,235578294,347
"16890","ENSMODG00000023900","2",235536321,235537158,837
"16891","ENSMODG00000023902","2",234403930,234404844,914
"16892","ENSMODG00000023903","2",233779065,233779391,326
"16893","ENSMODG00000023904","4",360382893,360383936,1043
"16894","ENSMODG00000023905","1",285304871,285306355,1484
"16895","ENSMODG00000023906","2",233153317,233153958,641
"16896","ENSMODG00000023907","1",284677990,284679671,1681
"16897","ENSMODG00000023909","2",232371365,232372176,811
"16898","ENSMODG00000023910","1",280988128,280989444,1316
"16899","ENSMODG00000023911","4",363032975,363034030,1055
"16900","ENSMODG00000023913","8",311737039,311737752,713
"16901","ENSMODG00000023914","1",277879670,277880445,775
"16902","ENSMODG00000023915","3",455944158,455944754,596
"16903","ENSMODG00000023916","2",229629754,229630667,913
"16904","ENSMODG00000023917","1",276892513,276893339,826
"16905","ENSMODG00000023918","3",455069158,455069649,491
"16906","ENSMODG00000023919","3",454945233,454946169,936
"16907","ENSMODG00000023920","4",364397322,364398095,773
"16908","ENSMODG00000023921","4",364673973,364674239,266
"16909","ENSMODG00000023922","2",226389651,226969664,580013
"16910","ENSMODG00000023924","8",304139092,304139676,584
"16911","ENSMODG00000023927","3",453935183,453936211,1028
"16912","ENSMODG00000023928","8",300855666,300857690,2024
"16913","ENSMODG00000023929","2",224137850,224438087,300237
"16914","ENSMODG00000023930","1",271702417,271702920,503
"16915","ENSMODG00000023931","1",271305572,271306036,464
"16916","ENSMODG00000023932","4",359106375,359145150,38775
"16917","ENSMODG00000023933","4",358913442,358914116,674
"16918","ENSMODG00000023935","2",222220748,222251285,30537
"16919","ENSMODG00000023936","4",358708497,358711585,3088
"16920","ENSMODG00000023937","2",222107325,222108593,1268
"16921","ENSMODG00000023938","2",222052174,222053457,1283
"16922","ENSMODG00000023939","3",452276489,452286964,10475
"16923","ENSMODG00000023940","2",218186396,218370047,183651
"16924","ENSMODG00000023942","2",217486099,217487190,1091
"16925","ENSMODG00000023943","2",217290838,217291902,1064
"16926","ENSMODG00000023944","8",298489184,298489549,365
"16927","ENSMODG00000023945","1",267216501,267218431,1930
"16928","ENSMODG00000023946","1",267195798,267197939,2141
"16929","ENSMODG00000023947","3",451350235,451351995,1760
"16930","ENSMODG00000023949","4",356385876,356479438,93562
"16931","ENSMODG00000023951","8",295608599,295611090,2491
"16932","ENSMODG00000023953","2",214216700,214217094,394
"16933","ENSMODG00000023954","3",447215781,447216494,713
"16934","ENSMODG00000023955","1",263651269,263652270,1001
"16935","ENSMODG00000023956","8",293647688,293648081,393
"16936","ENSMODG00000023957","8",292649316,292703202,53886
"16937","ENSMODG00000023959","1",262980646,262981710,1064
"16938","ENSMODG00000023961","1",262697247,262698138,891
"16939","ENSMODG00000023962","4",355277184,355281831,4647
"16940","ENSMODG00000023964","3",446452912,446453304,392
"16941","ENSMODG00000023965","1",260825016,260826491,1475
"16942","ENSMODG00000023966","4",354820632,354831531,10899
"16943","ENSMODG00000023967","4",354545737,354546870,1133
"16944","ENSMODG00000023968","8",288546735,288859501,312766
"16945","ENSMODG00000023969","4",350782973,350784005,1032
"16946","ENSMODG00000023970","4",350729518,350730640,1122
"16947","ENSMODG00000023972","2",212921380,212922252,872
"16948","ENSMODG00000023975","4",350627337,350764692,137355
"16949","ENSMODG00000023986","4",350231509,350232513,1004
"16950","ENSMODG00000023988","4",350075116,350076072,956
"16951","ENSMODG00000023989","4",350054222,350054413,191
"16952","ENSMODG00000023990","8",286887501,286888373,872
"16953","ENSMODG00000023995","4",349592143,349593534,1391
"16954","ENSMODG00000023997","4",349562408,349563522,1114
"16955","ENSMODG00000023998","4",349532740,349533723,983
"16956","ENSMODG00000023999","4",349487373,349487627,254
"16957","ENSMODG00000024000","4",349450809,349452194,1385
"16958","ENSMODG00000024001","4",349332249,349332902,653
"16959","ENSMODG00000024003","4",349118336,349118989,653
"16960","ENSMODG00000024004","8",281557741,281572591,14850
"16961","ENSMODG00000024005","4",348703637,348704212,575
"16962","ENSMODG00000024008","1",252711320,252712229,909
"16963","ENSMODG00000024009","3",444833254,444833908,654
"16964","ENSMODG00000024010","3",444746065,444746439,374
"16965","ENSMODG00000024011","3",444565217,444569356,4139
"16966","ENSMODG00000024012","1",250629472,250630833,1361
"16967","ENSMODG00000024015","8",274559155,274559532,377
"16968","ENSMODG00000024016","1",249287889,249310695,22806
"16969","ENSMODG00000024017","4",346152482,346199324,46842
"16970","ENSMODG00000024019","4",345593722,345627502,33780
"16971","ENSMODG00000024020","4",345357380,345357673,293
"16972","ENSMODG00000024021","2",206113880,206114236,356
"16973","ENSMODG00000024022","8",272763703,272764755,1052
"16974","ENSMODG00000024024","2",205493330,205494142,812
"16975","ENSMODG00000024025","8",271203602,271204603,1001
"16976","ENSMODG00000024026","8",271108158,271109268,1110
"16977","ENSMODG00000024028","3",441205302,441226410,21108
"16978","ENSMODG00000024029","6",291911580,292072407,160827
"16979","ENSMODG00000024031","2",205097816,205099075,1259
"16980","ENSMODG00000024032","6",291687074,291751962,64888
"16981","ENSMODG00000024034","1",242597170,242599162,1992
"16982","ENSMODG00000024035","1",241165807,241298620,132813
"16983","ENSMODG00000024036","3",440745675,440748764,3089
"16984","ENSMODG00000024037","1",235640719,235641609,890
"16985","ENSMODG00000024040","2",204868889,204890719,21830
"16986","ENSMODG00000024041","8",266788986,266790293,1307
"16987","ENSMODG00000024043","8",266725099,266726127,1028
"16988","ENSMODG00000024044","4",337298735,337299805,1070
"16989","ENSMODG00000024045","8",266670037,266671542,1505
"16990","ENSMODG00000024046","8",266632871,266634178,1307
"16991","ENSMODG00000024047","1",228489468,228500207,10739
"16992","ENSMODG00000024048","1",227896116,227990303,94187
"16993","ENSMODG00000024049","3",439731780,439768693,36913
"16994","ENSMODG00000024050","3",439221537,439222064,527
"16995","ENSMODG00000024053","8",265606661,265607359,698
"16996","ENSMODG00000024054","2",204188060,204207370,19310
"16997","ENSMODG00000024055","8",265565730,265570460,4730
"16998","ENSMODG00000024056","4",335437811,335450689,12878
"16999","ENSMODG00000024057","4",335398352,335398780,428
"17000","ENSMODG00000024058","2",204162198,204166184,3986
"17001","ENSMODG00000024059","4",335259135,335259939,804
"17002","ENSMODG00000024063","1",224303763,224308941,5178
"17003","ENSMODG00000024064","8",263660078,263661760,1682
"17004","ENSMODG00000024066","8",262742582,262742977,395
"17005","ENSMODG00000024067","3",438995602,439018021,22419
"17006","ENSMODG00000024069","4",324033638,324050364,16726
"17007","ENSMODG00000024070","2",203484901,203498661,13760
"17008","ENSMODG00000024072","4",323679962,323680426,464
"17009","ENSMODG00000024073","4",251837485,251838057,572
"17010","ENSMODG00000024076","8",14271514,14277147,5633
"17011","ENSMODG00000024077","8",14219079,14220227,1148
"17012","ENSMODG00000024078","1",221609651,221611900,2249
"17013","ENSMODG00000024079","6",286714836,286715423,587
"17014","ENSMODG00000024081","1",220090320,220091054,734
"17015","ENSMODG00000024082","6",285304116,285625381,321265
"17016","ENSMODG00000024084","8",13693473,13694126,653
"17017","ENSMODG00000024086","3",437417180,437453326,36146
"17018","ENSMODG00000024087","3",437313864,437486488,172624
"17019","ENSMODG00000024088","3",436840601,436853556,12955
"17020","ENSMODG00000024089","6",283887744,283888151,407
"17021","ENSMODG00000024090","2",200253154,200253459,305
"17022","ENSMODG00000024091","8",259265702,259266541,839
"17023","ENSMODG00000024097","2",198812938,198813924,986
"17024","ENSMODG00000024098","3",435154210,435157057,2847
"17025","ENSMODG00000024099","1",207660187,207660768,581
"17026","ENSMODG00000024100","1",207365830,207764631,398801
"17027","ENSMODG00000024101","4",319761129,319762091,962
"17028","ENSMODG00000024102","8",12610821,12626152,15331
"17029","ENSMODG00000024103","1",205397810,205907373,509563
"17030","ENSMODG00000024104","8",255330817,255331512,695
"17031","ENSMODG00000024105","4",318748750,318749334,584
"17032","ENSMODG00000024106","4",318242779,318244014,1235
"17033","ENSMODG00000024108","2",197797719,197798498,779
"17034","ENSMODG00000024109","8",247926292,247928526,2234
"17035","ENSMODG00000024110","4",315771114,315771818,704
"17036","ENSMODG00000024111","8",247283444,247746015,462571
"17037","ENSMODG00000024112","8",11896852,11899489,2637
"17038","ENSMODG00000024113","8",11565558,11598913,33355
"17039","ENSMODG00000024114","8",11486315,11492668,6353
"17040","ENSMODG00000024115","6",276469695,276477936,8241
"17041","ENSMODG00000024116","4",314661808,314662077,269
"17042","ENSMODG00000024117","8",10513678,10513857,179
"17043","ENSMODG00000024118","8",245722974,245723537,563
"17044","ENSMODG00000024119","8",245238157,245238621,464
"17045","ENSMODG00000024121","4",309947176,309947496,320
"17046","ENSMODG00000024122","4",308293974,308295053,1079
"17047","ENSMODG00000024123","5",302280341,302295863,15522
"17048","ENSMODG00000024124","4",306689858,306690277,419
"17049","ENSMODG00000024125","5",302153973,302170161,16188
"17050","ENSMODG00000024127","5",301974297,301991297,17000
"17051","ENSMODG00000024128","5",301907713,301907850,137
"17052","ENSMODG00000024129","3",434321644,434323559,1915
"17053","ENSMODG00000024130","3",434226541,434227416,875
"17054","ENSMODG00000024131","6",275094039,275094461,422
"17055","ENSMODG00000024132","6",275076223,275076624,401
"17056","ENSMODG00000024133","2",195522271,195522519,248
"17057","ENSMODG00000024134","8",239748471,239749520,1049
"17058","ENSMODG00000024135","8",239732394,239744865,12471
"17059","ENSMODG00000024136","3",432425688,432442453,16765
"17060","ENSMODG00000024137","6",270573478,270677922,104444
"17061","ENSMODG00000024138","3",432312907,432344122,31215
"17062","ENSMODG00000024141","8",235442547,235442918,371
"17063","ENSMODG00000024142","6",268914897,268915043,146
"17064","ENSMODG00000024145","1",200119383,200120348,965
"17065","ENSMODG00000024146","6",267393075,267393426,351
"17066","ENSMODG00000024147","6",267372578,267374626,2048
"17067","ENSMODG00000024148","8",231988926,231990203,1277
"17068","ENSMODG00000024149","6",266236135,266337189,101054
"17069","ENSMODG00000024150","4",298507511,298523175,15664
"17070","ENSMODG00000024151","3",432240847,432481046,240199
"17071","ENSMODG00000024153","3",432256217,432271836,15619
"17072","ENSMODG00000024154","4",294237663,294239369,1706
"17073","ENSMODG00000024155","4",290433027,290510548,77521
"17074","ENSMODG00000024156","4",290419598,290419906,308
"17075","ENSMODG00000024157","4",289906763,289908993,2230
"17076","ENSMODG00000024158","4",289225018,289225803,785
"17077","ENSMODG00000024159","4",289189707,289190387,680
"17078","ENSMODG00000024160","4",288969417,288970098,681
"17079","ENSMODG00000024163","8",217671723,217671962,239
"17080","ENSMODG00000024164","6",253302924,253303628,704
"17081","ENSMODG00000024165","5",298819305,298835652,16347
"17082","ENSMODG00000024167","5",298291721,298292590,869
"17083","ENSMODG00000024169","8",216431369,216432952,1583
"17084","ENSMODG00000024170","5",297975292,298029796,54504
"17085","ENSMODG00000024171","5",297897349,297898251,902
"17086","ENSMODG00000024172","5",297811596,297839698,28102
"17087","ENSMODG00000024174","2",193453206,193457327,4121
"17088","ENSMODG00000024175","5",297480905,297506111,25206
"17089","ENSMODG00000024176","2",193428259,193433184,4925
"17090","ENSMODG00000024178","5",297133264,297134167,903
"17091","ENSMODG00000024179","8",215985887,215986894,1007
"17092","ENSMODG00000024180","3",431628617,431629672,1055
"17093","ENSMODG00000024181","5",296769098,296787120,18022
"17094","ENSMODG00000024182","1",197672445,197672987,542
"17095","ENSMODG00000024185","5",296564319,296685935,121616
"17096","ENSMODG00000024192","6",250129897,250130106,209
"17097","ENSMODG00000024196","1",197265041,197266177,1136
"17098","ENSMODG00000024200","5",295909499,295910368,869
"17099","ENSMODG00000024201","5",295865194,295866237,1043
"17100","ENSMODG00000024202","2",192999537,193000142,605
"17101","ENSMODG00000024203","2",192480223,192495957,15734
"17102","ENSMODG00000024204","4",280135203,280135847,644
"17103","ENSMODG00000024207","5",294865518,294879748,14230
"17104","ENSMODG00000024209","3",431352511,431353539,1028
"17105","ENSMODG00000024210","3",431290969,431634642,343673
"17106","ENSMODG00000024212","5",294317446,294318378,932
"17107","ENSMODG00000024214","8",214639861,214659445,19584
"17108","ENSMODG00000024215","8",214436107,214436796,689
"17109","ENSMODG00000024216","5",293752057,293818475,66418
"17110","ENSMODG00000024219","5",293547726,293558554,10828
"17111","ENSMODG00000024220","5",293537607,293538539,932
"17112","ENSMODG00000024221","5",293524128,293524775,647
"17113","ENSMODG00000024223","8",213531800,213550428,18628
"17114","ENSMODG00000024227","4",273972014,274005104,33090
"17115","ENSMODG00000024233","1",189714945,189717008,2063
"17116","ENSMODG00000024237","5",292641805,292642725,920
"17117","ENSMODG00000024238","5",292624459,292625707,1248
"17118","ENSMODG00000024242","4",272211495,272212404,909
"17119","ENSMODG00000024244","1",187705797,187706269,472
"17120","ENSMODG00000024247","3",430149433,430306289,156856
"17121","ENSMODG00000024252","1",187205091,187206689,1598
"17122","ENSMODG00000024253","4",271871137,271871637,500
"17123","ENSMODG00000024254","8",213266111,213266741,630
"17124","ENSMODG00000024255","6",242877757,242878293,536
"17125","ENSMODG00000024256","4",271413054,271413971,917
"17126","ENSMODG00000024259","8",210690983,210691174,191
"17127","ENSMODG00000024260","8",209972308,210045352,73044
"17128","ENSMODG00000024261","4",271330317,271336070,5753
"17129","ENSMODG00000024262","8",209361262,209362020,758
"17130","ENSMODG00000024264","4",271113994,271114947,953
"17131","ENSMODG00000024275","4",270856878,270857810,932
"17132","ENSMODG00000024281","6",242751627,242753594,1967
"17133","ENSMODG00000024282","8",206966131,207194749,228618
"17134","ENSMODG00000024284","8",206820590,206849353,28763
"17135","ENSMODG00000024285","6",242706209,242707878,1669
"17136","ENSMODG00000024287","8",206525193,206526074,881
"17137","ENSMODG00000024288","4",269855735,269857324,1589
"17138","ENSMODG00000024291","2",190815364,190971934,156570
"17139","ENSMODG00000024309","4",266233212,266234270,1058
"17140","ENSMODG00000024310","4",266008492,266008671,179
"17141","ENSMODG00000024316","8",206393641,206394525,884
"17142","ENSMODG00000024342","2",189798026,189798310,284
"17143","ENSMODG00000024365","3",428776794,428778892,2098
"17144","ENSMODG00000024367","3",428660572,428662284,1712
"17145","ENSMODG00000024373","4",264462859,264464145,1286
"17146","ENSMODG00000024386","5",286797798,286798724,926
"17147","ENSMODG00000024387","5",286781338,286782270,932
"17148","ENSMODG00000024388","5",286751180,286752139,959
"17149","ENSMODG00000024396","3",424702045,424703106,1061
"17150","ENSMODG00000024398","3",424634416,424634853,437
"17151","ENSMODG00000024400","8",204819264,204836985,17721
"17152","ENSMODG00000024402","1",178240794,178240991,197
"17153","ENSMODG00000024403","5",285687586,285688572,986
"17154","ENSMODG00000024409","1",177798253,177799214,961
"17155","ENSMODG00000024410","5",285266162,285267514,1352
"17156","ENSMODG00000024413","3",424231521,424292784,61263
"17157","ENSMODG00000024414","4",262002220,262003797,1577
"17158","ENSMODG00000024415","4",261756453,261757493,1040
"17159","ENSMODG00000024416","6",235438750,235441051,2301
"17160","ENSMODG00000024417","4",250341353,250365549,24196
"17161","ENSMODG00000024418","8",204582665,204583618,953
"17162","ENSMODG00000024419","8",204533707,204545276,11569
"17163","ENSMODG00000024420","8",204443101,204443355,254
"17164","ENSMODG00000024421","4",249359334,249362581,3247
"17165","ENSMODG00000024422","3",422436964,423244856,807892
"17166","ENSMODG00000024423","3",422029445,422029750,305
"17167","ENSMODG00000024424","3",421563678,421564692,1014
"17168","ENSMODG00000024425","4",247158782,247159219,437
"17169","ENSMODG00000024427","3",416268047,416268400,353
"17170","ENSMODG00000024428","5",284511686,284512409,723
"17171","ENSMODG00000024430","8",200956908,200978275,21367
"17172","ENSMODG00000024433","2",187457488,187457718,230
"17173","ENSMODG00000024435","3",409053444,409054103,659
"17174","ENSMODG00000024436","1",173328627,173407327,78700
"17175","ENSMODG00000024437","2",186456849,186457509,660
"17176","ENSMODG00000024439","4",241036120,241041527,5407
"17177","ENSMODG00000024440","8",198461815,198463259,1444
"17178","ENSMODG00000024442","3",402327880,402328830,950
"17179","ENSMODG00000024443","1",172674835,172682726,7891
"17180","ENSMODG00000024444","1",172326549,172327226,677
"17181","ENSMODG00000024446","2",185184678,185186201,1523
"17182","ENSMODG00000024447","4",237132702,237133514,812
"17183","ENSMODG00000024448","1",172163749,172169723,5974
"17184","ENSMODG00000024449","3",397455700,397456505,805
"17185","ENSMODG00000024450","5",282681159,282682421,1262
"17186","ENSMODG00000024451","3",395831739,395832284,545
"17187","ENSMODG00000024453","6",210934479,211311961,377482
"17188","ENSMODG00000024457","1",170906344,170908068,1724
"17189","ENSMODG00000024458","2",184623291,184689142,65851
"17190","ENSMODG00000024459","1",170764205,170764513,308
"17191","ENSMODG00000024460","5",278965882,278967234,1352
"17192","ENSMODG00000024461","5",276711135,276713057,1922
"17193","ENSMODG00000024462","5",276312936,276313937,1001
"17194","ENSMODG00000024464","1",170320096,170321052,956
"17195","ENSMODG00000024466","4",232433162,232443612,10450
"17196","ENSMODG00000024470","5",272756599,272759742,3143
"17197","ENSMODG00000024471","4",231569076,231570436,1360
"17198","ENSMODG00000024473","5",271732117,271733427,1310
"17199","ENSMODG00000024474","2",181625741,181626445,704
"17200","ENSMODG00000024475","3",386334904,386335398,494
"17201","ENSMODG00000024476","3",386334825,386335398,573
"17202","ENSMODG00000024477","8",189445521,189445826,305
"17203","ENSMODG00000024478","2",177941041,177941445,404
"17204","ENSMODG00000024482","3",379509033,379509353,320
"17205","ENSMODG00000024483","8",189121648,189121920,272
"17206","ENSMODG00000024484","6",208359866,208535317,175451
"17207","ENSMODG00000024485","2",175174184,175174648,464
"17208","ENSMODG00000024486","3",377354782,377365160,10378
"17209","ENSMODG00000024488","3",376662470,376662931,461
"17210","ENSMODG00000024489","5",269487772,269627567,139795
"17211","ENSMODG00000024490","1",169180723,169181172,449
"17212","ENSMODG00000024491","1",169156512,169156985,473
"17213","ENSMODG00000024492","1",169101737,169102189,452
"17214","ENSMODG00000024493","1",168827103,168829375,2272
"17215","ENSMODG00000024495","4",230809478,230885770,76292
"17216","ENSMODG00000024496","6",153807740,153808683,943
"17217","ENSMODG00000024499","7",260786713,260854726,68013
"17218","ENSMODG00000024500","6",151287336,151297876,10540
"17219","ENSMODG00000024503","3",369750294,369750524,230
"17220","ENSMODG00000024504","7",260675916,260733419,57503
"17221","ENSMODG00000024506","5",262669069,262669987,918
"17222","ENSMODG00000024508","8",183467006,183468678,1672
"17223","ENSMODG00000024509","1",167395461,167396390,929
"17224","ENSMODG00000024513","3",368665570,368685903,20333
"17225","ENSMODG00000024517","2",172326445,172327005,560
"17226","ENSMODG00000024521","5",258585045,258586154,1109
"17227","ENSMODG00000024523","6",150876065,150930858,54793
"17228","ENSMODG00000024527","4",226505623,226506270,647
"17229","ENSMODG00000024529","5",257406682,257413273,6591
"17230","ENSMODG00000024530","7",260479110,260481768,2658
"17231","ENSMODG00000024533","7",260267051,260277853,10802
"17232","ENSMODG00000024535","8",177271850,177668567,396717
"17233","ENSMODG00000024536","2",169159472,169162278,2806
"17234","ENSMODG00000024537","3",363787165,363787980,815
"17235","ENSMODG00000024539","6",149374307,149398530,24223
"17236","ENSMODG00000024540","2",168841828,168879128,37300
"17237","ENSMODG00000024541","8",174370848,174371500,652
"17238","ENSMODG00000024544","3",361663530,361664018,488
"17239","ENSMODG00000024545","4",224013082,224014032,950
"17240","ENSMODG00000024546","6",148577165,148577697,532
"17241","ENSMODG00000024547","6",148552314,148563372,11058
"17242","ENSMODG00000024548","3",358709152,358854206,145054
"17243","ENSMODG00000024554","8",167259726,167260871,1145
"17244","ENSMODG00000024555","8",167189213,167190325,1112
"17245","ENSMODG00000024556","6",147753199,147753867,668
"17246","ENSMODG00000024558","4",223688798,223689775,977
"17247","ENSMODG00000024560","4",223659640,223660572,932
"17248","ENSMODG00000024563","8",160674212,160686042,11830
"17249","ENSMODG00000024565","7",252095773,252111541,15768
"17250","ENSMODG00000024566","3",356634121,356634330,209
"17251","ENSMODG00000024567","3",355858124,355944060,85936
"17252","ENSMODG00000024568","6",147546200,147554876,8676
"17253","ENSMODG00000024570","1",156262394,156441565,179171
"17254","ENSMODG00000024571","6",147432696,147433643,947
"17255","ENSMODG00000024572","6",147415635,147416327,692
"17256","ENSMODG00000024573","6",147332239,147348654,16415
"17257","ENSMODG00000024574","3",354044340,354045292,952
"17258","ENSMODG00000024575","3",353723568,353723795,227
"17259","ENSMODG00000024577","2",166257994,166720060,462066
"17260","ENSMODG00000024578","2",166215718,166222196,6478
"17261","ENSMODG00000024583","1",154783001,154795057,12056
"17262","ENSMODG00000024584","2",165838413,165839552,1139
"17263","ENSMODG00000024585","6",147127548,147132818,5270
"17264","ENSMODG00000024586","6",147052426,147053364,938
"17265","ENSMODG00000024587","8",158885082,158886401,1319
"17266","ENSMODG00000024588","8",158240443,158241102,659
"17267","ENSMODG00000024589","5",248604306,248604848,542
"17268","ENSMODG00000024591","2",165329906,165330307,401
"17269","ENSMODG00000024592","3",343139490,343236653,97163
"17270","ENSMODG00000024594","1",150910458,150911843,1385
"17271","ENSMODG00000024595","2",162078983,162079980,997
"17272","ENSMODG00000024596","5",244145209,244146279,1070
"17273","ENSMODG00000024599","7",248867351,248867902,551
"17274","ENSMODG00000024601","4",221364945,221416074,51129
"17275","ENSMODG00000024602","6",142838867,142848212,9345
"17276","ENSMODG00000024603","8",152944411,152944806,395
"17277","ENSMODG00000024604","4",218822734,218824419,1685
"17278","ENSMODG00000024606","2",156554426,156556111,1685
"17279","ENSMODG00000024608","3",333633802,333634272,470
"17280","ENSMODG00000024611","8",149890923,149891423,500
"17281","ENSMODG00000024613","6",141178542,141275491,96949
"17282","ENSMODG00000024614","2",154612792,154613139,347
"17283","ENSMODG00000024615","2",154588323,154588913,590
"17284","ENSMODG00000024616","8",149155374,149156675,1301
"17285","ENSMODG00000024617","5",243067984,243069153,1169
"17286","ENSMODG00000024618","3",330457528,330491707,34179
"17287","ENSMODG00000024619","7",244637520,244637807,287
"17288","ENSMODG00000024624","3",327159533,327160276,743
"17289","ENSMODG00000024625","3",326960602,326961267,665
"17290","ENSMODG00000024626","3",325554189,325554395,206
"17291","ENSMODG00000024628","1",146926032,147100605,174573
"17292","ENSMODG00000024629","6",138855214,138856503,1289
"17293","ENSMODG00000024630","7",242520886,242521467,581
"17294","ENSMODG00000024633","5",241839637,241840581,944
"17295","ENSMODG00000024637","7",242237350,242274594,37244
"17296","ENSMODG00000024641","3",322421337,322438148,16811
"17297","ENSMODG00000024642","4",211712705,211713370,665
"17298","ENSMODG00000024643","5",241635147,241636103,956
"17299","ENSMODG00000024644","7",242055342,242055560,218
"17300","ENSMODG00000024645","7",240809848,240810558,710
"17301","ENSMODG00000024646","5",240282290,240282727,437
"17302","ENSMODG00000024647","1",144428620,144429612,992
"17303","ENSMODG00000024648","5",239852681,239959444,106763
"17304","ENSMODG00000024649","1",143878583,143879908,1325
"17305","ENSMODG00000024650","1",143539926,143723711,183785
"17306","ENSMODG00000024652","2",148692201,148693958,1757
"17307","ENSMODG00000024653","6",135998538,135999797,1259
"17308","ENSMODG00000024654","6",135984691,135986025,1334
"17309","ENSMODG00000024655","3",321863703,321894226,30523
"17310","ENSMODG00000024656","2",148034482,148034988,506
"17311","ENSMODG00000024658","7",233055473,233055853,380
"17312","ENSMODG00000024659","3",318294196,318983686,689490
"17313","ENSMODG00000024661","6",135022790,135023764,974
"17314","ENSMODG00000024664","3",314034907,314186273,151366
"17315","ENSMODG00000024666","4",207187136,207217843,30707
"17316","ENSMODG00000024667","2",143938825,143939625,800
"17317","ENSMODG00000024668","2",143152477,143342192,189715
"17318","ENSMODG00000024669","2",142881359,142895524,14165
"17319","ENSMODG00000024670","5",238133689,238134150,461
"17320","ENSMODG00000024671","5",238076218,238076868,650
"17321","ENSMODG00000024672","3",312120926,312152353,31427
"17322","ENSMODG00000024673","6",131996871,132000773,3902
"17323","ENSMODG00000024674","2",142510588,142515312,4724
"17324","ENSMODG00000024675","8",129502432,129503283,851
"17325","ENSMODG00000024676","2",140463679,140488394,24715
"17326","ENSMODG00000024677","6",128225246,128225932,686
"17327","ENSMODG00000024678","1",131828602,131829147,545
"17328","ENSMODG00000024679","3",303479138,303522358,43220
"17329","ENSMODG00000024682","7",227751926,227752519,593
"17330","ENSMODG00000024683","2",138601589,138602592,1003
"17331","ENSMODG00000024684","6",127747187,127816840,69653
"17332","ENSMODG00000024685","7",227480071,227481072,1001
"17333","ENSMODG00000024687","8",128618816,128619181,365
"17334","ENSMODG00000024688","3",300256489,300257091,602
"17335","ENSMODG00000024689","1",127168129,127169898,1769
"17336","ENSMODG00000024691","3",296061956,296062213,257
"17337","ENSMODG00000024692","6",127686859,127688733,1874
"17338","ENSMODG00000024693","3",291498331,291498970,639
"17339","ENSMODG00000024694","8",127161038,127212011,50973
"17340","ENSMODG00000024695","2",136602409,136686956,84547
"17341","ENSMODG00000024696","3",282029275,282214913,185638
"17342","ENSMODG00000024697","1",122416561,122458497,41936
"17343","ENSMODG00000024699","6",123956508,123958169,1661
"17344","ENSMODG00000024702","5",232829503,232864224,34721
"17345","ENSMODG00000024703","4",202340433,202341224,791
"17346","ENSMODG00000024704","2",134241417,134244008,2591
"17347","ENSMODG00000024705","3",278180668,278508644,327976
"17348","ENSMODG00000024706","4",201493187,201493786,599
"17349","ENSMODG00000024707","4",201117616,201160813,43197
"17350","ENSMODG00000024710","3",277833947,277834951,1004
"17351","ENSMODG00000024711","3",276542230,276543266,1036
"17352","ENSMODG00000024712","4",196122871,196266637,143766
"17353","ENSMODG00000024714","1",121276343,121277728,1385
"17354","ENSMODG00000024715","7",221009205,221009957,752
"17355","ENSMODG00000024716","3",273831658,273832560,902
"17356","ENSMODG00000024718","8",123319975,123320809,834
"17357","ENSMODG00000024723","3",272787891,272789618,1727
"17358","ENSMODG00000024724","3",272154994,272156976,1982
"17359","ENSMODG00000024725","1",118307037,118308362,1325
"17360","ENSMODG00000024726","6",121981466,121981789,323
"17361","ENSMODG00000024728","3",270695907,270701233,5326
"17362","ENSMODG00000024729","4",190753067,190758719,5652
"17363","ENSMODG00000024731","1",117551224,117552336,1112
"17364","ENSMODG00000024732","8",121756071,121756466,395
"17365","ENSMODG00000024733","8",121626863,121627312,449
"17366","ENSMODG00000024734","1",116391532,116539782,148250
"17367","ENSMODG00000024736","2",120835092,120839703,4611
"17368","ENSMODG00000024737","4",189592567,189594577,2010
"17369","ENSMODG00000024738","4",189009015,189129078,120063
"17370","ENSMODG00000024740","3",266242155,266242526,371
"17371","ENSMODG00000024742","7",213916222,213917127,905
"17372","ENSMODG00000024743","6",120283792,120284451,659
"17373","ENSMODG00000024744","7",212964156,213003482,39326
"17374","ENSMODG00000024746","5",220935645,220958765,23120
"17375","ENSMODG00000024748","6",119953234,119984219,30985
"17376","ENSMODG00000024750","7",210240389,210241468,1079
"17377","ENSMODG00000024751","7",210179232,210180329,1097
"17378","ENSMODG00000024752","5",218890709,218891293,584
"17379","ENSMODG00000024753","5",216231091,216234957,3866
"17380","ENSMODG00000024755","2",116931222,116931527,305
"17381","ENSMODG00000024756","7",209121663,209177891,56228
"17382","ENSMODG00000024757","3",263616080,263616724,644
"17383","ENSMODG00000024759","5",213566211,213566921,710
"17384","ENSMODG00000024760","5",213532001,213532672,671
"17385","ENSMODG00000024761","7",208100579,208101544,965
"17386","ENSMODG00000024762","1",110671445,110672208,763
"17387","ENSMODG00000024763","7",207515951,207516907,956
"17388","ENSMODG00000024764","7",207359107,207363987,4880
"17389","ENSMODG00000024765","4",184584948,184585439,491
"17390","ENSMODG00000024766","7",207349310,207350338,1028
"17391","ENSMODG00000024767","6",115693321,115788397,95076
"17392","ENSMODG00000024768","7",206841185,206866446,25261
"17393","ENSMODG00000024769","5",211308782,211310565,1783
"17394","ENSMODG00000024772","7",206520883,206522028,1145
"17395","ENSMODG00000024773","2",113197658,113295434,97776
"17396","ENSMODG00000024777","5",206220616,206221131,515
"17397","ENSMODG00000024778","8",116336017,116341863,5846
"17398","ENSMODG00000024780","6",110549434,110549715,281
"17399","ENSMODG00000024781","6",109450067,109450330,263
"17400","ENSMODG00000024782","4",180968767,181012828,44061
"17401","ENSMODG00000024783","3",256169126,256170130,1004
"17402","ENSMODG00000024784","4",179908521,179995928,87407
"17403","ENSMODG00000024785","5",202555886,202556253,367
"17404","ENSMODG00000024787","4",179395061,179395768,707
"17405","ENSMODG00000024788","3",252069566,252070003,437
"17406","ENSMODG00000024789","5",199813548,199814678,1130
"17407","ENSMODG00000024790","5",195543551,195766894,223343
"17408","ENSMODG00000024791","8",112888950,112889872,922
"17409","ENSMODG00000024792","2",110886380,110887147,767
"17410","ENSMODG00000024794","5",187237316,187425884,188568
"17411","ENSMODG00000024795","7",198242111,198243124,1013
"17412","ENSMODG00000024796","8",111752619,111753083,464
"17413","ENSMODG00000024797","8",111514220,111514969,749
"17414","ENSMODG00000024800","2",110146354,110148495,2141
"17415","ENSMODG00000024802","8",108831953,109024260,192307
"17416","ENSMODG00000024803","4",177754478,177755200,722
"17417","ENSMODG00000024804","1",107190594,107206175,15581
"17418","ENSMODG00000024805","4",177194763,177195743,980
"17419","ENSMODG00000024808","4",175784264,175785512,1248
"17420","ENSMODG00000024809","8",108623562,108624191,629
"17421","ENSMODG00000024811","3",243809501,243810196,695
"17422","ENSMODG00000024812","5",184072454,184073026,572
"17423","ENSMODG00000024813","3",242438873,242439733,860
"17424","ENSMODG00000024814","3",242397549,242429374,31825
"17425","ENSMODG00000024815","1",100916617,100918510,1893
"17426","ENSMODG00000024817","7",190159242,190160108,866
"17427","ENSMODG00000024818","3",240945883,240947052,1169
"17428","ENSMODG00000024819","5",181862025,181862541,516
"17429","ENSMODG00000024820","5",181117834,181229230,111396
"17430","ENSMODG00000024822","5",180131523,180131988,465
"17431","ENSMODG00000024823","5",180065513,180065989,476
"17432","ENSMODG00000024824","7",189299220,189303644,4424
"17433","ENSMODG00000024826","2",107103196,107104294,1098
"17434","ENSMODG00000024828","1",97258092,97604223,346131
"17435","ENSMODG00000024829","8",107981986,107984733,2747
"17436","ENSMODG00000024830","7",186842180,186844731,2551
"17437","ENSMODG00000024831","3",238164037,238193538,29501
"17438","ENSMODG00000024832","7",186827040,186829067,2027
"17439","ENSMODG00000024834","3",237408750,237409131,381
"17440","ENSMODG00000024838","7",186786477,186815919,29442
"17441","ENSMODG00000024840","6",100183909,100184727,818
"17442","ENSMODG00000024841","1",95848811,95849433,622
"17443","ENSMODG00000024842","3",233023859,233024658,799
"17444","ENSMODG00000024843","7",182296911,182297060,149
"17445","ENSMODG00000024845","1",90834595,90835592,997
"17446","ENSMODG00000024846","2",105159041,105159421,380
"17447","ENSMODG00000024847","3",231627669,231690951,63282
"17448","ENSMODG00000024848","3",231602821,231603729,908
"17449","ENSMODG00000024849","8",105615461,105617290,1829
"17450","ENSMODG00000024850","8",105429551,105431083,1532
"17451","ENSMODG00000024851","5",173075662,173076153,491
"17452","ENSMODG00000024852","5",173022957,173072268,49311
"17453","ENSMODG00000024853","5",172927953,172928123,170
"17454","ENSMODG00000024854","6",98765190,98766386,1196
"17455","ENSMODG00000024855","1",89495878,89496339,461
"17456","ENSMODG00000024856","8",104783937,104785323,1386
"17457","ENSMODG00000024857","3",228425726,228426267,541
"17458","ENSMODG00000024858","3",227949008,227949345,337
"17459","ENSMODG00000024859","3",227546716,227548260,1544
"17460","ENSMODG00000024860","3",227409041,227432761,23720
"17461","ENSMODG00000024861","6",96948877,97027125,78248
"17462","ENSMODG00000024862","6",96440417,96441124,707
"17463","ENSMODG00000024863","7",177355090,177361726,6636
"17464","ENSMODG00000024864","2",103894508,103895272,764
"17465","ENSMODG00000024865","3",225417810,225814355,396545
"17466","ENSMODG00000024866","7",176237591,176237728,137
"17467","ENSMODG00000024867","8",104271845,104359691,87846
"17468","ENSMODG00000024868","3",219867306,219868388,1082
"17469","ENSMODG00000024869","8",104195411,104196088,677
"17470","ENSMODG00000024870","7",174479235,174480182,947
"17471","ENSMODG00000024871","4",158640981,158641565,584
"17472","ENSMODG00000024872","3",213507212,213507823,611
"17473","ENSMODG00000024873","1",84868248,84877223,8975
"17474","ENSMODG00000024881","1",82286946,82294903,7957
"17475","ENSMODG00000024882","1",82248308,82256697,8389
"17476","ENSMODG00000024883","6",91078065,91079115,1050
"17477","ENSMODG00000024884","6",90632153,90633004,851
"17478","ENSMODG00000024885","2",101648490,101650540,2050
"17479","ENSMODG00000024886","5",159823567,159824416,849
"17480","ENSMODG00000024887","1",80810401,80811078,677
"17481","ENSMODG00000024888","6",88924169,88925074,905
"17482","ENSMODG00000024890","6",86050409,86050717,308
"17483","ENSMODG00000024892","2",91537573,91538841,1268
"17484","ENSMODG00000024893","3",201634411,201635938,1527
"17485","ENSMODG00000024894","2",83536091,83536903,812
"17486","ENSMODG00000024897","4",140972548,140972667,119
"17487","ENSMODG00000024899","4",138741537,138742583,1046
"17488","ENSMODG00000024900","5",152719679,152720134,455
"17489","ENSMODG00000024902","5",142989066,142989647,581
"17490","ENSMODG00000024903","8",96679390,96680241,851
"17491","ENSMODG00000024904","8",96208097,96208978,881
"17492","ENSMODG00000024905","8",96107465,96108424,959
"17493","ENSMODG00000024906","2",81134271,81134558,287
"17494","ENSMODG00000024907","5",140445228,140445485,257
"17495","ENSMODG00000024908","7",173114440,173115030,590
"17496","ENSMODG00000024909","7",173067099,173072888,5789
"17497","ENSMODG00000024910","5",138937977,138966739,28762
"17498","ENSMODG00000024911","8",92869466,92946495,77029
"17499","ENSMODG00000024913","3",191291451,191291696,245
"17500","ENSMODG00000024914","7",159034094,159220297,186203
"17501","ENSMODG00000024915","7",155014900,155016039,1139
"17502","ENSMODG00000024917","6",85184874,85186334,1460
"17503","ENSMODG00000024918","7",154611075,154611593,518
"17504","ENSMODG00000024919","4",129381218,129899804,518586
"17505","ENSMODG00000024920","4",129061182,129350577,289395
"17506","ENSMODG00000024921","6",85125268,85125552,284
"17507","ENSMODG00000024922","7",153625497,153637954,12457
"17508","ENSMODG00000024924","3",187722335,187723919,1584
"17509","ENSMODG00000024926","3",186831392,186831640,248
"17510","ENSMODG00000024927","3",186013093,186023031,9938
"17511","ENSMODG00000024929","3",184001514,184002548,1034
"17512","ENSMODG00000024930","3",183876271,183878523,2252
"17513","ENSMODG00000024931","8",90817037,90898764,81727
"17514","ENSMODG00000024932","2",76550870,76551841,971
"17515","ENSMODG00000024934","4",115958821,116094978,136157
"17516","ENSMODG00000024935","4",115217927,115298448,80521
"17517","ENSMODG00000024936","4",114013042,114013656,614
"17518","ENSMODG00000024937","4",112857750,112858181,431
"17519","ENSMODG00000024938","3",178587957,178588310,353
"17520","ENSMODG00000024939","5",127470939,127472018,1079
"17521","ENSMODG00000024942","5",127028934,127029158,224
"17522","ENSMODG00000024943","8",87137167,87138327,1160
"17523","ENSMODG00000024944","7",169793561,169794337,776
"17524","ENSMODG00000024948","6",82183475,82184284,809
"17525","ENSMODG00000024949","7",166400973,166401413,440
"17526","ENSMODG00000024950","1",74325574,74329320,3746
"17527","ENSMODG00000024951","3",171497311,171497895,584
"17528","ENSMODG00000024952","3",171191979,171193073,1094
"17529","ENSMODG00000024953","3",171078599,171114920,36321
"17530","ENSMODG00000024954","5",123418565,123420922,2357
"17531","ENSMODG00000024955","5",123103802,123104402,600
"17532","ENSMODG00000024956","6",80832190,80832972,782
"17533","ENSMODG00000024957","4",110311188,110312204,1016
"17534","ENSMODG00000024958","3",170576860,170577186,326
"17535","ENSMODG00000024959","5",121511551,121512711,1160
"17536","ENSMODG00000024960","4",110246878,110247564,686
"17537","ENSMODG00000024962","2",71058482,71060642,2160
"17538","ENSMODG00000024963","4",108380271,108381176,905
"17539","ENSMODG00000024964","7",163020632,163020922,290
"17540","ENSMODG00000024965","7",144471555,144471899,344
"17541","ENSMODG00000024966","4",105218689,105219732,1043
"17542","ENSMODG00000024968","4",105027815,105028135,320
"17543","ENSMODG00000024969","4",105014011,105014348,337
"17544","ENSMODG00000024970","8",83728449,83730001,1552
"17545","ENSMODG00000024971","8",83712020,83712631,611
"17546","ENSMODG00000024973","1",72990518,72991792,1274
"17547","ENSMODG00000024974","3",166866251,166867304,1053
"17548","ENSMODG00000024975","8",82115396,82121629,6233
"17549","ENSMODG00000024976","3",166137105,166176030,38925
"17550","ENSMODG00000024977","5",116756990,116758668,1678
"17551","ENSMODG00000024978","2",66314418,66315748,1330
"17552","ENSMODG00000024979","6",76964162,76965421,1259
"17553","ENSMODG00000024980","7",132910317,132910719,402
"17554","ENSMODG00000024981","2",64707702,64708598,896
"17555","ENSMODG00000024983","4",99823369,99824121,752
"17556","ENSMODG00000024984","4",98716623,98717884,1261
"17557","ENSMODG00000024985","3",161810297,161811649,1352
"17558","ENSMODG00000024986","3",159829609,159830715,1106
"17559","ENSMODG00000024987","3",158559224,158560141,917
"17560","ENSMODG00000024988","7",127253295,127254038,743
"17561","ENSMODG00000024989","7",121663769,121664254,485
"17562","ENSMODG00000024990","7",121464138,121466228,2090
"17563","ENSMODG00000024991","6",71417565,71870530,452965
"17564","ENSMODG00000024992","7",113038087,113039211,1124
"17565","ENSMODG00000024993","7",112061240,112061911,671
"17566","ENSMODG00000024994","6",71330391,71332796,2405
"17567","ENSMODG00000024995","3",154411833,154412327,494
"17568","ENSMODG00000024996","8",79741374,79742603,1229
"17569","ENSMODG00000024997","8",79499931,79505540,5609
"17570","ENSMODG00000024998","4",97783228,97947023,163795
"17571","ENSMODG00000024999","2",63607765,63629180,21415
"17572","ENSMODG00000025000","4",97376521,97376808,287
"17573","ENSMODG00000025001","7",103051261,103159979,108718
"17574","ENSMODG00000025003","3",148529668,148530024,356
"17575","ENSMODG00000025004","6",68853250,68853993,743
"17576","ENSMODG00000025005","1",69963696,69997433,33737
"17577","ENSMODG00000025007","3",145819942,145822462,2520
"17578","ENSMODG00000025010","8",77496892,77680392,183500
"17579","ENSMODG00000025013","5",101293523,101298776,5253
"17580","ENSMODG00000025014","6",67205249,67210859,5610
"17581","ENSMODG00000025016","3",144768547,144787075,18528
"17582","ENSMODG00000025017","5",101047896,101157500,109604
"17583","ENSMODG00000025019","4",95248954,95249445,491
"17584","ENSMODG00000025020","3",144717557,144719449,1892
"17585","ENSMODG00000025022","5",100735829,100741124,5295
"17586","ENSMODG00000025023","3",144677060,144677723,663
"17587","ENSMODG00000025024","3",144654235,144655830,1595
"17588","ENSMODG00000025025","3",144651080,144651451,371
"17589","ENSMODG00000025037","5",100702460,100706594,4134
"17590","ENSMODG00000025038","1",66917985,66919022,1037
"17591","ENSMODG00000025039","5",100524223,100533796,9573
"17592","ENSMODG00000025040","3",144396547,144399030,2483
"17593","ENSMODG00000025042","1",66584072,66585196,1124
"17594","ENSMODG00000025043","1",66520880,66522880,2000
"17595","ENSMODG00000025044","6",63147241,63151586,4345
"17596","ENSMODG00000025045","7",98620144,98759965,139821
"17597","ENSMODG00000025047","1",66221512,66221790,278
"17598","ENSMODG00000025049","7",97602463,97603026,563
"17599","ENSMODG00000025050","8",72010961,72011251,290
"17600","ENSMODG00000025051","6",62159013,62159243,230
"17601","ENSMODG00000025052","8",70731835,70732463,628
"17602","ENSMODG00000025054","5",98601944,98602249,305
"17603","ENSMODG00000025055","5",96264172,96461642,197470
"17604","ENSMODG00000025056","7",94620793,94621034,241
"17605","ENSMODG00000025061","5",94092570,94092905,335
"17606","ENSMODG00000025062","3",141222232,141222846,614
"17607","ENSMODG00000025063","3",139112753,139113754,1001
"17608","ENSMODG00000025064","7",85657299,85660034,2735
"17609","ENSMODG00000025065","7",85624835,85625848,1013
"17610","ENSMODG00000025069","6",61227504,61292800,65296
"17611","ENSMODG00000025070","7",83604113,83604475,362
"17612","ENSMODG00000025072","1",60335129,60335911,782
"17613","ENSMODG00000025073","7",83031614,83032548,934
"17614","ENSMODG00000025074","5",82378638,82379300,662
"17615","ENSMODG00000025075","5",82376246,82376902,656
"17616","ENSMODG00000025076","4",90846605,90847282,677
"17617","ENSMODG00000025077","1",59747406,59747963,557
"17618","ENSMODG00000025078","5",81826170,81827057,887
"17619","ENSMODG00000025079","5",81734611,81735087,476
"17620","ENSMODG00000025080","3",116656045,116680000,23955
"17621","ENSMODG00000025082","1",58073416,58110099,36683
"17622","ENSMODG00000025084","8",64389468,64391668,2200
"17623","ENSMODG00000025086","3",113593762,113594601,839
"17624","ENSMODG00000025088","2",52193792,52195726,1934
"17625","ENSMODG00000025089","2",52182510,52184444,1934
"17626","ENSMODG00000025090","2",50780791,50781288,497
"17627","ENSMODG00000025091","1",55421399,55427975,6576
"17628","ENSMODG00000025092","5",79758069,79759064,995
"17629","ENSMODG00000025094","1",52146856,52147415,559
"17630","ENSMODG00000025096","5",78322521,78324510,1989
"17631","ENSMODG00000025098","5",78300438,78301120,682
"17632","ENSMODG00000025100","5",76287663,76288148,485
"17633","ENSMODG00000025103","3",109946894,109947118,224
"17634","ENSMODG00000025105","4",87226615,87227770,1155
"17635","ENSMODG00000025107","6",58272013,58273617,1604
"17636","ENSMODG00000025108","4",86370463,86396319,25856
"17637","ENSMODG00000025110","3",104459409,104459702,293
"17638","ENSMODG00000025111","5",65713163,65713702,539
"17639","ENSMODG00000025112","8",47944679,47966433,21754
"17640","ENSMODG00000025115","2",38386939,38438138,51199
"17641","ENSMODG00000025118","6",56736308,56736617,309
"17642","ENSMODG00000025119","6",56479949,56480326,377
"17643","ENSMODG00000025120","3",92873277,92873435,158
"17644","ENSMODG00000025122","2",38107615,38160425,52810
"17645","ENSMODG00000025123","2",37832364,37833797,1433
"17646","ENSMODG00000025124","5",61107179,61108058,879
"17647","ENSMODG00000025125","4",85037194,85037707,513
"17648","ENSMODG00000025126","6",52952306,52953037,731
"17649","ENSMODG00000025127","6",52421657,52434363,12706
"17650","ENSMODG00000025128","2",34067748,34068211,463
"17651","ENSMODG00000025130","8",44202819,44231321,28502
"17652","ENSMODG00000025131","8",41436442,41436920,478
"17653","ENSMODG00000025132","4",79135903,79136061,158
"17654","ENSMODG00000025133","3",78441282,78442091,809
"17655","ENSMODG00000025134","5",52268165,52268894,729
"17656","ENSMODG00000025135","5",52215995,52216540,545
"17657","ENSMODG00000025136","8",36941638,36942480,842
"17658","ENSMODG00000025138","5",52074904,52086700,11796
"17659","ENSMODG00000025139","7",75005616,75181421,175805
"17660","ENSMODG00000025140","6",51298803,51299519,716
"17661","ENSMODG00000025141","7",74888340,74967823,79483
"17662","ENSMODG00000025142","6",50978847,50981282,2435
"17663","ENSMODG00000025143","8",36609843,36626420,16577
"17664","ENSMODG00000025145","1",29104560,29419994,315434
"17665","ENSMODG00000025146","6",48714891,48715980,1089
"17666","ENSMODG00000025147","8",36555381,36564408,9027
"17667","ENSMODG00000025148","6",45005249,45007096,1847
"17668","ENSMODG00000025149","6",45004606,45005042,436
"17669","ENSMODG00000025150","5",49645199,49646056,857
"17670","ENSMODG00000025151","X",69948483,69949058,575
"17671","ENSMODG00000025153","4",66828788,66829690,902
"17672","ENSMODG00000025154","7",72414250,72454998,40748
"17673","ENSMODG00000025155","1",28605485,28606840,1355
"17674","ENSMODG00000025156","7",72129471,72245629,116158
"17675","ENSMODG00000025157","6",40812150,40812957,807
"17676","ENSMODG00000025159","6",38811363,39001486,190123
"17677","ENSMODG00000025160","6",38339124,38339690,566
"17678","ENSMODG00000025161","7",69731316,69762015,30699
"17679","ENSMODG00000025162","6",36330926,36336868,5942
"17680","ENSMODG00000025164","7",69592902,69594026,1124
"17681","ENSMODG00000025166","3",63937534,64104599,167065
"17682","ENSMODG00000025168","6",34150592,34150945,353
"17683","ENSMODG00000025170","X",69266059,69267776,1717
"17684","ENSMODG00000025171","1",28151754,28152146,392
"17685","ENSMODG00000025172","1",28104439,28199556,95117
"17686","ENSMODG00000025173","X",68703474,68704130,656
"17687","ENSMODG00000025175","4",62441170,62442429,1259
"17688","ENSMODG00000025177","7",64662080,64691265,29185
"17689","ENSMODG00000025178","8",36143146,36155251,12105
"17690","ENSMODG00000025179","7",64617193,64634218,17025
"17691","ENSMODG00000025180","3",56229902,56230453,551
"17692","ENSMODG00000025181","7",64565501,64572015,6514
"17693","ENSMODG00000025182","4",61573200,61574138,938
"17694","ENSMODG00000025184","X",75957980,75958966,986
"17695","ENSMODG00000025185","X",74648061,74649155,1094
"17696","ENSMODG00000025186","1",25374083,25375549,1466
"17697","ENSMODG00000025187","X",64165575,64165844,269
"17698","ENSMODG00000025188","X",64142223,64143113,890
"17699","ENSMODG00000025189","4",54348054,54349022,968
"17700","ENSMODG00000025190","X",63586101,63587339,1238
"17701","ENSMODG00000025192","X",62410036,62410977,941
"17702","ENSMODG00000025193","1",24550138,24550692,554
"17703","ENSMODG00000025194","3",54183654,54184418,764
"17704","ENSMODG00000025195","1",24532900,24533880,980
"17705","ENSMODG00000025196","6",31302337,31303890,1553
"17706","ENSMODG00000025197","X",50564558,50565859,1301
"17707","ENSMODG00000025199","6",30450206,30450412,206
"17708","ENSMODG00000025200","7",64465394,64525406,60012
"17709","ENSMODG00000025201","8",35921454,35927077,5623
"17710","ENSMODG00000025202","6",29733614,29734510,896
"17711","ENSMODG00000025203","X",48154431,48155997,1566
"17712","ENSMODG00000025204","X",46911623,46913279,1656
"17713","ENSMODG00000025205","X",46041740,46043893,2153
"17714","ENSMODG00000025206","6",29637140,29637808,668
"17715","ENSMODG00000025207","8",35801463,35809713,8250
"17716","ENSMODG00000025209","8",35782725,35784306,1581
"17717","ENSMODG00000025211","6",29500973,29504729,3756
"17718","ENSMODG00000025212","8",35655328,35656269,941
"17719","ENSMODG00000025213","6",29041920,29043950,2030
"17720","ENSMODG00000025215","1",23636055,23636660,605
"17721","ENSMODG00000025216","7",64414993,64438240,23247
"17722","ENSMODG00000025217","2",20462887,20548660,85773
"17723","ENSMODG00000025218","4",46152376,46154322,1946
"17724","ENSMODG00000025225","8",33056101,33056539,438
"17725","ENSMODG00000025226","3",50391431,50398429,6998
"17726","ENSMODG00000025227","8",32419832,32420332,500
"17727","ENSMODG00000025228","6",27128800,27130560,1760
"17728","ENSMODG00000025233","6",26821969,26822235,266
"17729","ENSMODG00000025234","X",42580585,42635756,55171
"17730","ENSMODG00000025240","1",22920417,22921547,1130
"17731","ENSMODG00000025241","1",22892245,22892448,203
"17732","ENSMODG00000025242","7",63957305,63977648,20343
"17733","ENSMODG00000025243","3",49589261,49590187,926
"17734","ENSMODG00000025244","3",49542903,49544672,1769
"17735","ENSMODG00000025246","8",31561615,31562610,995
"17736","ENSMODG00000025247","1",22742632,22806282,63650
"17737","ENSMODG00000025248","5",33232490,33233349,859
"17738","ENSMODG00000025252","8",31468831,31469932,1101
"17739","ENSMODG00000025253","4",42711872,42765190,53318
"17740","ENSMODG00000025254","6",26774366,26793002,18636
"17741","ENSMODG00000025255","6",26754802,26769021,14219
"17742","ENSMODG00000025258","5",32167625,32176221,8596
"17743","ENSMODG00000025259","1",20872230,20927613,55383
"17744","ENSMODG00000025260","4",36016112,36016342,230
"17745","ENSMODG00000025261","6",26683339,26731138,47799
"17746","ENSMODG00000025262","8",29709452,29718684,9232
"17747","ENSMODG00000025263","4",35125640,35126056,416
"17748","ENSMODG00000025264","2",13076350,13159125,82775
"17749","ENSMODG00000025266","7",60683183,60684301,1118
"17750","ENSMODG00000025267","8",29279246,29279437,191
"17751","ENSMODG00000025268","5",31771567,31772837,1270
"17752","ENSMODG00000025271","4",33048015,33048860,845
"17753","ENSMODG00000025272","3",45196730,45197143,413
"17754","ENSMODG00000025273","1",17292140,17293069,929
"17755","ENSMODG00000025275","X",38651165,38652151,986
"17756","ENSMODG00000025276","4",29172982,29291924,118942
"17757","ENSMODG00000025278","7",59209494,59210390,896
"17758","ENSMODG00000025279","7",58975996,59024458,48462
"17759","ENSMODG00000025280","X",36444413,36445498,1085
"17760","ENSMODG00000025281","2",11420070,11420606,536
"17761","ENSMODG00000025284","2",11060418,11061077,659
"17762","ENSMODG00000025285","1",17000169,17001101,932
"17763","ENSMODG00000025286","1",16954000,16954929,929
"17764","ENSMODG00000025288","1",16885428,16886384,956
"17765","ENSMODG00000025290","1",16693809,16694747,938
"17766","ENSMODG00000025292","4",26381268,26381561,293
"17767","ENSMODG00000025293","7",56835833,56837749,1916
"17768","ENSMODG00000025294","7",56822846,56823315,469
"17769","ENSMODG00000025295","4",26027584,26028150,566
"17770","ENSMODG00000025297","8",26288900,26297177,8277
"17771","ENSMODG00000025298","X",35255158,35256126,968
"17772","ENSMODG00000025299","6",26365833,26367179,1346
"17773","ENSMODG00000025301","5",23326215,23328602,2387
"17774","ENSMODG00000025302","8",25917881,25927063,9182
"17775","ENSMODG00000025303","8",24883804,24921264,37460
"17776","ENSMODG00000025304","7",55758771,55760308,1537
"17777","ENSMODG00000025305","2",10708444,10708622,178
"17778","ENSMODG00000025306","1",16444999,16445439,440
"17779","ENSMODG00000025307","7",54577823,54578685,862
"17780","ENSMODG00000025309","3",39721072,39721644,572
"17781","ENSMODG00000025310","6",25688907,25839745,150838
"17782","ENSMODG00000025311","4",22119048,22120160,1112
"17783","ENSMODG00000025312","6",25377320,25689068,311748
"17784","ENSMODG00000025313","4",21946073,21947212,1139
"17785","ENSMODG00000025314","4",21891920,21892936,1016
"17786","ENSMODG00000025316","4",20384958,20385856,898
"17787","ENSMODG00000025317","2",10471808,10475044,3236
"17788","ENSMODG00000025319","6",19937704,19949224,11520
"17789","ENSMODG00000025320","3",37899175,37900418,1243
"17790","ENSMODG00000025321","X",26530355,26531764,1409
"17791","ENSMODG00000025322","X",24730885,24731610,725
"17792","ENSMODG00000025323","X",24538884,24539084,200
"17793","ENSMODG00000025324","X",23143546,23144730,1184
"17794","ENSMODG00000025325","X",22631738,22633252,1514
"17795","ENSMODG00000025326","X",22384635,22385644,1009
"17796","ENSMODG00000025327","X",22292913,22293538,625
"17797","ENSMODG00000025328","3",36946633,36981977,35344
"17798","ENSMODG00000025329","X",21823638,21824571,933
"17799","ENSMODG00000025330","8",23142176,23167061,24885
"17800","ENSMODG00000025331","X",21673456,21674310,854
"17801","ENSMODG00000025332","7",53048982,53078914,29932
"17802","ENSMODG00000025333","5",20547595,20547895,300
"17803","ENSMODG00000025335","2",9472274,9478455,6181
"17804","ENSMODG00000025336","X",19144958,19145617,659
"17805","ENSMODG00000025337","2",9408495,9409658,1163
"17806","ENSMODG00000025338","4",14926191,14927168,977
"17807","ENSMODG00000025339","7",47275679,47326831,51152
"17808","ENSMODG00000025340","1",13071640,13074216,2576
"17809","ENSMODG00000025341","8",17812099,17812821,722
"17810","ENSMODG00000025342","4",14372594,14374143,1549
"17811","ENSMODG00000025344","7",37281709,37282131,422
"17812","ENSMODG00000025346","8",17523790,17544447,20657
"17813","ENSMODG00000025347","3",33781704,33785484,3780
"17814","ENSMODG00000025348","7",35837411,35837602,191
"17815","ENSMODG00000025349","7",32632118,32632765,647
"17816","ENSMODG00000025351","6",13957713,13958204,491
"17817","ENSMODG00000025353","4",13116660,13117418,758
"17818","ENSMODG00000025355","X",14659184,14674148,14964
"17819","ENSMODG00000025356","8",15723717,15723926,209
"17820","ENSMODG00000025357","X",14475738,14476541,803
"17821","ENSMODG00000025358","7",30213155,30213772,617
"17822","ENSMODG00000025359","2",8084001,8084549,548
"17823","ENSMODG00000025360","7",27576768,27577157,389
"17824","ENSMODG00000025361","7",27419067,27420104,1037
"17825","ENSMODG00000025362","7",27358587,27359189,602
"17826","ENSMODG00000025363","4",9412940,9413761,821
"17827","ENSMODG00000025364","7",25731331,25731588,257
"17828","ENSMODG00000025365","X",7789743,7789901,158
"17829","ENSMODG00000025366","4",8887640,9074510,186870
"17830","ENSMODG00000025367","1",9868335,9869771,1436
"17831","ENSMODG00000025369","5",13676550,13678763,2213
"17832","ENSMODG00000025370","5",13295802,13296011,209
"17833","ENSMODG00000025372","1",9221318,9221997,679
"17834","ENSMODG00000025378","2",6407520,6611547,204027
"17835","ENSMODG00000025380","7",22396921,22397875,954
"17836","ENSMODG00000025381","7",22114035,22114643,608
"17837","ENSMODG00000025382","3",19315790,19316308,518
"17838","ENSMODG00000025383","8",14784761,14785498,737
"17839","ENSMODG00000025386","6",12047767,12050142,2375
"17840","ENSMODG00000025395","X",5728112,5851941,123829
"17841","ENSMODG00000025396","6",11987239,11988408,1169
"17842","ENSMODG00000025397","5",8014258,8014962,704
"17843","ENSMODG00000025398","6",11395245,11406122,10877
"17844","ENSMODG00000025399","1",6823743,6825602,1859
"17845","ENSMODG00000025400","5",7916266,7916457,191
"17846","ENSMODG00000025401","X",4719465,4719986,521
"17847","ENSMODG00000025402","7",17878570,18209554,330984
"17848","ENSMODG00000025403","3",17626440,17641027,14587
"17849","ENSMODG00000025404","X",4314233,4315123,890
"17850","ENSMODG00000025406","3",16539875,16855695,315820
"17851","ENSMODG00000025407","8",9646513,9648437,1924
"17852","ENSMODG00000025408","2",3265679,3287483,21804
"17853","ENSMODG00000025409","2",3004396,3102362,97966
"17854","ENSMODG00000025410","X",3535265,3538121,2856
"17855","ENSMODG00000025411","5",6918870,6920987,2117
"17856","ENSMODG00000025412","1",38583197,38601692,18495
"17857","ENSMODG00000025413","4",4135860,4178525,42665
"17858","ENSMODG00000025415","7",12075943,12076947,1004
"17859","ENSMODG00000025416","7",11227655,11230207,2552
"17860","ENSMODG00000025417","6",4402497,4403471,974
"17861","ENSMODG00000025418","2",2552763,2553845,1082
"17862","ENSMODG00000025420","7",10172069,10172350,281
"17863","ENSMODG00000025423","3",6184482,6185558,1076
"17864","ENSMODG00000025424","7",6383947,6384357,410
"17865","ENSMODG00000025426","3",5326766,5327389,623
"17866","ENSMODG00000025427","7",474108,718792,244684
"17867","ENSMODG00000025428","7",347205,371331,24126
"17868","ENSMODG00000025429","8",7703457,7710339,6882
"17869","ENSMODG00000025430","2",1755699,1756745,1046
"17870","ENSMODG00000025431","3",1292182,1292781,599
"17871","ENSMODG00000025432","3",1236051,1236320,269
"17872","ENSMODG00000025433","8",7391581,7488769,97188
"17873","ENSMODG00000025434","X",28371563,28373566,2003
"17874","ENSMODG00000025435","4",1564153,1567877,3724
"17875","ENSMODG00000025436","3",777189,778571,1382
"17876","ENSMODG00000025437","X",3034182,3035366,1184
"17877","ENSMODG00000025438","4",654905,655726,821
"17878","ENSMODG00000025439","X",26345728,26394198,48470
"17879","ENSMODG00000025440","6",166312350,166411442,99092
"17880","ENSMODG00000025442","Un",30289876,30290399,523
"17881","ENSMODG00000025443","Un",30671467,30692181,20714
"17882","ENSMODG00000025446","Un",55178700,55187612,8912
"17883","ENSMODG00000025448","Un",82768457,82774949,6492
"17884","ENSMODG00000025449","6",203460767,203464581,3814
"17885","ENSMODG00000025450","Un",9825182,9840337,15155
"17886","ENSMODG00000025451","8",15352380,15355811,3431
"17887","ENSMODG00000025453","8",89940956,89986880,45924
"17888","ENSMODG00000025454","8",102859195,102941252,82057
"17889","ENSMODG00000025455","8",113523779,113530003,6224
"17890","ENSMODG00000025456","8",122842027,122905056,63029
"17891","ENSMODG00000025457","8",123988963,123996511,7548
"17892","ENSMODG00000025458","8",190255768,190293497,37729
"17893","ENSMODG00000025459","8",201663783,201696401,32618
"17894","ENSMODG00000025461","8",205045741,205046204,463
"17895","ENSMODG00000025462","8",205132244,205132824,580
"17896","ENSMODG00000025467","8",206288848,206295411,6563
"17897","ENSMODG00000025468","8",207509580,207946925,437345
"17898","ENSMODG00000025469","8",214976940,214989979,13039
"17899","ENSMODG00000025471","8",256291247,256307562,16315
"17900","ENSMODG00000025472","8",276298991,276315286,16295
"17901","ENSMODG00000025473","8",300505052,300519263,14211
"17902","ENSMODG00000025474","8",35827830,35895280,67450
"17903","ENSMODG00000025475","8",157057947,157174889,116942
"17904","ENSMODG00000025476","8",214323974,214326619,2645
"17905","ENSMODG00000025477","8",265686848,265787308,100460
"17906","ENSMODG00000025479","7",46805620,46862301,56681
"17907","ENSMODG00000025480","7",64784762,64930230,145468
"17908","ENSMODG00000025481","7",73397247,73432466,35219
"17909","ENSMODG00000025482","7",73514288,73535599,21311
"17910","ENSMODG00000025483","7",166803580,166912890,109310
"17911","ENSMODG00000025484","7",169720312,169883865,163553
"17912","ENSMODG00000025485","7",176676085,176683829,7744
"17913","ENSMODG00000025486","7",180415583,180700136,284553
"17914","ENSMODG00000025487","7",192090339,192129536,39197
"17915","ENSMODG00000025488","7",235364158,235514913,150755
"17916","ENSMODG00000025491","7",194313834,194369307,55473
"17917","ENSMODG00000025492","7",206966158,206986401,20243
"17918","ENSMODG00000025493","6",58753132,58953817,200685
"17919","ENSMODG00000025494","6",69732080,69734427,2347
"17920","ENSMODG00000025495","6",80548698,80581162,32464
"17921","ENSMODG00000025496","6",83666200,83674802,8602
"17922","ENSMODG00000025498","6",119857123,119883012,25889
"17923","ENSMODG00000025499","6",124050351,124052681,2330
"17924","ENSMODG00000025500","6",124086711,124087489,778
"17925","ENSMODG00000025501","4",381110571,381126037,15466
"17926","ENSMODG00000025508","6",141852058,141852996,938
"17927","ENSMODG00000025509","6",141875101,141876036,935
"17928","ENSMODG00000025510","6",147018659,147019489,830
"17929","ENSMODG00000025511","6",147742753,147745384,2631
"17930","ENSMODG00000025512","6",213933545,213954806,21261
"17931","ENSMODG00000025514","6",291795595,291816053,20458
"17932","ENSMODG00000025515","6",26611246,26614400,3154
"17933","ENSMODG00000025516","4",380890140,380933065,42925
"17934","ENSMODG00000025517","6",216080589,216149056,68467
"17935","ENSMODG00000025518","6",246306727,246320667,13940
"17936","ENSMODG00000025519","5",19656196,19734624,78428
"17937","ENSMODG00000025520","5",20972228,21012135,39907
"17938","ENSMODG00000025521","5",23086162,23111678,25516
"17939","ENSMODG00000025522","5",23943086,24300388,357302
"17940","ENSMODG00000025523","5",32516441,32532450,16009
"17941","ENSMODG00000025524","5",46874315,46982442,108127
"17942","ENSMODG00000025525","5",51698959,51739953,40994
"17943","ENSMODG00000025527","5",139047701,139182684,134983
"17944","ENSMODG00000025528","5",139297737,139355968,58231
"17945","ENSMODG00000025529","5",140174792,140204528,29736
"17946","ENSMODG00000025530","5",170171749,170192350,20601
"17947","ENSMODG00000025531","5",174176246,174195196,18950
"17948","ENSMODG00000025532","5",202125907,202354356,228449
"17949","ENSMODG00000025533","5",219771059,219893853,122794
"17950","ENSMODG00000025535","5",241505183,241537952,32769
"17951","ENSMODG00000025540","5",289344892,289345797,905
"17952","ENSMODG00000025543","5",291565648,291568902,3254
"17953","ENSMODG00000025545","5",298728057,298750539,22482
"17954","ENSMODG00000025546","5",62870698,63012228,141530
"17955","ENSMODG00000025547","5",101172012,101217743,45731
"17956","ENSMODG00000025548","5",140654772,140677700,22928
"17957","ENSMODG00000025549","5",202006603,202096890,90287
"17958","ENSMODG00000025550","5",220891134,220928125,36991
"17959","ENSMODG00000025551","5",248566030,248576067,10037
"17960","ENSMODG00000025552","5",301434632,301441439,6807
"17961","ENSMODG00000025553","4",42778515,42850091,71576
"17962","ENSMODG00000025554","4",42851768,42965035,113267
"17963","ENSMODG00000025555","4",63740598,63828406,87808
"17964","ENSMODG00000025556","4",73417479,73446305,28826
"17965","ENSMODG00000025559","4",172642346,172706268,63922
"17966","ENSMODG00000025562","4",232562190,232575327,13137
"17967","ENSMODG00000025563","4",232641251,232649563,8312
"17968","ENSMODG00000025564","4",240813556,240827917,14361
"17969","ENSMODG00000025565","4",240988423,240998166,9743
"17970","ENSMODG00000025566","4",241064363,241089615,25252
"17971","ENSMODG00000025567","4",241844499,241887889,43390
"17972","ENSMODG00000025570","4",371714865,371761281,46416
"17973","ENSMODG00000025571","4",372348753,372355316,6563
"17974","ENSMODG00000025573","4",376233437,376484322,250885
"17975","ENSMODG00000025574","4",382891825,382897211,5386
"17976","ENSMODG00000025575","4",383498922,383500282,1360
"17977","ENSMODG00000025576","4",383546013,383546551,538
"17978","ENSMODG00000025577","4",384219178,384220170,992
"17979","ENSMODG00000025578","X",78790592,78792534,1942
"17980","ENSMODG00000025579","4",399994672,400015685,21013
"17981","ENSMODG00000025580","4",406351562,406354304,2742
"17982","ENSMODG00000025581","4",406471777,406472592,815
"17983","ENSMODG00000025582","4",406594957,406663702,68745
"17984","ENSMODG00000025584","4",409740557,409765125,24568
"17985","ENSMODG00000025585","4",340521468,340575315,53847
"17986","ENSMODG00000025586","4",429285042,429304220,19178
"17987","ENSMODG00000025588","4",68524062,68628542,104480
"17988","ENSMODG00000025591","4",362894852,362966182,71330
"17989","ENSMODG00000025593","4",400918011,400922262,4251
"17990","ENSMODG00000025594","4",407780431,407786747,6316
"17991","ENSMODG00000025595","4",407968141,407981634,13493
"17992","ENSMODG00000025596","4",409729333,409754760,25427
"17993","ENSMODG00000025598","3",11602429,11637900,35471
"17994","ENSMODG00000025599","3",26719464,26742265,22801
"17995","ENSMODG00000025600","3",29725365,29772292,46927
"17996","ENSMODG00000025601","3",35449551,35468495,18944
"17997","ENSMODG00000025602","3",55337992,55342094,4102
"17998","ENSMODG00000025604","3",71517956,71568562,50606
"17999","ENSMODG00000025605","3",87491381,87498301,6920
"18000","ENSMODG00000025606","3",88525836,88735522,209686
"18001","ENSMODG00000025607","3",106763084,106842100,79016
"18002","ENSMODG00000025608","3",145416780,145440937,24157
"18003","ENSMODG00000025609","3",151896892,151918106,21214
"18004","ENSMODG00000025610","3",162508889,162530480,21591
"18005","ENSMODG00000025611","3",184584019,184624270,40251
"18006","ENSMODG00000025612","3",186009121,186023463,14342
"18007","ENSMODG00000025613","3",188244786,188277009,32223
"18008","ENSMODG00000025616","3",224303012,224333857,30845
"18009","ENSMODG00000025617","3",231100721,231116381,15660
"18010","ENSMODG00000025618","3",246311930,246330881,18951
"18011","ENSMODG00000025619","3",259945098,260031400,86302
"18012","ENSMODG00000025620","3",265118172,265183624,65452
"18013","ENSMODG00000025621","3",293513326,293960086,446760
"18014","ENSMODG00000025622","3",313972897,313986531,13634
"18015","ENSMODG00000025623","3",331427035,331437511,10476
"18016","ENSMODG00000025624","3",343402657,343430583,27926
"18017","ENSMODG00000025626","3",393286906,393466691,179785
"18018","ENSMODG00000025627","3",411366125,411420982,54857
"18019","ENSMODG00000025628","3",429266041,429267801,1760
"18020","ENSMODG00000025629","3",430209391,430212027,2636
"18021","ENSMODG00000025630","3",437624385,437649276,24891
"18022","ENSMODG00000025632","3",455534118,455545239,11121
"18023","ENSMODG00000025636","3",484554747,484595001,40254
"18024","ENSMODG00000025637","3",499705680,499723585,17905
"18025","ENSMODG00000025638","3",509688310,509698999,10689
"18026","ENSMODG00000025639","3",525169877,525170540,663
"18027","ENSMODG00000025640","3",516497569,516579651,82082
"18028","ENSMODG00000025641","3",89604822,89694614,89792
"18029","ENSMODG00000025642","3",163639931,163683762,43831
"18030","ENSMODG00000025644","3",443196539,443342444,145905
"18031","ENSMODG00000025645","3",445479080,445511575,32495
"18032","ENSMODG00000025647","3",499560776,499617156,56380
"18033","ENSMODG00000025648","3",503673613,503686755,13142
"18034","ENSMODG00000025649","3",522584986,522595780,10794
"18035","ENSMODG00000025650","2",15437343,15455004,17661
"18036","ENSMODG00000025651","2",15663074,15678534,15460
"18037","ENSMODG00000025652","2",16987628,16990154,2526
"18038","ENSMODG00000025653","2",31608142,31716210,108068
"18039","ENSMODG00000025655","2",58437097,58441656,4559
"18040","ENSMODG00000025657","2",108227443,108244981,17538
"18041","ENSMODG00000025658","2",108934913,108982607,47694
"18042","ENSMODG00000025659","2",109087936,109117730,29794
"18043","ENSMODG00000025660","2",109242776,109283086,40310
"18044","ENSMODG00000025661","2",109521351,109525870,4519
"18045","ENSMODG00000025662","2",111250888,111298093,47205
"18046","ENSMODG00000025664","2",137558381,137582158,23777
"18047","ENSMODG00000025665","2",164317798,164323684,5886
"18048","ENSMODG00000025666","2",164538001,164546244,8243
"18049","ENSMODG00000025667","2",167466463,167467389,926
"18050","ENSMODG00000025668","2",190440527,190481763,41236
"18051","ENSMODG00000025670","2",201410890,201476645,65755
"18052","ENSMODG00000025672","2",217322004,217334131,12127
"18053","ENSMODG00000025673","2",230069675,230169548,99873
"18054","ENSMODG00000025674","2",230327539,230343608,16069
"18055","ENSMODG00000025675","2",232285338,232314723,29385
"18056","ENSMODG00000025676","2",262590083,262675060,84977
"18057","ENSMODG00000025678","2",268878036,268885486,7450
"18058","ENSMODG00000025679","2",271065019,271065862,843
"18059","ENSMODG00000025680","2",257451229,257453472,2243
"18060","ENSMODG00000025681","2",255809118,255870514,61396
"18061","ENSMODG00000025682","2",255059103,255061420,2317
"18062","ENSMODG00000025683","2",254913727,254918805,5078
"18063","ENSMODG00000025684","2",251508055,251508429,374
"18064","ENSMODG00000025685","2",288723994,288724287,293
"18065","ENSMODG00000025686","2",296746153,296780936,34783
"18066","ENSMODG00000025687","2",314085770,314102552,16782
"18067","ENSMODG00000025688","2",395455966,395546936,90970
"18068","ENSMODG00000025689","2",450225819,450263307,37488
"18069","ENSMODG00000025690","2",451597966,451812402,214436
"18070","ENSMODG00000025691","2",481228632,481233949,5317
"18071","ENSMODG00000025694","2",498872264,498874231,1967
"18072","ENSMODG00000025695","2",498899762,498912014,12252
"18073","ENSMODG00000025696","2",503973328,503978584,5256
"18074","ENSMODG00000025697","2",508572807,508822718,249911
"18075","ENSMODG00000025698","2",525814950,525839896,24946
"18076","ENSMODG00000025699","2",7519179,7551168,31989
"18077","ENSMODG00000025700","2",27112861,27191957,79096
"18078","ENSMODG00000025701","2",31552000,31580965,28965
"18079","ENSMODG00000025702","2",41167632,41169887,2255
"18080","ENSMODG00000025703","2",42175740,42237415,61675
"18081","ENSMODG00000025704","2",44450564,44502702,52138
"18082","ENSMODG00000025705","2",109440378,109465444,25066
"18083","ENSMODG00000025706","2",114316866,114356862,39996
"18084","ENSMODG00000025707","2",196704125,196719501,15376
"18085","ENSMODG00000025708","2",268827081,268837671,10590
"18086","ENSMODG00000025710","2",458978956,459058249,79293
"18087","ENSMODG00000025711","2",526148624,526158637,10013
"18088","ENSMODG00000025712","2",536774513,536968505,193992
"18089","ENSMODG00000025714","1",38758210,38794832,36622
"18090","ENSMODG00000025715","1",9477705,9487614,9909
"18091","ENSMODG00000025716","1",14070834,14073561,2727
"18092","ENSMODG00000025717","1",14088950,14111758,22808
"18093","ENSMODG00000025719","1",14208385,14249304,40919
"18094","ENSMODG00000025720","1",14271258,14325613,54355
"18095","ENSMODG00000025721","1",14317458,14320274,2816
"18096","ENSMODG00000025722","1",28607904,28621550,13646
"18097","ENSMODG00000025723","1",59972117,59996187,24070
"18098","ENSMODG00000025724","1",65490576,65511466,20890
"18099","ENSMODG00000025725","1",67805359,67814071,8712
"18100","ENSMODG00000025726","1",75055059,75079316,24257
"18101","ENSMODG00000025728","1",84935900,84946170,10270
"18102","ENSMODG00000025733","1",171502288,171508363,6075
"18103","ENSMODG00000025734","1",171746301,171747185,884
"18104","ENSMODG00000025735","1",173554202,173557082,2880
"18105","ENSMODG00000025736","1",198310305,198323929,13624
"18106","ENSMODG00000025737","1",250543570,250640986,97416
"18107","ENSMODG00000025738","1",260873022,260988870,115848
"18108","ENSMODG00000025739","1",261928640,261978508,49868
"18109","ENSMODG00000025740","1",311672854,311674763,1909
"18110","ENSMODG00000025741","1",345209460,345301318,91858
"18111","ENSMODG00000025742","1",379115469,379128797,13328
"18112","ENSMODG00000025743","1",380174797,380252561,77764
"18113","ENSMODG00000025744","1",381880071,381885316,5245
"18114","ENSMODG00000025745","1",399394932,399458474,63542
"18115","ENSMODG00000025746","1",400252333,400283451,31118
"18116","ENSMODG00000025748","1",416005263,416020334,15071
"18117","ENSMODG00000025749","1",404510316,404546855,36539
"18118","ENSMODG00000025750","1",446202775,446375847,173072
"18119","ENSMODG00000025751","1",447482720,447484201,1481
"18120","ENSMODG00000025753","1",447543240,447544299,1059
"18121","ENSMODG00000025754","1",447553987,447554919,932
"18122","ENSMODG00000025755","1",448673999,448676099,2100
"18123","ENSMODG00000025756","1",453684610,453687366,2756
"18124","ENSMODG00000025759","1",468197343,468200626,3283
"18125","ENSMODG00000025761","1",494780069,494850295,70226
"18126","ENSMODG00000025763","1",522910018,522916536,6518
"18127","ENSMODG00000025764","1",545900481,545924351,23870
"18128","ENSMODG00000025766","1",574162603,574306908,144305
"18129","ENSMODG00000025767","1",600583639,600609468,25829
"18130","ENSMODG00000025768","1",640510719,640553699,42980
"18131","ENSMODG00000025769","1",683035933,683081711,45778
"18132","ENSMODG00000025772","1",713127950,713128604,654
"18133","ENSMODG00000025773","1",713608017,713611821,3804
"18134","ENSMODG00000025774","1",714386202,714392875,6673
"18135","ENSMODG00000025775","1",715454880,715455434,554
"18136","ENSMODG00000025776","1",715486847,715487443,596
"18137","ENSMODG00000025777","1",715634843,715676403,41560
"18138","ENSMODG00000025778","1",729096059,729110741,14682
"18139","ENSMODG00000025779","1",729170068,729178031,7963
"18140","ENSMODG00000025780","1",740160985,740163128,2143
"18141","ENSMODG00000025781","1",17230738,17267692,36954
"18142","ENSMODG00000025784","1",229556608,229663035,106427
"18143","ENSMODG00000025785","1",270420151,270440968,20817
"18144","ENSMODG00000025786","1",414417241,414496622,79381
"18145","ENSMODG00000025787","1",404452682,404509436,56754
"18146","ENSMODG00000025788","1",443423070,443429571,6501
"18147","ENSMODG00000025789","1",469176139,469180244,4105
"18148","ENSMODG00000025790","1",491278810,491428111,149301
"18149","ENSMODG00000025791","1",574505435,574642321,136886
"18150","ENSMODG00000025792","1",141020905,141021000,95
"18151","ENSMODG00000025793","4",379637525,379637616,91
"18152","ENSMODG00000025798","2",425777724,425777814,90
"18153","ENSMODG00000025800","2",255707663,255707746,83
"18154","ENSMODG00000025802","Un",72124460,72124551,91
"18155","ENSMODG00000025811","Un",48296698,48296767,69
"18156","ENSMODG00000025812","Un",67402800,67402891,91
"18157","ENSMODG00000025813","5",291719903,291719988,85
"18158","ENSMODG00000025814","2",130471225,130471327,102
"18159","ENSMODG00000025815","Un",28299328,28299395,67
"18160","ENSMODG00000025816","5",66074337,66074399,62
"18161","ENSMODG00000025818","3",430288104,430288213,109
"18162","ENSMODG00000025819","4",7729700,7729770,70
"18163","ENSMODG00000025824","2",233883739,233883827,88
"18164","ENSMODG00000025827","4",347282326,347282394,68
"18165","ENSMODG00000025828","3",446461109,446461226,117
"18166","ENSMODG00000025833","2",38861230,38861322,92
"18167","ENSMODG00000025835","Un",32096947,32097015,68
"18168","ENSMODG00000025836","X",35202524,35202615,91
"18169","ENSMODG00000025839","X",35734441,35734531,90
"18170","ENSMODG00000025840","Un",68114947,68115038,91
"18171","ENSMODG00000025843","Un",70978807,70978899,92
"18172","ENSMODG00000025844","2",270698625,270698731,106
"18173","ENSMODG00000025849","X",35202204,35202325,121
"18174","ENSMODG00000025852","7",50385238,50385329,91
"18175","ENSMODG00000025853","3",446461502,446461573,71
"18176","ENSMODG00000025856","2",405141970,405142065,95
"18177","ENSMODG00000025857","2",517205525,517205605,80
"18178","ENSMODG00000025861","1",172794234,172794310,76
"18179","ENSMODG00000025863","Un",71861707,71861798,91
"18180","ENSMODG00000025865","2",300507708,300507810,102
"18181","ENSMODG00000025867","6",256407623,256407728,105
"18182","ENSMODG00000025869","Un",23520869,23520948,79
"18183","ENSMODG00000025870","2",322692512,322692583,71
"18184","ENSMODG00000025871","4",226229991,226230053,62
"18185","ENSMODG00000025872","6",17695901,17695974,73
"18186","ENSMODG00000025874","5",66074649,66074718,69
"18187","ENSMODG00000025876","4",318199560,318199649,89
"18188","ENSMODG00000025877","X",10078238,10078348,110
"18189","ENSMODG00000025878","1",122711570,122711659,89
"18190","ENSMODG00000025879","8",108475449,108475516,67
"18191","ENSMODG00000025881","4",318199416,318199498,82
"18192","ENSMODG00000025882","3",446525995,446526080,85
"18193","ENSMODG00000025885","2",506777375,506777436,61
"18194","ENSMODG00000025886","8",190600409,190600472,63
"18195","ENSMODG00000025887","1",377173845,377173914,69
"18196","ENSMODG00000025888","8",11049697,11049775,78
"18197","ENSMODG00000025891","2",64368078,64368187,109
"18198","ENSMODG00000025893","3",17545606,17545684,78
"18199","ENSMODG00000025894","7",108468894,108468978,84
"18200","ENSMODG00000025895","5",66074864,66074922,58
"18201","ENSMODG00000025896","2",517587363,517587453,90
"18202","ENSMODG00000025897","7",108468191,108468268,77
"18203","ENSMODG00000025898","3",173742224,173742316,92
"18204","ENSMODG00000025900","6",166669166,166669244,78
"18205","ENSMODG00000025902","8",11048200,11048287,87
"18206","ENSMODG00000025903","3",446526144,446526216,72
"18207","ENSMODG00000025904","2",174133935,174134008,73
"18208","ENSMODG00000025906","2",257689983,257690071,88
"18209","ENSMODG00000025907","2",99873079,99873142,63
"18210","ENSMODG00000025909","3",263364374,263364459,85
"18211","ENSMODG00000025910","2",26267862,26267944,82
"18212","ENSMODG00000025913","3",452650279,452650393,114
"18213","ENSMODG00000025916","1",476676434,476676529,95
"18214","ENSMODG00000025918","4",424720151,424720242,91
"18215","ENSMODG00000025922","3",441600213,441600322,109
"18216","ENSMODG00000025923","4",424723783,424723871,88
"18217","ENSMODG00000025924","2",114183764,114183874,110
"18218","ENSMODG00000025925","8",293031764,293031853,89
"18219","ENSMODG00000025926","4",123574173,123574254,81
"18220","ENSMODG00000025929","7",174297322,174297389,67
"18221","ENSMODG00000025933","X",35202369,35202464,95
"18222","ENSMODG00000025936","6",197334847,197334931,84
"18223","ENSMODG00000025938","3",429645658,429645744,86
"18224","ENSMODG00000025939","2",322643003,322643115,112
"18225","ENSMODG00000025940","2",255708032,255708103,71
"18226","ENSMODG00000025946","3",414604722,414604805,83
"18227","ENSMODG00000025947","1",123558703,123558814,111
"18228","ENSMODG00000025949","2",191328841,191328929,88
"18229","ENSMODG00000025950","X",35203046,35203114,68
"18230","ENSMODG00000025951","2",201215966,201216060,94
"18231","ENSMODG00000025959","2",114184514,114184594,80
"18232","ENSMODG00000025968","2",73846327,73846430,103
"18233","ENSMODG00000025969","4",297492356,297492485,129
"18234","ENSMODG00000025970","2",267721806,267721940,134
"18235","ENSMODG00000025973","7",194116769,194116849,80
"18236","ENSMODG00000025978","1",497003564,497003660,96
"18237","ENSMODG00000025979","6",275141825,275141961,136
"18238","ENSMODG00000025981","1",312869200,312869324,124
"18239","ENSMODG00000025982","2",407250667,407250738,71
"18240","ENSMODG00000025983","2",506693575,506693681,106
"18241","ENSMODG00000025985","6",276309067,276309143,76
"18242","ENSMODG00000025992","5",235245917,235246086,169
"18243","ENSMODG00000025993","8",251522981,251523101,120
"18244","ENSMODG00000025994","2",211815232,211815305,73
"18245","ENSMODG00000025995","2",66319844,66319926,82
"18246","ENSMODG00000025997","2",255042949,255043092,143
"18247","ENSMODG00000026004","2",66319618,66319689,71
"18248","ENSMODG00000026007","3",440394424,440394489,65
"18249","ENSMODG00000026010","4",75712168,75712274,106
"18250","ENSMODG00000026011","2",517793394,517793487,93
"18251","ENSMODG00000026019","5",300774085,300774151,66
"18252","ENSMODG00000026021","5",300773499,300773621,122
"18253","ENSMODG00000026022","2",508387905,508388046,141
"18254","ENSMODG00000026023","2",370688504,370688622,118
"18255","ENSMODG00000026025","Un",30347834,30347908,74
"18256","ENSMODG00000026027","1",703176719,703176804,85
"18257","ENSMODG00000026030","2",506649512,506649583,71
"18258","ENSMODG00000026031","1",464663731,464663864,133
"18259","ENSMODG00000026032","2",506648472,506648538,66
"18260","ENSMODG00000026033","6",94252106,94252207,101
"18261","ENSMODG00000026034","2",154917901,154918035,134
"18262","ENSMODG00000026035","1",427640136,427640239,103
"18263","ENSMODG00000026038","X",43229017,43229093,76
"18264","ENSMODG00000026041","8",72893563,72893669,106
"18265","ENSMODG00000026043","Un",70097259,70097408,149
"18266","ENSMODG00000026049","2",540248364,540248437,73
"18267","ENSMODG00000026050","2",268002674,268002735,61
"18268","ENSMODG00000026051","2",536432615,536432744,129
"18269","ENSMODG00000026053","6",853407,853539,132
"18270","ENSMODG00000026054","6",157435525,157435607,82
"18271","ENSMODG00000026055","X",11630448,11630585,137
"18272","ENSMODG00000026057","2",268003674,268003742,68
"18273","ENSMODG00000026058","5",300775376,300775453,77
"18274","ENSMODG00000026065","5",248270422,248270552,130
"18275","ENSMODG00000026066","5",126920196,126920259,63
"18276","ENSMODG00000026067","2",540244451,540244527,76
"18277","ENSMODG00000026074","2",449731271,449731373,102
"18278","ENSMODG00000026077","5",300774824,300774950,126
"18279","ENSMODG00000026080","2",212982795,212982899,104
"18280","ENSMODG00000026081","8",64656660,64656752,92
"18281","ENSMODG00000026082","2",66318508,66318572,64
"18282","ENSMODG00000026083","4",423554848,423554982,134
"18283","ENSMODG00000026084","4",265668652,265668734,82
"18284","ENSMODG00000026088","2",520355102,520355174,72
"18285","ENSMODG00000026092","4",265458774,265458902,128
"18286","ENSMODG00000026094","7",169968721,169968847,126
"18287","ENSMODG00000026098","3",234018951,234019030,79
"18288","ENSMODG00000026099","4",249040975,249041078,103
"18289","ENSMODG00000026101","1",659832133,659832238,105
"18290","ENSMODG00000026102","1",497003982,497004073,91
"18291","ENSMODG00000026104","2",442171274,442171410,136
"18292","ENSMODG00000026107","6",246445994,246446134,140
"18293","ENSMODG00000026115","6",122733472,122733752,280
"18294","ENSMODG00000026117","2",520354177,520354250,73
"18295","ENSMODG00000026119","1",15502418,15502567,149
"18296","ENSMODG00000026121","4",431199454,431199539,85
"18297","ENSMODG00000026123","4",248030068,248030171,103
"18298","ENSMODG00000026124","2",11542125,11542263,138
"18299","ENSMODG00000026126","4",431252715,431252801,86
"18300","ENSMODG00000026129","7",195148051,195148175,124
"18301","ENSMODG00000026130","4",265668415,265668483,68
"18302","ENSMODG00000026131","6",276312195,276312271,76
"18303","ENSMODG00000026136","1",170001934,170002044,110
"18304","ENSMODG00000026140","5",237929877,237929944,67
"18305","ENSMODG00000026141","2",520355948,520356020,72
"18306","ENSMODG00000026144","7",167365605,167365710,105
"18307","ENSMODG00000026147","8",76097756,76097994,238
"18308","ENSMODG00000026148","1",497005778,497005868,90
"18309","ENSMODG00000026149","2",188577244,188577383,139
"18310","ENSMODG00000026150","5",283781516,283781626,110
"18311","ENSMODG00000026152","2",66316913,66316991,78
"18312","ENSMODG00000026162","3",466626263,466626397,134
"18313","ENSMODG00000026163","2",540247683,540247759,76
"18314","ENSMODG00000026165","5",126921945,126922016,71
"18315","ENSMODG00000026172","7",258653784,258653864,80
"18316","ENSMODG00000026177","5",60986184,60986259,75
"18317","ENSMODG00000026179","3",186849091,186849177,86
"18318","ENSMODG00000026180","7",30942340,30942428,88
"18319","ENSMODG00000026181","Un",26971835,26971904,69
"18320","ENSMODG00000026190","1",172843312,172843388,76
"18321","ENSMODG00000026194","2",107173631,107173728,97
"18322","ENSMODG00000026198","6",252907345,252907426,81
"18323","ENSMODG00000026202","5",283958736,283958847,111
"18324","ENSMODG00000026207","3",299142516,299142605,89
"18325","ENSMODG00000026215","X",11206305,11206395,90
"18326","ENSMODG00000026244","2",37795248,37795311,63
"18327","ENSMODG00000026257","1",186565467,186565541,74
"18328","ENSMODG00000026258","5",220903817,220903912,95
"18329","ENSMODG00000026267","4",381794441,381794532,91
"18330","ENSMODG00000026279","4",183165423,183165509,86
"18331","ENSMODG00000026295","3",442762750,442762827,77
"18332","ENSMODG00000026297","4",217155013,217155140,127
"18333","ENSMODG00000026298","2",407252030,407252113,83
"18334","ENSMODG00000026303","1",576972053,576972105,52
"18335","ENSMODG00000026304","2",541547258,541547317,59
"18336","ENSMODG00000026306","4",367803094,367803236,142
"18337","ENSMODG00000026311","1",28201150,28201215,65
"18338","ENSMODG00000026312","X",13994221,13994302,81
"18339","ENSMODG00000026313","4",118399218,118399343,125
"18340","ENSMODG00000026317","7",242646417,242646532,115
"18341","ENSMODG00000026322","5",173200902,173201023,121
"18342","ENSMODG00000026324","4",318563613,318563701,88
"18343","ENSMODG00000026325","5",81574658,81574742,84
"18344","ENSMODG00000026327","8",284174093,284174170,77
"18345","ENSMODG00000026334","2",66320148,66320208,60
"18346","ENSMODG00000026340","X",13990714,13990795,81
"18347","ENSMODG00000026343","7",22060032,22060124,92
"18348","ENSMODG00000026346","2",67179241,67179328,87
"18349","ENSMODG00000026349","1",708257052,708257140,88
"18350","ENSMODG00000026354","8",293063106,293063175,69
"18351","ENSMODG00000026355","1",708253165,708253244,79
"18352","ENSMODG00000026362","Un",60423748,60423810,62
"18353","ENSMODG00000026365","1",462066050,462066177,127
"18354","ENSMODG00000026369","5",248271368,248271499,131
"18355","ENSMODG00000026370","4",400891414,400891481,67
"18356","ENSMODG00000026372","1",580149257,580149333,76
"18357","ENSMODG00000026373","X",14001355,14001436,81
"18358","ENSMODG00000026377","Un",45366276,45366406,130
"18359","ENSMODG00000026378","2",426780983,426781102,119
"18360","ENSMODG00000026381","X",69822336,69822418,82
"18361","ENSMODG00000026384","7",18763501,18763561,60
"18362","ENSMODG00000026392","5",233323913,233324026,113
"18363","ENSMODG00000026393","X",14010505,14010586,81
"18364","ENSMODG00000026394","7",63678666,63678781,115
"18365","ENSMODG00000026395","4",335163695,335163785,90
"18366","ENSMODG00000026397","Un",72630670,72630758,88
"18367","ENSMODG00000026402","3",407165702,407165823,121
"18368","ENSMODG00000026403","8",21186900,21187023,123
"18369","ENSMODG00000026407","1",161172932,161172996,64
"18370","ENSMODG00000026410","1",717381126,717381262,136
"18371","ENSMODG00000026412","X",14005428,14005509,81
"18372","ENSMODG00000026414","8",300840052,300840128,76
"18373","ENSMODG00000026419","2",261412909,261413027,118
"18374","ENSMODG00000026420","1",314539585,314539712,127
"18375","ENSMODG00000026425","2",510997709,510997791,82
"18376","ENSMODG00000026426","1",72640994,72641094,100
"18377","ENSMODG00000026430","4",2595796,2595872,76
"18378","ENSMODG00000026431","Un",56032818,56032908,90
"18379","ENSMODG00000026432","X",13978259,13978340,81
"18380","ENSMODG00000026434","6",72197186,72197309,123
"18381","ENSMODG00000026446","X",14003847,14003918,71
"18382","ENSMODG00000026449","2",66318950,66319012,62
"18383","ENSMODG00000026450","2",103167747,103167852,105
"18384","ENSMODG00000026458","8",243118540,243118670,130
"18385","ENSMODG00000026460","7",225273017,225273121,104
"18386","ENSMODG00000026462","X",11632083,11632218,135
"18387","ENSMODG00000026469","2",277357776,277357897,121
"18388","ENSMODG00000026472","4",385520587,385520710,123
"18389","ENSMODG00000026478","3",509943803,509943932,129
"18390","ENSMODG00000026484","1",718817189,718817439,250
"18391","ENSMODG00000026487","4",265459317,265459449,132
"18392","ENSMODG00000026489","X",3166942,3167076,134
"18393","ENSMODG00000026495","3",102692999,102693104,105
"18394","ENSMODG00000026499","7",66618165,66618438,273
"18395","ENSMODG00000026500","1",458303473,458303578,105
"18396","ENSMODG00000026504","2",536435644,536435716,72
"18397","ENSMODG00000026510","4",319672412,319672585,173
"18398","ENSMODG00000026511","2",520881578,520881673,95
"18399","ENSMODG00000026516","7",206769159,206769290,131
"18400","ENSMODG00000026524","6",194973845,194973979,134
"18401","ENSMODG00000026528","2",66318048,66318128,80
"18402","ENSMODG00000026531","2",410652659,410652770,111
"18403","ENSMODG00000026533","7",48247613,48247729,116
"18404","ENSMODG00000026535","8",240555011,240555093,82
"18405","ENSMODG00000026555","2",9660350,9660482,132
"18406","ENSMODG00000026563","1",52631498,52631625,127
"18407","ENSMODG00000026564","3",328560722,328560849,127
"18408","ENSMODG00000026567","3",476543051,476543187,136
"18409","ENSMODG00000026568","7",204839810,204839875,65
"18410","ENSMODG00000026570","2",54151770,54151876,106
"18411","ENSMODG00000026571","2",199000374,199000508,134
"18412","ENSMODG00000026588","4",180735394,180735513,119
"18413","ENSMODG00000026590","1",741431765,741431878,113
"18414","ENSMODG00000026591","4",225494400,225494506,106
"18415","ENSMODG00000026594","5",28579153,28579213,60
"18416","ENSMODG00000026595","6",178553543,178553663,120
"18417","ENSMODG00000026596","3",227421548,227421684,136
"18418","ENSMODG00000026597","3",244425775,244425855,80
"18419","ENSMODG00000026600","1",70294481,70294679,198
"18420","ENSMODG00000026602","2",442165717,442165839,122
"18421","ENSMODG00000026604","1",168445201,168445348,147
"18422","ENSMODG00000026618","1",279572669,279572771,102
"18423","ENSMODG00000026622","5",173056234,173056354,120
"18424","ENSMODG00000026625","3",429282798,429282867,69
"18425","ENSMODG00000026626","1",709431296,709431436,140
"18426","ENSMODG00000026630","4",424337577,424337696,119
"18427","ENSMODG00000026632","2",322905710,322905816,106
"18428","ENSMODG00000026634","2",66317222,66317300,78
"18429","ENSMODG00000026640","2",516256251,516256357,106
"18430","ENSMODG00000026643","3",24453254,24453371,117
"18431","ENSMODG00000026650","8",136385413,136385498,85
"18432","ENSMODG00000026651","1",472807050,472807142,92
"18433","ENSMODG00000026654","2",492182745,492182873,128
"18434","ENSMODG00000026656","3",260270509,260270616,107
"18435","ENSMODG00000026660","2",199001502,199001641,139
"18436","ENSMODG00000026661","6",288213981,288214134,153
"18437","ENSMODG00000026665","1",666310997,666311090,93
"18438","ENSMODG00000026667","Un",54189075,54189203,128
"18439","ENSMODG00000026677","1",255429211,255429313,102
"18440","ENSMODG00000026681","4",314989757,314989835,78
"18441","ENSMODG00000026682","3",311115221,311115402,181
"18442","ENSMODG00000026684","4",297491975,297492050,75
"18443","ENSMODG00000026687","4",431218322,431218404,82
"18444","ENSMODG00000026688","4",377452729,377452831,102
"18445","ENSMODG00000026692","3",342838014,342838152,138
"18446","ENSMODG00000026696","Un",56033304,56033392,88
"18447","ENSMODG00000026697","1",332354981,332355106,125
"18448","ENSMODG00000026698","2",517793853,517793943,90
"18449","ENSMODG00000026701","1",117111138,117111226,88
"18450","ENSMODG00000026702","2",266865730,266865803,73
"18451","ENSMODG00000026707","3",170606325,170606412,87
"18452","ENSMODG00000026709","7",12349058,12349373,315
"18453","ENSMODG00000026713","4",265460839,265460969,130
"18454","ENSMODG00000026720","8",108478909,108479189,280
"18455","ENSMODG00000026721","1",257230933,257231073,140
"18456","ENSMODG00000026728","2",189523157,189523273,116
"18457","ENSMODG00000026730","2",211499587,211499727,140
"18458","ENSMODG00000026731","3",69757782,69757923,141
"18459","ENSMODG00000026734","1",501549999,501550103,104
"18460","ENSMODG00000026737","4",301904884,301904987,103
"18461","ENSMODG00000026739","7",255847280,255847380,100
"18462","ENSMODG00000026744","6",201713556,201713632,76
"18463","ENSMODG00000026745","3",28150543,28150664,121
"18464","ENSMODG00000026750","2",206387754,206387845,91
"18465","ENSMODG00000026764","1",497004390,497004481,91
"18466","ENSMODG00000026783","Un",101014151,101014245,94
"18467","ENSMODG00000026785","5",43101691,43101795,104
"18468","ENSMODG00000026787","4",354384986,354385081,95
"18469","ENSMODG00000026788","2",254532304,254532455,151
"18470","ENSMODG00000026793","3",429281586,429281656,70
"18471","ENSMODG00000026794","6",120643965,120644022,57
"18472","ENSMODG00000026799","4",31426551,31426772,221
"18473","ENSMODG00000026802","4",84027911,84028007,96
"18474","ENSMODG00000026803","1",168452256,168452332,76
"18475","ENSMODG00000026804","4",75095796,75095934,138
"18476","ENSMODG00000026808","2",504196637,504196743,106
"18477","ENSMODG00000026810","8",221297312,221297388,76
"18478","ENSMODG00000026814","1",388424206,388424284,78
"18479","ENSMODG00000026818","1",121495763,121495860,97
"18480","ENSMODG00000026820","Un",13961419,13961549,130
"18481","ENSMODG00000026821","8",107878675,107879001,326
"18482","ENSMODG00000026826","7",206772418,206772486,68
"18483","ENSMODG00000026827","2",481746696,481746798,102
"18484","ENSMODG00000026828","1",255634968,255635053,85
"18485","ENSMODG00000026829","5",300774336,300774406,70
"18486","ENSMODG00000026830","8",214350364,214350466,102
"18487","ENSMODG00000026833","1",90066572,90066698,126
"18488","ENSMODG00000026836","Un",50627192,50627286,94
"18489","ENSMODG00000026838","3",184035115,184035182,67
"18490","ENSMODG00000026840","2",197246514,197246632,118
"18491","ENSMODG00000026841","4",92808822,92808900,78
"18492","ENSMODG00000026844","1",127296817,127296888,71
"18493","ENSMODG00000026848","2",458060530,458060828,298
"18494","ENSMODG00000026852","7",204899848,204900120,272
"18495","ENSMODG00000026854","1",329586306,329586380,74
"18496","ENSMODG00000026856","5",232970831,232970956,125
"18497","ENSMODG00000026857","8",268769024,268769121,97
"18498","ENSMODG00000026862","1",152727119,152727189,70
"18499","ENSMODG00000026864","1",309211091,309211216,125
"18500","ENSMODG00000026865","2",11804397,11804495,98
"18501","ENSMODG00000026866","Un",50633892,50633988,96
"18502","ENSMODG00000026877","8",165780584,165780660,76
"18503","ENSMODG00000026879","5",245385045,245385243,198
"18504","ENSMODG00000026890","4",148860307,148860394,87
"18505","ENSMODG00000026893","1",311820590,311820727,137
"18506","ENSMODG00000026894","1",117653015,117653125,110
"18507","ENSMODG00000026895","5",300775695,300775763,68
"18508","ENSMODG00000026897","3",436313383,436313541,158
"18509","ENSMODG00000026898","2",190775389,190775517,128
"18510","ENSMODG00000026899","2",302262088,302262220,132
"18511","ENSMODG00000026901","Un",66362419,66362527,108
"18512","ENSMODG00000026904","2",290525938,290526041,103
"18513","ENSMODG00000026907","1",90196892,90196998,106
"18514","ENSMODG00000026915","1",18501346,18501457,111
"18515","ENSMODG00000026917","1",152729980,152730080,100
"18516","ENSMODG00000026918","6",276311485,276311564,79
"18517","ENSMODG00000026923","1",326692947,326693220,273
"18518","ENSMODG00000026924","2",66316671,66316746,75
"18519","ENSMODG00000026925","2",190840408,190840496,88
"18520","ENSMODG00000026927","6",61527798,61527904,106
"18521","ENSMODG00000026928","6",157435772,157435855,83
"18522","ENSMODG00000026941","1",566130679,566130781,102
"18523","ENSMODG00000026942","8",91705061,91705204,143
"18524","ENSMODG00000026943","Un",67403348,67403444,96
"18525","ENSMODG00000026948","5",173201621,173201741,120
"18526","ENSMODG00000026949","2",510678406,510678490,84
"18527","ENSMODG00000026950","3",258878774,258879050,276
"18528","ENSMODG00000026952","2",515269357,515269448,91
"18529","ENSMODG00000026957","2",242062448,242062627,179
"18530","ENSMODG00000026959","3",474642461,474642565,104
"18531","ENSMODG00000026962","7",189595317,189595435,118
"18532","ENSMODG00000026964","Un",54190146,54190249,103
"18533","ENSMODG00000026967","3",428145836,428145922,86
"18534","ENSMODG00000026969","2",391111799,391111883,84
"18535","ENSMODG00000026970","5",268810474,268810583,109
"18536","ENSMODG00000026972","2",345584361,345584479,118
"18537","ENSMODG00000026974","1",196080578,196080677,99
"18538","ENSMODG00000026984","4",412978949,412979038,89
"18539","ENSMODG00000026993","3",244736569,244736673,104
"18540","ENSMODG00000027000","4",265459613,265459683,70
"18541","ENSMODG00000027002","2",211499292,211499358,66
"18542","ENSMODG00000027005","Un",60423626,60423687,61
"18543","ENSMODG00000027007","5",250649171,250649316,145
"18544","ENSMODG00000027010","7",206770032,206770214,182
"18545","ENSMODG00000027016","2",533720417,533720535,118
"18546","ENSMODG00000027019","Un",67410060,67410154,94
"18547","ENSMODG00000027025","3",170605007,170605099,92
"18548","ENSMODG00000027032","1",173434956,173435053,97
"18549","ENSMODG00000027033","5",175500616,175500919,303
"18550","ENSMODG00000027037","5",126919891,126919956,65
"18551","ENSMODG00000027039","8",110208874,110208977,103
"18552","ENSMODG00000027040","1",333065084,333065183,99
"18553","ENSMODG00000027041","1",460619632,460619697,65
"18554","ENSMODG00000027044","3",163315518,163315621,103
"18555","ENSMODG00000027045","3",238832513,238832619,106
"18556","ENSMODG00000027049","2",26554633,26554758,125
"18557","ENSMODG00000027052","1",330614728,330614835,107
"18558","ENSMODG00000027058","Un",50631398,50631550,152
"18559","ENSMODG00000027059","1",591599388,591599535,147
"18560","ENSMODG00000027060","2",289338919,289339026,107
"18561","ENSMODG00000027063","1",330615360,330615560,200
"18562","ENSMODG00000027065","2",275854790,275854897,107
"18563","ENSMODG00000027068","X",35202082,35202170,88
"18564","ENSMODG00000027069","Un",67401232,67401306,74
"18565","ENSMODG00000027070","5",237929015,237929099,84
"18566","ENSMODG00000027071","5",300776314,300776385,71
"18567","ENSMODG00000027074","4",167306726,167306842,116
"18568","ENSMODG00000027084","Un",99584064,99584158,94
"18569","ENSMODG00000027088","1",240925623,240925750,127
"18570","ENSMODG00000027093","Un",67401442,67401527,85
"18571","ENSMODG00000027095","3",375309279,375309392,113
"18572","ENSMODG00000027096","4",412979285,412979367,82
"18573","ENSMODG00000027097","2",520372954,520373229,275
"18574","ENSMODG00000027100","1",170217989,170218070,81
"18575","ENSMODG00000027106","4",412977836,412977921,85
"18576","ENSMODG00000027109","1",590757335,590757446,111
"18577","ENSMODG00000027113","3",31246278,31246408,130
"18578","ENSMODG00000027117","8",232301465,232301556,91
"18579","ENSMODG00000027123","1",152728740,152728839,99
"18580","ENSMODG00000027126","3",39719581,39719669,88
"18581","ENSMODG00000027127","7",78171095,78171191,96
"18582","ENSMODG00000027130","1",494988379,494988452,73
"18583","ENSMODG00000027132","8",291844419,291844530,111
"18584","ENSMODG00000027133","3",405207425,405207540,115
"18585","ENSMODG00000027135","2",257960426,257960507,81
"18586","ENSMODG00000027137","1",152729489,152729561,72
"18587","ENSMODG00000027141","Un",67400671,67400758,87
"18588","ENSMODG00000027145","1",329583129,329583200,71
"18589","ENSMODG00000027148","8",88488145,88488252,107
"18590","ENSMODG00000027149","X",18392010,18392113,103
"18591","ENSMODG00000027155","6",216920309,216920413,104
"18592","ENSMODG00000027156","2",520384198,520384489,291
"18593","ENSMODG00000027157","4",431314252,431314333,81
"18594","ENSMODG00000027160","4",335187749,335187852,103
"18595","ENSMODG00000027161","2",196785374,196785476,102
"18596","ENSMODG00000027162","2",197510500,197510604,104
"18597","ENSMODG00000027164","1",168448369,168448445,76
"18598","ENSMODG00000027165","Un",50636132,50636205,73
"18599","ENSMODG00000027171","5",80616842,80616943,101
"18600","ENSMODG00000027173","2",531188614,531188754,140
"18601","ENSMODG00000027178","3",34849336,34849598,262
"18602","ENSMODG00000027179","8",220777344,220777443,99
"18603","ENSMODG00000027181","8",177568001,177568109,108
"18604","ENSMODG00000027182","2",68679603,68679742,139
"18605","ENSMODG00000027183","4",345211964,345212064,100
"18606","ENSMODG00000027184","5",254129766,254129885,119
"18607","ENSMODG00000027187","1",197621495,197621780,285
"18608","ENSMODG00000027190","1",255825136,255825201,65
"18609","ENSMODG00000027191","6",70744326,70744436,110
"18610","ENSMODG00000027192","2",277042812,277042917,105
"18611","ENSMODG00000027195","3",69758046,69758128,82
"18612","ENSMODG00000027197","5",301657744,301657869,125
"18613","ENSMODG00000027203","2",255042159,255042295,136
"18614","ENSMODG00000027210","4",412978649,412978735,86
"18615","ENSMODG00000027212","1",418049552,418049651,99
"18616","ENSMODG00000027216","7",242654398,242654710,312
"18617","ENSMODG00000027225","6",12672921,12673020,99
"18618","ENSMODG00000027226","Un",71862255,71862351,96
"18619","ENSMODG00000027228","1",454365397,454365488,91
"18620","ENSMODG00000027229","8",248811515,248811681,166
"18621","ENSMODG00000027233","3",338339370,338339481,111
"18622","ENSMODG00000027235","4",191902812,191902946,134
"18623","ENSMODG00000027237","1",559896283,559896381,98
"18624","ENSMODG00000027238","4",366840531,366840697,166
"18625","ENSMODG00000027240","1",152725829,152725900,71
"18626","ENSMODG00000027247","4",412978397,412978469,72
"18627","ENSMODG00000027248","7",129961787,129961928,141
"18628","ENSMODG00000027249","2",530156686,530156815,129
"18629","ENSMODG00000027252","5",300776064,300776138,74
"18630","ENSMODG00000027255","7",177519001,177519102,101
"18631","ENSMODG00000027256","2",506650493,506650561,68
"18632","ENSMODG00000027257","2",482079428,482079534,106
"18633","ENSMODG00000027258","4",308517940,308518041,101
"18634","ENSMODG00000027259","1",173429725,173429852,127
"18635","ENSMODG00000027260","7",18594190,18594301,111
"18636","ENSMODG00000027265","Un",50635915,50636000,85
"18637","ENSMODG00000027271","1",112938987,112939119,132
"18638","ENSMODG00000027273","Un",46252493,46252574,81
"18639","ENSMODG00000027274","1",502669250,502669349,99
"18640","ENSMODG00000027275","6",236240099,236240233,134
"18641","ENSMODG00000027276","6",156924940,156925069,129
"18642","ENSMODG00000027277","1",152561698,152561833,135
"18643","ENSMODG00000027285","1",240735318,240735422,104
"18644","ENSMODG00000027286","1",79216707,79216764,57
"18645","ENSMODG00000027288","1",308068225,308068335,110
"18646","ENSMODG00000027296","1",581375653,581375750,97
"18647","ENSMODG00000027298","2",478122325,478122769,444
"18648","ENSMODG00000027301","4",168086480,168087503,1023
"18649","ENSMODG00000027302","Un",44233156,44250254,17098
"18650","ENSMODG00000027303","3",397276398,397277321,923
"18651","ENSMODG00000027304","8",127313121,127314400,1279
"18652","ENSMODG00000027305","8",140494205,140495761,1556
"18653","ENSMODG00000027306","Un",315760,319695,3935
"18654","ENSMODG00000027307","4",290398381,290419109,20728
"18655","ENSMODG00000027308","Un",19642783,19645649,2866
"18656","ENSMODG00000027310","Un",64542956,64546944,3988
"18657","ENSMODG00000027311","3",436792552,436793688,1136
"18658","ENSMODG00000027312","4",355846709,355927657,80948
"18659","ENSMODG00000027313","Un",99030885,99031944,1059
"18660","ENSMODG00000027314","X",58682154,58691802,9648
"18661","ENSMODG00000027315","Un",87165223,87167807,2584
"18662","ENSMODG00000027316","8",106318757,106320745,1988
"18663","ENSMODG00000027317","3",49587100,49588158,1058
"18664","ENSMODG00000027318","3",434613703,434624761,11058
"18665","ENSMODG00000027319","2",93168474,93169567,1093
"18666","ENSMODG00000027320","4",419726853,419830720,103867
"18667","ENSMODG00000027321","8",174273434,174291066,17632
"18668","ENSMODG00000027322","Un",53777431,53778750,1319
"18669","ENSMODG00000027323","Un",72427504,72440392,12888
"18670","ENSMODG00000027324","1",81071485,81072758,1273
"18671","ENSMODG00000027325","1",124689005,124690322,1317
"18672","ENSMODG00000027326","2",104291313,104352208,60895
"18673","ENSMODG00000027327","4",354583968,354585035,1067
"18674","ENSMODG00000027328","6",205553005,205665442,112437
"18675","ENSMODG00000027329","5",13031423,13033830,2407
"18676","ENSMODG00000027330","8",214697926,214702660,4734
"18677","ENSMODG00000027331","Un",91220262,91224871,4609
"18678","ENSMODG00000027332","4",353185424,353186614,1190
"18679","ENSMODG00000027333","1",85146199,85155658,9459
"18680","ENSMODG00000027334","Un",51041066,51082231,41165
"18681","ENSMODG00000027335","4",36856161,36858327,2166
"18682","ENSMODG00000027336","7",168882079,168885422,3343
"18683","ENSMODG00000027337","1",427583850,427586841,2991
"18684","ENSMODG00000027338","X",9948300,9986849,38549
"18685","ENSMODG00000027339","8",294944497,294963626,19129
"18686","ENSMODG00000027340","1",16609894,16616332,6438
"18687","ENSMODG00000027341","3",272019040,272114769,95729
"18688","ENSMODG00000027342","1",234577292,234578548,1256
"18689","ENSMODG00000027343","7",186909513,187129763,220250
"18690","ENSMODG00000027344","X",25095918,25097747,1829
"18691","ENSMODG00000027345","7",106563410,106565780,2370
"18692","ENSMODG00000027346","1",71757288,71865457,108169
"18693","ENSMODG00000027347","Un",85575132,85578600,3468
"18694","ENSMODG00000027348","1",480065039,480066350,1311
"18695","ENSMODG00000027349","4",5425843,5427154,1311
"18696","ENSMODG00000027350","6",218575025,218670035,95010
"18697","ENSMODG00000027351","3",210464033,210465046,1013
"18698","ENSMODG00000027352","1",171253022,171254762,1740
"18699","ENSMODG00000027353","4",215098334,215100018,1684
"18700","ENSMODG00000027354","6",198153832,198160829,6997
"18701","ENSMODG00000027355","2",7109792,7110849,1057
"18702","ENSMODG00000027356","8",15478302,15479360,1058
"18703","ENSMODG00000027357","5",241541982,241543068,1086
"18704","ENSMODG00000027358","2",439596952,439602227,5275
"18705","ENSMODG00000027359","8",108253911,108258922,5011
"18706","ENSMODG00000027360","X",72310089,72317216,7127
"18707","ENSMODG00000027361","X",69401299,69422776,21477
"18708","ENSMODG00000027363","4",435120637,435137738,17101
"18709","ENSMODG00000027364","3",223142714,223144016,1302
"18710","ENSMODG00000027365","3",454701820,454702869,1049
"18711","ENSMODG00000027366","1",277378756,277379802,1046
"18712","ENSMODG00000027367","6",93517312,93518883,1571
"18713","ENSMODG00000027368","2",150706861,150708627,1766
"18714","ENSMODG00000027369","4",376156187,376161462,5275
"18715","ENSMODG00000027370","7",184994334,184995745,1411
"18716","ENSMODG00000027371","6",104946584,104947705,1121
"18717","ENSMODG00000027372","2",142608740,142721304,112564
"18718","ENSMODG00000027373","8",12065445,12068352,2907
"18719","ENSMODG00000027374","4",409484319,409493005,8686
"18720","ENSMODG00000027376","8",214472564,214482972,10408
"18721","ENSMODG00000027377","8",83577331,83578350,1019
"18722","ENSMODG00000027378","Un",46858521,46869675,11154
"18723","ENSMODG00000027379","Un",23155867,23167834,11967
"18724","ENSMODG00000027380","1",225336071,225344637,8566
"18725","ENSMODG00000027381","7",30192780,30193779,999
"18726","ENSMODG00000027382","2",31438650,31441602,2952
"18727","ENSMODG00000027383","Un",71174549,71180676,6127
"18728","ENSMODG00000027384","6",85501917,85562186,60269
"18729","ENSMODG00000027385","Un",92001267,92002497,1230
"18730","ENSMODG00000027386","7",245001377,245030273,28896
"18731","ENSMODG00000027387","2",356818577,356961527,142950
"18732","ENSMODG00000027388","3",412892610,413036429,143819
"18733","ENSMODG00000027389","6",103498218,103499403,1185
"18734","ENSMODG00000027390","4",175805056,175905728,100672
"18735","ENSMODG00000027391","6",51674453,51690526,16073
"18736","ENSMODG00000027392","2",169232033,169276585,44552
"18737","ENSMODG00000027393","2",183872437,183889994,17557
"18738","ENSMODG00000027394","Un",94464612,94465774,1162
"18739","ENSMODG00000027395","6",171691134,171693111,1977
"18740","ENSMODG00000027396","5",97898650,97899703,1053
"18741","ENSMODG00000027397","8",182238317,182239681,1364
"18742","ENSMODG00000027398","X",39010656,39019165,8509
"18743","ENSMODG00000027399","1",488289298,488350364,61066
"18744","ENSMODG00000027400","1",482561315,482571905,10590
"18745","ENSMODG00000027401","7",245255664,245349079,93415
"18746","ENSMODG00000027402","1",167581574,167583258,1684
"18747","ENSMODG00000027403","6",226568049,226744307,176258
"18748","ENSMODG00000027404","8",14874026,14876752,2726
"18749","ENSMODG00000027406","1",472090186,472091437,1251
"18750","ENSMODG00000027407","1",468726361,468727401,1040
"18751","ENSMODG00000027408","8",113474625,113484467,9842
"18752","ENSMODG00000027409","6",26592608,26596523,3915
"18753","ENSMODG00000027411","4",259050485,259052328,1843
"18754","ENSMODG00000027412","2",495407929,495441924,33995
"18755","ENSMODG00000027413","2",32868520,32964453,95933
"18756","ENSMODG00000027414","3",142978459,142979494,1035
"18757","ENSMODG00000027415","4",388068462,388069598,1136
"18758","ENSMODG00000027416","1",19259157,19266152,6995
"18759","ENSMODG00000027418","2",101504848,101505943,1095
"18760","ENSMODG00000027419","5",298457368,298474816,17448
"18761","ENSMODG00000027421","6",124279487,124283154,3667
"18762","ENSMODG00000027422","2",75246363,75247670,1307
"18763","ENSMODG00000027423","2",139003835,139111977,108142
"18764","ENSMODG00000027424","3",264178812,264179869,1057
"18765","ENSMODG00000027425","Un",65339947,65348177,8230
"18766","ENSMODG00000027427","4",103996545,103997757,1212
"18767","ENSMODG00000027428","7",16810375,16814907,4532
"18768","ENSMODG00000027429","4",151049000,151050195,1195
"18769","ENSMODG00000027430","2",218882271,218883584,1313
"18770","ENSMODG00000027431","4",354492761,354532247,39486
"18771","ENSMODG00000027432","3",514198002,514199028,1026
"18772","ENSMODG00000027433","8",72268569,72314029,45460
"18773","ENSMODG00000027434","Un",32987419,33006227,18808
"18774","ENSMODG00000027435","4",401945547,401981348,35801
"18775","ENSMODG00000027437","3",331703661,331736656,32995
"18776","ENSMODG00000027439","3",300040601,300042021,1420
"18777","ENSMODG00000027440","Un",20744265,20746539,2274
"18778","ENSMODG00000027441","4",369277660,369381080,103420
"18779","ENSMODG00000027442","3",425116870,425120867,3997
"18780","ENSMODG00000027443","Un",53325324,53365493,40169
"18781","ENSMODG00000027444","5",293297713,293335823,38110
"18782","ENSMODG00000027445","6",282502461,282504938,2477
"18783","ENSMODG00000027446","6",199281180,199312427,31247
"18784","ENSMODG00000027447","8",31995241,32002759,7518
"18785","ENSMODG00000027448","3",489793037,489795510,2473
"18786","ENSMODG00000027449","6",80241465,80242738,1273
"18787","ENSMODG00000027450","2",30564832,30565847,1015
"18788","ENSMODG00000027452","3",31682373,31844976,162603
"18789","ENSMODG00000027453","2",533170798,533235701,64903
"18790","ENSMODG00000027454","5",48740812,48741955,1143
"18791","ENSMODG00000027455","2",536294406,536295792,1386
"18792","ENSMODG00000027457","X",37445944,37509967,64023
"18793","ENSMODG00000027458","3",121240382,121241732,1350
"18794","ENSMODG00000027459","Un",65084596,65085604,1008
"18795","ENSMODG00000027461","2",255670386,255677085,6699
"18796","ENSMODG00000027462","1",380611323,380612602,1279
"18797","ENSMODG00000027463","7",221142667,221148048,5381
"18798","ENSMODG00000027464","Un",97177292,97178751,1459
"18799","ENSMODG00000027466","4",86678804,86679987,1183
"18800","ENSMODG00000027467","6",150525893,150526903,1010
"18801","ENSMODG00000027468","8",64894332,64916105,21773
"18802","ENSMODG00000027469","3",294646046,294647077,1031
"18803","ENSMODG00000027470","1",60116300,60128329,12029
"18804","ENSMODG00000027471","4",287689793,287708425,18632
"18805","ENSMODG00000027472","1",178453766,178508512,54746
"18806","ENSMODG00000027473","2",36165046,36169938,4892
"18807","ENSMODG00000027474","2",508174869,508198362,23493
"18808","ENSMODG00000027475","4",89375153,89390419,15266
"18809","ENSMODG00000027476","2",283111957,283158249,46292
"18810","ENSMODG00000027477","3",462904250,462911564,7314
"18811","ENSMODG00000027478","4",389082021,389141666,59645
"18812","ENSMODG00000027479","7",135186864,135187875,1011
"18813","ENSMODG00000027481","1",449262287,449292955,30668
"18814","ENSMODG00000027482","7",22043312,22049616,6304
"18815","ENSMODG00000027483","4",399957935,399971495,13560
"18816","ENSMODG00000027484","2",532498721,532508373,9652
"18817","ENSMODG00000027485","1",379210810,379267402,56592
"18818","ENSMODG00000027486","2",242152274,242153605,1331
"18819","ENSMODG00000027488","Un",6886953,6915909,28956
"18820","ENSMODG00000027489","2",37626132,37661794,35662
"18821","ENSMODG00000027490","7",241410030,241414063,4033
"18822","ENSMODG00000027491","2",167073463,167097600,24137
"18823","ENSMODG00000027492","2",259517708,259519216,1508
"18824","ENSMODG00000027493","6",196484015,196491028,7013
"18825","ENSMODG00000027494","1",194763281,194792010,28729
"18826","ENSMODG00000027495","5",98484433,98485692,1259
"18827","ENSMODG00000027496","Un",74512360,74517436,5076
"18828","ENSMODG00000027497","Un",90830212,90835045,4833
"18829","ENSMODG00000027498","1",61722166,61723292,1126
"18830","ENSMODG00000027499","2",466559544,466635297,75753
"18831","ENSMODG00000027500","8",282651101,282653036,1935
"18832","ENSMODG00000027501","4",405385478,405390517,5039
"18833","ENSMODG00000027502","2",392529784,392531920,2136
"18834","ENSMODG00000027503","7",73558925,73561220,2295
"18835","ENSMODG00000027504","Un",57619596,57645518,25922
"18836","ENSMODG00000027505","3",506705656,506747073,41417
"18837","ENSMODG00000027506","4",75468257,75469768,1511
"18838","ENSMODG00000027507","5",14174629,14181868,7239
"18839","ENSMODG00000027509","2",255359109,255361770,2661
"18840","ENSMODG00000027510","4",405187342,405299579,112237
"18841","ENSMODG00000027511","3",261274383,261275579,1196
"18842","ENSMODG00000027512","2",457205863,457221720,15857
"18843","ENSMODG00000027513","5",134650312,134651342,1030
"18844","ENSMODG00000027514","7",242878049,242883199,5150
"18845","ENSMODG00000027515","5",258813441,258823295,9854
"18846","ENSMODG00000027516","2",60651057,60654638,3581
"18847","ENSMODG00000027517","1",414024383,414025527,1144
"18848","ENSMODG00000027518","5",133427317,133428567,1250
"18849","ENSMODG00000027519","5",253249927,253251003,1076
"18850","ENSMODG00000027520","2",41963529,41967519,3990
"18851","ENSMODG00000027521","8",188277897,188279928,2031
"18852","ENSMODG00000027522","2",244918092,244919099,1007
"18853","ENSMODG00000027524","2",274719092,274720945,1853
"18854","ENSMODG00000027525","5",224599921,224625378,25457
"18855","ENSMODG00000027526","8",269331941,269333113,1172
"18856","ENSMODG00000027527","3",228101208,228177743,76535
"18857","ENSMODG00000027529","5",148204757,148206041,1284
"18858","ENSMODG00000027530","4",266062745,266064263,1518
"18859","ENSMODG00000027531","6",128608595,128790459,181864
"18860","ENSMODG00000027532","5",34781674,34815094,33420
"18861","ENSMODG00000027533","3",428958195,428970958,12763
"18862","ENSMODG00000027534","5",126621543,126622934,1391
"18863","ENSMODG00000027535","Un",88674059,88676135,2076
"18864","ENSMODG00000027536","1",291803079,291807772,4693
"18865","ENSMODG00000027537","2",514331029,514331622,593
"18866","ENSMODG00000027538","3",495687471,495695275,7804
"18867","ENSMODG00000027539","Un",32751304,32782834,31530
"18868","ENSMODG00000027540","1",383337127,383338176,1049
"18869","ENSMODG00000027541","4",416948017,416949936,1919
"18870","ENSMODG00000027543","Un",52166446,52169030,2584
"18871","ENSMODG00000027544","4",318851749,318897728,45979
"18872","ENSMODG00000027545","4",410417988,410419489,1501
"18873","ENSMODG00000027546","6",275033972,275039645,5673
"18874","ENSMODG00000027547","6",284213224,284214255,1031
"18875","ENSMODG00000027548","6",147459190,147466469,7279
"18876","ENSMODG00000027549","2",341398693,341401230,2537
"18877","ENSMODG00000027550","Un",55920793,55922805,2012
"18878","ENSMODG00000027551","Un",49483545,49492253,8708
"18879","ENSMODG00000027552","3",501887818,501889359,1541
"18880","ENSMODG00000027553","2",27926764,27956183,29419
"18881","ENSMODG00000027554","8",36272080,36273684,1604
"18882","ENSMODG00000027555","1",477513060,477514331,1271
"18883","ENSMODG00000027556","3",519904480,519910569,6089
"18884","ENSMODG00000027557","3",214448887,214450155,1268
"18885","ENSMODG00000027558","3",523085604,523149191,63587
"18886","ENSMODG00000027559","8",293355750,293356931,1181
"18887","ENSMODG00000027560","2",274945007,274969508,24501
"18888","ENSMODG00000027562","4",401383510,401412405,28895
"18889","ENSMODG00000027563","4",314999945,315024650,24705
"18890","ENSMODG00000027564","4",379504406,379568614,64208
"18891","ENSMODG00000027565","4",202367799,202372450,4651
"18892","ENSMODG00000027566","2",499055865,499061065,5200
"18893","ENSMODG00000027567","Un",45407280,45457259,49979
"18894","ENSMODG00000027568","Un",10985400,10986449,1049
"18895","ENSMODG00000027570","7",245074134,245170636,96502
"18896","ENSMODG00000027571","1",221399410,221400437,1027
"18897","ENSMODG00000027572","Un",66896505,66901482,4977
"18898","ENSMODG00000027573","Un",20108321,20131840,23519
"18899","ENSMODG00000027574","6",291638600,291643449,4849
"18900","ENSMODG00000027575","1",346385770,346387112,1342
"18901","ENSMODG00000027576","1",446504276,446505359,1083
"18902","ENSMODG00000027577","2",291834577,291975134,140557
"18903","ENSMODG00000027578","4",383467155,383474622,7467
"18904","ENSMODG00000027579","X",55452576,55491379,38803
"18905","ENSMODG00000027580","5",173814642,173840002,25360
"18906","ENSMODG00000027582","Un",34022747,34156873,134126
"18907","ENSMODG00000027583","1",83133874,83135112,1238
"18908","ENSMODG00000027584","8",234481232,234483825,2593
"18909","ENSMODG00000027585","8",182469473,182488735,19262
"18910","ENSMODG00000027586","8",214579010,214622975,43965
"18911","ENSMODG00000027587","8",18844182,18845342,1160
"18912","ENSMODG00000027588","3",436814586,436824211,9625
"18913","ENSMODG00000027589","2",104204458,104206766,2308
"18914","ENSMODG00000027590","2",128789426,128915768,126342
"18915","ENSMODG00000027591","5",114456314,114457767,1453
"18916","ENSMODG00000027592","4",125952779,125954108,1329
"18917","ENSMODG00000027593","6",277569290,277653805,84515
"18918","ENSMODG00000027594","1",364257658,364259552,1894
"18919","ENSMODG00000027595","X",59459581,59460951,1370
"18920","ENSMODG00000027596","X",7156418,7178632,22214
"18921","ENSMODG00000027597","7",258784508,258840356,55848
"18922","ENSMODG00000027598","8",177844521,177871976,27455
"18923","ENSMODG00000027599","Un",59854249,59866462,12213
"18924","ENSMODG00000027600","Un",64217104,64226273,9169
"18925","ENSMODG00000027601","4",155976073,155977138,1065
"18926","ENSMODG00000027603","8",213986030,214030670,44640
"18927","ENSMODG00000027605","8",306291307,306326594,35287
"18928","ENSMODG00000027606","8",82240060,82241114,1054
"18929","ENSMODG00000027607","3",261308986,261481515,172529
"18930","ENSMODG00000027608","Un",50564518,50566150,1632
"18931","ENSMODG00000027609","Un",70064287,70068231,3944
"18932","ENSMODG00000027610","Un",48316711,48317917,1206
"18933","ENSMODG00000027611","6",121788873,121792371,3498
"18934","ENSMODG00000027612","3",231579225,231580893,1668
"18935","ENSMODG00000027614","3",412647227,412654446,7219
"18936","ENSMODG00000027616","4",402822588,402845861,23273
"18937","ENSMODG00000027617","1",349324957,349460476,135519
"18938","ENSMODG00000027618","3",86345023,86346096,1073
"18939","ENSMODG00000027619","2",493734112,493735761,1649
"18940","ENSMODG00000027620","7",177274384,177292146,17762
"18941","ENSMODG00000027621","X",65324955,65325956,1001
"18942","ENSMODG00000027622","4",92462884,92464177,1293
"18943","ENSMODG00000027623","4",415160990,415163016,2026
"18944","ENSMODG00000027624","Un",42735613,42737036,1423
"18945","ENSMODG00000027625","2",436901198,436952779,51581
"18946","ENSMODG00000027626","4",87857245,87859287,2042
"18947","ENSMODG00000027627","2",16283559,16363578,80019
"18948","ENSMODG00000027628","4",64087209,64135990,48781
"18949","ENSMODG00000027629","1",255091361,255238100,146739
"18950","ENSMODG00000027630","4",15902268,15918791,16523
"18951","ENSMODG00000027631","8",79859195,79997102,137907
"18952","ENSMODG00000027633","1",507968573,507978209,9636
"18953","ENSMODG00000027634","5",103347506,103350642,3136
"18954","ENSMODG00000027635","3",90000735,90193793,193058
"18955","ENSMODG00000027636","4",100570079,100571258,1179
"18956","ENSMODG00000027637","Un",18575899,19021802,445903
"18957","ENSMODG00000027638","Un",96690691,96696193,5502
"18958","ENSMODG00000027639","8",86479833,86481053,1220
"18959","ENSMODG00000027641","1",437538188,437542546,4358
"18960","ENSMODG00000027643","4",278927791,278981593,53802
"18961","ENSMODG00000027644","1",371111675,371233968,122293
"18962","ENSMODG00000027645","2",190066752,190072088,5336
"18963","ENSMODG00000027646","1",24384755,24386338,1583
"18964","ENSMODG00000027647","Un",45463257,45545951,82694
"18965","ENSMODG00000027648","Un",55638328,55646107,7779
"18966","ENSMODG00000027649","Un",94037175,94043066,5891
"18967","ENSMODG00000027651","1",355162572,355163610,1038
"18968","ENSMODG00000027652","8",162423910,162425391,1481
"18969","ENSMODG00000027653","4",374136185,374165857,29672
"18970","ENSMODG00000027654","Un",46327682,46329223,1541
"18971","ENSMODG00000027655","3",503206241,503217423,11182
"18972","ENSMODG00000027656","3",509614476,509625982,11506
"18973","ENSMODG00000027657","5",283284657,283286312,1655
"18974","ENSMODG00000027658","2",136087609,136297325,209716
"18975","ENSMODG00000027659","Un",53623336,53628763,5427
"18976","ENSMODG00000027660","3",501950690,501973072,22382
"18977","ENSMODG00000027661","7",81336983,81340477,3494
"18978","ENSMODG00000027662","Un",80789388,80791025,1637
"18979","ENSMODG00000027663","3",509435725,509474871,39146
"18980","ENSMODG00000027664","4",57774097,57776351,2254
"18981","ENSMODG00000027665","2",443543120,443587816,44696
"18982","ENSMODG00000027666","5",61259561,61260619,1058
"18983","ENSMODG00000027667","5",301639968,301641095,1127
"18984","ENSMODG00000027668","3",400002685,400345867,343182
"18985","ENSMODG00000027669","1",8551840,8605138,53298
"18986","ENSMODG00000027670","1",423979011,424015322,36311
"18987","ENSMODG00000027671","Un",9612772,9622024,9252
"18988","ENSMODG00000027672","5",215039024,215041212,2188
"18989","ENSMODG00000027673","2",497004198,497049596,45398
"18990","ENSMODG00000027674","8",284273958,284365498,91540
"18991","ENSMODG00000027675","Un",44280223,44281254,1031
"18992","ENSMODG00000027676","2",5035455,5036536,1081
"18993","ENSMODG00000027677","2",285313814,285326643,12829
"18994","ENSMODG00000027678","4",137032456,137039389,6933
"18995","ENSMODG00000027679","3",362626632,362634956,8324
"18996","ENSMODG00000027680","Un",100743848,100748428,4580
"18997","ENSMODG00000027681","2",185604463,185605914,1451
"18998","ENSMODG00000027683","1",346401820,346403060,1240
"18999","ENSMODG00000027684","5",87408453,87410624,2171
"19000","ENSMODG00000027685","Un",83526686,83531445,4759
"19001","ENSMODG00000027687","1",370999284,371000452,1168
"19002","ENSMODG00000027688","8",196142807,196155534,12727
"19003","ENSMODG00000027689","2",133750284,133761059,10775
"19004","ENSMODG00000027690","6",109191329,109192512,1183
"19005","ENSMODG00000027691","4",412041174,412042661,1487
"19006","ENSMODG00000027692","1",305673807,305853190,179383
"19007","ENSMODG00000027693","7",188672583,188677689,5106
"19008","ENSMODG00000027694","5",298601265,298611080,9815
"19009","ENSMODG00000027695","3",432949765,433229661,279896
"19010","ENSMODG00000027697","2",52285222,52286672,1450
"19011","ENSMODG00000027698","X",47267834,47272857,5023
"19012","ENSMODG00000027699","4",1068988,1070613,1625
"19013","ENSMODG00000027700","8",74212352,74213425,1073
"19014","ENSMODG00000027702","2",426512200,426513120,920
"19015","ENSMODG00000027703","3",205315141,205316525,1384
"19016","ENSMODG00000027704","3",434624802,434626019,1217
"19017","ENSMODG00000027705","1",473187902,473194478,6576
"19018","ENSMODG00000027706","7",76238703,76280367,41664
"19019","ENSMODG00000027707","4",282983586,282985233,1647
"19020","ENSMODG00000027708","4",409591872,409607146,15274
"19021","ENSMODG00000027709","Un",47287281,47334954,47673
"19022","ENSMODG00000027710","1",150067932,150077993,10061
"19023","ENSMODG00000027711","4",354056644,354179586,122942
"19024","ENSMODG00000027712","5",144713194,144714424,1230
"19025","ENSMODG00000027713","2",119990710,119993257,2547
"19026","ENSMODG00000027714","3",354077908,354078948,1040
"19027","ENSMODG00000027716","5",194922409,194923626,1217
"19028","ENSMODG00000027717","X",5311132,5315105,3973
"19029","ENSMODG00000027718","7",201843850,201844929,1079
"19030","ENSMODG00000027719","5",291919830,291921719,1889
"19031","ENSMODG00000027720","4",276949937,276952444,2507
"19032","ENSMODG00000027721","4",389589773,389607865,18092
"19033","ENSMODG00000027722","4",392633278,392648143,14865
"19034","ENSMODG00000027723","8",294479935,294481308,1373
"19035","ENSMODG00000027724","6",289650064,289798229,148165
"19036","ENSMODG00000027725","2",483169574,483179943,10369
"19037","ENSMODG00000027726","1",107881205,107884694,3489
"19038","ENSMODG00000027727","3",521703429,521704533,1104
"19039","ENSMODG00000027729","1",351937037,351977154,40117
"19040","ENSMODG00000027730","6",147181124,147190000,8876
"19041","ENSMODG00000027731","2",197715883,197731031,15148
"19042","ENSMODG00000027732","5",53351074,53352306,1232
"19043","ENSMODG00000027733","Un",27764598,27765962,1364
"19044","ENSMODG00000027734","2",456296488,456315181,18693
"19045","ENSMODG00000027735","3",56605138,56610157,5019
"19046","ENSMODG00000027736","1",47375668,47398728,23060
"19047","ENSMODG00000027737","Un",53840041,53876899,36858
"19048","ENSMODG00000027738","4",331702386,331703787,1401
"19049","ENSMODG00000027739","1",245546251,245560656,14405
"19050","ENSMODG00000027740","2",533762583,533764546,1963
"19051","ENSMODG00000027741","8",160565837,160567066,1229
"19052","ENSMODG00000027743","Un",30229639,30243196,13557
"19053","ENSMODG00000027744","2",43747662,43748996,1334
"19054","ENSMODG00000027745","3",439238048,439254032,15984
"19055","ENSMODG00000027746","8",250019377,250069984,50607
"19056","ENSMODG00000027748","X",53403860,53435947,32087
"19057","ENSMODG00000027750","1",320321379,320399346,77967
"19058","ENSMODG00000027751","5",154663611,154668655,5044
"19059","ENSMODG00000027752","6",147606687,147611075,4388
"19060","ENSMODG00000027753","8",15074820,15076097,1277
"19061","ENSMODG00000027754","5",170046741,170048040,1299
"19062","ENSMODG00000027755","2",113919834,113979554,59720
"19063","ENSMODG00000027756","5",241545677,241546728,1051
"19064","ENSMODG00000027757","Un",7427809,7431432,3623
"19065","ENSMODG00000027758","4",402432371,402468317,35946
"19066","ENSMODG00000027760","5",197477393,197478856,1463
"19067","ENSMODG00000027761","2",90470453,90541348,70895
"19068","ENSMODG00000027762","1",345278456,345279458,1002
"19069","ENSMODG00000027763","1",203395541,203445166,49625
"19070","ENSMODG00000027764","6",27891723,27916657,24934
"19071","ENSMODG00000027765","1",369413345,369414384,1039
"19072","ENSMODG00000027766","2",217553138,218051847,498709
"19073","ENSMODG00000027767","X",72213106,72229666,16560
"19074","ENSMODG00000027768","2",59519392,59726384,206992
"19075","ENSMODG00000027769","5",11766295,11767429,1134
"19076","ENSMODG00000027770","1",270466009,270469788,3779
"19077","ENSMODG00000027771","4",30189175,30190367,1192
"19078","ENSMODG00000027772","4",418999180,419000479,1299
"19079","ENSMODG00000027773","1",351998665,352013882,15217
"19080","ENSMODG00000027774","6",90633297,90635165,1868
"19081","ENSMODG00000027775","4",116363048,116364140,1092
"19082","ENSMODG00000027776","4",369209273,369301241,91968
"19083","ENSMODG00000027777","Un",87731547,87735266,3719
"19084","ENSMODG00000027778","7",188650948,188663265,12317
"19085","ENSMODG00000027779","2",499391524,499392702,1178
"19086","ENSMODG00000027780","3",289744210,289745951,1741
"19087","ENSMODG00000027781","6",223992966,223995460,2494
"19088","ENSMODG00000027782","6",136822715,136829953,7238
"19089","ENSMODG00000027783","3",279067210,279069277,2067
"19090","ENSMODG00000027785","6",218844511,218845955,1444
"19091","ENSMODG00000027786","Un",8052644,8179615,126971
"19092","ENSMODG00000027787","Un",80686428,80688010,1582
"19093","ENSMODG00000027788","Un",53193714,53223933,30219
"19094","ENSMODG00000027789","Un",71054549,71063586,9037
"19095","ENSMODG00000027790","3",417333623,417336133,2510
"19096","ENSMODG00000027791","3",522626138,522627686,1548
"19097","ENSMODG00000027792","3",520738553,520759492,20939
"19098","ENSMODG00000027793","3",236138950,236140004,1054
"19099","ENSMODG00000027794","8",17155086,17156294,1208
"19100","ENSMODG00000027795","4",57796413,57801927,5514
"19101","ENSMODG00000027796","Un",59559635,59563376,3741
"19102","ENSMODG00000027797","6",243925958,243926960,1002
"19103","ENSMODG00000027798","1",2881656,2882733,1077
"19104","ENSMODG00000027799","Un",9789963,9791492,1529
"19105","ENSMODG00000027800","2",2046955,2075466,28511
"19106","ENSMODG00000027801","1",489837870,489841660,3790
"19107","ENSMODG00000027802","5",60667646,60668809,1163
"19108","ENSMODG00000027803","1",500966950,501024517,57567
"19109","ENSMODG00000027804","6",264557603,264558783,1180
"19110","ENSMODG00000027805","3",185664713,185758633,93920
"19111","ENSMODG00000027806","5",18180698,18207593,26895
"19112","ENSMODG00000027807","2",261648710,261650098,1388
"19113","ENSMODG00000027808","2",520873148,520874891,1743
"19114","ENSMODG00000027809","1",427468488,427469540,1052
"19115","ENSMODG00000027810","7",61114468,61430391,315923
"19116","ENSMODG00000027811","8",294308898,294312105,3207
"19117","ENSMODG00000027812","3",487494336,487501536,7200
"19118","ENSMODG00000027813","5",59087093,59088148,1055
"19119","ENSMODG00000027814","X",31113629,31114677,1048
"19120","ENSMODG00000027815","2",332501922,332506907,4985
"19121","ENSMODG00000027816","4",251109781,251111239,1458
"19122","ENSMODG00000027817","2",314687460,314755711,68251
"19123","ENSMODG00000027818","3",391620729,391621766,1037
"19124","ENSMODG00000027819","Un",85978838,86181060,202222
"19125","ENSMODG00000027820","4",48279056,48312858,33802
"19126","ENSMODG00000027822","3",155812607,155864780,52173
"19127","ENSMODG00000027823","3",172960261,172961332,1071
"19128","ENSMODG00000027824","6",124171316,124176699,5383
"19129","ENSMODG00000027825","4",412742768,412748558,5790
"19130","ENSMODG00000027826","2",181349743,181350994,1251
"19131","ENSMODG00000027827","7",81570168,81571181,1013
"19132","ENSMODG00000027828","7",13932259,13938867,6608
"19133","ENSMODG00000027829","3",509593816,509596957,3141
"19134","ENSMODG00000027833","Un",102065192,102068515,3323
"19135","ENSMODG00000027834","5",236284009,236351829,67820
"19136","ENSMODG00000027835","8",111694171,111716971,22800
"19137","ENSMODG00000027836","1",22679376,22681923,2547
"19138","ENSMODG00000027838","3",440799116,440810372,11256
"19139","ENSMODG00000027839","3",429121104,429133549,12445
"19140","ENSMODG00000027840","Un",77795041,77796510,1469
"19141","ENSMODG00000027841","6",85354978,85357134,2156
"19142","ENSMODG00000027842","2",490672719,490674279,1560
"19143","ENSMODG00000027843","3",444980379,444999455,19076
"19144","ENSMODG00000027844","4",400023147,400044979,21832
"19145","ENSMODG00000027845","1",189840346,189986574,146228
"19146","ENSMODG00000027846","5",48556959,48717652,160693
"19147","ENSMODG00000027847","Un",60532510,60542936,10426
"19148","ENSMODG00000027848","2",350711306,350712535,1229
"19149","ENSMODG00000027849","6",50904144,50905745,1601
"19150","ENSMODG00000027850","8",187061733,187063463,1730
"19151","ENSMODG00000027851","1",82597196,82600697,3501
"19152","ENSMODG00000027852","Un",55190992,55193196,2204
"19153","ENSMODG00000027853","8",182991732,182993026,1294
"19154","ENSMODG00000027854","1",327581628,327583157,1529
"19155","ENSMODG00000027855","4",411325460,411337601,12141
"19156","ENSMODG00000027856","6",119605534,119647265,41731
"19157","ENSMODG00000027857","Un",56953311,56982249,28938
"19158","ENSMODG00000027858","2",93434682,93435935,1253
"19159","ENSMODG00000027859","3",47853439,47854944,1505
"19160","ENSMODG00000027860","2",497161546,497162571,1025
"19161","ENSMODG00000027861","8",125095077,125096442,1365
"19162","ENSMODG00000027862","4",380833218,380870763,37545
"19163","ENSMODG00000027864","8",278185855,278187165,1310
"19164","ENSMODG00000027865","8",97242940,97244162,1222
"19165","ENSMODG00000027867","3",433983371,434073880,90509
"19166","ENSMODG00000027868","4",412100372,412131083,30711
"19167","ENSMODG00000027869","6",200030351,200034278,3927
"19168","ENSMODG00000027870","1",119683124,119684661,1537
"19169","ENSMODG00000027871","3",279427806,279433421,5615
"19170","ENSMODG00000027872","3",440773248,440774930,1682
"19171","ENSMODG00000027873","5",255172485,255173554,1069
"19172","ENSMODG00000027874","Un",42835624,42856537,20913
"19173","ENSMODG00000027875","2",361473656,361482249,8593
"19174","ENSMODG00000027876","5",239694532,239699437,4905
"19175","ENSMODG00000027877","Un",102523342,102524815,1473
"19176","ENSMODG00000027878","4",160323539,160440554,117015
"19177","ENSMODG00000027879","3",521006981,521012651,5670
"19178","ENSMODG00000027880","1",205953541,205955783,2242
"19179","ENSMODG00000027881","3",351637487,351638678,1191
"19180","ENSMODG00000027882","8",112007350,112040285,32935
"19181","ENSMODG00000027883","Un",16815645,16855325,39680
"19182","ENSMODG00000027884","Un",34339851,34394071,54220
"19183","ENSMODG00000027885","5",301213446,301226391,12945
"19184","ENSMODG00000027886","Un",54959966,54962997,3031
"19185","ENSMODG00000027887","1",228425193,228428190,2997
"19186","ENSMODG00000027888","3",432640537,432641574,1037
"19187","ENSMODG00000027889","8",221626861,221628164,1303
"19188","ENSMODG00000027890","6",274648383,274649492,1109
"19189","ENSMODG00000027891","Un",37541435,37542502,1067
"19190","ENSMODG00000027892","4",250159015,250196565,37550
"19191","ENSMODG00000027893","1",3509868,3511131,1263
"19192","ENSMODG00000027894","4",276471200,276472545,1345
"19193","ENSMODG00000027895","3",148163694,148164779,1085
"19194","ENSMODG00000027896","2",136721806,136737652,15846
"19195","ENSMODG00000027897","Un",75773381,75779419,6038
"19196","ENSMODG00000027898","4",370688564,370693510,4946
"19197","ENSMODG00000027900","1",530039019,530044998,5979
"19198","ENSMODG00000027901","Un",81895256,81896422,1166
"19199","ENSMODG00000027903","8",124571677,124616164,44487
"19200","ENSMODG00000027904","X",10125682,10126859,1177
"19201","ENSMODG00000027905","1",429749389,429750558,1169
"19202","ENSMODG00000027906","8",101952146,101978999,26853
"19203","ENSMODG00000027907","8",240226062,240270874,44812
"19204","ENSMODG00000027908","1",308351188,308366825,15637
"19205","ENSMODG00000027909","Un",30869601,30888036,18435
"19206","ENSMODG00000027910","1",175989830,175991323,1493
"19207","ENSMODG00000027911","3",188067134,188074282,7148
"19208","ENSMODG00000027913","3",341800059,341834108,34049
"19209","ENSMODG00000027914","1",494063993,494066083,2090
"19210","ENSMODG00000027915","6",82967311,83018470,51159
"19211","ENSMODG00000027916","3",428985463,428995158,9695
"19212","ENSMODG00000027917","5",109135538,109136654,1116
"19213","ENSMODG00000027918","6",208262408,208263517,1109
"19214","ENSMODG00000027919","2",447775859,447777927,2068
"19215","ENSMODG00000027920","7",62070281,62084480,14199
"19216","ENSMODG00000027921","Un",74022079,74031428,9349
"19217","ENSMODG00000027922","8",246597323,246601003,3680
"19218","ENSMODG00000027923","7",250848515,250849664,1149
"19219","ENSMODG00000027924","3",474216551,474218027,1476
"19220","ENSMODG00000027925","X",69701668,69710977,9309
"19221","ENSMODG00000027926","3",1347724,1350404,2680
"19222","ENSMODG00000027927","4",14324131,14325684,1553
"19223","ENSMODG00000027928","8",7565678,7573634,7956
"19224","ENSMODG00000027929","2",360208795,360210060,1265
"19225","ENSMODG00000027930","5",139691555,139692464,909
"19226","ENSMODG00000027931","Un",45756216,45757458,1242
"19227","ENSMODG00000027932","3",517893203,517894269,1066
"19228","ENSMODG00000027933","6",41916320,41917550,1230
"19229","ENSMODG00000027934","8",36102882,36127253,24371
"19230","ENSMODG00000027935","5",50253295,50405681,152386
"19231","ENSMODG00000027936","8",5273184,5274414,1230
"19232","ENSMODG00000027937","Un",68498925,68508110,9185
"19233","ENSMODG00000027938","5",295727849,295774376,46527
"19234","ENSMODG00000027939","6",218993017,219004711,11694
"19235","ENSMODG00000027940","2",212931563,212948888,17325
"19236","ENSMODG00000027941","6",206061811,206189010,127199
"19237","ENSMODG00000027942","7",152464885,152557490,92605
"19238","ENSMODG00000027943","4",369502165,369604323,102158
"19239","ENSMODG00000027944","4",262082038,262232177,150139
"19240","ENSMODG00000027945","Un",21281350,21695271,413921
"19241","ENSMODG00000027946","4",67607021,67608318,1297
"19242","ENSMODG00000027947","8",294647658,294654439,6781
"19243","ENSMODG00000027948","8",49532337,49533508,1171
"19244","ENSMODG00000027949","4",106839276,106840482,1206
"19245","ENSMODG00000027950","1",329184948,329186088,1140
"19246","ENSMODG00000027951","3",514229121,514234557,5436
"19247","ENSMODG00000027952","X",6979113,6981416,2303
"19248","ENSMODG00000027953","1",306669670,306676233,6563
"19249","ENSMODG00000027954","2",1352478,1353509,1031
"19250","ENSMODG00000027955","8",121083143,121091041,7898
"19251","ENSMODG00000027956","X",72334139,72350285,16146
"19252","ENSMODG00000027957","Un",37368684,37369745,1061
"19253","ENSMODG00000027958","1",205311144,205313531,2387
"19254","ENSMODG00000027959","4",224875601,224998995,123394
"19255","ENSMODG00000027960","3",9161422,9162616,1194
"19256","ENSMODG00000027961","Un",62369123,62385623,16500
"19257","ENSMODG00000027962","X",23225018,23258421,33403
"19258","ENSMODG00000027963","2",253239028,253260555,21527
"19259","ENSMODG00000027964","8",80506375,80659857,153482
"19260","ENSMODG00000027967","6",260584383,260585463,1080
"19261","ENSMODG00000027969","3",19073519,19224953,151434
"19262","ENSMODG00000027970","2",102590983,103045328,454345
"19263","ENSMODG00000027972","1",313760,326892,13132
"19264","ENSMODG00000027973","4",385569131,385570216,1085
"19265","ENSMODG00000027974","8",294709713,294712966,3253
"19266","ENSMODG00000027975","8",80146191,80147237,1046
"19267","ENSMODG00000027976","7",156248412,156376595,128183
"19268","ENSMODG00000027978","Un",58043773,58052189,8416
"19269","ENSMODG00000027979","1",22458804,22460552,1748
"19270","ENSMODG00000027980","4",55426457,55427959,1502
"19271","ENSMODG00000027981","8",48887970,48891237,3267
"19272","ENSMODG00000027982","X",31586098,31587233,1135
"19273","ENSMODG00000027983","4",347694546,347742740,48194
"19274","ENSMODG00000027984","X",40638665,40649411,10746
"19275","ENSMODG00000027985","7",211470196,211471530,1334
"19276","ENSMODG00000027986","Un",88797298,88801897,4599
"19277","ENSMODG00000027987","8",114568915,114569969,1054
"19278","ENSMODG00000027988","4",316440699,316477039,36340
"19279","ENSMODG00000027989","3",312011044,312017389,6345
"19280","ENSMODG00000027990","Un",41432161,41434038,1877
"19281","ENSMODG00000027991","2",340520110,340521361,1251
"19282","ENSMODG00000027992","4",344275142,344276421,1279
"19283","ENSMODG00000027993","8",116504664,116550359,45695
"19284","ENSMODG00000027994","3",519387006,519403461,16455
"19285","ENSMODG00000027995","5",103402685,103442232,39547
"19286","ENSMODG00000027996","1",105728,107033,1305
"19287","ENSMODG00000027997","3",21894444,21900224,5780
"19288","ENSMODG00000027998","5",235663639,235664800,1161
"19289","ENSMODG00000027999","1",350153314,350231854,78540
"19290","ENSMODG00000028000","2",517607150,517611865,4715
"19291","ENSMODG00000028001","2",497427910,497428953,1043
"19292","ENSMODG00000028002","4",208422348,208423938,1590
"19293","ENSMODG00000028003","Un",91115368,91121970,6602
"19294","ENSMODG00000028004","7",76850534,76851983,1449
"19295","ENSMODG00000028006","1",494510068,494511362,1294
"19296","ENSMODG00000028007","3",456327811,456332176,4365
"19297","ENSMODG00000028008","2",530320151,530424136,103985
"19298","ENSMODG00000028009","2",202545461,202546647,1186
"19299","ENSMODG00000028010","2",416383893,416384916,1023
"19300","ENSMODG00000028011","X",42075138,42150118,74980
"19301","ENSMODG00000028014","1",337516685,337518213,1528
"19302","ENSMODG00000028015","2",251478187,251483351,5164
"19303","ENSMODG00000028016","2",6714693,6716384,1691
"19304","ENSMODG00000028017","3",523743649,523749441,5792
"19305","ENSMODG00000028018","1",453298184,453308173,9989
"19306","ENSMODG00000028019","X",36819577,36865457,45880
"19307","ENSMODG00000028020","2",492068618,492088453,19835
"19308","ENSMODG00000028021","Un",83531662,83533888,2226
"19309","ENSMODG00000028022","2",280969242,280970315,1073
"19310","ENSMODG00000028023","2",510768603,510771854,3251
"19311","ENSMODG00000028024","6",45441436,45442473,1037
"19312","ENSMODG00000028025","5",301039437,301058162,18725
"19313","ENSMODG00000028026","Un",79735655,79736900,1245
"19314","ENSMODG00000028027","X",69152205,69156658,4453
"19315","ENSMODG00000028028","5",277813992,277963382,149390
"19316","ENSMODG00000028029","4",396543923,396558066,14143
"19317","ENSMODG00000028030","1",60316410,60332966,16556
"19318","ENSMODG00000028033","2",396018399,396019950,1551
"19319","ENSMODG00000028034","5",88849435,88850815,1380
"19320","ENSMODG00000028035","3",430558117,430560289,2172
"19321","ENSMODG00000028036","2",191802208,191944429,142221
"19322","ENSMODG00000028037","5",10891508,10892908,1400
"19323","ENSMODG00000028038","1",369468642,369469695,1053
"19324","ENSMODG00000028039","8",234736690,234737876,1186
"19325","ENSMODG00000028040","4",111419215,111673936,254721
"19326","ENSMODG00000028042","2",10567474,10575647,8173
"19327","ENSMODG00000028043","4",94136271,94140074,3803
"19328","ENSMODG00000028044","3",269962665,269968138,5473
"19329","ENSMODG00000028045","3",496948621,496949800,1179
"19330","ENSMODG00000028046","3",494741486,494744145,2659
"19331","ENSMODG00000028047","8",274940702,274985222,44520
"19332","ENSMODG00000028048","7",233765371,233779466,14095
"19333","ENSMODG00000028049","8",13430647,13432353,1706
"19334","ENSMODG00000028050","1",311635901,311638443,2542
"19335","ENSMODG00000028051","7",173101907,173103219,1312
"19336","ENSMODG00000028052","8",5842776,5844135,1359
"19337","ENSMODG00000028053","2",213006847,213007923,1076
"19338","ENSMODG00000028054","Un",32632742,32640887,8145
"19339","ENSMODG00000028055","2",35122199,35123271,1072
"19340","ENSMODG00000028056","6",223718698,223781606,62908
"19341","ENSMODG00000028058","6",149028840,149064902,36062
"19342","ENSMODG00000028059","7",9582679,9751022,168343
"19343","ENSMODG00000028060","Un",72017605,72019718,2113
"19344","ENSMODG00000028061","6",282742092,282743573,1481
"19345","ENSMODG00000028062","4",410687240,410704935,17695
"19346","ENSMODG00000028063","1",442739145,442740159,1014
"19347","ENSMODG00000028064","3",461611276,461625033,13757
"19348","ENSMODG00000028065","1",510792148,510807490,15342
"19349","ENSMODG00000028066","5",5583831,5585846,2015
"19350","ENSMODG00000028067","4",427686023,427697308,11285
"19351","ENSMODG00000028068","Un",63240701,63250415,9714
"19352","ENSMODG00000028069","3",462421425,462663943,242518
"19353","ENSMODG00000028070","1",84128434,84129743,1309
"19354","ENSMODG00000028071","2",208172797,208875796,702999
"19355","ENSMODG00000028072","Un",97795888,97796951,1063
"19356","ENSMODG00000028073","Un",67914360,67925547,11187
"19357","ENSMODG00000028074","6",40194112,40196643,2531
"19358","ENSMODG00000028075","8",308872022,308942053,70031
"19359","ENSMODG00000028076","3",433000827,433002684,1857
"19360","ENSMODG00000028077","4",204285989,204287554,1565
"19361","ENSMODG00000028078","1",464455697,464457011,1314
"19362","ENSMODG00000028079","8",27447448,27469271,21823
"19363","ENSMODG00000028081","1",378518591,378522279,3688
"19364","ENSMODG00000028083","1",367826886,367979929,153043
"19365","ENSMODG00000028084","4",383903976,383921143,17167
"19366","ENSMODG00000028085","Un",20915624,20922286,6662
"19367","ENSMODG00000028086","Un",15865999,15867129,1130
"19368","ENSMODG00000028087","5",97582385,97778356,195971
"19369","ENSMODG00000028088","6",283879023,283879664,641
"19370","ENSMODG00000028089","2",161488494,161489910,1416
"19371","ENSMODG00000028090","7",183248415,183249723,1308
"19372","ENSMODG00000028091","1",470052667,470248724,196057
"19373","ENSMODG00000028092","3",439451559,439462382,10823
"19374","ENSMODG00000028093","5",83501197,83528288,27091
"19375","ENSMODG00000028094","1",32187845,32266585,78740
"19376","ENSMODG00000028095","6",196346131,196356448,10317
"19377","ENSMODG00000028096","4",250308778,250326549,17771
"19378","ENSMODG00000028097","Un",84436,85606,1170
"19379","ENSMODG00000028098","4",433659095,433660819,1724
"19380","ENSMODG00000028099","4",21160847,21162426,1579
"19381","ENSMODG00000028100","Un",54703107,54738282,35175
"19382","ENSMODG00000028101","2",9615982,9623566,7584
"19383","ENSMODG00000028102","4",92399085,92417208,18123
"19384","ENSMODG00000028103","2",161319727,161365591,45864
"19385","ENSMODG00000028105","1",341207374,341208410,1036
"19386","ENSMODG00000028106","Un",43404139,43404698,559
"19387","ENSMODG00000028107","X",39120666,39124199,3533
"19388","ENSMODG00000028108","5",202110934,202112235,1301
"19389","ENSMODG00000028109","3",466345522,466391989,46467
"19390","ENSMODG00000028110","1",416200286,416201419,1133
"19391","ENSMODG00000028113","8",12162833,12163897,1064
"19392","ENSMODG00000028114","Un",90937455,90939136,1681
"19393","ENSMODG00000028115","8",217768569,217837351,68782
"19394","ENSMODG00000028116","5",303756623,303816161,59538
"19395","ENSMODG00000028117","4",421519918,421520961,1043
"19396","ENSMODG00000028118","Un",63524755,63526268,1513
"19397","ENSMODG00000028119","3",43627469,43628710,1241
"19398","ENSMODG00000028120","8",270292925,270294586,1661
"19399","ENSMODG00000028121","4",201033298,201035923,2625
"19400","ENSMODG00000028122","2",498952663,498956949,4286
"19401","ENSMODG00000028123","4",411544221,411550756,6535
"19402","ENSMODG00000028124","7",111344258,111345617,1359
"19403","ENSMODG00000028125","2",522222653,522237667,15014
"19404","ENSMODG00000028126","8",192999173,193000456,1283
"19405","ENSMODG00000028127","6",209419502,209420572,1070
"19406","ENSMODG00000028128","Un",102430823,102433115,2292
"19407","ENSMODG00000028130","Un",30099626,30101071,1445
"19408","ENSMODG00000028131","Un",97505222,97506344,1122
"19409","ENSMODG00000028132","7",235691573,235693339,1766
"19410","ENSMODG00000028134","4",363756174,363766151,9977
"19411","ENSMODG00000028135","4",378443985,378462337,18352
"19412","ENSMODG00000028136","4",323994956,323996037,1081
"19413","ENSMODG00000028137","X",36884046,36885924,1878
"19414","ENSMODG00000028139","2",426864724,426903286,38562
"19415","ENSMODG00000028141","7",129624036,129687785,63749
"19416","ENSMODG00000028142","7",220090519,220091643,1124
"19417","ENSMODG00000028143","1",82181556,82194699,13143
"19418","ENSMODG00000028144","Un",57198884,57200011,1127
"19419","ENSMODG00000028145","8",36165603,36168723,3120
"19420","ENSMODG00000028146","3",72559225,72561163,1938
"19421","ENSMODG00000028148","4",330560815,330562440,1625
"19422","ENSMODG00000028149","2",15532597,15545127,12530
"19423","ENSMODG00000028150","4",219967023,219969486,2463
"19424","ENSMODG00000028152","1",199588946,199590758,1812
"19425","ENSMODG00000028153","Un",73946953,73950808,3855
"19426","ENSMODG00000028154","7",28690849,28691967,1118
"19427","ENSMODG00000028155","8",105641851,105643237,1386
"19428","ENSMODG00000028156","1",30124886,30125991,1105
"19429","ENSMODG00000028157","4",409856396,409867131,10735
"19430","ENSMODG00000028158","1",225082268,225092663,10395
"19431","ENSMODG00000028159","Un",85996078,86003116,7038
"19432","ENSMODG00000028160","3",198139010,198740065,601055
"19433","ENSMODG00000028162","2",304855358,304856813,1455
"19434","ENSMODG00000028163","8",119586289,119673070,86781
"19435","ENSMODG00000028164","3",527614316,527615506,1190
"19436","ENSMODG00000028165","1",85631118,85632278,1160
"19437","ENSMODG00000028166","2",216616623,216617660,1037
"19438","ENSMODG00000028167","5",31210082,31211268,1186
"19439","ENSMODG00000028168","1",23412470,23558007,145537
"19440","ENSMODG00000028169","2",514300981,514325305,24324
"19441","ENSMODG00000028170","Un",40105851,40271937,166086
"19442","ENSMODG00000028171","2",150376118,150377400,1282
"19443","ENSMODG00000028172","7",82707448,82708547,1099
"19444","ENSMODG00000028174","3",135848230,135849457,1227
"19445","ENSMODG00000028175","2",532316023,532421206,105183
"19446","ENSMODG00000028176","6",89229938,89231139,1201
"19447","ENSMODG00000028177","Un",48449819,48450857,1038
"19448","ENSMODG00000028178","2",183633356,183634619,1263
"19449","ENSMODG00000028179","3",341975898,342023607,47709
"19450","ENSMODG00000028181","2",399532407,399564623,32216
"19451","ENSMODG00000028182","4",84537956,84538969,1013
"19452","ENSMODG00000028183","2",405610990,405612282,1292
"19453","ENSMODG00000028185","1",221242468,221366646,124178
"19454","ENSMODG00000028186","4",374834884,374868898,34014
"19455","ENSMODG00000028187","1",515599937,515601529,1592
"19456","ENSMODG00000028188","Un",94189211,94357633,168422
"19457","ENSMODG00000028189","8",311061784,311062926,1142
"19458","ENSMODG00000028190","1",240995434,241134992,139558
"19459","ENSMODG00000028191","4",27163850,27166568,2718
"19460","ENSMODG00000028192","1",73304144,73338612,34468
"19461","ENSMODG00000028195","1",468458839,468459966,1127
"19462","ENSMODG00000028196","4",429213527,429216609,3082
"19463","ENSMODG00000028197","Un",95251801,95252851,1050
"19464","ENSMODG00000028199","2",518711331,518712458,1127
"19465","ENSMODG00000028200","Un",14841527,14844678,3151
"19466","ENSMODG00000028201","6",80144528,80146291,1763
"19467","ENSMODG00000028202","2",164625005,164685421,60416
"19468","ENSMODG00000028203","3",252569350,252571109,1759
"19469","ENSMODG00000028204","Un",62586902,62588542,1640
"19470","ENSMODG00000028205","8",196669904,196671216,1312
"19471","ENSMODG00000028207","1",355160281,355161596,1315
"19472","ENSMODG00000028208","4",375673698,375674960,1262
"19473","ENSMODG00000028209","8",208646963,208648196,1233
"19474","ENSMODG00000028210","3",70700648,70797368,96720
"19475","ENSMODG00000028211","7",189723198,189724298,1100
"19476","ENSMODG00000028212","2",194022475,194108052,85577
"19477","ENSMODG00000028213","2",27720571,27740581,20010
"19478","ENSMODG00000028214","2",380733873,381008380,274507
"19479","ENSMODG00000028215","1",108518861,108519988,1127
"19480","ENSMODG00000028216","3",2308886,2309994,1108
"19481","ENSMODG00000028217","6",147782011,147794580,12569
"19482","ENSMODG00000028218","4",403484642,403516257,31615
"19483","ENSMODG00000028219","6",21085894,21088004,2110
"19484","ENSMODG00000028220","6",199619386,199664300,44914
"19485","ENSMODG00000028221","5",87427124,87429419,2295
"19486","ENSMODG00000028222","5",12897000,12898032,1032
"19487","ENSMODG00000028223","1",11063462,11067832,4370
"19488","ENSMODG00000028224","2",376968517,376969527,1010
"19489","ENSMODG00000028225","Un",59337497,59340885,3388
"19490","ENSMODG00000028226","8",6650727,6652228,1501
"19491","ENSMODG00000028227","3",476069954,476071159,1205
"19492","ENSMODG00000028228","4",412026061,412038499,12438
"19493","ENSMODG00000028229","7",114929532,114930623,1091
"19494","ENSMODG00000028230","4",434734452,434737753,3301
"19495","ENSMODG00000028231","3",300038674,300039679,1005
"19496","ENSMODG00000028232","6",61219608,61220653,1045
"19497","ENSMODG00000028233","Un",71079035,71080782,1747
"19498","ENSMODG00000028234","6",123593082,123594202,1120
"19499","ENSMODG00000028235","4",369883228,369900576,17348
"19500","ENSMODG00000028237","Un",11297472,11298606,1134
"19501","ENSMODG00000028238","7",260294964,260296134,1170
"19502","ENSMODG00000028239","3",53933247,53968719,35472
"19503","ENSMODG00000028240","2",431242916,431281457,38541
"19504","ENSMODG00000028242","8",213334792,213359973,25181
"19505","ENSMODG00000028243","8",23180656,23196571,15915
"19506","ENSMODG00000028244","5",12898086,12899776,1690
"19507","ENSMODG00000028245","3",318230570,318235660,5090
"19508","ENSMODG00000028246","3",337250922,337303200,52278
"19509","ENSMODG00000028247","8",108428668,108430527,1859
"19510","ENSMODG00000028248","8",15435855,15437600,1745
"19511","ENSMODG00000028249","Un",7961456,7970629,9173
"19512","ENSMODG00000028250","2",37582410,37587452,5042
"19513","ENSMODG00000028251","7",237962444,237965366,2922
"19514","ENSMODG00000028252","4",400483182,400501483,18301
"19515","ENSMODG00000028253","5",2022483,2038273,15790
"19516","ENSMODG00000028254","4",382833748,382834384,636
"19517","ENSMODG00000028255","6",267789498,267884244,94746
"19518","ENSMODG00000028256","7",20935191,20936292,1101
"19519","ENSMODG00000028257","5",66993921,66995624,1703
"19520","ENSMODG00000028258","5",254489320,254498293,8973
"19521","ENSMODG00000028259","3",476341762,476376014,34252
"19522","ENSMODG00000028261","3",518705492,518712137,6645
"19523","ENSMODG00000028263","1",83324321,83325346,1025
"19524","ENSMODG00000028264","X",36681333,36682418,1085
"19525","ENSMODG00000028265","7",259163941,259283607,119666
"19526","ENSMODG00000028266","4",223976625,223980411,3786
"19527","ENSMODG00000028267","2",511194414,511195434,1020
"19528","ENSMODG00000028268","1",260282458,260327278,44820
"19529","ENSMODG00000028270","2",83157534,83158982,1448
"19530","ENSMODG00000028272","2",494949040,494992899,43859
"19531","ENSMODG00000028273","3",459325109,459326248,1139
"19532","ENSMODG00000028274","5",294668473,294683835,15362
"19533","ENSMODG00000028275","3",290439855,290441151,1296
"19534","ENSMODG00000028276","8",268968180,268969310,1130
"19535","ENSMODG00000028277","3",51854815,51864911,10096
"19536","ENSMODG00000028278","X",40026183,40183039,156856
"19537","ENSMODG00000028279","1",203578577,203594327,15750
"19538","ENSMODG00000028283","8",18555915,18560175,4260
"19539","ENSMODG00000028284","5",237455858,237471296,15438
"19540","ENSMODG00000028285","1",272959621,273141538,181917
"19541","ENSMODG00000028286","3",179925775,179927046,1271
"19542","ENSMODG00000028287","2",314335745,314336785,1040
"19543","ENSMODG00000028288","Un",36535948,36550866,14918
"19544","ENSMODG00000028289","2",411346647,411347795,1148
"19545","ENSMODG00000028290","6",180167206,180255821,88615
"19546","ENSMODG00000028291","7",183600436,183601829,1393
"19547","ENSMODG00000028292","1",177825596,177834460,8864
"19548","ENSMODG00000028293","8",101006235,101007515,1280
"19549","ENSMODG00000028294","1",404393569,404428125,34556
"19550","ENSMODG00000028295","6",68845780,68847110,1330
"19551","ENSMODG00000028296","2",65977372,65998452,21080
"19552","ENSMODG00000028297","2",42772193,42773246,1053
"19553","ENSMODG00000028298","8",34900071,34904767,4696
"19554","ENSMODG00000028299","Un",71571,72589,1018
"19555","ENSMODG00000028300","Un",42388127,42401353,13226
"19556","ENSMODG00000028301","Un",47380632,47381782,1150
"19557","ENSMODG00000028302","1",32817454,32831408,13954
"19558","ENSMODG00000028303","2",165154459,165189395,34936
"19559","ENSMODG00000028304","1",451074850,451103034,28184
"19560","ENSMODG00000028305","2",530840324,530883796,43472
"19561","ENSMODG00000028306","1",251458836,251783656,324820
"19562","ENSMODG00000028307","6",196494113,196507306,13193
"19563","ENSMODG00000028308","2",427080555,427081568,1013
"19564","ENSMODG00000028309","3",495027166,495028739,1573
"19565","ENSMODG00000028311","4",182958713,182974564,15851
"19566","ENSMODG00000028313","1",150580630,150608078,27448
"19567","ENSMODG00000028314","2",289365733,289391299,25566
"19568","ENSMODG00000028315","Un",64999914,65003533,3619
"19569","ENSMODG00000028317","4",247040327,247041775,1448
"19570","ENSMODG00000028318","3",431101116,431102168,1052
"19571","ENSMODG00000028319","4",366477178,366479755,2577
"19572","ENSMODG00000028320","4",222700791,222708974,8183
"19573","ENSMODG00000028322","Un",65956762,65957994,1232
"19574","ENSMODG00000028323","4",287664560,287684358,19798
"19575","ENSMODG00000028324","3",331469143,331472846,3703
"19576","ENSMODG00000028325","Un",70823136,70825049,1913
"19577","ENSMODG00000028326","8",30967047,31007343,40296
"19578","ENSMODG00000028327","6",57163655,57201786,38131
"19579","ENSMODG00000028328","1",54921057,54938738,17681
"19580","ENSMODG00000028329","6",106824486,106870814,46328
"19581","ENSMODG00000028330","2",513393269,513520311,127042
"19582","ENSMODG00000028331","6",147576677,147607226,30549
"19583","ENSMODG00000028332","5",202413754,202415148,1394
"19584","ENSMODG00000028333","1",15670636,15818913,148277
"19585","ENSMODG00000028334","6",210768814,210769866,1052
"19586","ENSMODG00000028335","4",250234898,250250391,15493
"19587","ENSMODG00000028336","6",152646578,152833967,187389
"19588","ENSMODG00000028337","4",388465513,388469510,3997
"19589","ENSMODG00000028338","8",278751798,278954368,202570
"19590","ENSMODG00000028339","8",192874802,192876348,1546
"19591","ENSMODG00000028340","6",187508527,187509606,1079
"19592","ENSMODG00000028341","8",239970315,239971934,1619
"19593","ENSMODG00000028342","4",388459963,388461432,1469
"19594","ENSMODG00000028343","7",109713783,109715028,1245
"19595","ENSMODG00000028345","3",417828573,417830013,1440
"19596","ENSMODG00000028346","6",28849898,28850925,1027
"19597","ENSMODG00000028347","Un",58680427,58681510,1083
"19598","ENSMODG00000028348","2",255651579,255652877,1298
"19599","ENSMODG00000028349","3",432878463,433048290,169827
"19600","ENSMODG00000028350","Un",63198583,63205222,6639
"19601","ENSMODG00000028351","4",184435499,184509166,73667
"19602","ENSMODG00000028353","Un",73558915,73560041,1126
"19603","ENSMODG00000028354","1",155721742,155758871,37129
"19604","ENSMODG00000028355","3",470261761,470347962,86201
"19605","ENSMODG00000028358","3",449391797,449466987,75190
"19606","ENSMODG00000028359","3",262587287,262588563,1276
"19607","ENSMODG00000028360","4",63481860,63489842,7982
"19608","ENSMODG00000028361","2",423473045,423474305,1260
"19609","ENSMODG00000028362","2",505659324,505660619,1295
"19610","ENSMODG00000028364","Un",70722922,70725606,2684
"19611","ENSMODG00000028365","1",29579706,29659620,79914
"19612","ENSMODG00000028366","3",395103881,395105046,1165
"19613","ENSMODG00000028367","7",138410973,138412284,1311
"19614","ENSMODG00000028368","Un",64995904,65000068,4164
"19615","ENSMODG00000028370","1",476437481,476584445,146964
"19616","ENSMODG00000028371","Un",66969837,66971020,1183
"19617","ENSMODG00000028372","3",381858213,381860826,2613
"19618","ENSMODG00000028373","Un",80791062,80792259,1197
"19619","ENSMODG00000028374","4",388803132,388815947,12815
"19620","ENSMODG00000028375","3",210375842,210376988,1146
"19621","ENSMODG00000028376","2",283856008,283873477,17469
"19622","ENSMODG00000028377","4",320503693,320524427,20734
"19623","ENSMODG00000028379","5",194268359,194269701,1342
"19624","ENSMODG00000028380","7",47338786,47402050,63264
"19625","ENSMODG00000028381","5",301177804,301183276,5472
"19626","ENSMODG00000028382","4",124430853,124432301,1448
"19627","ENSMODG00000028383","Un",49353246,49355114,1868
"19628","ENSMODG00000028384","4",260336238,260337285,1047
"19629","ENSMODG00000028385","5",195798338,195802202,3864
"19630","ENSMODG00000028386","3",435919552,435927400,7848
"19631","ENSMODG00000028387","8",92638829,92639845,1016
"19632","ENSMODG00000028388","3",65753315,65800862,47547
"19633","ENSMODG00000028389","2",9655944,9663152,7208
"19634","ENSMODG00000028390","8",13232166,13234432,2266
"19635","ENSMODG00000028391","4",415164305,415166376,2071
"19636","ENSMODG00000028392","4",175146717,175246266,99549
"19637","ENSMODG00000028393","Un",46052443,46058627,6184
"19638","ENSMODG00000028394","2",108370271,108377712,7441
"19639","ENSMODG00000028395","4",124534424,124535513,1089
"19640","ENSMODG00000028396","5",38534469,38537482,3013
"19641","ENSMODG00000028397","5",247210713,247222469,11756
"19642","ENSMODG00000028398","5",103380739,103392033,11294
"19643","ENSMODG00000028399","6",284388483,284390326,1843
"19644","ENSMODG00000028400","4",401420866,401435963,15097
"19645","ENSMODG00000028401","8",80129810,80130883,1073
"19646","ENSMODG00000028402","4",360362604,360363639,1035
"19647","ENSMODG00000028403","1",414930245,414998648,68403
"19648","ENSMODG00000028404","4",55499261,55500330,1069
"19649","ENSMODG00000028406","7",168148787,168258698,109911
"19650","ENSMODG00000028407","Un",13704429,13705706,1277
"19651","ENSMODG00000028408","1",337679561,337683185,3624
"19652","ENSMODG00000028409","Un",96741932,96746956,5024
"19653","ENSMODG00000028410","2",175048890,175056635,7745
"19654","ENSMODG00000028411","2",322940942,322942167,1225
"19655","ENSMODG00000028412","5",103123479,103125476,1997
"19656","ENSMODG00000028413","5",91465233,91556378,91145
"19657","ENSMODG00000028414","8",80191905,80438277,246372
"19658","ENSMODG00000028415","8",54961258,54962299,1041
"19659","ENSMODG00000028416","1",220408330,220413546,5216
"19660","ENSMODG00000028417","4",42309476,42310478,1002
"19661","ENSMODG00000028418","2",514156981,514158009,1028
"19662","ENSMODG00000028419","Un",70683383,70696452,13069
"19663","ENSMODG00000028420","Un",66087583,66090449,2866
"19664","ENSMODG00000028421","7",63568750,63569792,1042
"19665","ENSMODG00000028423","7",234249622,234370044,120422
"19666","ENSMODG00000028424","4",222770832,222779789,8957
"19667","ENSMODG00000028425","4",389320312,389337156,16844
"19668","ENSMODG00000028427","2",110404370,110405624,1254
"19669","ENSMODG00000028428","2",176033200,176050761,17561
"19670","ENSMODG00000028429","3",504418868,504459541,40673
"19671","ENSMODG00000028430","X",42304414,42305903,1489
"19672","ENSMODG00000028431","Un",43155258,43159818,4560
"19673","ENSMODG00000028432","1",169656938,169667068,10130
"19674","ENSMODG00000028433","6",274987535,274999119,11584
"19675","ENSMODG00000028434","2",211300613,211309463,8850
"19676","ENSMODG00000028436","Un",72840059,72849517,9458
"19677","ENSMODG00000028437","3",487769116,487982963,213847
"19678","ENSMODG00000028438","8",31238598,31240294,1696
"19679","ENSMODG00000028439","4",152770071,152771185,1114
"19680","ENSMODG00000028440","4",66179147,66180358,1211
"19681","ENSMODG00000028441","5",236566264,236640439,74175
"19682","ENSMODG00000028442","3",524357567,524358470,903
"19683","ENSMODG00000028443","1",119371907,119662617,290710
"19684","ENSMODG00000028444","2",73644337,73645464,1127
"19685","ENSMODG00000028445","Un",33872452,33933620,61168
"19686","ENSMODG00000028446","Un",98774037,98776078,2041
"19687","ENSMODG00000028447","3",23168107,23171620,3513
"19688","ENSMODG00000028448","1",94247160,94514107,266947
"19689","ENSMODG00000028449","8",50376464,50432012,55548
"19690","ENSMODG00000028450","4",381245252,381246376,1124
"19691","ENSMODG00000028451","3",35087772,35270895,183123
"19692","ENSMODG00000028452","2",85617273,85618558,1285
"19693","ENSMODG00000028453","4",68656557,68658557,2000
"19694","ENSMODG00000028454","3",33603815,33735312,131497
"19695","ENSMODG00000028455","1",459396992,459625718,228726
"19696","ENSMODG00000028456","Un",26374105,26378821,4716
"19697","ENSMODG00000028457","1",84956575,84969058,12483
"19698","ENSMODG00000028458","8",215854300,215855517,1217
"19699","ENSMODG00000028459","Un",73006238,73009232,2994
"19700","ENSMODG00000028460","5",180010862,180011955,1093
"19701","ENSMODG00000028461","4",94030410,94058941,28531
"19702","ENSMODG00000028462","2",184930528,184931572,1044
"19703","ENSMODG00000028463","4",297077620,297100967,23347
"19704","ENSMODG00000028464","1",171259408,171260183,775
"19705","ENSMODG00000028465","1",327940228,327943451,3223
"19706","ENSMODG00000028466","5",253817166,253818203,1037
"19707","ENSMODG00000028467","Un",46681239,46780475,99236
"19708","ENSMODG00000028468","8",291777077,291777693,616
"19709","ENSMODG00000028469","3",328780679,328805590,24911
"19710","ENSMODG00000028470","5",116072186,116256198,184012
"19711","ENSMODG00000028471","7",250856879,250857913,1034
"19712","ENSMODG00000028472","4",249283637,249284658,1021
"19713","ENSMODG00000028473","4",380265238,380266299,1061
"19714","ENSMODG00000028474","3",195685488,195848421,162933
"19715","ENSMODG00000028475","2",283641427,283663503,22076
"19716","ENSMODG00000028476","2",293125209,293126300,1091
"19717","ENSMODG00000028477","1",277344115,277356858,12743
"19718","ENSMODG00000028478","6",119088393,119089660,1267
"19719","ENSMODG00000028479","4",315401885,315518984,117099
"19720","ENSMODG00000028480","1",135574781,135576133,1352
"19721","ENSMODG00000028483","1",410354557,410355643,1086
"19722","ENSMODG00000028484","Un",79806747,79814646,7899
"19723","ENSMODG00000028485","1",530717914,530845248,127334
"19724","ENSMODG00000028486","3",467202540,467203603,1063
"19725","ENSMODG00000028487","3",505585465,505586485,1020
"19726","ENSMODG00000028488","4",396452998,396462517,9519
"19727","ENSMODG00000028489","4",120696622,120829290,132668
"19728","ENSMODG00000028491","4",313127972,313291509,163537
"19729","ENSMODG00000028492","2",184090725,184106850,16125
"19730","ENSMODG00000028493","8",143670178,143671297,1119
"19731","ENSMODG00000028494","2",510953200,511079618,126418
"19732","ENSMODG00000028495","X",13930580,13932453,1873
"19733","ENSMODG00000028497","7",123670055,123671145,1090
"19734","ENSMODG00000028498","3",508320789,508388829,68040
"19735","ENSMODG00000028499","5",295530020,295642554,112534
"19736","ENSMODG00000028500","3",150916629,150917762,1133
"19737","ENSMODG00000028501","5",188411679,188412735,1056
"19738","ENSMODG00000028502","Un",60125434,60127251,1817
"19739","ENSMODG00000028503","6",204886790,204907115,20325
"19740","ENSMODG00000028504","8",34887962,34890676,2714
"19741","ENSMODG00000028505","4",389611217,389641334,30117
"19742","ENSMODG00000028506","1",216762177,216763419,1242
"19743","ENSMODG00000028507","7",88891919,88893902,1983
"19744","ENSMODG00000028508","1",496308667,496310154,1487
"19745","ENSMODG00000028509","7",251885394,251886830,1436
"19746","ENSMODG00000028510","6",50551187,50552362,1175
"19747","ENSMODG00000028511","3",522453729,522454841,1112
"19748","ENSMODG00000028512","5",65352480,65353630,1150
"19749","ENSMODG00000028513","Un",71864808,71865962,1154
"19750","ENSMODG00000028514","6",242917777,242926459,8682
"19751","ENSMODG00000028515","2",35487984,35612711,124727
"19752","ENSMODG00000028516","Un",59331853,59334333,2480
"19753","ENSMODG00000028518","2",314542235,314542756,521
"19754","ENSMODG00000028519","Un",100595881,100597759,1878
"19755","ENSMODG00000028520","6",200206528,200208054,1526
"19756","ENSMODG00000028523","3",103200219,103221969,21750
"19757","ENSMODG00000028524","5",64522314,64559195,36881
"19758","ENSMODG00000028525","8",109918515,109924057,5542
"19759","ENSMODG00000028527","2",85319195,85320562,1367
"19760","ENSMODG00000028528","1",276284305,276432514,148209
"19761","ENSMODG00000028529","Un",10864225,10865331,1106
"19762","ENSMODG00000028530","4",388188794,388374216,185422
"19763","ENSMODG00000028532","5",124709054,124777705,68651
"19764","ENSMODG00000028535","4",73673295,73738152,64857
"19765","ENSMODG00000028536","1",175557452,175558615,1163
"19766","ENSMODG00000028537","6",223999367,224092056,92689
"19767","ENSMODG00000028538","2",497439984,497441447,1463
"19768","ENSMODG00000028539","8",36194487,36235562,41075
"19769","ENSMODG00000028540","7",260135860,260136906,1046
"19770","ENSMODG00000028541","3",495365965,495521698,155733
"19771","ENSMODG00000028542","6",8799333,8800400,1067
"19772","ENSMODG00000028543","1",84073293,84074764,1471
"19773","ENSMODG00000028544","3",54883224,54889143,5919
"19774","ENSMODG00000028545","Un",98801056,98803834,2778
"19775","ENSMODG00000028546","4",69036950,69281394,244444
"19776","ENSMODG00000028547","5",97418130,97419150,1020
"19777","ENSMODG00000028548","2",520615107,520616285,1178
"19778","ENSMODG00000028549","3",433145362,433146798,1436
"19779","ENSMODG00000028550","2",472324334,472326052,1718
"19780","ENSMODG00000028551","5",122122196,122123283,1087
"19781","ENSMODG00000028552","X",51058776,51059941,1165
"19782","ENSMODG00000028553","2",23733170,23734570,1400
"19783","ENSMODG00000028554","7",142029101,142216416,187315
"19784","ENSMODG00000028555","3",466214945,466286203,71258
"19785","ENSMODG00000028556","Un",71579513,71588936,9423
"19786","ENSMODG00000028557","2",258242945,258245961,3016
"19787","ENSMODG00000028558","3",37485916,37658088,172172
"19788","ENSMODG00000028559","6",44034724,44069859,35135
"19789","ENSMODG00000028560","5",86461249,86462298,1049
"19790","ENSMODG00000028561","4",221803435,221804705,1270
"19791","ENSMODG00000028562","6",262729036,262730626,1590
"19792","ENSMODG00000028563","3",114607868,114642197,34329
"19793","ENSMODG00000028565","Un",60255123,60256151,1028
"19794","ENSMODG00000028566","3",164094387,164249009,154622
"19795","ENSMODG00000028567","3",519876879,519901345,24466
"19796","ENSMODG00000028568","7",169242449,169243897,1448
"19797","ENSMODG00000028569","7",42461844,42463122,1278
"19798","ENSMODG00000028570","6",276630707,276631099,392
"19799","ENSMODG00000028572","7",115371845,115373863,2018
"19800","ENSMODG00000028573","5",3212322,3216914,4592
"19801","ENSMODG00000028574","8",35273510,35274658,1148
"19802","ENSMODG00000028575","2",536491428,536492522,1094
"19803","ENSMODG00000028576","6",221605462,221606596,1134
"19804","ENSMODG00000028577","3",949919,951289,1370
"19805","ENSMODG00000028578","2",183825709,183837684,11975
"19806","ENSMODG00000028579","6",112884145,112885392,1247
"19807","ENSMODG00000028580","Un",92651011,92653343,2332
"19808","ENSMODG00000028581","Un",73079372,73087179,7807
"19809","ENSMODG00000028582","4",369703056,369727513,24457
"19810","ENSMODG00000028583","8",154798382,154799628,1246
"19811","ENSMODG00000028584","Un",89155056,89156626,1570
"19812","ENSMODG00000028585","1",527336659,527397162,60503
"19813","ENSMODG00000028588","1",34643530,34699362,55832
"19814","ENSMODG00000028590","5",281993519,281994400,881
"19815","ENSMODG00000028591","3",523356518,523357639,1121
"19816","ENSMODG00000028592","6",205852670,205854448,1778
"19817","ENSMODG00000028593","3",406928090,406933111,5021
"19818","ENSMODG00000028594","4",363105705,363108481,2776
"19819","ENSMODG00000028595","2",533819637,533846432,26795
"19820","ENSMODG00000028597","2",169011071,169033710,22639
"19821","ENSMODG00000028598","3",492136930,492137971,1041
"19822","ENSMODG00000028599","2",38192830,38193880,1050
"19823","ENSMODG00000028600","3",470307446,470450407,142961
"19824","ENSMODG00000028601","2",33123873,33125055,1182
"19825","ENSMODG00000028602","2",48368022,48371925,3903
"19826","ENSMODG00000028603","3",94394918,94396085,1167
"19827","ENSMODG00000028604","2",104703872,104716554,12682
"19828","ENSMODG00000028605","3",56220473,56221641,1168
"19829","ENSMODG00000028606","4",411619561,411789795,170234
"19830","ENSMODG00000028607","4",402182296,402215915,33619
"19831","ENSMODG00000028608","4",381900623,381905083,4460
"19832","ENSMODG00000028609","8",216924283,216984799,60516
"19833","ENSMODG00000028610","2",111955466,111956946,1480
"19834","ENSMODG00000028611","Un",89307668,89309686,2018
"19835","ENSMODG00000028612","2",172943500,172980001,36501
"19836","ENSMODG00000028613","4",264502321,264524494,22173
"19837","ENSMODG00000028614","Un",98235498,98237177,1679
"19838","ENSMODG00000028615","4",304987183,304988615,1432
"19839","ENSMODG00000028616","4",360740800,360835493,94693
"19840","ENSMODG00000028617","1",327863297,327864323,1026
"19841","ENSMODG00000028618","6",289337642,289389600,51958
"19842","ENSMODG00000028619","1",158917390,158918560,1170
"19843","ENSMODG00000028620","1",81069952,81071011,1059
"19844","ENSMODG00000028622","5",212040654,212087999,47345
"19845","ENSMODG00000028623","7",13100355,13101728,1373
"19846","ENSMODG00000028625","3",16013709,16015449,1740
"19847","ENSMODG00000028626","Un",65235647,65238107,2460
"19848","ENSMODG00000028627","3",501781822,501783390,1568
"19849","ENSMODG00000028628","1",125016631,125018183,1552
"19850","ENSMODG00000028629","2",12974302,12976184,1882
"19851","ENSMODG00000028630","8",163645063,163646320,1257
"19852","ENSMODG00000028631","4",217850456,217856386,5930
"19853","ENSMODG00000028632","Un",66272121,66277206,5085
"19854","ENSMODG00000028633","X",13764862,13788496,23634
"19855","ENSMODG00000028634","3",432083998,432103675,19677
"19856","ENSMODG00000028635","1",37204108,37205274,1166
"19857","ENSMODG00000028636","2",103068472,103082004,13532
"19858","ENSMODG00000028637","8",27945510,27952402,6892
"19859","ENSMODG00000028638","3",260608630,260609982,1352
"19860","ENSMODG00000028639","6",209092432,209098903,6471
"19861","ENSMODG00000028640","3",86913525,87071838,158313
"19862","ENSMODG00000028641","7",87902729,87903736,1007
"19863","ENSMODG00000028642","Un",48037448,48051961,14513
"19864","ENSMODG00000028643","2",254091497,254092635,1138
"19865","ENSMODG00000028645","3",521714968,521744709,29741
"19866","ENSMODG00000028646","4",405121575,405314059,192484
"19867","ENSMODG00000028647","Un",88318662,88319864,1202
"19868","ENSMODG00000028648","6",195642058,195766721,124663
"19869","ENSMODG00000028649","2",326846396,326847619,1223
"19870","ENSMODG00000028650","6",62195773,62197579,1806
"19871","ENSMODG00000028651","3",244455020,244456138,1118
"19872","ENSMODG00000028652","8",201408254,201425128,16874
"19873","ENSMODG00000028653","3",144213474,144226404,12930
"19874","ENSMODG00000028654","X",25296272,25302614,6342
"19875","ENSMODG00000028655","3",476382744,476399357,16613
"19876","ENSMODG00000028656","1",218734991,218737251,2260
"19877","ENSMODG00000028657","3",430174779,430208929,34150
"19878","ENSMODG00000028658","2",501295462,501296584,1122
"19879","ENSMODG00000028659","3",503395887,503477691,81804
"19880","ENSMODG00000028660","1",501039617,501066738,27121
"19881","ENSMODG00000028661","3",10105380,10106544,1164
"19882","ENSMODG00000028662","4",381876518,381891558,15040
"19883","ENSMODG00000028663","3",141243623,141245850,2227
"19884","ENSMODG00000028664","6",228433275,228434817,1542
"19885","ENSMODG00000028665","4",397240757,397242667,1910
"19886","ENSMODG00000028666","3",462984309,462992458,8149
"19887","ENSMODG00000028667","8",36182481,36202816,20335
"19888","ENSMODG00000028668","3",379593059,379594207,1148
"19889","ENSMODG00000028669","2",61942063,61974439,32376
"19890","ENSMODG00000028670","2",237637169,237807147,169978
"19891","ENSMODG00000028671","4",387206024,387215202,9178
"19892","ENSMODG00000028672","6",195080349,195083400,3051
"19893","ENSMODG00000028673","4",213065101,213066453,1352
"19894","ENSMODG00000028675","Un",62312809,62314083,1274
"19895","ENSMODG00000028676","2",252979895,253062416,82521
"19896","ENSMODG00000028677","2",38206620,38216494,9874
"19897","ENSMODG00000028678","Un",90714465,90715822,1357
"19898","ENSMODG00000028679","7",233793118,233918712,125594
"19899","ENSMODG00000028681","6",96913972,96915219,1247
"19900","ENSMODG00000028682","8",137590113,137622828,32715
"19901","ENSMODG00000028683","8",55038284,55039642,1358
"19902","ENSMODG00000028684","5",228309165,228313741,4576
"19903","ENSMODG00000028685","Un",74366253,74367342,1089
"19904","ENSMODG00000028686","Un",87911717,87913958,2241
"19905","ENSMODG00000028688","2",498978830,498982432,3602
"19906","ENSMODG00000028689","3",480388927,480392403,3476
"19907","ENSMODG00000028690","Un",78804490,78808160,3670
"19908","ENSMODG00000028691","2",274723344,274724889,1545
"19909","ENSMODG00000028693","1",136533027,136662418,129391
"19910","ENSMODG00000028694","3",193156831,193163789,6958
"19911","ENSMODG00000028695","3",422058442,422164176,105734
"19912","ENSMODG00000028696","2",138022716,138023723,1007
"19913","ENSMODG00000028697","Un",100254230,100258738,4508
"19914","ENSMODG00000028698","3",94393556,94394618,1062
"19915","ENSMODG00000028699","1",71717217,71827208,109991
"19916","ENSMODG00000028700","6",148069296,148077412,8116
"19917","ENSMODG00000028701","3",374497666,374499054,1388
"19918","ENSMODG00000028702","7",159970934,159972539,1605
"19919","ENSMODG00000028703","3",501547148,501548287,1139
"19920","ENSMODG00000028704","7",259460363,259763133,302770
"19921","ENSMODG00000028705","3",342546087,342617059,70972
"19922","ENSMODG00000028706","5",300291012,300293622,2610
"19923","ENSMODG00000028707","Un",27343426,27344576,1150
"19924","ENSMODG00000028708","6",247390841,247398960,8119
"19925","ENSMODG00000028709","3",502395014,502408028,13014
"19926","ENSMODG00000028710","3",184731867,184733967,2100
"19927","ENSMODG00000028711","3",337960949,338138126,177177
"19928","ENSMODG00000028712","1",20751647,20769860,18213
"19929","ENSMODG00000028714","5",220024158,220025242,1084
"19930","ENSMODG00000028715","2",258217981,258245993,28012
"19931","ENSMODG00000028716","8",246653178,246669860,16682
"19932","ENSMODG00000028717","2",256283778,256299928,16150
"19933","ENSMODG00000028719","4",106842333,106843751,1418
"19934","ENSMODG00000028720","Un",52622672,52630088,7416
"19935","ENSMODG00000028721","4",134572392,134573535,1143
"19936","ENSMODG00000028722","7",254431339,254434931,3592
"19937","ENSMODG00000028723","4",44277546,44278574,1028
"19938","ENSMODG00000028724","8",295367545,295368909,1364
"19939","ENSMODG00000028725","Un",55974197,55999940,25743
"19940","ENSMODG00000028726","5",136214795,136215955,1160
"19941","ENSMODG00000028727","3",329460,344138,14678
"19942","ENSMODG00000028729","4",424846328,424858939,12611
"19943","ENSMODG00000028730","4",218972789,218975013,2224
"19944","ENSMODG00000028731","2",378754511,378755515,1004
"19945","ENSMODG00000028732","3",503519222,503528859,9637
"19946","ENSMODG00000028733","5",11260850,11262349,1499
"19947","ENSMODG00000028734","Un",28,20750,20722
"19948","ENSMODG00000028735","3",214545252,214546962,1710
"19949","ENSMODG00000028736","5",200641539,200813356,171817
"19950","ENSMODG00000028737","Un",63926163,63939632,13469
"19951","ENSMODG00000028738","Un",72574655,72576914,2259
"19952","ENSMODG00000028739","7",76700168,76879893,179725
"19953","ENSMODG00000028740","5",280947662,281065012,117350
"19954","ENSMODG00000028741","2",387815999,387818851,2852
"19955","ENSMODG00000028742","3",5358828,5360210,1382
"19956","ENSMODG00000028743","7",41246285,41247421,1136
"19957","ENSMODG00000028744","3",2448016,2449026,1010
"19958","ENSMODG00000028745","1",379038476,379046988,8512
"19959","ENSMODG00000028746","3",486409696,486410711,1015
"19960","ENSMODG00000028747","Un",58721435,58825929,104494
"19961","ENSMODG00000028748","3",23492850,23645256,152406
"19962","ENSMODG00000028749","2",478101724,478110741,9017
"19963","ENSMODG00000028750","6",277730062,277737601,7539
"19964","ENSMODG00000028751","8",80734090,80766061,31971
"19965","ENSMODG00000028752","3",102726037,102727095,1058
"19966","ENSMODG00000028753","5",254131691,254177337,45646
"19967","ENSMODG00000028755","6",148135829,148144806,8977
"19968","ENSMODG00000028756","1",343710631,343727101,16470
"19969","ENSMODG00000028757","5",241543309,241544377,1068
"19970","ENSMODG00000028758","8",206123542,206154674,31132
"19971","ENSMODG00000028760","7",102326468,102328707,2239
"19972","ENSMODG00000028761","Un",8247034,8257236,10202
"19973","ENSMODG00000028762","3",391907700,391908875,1175
"19974","ENSMODG00000028763","1",330799978,330820195,20217
"19975","ENSMODG00000028764","3",481558627,481568377,9750
"19976","ENSMODG00000028765","1",140839018,140902495,63477
"19977","ENSMODG00000028767","6",206037285,206043658,6373
"19978","ENSMODG00000028768","3",232058049,232059065,1016
"19979","ENSMODG00000028769","8",246580310,246588166,7856
"19980","ENSMODG00000028770","Un",76991061,76993845,2784
"19981","ENSMODG00000028771","4",222712174,222717805,5631
"19982","ENSMODG00000028772","1",399902514,399917546,15032
"19983","ENSMODG00000028773","4",433128810,433161965,33155
"19984","ENSMODG00000028774","Un",11824656,11881717,57061
"19985","ENSMODG00000028775","Un",65012485,65028139,15654
"19986","ENSMODG00000028776","1",482614708,482617267,2559
"19987","ENSMODG00000028777","4",113522837,113524039,1202
"19988","ENSMODG00000028778","7",151741700,151743481,1781
"19989","ENSMODG00000028780","3",494686317,494687453,1136
"19990","ENSMODG00000028781","1",81251593,81252622,1029
"19991","ENSMODG00000028782","1",438265422,438266651,1229
"19992","ENSMODG00000028783","5",234696894,234698618,1724
"19993","ENSMODG00000028784","2",98621794,98627022,5228
"19994","ENSMODG00000028785","8",108220344,108233265,12921
"19995","ENSMODG00000028786","4",322975254,322990753,15499
"19996","ENSMODG00000028787","1",438980960,439012570,31610
"19997","ENSMODG00000028788","3",512445506,512453521,8015
"19998","ENSMODG00000028789","3",313834023,313859714,25691
"19999","ENSMODG00000028790","X",4963030,4975940,12910
"20000","ENSMODG00000028791","6",163539565,163546097,6532
"20001","ENSMODG00000028792","3",424511349,424531451,20102
"20002","ENSMODG00000028793","3",330401743,330409861,8118
"20003","ENSMODG00000028795","4",222763661,222769370,5709
"20004","ENSMODG00000028796","4",426525521,426526561,1040
"20005","ENSMODG00000028797","Un",76071125,76076748,5623
"20006","ENSMODG00000028798","Un",9311070,9324725,13655
"20007","ENSMODG00000028799","6",1507257,1508273,1016
"20008","ENSMODG00000028800","4",316306337,316307456,1119
"20009","ENSMODG00000028802","2",136414850,136416423,1573
"20010","ENSMODG00000028803","6",197506783,197518683,11900
"20011","ENSMODG00000028805","4",347507316,347535328,28012
"20012","ENSMODG00000028806","3",332185160,332187810,2650
"20013","ENSMODG00000028807","7",243754532,243766088,11556
"20014","ENSMODG00000028808","7",235119979,235122669,2690
"20015","ENSMODG00000028809","6",199685576,199709791,24215
"20016","ENSMODG00000028810","8",286116651,286157418,40767
"20017","ENSMODG00000028811","8",13337424,13339727,2303
"20018","ENSMODG00000028812","1",469240796,469247486,6690
"20019","ENSMODG00000028813","6",109612687,109614017,1330
"20020","ENSMODG00000028814","4",243901325,243903554,2229
"20021","ENSMODG00000028815","3",434205393,434207873,2480
"20022","ENSMODG00000028816","4",354247884,354254657,6773
"20023","ENSMODG00000028817","4",350095667,350096776,1109
"20024","ENSMODG00000028818","8",40001852,40003362,1510
"20025","ENSMODG00000028820","1",311044102,311129816,85714
"20026","ENSMODG00000028821","2",499540308,499545407,5099
"20027","ENSMODG00000028822","4",406106969,406126637,19668
"20028","ENSMODG00000028823","3",462221151,462231213,10062
"20029","ENSMODG00000028824","8",17313570,17314592,1022
"20030","ENSMODG00000028826","5",70367851,70369169,1318
"20031","ENSMODG00000028827","Un",101715855,101717609,1754
"20032","ENSMODG00000028829","4",91783814,91785478,1664
"20033","ENSMODG00000028830","5",303833090,303834433,1343
"20034","ENSMODG00000028831","1",6662844,6810744,147900
"20035","ENSMODG00000028832","1",2245070,2246108,1038
"20036","ENSMODG00000028833","Un",73272685,73281687,9002
"20037","ENSMODG00000028834","Un",42586656,42631878,45222
"20038","ENSMODG00000028835","2",419731043,419732129,1086
"20039","ENSMODG00000028836","Un",39876964,39880525,3561
"20040","ENSMODG00000028837","4",15191823,15193032,1209
"20041","ENSMODG00000028838","2",27244338,27246166,1828
"20042","ENSMODG00000028839","1",361943924,361984667,40743
"20043","ENSMODG00000028841","3",410444977,410467887,22910
"20044","ENSMODG00000028842","Un",97192465,97194732,2267
"20045","ENSMODG00000028843","1",58135730,58141472,5742
"20046","ENSMODG00000028844","4",377730153,377732407,2254
"20047","ENSMODG00000028846","4",63879497,63918845,39348
"20048","ENSMODG00000028847","2",334016475,334118396,101921
"20049","ENSMODG00000028848","7",52278591,52291806,13215
"20050","ENSMODG00000028849","4",377358900,377359538,638
"20051","ENSMODG00000028850","8",249941132,250000094,58962
"20052","ENSMODG00000028851","2",499046857,499054894,8037
"20053","ENSMODG00000028852","3",443887741,443889038,1297
"20054","ENSMODG00000028853","Un",1262231,1410289,148058
"20055","ENSMODG00000028854","4",389950528,389966284,15756
"20056","ENSMODG00000028855","2",257812615,257822783,10168
"20057","ENSMODG00000028856","1",163190616,163191814,1198
"20058","ENSMODG00000028857","8",292326832,292383924,57092
"20059","ENSMODG00000028858","7",208238642,208271593,32951
"20060","ENSMODG00000028859","1",499723840,499733362,9522
"20061","ENSMODG00000028860","2",195334607,195337703,3096
"20062","ENSMODG00000028862","5",194228388,194229482,1094
"20063","ENSMODG00000028863","2",11183300,11246234,62934
"20064","ENSMODG00000028864","2",341409915,341443175,33260
"20065","ENSMODG00000028865","3",155668575,155719487,50912
"20066","ENSMODG00000028866","2",510937854,511138072,200218
"20067","ENSMODG00000028867","2",15415556,15423979,8423
"20068","ENSMODG00000028868","1",13828644,13832926,4282
"20069","ENSMODG00000028870","8",113797904,113804476,6572
"20070","ENSMODG00000028871","6",194527034,194612956,85922
"20071","ENSMODG00000028872","6",289793412,289794497,1085
"20072","ENSMODG00000028873","6",283842392,283844461,2069
"20073","ENSMODG00000028874","2",95242731,95243873,1142
"20074","ENSMODG00000028875","1",16067540,16068832,1292
"20075","ENSMODG00000028876","6",287943579,287944859,1280
"20076","ENSMODG00000028877","8",246638061,246643810,5749
"20077","ENSMODG00000028878","3",277264545,277381503,116958
"20078","ENSMODG00000028879","8",66832263,66835185,2922
"20079","ENSMODG00000028880","3",56704115,56709174,5059
"20080","ENSMODG00000028881","1",11427987,11444427,16440
"20081","ENSMODG00000028882","Un",79799805,79804223,4418
"20082","ENSMODG00000028884","1",533593624,533594759,1135
"20083","ENSMODG00000028885","6",247737138,247896109,158971
"20084","ENSMODG00000028886","6",64414840,64456427,41587
"20085","ENSMODG00000028887","Un",74951528,74958867,7339
"20086","ENSMODG00000028888","1",40670532,40671753,1221
"20087","ENSMODG00000028889","2",324609799,324611177,1378
"20088","ENSMODG00000028890","4",260736874,260737949,1075
"20089","ENSMODG00000028891","8",132112932,132178294,65362
"20090","ENSMODG00000028892","7",260423998,260425151,1153
"20091","ENSMODG00000028893","Un",37888365,38036044,147679
"20092","ENSMODG00000028894","7",260534534,260535709,1175
"20093","ENSMODG00000028895","2",1019586,1020779,1193
"20094","ENSMODG00000028896","3",480692488,480694434,1946
"20095","ENSMODG00000028897","1",306049177,306050831,1654
"20096","ENSMODG00000028899","5",279173830,279277135,103305
"20097","ENSMODG00000028900","Un",28778616,28856748,78132
"20098","ENSMODG00000028901","3",462122517,462306277,183760
"20099","ENSMODG00000028902","3",500053671,500078135,24464
"20100","ENSMODG00000028903","4",197575363,197577290,1927
"20101","ENSMODG00000028904","2",481141663,481154833,13170
"20102","ENSMODG00000028905","6",147771514,147778619,7105
"20103","ENSMODG00000028906","1",511972337,512012705,40368
"20104","ENSMODG00000028907","4",128523825,128525170,1345
"20105","ENSMODG00000028908","Un",46969703,46978911,9208
"20106","ENSMODG00000028909","5",80338496,80339566,1070
"20107","ENSMODG00000028910","6",143845208,143847182,1974
"20108","ENSMODG00000028911","1",498373186,498453400,80214
"20109","ENSMODG00000028912","3",241730906,241731910,1004
"20110","ENSMODG00000028913","2",8232407,8236711,4304
"20111","ENSMODG00000028914","1",463740126,463741139,1013
"20112","ENSMODG00000028915","6",247603440,247604477,1037
"20113","ENSMODG00000028916","4",405348257,405361325,13068
"20114","ENSMODG00000028917","1",363122571,363124377,1806
"20115","ENSMODG00000028919","4",389431932,389432995,1063
"20116","ENSMODG00000028921","Un",2934818,3486826,552008
"20117","ENSMODG00000028922","Un",80161808,80167953,6145
"20118","ENSMODG00000028924","8",10224051,10225894,1843
"20119","ENSMODG00000028925","Un",19980510,19994312,13802
"20120","ENSMODG00000028926","3",23414646,23459175,44529
"20121","ENSMODG00000028927","6",26434303,26439050,4747
"20122","ENSMODG00000028928","1",339949548,339950792,1244
"20123","ENSMODG00000028929","8",80770857,80773130,2273
"20124","ENSMODG00000028930","2",441975938,441977019,1081
"20125","ENSMODG00000028931","6",250697810,250934492,236682
"20126","ENSMODG00000028932","6",160960201,160961381,1180
"20127","ENSMODG00000028933","3",431064554,431076842,12288
"20128","ENSMODG00000028934","2",504761790,504778233,16443
"20129","ENSMODG00000028935","4",79736941,79737644,703
"20130","ENSMODG00000028936","2",223839306,223841245,1939
"20131","ENSMODG00000028937","Un",69104160,69111867,7707
"20132","ENSMODG00000028938","Un",51514045,51544198,30153
"20133","ENSMODG00000028939","6",69085158,69086662,1504
"20134","ENSMODG00000028940","2",494949040,494994223,45183
"20135","ENSMODG00000028941","3",346785909,346943152,157243
"20136","ENSMODG00000028942","X",56289033,56291897,2864
"20137","ENSMODG00000028943","3",63470418,63471425,1007
"20138","ENSMODG00000028944","1",8835045,8836044,999
"20139","ENSMODG00000028945","5",137417558,137419333,1775
"20140","ENSMODG00000028946","3",283885978,283887193,1215
"20141","ENSMODG00000028947","Un",13913111,13914239,1128
"20142","ENSMODG00000028949","Un",59893449,59918455,25006
"20143","ENSMODG00000028950","3",355784615,355785647,1032
"20144","ENSMODG00000028951","6",30052743,30173053,120310
"20145","ENSMODG00000028952","4",40098072,40099151,1079
"20146","ENSMODG00000028953","2",115013570,115066539,52969
"20147","ENSMODG00000028954","1",441825095,441826283,1188
"20148","ENSMODG00000028955","2",514008801,514010221,1420
"20149","ENSMODG00000028956","1",425936035,425937067,1032
"20150","ENSMODG00000028957","5",188412892,188413928,1036
"20151","ENSMODG00000028958","8",298857194,298858518,1324
"20152","ENSMODG00000028959","X",4852464,4854125,1661
"20153","ENSMODG00000028960","6",114326864,114329100,2236
"20154","ENSMODG00000028962","3",101057582,101116814,59232
"20155","ENSMODG00000028963","4",173507152,173550922,43770
"20156","ENSMODG00000028965","X",27252996,27264253,11257
"20157","ENSMODG00000028966","1",77776317,77796729,20412
"20158","ENSMODG00000028967","3",56821568,56853376,31808
"20159","ENSMODG00000028968","6",34897374,34899382,2008
"20160","ENSMODG00000028970","2",10702978,10905852,202874
"20161","ENSMODG00000028971","4",23793555,23794625,1070
"20162","ENSMODG00000028972","3",80878147,80931414,53267
"20163","ENSMODG00000028973","Un",68814141,68815314,1173
"20164","ENSMODG00000028974","5",153235034,153236169,1135
"20165","ENSMODG00000028976","1",400382522,400489898,107376
"20166","ENSMODG00000028977","4",73575796,73597484,21688
"20167","ENSMODG00000028978","6",161465622,161589712,124090
"20168","ENSMODG00000028979","2",256008104,256014172,6068
"20169","ENSMODG00000028980","5",110495017,110516526,21509
"20170","ENSMODG00000028981","4",104339265,104340382,1117
"20171","ENSMODG00000028982","1",16623846,16638903,15057
"20172","ENSMODG00000028983","2",508123375,508170536,47161
"20173","ENSMODG00000028984","4",57310611,57312251,1640
"20174","ENSMODG00000028985","Un",23214370,23216175,1805
"20175","ENSMODG00000028986","4",312021408,312042819,21411
"20176","ENSMODG00000028987","6",107910542,107911677,1135
"20177","ENSMODG00000028988","4",372291382,372293154,1772
"20178","ENSMODG00000028990","1",59479151,59480929,1778
"20179","ENSMODG00000028991","Un",30101347,30102377,1030
"20180","ENSMODG00000028992","7",115716078,115717108,1030
"20181","ENSMODG00000028993","4",158905150,158906794,1644
"20182","ENSMODG00000028994","3",416291254,416292270,1016
"20183","ENSMODG00000028995","Un",52194283,52215102,20819
"20184","ENSMODG00000028996","4",330578724,330579856,1132
"20185","ENSMODG00000028997","2",96822446,96823823,1377
"20186","ENSMODG00000028998","Un",787202,794335,7133
"20187","ENSMODG00000028999","5",25698197,25699782,1585
"20188","ENSMODG00000029000","Un",83082181,83086260,4079
"20189","ENSMODG00000029001","8",170439240,170440241,1001
"20190","ENSMODG00000029002","5",222065590,222066590,1000
"20191","ENSMODG00000029003","1",225419698,225420936,1238
"20192","ENSMODG00000029004","3",504465401,504466621,1220
"20193","ENSMODG00000029005","2",375683804,375684916,1112
"20194","ENSMODG00000029006","4",411741444,411742700,1256
"20195","ENSMODG00000029007","Un",46418984,46422565,3581
"20196","ENSMODG00000029008","2",32935,35379,2444
"20197","ENSMODG00000029010","1",170946366,170947213,847
"20198","ENSMODG00000029011","4",256367672,256369061,1389
"20199","ENSMODG00000029012","1",360154936,360156883,1947
"20200","ENSMODG00000029013","1",58150944,58157941,6997
"20201","ENSMODG00000029014","8",191299470,191367964,68494
"20202","ENSMODG00000029015","5",295311770,295320917,9147
"20203","ENSMODG00000029016","2",52421959,52423827,1868
"20204","ENSMODG00000029017","X",10816683,10832735,16052
"20205","ENSMODG00000029018","5",155027067,155028099,1032
"20206","ENSMODG00000029019","7",147065387,147066667,1280
"20207","ENSMODG00000029020","2",77508150,77509219,1069
"20208","ENSMODG00000029021","4",93289317,93304520,15203
"20209","ENSMODG00000029022","2",195119807,195146875,27068
"20210","ENSMODG00000029023","Un",30280335,30281419,1084
"20211","ENSMODG00000029024","2",149993559,149995761,2202
"20212","ENSMODG00000029025","8",3990731,3993237,2506
"20213","ENSMODG00000029026","2",523789760,523803037,13277
"20214","ENSMODG00000029027","2",72195544,72210849,15305
"20215","ENSMODG00000029028","6",82550845,82552338,1493
"20216","ENSMODG00000029029","7",200317695,200363497,45802
"20217","ENSMODG00000029030","Un",92622331,92627582,5251
"20218","ENSMODG00000029031","4",416316498,416377918,61420
"20219","ENSMODG00000029032","8",310882867,310883969,1102
"20220","ENSMODG00000029033","1",57341106,57342131,1025
"20221","ENSMODG00000029034","4",397552121,397554768,2647
"20222","ENSMODG00000029035","6",119885397,119919692,34295
"20223","ENSMODG00000029036","2",419032457,419033687,1230
"20224","ENSMODG00000029037","8",8193407,8194462,1055
"20225","ENSMODG00000029038","2",456373230,456516109,142879
"20226","ENSMODG00000029039","Un",47277362,47278835,1473
"20227","ENSMODG00000029040","3",429132881,429137801,4920
"20228","ENSMODG00000029041","3",487395443,487416496,21053
"20229","ENSMODG00000029042","4",379952295,379966341,14046
"20230","ENSMODG00000029043","5",31659288,31669715,10427
"20231","ENSMODG00000029044","3",100075105,100077032,1927
"20232","ENSMODG00000029045","4",258022212,258023457,1245
"20233","ENSMODG00000029046","8",10296950,10302609,5659
"20234","ENSMODG00000029047","7",80831524,80859947,28423
"20235","ENSMODG00000029048","1",535459335,535460478,1143
"20236","ENSMODG00000029049","4",367290460,367339272,48812
"20237","ENSMODG00000029050","8",296957646,296958993,1347
"20238","ENSMODG00000029051","6",67360922,67361993,1071
"20239","ENSMODG00000029052","3",486622385,486626179,3794
"20240","ENSMODG00000029053","3",516486298,516487304,1006
"20241","ENSMODG00000029054","4",253745371,253746568,1197
"20242","ENSMODG00000029055","4",367289927,367307073,17146
"20243","ENSMODG00000029056","1",3147631,3171189,23558
"20244","ENSMODG00000029057","1",345108325,345144257,35932
"20245","ENSMODG00000029058","4",370398539,370404621,6082
"20246","ENSMODG00000029059","3",430472869,430473918,1049
"20247","ENSMODG00000029060","1",429797931,429971364,173433
"20248","ENSMODG00000029061","6",22149520,22150962,1442
"20249","ENSMODG00000029062","4",87907617,87908722,1105
"20250","ENSMODG00000029063","1",85322535,85329695,7160
"20251","ENSMODG00000029064","1",518990152,518992316,2164
"20252","ENSMODG00000029065","8",271589088,271615841,26753
"20253","ENSMODG00000029066","1",49949957,49951584,1627
"20254","ENSMODG00000029067","6",108902435,108903581,1146
"20255","ENSMODG00000029068","4",374751392,374789327,37935
"20256","ENSMODG00000029069","3",520838556,520846022,7466
"20257","ENSMODG00000029070","8",235053854,235055516,1662
"20258","ENSMODG00000029071","1",174055976,174057699,1723
"20259","ENSMODG00000029073","5",27116660,27118629,1969
"20260","ENSMODG00000029074","Un",61821538,61838092,16554
"20261","ENSMODG00000029076","6",83944022,83948726,4704
"20262","ENSMODG00000029077","1",316769205,316770230,1025
"20263","ENSMODG00000029078","8",311072797,311073879,1082
"20264","ENSMODG00000029079","6",151612602,151692607,80005
"20265","ENSMODG00000029080","3",162631425,162736824,105399
"20266","ENSMODG00000029081","3",21882637,21883854,1217
"20267","ENSMODG00000029082","5",233936526,233970254,33728
"20268","ENSMODG00000029083","1",34059708,34161223,101515
"20269","ENSMODG00000029084","4",299754183,299834288,80105
"20270","ENSMODG00000029085","Un",72087983,72131225,43242
"20271","ENSMODG00000029087","6",238036548,238037657,1109
"20272","ENSMODG00000029089","1",815846,963007,147161
"20273","ENSMODG00000029090","2",491424873,491428403,3530
"20274","ENSMODG00000029091","1",358017642,358019133,1491
"20275","ENSMODG00000029092","4",287712862,287724816,11954
"20276","ENSMODG00000029093","4",358550698,358564602,13904
"20277","ENSMODG00000029094","7",64019649,64034208,14559
"20278","ENSMODG00000029095","3",59965046,59966631,1585
"20279","ENSMODG00000029096","Un",99311096,99315056,3960
"20280","ENSMODG00000029097","Un",39535928,39547721,11793
"20281","ENSMODG00000029098","3",101341710,101343044,1334
"20282","ENSMODG00000029100","3",500893400,500907577,14177
"20283","ENSMODG00000029101","1",175558763,175559827,1064
"20284","ENSMODG00000029102","1",408683050,408684665,1615
"20285","ENSMODG00000029103","7",7522543,7524527,1984
"20286","ENSMODG00000029104","2",154234106,154325845,91739
"20287","ENSMODG00000029105","1",334538176,334706465,168289
"20288","ENSMODG00000029106","2",508369844,508376835,6991
"20289","ENSMODG00000029107","4",322655915,322854183,198268
"20290","ENSMODG00000029108","X",51083353,51142924,59571
"20291","ENSMODG00000029109","8",214722163,214740999,18836
"20292","ENSMODG00000029110","2",113988355,113989399,1044
"20293","ENSMODG00000029111","6",291641897,291642955,1058
"20294","ENSMODG00000029112","1",508633937,508635006,1069
"20295","ENSMODG00000029113","1",378535908,378540471,4563
"20296","ENSMODG00000029115","2",244149182,244150452,1270
"20297","ENSMODG00000029116","3",86778985,86780364,1379
"20298","ENSMODG00000029117","Un",75974327,75980132,5805
"20299","ENSMODG00000029118","8",218399150,218400314,1164
"20300","ENSMODG00000029119","2",134198221,134200218,1997
"20301","ENSMODG00000029120","7",29909953,29911075,1122
"20302","ENSMODG00000029121","8",174330894,174365667,34773
"20303","ENSMODG00000029122","6",122811194,122813648,2454
"20304","ENSMODG00000029123","8",246545513,246578219,32706
"20305","ENSMODG00000029124","1",297433118,297451906,18788
"20306","ENSMODG00000029125","3",502102539,502109317,6778
"20307","ENSMODG00000029126","7",256872482,256898202,25720
"20308","ENSMODG00000029127","2",5540493,5541591,1098
"20309","ENSMODG00000029128","3",504588343,504699418,111075
"20310","ENSMODG00000029129","3",513730141,513983706,253565
"20311","ENSMODG00000029130","3",502260255,502282003,21748
"20312","ENSMODG00000029131","1",436673765,436727707,53942
"20313","ENSMODG00000029132","1",4314438,4318941,4503
"20314","ENSMODG00000029133","1",209864030,209948071,84041
"20315","ENSMODG00000029134","3",317377983,317379043,1060
"20316","ENSMODG00000029135","1",27729384,27770978,41594
"20317","ENSMODG00000029136","5",74870838,74871906,1068
"20318","ENSMODG00000029138","4",16608511,16634872,26361
"20319","ENSMODG00000029139","3",522293575,522309588,16013
"20320","ENSMODG00000029140","3",19050009,19229098,179089
"20321","ENSMODG00000029141","3",368911601,368913266,1665
"20322","ENSMODG00000029142","4",206787452,206901562,114110
"20323","ENSMODG00000029143","5",145360714,145361800,1086
"20324","ENSMODG00000029144","7",87629205,87630600,1395
"20325","ENSMODG00000029145","3",187473257,187474574,1317
"20326","ENSMODG00000029146","4",350991907,350994224,2317
"20327","ENSMODG00000029147","8",162990154,162991590,1436
"20328","ENSMODG00000029148","4",268399937,268401073,1136
"20329","ENSMODG00000029149","4",63579987,63582212,2225
"20330","ENSMODG00000029150","4",227468051,227469241,1190
"20331","ENSMODG00000029151","4",384467292,384482605,15313
"20332","ENSMODG00000029152","5",282379567,282384933,5366
"20333","ENSMODG00000029153","1",10293264,10305055,11791
"20334","ENSMODG00000029154","1",72779514,72781195,1681
"20335","ENSMODG00000029156","3",175088907,175090318,1411
"20336","ENSMODG00000029157","2",38298511,38360427,61916
"20337","ENSMODG00000029158","4",9420326,9444935,24609
"20338","ENSMODG00000029159","4",4278940,4280452,1512
"20339","ENSMODG00000029160","5",275946832,275947938,1106
"20340","ENSMODG00000029161","2",8245029,8246610,1581
"20341","ENSMODG00000029162","Un",91625410,91626488,1078
"20342","ENSMODG00000029163","5",287335390,287336819,1429
"20343","ENSMODG00000029166","7",170187967,170203303,15336
"20344","ENSMODG00000029167","8",180512649,180515558,2909
"20345","ENSMODG00000029169","Un",48753158,48773430,20272
"20346","ENSMODG00000029170","Un",32665189,32677154,11965
"20347","ENSMODG00000029171","8",228385557,228386572,1015
"20348","ENSMODG00000029172","1",438108259,438109413,1154
"20349","ENSMODG00000029173","4",389354157,389355716,1559
"20350","ENSMODG00000029174","4",222988753,222999674,10921
"20351","ENSMODG00000029175","X",27809299,27825930,16631
"20352","ENSMODG00000029176","4",210393480,210394653,1173
"20353","ENSMODG00000029178","4",147817248,147819447,2199
"20354","ENSMODG00000029179","7",9410311,9438665,28354
"20355","ENSMODG00000029180","1",16582954,16597394,14440
"20356","ENSMODG00000029181","1",397935395,397964034,28639
"20357","ENSMODG00000029183","8",215044811,215056134,11323
"20358","ENSMODG00000029184","1",194920558,194921739,1181
"20359","ENSMODG00000029185","3",452785332,452786417,1085
"20360","ENSMODG00000029186","6",131992193,131993536,1343
"20361","ENSMODG00000029187","6",188720474,188722684,2210
"20362","ENSMODG00000029188","3",523165143,523180326,15183
"20363","ENSMODG00000029190","7",203369154,203370391,1237
"20364","ENSMODG00000029191","4",49310813,49312027,1214
"20365","ENSMODG00000029192","Un",90274620,90275678,1058
"20366","ENSMODG00000029193","Un",20377601,20741657,364056
"20367","ENSMODG00000029194","X",25370846,25374460,3614
"20368","ENSMODG00000029195","6",263604597,263606688,2091
"20369","ENSMODG00000029196","4",73133485,73135488,2003
"20370","ENSMODG00000029197","2",76433616,76434776,1160
"20371","ENSMODG00000029198","2",66079981,66084759,4778
"20372","ENSMODG00000029199","2",521563788,521565005,1217
"20373","ENSMODG00000029200","Un",102365105,102367612,2507
"20374","ENSMODG00000029201","Un",31699632,31880009,180377
"20375","ENSMODG00000029202","2",284092825,284094031,1206
"20376","ENSMODG00000029204","1",196355578,196404792,49214
"20377","ENSMODG00000029205","4",363046162,363047529,1367
"20378","ENSMODG00000029206","Un",79201746,79210842,9096
"20379","ENSMODG00000029207","2",103093469,103094596,1127
"20380","ENSMODG00000029208","5",107906587,107907892,1305
"20381","ENSMODG00000029209","5",63653054,63654073,1019
"20382","ENSMODG00000029210","X",43782299,43788110,5811
"20383","ENSMODG00000029211","8",214354999,214375376,20377
"20384","ENSMODG00000029212","2",527096489,527192326,95837
"20385","ENSMODG00000029213","3",407825444,407826749,1305
"20386","ENSMODG00000029214","Un",69331122,69332180,1058
"20387","ENSMODG00000029215","Un",83847885,83851128,3243
"20388","ENSMODG00000029216","4",311734163,311735180,1017
"20389","ENSMODG00000029217","5",5787025,5788811,1786
"20390","ENSMODG00000029218","8",272380231,272381654,1423
"20391","ENSMODG00000029220","6",1167325,1446948,279623
"20392","ENSMODG00000029221","X",60172814,60267403,94589
"20393","ENSMODG00000029222","3",464315592,464316945,1353
"20394","ENSMODG00000029224","8",269404203,269405615,1412
"20395","ENSMODG00000029225","6",116554704,116555289,585
"20396","ENSMODG00000029226","3",168415049,168416797,1748
"20397","ENSMODG00000029227","5",280351587,280366102,14515
"20398","ENSMODG00000029228","2",233602874,233630847,27973
"20399","ENSMODG00000029229","3",230472529,230474964,2435
"20400","ENSMODG00000029230","7",56918895,56920098,1203
"20401","ENSMODG00000029231","8",292824920,292932039,107119
"20402","ENSMODG00000029233","8",203539765,203540944,1179
"20403","ENSMODG00000029234","3",298025393,298121315,95922
"20404","ENSMODG00000029235","2",203870733,203872085,1352
"20405","ENSMODG00000029236","2",3102594,3190181,87587
"20406","ENSMODG00000029237","2",136817301,136855305,38004
"20407","ENSMODG00000029238","5",129905595,129906979,1384
"20408","ENSMODG00000029239","3",146772710,147149330,376620
"20409","ENSMODG00000029240","3",348239088,348592158,353070
"20410","ENSMODG00000029241","7",173132823,173134880,2057
"20411","ENSMODG00000029242","4",325820862,326096925,276063
"20412","ENSMODG00000029243","4",355367367,355368554,1187
"20413","ENSMODG00000029244","3",445291937,445312923,20986
"20414","ENSMODG00000029245","1",85131763,85143156,11393
"20415","ENSMODG00000029246","6",222532905,222543822,10917
"20416","ENSMODG00000029247","7",49640614,49697879,57265
"20417","ENSMODG00000029248","5",169961750,169992101,30351
"20418","ENSMODG00000029249","5",238678063,238693720,15657
"20419","ENSMODG00000029250","2",513636980,513639988,3008
"20420","ENSMODG00000029251","5",301023914,301025379,1465
"20421","ENSMODG00000029252","5",152423427,152424453,1026
"20422","ENSMODG00000029253","5",260052879,260500630,447751
"20423","ENSMODG00000029254","1",103446102,103524014,77912
"20424","ENSMODG00000029255","1",73767349,73768904,1555
"20425","ENSMODG00000029256","4",230750924,230751997,1073
"20426","ENSMODG00000029257","5",42190000,42206556,16556
"20427","ENSMODG00000029258","7",251203594,251256692,53098
"20428","ENSMODG00000029259","Un",43870922,43880517,9595
"20429","ENSMODG00000029260","5",250024075,250025191,1116
"20430","ENSMODG00000029261","5",298522756,298524798,2042
"20431","ENSMODG00000029262","1",359857941,359859993,2052
"20432","ENSMODG00000029263","6",258937058,259130908,193850
"20433","ENSMODG00000029264","6",259740283,259748164,7881
"20434","ENSMODG00000029265","4",17704548,17705743,1195
"20435","ENSMODG00000029266","2",35961053,36053808,92755
"20436","ENSMODG00000029267","Un",4074383,4075522,1139
"20437","ENSMODG00000029268","7",253355352,253380057,24705
"20438","ENSMODG00000029269","5",262212480,262213615,1135
"20439","ENSMODG00000029270","4",107066705,107068941,2236
"20440","ENSMODG00000029271","1",390761394,390762718,1324
"20441","ENSMODG00000029273","4",67986741,68023573,36832
"20442","ENSMODG00000029274","8",121371376,121372467,1091
"20443","ENSMODG00000029276","2",150929881,150931485,1604
"20444","ENSMODG00000029277","3",1835946,1837066,1120
"20445","ENSMODG00000029278","7",189091832,189137630,45798
"20446","ENSMODG00000029279","4",248673587,248709043,35456
"20447","ENSMODG00000029280","5",3164868,3165885,1017
"20448","ENSMODG00000029281","1",167254566,167256290,1724
"20449","ENSMODG00000029282","6",217382033,217383150,1117
"20450","ENSMODG00000029283","2",114264047,114267872,3825
"20451","ENSMODG00000029284","5",281317612,281358377,40765
"20452","ENSMODG00000029285","8",117888622,117889971,1349
"20453","ENSMODG00000029286","8",275999585,276000950,1365
"20454","ENSMODG00000029287","1",39847747,39848800,1053
"20455","ENSMODG00000029288","7",260339506,260340772,1266
"20456","ENSMODG00000029289","Un",42454432,42455835,1403
"20457","ENSMODG00000029290","2",407686495,407687901,1406
"20458","ENSMODG00000029291","3",27581305,27582325,1020
"20459","ENSMODG00000029292","2",251694342,251695415,1073
"20460","ENSMODG00000029293","1",410567276,410568599,1323
"20461","ENSMODG00000029294","2",83159008,83161477,2469
"20462","ENSMODG00000029295","8",230020011,230021035,1024
"20463","ENSMODG00000029296","7",259392112,259409030,16918
"20464","ENSMODG00000029297","1",383424372,383431830,7458
"20465","ENSMODG00000029298","1",207311904,207314832,2928
"20466","ENSMODG00000029299","2",140746460,140763804,17344
"20467","ENSMODG00000029300","6",270534842,270558254,23412
"20468","ENSMODG00000029301","Un",51279314,51293451,14137
"20469","ENSMODG00000029302","8",262382831,262496787,113956
"20470","ENSMODG00000029303","6",279319090,279462366,143276
"20471","ENSMODG00000029304","2",287159902,287162648,2746
"20472","ENSMODG00000029305","1",480066384,480068691,2307
"20473","ENSMODG00000029306","3",230470651,230472363,1712
"20474","ENSMODG00000029307","1",332637457,332900773,263316
"20475","ENSMODG00000029308","8",214749306,214750306,1000
"20476","ENSMODG00000029309","3",137285622,137287051,1429
"20477","ENSMODG00000029310","Un",96555816,96559227,3411
"20478","ENSMODG00000029311","2",203331039,203332876,1837
"20479","ENSMODG00000029312","8",295320930,295325689,4759
"20480","ENSMODG00000029313","7",36476748,36477945,1197
"20481","ENSMODG00000029314","4",262063761,262122794,59033
"20482","ENSMODG00000029315","Un",9200757,9207298,6541
"20483","ENSMODG00000029316","Un",82352633,82355129,2496
"20484","ENSMODG00000029317","1",195740081,196035800,295719
"20485","ENSMODG00000029318","1",128048791,128050758,1967
"20486","ENSMODG00000029319","4",304985727,304987166,1439
"20487","ENSMODG00000029320","6",112885599,112886727,1128
"20488","ENSMODG00000029321","3",24178608,24193448,14840
"20489","ENSMODG00000029322","4",145735128,145736467,1339
"20490","ENSMODG00000029323","1",503906572,503909782,3210
"20491","ENSMODG00000029324","3",487837078,488013734,176656
"20492","ENSMODG00000029325","7",62929920,62931118,1198
"20493","ENSMODG00000029327","6",200238438,200240540,2102
"20494","ENSMODG00000029328","8",119093352,119180910,87558
"20495","ENSMODG00000029329","7",53581096,53655667,74571
"20496","ENSMODG00000029330","3",39866380,39867470,1090
"20497","ENSMODG00000029332","Un",8329744,8331363,1619
"20498","ENSMODG00000029333","1",69166334,69181246,14912
"20499","ENSMODG00000029334","4",339750817,339752008,1191
"20500","ENSMODG00000029335","2",194910966,194912150,1184
"20501","ENSMODG00000029336","2",531897765,531898781,1016
"20502","ENSMODG00000029337","6",201269944,201288094,18150
"20503","ENSMODG00000029338","3",479464227,479467434,3207
"20504","ENSMODG00000029339","2",380585992,380947582,361590
"20505","ENSMODG00000029341","7",42463744,42464777,1033
"20506","ENSMODG00000029342","4",417799105,417826479,27374
"20507","ENSMODG00000029343","Un",75253200,75259142,5942
"20508","ENSMODG00000029344","3",276137741,276139011,1270
"20509","ENSMODG00000029345","3",519356019,519361939,5920
"20510","ENSMODG00000029346","5",215875961,216064257,188296
"20511","ENSMODG00000029347","3",521888827,521889922,1095
"20512","ENSMODG00000029349","3",185357667,185634272,276605
"20513","ENSMODG00000029350","5",164944454,164945575,1121
"20514","ENSMODG00000029352","5",173658189,173659880,1691
"20515","ENSMODG00000029353","1",13895111,13918257,23146
"20516","ENSMODG00000029354","1",361471157,361478584,7427
"20517","ENSMODG00000029355","4",404041411,404070749,29338
"20518","ENSMODG00000029356","Un",92334683,92335648,965
"20519","ENSMODG00000029357","8",184145492,184146512,1020
"20520","ENSMODG00000029358","6",138210480,138435569,225089
"20521","ENSMODG00000029360","1",207296569,207298318,1749
"20522","ENSMODG00000029361","1",102634910,102636093,1183
"20523","ENSMODG00000029362","2",204965462,204966534,1072
"20524","ENSMODG00000029363","6",221627562,221628568,1006
"20525","ENSMODG00000029364","3",509498141,509511527,13386
"20526","ENSMODG00000029365","1",22599451,22600542,1091
"20527","ENSMODG00000029366","Un",83259498,83261228,1730
"20528","ENSMODG00000029367","1",56781565,56879931,98366
"20529","ENSMODG00000029368","Un",2323468,2477759,154291
"20530","ENSMODG00000029369","7",56849001,56850528,1527
"20531","ENSMODG00000029371","1",37313839,37315008,1169
"20532","ENSMODG00000029372","1",299159461,299196458,36997
"20533","ENSMODG00000029373","2",511544275,511545374,1099
"20534","ENSMODG00000029374","1",39540529,39541587,1058
"20535","ENSMODG00000029375","3",11563932,11565452,1520
"20536","ENSMODG00000029376","8",240114106,240483361,369255
"20537","ENSMODG00000029377","3",395060125,395062046,1921
"20538","ENSMODG00000029379","8",249929219,249930563,1344
"20539","ENSMODG00000029380","2",32959961,33112519,152558
"20540","ENSMODG00000029381","Un",44695940,44766519,70579
"20541","ENSMODG00000029382","8",234382085,234383444,1359
"20542","ENSMODG00000029383","5",7075297,7077779,2482
"20543","ENSMODG00000029384","3",462154988,462369251,214263
"20544","ENSMODG00000029385","1",332023155,332032458,9303
"20545","ENSMODG00000029386","Un",49921154,49980003,58849
"20546","ENSMODG00000029387","7",253321185,253324062,2877
"20547","ENSMODG00000029388","2",23476645,23479469,2824
"20548","ENSMODG00000029390","Un",89773347,89775129,1782
"20549","ENSMODG00000029391","1",520491642,520493619,1977
"20550","ENSMODG00000029393","Un",94624246,94625568,1322
"20551","ENSMODG00000029395","8",97263552,97264745,1193
"20552","ENSMODG00000029396","1",4741110,4742300,1190
"20553","ENSMODG00000029397","4",402369627,402615750,246123
"20554","ENSMODG00000029398","4",24073727,24249391,175664
"20555","ENSMODG00000029399","5",205131677,205132805,1128
"20556","ENSMODG00000029400","Un",48417963,48419318,1355
"20557","ENSMODG00000029401","8",64921551,64922224,673
"20558","ENSMODG00000029402","Un",84953857,84959886,6029
"20559","ENSMODG00000029403","5",282624176,282627293,3117
"20560","ENSMODG00000029404","6",147085289,147086851,1562
"20561","ENSMODG00000029405","Un",88705232,88706335,1103
"20562","ENSMODG00000029406","1",432450901,432465192,14291
"20563","ENSMODG00000029407","Un",53795550,53806362,10812
"20564","ENSMODG00000029408","2",112414958,112416601,1643
"20565","ENSMODG00000029409","3",286209384,286210641,1257
"20566","ENSMODG00000029410","3",77961575,78142816,181241
"20567","ENSMODG00000029411","8",188731420,188732570,1150
"20568","ENSMODG00000029412","4",85663754,85694472,30718
"20569","ENSMODG00000029413","2",430921672,431062547,140875
"20570","ENSMODG00000029414","4",25696038,25698606,2568
"20571","ENSMODG00000029415","1",467276506,467283001,6495
"20572","ENSMODG00000029416","X",13582908,13584612,1704
"20573","ENSMODG00000029417","3",439322600,439323138,538
"20574","ENSMODG00000029418","3",523124018,523216101,92083
"20575","ENSMODG00000029419","Un",92225041,92226361,1320
"20576","ENSMODG00000029420","2",709582,852083,142501
"20577","ENSMODG00000029421","6",112881855,112883050,1195
"20578","ENSMODG00000029422","4",266508671,266510459,1788
"20579","ENSMODG00000029423","6",188333481,188473759,140278
"20580","ENSMODG00000029424","4",409687675,409697273,9598
"20581","ENSMODG00000029425","4",404360529,404382640,22111
"20582","ENSMODG00000029426","3",514580339,514581721,1382
"20583","ENSMODG00000029427","Un",39941076,39985080,44004
"20584","ENSMODG00000029429","5",303777490,303779252,1762
"20585","ENSMODG00000029430","X",32664581,32665780,1199
"20586","ENSMODG00000029431","Un",11661585,11664034,2449
"20587","ENSMODG00000029432","2",283806156,283818795,12639
"20588","ENSMODG00000029433","6",216748116,216749582,1466
"20589","ENSMODG00000029434","7",11796695,11800048,3353
"20590","ENSMODG00000029435","5",301599166,301616645,17479
"20591","ENSMODG00000029436","3",392526698,392528670,1972
"20592","ENSMODG00000029437","1",84077064,84079453,2389
"20593","ENSMODG00000029438","3",477971441,477973783,2342
"20594","ENSMODG00000029439","2",230401967,230402741,774
"20595","ENSMODG00000029440","3",478559367,478581833,22466
"20596","ENSMODG00000029441","8",80000101,80056133,56032
"20597","ENSMODG00000029442","4",124433427,124435012,1585
"20598","ENSMODG00000029443","8",204916987,204918273,1286
"20599","ENSMODG00000029444","2",523181395,523182948,1553
"20600","ENSMODG00000029445","1",467190051,467213847,23796
"20601","ENSMODG00000029446","4",63537742,63544262,6520
"20602","ENSMODG00000029447","3",484112650,484128111,15461
"20603","ENSMODG00000029448","1",89575274,89577008,1734
"20604","ENSMODG00000029449","8",225216820,225562390,345570
"20605","ENSMODG00000029450","6",282510797,282511920,1123
"20606","ENSMODG00000029451","7",234835420,234836606,1186
"20607","ENSMODG00000029452","7",204165444,204166903,1459
"20608","ENSMODG00000029453","3",501192760,501224624,31864
"20609","ENSMODG00000029454","4",21599435,21600787,1352
"20610","ENSMODG00000029456","5",139477518,139502107,24589
"20611","ENSMODG00000029457","Un",89552366,89558451,6085
"20612","ENSMODG00000029458","5",299220528,299249931,29403
"20613","ENSMODG00000029459","1",197132263,197133495,1232
"20614","ENSMODG00000029461","5",164678595,164679828,1233
"20615","ENSMODG00000029462","5",128261765,128804664,542899
"20616","ENSMODG00000029464","3",72141501,72142638,1137
"20617","ENSMODG00000029466","Un",42252808,42271263,18455
"20618","ENSMODG00000029467","7",100255093,100272566,17473
"20619","ENSMODG00000029468","6",148026051,148032127,6076
"20620","ENSMODG00000029469","6",125831041,125832243,1202
"20621","ENSMODG00000029470","3",487524189,487530196,6007
"20622","ENSMODG00000029471","2",283177106,283228602,51496
"20623","ENSMODG00000029472","5",268900945,268926641,25696
"20624","ENSMODG00000029473","2",218636300,218792190,155890
"20625","ENSMODG00000029474","6",188552014,188553658,1644
"20626","ENSMODG00000029475","6",197718596,197742237,23641
"20627","ENSMODG00000029476","3",279081199,279083183,1984
"20628","ENSMODG00000029477","2",324556464,324569751,13287
"20629","ENSMODG00000029478","2",536614273,536615404,1131
"20630","ENSMODG00000029479","4",405068601,405075880,7279
"20631","ENSMODG00000029480","2",306608146,306609193,1047
"20632","ENSMODG00000029481","6",41911773,41913585,1812
"20633","ENSMODG00000029482","3",500189042,500207573,18531
"20634","ENSMODG00000029483","2",451296602,451403208,106606
"20635","ENSMODG00000029484","3",185181593,185341170,159577
"20636","ENSMODG00000029485","3",265382866,265384710,1844
"20637","ENSMODG00000029486","1",59696955,59698335,1380
"20638","ENSMODG00000029488","3",439278754,439303946,25192
"20639","ENSMODG00000029489","Un",30527687,30529784,2097
"20640","ENSMODG00000029490","5",11925529,11926842,1313
"20641","ENSMODG00000029491","1",171229230,171229894,664
"20642","ENSMODG00000029492","4",422172736,422174001,1265
"20643","ENSMODG00000029493","Un",20187604,20249194,61590
"20644","ENSMODG00000029494","6",105018660,105036280,17620
"20645","ENSMODG00000029495","6",22236432,22237918,1486
"20646","ENSMODG00000029496","Un",87369822,87377168,7346
"20647","ENSMODG00000029497","7",129363297,129555777,192480
"20648","ENSMODG00000029498","2",533095001,533194349,99348
"20649","ENSMODG00000029499","3",69056271,69057445,1174
"20650","ENSMODG00000029500","3",390204119,390382634,178515
"20651","ENSMODG00000029502","5",262245871,262276812,30941
"20652","ENSMODG00000029503","2",433669921,433671072,1151
"20653","ENSMODG00000029504","X",70106257,70167981,61724
"20654","ENSMODG00000029505","4",412467520,412476468,8948
"20655","ENSMODG00000029506","Un",65175696,65181761,6065
"20656","ENSMODG00000029507","2",114117474,114177140,59666
"20657","ENSMODG00000029508","1",426399152,426401878,2726
"20658","ENSMODG00000029509","2",201497598,201507000,9402
"20659","ENSMODG00000029511","1",16576653,16581161,4508
"20660","ENSMODG00000029512","7",109826676,109827747,1071
"20661","ENSMODG00000029513","3",476569616,476582970,13354
"20662","ENSMODG00000029514","3",467388059,467389258,1199
"20663","ENSMODG00000029515","3",462806262,462812234,5972
"20664","ENSMODG00000029516","1",36247725,36250118,2393
"20665","ENSMODG00000029517","Un",14342070,14343122,1052
"20666","ENSMODG00000029518","Un",67551539,67566901,15362
"20667","ENSMODG00000029519","4",107046237,107047419,1182
"20668","ENSMODG00000029520","3",89586182,89587644,1462
"20669","ENSMODG00000029521","Un",101961246,101962322,1076
"20670","ENSMODG00000029522","5",146449268,146450953,1685
"20671","ENSMODG00000029523","5",150029982,150031179,1197
"20672","ENSMODG00000029524","3",506916490,506943307,26817
"20673","ENSMODG00000029525","X",22388933,22390201,1268
"20674","ENSMODG00000029527","Un",62631563,62633299,1736
"20675","ENSMODG00000029528","3",481254564,481257193,2629
"20676","ENSMODG00000029529","8",188491416,188539409,47993
"20677","ENSMODG00000029530","5",236062721,236064362,1641
"20678","ENSMODG00000029531","6",190829521,190830647,1126
"20679","ENSMODG00000029532","Un",30295543,30302053,6510
"20680","ENSMODG00000029533","1",380434192,380435320,1128
"20681","ENSMODG00000029534","1",444221294,444222506,1212
"20682","ENSMODG00000029535","8",230742083,230743134,1051
"20683","ENSMODG00000029536","4",308114440,308115503,1063
"20684","ENSMODG00000029537","3",522951931,522973757,21826
"20685","ENSMODG00000029539","3",96935499,96936635,1136
"20686","ENSMODG00000029540","3",439413063,439423380,10317
"20687","ENSMODG00000029541","5",303038706,303039756,1050
"20688","ENSMODG00000029542","8",77483494,77491420,7926
"20689","ENSMODG00000029543","1",179389376,179390508,1132
"20690","ENSMODG00000029544","2",270426037,270430980,4943
"20691","ENSMODG00000029545","4",386325563,386329324,3761
"20692","ENSMODG00000029547","1",464816141,464817258,1117
"20693","ENSMODG00000029548","1",520076119,520077319,1200
"20694","ENSMODG00000029549","Un",67403583,67412926,9343
"20695","ENSMODG00000029550","4",146170717,146173317,2600
"20696","ENSMODG00000029551","1",6054015,6069964,15949
"20697","ENSMODG00000029552","3",427603448,427769018,165570
"20698","ENSMODG00000029553","4",405749994,405755601,5607
"20699","ENSMODG00000029554","7",16814966,16816649,1683
"20700","ENSMODG00000029555","X",11742800,11763945,21145
"20701","ENSMODG00000029556","5",26160585,26161720,1135
"20702","ENSMODG00000029557","8",52135518,52300222,164704
"20703","ENSMODG00000029558","2",213711831,213713774,1943
"20704","ENSMODG00000029559","2",270776741,270778690,1949
"20705","ENSMODG00000029560","1",369504740,369506091,1351
"20706","ENSMODG00000029561","3",379823625,379824866,1241
"20707","ENSMODG00000029562","1",181571927,181573372,1445
"20708","ENSMODG00000029563","4",190184301,190193087,8786
"20709","ENSMODG00000029564","4",288172291,288173448,1157
"20710","ENSMODG00000029565","4",111904008,112001092,97084
"20711","ENSMODG00000029567","Un",69099144,69100280,1136
"20712","ENSMODG00000029569","3",458939967,458950660,10693
"20713","ENSMODG00000029570","2",8700485,8703200,2715
"20714","ENSMODG00000029571","2",107145909,107153253,7344
"20715","ENSMODG00000029572","Un",96806196,96808091,1895
"20716","ENSMODG00000029573","Un",17534722,17536655,1933
"20717","ENSMODG00000029574","4",108010621,108015053,4432
"20718","ENSMODG00000029575","2",3727507,3771214,43707
"20719","ENSMODG00000029576","3",500131917,500204519,72602
"20720","ENSMODG00000029577","Un",65019234,65029411,10177
"20721","ENSMODG00000029578","1",171423783,171424393,610
"20722","ENSMODG00000029579","3",520747207,520748238,1031
"20723","ENSMODG00000029580","Un",18330270,18335382,5112
"20724","ENSMODG00000029581","Un",73078691,73090495,11804
"20725","ENSMODG00000029582","3",33591716,33592817,1101
"20726","ENSMODG00000029583","7",194440288,194446885,6597
"20727","ENSMODG00000029584","8",215819997,215825248,5251
"20728","ENSMODG00000029585","3",221767871,221768917,1046
"20729","ENSMODG00000029586","X",69831551,69846326,14775
"20730","ENSMODG00000029587","3",524199568,524377387,177819
"20731","ENSMODG00000029588","4",330898577,330900104,1527
"20732","ENSMODG00000029589","7",236494472,236495671,1199
"20733","ENSMODG00000029590","3",118556877,118559655,2778
"20734","ENSMODG00000029591","7",149147803,149149972,2169
"20735","ENSMODG00000029592","Un",60313114,60331255,18141
"20736","ENSMODG00000029593","2",529067288,529178583,111295
"20737","ENSMODG00000029594","3",432538411,432558493,20082
"20738","ENSMODG00000029595","4",401445449,401549253,103804
"20739","ENSMODG00000029596","2",168888520,168889645,1125
"20740","ENSMODG00000029597","Un",65020126,65023179,3053
"20741","ENSMODG00000029598","X",73247241,73249010,1769
"20742","ENSMODG00000029599","1",390684426,390802696,118270
"20743","ENSMODG00000029601","X",29132006,29203681,71675
"20744","ENSMODG00000029602","3",94390411,94391803,1392
"20745","ENSMODG00000029603","3",371735297,371736433,1136
"20746","ENSMODG00000029604","Un",48783798,48806478,22680
"20747","ENSMODG00000029605","5",55652040,55653162,1122
"20748","ENSMODG00000029606","2",108461505,108463125,1620
"20749","ENSMODG00000029607","2",461296126,461297377,1251
"20750","ENSMODG00000029608","2",3231964,3233594,1630
"20751","ENSMODG00000029609","4",82140340,82193397,53057
"20752","ENSMODG00000029610","2",81965251,81967003,1752
"20753","ENSMODG00000029611","7",252026759,252029628,2869
"20754","ENSMODG00000029612","3",451095826,451164815,68989
"20755","ENSMODG00000029614","6",265303992,265305837,1845
"20756","ENSMODG00000029615","3",144941664,144959856,18192
"20757","ENSMODG00000029616","1",535360290,535361382,1092
"20758","ENSMODG00000029617","6",222062244,222213575,151331
"20759","ENSMODG00000029619","Un",61178927,61180018,1091
"20760","ENSMODG00000029621","5",285015091,285022251,7160
"20761","ENSMODG00000029622","1",42456077,42487219,31142
"20762","ENSMODG00000029623","1",252454324,252455880,1556
"20763","ENSMODG00000029625","8",301130494,301182109,51615
"20764","ENSMODG00000029626","6",208265318,208267634,2316
"20765","ENSMODG00000029628","8",35591747,35593039,1292
"20766","ENSMODG00000029629","4",250266015,250294891,28876
"20767","ENSMODG00000029630","3",491340016,491390186,50170
"20768","ENSMODG00000029631","7",140068136,140070064,1928
"20769","ENSMODG00000029632","5",9949596,9951685,2089
"20770","ENSMODG00000029633","3",20463734,20465157,1423
"20771","ENSMODG00000029634","1",274048419,274049631,1212
"20772","ENSMODG00000029635","3",475067023,475068058,1035
"20773","ENSMODG00000029636","2",477393832,477439237,45405
"20774","ENSMODG00000029637","X",4080898,4157197,76299
"20775","ENSMODG00000029638","1",38980043,38981216,1173
"20776","ENSMODG00000029639","1",159579065,159927094,348029
"20777","ENSMODG00000029640","8",203407694,203539628,131934
"20778","ENSMODG00000029641","3",300194675,300195990,1315
"20779","ENSMODG00000029642","5",12669359,12671080,1721
"20780","ENSMODG00000029643","4",402918754,402933396,14642
"20781","ENSMODG00000029644","X",62739016,62740443,1427
"20782","ENSMODG00000029645","6",69576872,69577913,1041
"20783","ENSMODG00000029646","2",199765627,199839489,73862
"20784","ENSMODG00000029647","5",294299604,294301982,2378
"20785","ENSMODG00000029648","2",123870131,123871305,1174
"20786","ENSMODG00000029649","Un",43184329,43296913,112584
"20787","ENSMODG00000029650","1",379898292,379899311,1019
"20788","ENSMODG00000029651","1",415551341,415552372,1031
"20789","ENSMODG00000029652","4",402861359,402900781,39422
"20790","ENSMODG00000029653","Un",74014888,74016422,1534
"20791","ENSMODG00000029654","1",58609276,58757116,147840
"20792","ENSMODG00000029655","3",365945310,365953184,7874
"20793","ENSMODG00000029656","7",171568675,171621705,53030
"20794","ENSMODG00000029657","5",284145681,284146733,1052
"20795","ENSMODG00000029658","3",392090322,392098776,8454
"20796","ENSMODG00000029659","3",428856344,428863285,6941
"20797","ENSMODG00000029660","3",491070212,491202379,132167
"20798","ENSMODG00000029661","4",381934897,381972619,37722
"20799","ENSMODG00000029663","1",202575954,202589725,13771
"20800","ENSMODG00000029664","3",434066698,434086518,19820
"20801","ENSMODG00000029665","1",461717139,461814972,97833
"20802","ENSMODG00000029666","7",49807405,49828321,20916
"20803","ENSMODG00000029667","6",146919080,146920896,1816
"20804","ENSMODG00000029668","5",141738467,141740685,2218
"20805","ENSMODG00000029669","Un",63773651,63778534,4883
"20806","ENSMODG00000029670","2",33288452,33289643,1191
"20807","ENSMODG00000029671","7",42464794,42466005,1211
"20808","ENSMODG00000029672","4",389820670,389835181,14511
"20809","ENSMODG00000029673","4",14596771,14598540,1769
"20810","ENSMODG00000029674","8",17634783,17664092,29309
"20811","ENSMODG00000029675","X",47992866,47994101,1235
"20812","ENSMODG00000029676","5",299123528,299126886,3358
"20813","ENSMODG00000029677","X",27125754,27158312,32558
"20814","ENSMODG00000029678","8",243176825,243178287,1462
"20815","ENSMODG00000029679","1",224712002,224719873,7871
"20816","ENSMODG00000029680","2",443747723,443887424,139701
"20817","ENSMODG00000029681","3",460873265,460917682,44417
"20818","ENSMODG00000029682","4",20096013,20217764,121751
"20819","ENSMODG00000029683","1",467173615,467182895,9280
"20820","ENSMODG00000029684","8",232102410,232104242,1832
"20821","ENSMODG00000029685","1",467637417,467643817,6400
"20822","ENSMODG00000029686","2",17671156,17672315,1159
"20823","ENSMODG00000029689","7",228185766,228187264,1498
"20824","ENSMODG00000029691","8",274901562,274936311,34749
"20825","ENSMODG00000029692","X",30765516,30782582,17066
"20826","ENSMODG00000029693","1",114434375,114436103,1728
"20827","ENSMODG00000029694","4",180709503,180819167,109664
"20828","ENSMODG00000029695","7",13873245,13874819,1574
"20829","ENSMODG00000029696","6",68220754,68221821,1067
"20830","ENSMODG00000029697","3",437280404,437282678,2274
"20831","ENSMODG00000029698","5",87146109,87150820,4711
"20832","ENSMODG00000029699","1",274518244,274541606,23362
"20833","ENSMODG00000029700","3",509657005,509671328,14323
"20834","ENSMODG00000029701","2",314182574,314295966,113392
"20835","ENSMODG00000029702","3",427540815,427565515,24700
"20836","ENSMODG00000029703","4",374939435,374983968,44533
"20837","ENSMODG00000029704","Un",79533226,79541057,7831
"20838","ENSMODG00000029705","3",434180719,434190900,10181
"20839","ENSMODG00000029706","8",269869742,269879077,9335
"20840","ENSMODG00000029707","3",435903760,435907180,3420
"20841","ENSMODG00000029708","X",50830998,50835680,4682
"20842","ENSMODG00000029709","6",163409494,163410643,1149
"20843","ENSMODG00000029710","4",399801796,399820115,18319
"20844","ENSMODG00000029711","1",385552242,385561772,9530
"20845","ENSMODG00000029712","6",31483788,31498885,15097
"20846","ENSMODG00000029713","1",530992222,530993229,1007
"20847","ENSMODG00000029714","5",47324778,47325896,1118
"20848","ENSMODG00000029715","Un",81975798,82002724,26926
"20849","ENSMODG00000029716","3",7335313,7336334,1021
"20850","ENSMODG00000029717","1",468095276,468103261,7985
"20851","ENSMODG00000029718","3",201235738,201237509,1771
"20852","ENSMODG00000029719","3",213423701,213425948,2247
"20853","ENSMODG00000029720","3",410399689,410436237,36548
"20854","ENSMODG00000029721","2",419727893,419729280,1387
"20855","ENSMODG00000029722","2",317266820,317270719,3899
"20856","ENSMODG00000029723","3",126278551,126279697,1146
"20857","ENSMODG00000029724","5",154503418,154505661,2243
"20858","ENSMODG00000029725","1",306615747,306643563,27816
"20859","ENSMODG00000029726","4",423564564,423565718,1154
"20860","ENSMODG00000029727","7",175507644,175508852,1208
"20861","ENSMODG00000029728","8",109620004,109753495,133491
"20862","ENSMODG00000029729","8",50753283,50754534,1251
"20863","ENSMODG00000029730","2",380629636,380764459,134823
"20864","ENSMODG00000029732","Un",39788035,39789117,1082
"20865","ENSMODG00000029733","1",499870035,499871112,1077
"20866","ENSMODG00000029734","3",438727180,438793712,66532
"20867","ENSMODG00000029735","Un",56033479,56035518,2039
"20868","ENSMODG00000029736","4",354785332,354804722,19390
"20869","ENSMODG00000029737","3",521909915,521923527,13612
"20870","ENSMODG00000029739","2",58185736,58192093,6357
"20871","ENSMODG00000029740","2",144867028,144871169,4141
"20872","ENSMODG00000029741","2",224456724,224482596,25872
"20873","ENSMODG00000029742","Un",27408531,27409797,1266
"20874","ENSMODG00000029743","2",494994446,495000068,5622
"20875","ENSMODG00000029744","7",250732073,250733203,1130
"20876","ENSMODG00000029746","8",308164429,308206347,41918
"20877","ENSMODG00000029747","5",143606006,143607294,1288
"20878","ENSMODG00000029748","Un",89115098,89118562,3464
"20879","ENSMODG00000029749","1",309475307,309496581,21274
"20880","ENSMODG00000029751","1",150940623,150970518,29895
"20881","ENSMODG00000029752","6",182556748,182557803,1055
"20882","ENSMODG00000029754","4",406521968,406527964,5996
"20883","ENSMODG00000029755","4",127793393,127794974,1581
"20884","ENSMODG00000029756","6",14543505,14549493,5988
"20885","ENSMODG00000029757","Un",71317621,71326749,9128
"20886","ENSMODG00000029758","8",205181639,205182197,558
"20887","ENSMODG00000029760","3",318228706,318253072,24366
"20888","ENSMODG00000029761","2",9445647,9455863,10216
"20889","ENSMODG00000029762","3",91336068,91337149,1081
"20890","ENSMODG00000029763","Un",45790942,45842187,51245
"20891","ENSMODG00000029764","4",179066106,179075301,9195
"20892","ENSMODG00000029765","8",12945528,12946949,1421
"20893","ENSMODG00000029766","6",163410673,163411992,1319
"20894","ENSMODG00000029767","3",51756673,51872749,116076
"20895","ENSMODG00000029768","3",245350880,245352045,1165
"20896","ENSMODG00000029769","2",471582755,471585685,2930
"20897","ENSMODG00000029770","3",5718198,5720024,1826
"20898","ENSMODG00000029771","1",171001659,171003617,1958
"20899","ENSMODG00000029772","2",262352633,262354630,1997
"20900","ENSMODG00000029773","2",430381970,430385566,3596
"20901","ENSMODG00000029774","2",283597896,283613672,15776
"20902","ENSMODG00000029775","2",337871068,337872992,1924
"20903","ENSMODG00000029776","2",208375199,208472035,96836
"20904","ENSMODG00000029777","X",25259452,25376289,116837
"20905","ENSMODG00000029778","Un",60003910,60005793,1883
"20906","ENSMODG00000029779","7",60089894,60091099,1205
"20907","ENSMODG00000029780","8",26380975,26382291,1316
"20908","ENSMODG00000029781","5",266051306,266095334,44028
"20909","ENSMODG00000029782","4",54543915,54545038,1123
"20910","ENSMODG00000029783","7",189592642,189593710,1068
"20911","ENSMODG00000029784","Un",50779840,50781150,1310
"20912","ENSMODG00000029785","4",340604229,340605287,1058
"20913","ENSMODG00000029787","3",85723869,86269350,545481
"20914","ENSMODG00000029788","4",377289361,377299746,10385
"20915","ENSMODG00000029789","3",526113232,526295317,182085
"20916","ENSMODG00000029790","Un",13986639,13989620,2981
"20917","ENSMODG00000029791","1",85298324,85304287,5963
"20918","ENSMODG00000029792","5",2124540,2141257,16717
"20919","ENSMODG00000029793","5",222927457,223097417,169960
"20920","ENSMODG00000029794","5",206953955,206954992,1037
"20921","ENSMODG00000029795","2",140798425,140807869,9444
"20922","ENSMODG00000029796","2",312616933,312846275,229342
"20923","ENSMODG00000029797","1",468855584,468857971,2387
"20924","ENSMODG00000029798","2",175063672,175066888,3216
"20925","ENSMODG00000029800","1",517945189,517947683,2494
"20926","ENSMODG00000029801","3",507966218,508176738,210520
"20927","ENSMODG00000029802","Un",89831561,89838051,6490
"20928","ENSMODG00000029803","3",205775438,205794198,18760
"20929","ENSMODG00000029804","1",344122711,344125471,2760
"20930","ENSMODG00000029805","8",188751828,188769397,17569
"20931","ENSMODG00000029806","7",149143148,149146196,3048
"20932","ENSMODG00000029807","3",194887416,194914354,26938
"20933","ENSMODG00000029808","5",81318239,81395395,77156
"20934","ENSMODG00000029809","5",74415406,74480711,65305
"20935","ENSMODG00000029810","8",103692175,103706772,14597
"20936","ENSMODG00000029811","8",260659143,260690054,30911
"20937","ENSMODG00000029812","6",68661301,68669636,8335
"20938","ENSMODG00000029813","1",533368611,533445259,76648
"20939","ENSMODG00000029814","8",43290964,43361891,70927
"20940","ENSMODG00000029815","8",68877654,68880739,3085
"20941","ENSMODG00000029816","1",177937700,177941579,3879
"20942","ENSMODG00000029817","8",72574079,72587680,13601
"20943","ENSMODG00000029819","2",107820515,107825516,5001
"20944","ENSMODG00000029820","4",65385075,65417856,32781
"20945","ENSMODG00000029821","3",70678614,70680496,1882
"20946","ENSMODG00000029822","Un",36438351,36525144,86793
"20947","ENSMODG00000029823","3",231564392,231569788,5396
"20948","ENSMODG00000029824","4",226848534,226890496,41962
"20949","ENSMODG00000029825","2",182052606,182054396,1790
"20950","ENSMODG00000029826","2",258262662,258265865,3203
"20951","ENSMODG00000029827","6",188873605,188879729,6124
"20952","ENSMODG00000029828","1",217746295,217766953,20658
"20953","ENSMODG00000029830","4",242142073,242152447,10374
"20954","ENSMODG00000029831","1",300096720,300109626,12906
"20955","ENSMODG00000029833","3",445852957,445856596,3639
"20956","ENSMODG00000029834","1",451246754,451248195,1441
"20957","ENSMODG00000029835","Un",19972285,19980133,7848
"20958","ENSMODG00000029836","6",129670890,129680516,9626
"20959","ENSMODG00000029841","2",200068437,200072270,3833
"20960","ENSMODG00000029842","3",417188734,417192362,3628
"20961","ENSMODG00000029846","4",323024106,323026008,1902
"20962","ENSMODG00000029847","1",472295336,472314444,19108
"20963","ENSMODG00000029848","3",337750260,337763836,13576
"20964","ENSMODG00000029849","X",4708518,4717987,9469
"20965","ENSMODG00000029850","3",88482528,88502279,19751
"20966","ENSMODG00000029851","3",276599033,276634821,35788
"20967","ENSMODG00000029852","8",13594688,13601694,7006
"20968","ENSMODG00000029853","Un",31293276,31382825,89549
"20969","ENSMODG00000029854","6",38515665,38518625,2960
"20970","ENSMODG00000029855","3",99545244,99565253,20009
"20971","ENSMODG00000029857","X",26543144,26546094,2950
"20972","ENSMODG00000029858","8",8225099,8228355,3256
"20973","ENSMODG00000029859","8",66925021,66926134,1113
"20974","ENSMODG00000029862","4",350140779,350190050,49271
"20975","ENSMODG00000029863","2",391636867,391660372,23505
"20976","ENSMODG00000029864","1",113489288,113502723,13435
"20977","ENSMODG00000029865","8",292504061,292515392,11331
"20978","ENSMODG00000029867","8",51343515,51385558,42043
"20979","ENSMODG00000029868","4",275699082,275726751,27669
"20980","ENSMODG00000029869","3",347961747,348070995,109248
"20981","ENSMODG00000029870","3",389546646,389549083,2437
"20982","ENSMODG00000029871","4",34579566,34625194,45628
"20983","ENSMODG00000029872","3",110462188,110464069,1881
"20984","ENSMODG00000029873","2",494601234,494603817,2583
"20985","ENSMODG00000029875","3",408027120,408127258,100138
"20986","ENSMODG00000029877","3",377605123,377611904,6781
"20987","ENSMODG00000029880","6",146685544,146718182,32638
"20988","ENSMODG00000029881","3",472925513,472934051,8538
"20989","ENSMODG00000029882","3",318172555,318181349,8794
"20990","ENSMODG00000029885","3",136067100,136139510,72410
"20991","ENSMODG00000029886","3",139448292,139485828,37536
"20992","ENSMODG00000029888","2",532726355,532733967,7612
"20993","ENSMODG00000029889","6",130809869,130826536,16667
"20994","ENSMODG00000029890","4",325241112,325267152,26040
"20995","ENSMODG00000029891","6",138971357,138973626,2269
"20996","ENSMODG00000029893","5",117347143,117352166,5023
"20997","ENSMODG00000029894","4",359098357,359100110,1753
"20998","ENSMODG00000029896","7",9154627,9187328,32701
"20999","ENSMODG00000029899","6",106019067,106022788,3721
"21000","ENSMODG00000029900","3",369425651,369428646,2995
"21001","ENSMODG00000029901","8",44395662,44397343,1681
"21002","ENSMODG00000029902","3",215193368,215202773,9405
"21003","ENSMODG00000029903","8",9073164,9075042,1878
"21004","ENSMODG00000029904","5",224173210,224227019,53809
"21005","ENSMODG00000029905","8",236853097,236887656,34559
"21006","ENSMODG00000029906","5",9818306,9819986,1680
"21007","ENSMODG00000029907","3",487385318,487391654,6336
"21008","ENSMODG00000029908","3",334632822,334707424,74602
"21009","ENSMODG00000029909","8",148326558,148328553,1995
"21010","ENSMODG00000029910","3",456658910,456661405,2495
"21011","ENSMODG00000029911","2",200498621,200505887,7266
"21012","ENSMODG00000029916","2",440222219,440229276,7057
"21013","ENSMODG00000029917","2",250180165,250212343,32178
"21014","ENSMODG00000029918","5",270465101,270467795,2694
"21015","ENSMODG00000029919","1",492626236,492638954,12718
"21016","ENSMODG00000029920","7",155230202,155348599,118397
"21017","ENSMODG00000029921","7",239722105,239788549,66444
"21018","ENSMODG00000029922","3",151137925,151140095,2170
"21019","ENSMODG00000029925","1",476771226,476774299,3073
"21020","ENSMODG00000029928","2",198617789,198621148,3359
"21021","ENSMODG00000029929","3",491977983,491986162,8179
"21022","ENSMODG00000029930","2",487305612,487345872,40260
"21023","ENSMODG00000029931","2",103158055,103160740,2685
"21024","ENSMODG00000029932","2",458544692,458554528,9836
"21025","ENSMODG00000029934","8",162846607,162847624,1017
"21026","ENSMODG00000029936","3",141001376,141008287,6911
"21027","ENSMODG00000029937","4",240970674,240973747,3073
"21028","ENSMODG00000029938","5",103955144,103970153,15009
"21029","ENSMODG00000029939","4",43254771,43268203,13432
"21030","ENSMODG00000029941","5",229452897,229458027,5130
"21031","ENSMODG00000029942","Un",23253081,23270986,17905
"21032","ENSMODG00000029943","5",238103805,238105281,1476
"21033","ENSMODG00000029944","4",279687891,279688773,882
"21034","ENSMODG00000029946","2",206131929,206135263,3334
"21035","ENSMODG00000029947","2",527575431,527577503,2072
"21036","ENSMODG00000029948","6",243177438,243304851,127413
"21037","ENSMODG00000029949","5",254434559,254450676,16117
"21038","ENSMODG00000029950","2",229706609,229707789,1180
"21039","ENSMODG00000029951","2",25526058,25530376,4318
"21040","ENSMODG00000029952","6",235465656,235466945,1289
"21041","ENSMODG00000029953","7",223158752,223234304,75552
"21042","ENSMODG00000029956","2",101535697,101558961,23264
"21043","ENSMODG00000029957","6",68858873,68862325,3452
"21044","ENSMODG00000029958","3",227678677,227680624,1947
"21045","ENSMODG00000029959","4",279343471,279349133,5662
"21046","ENSMODG00000029961","3",116757972,116768074,10102
"21047","ENSMODG00000029962","6",155315579,155330024,14445
"21048","ENSMODG00000029963","3",255347836,255352067,4231
"21049","ENSMODG00000029964","1",72642503,72645066,2563
"21050","ENSMODG00000029966","5",111952255,111953572,1317
"21051","ENSMODG00000029967","1",372104370,372105545,1175
"21052","ENSMODG00000029969","8",221374684,221375919,1235
"21053","ENSMODG00000029970","2",43254223,43258198,3975
"21054","ENSMODG00000029971","1",442909199,442986141,76942
"21055","ENSMODG00000029973","Un",23938518,23940069,1551
"21056","ENSMODG00000029974","2",525451667,525464557,12890
"21057","ENSMODG00000029975","2",328774104,328873026,98922
"21058","ENSMODG00000029976","1",148851351,148902675,51324
"21059","ENSMODG00000029977","3",269055286,269057449,2163
"21060","ENSMODG00000029979","2",83444065,83456293,12228
"21061","ENSMODG00000029980","3",352883328,352894139,10811
"21062","ENSMODG00000029981","6",275233005,275279495,46490
"21063","ENSMODG00000029982","Un",12387452,12391075,3623
"21064","ENSMODG00000029983","3",25863230,25867481,4251
"21065","ENSMODG00000029986","Un",51750748,51779823,29075
"21066","ENSMODG00000029987","5",22362125,22379380,17255
"21067","ENSMODG00000029988","3",424847586,424945269,97683
"21068","ENSMODG00000029989","8",242893162,242897550,4388
"21069","ENSMODG00000029990","3",320113810,320116448,2638
"21070","ENSMODG00000029991","1",133589133,133593641,4508
"21071","ENSMODG00000029992","6",166774579,166778138,3559
"21072","ENSMODG00000029993","6",69920752,69958060,37308
"21073","ENSMODG00000029994","1",62998181,62999908,1727
"21074","ENSMODG00000029996","1",526451362,526520455,69093
"21075","ENSMODG00000029997","7",108358282,108359612,1330
"21076","ENSMODG00000030000","3",481404702,481436269,31567
"21077","ENSMODG00000030002","8",179315458,179321281,5823
"21078","ENSMODG00000030003","4",22115024,22166677,51653
"21079","ENSMODG00000030004","2",225631713,225633691,1978
"21080","ENSMODG00000030005","3",285945402,285949242,3840
"21081","ENSMODG00000030006","6",108430471,108433132,2661
"21082","ENSMODG00000030007","4",188514065,188515930,1865
"21083","ENSMODG00000030008","6",138946755,138963139,16384
"21084","ENSMODG00000030009","8",219048127,219093613,45486
"21085","ENSMODG00000030010","4",403569463,403570533,1070
"21086","ENSMODG00000030011","6",162694876,162698066,3190
"21087","ENSMODG00000030015","5",285349677,285355544,5867
"21088","ENSMODG00000030016","4",285275484,285336705,61221
"21089","ENSMODG00000030017","3",215707334,215848532,141198
"21090","ENSMODG00000030018","2",76386328,76389878,3550
"21091","ENSMODG00000030019","7",11761421,11768726,7305
"21092","ENSMODG00000030021","7",46538688,46554016,15328
"21093","ENSMODG00000030022","1",95485244,95488600,3356
"21094","ENSMODG00000030023","7",10169186,10171263,2077
"21095","ENSMODG00000030024","4",235503229,235505965,2736
"21096","ENSMODG00000030025","4",192225411,192226059,648
"21097","ENSMODG00000030026","1",153308153,153313452,5299
"21098","ENSMODG00000030028","6",137266599,137287514,20915
"21099","ENSMODG00000030029","3",188364863,188366144,1281
"21100","ENSMODG00000030030","7",237615951,237669729,53778
"21101","ENSMODG00000030031","5",199068547,199069445,898
"21102","ENSMODG00000030032","3",402339507,402416220,76713
"21103","ENSMODG00000030033","8",196954068,197138507,184439
"21104","ENSMODG00000030034","6",60925929,60931333,5404
"21105","ENSMODG00000030035","5",214426141,214460556,34415
"21106","ENSMODG00000030036","1",486328277,486376461,48184
"21107","ENSMODG00000030038","6",223792731,223795468,2737
"21108","ENSMODG00000030039","2",426220689,426443925,223236
"21109","ENSMODG00000030040","7",257901152,257953617,52465
"21110","ENSMODG00000030042","3",301152584,301161700,9116
"21111","ENSMODG00000030043","8",36775371,36842630,67259
"21112","ENSMODG00000030044","8",217764188,217764771,583
"21113","ENSMODG00000030045","Un",23829891,23830445,554
"21114","ENSMODG00000030046","3",347166118,347170465,4347
"21115","ENSMODG00000030047","7",235957286,235958278,992
"21116","ENSMODG00000030048","2",35889126,35893773,4647
"21117","ENSMODG00000030049","4",314412718,314444909,32191
"21118","ENSMODG00000030051","3",112499879,112502351,2472
"21119","ENSMODG00000030052","Un",65786979,65789436,2457
"21120","ENSMODG00000030053","4",278574699,278581313,6614
"21121","ENSMODG00000030054","6",291273688,291275703,2015
"21122","ENSMODG00000030055","7",164218064,164235233,17169
"21123","ENSMODG00000030056","6",71161778,71174357,12579
"21124","ENSMODG00000030057","3",306775903,306917046,141143
"21125","ENSMODG00000030058","2",388403022,388410065,7043
"21126","ENSMODG00000030059","3",480615414,480619609,4195
"21127","ENSMODG00000030060","3",103486570,103490041,3471
"21128","ENSMODG00000030061","7",139867473,139891521,24048
"21129","ENSMODG00000030062","3",422031029,422039255,8226
"21130","ENSMODG00000030063","5",80116550,80123725,7175
"21131","ENSMODG00000030064","4",299533438,299534797,1359
"21132","ENSMODG00000030065","6",149897468,149933030,35562
"21133","ENSMODG00000030066","2",16486913,16492809,5896
"21134","ENSMODG00000030068","6",117800041,117829953,29912
"21135","ENSMODG00000030069","3",412318223,412327703,9480
"21136","ENSMODG00000030071","2",404455350,404475564,20214
"21137","ENSMODG00000030072","5",63081041,63134386,53345
"21138","ENSMODG00000030073","8",264274989,264328648,53659
"21139","ENSMODG00000030074","3",323578376,323763396,185020
"21140","ENSMODG00000030075","6",243185035,243217414,32379
"21141","ENSMODG00000030080","1",507205246,507211171,5925
"21142","ENSMODG00000030081","1",142694651,142695295,644
"21143","ENSMODG00000030082","4",193792614,193992729,200115
"21144","ENSMODG00000030083","8",70594331,70595129,798
"21145","ENSMODG00000030084","2",198266994,198288470,21476
"21146","ENSMODG00000030085","8",286557117,286572622,15505
"21147","ENSMODG00000030086","3",366559558,366571169,11611
"21148","ENSMODG00000030087","4",137126559,137130394,3835
"21149","ENSMODG00000030088","3",49486910,49502755,15845
"21150","ENSMODG00000030089","1",307360835,307462583,101748
"21151","ENSMODG00000030091","7",40087886,40264873,176987
"21152","ENSMODG00000030093","2",525312161,525316543,4382
"21153","ENSMODG00000030094","1",88675777,88791439,115662
"21154","ENSMODG00000030097","8",228114608,228124999,10391
"21155","ENSMODG00000030098","1",524033943,524075897,41954
"21156","ENSMODG00000030099","1",373087987,373095336,7349
"21157","ENSMODG00000030100","4",230369201,230370953,1752
"21158","ENSMODG00000030101","8",277572746,277591574,18828
"21159","ENSMODG00000030102","2",496773412,496779448,6036
"21160","ENSMODG00000030103","2",243629972,243630874,902
"21161","ENSMODG00000030104","2",216344000,216358582,14582
"21162","ENSMODG00000030106","4",286048678,286056923,8245
"21163","ENSMODG00000030108","3",442841016,442857306,16290
"21164","ENSMODG00000030109","1",176406511,176407320,809
"21165","ENSMODG00000030111","3",311871751,311879626,7875
"21166","ENSMODG00000030112","5",278733530,278734658,1128
"21167","ENSMODG00000030113","7",260374189,260386153,11964
"21168","ENSMODG00000030114","6",34252381,34257368,4987
"21169","ENSMODG00000030115","7",2395833,2398079,2246
"21170","ENSMODG00000030116","1",329503040,329503539,499
"21171","ENSMODG00000030117","7",84095963,84097240,1277
"21172","ENSMODG00000030119","4",235980874,235990997,10123
"21173","ENSMODG00000030120","2",120625766,120641189,15423
"21174","ENSMODG00000030121","5",114486863,114545754,58891
"21175","ENSMODG00000030122","1",49104553,49112291,7738
"21176","ENSMODG00000030124","5",210739494,210840735,101241
"21177","ENSMODG00000030125","5",63821512,64126799,305287
"21178","ENSMODG00000030126","3",439617491,439657053,39562
"21179","ENSMODG00000030129","5",172222584,172228415,5831
"21180","ENSMODG00000030130","1",486397503,486414636,17133
"21181","ENSMODG00000030132","4",71289322,71294025,4703
"21182","ENSMODG00000030136","X",52209115,52211252,2137
"21183","ENSMODG00000030137","6",209629433,209634839,5406
"21184","ENSMODG00000030139","4",351284777,351286230,1453
"21185","ENSMODG00000030140","1",27780656,27814332,33676
"21186","ENSMODG00000030141","1",326084609,326088646,4037
"21187","ENSMODG00000030142","4",308539314,308542877,3563
"21188","ENSMODG00000030144","1",334436606,334438354,1748
"21189","ENSMODG00000030145","7",224950287,224964790,14503
"21190","ENSMODG00000030146","7",129033898,129041062,7164
"21191","ENSMODG00000030148","6",62969754,62980845,11091
"21192","ENSMODG00000030149","6",81151429,81162740,11311
"21193","ENSMODG00000030150","1",453901936,453904212,2276
"21194","ENSMODG00000030151","2",172686317,172695937,9620
"21195","ENSMODG00000030152","7",19410064,19506786,96722
"21196","ENSMODG00000030153","7",185428186,185476020,47834
"21197","ENSMODG00000030154","7",71700550,71708461,7911
"21198","ENSMODG00000030155","5",138144023,138146523,2500
"21199","ENSMODG00000030156","2",470029926,470035384,5458
"21200","ENSMODG00000030157","4",123665651,123719305,53654
"21201","ENSMODG00000030159","4",337484450,337486934,2484
"21202","ENSMODG00000030160","2",428042270,428048733,6463
"21203","ENSMODG00000030161","3",489004435,489066116,61681
"21204","ENSMODG00000030162","6",183051641,183147519,95878
"21205","ENSMODG00000030163","4",138842313,138862823,20510
"21206","ENSMODG00000030164","1",474842698,474993702,151004
"21207","ENSMODG00000030166","3",363814750,363817857,3107
"21208","ENSMODG00000030167","1",445713767,445728662,14895
"21209","ENSMODG00000030168","2",211999240,212010670,11430
"21210","ENSMODG00000030169","1",329512691,329514732,2041
"21211","ENSMODG00000030170","1",411035995,411039359,3364
"21212","ENSMODG00000030171","4",284818121,284908342,90221
"21213","ENSMODG00000030173","3",367689801,367861591,171790
"21214","ENSMODG00000030174","3",281158087,281163406,5319
"21215","ENSMODG00000030175","4",332609908,332610594,686
"21216","ENSMODG00000030176","3",301863374,301945424,82050
"21217","ENSMODG00000030177","1",19048423,19257012,208589
"21218","ENSMODG00000030180","3",451448251,451459669,11418
"21219","ENSMODG00000030181","2",116950589,116964032,13443
"21220","ENSMODG00000030182","5",300057770,300059534,1764
"21221","ENSMODG00000030183","3",250333420,250351441,18021
"21222","ENSMODG00000030184","2",202982442,202998105,15663
"21223","ENSMODG00000030185","2",106120208,106121788,1580
"21224","ENSMODG00000030186","3",482174944,482199440,24496
"21225","ENSMODG00000030189","8",34752100,34793125,41025
"21226","ENSMODG00000030190","2",215174547,215247706,73159
"21227","ENSMODG00000030191","2",446946780,446967941,21161
"21228","ENSMODG00000030192","4",133473857,133493595,19738
"21229","ENSMODG00000030193","4",316482681,316484791,2110
"21230","ENSMODG00000030194","2",114293769,114298771,5002
"21231","ENSMODG00000030195","1",145423260,145502039,78779
"21232","ENSMODG00000030196","4",233990275,233996168,5893
"21233","ENSMODG00000030198","1",410881045,410883170,2125
"21234","ENSMODG00000030199","2",22306918,22311697,4779
"21235","ENSMODG00000030200","1",455142352,455143114,762
"21236","ENSMODG00000030202","Un",11687369,11688409,1040
"21237","ENSMODG00000030203","1",427027098,427029970,2872
"21238","ENSMODG00000030205","6",101044653,101070008,25355
"21239","ENSMODG00000030206","3",514523428,514525263,1835
"21240","ENSMODG00000030207","8",262335417,262356898,21481
"21241","ENSMODG00000030209","1",25671607,25672420,813
"21242","ENSMODG00000030210","1",430932294,430956840,24546
"21243","ENSMODG00000030211","7",213233463,213318600,85137
"21244","ENSMODG00000030212","8",64617934,64626658,8724
"21245","ENSMODG00000030213","7",93886420,93896997,10577
"21246","ENSMODG00000030214","5",269638504,269809446,170942
"21247","ENSMODG00000030216","7",133442719,133447023,4304
"21248","ENSMODG00000030217","7",229131978,229133926,1948
"21249","ENSMODG00000030218","3",17113784,17124045,10261
"21250","ENSMODG00000030220","Un",38110672,38122034,11362
"21251","ENSMODG00000030221","3",323060598,323062071,1473
"21252","ENSMODG00000030224","4",111734111,111833776,99665
"21253","ENSMODG00000030225","3",330423548,330424568,1020
"21254","ENSMODG00000030226","6",186394082,186417158,23076
"21255","ENSMODG00000030227","8",249105705,249110029,4324
"21256","ENSMODG00000030228","3",152519230,152522803,3573
"21257","ENSMODG00000030229","4",95637440,95695474,58034
"21258","ENSMODG00000030230","1",59492326,59546294,53968
"21259","ENSMODG00000030231","7",141660592,141661712,1120
"21260","ENSMODG00000030232","1",169208429,169241579,33150
"21261","ENSMODG00000030233","8",215405697,215438237,32540
"21262","ENSMODG00000030234","5",242866501,242868706,2205
"21263","ENSMODG00000030235","4",323002039,323006637,4598
"21264","ENSMODG00000030236","5",248109111,248115659,6548
"21265","ENSMODG00000030238","6",281377797,281379132,1335
"21266","ENSMODG00000030239","3",305719517,305755450,35933
"21267","ENSMODG00000030240","6",130140030,130150576,10546
"21268","ENSMODG00000030241","2",305460909,305464162,3253
"21269","ENSMODG00000030243","1",464474507,464475898,1391
"21270","ENSMODG00000030244","6",169314370,169382318,67948
"21271","ENSMODG00000030245","X",73777564,73778579,1015
"21272","ENSMODG00000030246","5",223373722,223380299,6577
"21273","ENSMODG00000030247","4",198929422,199114347,184925
"21274","ENSMODG00000030251","4",319958424,319975400,16976
"21275","ENSMODG00000030252","4",390033727,390038863,5136
"21276","ENSMODG00000030253","2",51269255,51324166,54911
"21277","ENSMODG00000030255","3",151197951,151288383,90432
"21278","ENSMODG00000030256","5",9709962,9908162,198200
"21279","ENSMODG00000030257","8",252107552,252136402,28850
"21280","ENSMODG00000030258","2",127963604,128019006,55402
"21281","ENSMODG00000030259","4",148995289,149019658,24369
"21282","ENSMODG00000030260","6",256218831,256219940,1109
"21283","ENSMODG00000030261","5",225557710,225716621,158911
"21284","ENSMODG00000030263","8",37133869,37148578,14709
"21285","ENSMODG00000030264","3",317801761,317805300,3539
"21286","ENSMODG00000030266","Un",1540103,1614640,74537
"21287","ENSMODG00000030267","3",363042215,363095414,53199
"21288","ENSMODG00000030268","3",83478553,83528998,50445
"21289","ENSMODG00000030269","4",123419584,123424120,4536
"21290","ENSMODG00000030270","1",54830566,54838169,7603
"21291","ENSMODG00000030271","7",173105386,173111011,5625
"21292","ENSMODG00000030272","6",225981532,225984475,2943
"21293","ENSMODG00000030273","2",155032106,155141550,109444
"21294","ENSMODG00000030274","6",61962954,61970465,7511
"21295","ENSMODG00000030275","1",236639051,236746205,107154
"21296","ENSMODG00000030276","3",164827099,164830975,3876
"21297","ENSMODG00000030277","3",446075974,446080126,4152
"21298","ENSMODG00000030278","3",70332859,70349309,16450
"21299","ENSMODG00000030279","Un",96496124,96509121,12997
"21300","ENSMODG00000030280","4",297064651,297068536,3885
"21301","ENSMODG00000030281","3",195994717,196051899,57182
"21302","ENSMODG00000030282","2",28010775,28011842,1067
"21303","ENSMODG00000030283","6",195044430,195046170,1740
"21304","ENSMODG00000030284","7",203280127,203333877,53750
"21305","ENSMODG00000030286","7",255999009,256195338,196329
"21306","ENSMODG00000030287","8",188785209,188786686,1477
"21307","ENSMODG00000030289","8",74172216,74181234,9018
"21308","ENSMODG00000030290","2",46104593,46105777,1184
"21309","ENSMODG00000030291","4",342802281,342803345,1064
"21310","ENSMODG00000030292","3",503178362,503180271,1909
"21311","ENSMODG00000030293","1",191434026,191502417,68391
"21312","ENSMODG00000030296","1",502759807,502764547,4740
"21313","ENSMODG00000030297","4",190424123,190425303,1180
"21314","ENSMODG00000030299","6",203932461,203939140,6679
"21315","ENSMODG00000030300","5",299911398,299913713,2315
"21316","ENSMODG00000030301","7",101970431,101972476,2045
"21317","ENSMODG00000030302","7",232661567,232689166,27599
"21318","ENSMODG00000030303","2",496760792,496786875,26083
"21319","ENSMODG00000030304","3",431936806,431938009,1203
"21320","ENSMODG00000030305","6",167278641,167297174,18533
"21321","ENSMODG00000030308","4",372060249,372060994,745
"21322","ENSMODG00000030309","1",534421654,534427061,5407
"21323","ENSMODG00000030311","4",62877900,62941097,63197
"21324","ENSMODG00000030312","2",161212176,161266676,54500
"21325","ENSMODG00000030313","5",64968031,64973782,5751
"21326","ENSMODG00000030315","8",308469490,308499216,29726
"21327","ENSMODG00000030316","6",134872390,134874012,1622
"21328","ENSMODG00000030317","1",146057858,146075262,17404
"21329","ENSMODG00000030319","4",334996728,334998711,1983
"21330","ENSMODG00000030320","6",177978117,177990466,12349
"21331","ENSMODG00000030321","1",294435958,294489514,53556
"21332","ENSMODG00000030322","2",39513613,39515752,2139
"21333","ENSMODG00000030323","3",216398137,216499267,101130
"21334","ENSMODG00000030324","2",191439462,191452446,12984
"21335","ENSMODG00000030325","2",452499,466586,14087
"21336","ENSMODG00000030326","3",376788403,376804908,16505
"21337","ENSMODG00000030327","4",384424090,384432072,7982
"21338","ENSMODG00000030328","3",164320594,164323110,2516
"21339","ENSMODG00000030329","5",78928518,78965613,37095
"21340","ENSMODG00000030330","3",400650965,400702528,51563
"21341","ENSMODG00000030332","5",273380406,273429368,48962
"21342","ENSMODG00000030334","Un",80689754,80691357,1603
"21343","ENSMODG00000030336","2",326662754,326678840,16086
"21344","ENSMODG00000030337","Un",22338183,22384613,46430
"21345","ENSMODG00000030338","X",13086148,13087301,1153
"21346","ENSMODG00000030339","1",312879088,312899007,19919
"21347","ENSMODG00000030340","4",236663221,236663898,677
"21348","ENSMODG00000030341","5",265458154,265494165,36011
"21349","ENSMODG00000030342","3",202874232,202881012,6780
"21350","ENSMODG00000030343","3",317972426,317984816,12390
"21351","ENSMODG00000030344","8",189732663,189735953,3290
"21352","ENSMODG00000030345","6",171355649,171361716,6067
"21353","ENSMODG00000030346","3",390073746,390096747,23001
"21354","ENSMODG00000030347","2",306517028,306523371,6343
"21355","ENSMODG00000030348","8",271778291,271833608,55317
"21356","ENSMODG00000030350","3",182557673,182667289,109616
"21357","ENSMODG00000030351","7",177292211,177297875,5664
"21358","ENSMODG00000030352","4",402939443,402944502,5059
"21359","ENSMODG00000030353","4",161730361,161811580,81219
"21360","ENSMODG00000030354","1",396295192,396296455,1263
"21361","ENSMODG00000030355","2",23897591,23906843,9252
"21362","ENSMODG00000030356","3",372330860,372343708,12848
"21363","ENSMODG00000030358","3",463846812,463847709,897
"21364","ENSMODG00000030359","4",375302568,375320149,17581
"21365","ENSMODG00000030360","3",446051712,446083939,32227
"21366","ENSMODG00000030361","5",2049688,2053592,3904
"21367","ENSMODG00000030362","8",310046658,310053716,7058
"21368","ENSMODG00000030365","1",479533492,479659621,126129
"21369","ENSMODG00000030366","6",148333707,148407817,74110
"21370","ENSMODG00000030369","1",422177081,422178906,1825
"21371","ENSMODG00000030370","4",67414364,67426730,12366
"21372","ENSMODG00000030372","2",91866608,91942189,75581
"21373","ENSMODG00000030373","4",193754749,193773953,19204
"21374","ENSMODG00000030374","3",98182940,98189663,6723
"21375","ENSMODG00000030375","2",308732212,309013522,281310
"21376","ENSMODG00000030376","3",19960625,19964600,3975
"21377","ENSMODG00000030377","3",350454391,350573915,119524
"21378","ENSMODG00000030378","2",418625702,418628699,2997
"21379","ENSMODG00000030379","2",114893758,114921708,27950
"21380","ENSMODG00000030380","6",83716751,83732756,16005
"21381","ENSMODG00000030381","Un",24998499,24999962,1463
"21382","ENSMODG00000030383","6",6887038,6888082,1044
"21383","ENSMODG00000030385","7",149616657,149617793,1136
"21384","ENSMODG00000030386","1",61606524,61640155,33631
"21385","ENSMODG00000030387","8",79322150,79498438,176288
"21386","ENSMODG00000030388","2",16556522,16557879,1357
"21387","ENSMODG00000030389","2",416874167,416908013,33846
"21388","ENSMODG00000030390","1",57047268,57055059,7791
"21389","ENSMODG00000030391","7",241507777,241511183,3406
"21390","ENSMODG00000030395","2",201113279,201115089,1810
"21391","ENSMODG00000030397","Un",32881852,32895279,13427
"21392","ENSMODG00000030398","3",245461640,245467714,6074
"21393","ENSMODG00000030399","4",24580374,24593149,12775
"21394","ENSMODG00000030400","3",332364998,332371617,6619
"21395","ENSMODG00000030401","1",490883833,490886277,2444
"21396","ENSMODG00000030402","2",438323017,438330765,7748
"21397","ENSMODG00000030403","8",104848527,104856540,8013
"21398","ENSMODG00000030404","3",301478177,301539682,61505
"21399","ENSMODG00000030405","4",240133743,240143442,9699
"21400","ENSMODG00000030406","X",59823201,59825115,1914
"21401","ENSMODG00000030407","2",510321426,510335671,14245
"21402","ENSMODG00000030408","5",3608357,3736410,128053
"21403","ENSMODG00000030410","1",162597057,162663991,66934
"21404","ENSMODG00000030411","8",121700388,121702297,1909
"21405","ENSMODG00000030412","Un",13425370,13429104,3734
"21406","ENSMODG00000030413","8",34675546,34678330,2784
"21407","ENSMODG00000030415","1",395364739,395408571,43832
"21408","ENSMODG00000030416","7",253010192,253017473,7281
"21409","ENSMODG00000030417","8",117146710,117166738,20028
"21410","ENSMODG00000030418","3",79110905,79124180,13275
"21411","ENSMODG00000030419","6",20907058,21040549,133491
"21412","ENSMODG00000030421","3",320602128,320635803,33675
"21413","ENSMODG00000030422","1",350454760,350457948,3188
"21414","ENSMODG00000030423","3",425454112,425463125,9013
"21415","ENSMODG00000030424","7",67354086,67357629,3543
"21416","ENSMODG00000030425","4",229313304,229321880,8576
"21417","ENSMODG00000030426","3",160440072,160525344,85272
"21418","ENSMODG00000030428","2",40504136,40507196,3060
"21419","ENSMODG00000030429","3",49317851,49321549,3698
"21420","ENSMODG00000030430","5",101269432,101285631,16199
"21421","ENSMODG00000030431","1",359969948,359980581,10633
"21422","ENSMODG00000030432","4",287610713,287612631,1918
"21423","ENSMODG00000030434","3",81718406,81722896,4490
"21424","ENSMODG00000030435","7",209554003,209556469,2466
"21425","ENSMODG00000030436","4",389975097,389976637,1540
"21426","ENSMODG00000030437","3",47446005,47451288,5283
"21427","ENSMODG00000030439","4",370265784,370271152,5368
"21428","ENSMODG00000030440","2",289917113,289923998,6885
"21429","ENSMODG00000030441","2",284099290,284101104,1814
"21430","ENSMODG00000030442","6",29075115,29091698,16583
"21431","ENSMODG00000030444","Un",53182421,53188386,5965
"21432","ENSMODG00000030445","1",58026157,58029295,3138
"21433","ENSMODG00000030447","Un",11185694,11224487,38793
"21434","ENSMODG00000030451","8",270207426,270239778,32352
"21435","ENSMODG00000030452","6",10477853,10502645,24792
"21436","ENSMODG00000030455","7",184064472,184070829,6357
"21437","ENSMODG00000030456","3",138771474,138772746,1272
"21438","ENSMODG00000030457","2",122559929,122561860,1931
"21439","ENSMODG00000030458","6",30786287,30791739,5452
"21440","ENSMODG00000030460","8",79612420,79716995,104575
"21441","ENSMODG00000030461","4",279690832,279692360,1528
"21442","ENSMODG00000030462","7",188454068,188455839,1771
"21443","ENSMODG00000030463","4",235974264,235978726,4462
"21444","ENSMODG00000030464","5",267427492,267476431,48939
"21445","ENSMODG00000030466","3",142257002,142272301,15299
"21446","ENSMODG00000030467","Un",10454280,10456364,2084
"21447","ENSMODG00000030468","4",191619342,191630120,10778
"21448","ENSMODG00000030469","4",361407525,361410871,3346
"21449","ENSMODG00000030470","1",334479702,334486244,6542
"21450","ENSMODG00000030471","1",462401240,462405365,4125
"21451","ENSMODG00000030472","3",441363330,441366297,2967
"21452","ENSMODG00000030474","3",93397461,93532467,135006
"21453","ENSMODG00000030475","1",488953681,489008806,55125
"21454","ENSMODG00000030476","3",98366660,98513003,146343
"21455","ENSMODG00000030477","3",361588125,361599253,11128
"21456","ENSMODG00000030478","2",373114718,373116176,1458
"21457","ENSMODG00000030480","2",521509550,521519111,9561
"21458","ENSMODG00000030481","5",75836570,75924903,88333
"21459","ENSMODG00000030482","3",152237723,152262650,24927
"21460","ENSMODG00000030483","3",380605,381469,864
"21461","ENSMODG00000030484","Un",42271611,42273536,1925
"21462","ENSMODG00000030485","4",383211840,383218024,6184
"21463","ENSMODG00000030486","X",13705021,13715190,10169
"21464","ENSMODG00000030487","3",196178753,196187185,8432
"21465","ENSMODG00000030488","7",248243211,248281658,38447
"21466","ENSMODG00000030490","4",49807853,49810289,2436
"21467","ENSMODG00000030493","1",529973089,529977078,3989
"21468","ENSMODG00000030494","4",294643214,294666527,23313
"21469","ENSMODG00000030496","7",32012859,32027360,14501
"21470","ENSMODG00000030497","2",518915561,518926942,11381
"21471","ENSMODG00000030498","6",147685517,147691076,5559
"21472","ENSMODG00000030499","7",22778872,22790420,11548
"21473","ENSMODG00000030500","4",50051951,50082621,30670
"21474","ENSMODG00000030502","8",5351634,5360071,8437
"21475","ENSMODG00000030503","4",355952632,356035544,82912
"21476","ENSMODG00000030504","2",333713128,333732137,19009
"21477","ENSMODG00000030505","7",215486370,215490392,4022
"21478","ENSMODG00000030506","5",102011667,102015768,4101
"21479","ENSMODG00000030507","6",71119549,71237876,118327
"21480","ENSMODG00000030509","1",277418434,277421219,2785
"21481","ENSMODG00000030510","5",249499251,249505432,6181
"21482","ENSMODG00000030511","8",193664197,193767131,102934
"21483","ENSMODG00000030512","3",116714085,116736181,22096
"21484","ENSMODG00000030513","8",131512200,131525357,13157
"21485","ENSMODG00000030514","3",75662530,75664182,1652
"21486","ENSMODG00000030515","8",156030026,156032687,2661
"21487","ENSMODG00000030516","3",422354075,422371236,17161
"21488","ENSMODG00000030517","4",174278293,174353205,74912
"21489","ENSMODG00000030518","7",69283827,69287714,3887
"21490","ENSMODG00000030519","2",111098940,111105742,6802
"21491","ENSMODG00000030520","4",229012047,229019498,7451
"21492","ENSMODG00000030521","3",321048940,321068163,19223
"21493","ENSMODG00000030522","2",461239673,461249812,10139
"21494","ENSMODG00000030523","1",5025286,5043524,18238
"21495","ENSMODG00000030524","3",451399251,451404247,4996
"21496","ENSMODG00000030526","Un",46793018,46796178,3160
"21497","ENSMODG00000030528","6",253399171,253404480,5309
"21498","ENSMODG00000030529","7",244827938,244831585,3647
"21499","ENSMODG00000030530","3",503388788,503395802,7014
"21500","ENSMODG00000030531","8",214466629,214471248,4619
"21501","ENSMODG00000030532","2",231690365,231735519,45154
"21502","ENSMODG00000030533","6",251697403,251789626,92223
"21503","ENSMODG00000030534","4",421847290,421865596,18306
"21504","ENSMODG00000030535","1",402168021,402352996,184975
"21505","ENSMODG00000030537","5",302795494,302798074,2580
"21506","ENSMODG00000030538","1",148013840,148041545,27705
"21507","ENSMODG00000030539","2",36172444,36185125,12681
"21508","ENSMODG00000030540","1",399595994,399604031,8037
"21509","ENSMODG00000030542","4",226626371,226687250,60879
"21510","ENSMODG00000030543","8",134546638,134554019,7381
"21511","ENSMODG00000030544","4",73115737,73119700,3963
"21512","ENSMODG00000030545","5",292101052,292101874,822
"21513","ENSMODG00000030546","6",127208582,127210852,2270
"21514","ENSMODG00000030547","4",406063363,406067220,3857
"21515","ENSMODG00000030548","Un",75430914,75440566,9652
"21516","ENSMODG00000030549","5",260922260,261023235,100975
"21517","ENSMODG00000030550","2",46168490,46169561,1071
"21518","ENSMODG00000030551","3",217543593,217547782,4189
"21519","ENSMODG00000030552","X",64797882,64993973,196091
"21520","ENSMODG00000030553","2",121451663,121455318,3655
"21521","ENSMODG00000030554","4",343021450,343025829,4379
"21522","ENSMODG00000030555","8",310155939,310156904,965
"21523","ENSMODG00000030556","3",448373319,448398613,25294
"21524","ENSMODG00000030558","2",531441927,531447121,5194
"21525","ENSMODG00000030559","3",66012693,66028454,15761
"21526","ENSMODG00000030561","3",485338333,485358153,19820
"21527","ENSMODG00000030562","6",237614529,237698163,83634
"21528","ENSMODG00000030563","6",151791813,151848165,56352
"21529","ENSMODG00000030564","8",20009731,20053524,43793
"21530","ENSMODG00000030565","3",326608009,326629783,21774
"21531","ENSMODG00000030566","4",111689778,111713314,23536
"21532","ENSMODG00000030567","1",444614839,444623945,9106
"21533","ENSMODG00000030568","6",2108543,2112317,3774
"21534","ENSMODG00000030569","6",46155456,46348255,192799
"21535","ENSMODG00000030570","7",260251558,260263199,11641
"21536","ENSMODG00000030571","X",69692221,69700619,8398
"21537","ENSMODG00000030572","8",294617912,294641740,23828
"21538","ENSMODG00000030573","8",33661520,33679910,18390
"21539","ENSMODG00000030574","1",115295394,115303553,8159
"21540","ENSMODG00000030575","6",243311686,243395125,83439
"21541","ENSMODG00000030576","4",82650948,82658591,7643
"21542","ENSMODG00000030577","Un",61911578,61917851,6273
"21543","ENSMODG00000030578","1",42045437,42079079,33642
"21544","ENSMODG00000030579","2",88985190,89213767,228577
"21545","ENSMODG00000030580","8",308161692,308162506,814
"21546","ENSMODG00000030581","5",45411049,45601369,190320
"21547","ENSMODG00000030583","1",475144191,475156028,11837
"21548","ENSMODG00000030584","3",79780860,79794802,13942
"21549","ENSMODG00000030586","Un",41073869,41074969,1100
"21550","ENSMODG00000030587","2",505051933,505069276,17343
"21551","ENSMODG00000030588","6",72379481,72389280,9799
"21552","ENSMODG00000030589","3",141426833,141442513,15680
"21553","ENSMODG00000030590","6",69352868,69353370,502
"21554","ENSMODG00000030591","2",392664716,392668325,3609
"21555","ENSMODG00000030592","1",485314479,485316717,2238
"21556","ENSMODG00000030594","2",22291620,22299445,7825
"21557","ENSMODG00000030595","4",155624565,155633129,8564
"21558","ENSMODG00000030596","5",207300144,207305815,5671
"21559","ENSMODG00000030597","3",213050167,213052088,1921
"21560","ENSMODG00000030598","Un",18338967,18342687,3720
"21561","ENSMODG00000030600","6",156744043,156745543,1500
"21562","ENSMODG00000030601","2",40856346,40883629,27283
"21563","ENSMODG00000030602","X",44055796,44056830,1034
"21564","ENSMODG00000030603","1",46976013,46978298,2285
"21565","ENSMODG00000030605","1",3943603,3949676,6073
"21566","ENSMODG00000030606","Un",15970139,15971669,1530
"21567","ENSMODG00000030607","Un",22272049,22311255,39206
"21568","ENSMODG00000030608","2",464125443,464138195,12752
"21569","ENSMODG00000030611","4",294484280,294487718,3438
"21570","ENSMODG00000030612","3",420236059,420301830,65771
"21571","ENSMODG00000030613","2",468183753,468185715,1962
"21572","ENSMODG00000030614","2",283980012,283981282,1270
"21573","ENSMODG00000030616","6",157544654,157548077,3423
"21574","ENSMODG00000030617","8",108194655,108198208,3553
"21575","ENSMODG00000030618","2",442798957,442800315,1358
"21576","ENSMODG00000030619","Un",1949020,1952905,3885
"21577","ENSMODG00000030620","7",108841259,108982643,141384
"21578","ENSMODG00000030621","6",31958963,31960008,1045
"21579","ENSMODG00000030622","1",465794389,465796066,1677
"21580","ENSMODG00000030623","3",249310537,249315261,4724
"21581","ENSMODG00000030624","4",50421846,50426520,4674
"21582","ENSMODG00000030625","3",142229836,142230376,540
"21583","ENSMODG00000030626","3",442232744,442237986,5242
"21584","ENSMODG00000030628","1",120832678,120834450,1772
"21585","ENSMODG00000030629","Un",54389073,54390096,1023
"21586","ENSMODG00000030630","4",356492113,356494590,2477
"21587","ENSMODG00000030631","2",456221853,456227818,5965
"21588","ENSMODG00000030633","Un",75713496,75717620,4124
"21589","ENSMODG00000030634","1",162542370,162546258,3888
"21590","ENSMODG00000030635","7",169344458,169346415,1957
"21591","ENSMODG00000030637","7",243331500,243332142,642
"21592","ENSMODG00000030638","Un",32694079,32696596,2517
"21593","ENSMODG00000030640","8",286205413,286221329,15916
"21594","ENSMODG00000030642","6",210274143,210368944,94801
"21595","ENSMODG00000030643","6",199330407,199333767,3360
"21596","ENSMODG00000030645","3",132927711,133038701,110990
"21597","ENSMODG00000030646","4",39933682,39995832,62150
"21598","ENSMODG00000030647","2",483465784,483468109,2325
"21599","ENSMODG00000030648","5",215870079,215872147,2068
"21600","ENSMODG00000030649","2",233138359,233141347,2988
"21601","ENSMODG00000030650","2",416798537,416810599,12062
"21602","ENSMODG00000030651","3",244213414,244239978,26564
"21603","ENSMODG00000030652","8",165445076,165479852,34776
"21604","ENSMODG00000030653","4",74644334,74655388,11054
"21605","ENSMODG00000030654","2",159353957,159359691,5734
"21606","ENSMODG00000030655","1",115377597,115387633,10036
"21607","ENSMODG00000030657","8",260753222,260797684,44462
"21608","ENSMODG00000030658","5",200216660,200217698,1038
"21609","ENSMODG00000030659","3",184303978,184314603,10625
"21610","ENSMODG00000030662","5",277307933,277308503,570
"21611","ENSMODG00000030663","5",115136506,115143860,7354
"21612","ENSMODG00000030664","4",384177117,384178027,910
"21613","ENSMODG00000030665","1",315933224,316087678,154454
"21614","ENSMODG00000030666","8",209523568,209524657,1089
"21615","ENSMODG00000030667","1",91677614,91684983,7369
"21616","ENSMODG00000030668","4",49838294,49887637,49343
"21617","ENSMODG00000030670","X",22173784,22181007,7223
"21618","ENSMODG00000030671","3",91460362,91594375,134013
"21619","ENSMODG00000030672","7",143439646,143443218,3572
"21620","ENSMODG00000030673","X",35392831,35479365,86534
"21621","ENSMODG00000030674","7",90053417,90083001,29584
"21622","ENSMODG00000030677","5",229185749,229187392,1643
"21623","ENSMODG00000030679","2",334266983,334271587,4604
"21624","ENSMODG00000030681","1",390987903,390989329,1426
"21625","ENSMODG00000030683","Un",47458363,47461221,2858
"21626","ENSMODG00000030684","5",295493419,295499239,5820
"21627","ENSMODG00000030685","8",178923525,178977731,54206
"21628","ENSMODG00000030686","4",229875721,229877041,1320
"21629","ENSMODG00000030687","1",444786296,444840804,54508
"21630","ENSMODG00000030688","2",281764727,281773764,9037
"21631","ENSMODG00000030689","3",187821020,187826569,5549
"21632","ENSMODG00000030690","1",34543862,34549263,5401
"21633","ENSMODG00000030692","6",21628546,21638356,9810
"21634","ENSMODG00000030693","4",251245902,251255465,9563
"21635","ENSMODG00000030696","Un",92235680,92236954,1274
"21636","ENSMODG00000030698","8",201162689,201166020,3331
"21637","ENSMODG00000030699","Un",34280611,34288426,7815
"21638","ENSMODG00000030701","2",409155700,409162227,6527
"21639","ENSMODG00000030702","4",34523016,34530476,7460
"21640","ENSMODG00000030703","4",225655533,225662069,6536
"21641","ENSMODG00000030704","Un",78648287,78733858,85571
"21642","ENSMODG00000030705","3",361616980,361624341,7361
"21643","ENSMODG00000030707","2",518088594,518132064,43470
"21644","ENSMODG00000030708","1",312548891,312550127,1236
"21645","ENSMODG00000030709","1",101414312,101419931,5619
"21646","ENSMODG00000030710","Un",41405453,41406403,950
"21647","ENSMODG00000030711","2",255217749,255220195,2446
"21648","ENSMODG00000030712","6",51460662,51466235,5573
"21649","ENSMODG00000030715","Un",75847435,75849568,2133
"21650","ENSMODG00000030716","8",236321522,236400337,78815
"21651","ENSMODG00000030717","3",350277621,350287971,10350
"21652","ENSMODG00000030719","2",528043515,528066833,23318
"21653","ENSMODG00000030720","5",80028918,80055180,26262
"21654","ENSMODG00000030721","6",58257397,58261942,4545
"21655","ENSMODG00000030722","4",286050337,286087053,36716
"21656","ENSMODG00000030724","1",335437369,335438280,911
"21657","ENSMODG00000030725","1",409070826,409073216,2390
"21658","ENSMODG00000030726","Un",22445263,22446627,1364
"21659","ENSMODG00000030727","8",109399067,109404820,5753
"21660","ENSMODG00000030728","4",216604156,216609141,4985
"21661","ENSMODG00000030729","X",43613530,43641767,28237
"21662","ENSMODG00000030730","X",38697695,38714186,16491
"21663","ENSMODG00000030732","8",31103309,31118773,15464
"21664","ENSMODG00000030733","4",337236583,337256719,20136
"21665","ENSMODG00000030734","1",311187467,311196173,8706
"21666","ENSMODG00000030735","Un",60834283,60835606,1323
"21667","ENSMODG00000030736","6",246258241,246266315,8074
"21668","ENSMODG00000030737","3",244166951,244170412,3461
"21669","ENSMODG00000030738","3",142140408,142151992,11584
"21670","ENSMODG00000030741","6",77151005,77156860,5855
"21671","ENSMODG00000030742","6",199083408,199085156,1748
"21672","ENSMODG00000030743","3",416055127,416081777,26650
"21673","ENSMODG00000030744","5",15015876,15029122,13246
"21674","ENSMODG00000030745","8",99133981,99144743,10762
"21675","ENSMODG00000030746","6",235230896,235339889,108993
"21676","ENSMODG00000030747","2",332416280,332428128,11848
"21677","ENSMODG00000030748","1",372693259,372710178,16919
"21678","ENSMODG00000030749","3",216780512,216855462,74950
"21679","ENSMODG00000030751","4",108050614,108069111,18497
"21680","ENSMODG00000030752","5",227586006,227706785,120779
"21681","ENSMODG00000030753","5",253785049,253788343,3294
"21682","ENSMODG00000030754","2",528936222,528947624,11402
"21683","ENSMODG00000030755","1",327056311,327058714,2403
"21684","ENSMODG00000030756","4",7133822,7135080,1258
"21685","ENSMODG00000030757","5",124884072,124890587,6515
"21686","ENSMODG00000030758","4",66144070,66149229,5159
"21687","ENSMODG00000030760","1",399852206,399854842,2636
"21688","ENSMODG00000030761","2",377457910,377583034,125124
"21689","ENSMODG00000030762","1",273618895,273628775,9880
"21690","ENSMODG00000030763","8",62488179,62489071,892
"21691","ENSMODG00000030765","2",242954060,242981237,27177
"21692","ENSMODG00000030766","5",257534633,257562571,27938
"21693","ENSMODG00000030767","7",75231776,75238394,6618
"21694","ENSMODG00000030768","7",62347820,62353888,6068
"21695","ENSMODG00000030771","7",249396028,249502346,106318
"21696","ENSMODG00000030772","5",16162897,16163565,668
"21697","ENSMODG00000030773","2",429910465,429945625,35160
"21698","ENSMODG00000030774","4",432471501,432476446,4945
"21699","ENSMODG00000030775","3",514768505,514817533,49028
"21700","ENSMODG00000030776","7",167565248,167568653,3405
"21701","ENSMODG00000030777","2",240775617,240788991,13374
"21702","ENSMODG00000030778","Un",46112637,46137642,25005
"21703","ENSMODG00000030783","1",370587660,370591564,3904
"21704","ENSMODG00000030785","8",233461757,233492585,30828
"21705","ENSMODG00000030786","X",29597157,29780664,183507
"21706","ENSMODG00000030787","3",492413138,492414356,1218
"21707","ENSMODG00000030788","8",236849409,236902583,53174
"21708","ENSMODG00000030789","4",151579452,151582004,2552
"21709","ENSMODG00000030790","4",229019631,229026355,6724
"21710","ENSMODG00000030791","5",11314273,11337484,23211
"21711","ENSMODG00000030792","2",349997678,349998057,379
"21712","ENSMODG00000030793","3",388664311,388678621,14310
"21713","ENSMODG00000030796","3",176241490,176243426,1936
"21714","ENSMODG00000030797","5",71408817,71435143,26326
"21715","ENSMODG00000030798","2",22584104,22610784,26680
"21716","ENSMODG00000030799","2",203842427,203853125,10698
"21717","ENSMODG00000030801","7",71554544,71584033,29489
"21718","ENSMODG00000030802","7",13904352,13923462,19110
"21719","ENSMODG00000030803","8",272509274,272512571,3297
"21720","ENSMODG00000030804","4",405090217,405092714,2497
"21721","ENSMODG00000030805","Un",27793103,27821804,28701
"21722","ENSMODG00000030806","2",239338112,239353583,15471
"21723","ENSMODG00000030807","4",132298355,132307648,9293
"21724","ENSMODG00000030808","2",533851911,533859465,7554
"21725","ENSMODG00000030809","2",363022873,363080968,58095
"21726","ENSMODG00000030810","4",136070721,136100814,30093
"21727","ENSMODG00000030811","7",157233435,157295189,61754
"21728","ENSMODG00000030813","5",298846723,298848174,1451
"21729","ENSMODG00000030814","1",460458644,460503444,44800
"21730","ENSMODG00000030815","4",339986329,339989512,3183
"21731","ENSMODG00000030816","4",184164086,184243354,79268
"21732","ENSMODG00000030817","3",451082510,451087872,5362
"21733","ENSMODG00000030818","8",8374919,8380701,5782
"21734","ENSMODG00000030821","3",459270520,459307652,37132
"21735","ENSMODG00000030822","Un",30278543,30280241,1698
"21736","ENSMODG00000030823","1",299928718,299935105,6387
"21737","ENSMODG00000030826","8",169429948,169469224,39276
"21738","ENSMODG00000030828","2",49813694,49819695,6001
"21739","ENSMODG00000030829","6",176704693,176723384,18691
"21740","ENSMODG00000030830","Un",50481314,50486561,5247
"21741","ENSMODG00000030831","1",160712885,160721265,8380
"21742","ENSMODG00000030832","6",118014273,118021668,7395
"21743","ENSMODG00000030833","1",113353733,113369099,15366
"21744","ENSMODG00000030834","4",393413991,393446403,32412
"21745","ENSMODG00000030836","5",14786787,14809915,23128
"21746","ENSMODG00000030837","5",173883712,173885925,2213
"21747","ENSMODG00000030838","1",447973175,447981166,7991
"21748","ENSMODG00000030839","7",134810864,134825001,14137
"21749","ENSMODG00000030840","3",270927,291370,20443
"21750","ENSMODG00000030841","2",79969139,79970837,1698
"21751","ENSMODG00000030842","4",421804321,421826608,22287
"21752","ENSMODG00000030844","6",125835448,125867498,32050
"21753","ENSMODG00000030845","3",77459147,77478676,19529
"21754","ENSMODG00000030846","5",52456637,52499406,42769
"21755","ENSMODG00000030847","2",368634326,368645210,10884
"21756","ENSMODG00000030848","4",93865617,93900207,34590
"21757","ENSMODG00000030849","Un",57502062,57512657,10595
"21758","ENSMODG00000030850","1",22385384,22389160,3776
"21759","ENSMODG00000030851","Un",80559238,80561456,2218
"21760","ENSMODG00000030852","7",244231070,244231928,858
"21761","ENSMODG00000030853","1",474876781,474898417,21636
"21762","ENSMODG00000030855","1",139233489,139237989,4500
"21763","ENSMODG00000030856","3",85438389,85469294,30905
"21764","ENSMODG00000030857","1",373670128,373677085,6957
"21765","ENSMODG00000030858","7",239844354,239856813,12459
"21766","ENSMODG00000030859","1",317108171,317126324,18153
"21767","ENSMODG00000030861","2",532827535,532836909,9374
"21768","ENSMODG00000030862","3",233520338,233521381,1043
"21769","ENSMODG00000030863","8",275452735,275453443,708
"21770","ENSMODG00000030864","3",337544380,337550088,5708
"21771","ENSMODG00000030865","6",216687078,216689444,2366
"21772","ENSMODG00000030866","4",63606764,63614635,7871
"21773","ENSMODG00000030867","2",354940682,354963431,22749
"21774","ENSMODG00000030869","5",215261153,215281988,20835
"21775","ENSMODG00000030870","3",389314781,389364731,49950
"21776","ENSMODG00000030871","2",305496542,305549942,53400
"21777","ENSMODG00000030872","1",424324603,424331181,6578
"21778","ENSMODG00000030873","X",3037225,3038916,1691
"21779","ENSMODG00000030877","1",284753594,284952778,199184
"21780","ENSMODG00000030878","1",119147244,119169444,22200
"21781","ENSMODG00000030879","8",300981684,300990683,8999
"21782","ENSMODG00000030880","3",199186323,199193579,7256
"21783","ENSMODG00000030882","Un",31152682,31157906,5224
"21784","ENSMODG00000030885","2",204094565,204111585,17020
"21785","ENSMODG00000030886","7",92535676,92665660,129984
"21786","ENSMODG00000030887","3",254679334,254687355,8021
"21787","ENSMODG00000030888","1",24008640,24011894,3254
"21788","ENSMODG00000030889","2",322891149,322902059,10910
"21789","ENSMODG00000030890","8",228762096,228785481,23385
"21790","ENSMODG00000030891","X",64287751,64317202,29451
"21791","ENSMODG00000030892","6",115904814,116014434,109620
"21792","ENSMODG00000030893","6",167957501,167964036,6535
"21793","ENSMODG00000030894","7",129069001,129108782,39781
"21794","ENSMODG00000030896","2",112091540,112106882,15342
"21795","ENSMODG00000030898","1",122578592,122591899,13307
"21796","ENSMODG00000030899","3",210637540,210725458,87918
"21797","ENSMODG00000030900","7",205347986,205400381,52395
"21798","ENSMODG00000030901","8",309280152,309284873,4721
"21799","ENSMODG00000030903","1",390853724,390857150,3426
"21800","ENSMODG00000030904","1",152873930,152887380,13450
"21801","ENSMODG00000030905","2",461048357,461049475,1118
"21802","ENSMODG00000030906","4",205112630,205114041,1411
"21803","ENSMODG00000030907","6",122124400,122146863,22463
"21804","ENSMODG00000030908","5",124624713,124627416,2703
"21805","ENSMODG00000030909","5",143092532,143131755,39223
"21806","ENSMODG00000030910","3",47606761,47608146,1385
"21807","ENSMODG00000030911","4",349973625,349974771,1146
"21808","ENSMODG00000030912","Un",54356668,54358539,1871
"21809","ENSMODG00000030914","2",371885570,371906242,20672
"21810","ENSMODG00000030915","1",128289132,128292819,3687
"21811","ENSMODG00000030916","8",191659003,191683101,24098
"21812","ENSMODG00000030917","5",170922567,170982452,59885
"21813","ENSMODG00000030919","X",9078720,9097736,19016
"21814","ENSMODG00000030920","X",14203006,14312958,109952
"21815","ENSMODG00000030921","4",63721360,63735696,14336
"21816","ENSMODG00000030922","5",265064317,265065271,954
"21817","ENSMODG00000030923","3",226080569,226084282,3713
"21818","ENSMODG00000030924","4",55627298,55684477,57179
"21819","ENSMODG00000030925","5",183928092,183939265,11173
"21820","ENSMODG00000030926","Un",22228911,22286152,57241
"21821","ENSMODG00000030927","3",359403804,359439340,35536
"21822","ENSMODG00000030928","7",101120459,101149666,29207
"21823","ENSMODG00000030931","8",231680961,231716962,36001
"21824","ENSMODG00000030932","2",480176993,480186955,9962
"21825","ENSMODG00000030933","2",52092682,52162420,69738
"21826","ENSMODG00000030934","4",65097183,65215369,118186
"21827","ENSMODG00000030935","5",280872695,280875720,3025
"21828","ENSMODG00000030937","2",220030735,220042426,11691
"21829","ENSMODG00000030938","7",225000716,225001896,1180
"21830","ENSMODG00000030940","8",310784929,310785809,880
"21831","ENSMODG00000030942","2",182060549,182074795,14246
"21832","ENSMODG00000030943","1",103191929,103373088,181159
"21833","ENSMODG00000030944","4",83947289,83951376,4087
"21834","ENSMODG00000030945","3",511083370,511093461,10091
"21835","ENSMODG00000030946","1",486185011,486199156,14145
"21836","ENSMODG00000030948","3",395201834,395214788,12954
"21837","ENSMODG00000030949","6",202873066,202875545,2479
"21838","ENSMODG00000030950","X",59077652,59078988,1336
"21839","ENSMODG00000030951","2",83539460,83586506,47046
"21840","ENSMODG00000030952","5",62635534,62639642,4108
"21841","ENSMODG00000030953","2",39652218,39704633,52415
"21842","ENSMODG00000030954","8",249907564,249912541,4977
"21843","ENSMODG00000030956","4",397232955,397234774,1819
"21844","ENSMODG00000030957","2",177226744,177332618,105874
"21845","ENSMODG00000030958","6",186509702,186639950,130248
"21846","ENSMODG00000030960","2",108644007,108648574,4567
"21847","ENSMODG00000030961","2",438228864,438230819,1955
"21848","ENSMODG00000030962","4",137989428,137993893,4465
"21849","ENSMODG00000030963","1",132205220,132225134,19914
"21850","ENSMODG00000030964","2",523252391,523257996,5605
"21851","ENSMODG00000030965","2",61223727,61226692,2965
"21852","ENSMODG00000030966","5",44028154,44146512,118358
"21853","ENSMODG00000030968","1",417290830,417300764,9934
"21854","ENSMODG00000030969","6",217565904,217574841,8937
"21855","ENSMODG00000030970","2",289783272,289802934,19662
"21856","ENSMODG00000030973","6",101856930,101868086,11156
"21857","ENSMODG00000030974","1",396149855,396166987,17132
"21858","ENSMODG00000030975","6",219739775,219744894,5119
"21859","ENSMODG00000030976","1",174373052,174376675,3623
"21860","ENSMODG00000030977","7",230537498,230538870,1372
"21861","ENSMODG00000030978","3",80682734,80684507,1773
"21862","ENSMODG00000030980","3",50317320,50351388,34068
"21863","ENSMODG00000030983","3",428941473,428946727,5254
"21864","ENSMODG00000030984","3",401190493,401270302,79809
"21865","ENSMODG00000030987","7",144490210,144499704,9494
"21866","ENSMODG00000030989","3",180121115,180123134,2019
"21867","ENSMODG00000030991","6",195588714,195591351,2637
"21868","ENSMODG00000030993","7",78156273,78337761,181488
"21869","ENSMODG00000030994","Un",15382973,15385776,2803
"21870","ENSMODG00000030995","4",238571664,238600815,29151
"21871","ENSMODG00000030996","1",246717535,246732775,15240
"21872","ENSMODG00000030997","Un",28467354,28493155,25801
"21873","ENSMODG00000030998","2",201375145,201376761,1616
"21874","ENSMODG00000030999","2",27780535,27801964,21429
"21875","ENSMODG00000031000","7",255762103,255763518,1415
"21876","ENSMODG00000031002","4",81311866,81322140,10274
"21877","ENSMODG00000031003","5",75822945,75890435,67490
"21878","ENSMODG00000031004","1",352577619,352598701,21082
"21879","ENSMODG00000031005","7",108384049,108393830,9781
"21880","ENSMODG00000031008","2",105877375,105882633,5258
"21881","ENSMODG00000031009","2",59019407,59025982,6575
"21882","ENSMODG00000031011","6",137755301,137798730,43429
"21883","ENSMODG00000031012","5",41964605,41966911,2306
"21884","ENSMODG00000031013","8",150719621,150723920,4299
"21885","ENSMODG00000031014","3",376787216,376788704,1488
"21886","ENSMODG00000031015","8",174229838,174234629,4791
"21887","ENSMODG00000031016","1",198103155,198117927,14772
"21888","ENSMODG00000031017","6",196512681,196513843,1162
"21889","ENSMODG00000031018","Un",11117471,11126417,8946
"21890","ENSMODG00000031020","4",307352082,307357153,5071
"21891","ENSMODG00000031021","1",265451590,265469416,17826
"21892","ENSMODG00000031022","4",286499527,286512237,12710
"21893","ENSMODG00000031024","4",323967967,323968773,806
"21894","ENSMODG00000031025","2",284085571,284089309,3738
"21895","ENSMODG00000031026","8",291817782,291825343,7561
"21896","ENSMODG00000031029","8",155153901,155157145,3244
"21897","ENSMODG00000031031","Un",28272980,28274461,1481
"21898","ENSMODG00000031032","Un",85024859,85026206,1347
"21899","ENSMODG00000031033","4",59253358,59254428,1070
"21900","ENSMODG00000031034","6",163460584,163465874,5290
"21901","ENSMODG00000031035","2",179041914,179418347,376433
"21902","ENSMODG00000031036","7",225308637,225316051,7414
"21903","ENSMODG00000031037","X",33324268,33479386,155118
"21904","ENSMODG00000031038","2",38442358,38453346,10988
"21905","ENSMODG00000031039","3",19879134,19883044,3910
"21906","ENSMODG00000031041","2",532461604,532474326,12722
"21907","ENSMODG00000031042","8",103105051,103190031,84980
"21908","ENSMODG00000031044","8",249092241,249096881,4640
"21909","ENSMODG00000031045","4",357967827,357993000,25173
"21910","ENSMODG00000031047","1",174331770,174348703,16933
"21911","ENSMODG00000031048","2",507057528,507068631,11103
"21912","ENSMODG00000031049","8",301097869,301103145,5276
"21913","ENSMODG00000031051","1",441380640,441381993,1353
"21914","ENSMODG00000031052","3",232468735,232471348,2613
"21915","ENSMODG00000031053","3",491856733,491871175,14442
"21916","ENSMODG00000031054","4",107012240,107022810,10570
"21917","ENSMODG00000031056","5",1870112,1872560,2448
"21918","ENSMODG00000031057","6",234513871,234586305,72434
"21919","ENSMODG00000031058","2",313529021,313593577,64556
"21920","ENSMODG00000031059","X",69322401,69325124,2723
"21921","ENSMODG00000031061","4",393245273,393265631,20358
"21922","ENSMODG00000031062","6",220149326,220152232,2906
"21923","ENSMODG00000031063","2",135955577,136035986,80409
"21924","ENSMODG00000031065","2",468106966,468121073,14107
"21925","ENSMODG00000031069","4",230445043,230470937,25894
"21926","ENSMODG00000031071","1",448902228,448916306,14078
"21927","ENSMODG00000031072","8",90977304,90981830,4526
"21928","ENSMODG00000031073","X",48059482,48068827,9345
"21929","ENSMODG00000031074","2",455607445,455608859,1414
"21930","ENSMODG00000031075","4",364065893,364078092,12199
"21931","ENSMODG00000031076","Un",14004617,14007998,3381
"21932","ENSMODG00000031078","4",50082321,50093450,11129
"21933","ENSMODG00000031081","2",447066943,447079115,12172
"21934","ENSMODG00000031082","7",208931515,208941042,9527
"21935","ENSMODG00000031083","8",116496308,116497452,1144
"21936","ENSMODG00000031084","6",110078537,110081514,2977
"21937","ENSMODG00000031085","2",176716885,176723732,6847
"21938","ENSMODG00000031087","2",220979751,221131650,151899
"21939","ENSMODG00000031088","8",6928721,6957829,29108
"21940","ENSMODG00000031089","Un",19997140,19999621,2481
"21941","ENSMODG00000031090","6",234934667,234967176,32509
"21942","ENSMODG00000031092","5",95866131,95914405,48274
"21943","ENSMODG00000031093","6",200376047,200389054,13007
"21944","ENSMODG00000031094","6",283319436,283335399,15963
"21945","ENSMODG00000031096","3",104617472,104634149,16677
"21946","ENSMODG00000031097","3",375485863,375584655,98792
"21947","ENSMODG00000031098","Un",95525394,95525837,443
"21948","ENSMODG00000031099","5",141818685,141843970,25285
"21949","ENSMODG00000031100","6",80893873,80910094,16221
"21950","ENSMODG00000031101","2",222058504,222060354,1850
"21951","ENSMODG00000031102","2",353087276,353181654,94378
"21952","ENSMODG00000031103","Un",30946277,31019472,73195
"21953","ENSMODG00000031104","2",234076722,234207336,130614
"21954","ENSMODG00000031105","1",81199024,81207635,8611
"21955","ENSMODG00000031106","3",33766366,33781683,15317
"21956","ENSMODG00000031108","4",20791162,20797183,6021
"21957","ENSMODG00000031109","8",312052844,312102373,49529
"21958","ENSMODG00000031110","2",437196697,437222183,25486
"21959","ENSMODG00000031111","8",70829422,70830902,1480
"21960","ENSMODG00000031112","3",105719825,105754156,34331
"21961","ENSMODG00000031113","1",499525370,499535905,10535
"21962","ENSMODG00000031114","4",406212889,406214890,2001
"21963","ENSMODG00000031117","8",59648709,59655895,7186
"21964","ENSMODG00000031118","4",235652971,235669680,16709
"21965","ENSMODG00000031119","6",121538063,121549488,11425
"21966","ENSMODG00000031120","8",148094082,148119052,24970
"21967","ENSMODG00000031121","3",49842001,49845877,3876
"21968","ENSMODG00000031123","3",369134594,369136597,2003
"21969","ENSMODG00000031124","2",409569143,409583613,14470
"21970","ENSMODG00000031126","3",6077450,6129864,52414
"21971","ENSMODG00000031127","1",277895097,277914978,19881
"21972","ENSMODG00000031128","2",501851152,501878158,27006
"21973","ENSMODG00000031129","6",186772929,186826521,53592
"21974","ENSMODG00000031130","8",45629343,45664916,35573
"21975","ENSMODG00000031133","4",239511324,239602101,90777
"21976","ENSMODG00000031135","3",2006518,2016739,10221
"21977","ENSMODG00000031136","7",259147367,259163778,16411
"21978","ENSMODG00000031137","1",523428289,523461861,33572
"21979","ENSMODG00000031138","5",77909523,77912382,2859
"21980","ENSMODG00000031139","2",123461037,123468182,7145
"21981","ENSMODG00000031140","6",24768329,24976304,207975
"21982","ENSMODG00000031142","1",121386349,121432328,45979
"21983","ENSMODG00000031143","3",70939078,70940121,1043
"21984","ENSMODG00000031144","4",367693550,367697408,3858
"21985","ENSMODG00000031145","3",366130336,366132541,2205
"21986","ENSMODG00000031146","1",141308643,141451708,143065
"21987","ENSMODG00000031147","6",264154284,264171870,17586
"21988","ENSMODG00000031148","6",137552463,137563988,11525
"21989","ENSMODG00000031149","Un",69536204,69544838,8634
"21990","ENSMODG00000031150","7",3712686,3726431,13745
"21991","ENSMODG00000031151","2",283908503,283912199,3696
"21992","ENSMODG00000031152","5",53289521,53294122,4601
"21993","ENSMODG00000031153","6",19847506,19890497,42991
"21994","ENSMODG00000031155","1",437757464,437761854,4390
"21995","ENSMODG00000031156","2",276753504,276785477,31973
"21996","ENSMODG00000031157","1",190711019,190724989,13970
"21997","ENSMODG00000031159","X",51051187,51057565,6378
"21998","ENSMODG00000031160","3",341390811,341395820,5009
"21999","ENSMODG00000031161","7",248691426,248710132,18706
"22000","ENSMODG00000031162","4",103588812,103606566,17754
"22001","ENSMODG00000031163","3",399520629,399522825,2196
"22002","ENSMODG00000031165","1",177359168,177381875,22707
"22003","ENSMODG00000031166","3",473794071,473815181,21110
"22004","ENSMODG00000031168","4",138857891,138861030,3139
"22005","ENSMODG00000031169","1",252724500,252828507,104007
"22006","ENSMODG00000031170","5",263615788,263630070,14282
"22007","ENSMODG00000031173","Un",41057040,41058977,1937
"22008","ENSMODG00000031174","3",219055809,219068696,12887
"22009","ENSMODG00000031176","3",13491439,13505308,13869
"22010","ENSMODG00000031177","8",255322586,255325964,3378
"22011","ENSMODG00000031178","3",314864776,314922013,57237
"22012","ENSMODG00000031179","Un",22333167,22390343,57176
"22013","ENSMODG00000031181","7",12279588,12317262,37674
"22014","ENSMODG00000031182","4",317659172,317750786,91614
"22015","ENSMODG00000031183","2",528705678,528710190,4512
"22016","ENSMODG00000031185","2",167021929,167035092,13163
"22017","ENSMODG00000031186","6",156725070,156741206,16136
"22018","ENSMODG00000031187","2",115453942,115456885,2943
"22019","ENSMODG00000031188","Un",37361079,37362170,1091
"22020","ENSMODG00000031189","4",300682241,300800475,118234
"22021","ENSMODG00000031191","2",536524217,536525159,942
"22022","ENSMODG00000031192","4",225897863,225900294,2431
"22023","ENSMODG00000031194","2",386144394,386150086,5692
"22024","ENSMODG00000031195","2",340251675,340444757,193082
"22025","ENSMODG00000031196","5",90565412,90611019,45607
"22026","ENSMODG00000031197","4",234221390,234231106,9716
"22027","ENSMODG00000031198","3",331019652,331042946,23294
"22028","ENSMODG00000031199","4",111714086,111715561,1475
"22029","ENSMODG00000031202","2",396012363,396013263,900
"22030","ENSMODG00000031203","2",482740138,482751365,11227
"22031","ENSMODG00000031204","3",163346363,163409780,63417
"22032","ENSMODG00000031207","8",273096815,273123620,26805
"22033","ENSMODG00000031208","Un",91305205,91308347,3142
"22034","ENSMODG00000031210","7",251178041,251179290,1249
"22035","ENSMODG00000031212","2",89400548,89439966,39418
"22036","ENSMODG00000031213","5",215706004,215708511,2507
"22037","ENSMODG00000031214","8",147513847,147529468,15621
"22038","ENSMODG00000031215","3",187147302,187167786,20484
"22039","ENSMODG00000031216","5",70042785,70081375,38590
"22040","ENSMODG00000031217","1",335930938,335978319,47381
"22041","ENSMODG00000031219","5",2182111,2214504,32393
"22042","ENSMODG00000031220","8",240032893,240036000,3107
"22043","ENSMODG00000031221","3",441251793,441294907,43114
"22044","ENSMODG00000031222","2",8521495,8524710,3215
"22045","ENSMODG00000031223","7",244015285,244038414,23129
"22046","ENSMODG00000031225","8",291446243,291447830,1587
"22047","ENSMODG00000031226","3",186363879,186428992,65113
"22048","ENSMODG00000031227","1",308508085,308512685,4600
"22049","ENSMODG00000031231","1",16046936,16058148,11212
"22050","ENSMODG00000031233","3",171731599,171738547,6948
"22051","ENSMODG00000031234","2",176499106,176500677,1571
"22052","ENSMODG00000031235","2",457995684,458015322,19638
"22053","ENSMODG00000031236","8",158186758,158188995,2237
"22054","ENSMODG00000031237","Un",31618398,31619709,1311
"22055","ENSMODG00000031238","7",109182568,109197942,15374
"22056","ENSMODG00000031241","4",121906542,121909975,3433
"22057","ENSMODG00000031242","1",282143250,282253919,110669
"22058","ENSMODG00000031243","2",60363706,60390565,26859
"22059","ENSMODG00000031244","7",229797751,229821850,24099
"22060","ENSMODG00000031245","8",46324115,46336026,11911
"22061","ENSMODG00000031246","6",122711347,122712922,1575
"22062","ENSMODG00000031247","8",112883587,112886409,2822
"22063","ENSMODG00000031248","1",374871038,374895827,24789
"22064","ENSMODG00000031249","7",16961,22477,5516
"22065","ENSMODG00000031251","6",217437906,217523098,85192
"22066","ENSMODG00000031252","8",137894789,137901767,6978
"22067","ENSMODG00000031253","7",240607573,240609737,2164
"22068","ENSMODG00000031255","1",487089735,487091351,1616
"22069","ENSMODG00000031256","5",39314412,39315418,1006
"22070","ENSMODG00000031257","7",169601720,169627511,25791
"22071","ENSMODG00000031259","7",11137082,11142300,5218
"22072","ENSMODG00000031260","4",346210747,346225284,14537
"22073","ENSMODG00000031261","5",162354753,162370224,15471
"22074","ENSMODG00000031262","6",140895596,140942043,46447
"22075","ENSMODG00000031263","7",25463756,25477540,13784
"22076","ENSMODG00000031266","3",166407594,166424393,16799
"22077","ENSMODG00000031267","3",444018945,444040159,21214
"22078","ENSMODG00000031268","3",340344092,340359099,15007
"22079","ENSMODG00000031270","1",244284793,244287621,2828
"22080","ENSMODG00000031273","5",78669928,78684899,14971
"22081","ENSMODG00000031274","3",446057742,446075808,18066
"22082","ENSMODG00000031275","X",41388096,41389353,1257
"22083","ENSMODG00000031276","4",294751262,294817409,66147
"22084","ENSMODG00000031277","1",278524073,278525640,1567
"22085","ENSMODG00000031278","5",280377089,280415552,38463
"22086","ENSMODG00000031280","2",65494775,65533653,38878
"22087","ENSMODG00000031281","3",488645707,488657030,11323
"22088","ENSMODG00000031282","4",170762583,170858130,95547
"22089","ENSMODG00000031283","X",67312151,67313583,1432
"22090","ENSMODG00000031284","4",237534806,237570952,36146
"22091","ENSMODG00000031285","7",109362245,109448197,85952
"22092","ENSMODG00000031286","1",436662076,436673763,11687
"22093","ENSMODG00000031287","2",459625135,459717127,91992
"22094","ENSMODG00000031288","4",10597394,10626847,29453
"22095","ENSMODG00000031290","4",200444195,200526530,82335
"22096","ENSMODG00000031291","2",153011222,153018916,7694
"22097","ENSMODG00000031292","7",36866700,36872786,6086
"22098","ENSMODG00000031293","2",437265619,437281697,16078
"22099","ENSMODG00000031295","1",472157371,472160834,3463
"22100","ENSMODG00000031298","8",113518027,113522976,4949
"22101","ENSMODG00000031299","3",445203659,445211870,8211
"22102","ENSMODG00000031300","4",156320593,156321395,802
"22103","ENSMODG00000031301","3",395666932,395697570,30638
"22104","ENSMODG00000031302","3",225289640,225303585,13945
"22105","ENSMODG00000031304","5",173147497,173200552,53055
"22106","ENSMODG00000031305","4",333301396,333328442,27046
"22107","ENSMODG00000031306","2",457462089,457471362,9273
"22108","ENSMODG00000031307","6",26842006,26852575,10569
"22109","ENSMODG00000031308","1",485748312,485773158,24846
"22110","ENSMODG00000031309","2",143767111,143828705,61594
"22111","ENSMODG00000031310","Un",56234821,56239883,5062
"22112","ENSMODG00000031311","6",19715455,19825748,110293
"22113","ENSMODG00000031313","3",24270417,24292391,21974
"22114","ENSMODG00000031314","8",142637200,142638879,1679
"22115","ENSMODG00000031315","2",264353030,264359370,6340
"22116","ENSMODG00000031317","2",108616520,108632186,15666
"22117","ENSMODG00000031318","1",296270652,296274640,3988
"22118","ENSMODG00000031319","7",149110934,149113487,2553
"22119","ENSMODG00000031320","3",433236828,433352264,115436
"22120","ENSMODG00000031321","3",145036191,145112979,76788
"22121","ENSMODG00000031322","4",361925668,362063678,138010
"22122","ENSMODG00000031323","4",211188894,211192672,3778
"22123","ENSMODG00000031324","1",26427820,26429605,1785
"22124","ENSMODG00000031325","2",44267563,44272241,4678
"22125","ENSMODG00000031326","5",84072521,84259023,186502
"22126","ENSMODG00000031327","6",11572979,11574990,2011
"22127","ENSMODG00000031328","1",221515056,221519513,4457
"22128","ENSMODG00000031329","5",214430555,214436252,5697
"22129","ENSMODG00000031330","X",58952954,59072894,119940
"22130","ENSMODG00000031331","6",270708731,270710347,1616
"22131","ENSMODG00000031333","1",101505205,101506758,1553
"22132","ENSMODG00000031334","X",79036717,79038252,1535
"22133","ENSMODG00000031335","8",255935804,255952683,16879
"22134","ENSMODG00000031336","2",523976934,523981249,4315
"22135","ENSMODG00000031337","2",255259128,255265557,6429
"22136","ENSMODG00000031338","1",434461192,434467256,6064
"22137","ENSMODG00000031340","7",182420096,182457282,37186
"22138","ENSMODG00000031341","8",234539436,234545907,6471
"22139","ENSMODG00000031344","2",186636508,186663657,27149
"22140","ENSMODG00000031345","1",295790361,295807959,17598
"22141","ENSMODG00000031346","5",200352407,200369898,17491
"22142","ENSMODG00000031347","1",474206458,474208166,1708
"22143","ENSMODG00000031348","8",68137425,68170538,33113
"22144","ENSMODG00000031349","1",130503316,130656164,152848
"22145","ENSMODG00000031350","8",278358574,278391922,33348
"22146","ENSMODG00000031351","3",418868198,418874473,6275
"22147","ENSMODG00000031352","5",108066599,108149370,82771
"22148","ENSMODG00000031354","2",529446564,529447536,972
"22149","ENSMODG00000031355","2",241177553,241187615,10062
"22150","ENSMODG00000031356","4",240410453,240546127,135674
"22151","ENSMODG00000031357","5",262875198,262877360,2162
"22152","ENSMODG00000031358","2",273151309,273154843,3534
"22153","ENSMODG00000031359","X",47767786,47769038,1252
"22154","ENSMODG00000031360","X",22253236,22326646,73410
"22155","ENSMODG00000031362","5",173903466,173908578,5112
"22156","ENSMODG00000031363","1",446643157,446713152,69995
"22157","ENSMODG00000031364","3",239410927,239444941,34014
"22158","ENSMODG00000031365","1",380597631,380601320,3689
"22159","ENSMODG00000031367","1",111023770,111031371,7601
"22160","ENSMODG00000031370","5",25451187,25466293,15106
"22161","ENSMODG00000031371","2",343362229,343427235,65006
"22162","ENSMODG00000031372","4",704551,705947,1396
"22163","ENSMODG00000031375","3",475279395,475296749,17354
"22164","ENSMODG00000031376","6",96220669,96224006,3337
"22165","ENSMODG00000031377","2",285437932,285440992,3060
"22166","ENSMODG00000031378","2",51952357,51958498,6141
"22167","ENSMODG00000031379","8",47878639,47880088,1449
"22168","ENSMODG00000031381","5",146644423,146715154,70731
"22169","ENSMODG00000031382","2",516422693,516424867,2174
"22170","ENSMODG00000031383","7",89318313,89318834,521
"22171","ENSMODG00000031384","1",450561098,450562788,1690
"22172","ENSMODG00000031385","2",228142301,228149122,6821
"22173","ENSMODG00000031386","3",439672406,439674950,2544
"22174","ENSMODG00000031387","8",293043640,293146543,102903
"22175","ENSMODG00000031389","1",486086747,486099789,13042
"22176","ENSMODG00000031390","1",256575504,256593889,18385
"22177","ENSMODG00000031391","6",283771498,283788019,16521
"22178","ENSMODG00000031392","2",242156853,242173368,16515
"22179","ENSMODG00000031393","1",183797343,183808441,11098
"22180","ENSMODG00000031394","4",225977035,225981121,4086
"22181","ENSMODG00000031395","Un",91306525,91307494,969
"22182","ENSMODG00000031397","3",22869616,22898522,28906
"22183","ENSMODG00000031399","2",299468338,299469150,812
"22184","ENSMODG00000031401","3",200713284,200726562,13278
"22185","ENSMODG00000031403","1",458636857,458670763,33906
"22186","ENSMODG00000031404","2",276778062,276782648,4586
"22187","ENSMODG00000031407","8",305492727,305531583,38856
"22188","ENSMODG00000031408","3",366589453,366590505,1052
"22189","ENSMODG00000031409","Un",43664524,43720815,56291
"22190","ENSMODG00000031410","3",394411345,394441192,29847
"22191","ENSMODG00000031412","4",13587327,13618689,31362
"22192","ENSMODG00000031413","3",107903794,107925888,22094
"22193","ENSMODG00000031415","3",517339484,517348606,9122
"22194","ENSMODG00000031416","7",13957,68396,54439
"22195","ENSMODG00000031417","1",99413280,99549585,136305
"22196","ENSMODG00000031418","2",138147704,138158831,11127
"22197","ENSMODG00000031419","4",71267122,71277874,10752
"22198","ENSMODG00000031422","4",379360572,379462115,101543
"22199","ENSMODG00000031424","4",374699960,374708926,8966
"22200","ENSMODG00000031425","5",79280610,79286681,6071
"22201","ENSMODG00000031426","2",527195148,527204840,9692
"22202","ENSMODG00000031427","6",248431194,248435453,4259
"22203","ENSMODG00000031428","2",393175599,393252573,76974
"22204","ENSMODG00000031429","4",363499048,363501189,2141
"22205","ENSMODG00000031430","2",49915653,49962005,46352
"22206","ENSMODG00000031431","3",316957591,316999262,41671
"22207","ENSMODG00000031433","1",400772802,400778787,5985
"22208","ENSMODG00000031434","7",239912119,239919428,7309
"22209","ENSMODG00000031435","1",485700660,485706854,6194
"22210","ENSMODG00000031436","4",243811128,243815674,4546
"22211","ENSMODG00000031438","1",117255898,117258190,2292
"22212","ENSMODG00000031439","1",154775224,154779836,4612
"22213","ENSMODG00000031440","2",273381668,273407507,25839
"22214","ENSMODG00000031441","6",157738725,157744381,5656
"22215","ENSMODG00000031443","1",424232465,424239305,6840
"22216","ENSMODG00000031444","6",262899184,262906666,7482
"22217","ENSMODG00000031445","4",177270119,177272258,2139
"22218","ENSMODG00000031446","1",194502722,194504360,1638
"22219","ENSMODG00000031447","8",221160639,221166455,5816
"22220","ENSMODG00000031448","2",382445910,382584905,138995
"22221","ENSMODG00000031450","3",78893082,78930926,37844
"22222","ENSMODG00000031451","7",242838052,242840516,2464
"22223","ENSMODG00000031452","4",136476136,136524834,48698
"22224","ENSMODG00000031453","4",381427260,381428955,1695
"22225","ENSMODG00000031454","2",160662458,160679965,17507
"22226","ENSMODG00000031456","2",288749886,288753084,3198
"22227","ENSMODG00000031457","5",168943029,168953629,10600
"22228","ENSMODG00000031459","6",6409738,6412141,2403
"22229","ENSMODG00000031460","2",112230023,112237589,7566
"22230","ENSMODG00000031461","1",56480905,56481850,945
"22231","ENSMODG00000031462","3",159449101,159499811,50710
"22232","ENSMODG00000031463","Un",5049853,5071358,21505
"22233","ENSMODG00000031464","6",175194638,175207386,12748
"22234","ENSMODG00000031465","8",183458022,183460063,2041
"22235","ENSMODG00000031466","6",205035454,205036753,1299
"22236","ENSMODG00000031468","6",208077476,208088086,10610
"22237","ENSMODG00000031469","4",422178094,422179245,1151
"22238","ENSMODG00000031470","3",93010162,93014970,4808
"22239","ENSMODG00000031471","5",98183321,98231256,47935
"22240","ENSMODG00000031472","8",287824765,287849874,25109
"22241","ENSMODG00000031473","8",12348054,12350762,2708
"22242","ENSMODG00000031474","3",219152997,219160455,7458
"22243","ENSMODG00000031475","7",250673652,250678938,5286
"22244","ENSMODG00000031476","8",225835814,225984576,148762
"22245","ENSMODG00000031478","7",251141899,251150501,8602
"22246","ENSMODG00000031480","8",222033981,222087571,53590
"22247","ENSMODG00000031481","7",62865331,62871128,5797
"22248","ENSMODG00000031482","7",157341094,157342164,1070
"22249","ENSMODG00000031483","2",211825088,211826632,1544
"22250","ENSMODG00000031485","6",7739036,7741175,2139
"22251","ENSMODG00000031486","3",521095730,521101019,5289
"22252","ENSMODG00000031487","1",530861580,530905320,43740
"22253","ENSMODG00000031488","2",536506788,536508553,1765
"22254","ENSMODG00000031489","1",159155044,159159707,4663
"22255","ENSMODG00000031490","1",365939350,365947249,7899
"22256","ENSMODG00000031491","7",117857897,117912302,54405
"22257","ENSMODG00000031492","2",273963594,273966035,2441
"22258","ENSMODG00000031493","1",12841730,12846388,4658
"22259","ENSMODG00000031496","3",474955602,474962707,7105
"22260","ENSMODG00000031497","8",243497981,243500810,2829
"22261","ENSMODG00000031498","8",60592789,60593631,842
"22262","ENSMODG00000031499","2",186837477,186847077,9600
"22263","ENSMODG00000031500","1",52136311,52161870,25559
"22264","ENSMODG00000031501","2",13238506,13258830,20324
"22265","ENSMODG00000031502","4",368615717,368623222,7505
"22266","ENSMODG00000031503","6",71133523,71136596,3073
"22267","ENSMODG00000031504","6",93830934,93841824,10890
"22268","ENSMODG00000031506","8",68920743,68936333,15590
"22269","ENSMODG00000031508","7",189633910,189639767,5857
"22270","ENSMODG00000031509","X",21846399,21968948,122549
"22271","ENSMODG00000031510","1",359119580,359123428,3848
"22272","ENSMODG00000031511","7",210656462,210704259,47797
"22273","ENSMODG00000031514","8",181571505,181576700,5195
"22274","ENSMODG00000031515","Un",61004561,61024785,20224
"22275","ENSMODG00000031516","6",233507967,233521362,13395
"22276","ENSMODG00000031520","X",35204896,35206372,1476
"22277","ENSMODG00000031521","4",326625979,326629908,3929
"22278","ENSMODG00000031522","4",364091983,364155798,63815
"22279","ENSMODG00000031523","5",76796272,76924200,127928
"22280","ENSMODG00000031527","6",127727229,127729833,2604
"22281","ENSMODG00000031528","2",138164250,138169474,5224
"22282","ENSMODG00000031529","2",121275542,121280253,4711
"22283","ENSMODG00000031532","8",288232802,288238299,5497
"22284","ENSMODG00000031533","5",227153001,227174633,21632
"22285","ENSMODG00000031535","X",43811879,43820366,8487
"22286","ENSMODG00000031536","1",189209991,189213044,3053
"22287","ENSMODG00000031537","4",202347545,202356080,8535
"22288","ENSMODG00000031538","1",140523235,140562280,39045
"22289","ENSMODG00000031539","6",3806319,3869306,62987
"22290","ENSMODG00000031541","3",38854615,38858175,3560
"22291","ENSMODG00000031543","4",77452536,77457270,4734
"22292","ENSMODG00000031544","2",151053920,151065882,11962
"22293","ENSMODG00000031545","7",177962759,177992387,29628
"22294","ENSMODG00000031546","5",224963793,224980308,16515
"22295","ENSMODG00000031548","2",172549439,172558817,9378
"22296","ENSMODG00000031549","7",159554955,159621426,66471
"22297","ENSMODG00000031550","2",28138777,28143977,5200
"22298","ENSMODG00000031552","6",248952197,248962418,10221
"22299","ENSMODG00000031555","8",294550357,294557979,7622
"22300","ENSMODG00000031556","1",97080223,97113884,33661
"22301","ENSMODG00000031557","4",241923476,241940512,17036
"22302","ENSMODG00000031558","8",78890435,79103510,213075
"22303","ENSMODG00000031559","1",440382393,440383729,1336
"22304","ENSMODG00000031560","4",428965446,428973234,7788
"22305","ENSMODG00000031561","2",386315009,386363653,48644
"22306","ENSMODG00000031562","8",305299133,305300666,1533
"22307","ENSMODG00000031563","1",464666818,464671515,4697
"22308","ENSMODG00000031564","2",57243422,57259206,15784
"22309","ENSMODG00000031565","7",227704700,227719096,14396
"22310","ENSMODG00000031566","8",45321096,45340101,19005
"22311","ENSMODG00000031568","2",405840507,405843388,2881
"22312","ENSMODG00000031569","Un",51679152,51682433,3281
"22313","ENSMODG00000031570","5",201409873,201419309,9436
"22314","ENSMODG00000031571","8",312125431,312138519,13088
"22315","ENSMODG00000031572","3",351895545,351902051,6506
"22316","ENSMODG00000031573","X",57720517,57721846,1329
"22317","ENSMODG00000031575","Un",61317515,61318832,1317
"22318","ENSMODG00000031576","1",111084843,111095902,11059
"22319","ENSMODG00000031580","6",187376682,187414492,37810
"22320","ENSMODG00000031582","3",376474600,376484219,9619
"22321","ENSMODG00000031583","3",14746210,14812150,65940
"22322","ENSMODG00000031584","1",364915676,364919683,4007
"22323","ENSMODG00000031586","3",123492238,123646673,154435
"22324","ENSMODG00000031587","7",93481610,93524931,43321
"22325","ENSMODG00000031588","1",432036436,432048606,12170
"22326","ENSMODG00000031589","7",82057018,82069094,12076
"22327","ENSMODG00000031590","1",530898631,530931786,33155
"22328","ENSMODG00000031591","6",290937941,290940968,3027
"22329","ENSMODG00000031592","8",302811421,302816954,5533
"22330","ENSMODG00000031593","Un",61139453,61145413,5960
"22331","ENSMODG00000031594","8",122767767,122787935,20168
"22332","ENSMODG00000031595","3",323270680,323276118,5438
"22333","ENSMODG00000031596","3",92803470,92805011,1541
"22334","ENSMODG00000031597","1",516559550,516564383,4833
"22335","ENSMODG00000031598","4",355282796,355353547,70751
"22336","ENSMODG00000031599","2",285617451,285624601,7150
"22337","ENSMODG00000031600","Un",71012936,71016976,4040
"22338","ENSMODG00000031601","2",327204584,327251515,46931
"22339","ENSMODG00000031602","8",296719120,296727993,8873
"22340","ENSMODG00000031605","1",485245778,485298816,53038
"22341","ENSMODG00000031607","5",183942262,183945808,3546
"22342","ENSMODG00000031608","1",4735266,4738529,3263
"22343","ENSMODG00000031611","3",326143581,326228678,85097
"22344","ENSMODG00000031612","4",419680107,419687860,7753
"22345","ENSMODG00000031613","3",449141831,449165531,23700
"22346","ENSMODG00000031614","6",162673604,162682949,9345
"22347","ENSMODG00000031616","2",25781497,25792276,10779
"22348","ENSMODG00000031617","1",421195199,421196195,996
"22349","ENSMODG00000031618","2",116187490,116201835,14345
"22350","ENSMODG00000031619","2",434517915,434563278,45363
"22351","ENSMODG00000031621","1",480181801,480251211,69410
"22352","ENSMODG00000031624","5",172002468,172029500,27032
"22353","ENSMODG00000031625","4",118896349,118967742,71393
"22354","ENSMODG00000031626","3",267041469,267109758,68289
"22355","ENSMODG00000031627","Un",55083368,55085419,2051
"22356","ENSMODG00000031628","3",197498687,197514758,16071
"22357","ENSMODG00000031630","6",258577228,258582685,5457
"22358","ENSMODG00000031631","8",221155513,221176908,21395
"22359","ENSMODG00000031633","3",10718709,10724129,5420
"22360","ENSMODG00000031634","6",216176532,216244424,67892
"22361","ENSMODG00000031635","3",68364849,68372406,7557
"22362","ENSMODG00000031636","6",96233305,96280321,47016
"22363","ENSMODG00000031637","1",533627949,533640811,12862
"22364","ENSMODG00000031638","4",429444891,429449481,4590
"22365","ENSMODG00000031639","3",424057688,424162354,104666
"22366","ENSMODG00000031641","4",185502108,185512669,10561
"22367","ENSMODG00000031642","8",149491568,149523824,32256
"22368","ENSMODG00000031643","5",299809307,299811559,2252
"22369","ENSMODG00000031645","7",93957490,93968697,11207
"22370","ENSMODG00000031646","3",186410838,186413571,2733
"22371","ENSMODG00000031647","4",293892903,293894609,1706
"22372","ENSMODG00000031648","2",503684455,503685223,768
"22373","ENSMODG00000031652","2",479270368,479280478,10110
"22374","ENSMODG00000031654","4",74553702,74555237,1535
"22375","ENSMODG00000031655","4",363969594,363972390,2796
"22376","ENSMODG00000031657","1",518805769,518817061,11292
"22377","ENSMODG00000031658","1",468114313,468119710,5397
"22378","ENSMODG00000031659","3",317056823,317070082,13259
"22379","ENSMODG00000031661","4",14763293,14765936,2643
"22380","ENSMODG00000031662","6",229364035,229365144,1109
"22381","ENSMODG00000031663","2",406163422,406167851,4429
"22382","ENSMODG00000031664","8",116489598,116493459,3861
"22383","ENSMODG00000031666","1",85156412,85160945,4533
"22384","ENSMODG00000031667","2",461000711,461061169,60458
"22385","ENSMODG00000031668","2",334211824,334243160,31336
"22386","ENSMODG00000031669","X",77485267,77488946,3679
"22387","ENSMODG00000031670","4",413874235,413876264,2029
"22388","ENSMODG00000031671","1",18486472,18495829,9357
"22389","ENSMODG00000031672","4",137175522,137183437,7915
"22390","ENSMODG00000031673","6",9305837,9462978,157141
"22391","ENSMODG00000031674","7",79110468,79137092,26624
"22392","ENSMODG00000031676","1",163028376,163037119,8743
"22393","ENSMODG00000031677","4",136424835,136452143,27308
"22394","ENSMODG00000031678","8",4740527,4758445,17918
"22395","ENSMODG00000031679","7",33244916,33378851,133935
"22396","ENSMODG00000031681","4",34164145,34168610,4465
"22397","ENSMODG00000031683","2",264547588,264549263,1675
"22398","ENSMODG00000031684","6",198360659,198399695,39036
"22399","ENSMODG00000031687","5",228829509,228829951,442
"22400","ENSMODG00000031688","1",434417789,434471731,53942
"22401","ENSMODG00000031689","Un",47861535,47866451,4916
"22402","ENSMODG00000031690","8",10167161,10168837,1676
"22403","ENSMODG00000031691","Un",12751572,12752689,1117
"22404","ENSMODG00000031692","7",204798599,204820585,21986
"22405","ENSMODG00000031695","Un",34668804,34679801,10997
"22406","ENSMODG00000031696","7",27736045,27756663,20618
"22407","ENSMODG00000031697","7",423490,428849,5359
"22408","ENSMODG00000031698","4",21219263,21225742,6479
"22409","ENSMODG00000031699","7",247954764,247993976,39212
"22410","ENSMODG00000031700","2",520257650,520260382,2732
"22411","ENSMODG00000031701","6",136915083,137009901,94818
"22412","ENSMODG00000031702","3",319085657,319087143,1486
"22413","ENSMODG00000031703","7",205618500,205622596,4096
"22414","ENSMODG00000031705","1",244392652,244403450,10798
"22415","ENSMODG00000031706","5",282440060,282444553,4493
"22416","ENSMODG00000031707","8",55654168,55958870,304702
"22417","ENSMODG00000031708","7",158861215,158867201,5986
"22418","ENSMODG00000031709","1",420978134,420987697,9563
"22419","ENSMODG00000031710","1",462152222,462159833,7611
"22420","ENSMODG00000031711","7",142565361,142591092,25731
"22421","ENSMODG00000031712","6",224481964,224525565,43601
"22422","ENSMODG00000031713","1",399161413,399162700,1287
"22423","ENSMODG00000031715","4",261592471,261615620,23149
"22424","ENSMODG00000031716","4",226142660,226285739,143079
"22425","ENSMODG00000031719","1",310358923,310364086,5163
"22426","ENSMODG00000031720","7",88166888,88170602,3714
"22427","ENSMODG00000031721","7",252485422,252486500,1078
"22428","ENSMODG00000031722","3",317953481,317972405,18924
"22429","ENSMODG00000031723","8",63551163,63623553,72390
"22430","ENSMODG00000031724","8",161986031,161992341,6310
"22431","ENSMODG00000031725","X",28973621,29054052,80431
"22432","ENSMODG00000031726","1",41374859,41383011,8152
"22433","ENSMODG00000031727","1",439582757,439583801,1044
"22434","ENSMODG00000031728","3",326682890,326693446,10556
"22435","ENSMODG00000031729","4",24781106,24839160,58054
"22436","ENSMODG00000031730","2",506205696,506222237,16541
"22437","ENSMODG00000031733","8",205004418,205012982,8564
"22438","ENSMODG00000031734","1",81210753,81212555,1802
"22439","ENSMODG00000031735","1",453904997,453923547,18550
"22440","ENSMODG00000031740","3",26208643,26216106,7463
"22441","ENSMODG00000031741","5",284757693,284761437,3744
"22442","ENSMODG00000031742","1",223596441,223638467,42026
"22443","ENSMODG00000031743","1",533048562,533050350,1788
"22444","ENSMODG00000031745","8",135078818,135084064,5246
"22445","ENSMODG00000031747","5",303870443,303875086,4643
"22446","ENSMODG00000031748","6",115116332,115196998,80666
"22447","ENSMODG00000031749","1",491644922,491659495,14573
"22448","ENSMODG00000031750","2",39420455,39423311,2856
"22449","ENSMODG00000031751","5",156212368,156325635,113267
"22450","ENSMODG00000031752","1",485333465,485365392,31927
"22451","ENSMODG00000031753","5",300297502,300302414,4912
"22452","ENSMODG00000031754","5",78987414,78988586,1172
"22453","ENSMODG00000031755","2",275632178,275643983,11805
"22454","ENSMODG00000031756","3",95548724,95549619,895
"22455","ENSMODG00000031757","3",306706055,306715878,9823
"22456","ENSMODG00000031758","2",162518695,162520291,1596
"22457","ENSMODG00000031760","3",397531455,397551188,19733
"22458","ENSMODG00000031761","1",531552179,531554168,1989
"22459","ENSMODG00000031762","Un",37444276,37451796,7520
"22460","ENSMODG00000031763","2",339241747,339263631,21884
"22461","ENSMODG00000031764","3",461814888,461816709,1821
"22462","ENSMODG00000031765","4",35130343,35144043,13700
"22463","ENSMODG00000031766","1",82350220,82382486,32266
"22464","ENSMODG00000031768","6",212538270,212541484,3214
"22465","ENSMODG00000031769","3",145010511,145021190,10679
"22466","ENSMODG00000031770","6",59338559,59346938,8379
"22467","ENSMODG00000031771","6",82306297,82307736,1439
"22468","ENSMODG00000031772","8",40563814,40576875,13061
"22469","ENSMODG00000031773","3",486775943,486778296,2353
"22470","ENSMODG00000031774","2",402980647,403028282,47635
"22471","ENSMODG00000031775","1",314191576,314208792,17216
"22472","ENSMODG00000031776","Un",24065790,24075274,9484
"22473","ENSMODG00000031777","3",366445755,366446950,1195
"22474","ENSMODG00000031779","X",22809984,22815432,5448
"22475","ENSMODG00000031780","7",130797057,130797916,859
"22476","ENSMODG00000031781","7",183992514,184125873,133359
"22477","ENSMODG00000031783","2",40732939,40880317,147378
"22478","ENSMODG00000031784","4",22985988,23007526,21538
"22479","ENSMODG00000031785","2",398065953,398086107,20154
"22480","ENSMODG00000031786","8",309206482,309217998,11516
"22481","ENSMODG00000031787","8",11113431,11116690,3259
"22482","ENSMODG00000031788","1",117461130,117463758,2628
"22483","ENSMODG00000031789","3",442236934,442244995,8061
"22484","ENSMODG00000031790","4",148989276,148990513,1237
"22485","ENSMODG00000031791","1",4493620,4495666,2046
"22486","ENSMODG00000031792","3",264144761,264170840,26079
"22487","ENSMODG00000031793","2",251486394,251493646,7252
"22488","ENSMODG00000031794","4",100571849,100573639,1790
"22489","ENSMODG00000031795","8",94067695,94072401,4706
"22490","ENSMODG00000031796","4",189873479,189884507,11028
"22491","ENSMODG00000031798","1",462112151,462114942,2791
"22492","ENSMODG00000031799","6",176183304,176184319,1015
"22493","ENSMODG00000031801","1",456105363,456109268,3905
"22494","ENSMODG00000031802","1",236285866,236310961,25095
"22495","ENSMODG00000031803","5",45222323,45241480,19157
"22496","ENSMODG00000031804","3",241353741,241374736,20995
"22497","ENSMODG00000031805","5",88799799,88803003,3204
"22498","ENSMODG00000031806","1",403211828,403214173,2345
"22499","ENSMODG00000031807","3",173753011,173835120,82109
"22500","ENSMODG00000031809","X",69342946,69345102,2156
"22501","ENSMODG00000031811","2",231115026,231116280,1254
"22502","ENSMODG00000031812","7",186471974,186479325,7351
"22503","ENSMODG00000031813","X",33871970,33902719,30749
"22504","ENSMODG00000031814","1",274481642,274483573,1931
"22505","ENSMODG00000031817","7",189392835,189411610,18775
"22506","ENSMODG00000031818","2",501541472,501658899,117427
"22507","ENSMODG00000031819","1",230767986,231060848,292862
"22508","ENSMODG00000031820","Un",55882284,55884798,2514
"22509","ENSMODG00000031821","7",240780612,240784910,4298
"22510","ENSMODG00000031822","5",262152347,262180015,27668
"22511","ENSMODG00000031823","5",169633167,169644274,11107
"22512","ENSMODG00000031826","3",437496628,437505041,8413
"22513","ENSMODG00000031828","5",17832110,17837987,5877
"22514","ENSMODG00000031829","1",318538291,318547282,8991
"22515","ENSMODG00000031830","7",250067151,250069988,2837
"22516","ENSMODG00000031831","4",189973705,189977988,4283
"22517","ENSMODG00000031832","1",531520843,531592154,71311
"22518","ENSMODG00000031834","3",151746816,151767540,20724
"22519","ENSMODG00000031835","4",206786760,206787444,684
"22520","ENSMODG00000031838","1",412607864,412637866,30002
"22521","ENSMODG00000031839","8",188788561,188799315,10754
"22522","ENSMODG00000031840","2",159543137,159546467,3330
"22523","ENSMODG00000031841","1",5098804,5100515,1711
"22524","ENSMODG00000031842","2",376483774,376487260,3486
"22525","ENSMODG00000031844","7",105767017,105773153,6136
"22526","ENSMODG00000031845","8",276775817,276790165,14348
"22527","ENSMODG00000031846","5",22021622,22036998,15376
"22528","ENSMODG00000031847","1",123569462,123570397,935
"22529","ENSMODG00000031849","2",207377709,207380432,2723
"22530","ENSMODG00000031850","2",529565138,529570473,5335
"22531","ENSMODG00000031851","8",44759125,44777539,18414
"22532","ENSMODG00000031852","2",512392949,512515144,122195
"22533","ENSMODG00000031854","2",518273241,518276618,3377
"22534","ENSMODG00000031855","3",71679000,71714073,35073
"22535","ENSMODG00000031857","8",15419162,15421450,2288
"22536","ENSMODG00000031858","6",94546104,94559980,13876
"22537","ENSMODG00000031859","6",69383344,69386167,2823
"22538","ENSMODG00000031861","Un",77683657,77691123,7466
"22539","ENSMODG00000031862","1",7098534,7099357,823
"22540","ENSMODG00000031863","8",171983227,171985929,2702
"22541","ENSMODG00000031864","2",408697378,408719797,22419
"22542","ENSMODG00000031865","8",96834855,96835601,746
"22543","ENSMODG00000031867","5",1989549,1999320,9771
"22544","ENSMODG00000031870","2",195343895,195346787,2892
"22545","ENSMODG00000031872","1",178086087,178107127,21040
"22546","ENSMODG00000031873","7",205866963,205932440,65477
"22547","ENSMODG00000031874","4",429578420,429581337,2917
"22548","ENSMODG00000031875","3",214003803,214018698,14895
"22549","ENSMODG00000031876","Un",86928183,86929012,829
"22550","ENSMODG00000031877","7",251184748,251187959,3211
"22551","ENSMODG00000031878","7",197782955,197787568,4613
"22552","ENSMODG00000031880","1",129674279,129683480,9201
"22553","ENSMODG00000031881","2",504275977,504313015,37038
"22554","ENSMODG00000031882","4",247280397,247355283,74886
"22555","ENSMODG00000031883","3",234453988,234565860,111872
"22556","ENSMODG00000031884","4",310589686,310652162,62476
"22557","ENSMODG00000031885","1",79533148,79599784,66636
"22558","ENSMODG00000031886","X",72097493,72101049,3556
"22559","ENSMODG00000031887","4",318531648,318538930,7282
"22560","ENSMODG00000031888","1",307246953,307281976,35023
"22561","ENSMODG00000031889","3",106028910,106031220,2310
"22562","ENSMODG00000031890","5",80693596,80697322,3726
"22563","ENSMODG00000031891","6",19813938,19834899,20961
"22564","ENSMODG00000031892","7",11830108,11833252,3144
"22565","ENSMODG00000031893","7",111175108,111176261,1153
"22566","ENSMODG00000031894","X",57601088,57602820,1732
"22567","ENSMODG00000031895","4",300953597,300954297,700
"22568","ENSMODG00000031896","3",94426847,94430236,3389
"22569","ENSMODG00000031897","2",16493158,16501481,8323
"22570","ENSMODG00000031898","7",1400037,1415450,15413
"22571","ENSMODG00000031899","7",205425087,205428409,3322
"22572","ENSMODG00000031900","6",235747602,235913017,165415
"22573","ENSMODG00000031902","6",125267402,125271492,4090
"22574","ENSMODG00000031903","4",299510578,299528563,17985
"22575","ENSMODG00000031904","1",485332200,485350049,17849
"22576","ENSMODG00000031905","Un",93265573,93269330,3757
"22577","ENSMODG00000031906","7",258179668,258191170,11502
"22578","ENSMODG00000031908","2",404459516,404462856,3340
"22579","ENSMODG00000031909","4",3557136,3558561,1425
"22580","ENSMODG00000031910","1",248170424,248178926,8502
"22581","ENSMODG00000031911","3",46825980,46870866,44886
"22582","ENSMODG00000031912","7",101364248,101403276,39028
"22583","ENSMODG00000031913","5",160576606,160650537,73931
"22584","ENSMODG00000031914","2",498718552,498724150,5598
"22585","ENSMODG00000031915","X",59054735,59056085,1350
"22586","ENSMODG00000031916","4",412074825,412094182,19357
"22587","ENSMODG00000031917","3",175525954,175528458,2504
"22588","ENSMODG00000031918","3",450158529,450168261,9732
"22589","ENSMODG00000031919","4",301136595,301140722,4127
"22590","ENSMODG00000031920","7",168341178,168341801,623
"22591","ENSMODG00000031922","4",420472714,420474858,2144
"22592","ENSMODG00000031923","2",487965915,487980212,14297
"22593","ENSMODG00000031924","8",276182735,276221755,39020
"22594","ENSMODG00000031925","5",153743871,153746536,2665
"22595","ENSMODG00000031926","1",116868662,116883702,15040
"22596","ENSMODG00000031927","5",34597582,34602170,4588
"22597","ENSMODG00000031928","7",192498160,192647122,148962
"22598","ENSMODG00000031929","8",283492584,283604894,112310
"22599","ENSMODG00000031930","1",115497940,115723973,226033
"22600","ENSMODG00000031931","2",510379750,510393020,13270
"22601","ENSMODG00000031932","4",226740904,226778189,37285
"22602","ENSMODG00000031934","5",253203142,253227456,24314
"22603","ENSMODG00000031935","1",517823383,517852855,29472
"22604","ENSMODG00000031936","1",394832797,394836639,3842
"22605","ENSMODG00000031937","1",496572133,496593483,21350
"22606","ENSMODG00000031938","6",6652447,6657385,4938
"22607","ENSMODG00000031939","8",11281015,11358759,77744
"22608","ENSMODG00000031940","8",67672285,67716550,44265
"22609","ENSMODG00000031941","3",96215842,96227105,11263
"22610","ENSMODG00000031942","Un",38997673,39162918,165245
"22611","ENSMODG00000031943","5",229205300,229217256,11956
"22612","ENSMODG00000031944","4",137960205,137965406,5201
"22613","ENSMODG00000031945","1",378599227,378601497,2270
"22614","ENSMODG00000031946","4",26534486,26535082,596
"22615","ENSMODG00000031947","6",193945560,193972190,26630
"22616","ENSMODG00000031949","8",13627202,13628332,1130
"22617","ENSMODG00000031950","6",271820818,271821593,775
"22618","ENSMODG00000031951","X",78231709,78232778,1069
"22619","ENSMODG00000031952","4",66629046,66637645,8599
"22620","ENSMODG00000031953","1",518056747,518060872,4125
"22621","ENSMODG00000031954","6",186157853,186162495,4642
"22622","ENSMODG00000031955","2",529411059,529436890,25831
"22623","ENSMODG00000031956","6",101985877,101989185,3308
"22624","ENSMODG00000031957","8",229799800,229820660,20860
"22625","ENSMODG00000031959","8",228864286,228869266,4980
"22626","ENSMODG00000031960","7",254170654,254176651,5997
"22627","ENSMODG00000031961","6",225180413,225196126,15713
"22628","ENSMODG00000031962","5",79488847,79495987,7140
"22629","ENSMODG00000031963","1",495634735,495650062,15327
"22630","ENSMODG00000031964","2",194428823,194432430,3607
"22631","ENSMODG00000031965","2",240885980,240887541,1561
"22632","ENSMODG00000031966","6",110926029,110927374,1345
"22633","ENSMODG00000031968","1",264334811,264405002,70191
"22634","ENSMODG00000031970","8",218844744,218848063,3319
"22635","ENSMODG00000031971","1",514589530,514597473,7943
"22636","ENSMODG00000031972","8",85208805,85212482,3677
"22637","ENSMODG00000031973","3",151040299,151152447,112148
"22638","ENSMODG00000031974","1",472328884,472332575,3691
"22639","ENSMODG00000031976","3",184438587,184459002,20415
"22640","ENSMODG00000031978","2",175799213,175801505,2292
"22641","ENSMODG00000031980","4",93847988,93857102,9114
"22642","ENSMODG00000031981","2",477366811,477368006,1195
"22643","ENSMODG00000031982","1",366916302,366928480,12178
"22644","ENSMODG00000031983","1",202849703,202856651,6948
"22645","ENSMODG00000031984","4",431036661,431069504,32843
"22646","ENSMODG00000031985","1",367124954,367126994,2040
"22647","ENSMODG00000031986","3",318283438,318285880,2442
"22648","ENSMODG00000031987","8",113137804,113141358,3554
"22649","ENSMODG00000031988","7",90152537,90162757,10220
"22650","ENSMODG00000031989","3",190335891,190433649,97758
"22651","ENSMODG00000031990","1",57016222,57029219,12997
"22652","ENSMODG00000031991","1",464413364,464415326,1962
"22653","ENSMODG00000031992","7",237637731,237652169,14438
"22654","ENSMODG00000031993","8",12402642,12407263,4621
"22655","ENSMODG00000031994","6",132164339,132274849,110510
"22656","ENSMODG00000031996","1",450901531,450950456,48925
"22657","ENSMODG00000031997","2",360910133,360912514,2381
"22658","ENSMODG00000031998","6",159556699,159568691,11992
"22659","ENSMODG00000031999","4",182424326,182541655,117329
"22660","ENSMODG00000032000","2",10052869,10057103,4234
"22661","ENSMODG00000032001","6",184264,187738,3474
"22662","ENSMODG00000032002","5",261911424,261912484,1060
"22663","ENSMODG00000032003","6",126314147,126315946,1799
"22664","ENSMODG00000032004","8",69758530,69811377,52847
"22665","ENSMODG00000032007","8",158349328,158375134,25806
"22666","ENSMODG00000032008","1",112595246,112597353,2107
"22667","ENSMODG00000032009","1",486088433,486158121,69688
"22668","ENSMODG00000032010","4",3284430,3303715,19285
"22669","ENSMODG00000032013","3",396333822,396338057,4235
"22670","ENSMODG00000032014","Un",10223776,10227743,3967
"22671","ENSMODG00000032016","4",366063862,366067332,3470
"22672","ENSMODG00000032017","Un",48853858,48864459,10601
"22673","ENSMODG00000032018","2",525917534,525923459,5925
"22674","ENSMODG00000032020","Un",55961593,55963011,1418
"22675","ENSMODG00000032021","1",427046442,427049896,3454
"22676","ENSMODG00000032022","8",288237378,288262378,25000
"22677","ENSMODG00000032023","7",200660986,200705253,44267
"22678","ENSMODG00000032024","2",389114707,389119022,4315
"22679","ENSMODG00000032026","5",12531412,12553966,22554
"22680","ENSMODG00000032027","5",143888064,143907141,19077
"22681","ENSMODG00000032028","2",99144390,99159859,15469
"22682","ENSMODG00000032029","2",370949226,370958006,8780
"22683","ENSMODG00000032030","8",232618427,232624344,5917
"22684","ENSMODG00000032031","2",120729665,120767348,37683
"22685","ENSMODG00000032033","7",61442304,61448421,6117
"22686","ENSMODG00000032034","5",58274772,58282792,8020
"22687","ENSMODG00000032035","1",462014519,462015954,1435
"22688","ENSMODG00000032036","X",23465421,23466432,1011
"22689","ENSMODG00000032037","3",301202216,301261883,59667
"22690","ENSMODG00000032039","8",290546765,290548514,1749
"22691","ENSMODG00000032040","3",1457227,1462986,5759
"22692","ENSMODG00000032042","4",40456157,40470134,13977
"22693","ENSMODG00000032046","3",352744156,352785689,41533
"22694","ENSMODG00000032047","2",338279113,338332583,53470
"22695","ENSMODG00000032048","8",285026143,285088483,62340
"22696","ENSMODG00000032050","2",385431662,385470737,39075
"22697","ENSMODG00000032053","6",203632630,203633493,863
"22698","ENSMODG00000032056","4",166490064,166667144,177080
"22699","ENSMODG00000032057","3",93128645,93132925,4280
"22700","ENSMODG00000032059","7",49178210,49179897,1687
"22701","ENSMODG00000032060","2",360773888,360776816,2928
"22702","ENSMODG00000032062","Un",22548632,22550809,2177
"22703","ENSMODG00000032063","5",147566033,147581155,15122
"22704","ENSMODG00000032065","8",111065242,111087791,22549
"22705","ENSMODG00000032066","X",69377006,69380109,3103
"22706","ENSMODG00000032067","1",131969083,131981535,12452
"22707","ENSMODG00000032068","1",421933030,421936431,3401
"22708","ENSMODG00000032069","4",228991203,228993429,2226
"22709","ENSMODG00000032071","5",121177167,121216210,39043
"22710","ENSMODG00000032072","5",819241,872993,53752
"22711","ENSMODG00000032073","8",229938580,229969515,30935
"22712","ENSMODG00000032074","4",230047380,230089038,41658
"22713","ENSMODG00000032075","6",147675806,147684778,8972
"22714","ENSMODG00000032076","2",20323745,20328924,5179
"22715","ENSMODG00000032077","2",177368940,177538065,169125
"22716","ENSMODG00000032078","2",110414701,110502497,87796
"22717","ENSMODG00000032079","3",351850891,351859460,8569
"22718","ENSMODG00000032080","5",18972923,18974538,1615
"22719","ENSMODG00000032082","3",273771804,273812338,40534
"22720","ENSMODG00000032083","3",513202007,513209085,7078
"22721","ENSMODG00000032084","1",455484856,455488342,3486
"22722","ENSMODG00000032085","Un",84582294,84583486,1192
"22723","ENSMODG00000032088","7",140789855,140822131,32276
"22724","ENSMODG00000032089","1",186417643,186486350,68707
"22725","ENSMODG00000032091","2",345169143,345170790,1647
"22726","ENSMODG00000032092","3",116463350,116480415,17065
"22727","ENSMODG00000032093","4",316779596,316826826,47230
"22728","ENSMODG00000032095","2",176712607,176741581,28974
"22729","ENSMODG00000032096","1",136076012,136088039,12027
"22730","ENSMODG00000032097","1",40356662,40383081,26419
"22731","ENSMODG00000032098","2",202188913,202192565,3652
"22732","ENSMODG00000032099","7",23376158,23379167,3009
"22733","ENSMODG00000032101","5",173544301,173546161,1860
"22734","ENSMODG00000032102","4",399426446,399435391,8945
"22735","ENSMODG00000032103","7",3407619,3411555,3936
"22736","ENSMODG00000032104","1",95813998,95831979,17981
"22737","ENSMODG00000032106","1",479222322,479223974,1652
"22738","ENSMODG00000032107","1",419935193,419939754,4561
"22739","ENSMODG00000032108","8",309452059,309560632,108573
"22740","ENSMODG00000032109","5",159404271,159407796,3525
"22741","ENSMODG00000032111","7",199204957,199229479,24522
"22742","ENSMODG00000032112","1",328996546,328997231,685
"22743","ENSMODG00000032114","5",95200992,95535110,334118
"22744","ENSMODG00000032115","5",4361007,4582353,221346
"22745","ENSMODG00000032116","5",130696,155764,25068
"22746","ENSMODG00000032117","Un",71562752,71563999,1247
"22747","ENSMODG00000032118","4",188918216,188975536,57320
"22748","ENSMODG00000032119","4",201581805,201610051,28246
"22749","ENSMODG00000032120","7",13248559,13250065,1506
"22750","ENSMODG00000032122","2",34166856,34169398,2542
"22751","ENSMODG00000032123","4",364505628,364515057,9429
"22752","ENSMODG00000032124","1",437041330,437044869,3539
"22753","ENSMODG00000032125","7",175027210,175063096,35886
"22754","ENSMODG00000032128","1",400285674,400292650,6976
"22755","ENSMODG00000032129","4",50137776,50160259,22483
"22756","ENSMODG00000032130","2",468060846,468062044,1198
"22757","ENSMODG00000032131","8",265614826,265647785,32959
"22758","ENSMODG00000032132","5",299902340,299915050,12710
"22759","ENSMODG00000032133","2",386517389,386521003,3614
"22760","ENSMODG00000032135","4",184428811,184431242,2431
"22761","ENSMODG00000032139","2",531754053,531784128,30075
"22762","ENSMODG00000032140","Un",22606182,22831769,225587
"22763","ENSMODG00000032141","4",358394523,358466035,71512
"22764","ENSMODG00000032142","1",164852746,164853787,1041
"22765","ENSMODG00000032145","8",146520894,146632589,111695
"22766","ENSMODG00000032146","8",246825641,246828363,2722
"22767","ENSMODG00000032147","6",198728667,198731536,2869
"22768","ENSMODG00000032148","5",242864440,242904282,39842
"22769","ENSMODG00000032150","4",113541381,113588525,47144
"22770","ENSMODG00000032151","6",220873443,220986116,112673
"22771","ENSMODG00000032152","3",492112649,492113527,878
"22772","ENSMODG00000032153","8",182354242,182395752,41510
"22773","ENSMODG00000032154","1",1147707,1294889,147182
"22774","ENSMODG00000032155","2",533073782,533074994,1212
"22775","ENSMODG00000032156","2",143725892,143727015,1123
"22776","ENSMODG00000032158","1",245641583,245691112,49529
"22777","ENSMODG00000032160","2",201232157,201236647,4490
"22778","ENSMODG00000032161","7",84005100,84006524,1424
"22779","ENSMODG00000032163","4",434036565,434051774,15209
"22780","ENSMODG00000032167","2",100859151,100983648,124497
"22781","ENSMODG00000032168","1",394859346,394860780,1434
"22782","ENSMODG00000032169","6",189662278,189663779,1501
"22783","ENSMODG00000032173","2",33605404,33654965,49561
"22784","ENSMODG00000032175","2",204396734,204403459,6725
"22785","ENSMODG00000032177","8",251187945,251197857,9912
"22786","ENSMODG00000032180","3",405773219,405795066,21847
"22787","ENSMODG00000032181","2",525779075,525797085,18010
"22788","ENSMODG00000032182","6",259926286,259930241,3955
"22789","ENSMODG00000032183","6",29224240,29232619,8379
"22790","ENSMODG00000032184","3",439469519,439479228,9709
"22791","ENSMODG00000032185","1",384930318,384942603,12285
"22792","ENSMODG00000032186","2",156713575,156749388,35813
"22793","ENSMODG00000032188","2",293570022,293570880,858
"22794","ENSMODG00000032189","4",313848113,313949727,101614
"22795","ENSMODG00000032190","6",125150246,125165252,15006
"22796","ENSMODG00000032191","6",176503920,176525324,21404
"22797","ENSMODG00000032194","6",134602842,134604657,1815
"22798","ENSMODG00000032196","2",197436611,197440432,3821
"22799","ENSMODG00000032197","1",79187467,79197397,9930
"22800","ENSMODG00000032198","1",49067242,49072569,5327
"22801","ENSMODG00000032199","1",155241944,155249004,7060
"22802","ENSMODG00000032200","8",8836507,8859459,22952
"22803","ENSMODG00000032201","3",32010630,32016970,6340
"22804","ENSMODG00000032202","1",146656115,146669275,13160
"22805","ENSMODG00000032203","1",405928110,405978050,49940
"22806","ENSMODG00000032204","Un",3536387,3539118,2731
"22807","ENSMODG00000032206","3",70805766,70871507,65741
"22808","ENSMODG00000032207","5",275798747,275818095,19348
"22809","ENSMODG00000032208","1",453792656,453795997,3341
"22810","ENSMODG00000032209","4",25657287,25661801,4514
"22811","ENSMODG00000032210","2",479238946,479241996,3050
"22812","ENSMODG00000032211","1",210762437,210831669,69232
"22813","ENSMODG00000032212","X",40207871,40225170,17299
"22814","ENSMODG00000032214","3",328077422,328086181,8759
"22815","ENSMODG00000032215","2",257899590,257918800,19210
"22816","ENSMODG00000032216","4",299561149,299570900,9751
"22817","ENSMODG00000032220","1",103719330,103819869,100539
"22818","ENSMODG00000032221","X",23613054,23660277,47223
"22819","ENSMODG00000032222","8",56115599,56127457,11858
"22820","ENSMODG00000032224","8",14462108,14475667,13559
"22821","ENSMODG00000032225","4",383970529,383971711,1182
"22822","ENSMODG00000032226","2",447939724,448081071,141347
"22823","ENSMODG00000032227","5",5971915,5978601,6686
"22824","ENSMODG00000032230","3",394401461,394505845,104384
"22825","ENSMODG00000032232","3",394009631,394010747,1116
"22826","ENSMODG00000032233","8",22287819,22293724,5905
"22827","ENSMODG00000032235","4",188698842,188874345,175503
"22828","ENSMODG00000032236","1",245759145,245773146,14001
"22829","ENSMODG00000032237","1",229475842,229504593,28751
"22830","ENSMODG00000032238","2",146982934,146991784,8850
"22831","ENSMODG00000032239","1",42266179,42278914,12735
"22832","ENSMODG00000032240","8",93130928,93137242,6314
"22833","ENSMODG00000032241","6",70000690,70057128,56438
"22834","ENSMODG00000032242","4",272808306,272832809,24503
"22835","ENSMODG00000032243","5",1844052,1844817,765
"22836","ENSMODG00000032245","2",460538488,460691747,153259
"22837","ENSMODG00000032246","3",405227174,405324784,97610
"22838","ENSMODG00000032247","8",280656857,280738552,81695
"22839","ENSMODG00000032248","6",67798814,67803138,4324
"22840","ENSMODG00000032250","Un",14423054,14436863,13809
"22841","ENSMODG00000032252","Un",29255702,29258621,2919
"22842","ENSMODG00000032253","4",422428852,422431557,2705
"22843","ENSMODG00000032254","7",14116783,14124832,8049
"22844","ENSMODG00000032255","6",15809159,15811570,2411
"22845","ENSMODG00000032256","2",344647912,344650993,3081
"22846","ENSMODG00000032257","7",139673698,139798548,124850
"22847","ENSMODG00000032258","6",227247286,227267290,20004
"22848","ENSMODG00000032260","1",436656063,436662011,5948
"22849","ENSMODG00000032262","4",296268499,296269394,895
"22850","ENSMODG00000032263","3",511983844,511986067,2223
"22851","ENSMODG00000032264","3",308935658,308965056,29398
"22852","ENSMODG00000032265","4",386943836,386945645,1809
"22853","ENSMODG00000032267","5",280050483,280060162,9679
"22854","ENSMODG00000032268","7",79172976,79186698,13722
"22855","ENSMODG00000032271","4",358029566,358045805,16239
"22856","ENSMODG00000032272","8",15944851,15946646,1795
"22857","ENSMODG00000032273","2",36100594,36101327,733
"22858","ENSMODG00000032275","4",155609976,155624087,14111
"22859","ENSMODG00000032276","5",43771328,43771710,382
"22860","ENSMODG00000032278","1",450320064,450337034,16970
"22861","ENSMODG00000032279","3",199343909,199364784,20875
"22862","ENSMODG00000032281","3",186263385,186269199,5814
"22863","ENSMODG00000032282","1",297613277,297632732,19455
"22864","ENSMODG00000032283","Un",40078332,40104369,26037
"22865","ENSMODG00000032284","3",525967127,525968048,921
"22866","ENSMODG00000032285","4",22348943,22351367,2424
"22867","ENSMODG00000032287","3",229561613,229568769,7156
"22868","ENSMODG00000032289","4",236880654,236881485,831
"22869","ENSMODG00000032291","6",57591658,57600455,8797
"22870","ENSMODG00000032292","4",273681346,273683412,2066
"22871","ENSMODG00000032293","6",34079218,34081096,1878
"22872","ENSMODG00000032294","1",186498050,186660013,161963
"22873","ENSMODG00000032295","3",87731482,87766968,35486
"22874","ENSMODG00000032296","6",280829029,280830627,1598
"22875","ENSMODG00000032298","5",278523019,278546365,23346
"22876","ENSMODG00000032299","2",197253607,197273785,20178
"22877","ENSMODG00000032300","7",84084067,84093855,9788
"22878","ENSMODG00000032301","5",183600310,183607839,7529
"22879","ENSMODG00000032303","6",123866978,123868854,1876
"22880","ENSMODG00000032304","3",277939117,277946914,7797
"22881","ENSMODG00000032305","1",244281785,244284740,2955
"22882","ENSMODG00000032307","2",452237307,452295932,58625
"22883","ENSMODG00000032309","Un",90026329,90031101,4772
"22884","ENSMODG00000032310","8",113042968,113067617,24649
"22885","ENSMODG00000032311","3",209550622,209597163,46541
"22886","ENSMODG00000032312","1",1852922,1858032,5110
"22887","ENSMODG00000032313","5",220047336,220052504,5168
"22888","ENSMODG00000032314","Un",22555226,22576262,21036
"22889","ENSMODG00000032315","7",237639571,237685812,46241
"22890","ENSMODG00000032316","2",363529767,363603881,74114
"22891","ENSMODG00000032317","1",153483134,153551121,67987
"22892","ENSMODG00000032319","Un",74241922,74242478,556
"22893","ENSMODG00000032320","3",366451579,366528201,76622
"22894","ENSMODG00000032321","2",23933070,23938027,4957
"22895","ENSMODG00000032323","X",13718352,13723090,4738
"22896","ENSMODG00000032324","3",516026599,516030249,3650
"22897","ENSMODG00000032325","2",437428511,437504390,75879
"22898","ENSMODG00000032326","1",308415348,308429918,14570
"22899","ENSMODG00000032327","4",310958533,310988130,29597
"22900","ENSMODG00000032328","4",224015788,224018073,2285
"22901","ENSMODG00000032329","1",463984452,464101185,116733
"22902","ENSMODG00000032330","6",233282586,233284458,1872
"22903","ENSMODG00000032331","2",333609263,333632453,23190
"22904","ENSMODG00000032333","4",311943841,311945346,1505
"22905","ENSMODG00000032334","6",290053335,290097960,44625
"22906","ENSMODG00000032336","Un",3560123,3567784,7661
"22907","ENSMODG00000032337","2",432820104,432831737,11633
"22908","ENSMODG00000032339","6",80153408,80189477,36069
"22909","ENSMODG00000032340","1",464414311,464419109,4798
"22910","ENSMODG00000032341","1",78071851,78078368,6517
"22911","ENSMODG00000032342","2",71411563,71502231,90668
"22912","ENSMODG00000032343","1",333692578,333693559,981
"22913","ENSMODG00000032344","4",23890278,23911918,21640
"22914","ENSMODG00000032345","7",19379200,19382997,3797
"22915","ENSMODG00000032346","8",114579235,114695521,116286
"22916","ENSMODG00000032349","3",374338096,374342125,4029
"22917","ENSMODG00000032350","2",283907022,283916088,9066
"22918","ENSMODG00000032352","4",300816570,300824876,8306
"22919","ENSMODG00000032353","7",26877920,26887415,9495
"22920","ENSMODG00000032356","7",92562496,92569989,7493
"22921","ENSMODG00000032357","3",466188004,466198212,10208
"22922","ENSMODG00000032358","7",215477248,215481093,3845
"22923","ENSMODG00000032359","8",193110206,193133838,23632
"22924","ENSMODG00000032361","4",287778322,287822364,44042
"22925","ENSMODG00000032362","8",82339879,82401686,61807
"22926","ENSMODG00000032364","8",114738727,114744286,5559
"22927","ENSMODG00000032365","1",159191491,159198136,6645
"22928","ENSMODG00000032366","8",311455117,311548043,92926
"22929","ENSMODG00000032367","1",219771559,219776563,5004
"22930","ENSMODG00000032368","8",236605792,236611468,5676
"22931","ENSMODG00000032369","1",248393080,248395579,2499
"22932","ENSMODG00000032370","5",145449620,145450818,1198
"22933","ENSMODG00000032371","6",135296716,135327814,31098
"22934","ENSMODG00000032373","2",361778054,361801785,23731
"22935","ENSMODG00000032374","4",393546260,393578390,32130
"22936","ENSMODG00000032376","5",110149642,110174005,24363
"22937","ENSMODG00000032377","1",80340313,80347837,7524
"22938","ENSMODG00000032378","1",167485070,167489323,4253
"22939","ENSMODG00000032379","2",24846116,24872288,26172
"22940","ENSMODG00000032380","2",489721011,489722124,1113
"22941","ENSMODG00000032381","8",223394720,223414809,20089
"22942","ENSMODG00000032383","6",73838792,73840316,1524
"22943","ENSMODG00000032384","8",234633629,234640119,6490
"22944","ENSMODG00000032386","7",24337935,24338865,930
"22945","ENSMODG00000032387","1",353194095,353195624,1529
"22946","ENSMODG00000032388","3",202346271,202349872,3601
"22947","ENSMODG00000032389","8",5445000,5489425,44425
"22948","ENSMODG00000032390","4",195323651,195357891,34240
"22949","ENSMODG00000032392","6",135103130,135105682,2552
"22950","ENSMODG00000032394","6",127736984,127739409,2425
"22951","ENSMODG00000032395","1",491042981,491045083,2102
"22952","ENSMODG00000032398","2",321394452,321412931,18479
"22953","ENSMODG00000032399","2",457360567,457422906,62339
"22954","ENSMODG00000032400","2",392787486,392790028,2542
"22955","ENSMODG00000032401","3",415045458,415131407,85949
"22956","ENSMODG00000032403","5",95582416,95609160,26744
"22957","ENSMODG00000032404","4",333641235,333644605,3370
"22958","ENSMODG00000032405","3",410849161,410867914,18753
"22959","ENSMODG00000032406","3",366633385,366638984,5599
"22960","ENSMODG00000032407","2",156454883,156466862,11979
"22961","ENSMODG00000032408","5",219666603,219670943,4340
"22962","ENSMODG00000032409","1",455089018,455167494,78476
"22963","ENSMODG00000032410","1",110958984,110999937,40953
"22964","ENSMODG00000032411","4",433502651,433565795,63144
"22965","ENSMODG00000032412","1",453308332,453312253,3921
"22966","ENSMODG00000032413","8",95562611,95583151,20540
"22967","ENSMODG00000032414","3",305735647,305758428,22781
"22968","ENSMODG00000032416","2",346684317,346699402,15085
"22969","ENSMODG00000032418","7",140658227,140678975,20748
"22970","ENSMODG00000032419","3",345330759,345334413,3654
"22971","ENSMODG00000032420","1",204409257,204411192,1935
"22972","ENSMODG00000032421","4",429497542,429513122,15580
"22973","ENSMODG00000032422","7",213407196,213413991,6795
"22974","ENSMODG00000032423","X",68738671,68741415,2744
"22975","ENSMODG00000032424","3",20217228,20240592,23364
"22976","ENSMODG00000032425","2",477666991,477669214,2223
"22977","ENSMODG00000032426","8",46732465,46757582,25117
"22978","ENSMODG00000032427","2",163639682,163644726,5044
"22979","ENSMODG00000032428","4",209062500,209068913,6413
"22980","ENSMODG00000032429","2",297433236,297509158,75922
"22981","ENSMODG00000032430","1",206789896,206792007,2111
"22982","ENSMODG00000032431","5",793593,795300,1707
"22983","ENSMODG00000032432","2",15255248,15260093,4845
"22984","ENSMODG00000032434","6",263197111,263224346,27235
"22985","ENSMODG00000032436","6",114871146,114960827,89681
"22986","ENSMODG00000032437","X",25615279,25730937,115658
"22987","ENSMODG00000032438","3",126065770,126191753,125983
"22988","ENSMODG00000032440","1",522863635,522868979,5344
"22989","ENSMODG00000032441","2",447367706,447383383,15677
"22990","ENSMODG00000032442","1",349255356,349283809,28453
"22991","ENSMODG00000032443","8",309937916,309946591,8675
"22992","ENSMODG00000032444","8",186915560,186917015,1455
"22993","ENSMODG00000032446","7",26214060,26215052,992
"22994","ENSMODG00000032447","Un",97120460,97121932,1472
"22995","ENSMODG00000032448","1",444360578,444380455,19877
"22996","ENSMODG00000032450","2",239530795,239588170,57375
"22997","ENSMODG00000032451","8",203348078,203348856,778
"22998","ENSMODG00000032452","3",44918434,44919534,1100
"22999","ENSMODG00000032453","4",235274866,235281976,7110
"23000","ENSMODG00000032454","7",140144269,140175824,31555
"23001","ENSMODG00000032455","2",406263911,406270052,6141
"23002","ENSMODG00000032456","5",178942462,178943161,699
"23003","ENSMODG00000032457","1",384569644,384592881,23237
"23004","ENSMODG00000032459","4",109655635,109660161,4526
"23005","ENSMODG00000032461","4",160720481,160751035,30554
"23006","ENSMODG00000032462","6",148477886,148488910,11024
"23007","ENSMODG00000032464","Un",87090342,87159154,68812
"23008","ENSMODG00000032465","6",92644053,92713698,69645
"23009","ENSMODG00000032466","6",121189822,121206680,16858
"23010","ENSMODG00000032467","8",67072857,67180229,107372
"23011","ENSMODG00000032468","2",112247070,112255810,8740
"23012","ENSMODG00000032469","1",57713568,57714105,537
"23013","ENSMODG00000032471","3",374478514,374480972,2458
"23014","ENSMODG00000032472","1",205333708,205339735,6027
"23015","ENSMODG00000032473","X",6952796,6972981,20185
"23016","ENSMODG00000032474","1",529289447,529306198,16751
"23017","ENSMODG00000032475","3",523905524,523907679,2155
"23018","ENSMODG00000032476","Un",22760957,22927152,166195
"23019","ENSMODG00000032477","7",197816501,197833519,17018
"23020","ENSMODG00000032478","1",118159,144620,26461
"23021","ENSMODG00000032479","3",236678730,236682065,3335
"23022","ENSMODG00000032481","X",50724056,50725050,994
"23023","ENSMODG00000032482","4",29323697,29326459,2762
"23024","ENSMODG00000032483","4",416895323,416905120,9797
"23025","ENSMODG00000032485","6",248941376,248943098,1722
"23026","ENSMODG00000032486","2",520660498,520678012,17514
"23027","ENSMODG00000032487","Un",8692303,8695432,3129
"23028","ENSMODG00000032488","3",235081111,235138549,57438
"23029","ENSMODG00000032489","4",301058206,301074158,15952
"23030","ENSMODG00000032490","4",174661620,174664132,2512
"23031","ENSMODG00000032491","7",201098469,201120463,21994
"23032","ENSMODG00000032493","1",376312270,376426889,114619
"23033","ENSMODG00000032494","3",91567713,91580048,12335
"23034","ENSMODG00000032495","6",201833755,201841896,8141
"23035","ENSMODG00000032497","3",521271463,521281309,9846
"23036","ENSMODG00000032498","8",67727323,67754873,27550
"23037","ENSMODG00000032499","2",203380032,203388182,8150
"23038","ENSMODG00000032500","7",249359284,249361988,2704
"23039","ENSMODG00000032501","1",105852507,105868469,15962
"23040","ENSMODG00000032503","6",259318216,259341568,23352
"23041","ENSMODG00000032506","3",99904055,99989300,85245
"23042","ENSMODG00000032507","4",358591352,358592352,1000
"23043","ENSMODG00000032508","3",242270495,242334309,63814
"23044","ENSMODG00000032509","3",441592583,441598897,6314
"23045","ENSMODG00000032510","6",39693022,39710207,17185
"23046","ENSMODG00000032511","2",141011813,141120266,108453
"23047","ENSMODG00000032512","8",242533716,242543679,9963
"23048","ENSMODG00000032513","3",250732352,250737600,5248
"23049","ENSMODG00000032515","3",35019667,35021298,1631
"23050","ENSMODG00000032517","2",536487738,536489700,1962
"23051","ENSMODG00000032518","3",166960288,166968629,8341
"23052","ENSMODG00000032519","2",84084573,84090971,6398
"23053","ENSMODG00000032520","2",288815898,288821051,5153
"23054","ENSMODG00000032522","1",232626936,232630026,3090
"23055","ENSMODG00000032523","1",411188174,411189475,1301
"23056","ENSMODG00000032524","6",203973135,203978854,5719
"23057","ENSMODG00000032526","2",458550341,458554194,3853
"23058","ENSMODG00000032527","Un",40059170,40078248,19078
"23059","ENSMODG00000032528","8",234894656,234952776,58120
"23060","ENSMODG00000032529","1",341244625,341245122,497
"23061","ENSMODG00000032530","1",324153929,324154624,695
"23062","ENSMODG00000032531","2",161414434,161418941,4507
"23063","ENSMODG00000032532","8",62397239,62408789,11550
"23064","ENSMODG00000032533","4",302410447,302467091,56644
"23065","ENSMODG00000032534","1",240819704,240852863,33159
"23066","ENSMODG00000032535","1",495244364,495274209,29845
"23067","ENSMODG00000032536","3",392685408,392718379,32971
"23068","ENSMODG00000032537","4",431706,434456,2750
"23069","ENSMODG00000032538","1",335810921,335827801,16880
"23070","ENSMODG00000032540","3",396828219,396857570,29351
"23071","ENSMODG00000032541","6",6222881,6230121,7240
"23072","ENSMODG00000032542","1",214918252,214920479,2227
"23073","ENSMODG00000032543","5",136284002,136452501,168499
"23074","ENSMODG00000032544","7",180803184,180808122,4938
"23075","ENSMODG00000032546","6",35733967,35783371,49404
"23076","ENSMODG00000032547","2",339872674,339890023,17349
"23077","ENSMODG00000032548","Un",93895416,94020169,124753
"23078","ENSMODG00000032549","4",388115523,388145651,30128
"23079","ENSMODG00000032550","3",318185063,318217106,32043
"23080","ENSMODG00000032551","6",178715768,178724067,8299
"23081","ENSMODG00000032552","8",81343482,81346428,2946
"23082","ENSMODG00000032553","3",5758667,5762247,3580
"23083","ENSMODG00000032554","5",283651456,283653895,2439
"23084","ENSMODG00000032555","4",406735682,406741407,5725
"23085","ENSMODG00000032556","4",362453024,362473786,20762
"23086","ENSMODG00000032557","6",11067951,11099579,31628
"23087","ENSMODG00000032558","Un",27769856,27772515,2659
"23088","ENSMODG00000032559","X",42706730,42723122,16392
"23089","ENSMODG00000032560","2",255346151,255347244,1093
"23090","ENSMODG00000032561","6",217725481,217725912,431
"23091","ENSMODG00000032563","4",317933856,317940747,6891
"23092","ENSMODG00000032564","6",206251976,206255477,3501
"23093","ENSMODG00000032565","6",90196350,90198102,1752
"23094","ENSMODG00000032566","5",174132763,174154299,21536
"23095","ENSMODG00000032567","8",25550637,25588648,38011
"23096","ENSMODG00000032568","6",212865813,212874041,8228
"23097","ENSMODG00000032569","1",404970064,404991037,20973
"23098","ENSMODG00000032571","8",221337997,221339399,1402
"23099","ENSMODG00000032573","6",83759395,83763147,3752
"23100","ENSMODG00000032574","3",475722119,475723669,1550
"23101","ENSMODG00000032576","3",61667395,61787953,120558
"23102","ENSMODG00000032577","6",275057443,275069524,12081
"23103","ENSMODG00000032578","1",294490243,294496797,6554
"23104","ENSMODG00000032579","3",66107834,66120700,12866
"23105","ENSMODG00000032580","Un",37660061,37668877,8816
"23106","ENSMODG00000032581","2",283916482,283920226,3744
"23107","ENSMODG00000032582","Un",33425917,33439901,13984
"23108","ENSMODG00000032583","6",216618642,216658561,39919
"23109","ENSMODG00000032584","5",246655832,246658718,2886
"23110","ENSMODG00000032585","1",197498754,197499309,555
"23111","ENSMODG00000032586","Un",96089300,96092361,3061
"23112","ENSMODG00000032587","4",257631990,257647875,15885
"23113","ENSMODG00000032588","2",41041531,41122807,81276
"23114","ENSMODG00000032590","X",31156222,31175159,18937
"23115","ENSMODG00000032591","Un",23456529,23459413,2884
"23116","ENSMODG00000032592","5",302376906,302384247,7341
"23117","ENSMODG00000032593","4",229151571,229167829,16258
"23118","ENSMODG00000032594","3",277899165,277903165,4000
"23119","ENSMODG00000032596","3",153394447,153396623,2176
"23120","ENSMODG00000032597","7",208832053,208840772,8719
"23121","ENSMODG00000032598","6",282566122,282600900,34778
"23122","ENSMODG00000032599","7",204822277,204824213,1936
"23123","ENSMODG00000032600","4",10071061,10071990,929
"23124","ENSMODG00000032601","3",16095416,16097071,1655
"23125","ENSMODG00000032602","3",236751468,236803760,52292
"23126","ENSMODG00000032603","7",141373222,141450092,76870
"23127","ENSMODG00000032604","4",21390678,21416585,25907
"23128","ENSMODG00000032605","4",433064118,433074115,9997
"23129","ENSMODG00000032606","4",231167508,231235024,67516
"23130","ENSMODG00000032607","3",6690439,6702388,11949
"23131","ENSMODG00000032608","5",8897743,8907346,9603
"23132","ENSMODG00000032609","1",510124259,510130055,5796
"23133","ENSMODG00000032610","8",243728961,243730932,1971
"23134","ENSMODG00000032611","1",214732591,214761771,29180
"23135","ENSMODG00000032613","7",48426032,48532342,106310
"23136","ENSMODG00000032614","2",269939054,269942472,3418
"23137","ENSMODG00000032615","8",147927939,147930863,2924
"23138","ENSMODG00000032616","4",162428983,162454053,25070
"23139","ENSMODG00000032618","4",323026018,323027516,1498
"23140","ENSMODG00000032619","5",101355596,101357733,2137
"23141","ENSMODG00000032620","X",79325038,79327501,2463
"23142","ENSMODG00000032622","2",132562658,132577975,15317
"23143","ENSMODG00000032623","8",305749093,305756134,7041
"23144","ENSMODG00000032624","3",210466600,210472872,6272
"23145","ENSMODG00000032625","5",85866596,85870159,3563
"23146","ENSMODG00000032626","6",122732583,122733215,632
"23147","ENSMODG00000032627","1",66576228,66577388,1160
"23148","ENSMODG00000032629","X",22479811,22526498,46687
"23149","ENSMODG00000032631","2",436036073,436037838,1765
"23150","ENSMODG00000032632","1",69352548,69373873,21325
"23151","ENSMODG00000032633","4",22166689,22167782,1093
"23152","ENSMODG00000032634","4",279163298,279255155,91857
"23153","ENSMODG00000032635","1",71676727,71680114,3387
"23154","ENSMODG00000032636","6",106437849,106493282,55433
"23155","ENSMODG00000032640","2",115430754,115431986,1232
"23156","ENSMODG00000032641","4",188406715,188408822,2107
"23157","ENSMODG00000032644","Un",11179745,11192390,12645
"23158","ENSMODG00000032645","3",405982020,406068450,86430
"23159","ENSMODG00000032646","6",290943476,290955161,11685
"23160","ENSMODG00000032647","7",236111948,236120911,8963
"23161","ENSMODG00000032648","3",492772808,492815494,42686
"23162","ENSMODG00000032649","5",251848010,251879245,31235
"23163","ENSMODG00000032650","1",444911758,444926182,14424
"23164","ENSMODG00000032652","5",189539429,189735276,195847
"23165","ENSMODG00000032653","Un",65687778,65690396,2618
"23166","ENSMODG00000032654","1",111031742,111034347,2605
"23167","ENSMODG00000032655","2",457506577,457509841,3264
"23168","ENSMODG00000032656","4",238240826,238269111,28285
"23169","ENSMODG00000032657","1",101541698,101599479,57781
"23170","ENSMODG00000032658","3",102060805,102084980,24175
"23171","ENSMODG00000032659","1",471126943,471201649,74706
"23172","ENSMODG00000032660","4",361274641,361281878,7237
"23173","ENSMODG00000032661","3",521687739,521690430,2691
"23174","ENSMODG00000032662","7",14777605,14829069,51464
"23175","ENSMODG00000032663","2",239291850,239295549,3699
"23176","ENSMODG00000032664","6",289891212,289893241,2029
"23177","ENSMODG00000032665","8",302229846,302238518,8672
"23178","ENSMODG00000032666","3",478505875,478507972,2097
"23179","ENSMODG00000032669","1",162826233,162854116,27883
"23180","ENSMODG00000032670","5",184382708,184420816,38108
"23181","ENSMODG00000032671","1",395222365,395234742,12377
"23182","ENSMODG00000032672","2",257827151,257831261,4110
"23183","ENSMODG00000032674","2",335366105,335403762,37657
"23184","ENSMODG00000032675","3",289123465,289124108,643
"23185","ENSMODG00000032676","4",80860532,80866007,5475
"23186","ENSMODG00000032677","4",24305133,24310738,5605
"23187","ENSMODG00000032678","X",14813813,14880794,66981
"23188","ENSMODG00000032679","8",65272975,65275996,3021
"23189","ENSMODG00000032680","5",184228426,184234868,6442
"23190","ENSMODG00000032681","4",123308585,123349673,41088
"23191","ENSMODG00000032682","3",160487333,160563450,76117
"23192","ENSMODG00000032684","4",323150991,323154397,3406
"23193","ENSMODG00000032685","7",86070517,86195739,125222
"23194","ENSMODG00000032686","2",40377569,40440344,62775
"23195","ENSMODG00000032687","X",46551410,46564722,13312
"23196","ENSMODG00000032688","2",48364056,48365660,1604
"23197","ENSMODG00000032689","3",40631814,40643586,11772
"23198","ENSMODG00000032690","1",51950674,51970657,19983
"23199","ENSMODG00000032693","7",7225046,7261425,36379
"23200","ENSMODG00000032694","3",49124291,49125389,1098
"23201","ENSMODG00000032697","Un",67126601,67132297,5696
"23202","ENSMODG00000032699","4",104772500,104786353,13853
"23203","ENSMODG00000032701","5",300191329,300209253,17924
"23204","ENSMODG00000032702","5",104832364,104928343,95979
"23205","ENSMODG00000032703","4",431822864,431828985,6121
"23206","ENSMODG00000032704","8",189393231,189408372,15141
"23207","ENSMODG00000032705","2",468233727,468237151,3424
"23208","ENSMODG00000032706","5",141303122,141307288,4166
"23209","ENSMODG00000032707","6",147916705,147920428,3723
"23210","ENSMODG00000032708","2",479019814,479022363,2549
"23211","ENSMODG00000032709","X",44273917,44275318,1401
"23212","ENSMODG00000032711","7",19300610,19327261,26651
"23213","ENSMODG00000032712","Un",100027317,100028300,983
"23214","ENSMODG00000032713","X",61595702,61842529,246827
"23215","ENSMODG00000032714","1",444736404,444746976,10572
"23216","ENSMODG00000032717","1",382017332,382022491,5159
"23217","ENSMODG00000032718","4",184724630,184728039,3409
"23218","ENSMODG00000032719","3",99862079,99867352,5273
"23219","ENSMODG00000032720","5",227455407,227477486,22079
"23220","ENSMODG00000032721","2",533862465,533864353,1888
"23221","ENSMODG00000032722","Un",32419668,32421868,2200
"23222","ENSMODG00000032723","8",276020023,276029310,9287
"23223","ENSMODG00000032724","2",112224520,112251157,26637
"23224","ENSMODG00000032725","1",142689898,142690901,1003
"23225","ENSMODG00000032726","6",4852527,4886486,33959
"23226","ENSMODG00000032728","7",199272309,199283800,11491
"23227","ENSMODG00000032729","1",79555584,79584407,28823
"23228","ENSMODG00000032730","1",386279393,386285295,5902
"23229","ENSMODG00000032731","5",1022941,1025836,2895
"23230","ENSMODG00000032732","1",512507071,512511160,4089
"23231","ENSMODG00000032733","4",338729823,338798412,68589
"23232","ENSMODG00000032734","4",36604721,36647388,42667
"23233","ENSMODG00000032736","5",219582884,219595681,12797
"23234","ENSMODG00000032737","1",21784365,21789684,5319
"23235","ENSMODG00000032739","1",508926473,508937113,10640
"23236","ENSMODG00000032740","4",266594288,266597067,2779
"23237","ENSMODG00000032742","4",192918252,192920845,2593
"23238","ENSMODG00000032745","2",311857298,311858273,975
"23239","ENSMODG00000032746","6",147169573,147173272,3699
"23240","ENSMODG00000032747","5",87328329,87329784,1455
"23241","ENSMODG00000032748","1",326149409,326217116,67707
"23242","ENSMODG00000032749","8",58624545,58810797,186252
"23243","ENSMODG00000032750","Un",34689912,34704850,14938
"23244","ENSMODG00000032751","4",148673678,148686405,12727
"23245","ENSMODG00000032752","4",427911689,427946884,35195
"23246","ENSMODG00000032753","3",97072935,97135512,62577
"23247","ENSMODG00000032754","7",192483993,192494934,10941
"23248","ENSMODG00000032755","1",86591536,86600054,8518
"23249","ENSMODG00000032756","2",485899434,485900591,1157
"23250","ENSMODG00000032757","6",121275160,121286156,10996
"23251","ENSMODG00000032758","5",41836425,41862113,25688
"23252","ENSMODG00000032761","1",147432639,147482665,50026
"23253","ENSMODG00000032762","5",188914273,188986421,72148
"23254","ENSMODG00000032763","8",89360256,89373444,13188
"23255","ENSMODG00000032764","2",339678106,339703295,25189
"23256","ENSMODG00000032765","5",300256616,300259051,2435
"23257","ENSMODG00000032766","2",40122221,40123689,1468
"23258","ENSMODG00000032767","7",11696159,11709130,12971
"23259","ENSMODG00000032768","7",214527370,214573386,46016
"23260","ENSMODG00000032770","1",303497648,303629615,131967
"23261","ENSMODG00000032771","3",179738594,179892241,153647
"23262","ENSMODG00000032772","8",140926009,140937867,11858
"23263","ENSMODG00000032773","1",435334900,435338428,3528
"23264","ENSMODG00000032774","8",3839953,3923259,83306
"23265","ENSMODG00000032776","3",450171496,450182940,11444
"23266","ENSMODG00000032780","Un",50893551,50894910,1359
"23267","ENSMODG00000032781","1",378445352,378457588,12236
"23268","ENSMODG00000032782","1",232425526,232531633,106107
"23269","ENSMODG00000032783","4",323135759,323137087,1328
"23270","ENSMODG00000032784","4",56026030,56102655,76625
"23271","ENSMODG00000032785","3",23357628,23377092,19464
"23272","ENSMODG00000032786","2",356019612,356022834,3222
"23273","ENSMODG00000032787","1",34161627,34163441,1814
"23274","ENSMODG00000032788","2",115847744,115951753,104009
"23275","ENSMODG00000032789","4",256430345,256492621,62276
"23276","ENSMODG00000032792","3",312026963,312040973,14010
"23277","ENSMODG00000032793","3",321158907,321171317,12410
"23278","ENSMODG00000032795","7",71052698,71056794,4096
"23279","ENSMODG00000032796","1",437702660,437881002,178342
"23280","ENSMODG00000032797","5",254957971,254998153,40182
"23281","ENSMODG00000032799","2",132235739,132281259,45520
"23282","ENSMODG00000032802","3",89919738,89927920,8182
"23283","ENSMODG00000032803","1",512635235,512637686,2451
"23284","ENSMODG00000032804","Un",72066508,72071381,4873
"23285","ENSMODG00000032805","4",224186260,224187235,975
"23286","ENSMODG00000032806","2",518255665,518264731,9066
"23287","ENSMODG00000032807","1",75353704,75359095,5391
"23288","ENSMODG00000032809","2",289810856,289815269,4413
"23289","ENSMODG00000032810","Un",31908992,31939098,30106
"23290","ENSMODG00000032811","7",93810169,93839631,29462
"23291","ENSMODG00000032812","5",117945638,118022315,76677
"23292","ENSMODG00000032813","4",232084441,232091437,6996
"23293","ENSMODG00000032815","4",431992236,431994936,2700
"23294","ENSMODG00000032816","8",126703141,126704783,1642
"23295","ENSMODG00000032817","7",163570479,163597093,26614
"23296","ENSMODG00000032818","4",337834826,337864381,29555
"23297","ENSMODG00000032820","3",193899608,193900157,549
"23298","ENSMODG00000032821","X",59427490,59439034,11544
"23299","ENSMODG00000032824","4",359532421,359549066,16645
"23300","ENSMODG00000032825","8",132685542,132689124,3582
"23301","ENSMODG00000032828","1",112920886,112923604,2718
"23302","ENSMODG00000032829","4",358447836,358452105,4269
"23303","ENSMODG00000032831","6",59840475,59841617,1142
"23304","ENSMODG00000032832","5",253371561,253410512,38951
"23305","ENSMODG00000032833","5",46593233,46594393,1160
"23306","ENSMODG00000032835","7",27830845,27907084,76239
"23307","ENSMODG00000032836","6",72259588,72389836,130248
"23308","ENSMODG00000032837","1",424022655,424023462,807
"23309","ENSMODG00000032839","8",117902974,117906866,3892
"23310","ENSMODG00000032840","8",172278127,172280042,1915
"23311","ENSMODG00000032841","1",209817781,209840059,22278
"23312","ENSMODG00000032842","4",350108010,350109045,1035
"23313","ENSMODG00000032844","2",484568795,484572946,4151
"23314","ENSMODG00000032845","8",8614869,8620940,6071
"23315","ENSMODG00000032846","2",143460200,143465032,4832
"23316","ENSMODG00000032847","7",208915527,208930049,14522
"23317","ENSMODG00000032848","6",113321377,113398414,77037
"23318","ENSMODG00000032849","6",100186831,100210862,24031
"23319","ENSMODG00000032850","8",69833399,69835346,1947
"23320","ENSMODG00000032851","1",426573664,426585444,11780
"23321","ENSMODG00000032852","2",439694882,439704145,9263
"23322","ENSMODG00000032853","2",27625616,27628948,3332
"23323","ENSMODG00000032856","8",312374114,312375332,1218
"23324","ENSMODG00000032857","4",241945517,241946767,1250
"23325","ENSMODG00000032858","3",471947767,471960808,13041
"23326","ENSMODG00000032859","3",34319540,34320903,1363
"23327","ENSMODG00000032860","6",169507332,169599495,92163
"23328","ENSMODG00000032861","1",460450995,460453321,2326
"23329","ENSMODG00000032862","4",103359564,103361176,1612
"23330","ENSMODG00000032863","X",52169735,52171897,2162
"23331","ENSMODG00000032865","3",161888632,161890625,1993
"23332","ENSMODG00000032868","3",150196406,150198635,2229
"23333","ENSMODG00000032869","1",466264458,466266180,1722
"23334","ENSMODG00000032872","1",394131434,394139362,7928
"23335","ENSMODG00000032873","4",145767870,145907419,139549
"23336","ENSMODG00000032874","1",230123244,230191981,68737
"23337","ENSMODG00000032875","8",148029877,148087995,58118
"23338","ENSMODG00000032876","7",85433981,85438774,4793
"23339","ENSMODG00000032877","2",143689669,143743135,53466
"23340","ENSMODG00000032878","4",120459227,120467069,7842
"23341","ENSMODG00000032879","3",276636320,276651872,15552
"23342","ENSMODG00000032880","3",527647315,527650521,3206
"23343","ENSMODG00000032881","3",152496215,152574847,78632
"23344","ENSMODG00000032882","5",284518833,284522275,3442
"23345","ENSMODG00000032883","4",223691995,223704966,12971
"23346","ENSMODG00000032884","4",43774534,43780499,5965
"23347","ENSMODG00000032885","7",208483644,208528489,44845
"23348","ENSMODG00000032886","2",4802833,4823182,20349
"23349","ENSMODG00000032887","3",317888297,317920352,32055
"23350","ENSMODG00000032888","7",143829818,143835150,5332
"23351","ENSMODG00000032889","3",272237839,272251855,14016
"23352","ENSMODG00000032890","1",532045056,532052619,7563
"23353","ENSMODG00000032891","6",7766453,7883148,116695
"23354","ENSMODG00000032892","1",300456329,300463596,7267
"23355","ENSMODG00000032893","2",140166444,140185144,18700
"23356","ENSMODG00000032894","2",61301270,61319914,18644
"23357","ENSMODG00000032895","7",103238673,103242835,4162
"23358","ENSMODG00000032896","X",25983465,26064296,80831
"23359","ENSMODG00000032897","7",239839499,239844017,4518
"23360","ENSMODG00000032898","4",372985003,373067216,82213
"23361","ENSMODG00000032899","5",65363279,65401703,38424
"23362","ENSMODG00000032900","4",199803822,199807592,3770
"23363","ENSMODG00000032902","3",222260791,222263358,2567
"23364","ENSMODG00000032903","3",99803125,99807858,4733
"23365","ENSMODG00000032904","5",172111595,172113331,1736
"23366","ENSMODG00000032905","3",477634927,477640885,5958
"23367","ENSMODG00000032906","1",157061190,157065602,4412
"23368","ENSMODG00000032907","4",305588731,305596499,7768
"23369","ENSMODG00000032909","6",194970130,194974427,4297
"23370","ENSMODG00000032910","2",504152476,504158532,6056
"23371","ENSMODG00000032911","Un",50487252,50489266,2014
"23372","ENSMODG00000032912","Un",22162796,22321033,158237
"23373","ENSMODG00000032913","2",452282107,452318624,36517
"23374","ENSMODG00000032914","Un",1153326,1175342,22016
"23375","ENSMODG00000032915","Un",88362144,88362667,523
"23376","ENSMODG00000032917","3",337675871,337684199,8328
"23377","ENSMODG00000032918","2",79420163,79542954,122791
"23378","ENSMODG00000032919","4",38740231,38864325,124094
"23379","ENSMODG00000032920","3",520096488,520113134,16646
"23380","ENSMODG00000032921","6",36471724,36585397,113673
"23381","ENSMODG00000032923","4",94082784,94093740,10956
"23382","ENSMODG00000032924","3",419310528,419383707,73179
"23383","ENSMODG00000032925","2",167051699,167065829,14130
"23384","ENSMODG00000032927","2",192937440,192947563,10123
"23385","ENSMODG00000032928","6",45350987,45394845,43858
"23386","ENSMODG00000032929","3",35414516,35417510,2994
"23387","ENSMODG00000032932","8",310833928,310839109,5181
"23388","ENSMODG00000032933","2",489661651,489665235,3584
"23389","ENSMODG00000032934","3",337882509,337895115,12606
"23390","ENSMODG00000032935","Un",60831577,60833655,2078
"23391","ENSMODG00000032936","3",199807127,199823427,16300
"23392","ENSMODG00000032938","7",83698049,83777157,79108
"23393","ENSMODG00000032939","4",375322032,375323075,1043
"23394","ENSMODG00000032940","8",10377421,10387969,10548
"23395","ENSMODG00000032941","2",140503373,140510937,7564
"23396","ENSMODG00000032942","6",148052525,148061344,8819
"23397","ENSMODG00000032944","4",236646216,236654574,8358
"23398","ENSMODG00000032945","1",202118073,202170110,52037
"23399","ENSMODG00000032947","4",275924108,275965769,41661
"23400","ENSMODG00000032948","3",324709802,324757441,47639
"23401","ENSMODG00000032949","3",440726240,440727569,1329
"23402","ENSMODG00000032950","7",177592284,177648313,56029
"23403","ENSMODG00000032951","7",11745471,11750592,5121
"23404","ENSMODG00000032953","2",492116626,492134809,18183
"23405","ENSMODG00000032954","6",81867224,81872949,5725
"23406","ENSMODG00000032955","2",374223894,374224698,804
"23407","ENSMODG00000032956","3",454264496,454266001,1505
"23408","ENSMODG00000032957","1",302835544,302836501,957
"23409","ENSMODG00000032959","X",34238125,34247118,8993
"23410","ENSMODG00000032961","8",62453929,62455600,1671
"23411","ENSMODG00000032963","2",82972325,82976983,4658
"23412","ENSMODG00000032964","3",211653817,211655587,1770
"23413","ENSMODG00000032965","5",44123867,44126012,2145
"23414","ENSMODG00000032966","2",279147015,279149687,2672
"23415","ENSMODG00000032968","2",146283815,146289754,5939
"23416","ENSMODG00000032969","2",78729833,78732402,2569
"23417","ENSMODG00000032970","2",525326542,525331917,5375
"23418","ENSMODG00000032971","2",341534375,341535110,735
"23419","ENSMODG00000032972","3",236906267,236908784,2517
"23420","ENSMODG00000032973","3",356046186,356047563,1377
"23421","ENSMODG00000032974","4",388989163,388989857,694
"23422","ENSMODG00000032975","1",137720684,137747641,26957
"23423","ENSMODG00000032976","1",437607996,437615908,7912
"23424","ENSMODG00000032977","6",194518278,194519738,1460
"23425","ENSMODG00000032978","6",201207834,201213738,5904
"23426","ENSMODG00000032980","7",176273467,176279351,5884
"23427","ENSMODG00000032981","4",314528464,314531092,2628
"23428","ENSMODG00000032982","3",89950998,89980592,29594
"23429","ENSMODG00000032983","2",474511480,474514075,2595
"23430","ENSMODG00000032984","1",57071477,57072207,730
"23431","ENSMODG00000032985","Un",54869042,54873728,4686
"23432","ENSMODG00000032987","5",40831105,40846199,15094
"23433","ENSMODG00000032988","8",221207158,221246621,39463
"23434","ENSMODG00000032989","1",382652382,382694250,41868
"23435","ENSMODG00000032990","2",330200228,330256779,56551
"23436","ENSMODG00000032991","8",170502794,170515831,13037
"23437","ENSMODG00000032992","7",201506161,201511340,5179
"23438","ENSMODG00000032993","Un",27910408,27916596,6188
"23439","ENSMODG00000032994","4",106881354,106925064,43710
"23440","ENSMODG00000032995","3",479261818,479268506,6688
"23441","ENSMODG00000032996","4",151904557,151911720,7163
"23442","ENSMODG00000032997","3",277441030,277441917,887
"23443","ENSMODG00000032999","7",121634645,121637085,2440
"23444","ENSMODG00000033001","8",160664555,160665414,859
"23445","ENSMODG00000033002","Un",32875929,32880179,4250
"23446","ENSMODG00000033003","6",275351843,275374534,22691
"23447","ENSMODG00000033004","3",245556623,245557323,700
"23448","ENSMODG00000033005","6",165185675,165192051,6376
"23449","ENSMODG00000033007","3",101200750,101202824,2074
"23450","ENSMODG00000033008","4",279056280,279196754,140474
"23451","ENSMODG00000033009","5",176960178,176983624,23446
"23452","ENSMODG00000033011","3",257000567,257014525,13958
"23453","ENSMODG00000033012","4",135539360,135540214,854
"23454","ENSMODG00000033013","5",267874407,268020865,146458
"23455","ENSMODG00000033015","1",6422233,6430381,8148
"23456","ENSMODG00000033016","Un",99275975,99279641,3666
"23457","ENSMODG00000033017","3",278624596,278724934,100338
"23458","ENSMODG00000033018","1",99211016,99212658,1642
"23459","ENSMODG00000033019","8",12254564,12255755,1191
"23460","ENSMODG00000033020","X",69394138,69400061,5923
"23461","ENSMODG00000033021","5",300816968,300829332,12364
"23462","ENSMODG00000033022","2",469873561,469877734,4173
"23463","ENSMODG00000033024","8",175011257,175034821,23564
"23464","ENSMODG00000033026","X",11736589,11740976,4387
"23465","ENSMODG00000033027","1",497864216,497879101,14885
"23466","ENSMODG00000033028","6",246274020,246281112,7092
"23467","ENSMODG00000033029","5",808580,816153,7573
"23468","ENSMODG00000033032","1",498184250,498192346,8096
"23469","ENSMODG00000033033","5",58272302,58284233,11931
"23470","ENSMODG00000033034","6",148503935,148505648,1713
"23471","ENSMODG00000033035","4",230144958,230146539,1581
"23472","ENSMODG00000033038","2",225188775,225262810,74035
"23473","ENSMODG00000033039","2",413052497,413167490,114993
"23474","ENSMODG00000033040","8",227376642,227414466,37824
"23475","ENSMODG00000033041","1",512458609,512505881,47272
"23476","ENSMODG00000033042","2",369126483,369132437,5954
"23477","ENSMODG00000033043","6",240765642,240768781,3139
"23478","ENSMODG00000033044","6",103910801,103918586,7785
"23479","ENSMODG00000033045","8",95756271,95844911,88640
"23480","ENSMODG00000033046","2",192912532,192919868,7336
"23481","ENSMODG00000033047","1",133650346,133687179,36833
"23482","ENSMODG00000033049","1",420987772,421009582,21810
"23483","ENSMODG00000033050","3",95087063,95101130,14067
"23484","ENSMODG00000033051","2",342119664,342125003,5339
"23485","ENSMODG00000033053","8",276606404,276607561,1157
"23486","ENSMODG00000033056","2",87975864,88065359,89495
"23487","ENSMODG00000033057","8",119365430,119392128,26698
"23488","ENSMODG00000033058","1",490381660,490383997,2337
"23489","ENSMODG00000033060","1",40106693,40127205,20512
"23490","ENSMODG00000033061","2",113613470,113627495,14025
"23491","ENSMODG00000033065","2",483861560,483879491,17931
"23492","ENSMODG00000033066","5",218844659,218848835,4176
"23493","ENSMODG00000033067","3",389266463,389274095,7632
"23494","ENSMODG00000033068","3",441096081,441100639,4558
"23495","ENSMODG00000033069","5",274102017,274215184,113167
"23496","ENSMODG00000033070","4",301539492,301539973,481
"23497","ENSMODG00000033073","8",11142779,11145197,2418
"23498","ENSMODG00000033074","3",67647344,67675951,28607
"23499","ENSMODG00000033075","5",300111486,300113649,2163
"23500","ENSMODG00000033076","4",71997878,72000902,3024
"23501","ENSMODG00000033077","1",72582738,72761854,179116
"23502","ENSMODG00000033078","1",2520198,2533261,13063
"23503","ENSMODG00000033079","3",227557496,227561441,3945
"23504","ENSMODG00000033080","2",230242077,230313694,71617
"23505","ENSMODG00000033081","3",204814967,204855561,40594
"23506","ENSMODG00000033082","2",284016907,284062415,45508
"23507","ENSMODG00000033083","1",140981795,140983589,1794
"23508","ENSMODG00000033084","3",323448492,323551162,102670
"23509","ENSMODG00000033085","6",193646349,193662444,16095
"23510","ENSMODG00000033086","4",431636662,431640563,3901
"23511","ENSMODG00000033088","8",180848784,180854157,5373
"23512","ENSMODG00000033090","7",129814212,129952152,137940
"23513","ENSMODG00000033091","1",129502732,129513095,10363
"23514","ENSMODG00000033093","5",115988853,116004744,15891
"23515","ENSMODG00000033094","5",250842110,250844529,2419
"23516","ENSMODG00000033095","2",322847833,322913687,65854
"23517","ENSMODG00000033097","4",277471866,277493266,21400
"23518","ENSMODG00000033098","1",385538628,385541929,3301
"23519","ENSMODG00000033099","2",498643955,498660663,16708
"23520","ENSMODG00000033100","4",92389364,92390987,1623
"23521","ENSMODG00000033101","3",74478851,74747154,268303
"23522","ENSMODG00000033102","1",116778215,116796855,18640
"23523","ENSMODG00000033103","7",19486954,19490530,3576
"23524","ENSMODG00000033105","5",97319597,97328409,8812
"23525","ENSMODG00000033106","8",39355928,39377319,21391
"23526","ENSMODG00000033107","2",387348769,387349520,751
"23527","ENSMODG00000033108","Un",73412248,73413933,1685
"23528","ENSMODG00000033109","4",43271371,43305022,33651
"23529","ENSMODG00000033110","4",112388195,112473807,85612
"23530","ENSMODG00000033111","1",153419861,153427518,7657
"23531","ENSMODG00000033112","3",506686814,506688383,1569
"23532","ENSMODG00000033114","7",253791747,253794451,2704
"23533","ENSMODG00000033115","6",209606849,209609986,3137
"23534","ENSMODG00000033116","7",134033139,134035809,2670
"23535","ENSMODG00000033117","2",69264539,69303350,38811
"23536","ENSMODG00000033118","8",244968647,244970516,1869
"23537","ENSMODG00000033119","7",252181048,252312226,131178
"23538","ENSMODG00000033120","4",344711753,344780829,69076
"23539","ENSMODG00000033121","3",19787545,19799045,11500
"23540","ENSMODG00000033122","5",180191449,180196808,5359
"23541","ENSMODG00000033123","8",218309320,218329010,19690
"23542","ENSMODG00000033124","3",21149928,21154059,4131
"23543","ENSMODG00000033125","8",65680387,65712718,32331
"23544","ENSMODG00000033127","2",191648520,191657425,8905
"23545","ENSMODG00000033128","2",327108738,327113620,4882
"23546","ENSMODG00000033129","6",170873467,170877150,3683
"23547","ENSMODG00000033130","X",61973935,62147711,173776
"23548","ENSMODG00000033131","4",341843747,341884835,41088
"23549","ENSMODG00000033133","2",202356434,202358231,1797
"23550","ENSMODG00000033134","3",359163346,359214389,51043
"23551","ENSMODG00000033136","8",29907259,29923287,16028
"23552","ENSMODG00000033137","1",520631144,520641111,9967
"23553","ENSMODG00000033138","5",239512912,239555061,42149
"23554","ENSMODG00000033139","5",4789694,4865356,75662
"23555","ENSMODG00000033140","1",6563093,6652471,89378
"23556","ENSMODG00000033141","2",138881373,138884339,2966
"23557","ENSMODG00000033144","1",154839512,154992143,152631
"23558","ENSMODG00000033145","Un",22258230,22364709,106479
"23559","ENSMODG00000033146","4",383369689,383389459,19770
"23560","ENSMODG00000033147","2",468241749,468244147,2398
"23561","ENSMODG00000033148","X",59079600,59081596,1996
"23562","ENSMODG00000033151","2",76800293,76808723,8430
"23563","ENSMODG00000033152","7",81617105,81690014,72909
"23564","ENSMODG00000033153","7",189175087,189242614,67527
"23565","ENSMODG00000033154","3",85151931,85451330,299399
"23566","ENSMODG00000033155","8",275420199,275431356,11157
"23567","ENSMODG00000033156","1",230823611,230859750,36139
"23568","ENSMODG00000033157","3",439304444,439307887,3443
"23569","ENSMODG00000033158","3",66081396,66088168,6772
"23570","ENSMODG00000033159","4",349498577,349503301,4724
"23571","ENSMODG00000033160","6",123884617,123898408,13791
"23572","ENSMODG00000033163","7",3909168,4006347,97179
"23573","ENSMODG00000033165","1",157907219,157915832,8613
"23574","ENSMODG00000033166","6",218837712,218839440,1728
"23575","ENSMODG00000033167","2",330409777,330417572,7795
"23576","ENSMODG00000033170","X",4385258,4395107,9849
"23577","ENSMODG00000033171","5",242354457,242358981,4524
"23578","ENSMODG00000033172","2",182803894,182806124,2230
"23579","ENSMODG00000033173","4",188053102,188087513,34411
"23580","ENSMODG00000033174","4",329240701,329259057,18356
"23581","ENSMODG00000033175","X",45918679,45926762,8083
"23582","ENSMODG00000033176","3",153854274,153864160,9886
"23583","ENSMODG00000033178","6",194322252,194335147,12895
"23584","ENSMODG00000033179","3",30932705,30933891,1186
"23585","ENSMODG00000033180","6",169299636,169303651,4015
"23586","ENSMODG00000033181","4",312792955,312798232,5277
"23587","ENSMODG00000033182","4",104477569,104483712,6143
"23588","ENSMODG00000033183","2",232241754,232245362,3608
"23589","ENSMODG00000033184","8",64457012,64461415,4403
"23590","ENSMODG00000033185","2",471310416,471370285,59869
"23591","ENSMODG00000033187","4",237885955,237887994,2039
"23592","ENSMODG00000033188","4",280833512,280923244,89732
"23593","ENSMODG00000033189","6",184428782,184486600,57818
"23594","ENSMODG00000033190","1",65511983,65513514,1531
"23595","ENSMODG00000033191","2",392302114,392387417,85303
"23596","ENSMODG00000033192","7",189648096,189648924,828
"23597","ENSMODG00000033193","5",132866008,132866958,950
"23598","ENSMODG00000033194","Un",11076083,11229308,153225
"23599","ENSMODG00000033195","1",198460479,198462683,2204
"23600","ENSMODG00000033196","1",123465107,123466218,1111
"23601","ENSMODG00000033197","4",284305727,284310909,5182
"23602","ENSMODG00000033198","8",12342798,12347553,4755
"23603","ENSMODG00000033199","3",357214237,357260231,45994
"23604","ENSMODG00000033201","Un",63639365,63657160,17795
"23605","ENSMODG00000033202","2",360674181,360713840,39659
"23606","ENSMODG00000033203","1",132230821,132270664,39843
"23607","ENSMODG00000033204","7",206369137,206379026,9889
"23608","ENSMODG00000033205","7",13984182,13999107,14925
"23609","ENSMODG00000033207","3",392330776,392378928,48152
"23610","ENSMODG00000033208","8",155831167,155852367,21200
"23611","ENSMODG00000033209","4",229477680,229481180,3500
"23612","ENSMODG00000033210","4",239416923,239600955,184032
"23613","ENSMODG00000033211","2",478835785,478848734,12949
"23614","ENSMODG00000033212","4",261480267,261488729,8462
"23615","ENSMODG00000033213","7",127267967,127355130,87163
"23616","ENSMODG00000033214","3",527151871,527158628,6757
"23617","ENSMODG00000033217","3",50577513,50578350,837
"23618","ENSMODG00000033219","8",301409201,301410015,814
"23619","ENSMODG00000033223","1",373079138,373085606,6468
"23620","ENSMODG00000033224","1",394599111,394601674,2563
"23621","ENSMODG00000033225","2",168355264,168414278,59014
"23622","ENSMODG00000033227","2",105281484,105291044,9560
"23623","ENSMODG00000033228","1",156177335,156201103,23768
"23624","ENSMODG00000033229","2",119602679,119620315,17636
"23625","ENSMODG00000033232","4",49570256,49575047,4791
"23626","ENSMODG00000033233","4",397733830,397742791,8961
"23627","ENSMODG00000033234","1",177175734,177176983,1249
"23628","ENSMODG00000033235","7",85999986,86010796,10810
"23629","ENSMODG00000033236","4",206288684,206293186,4502
"23630","ENSMODG00000033237","X",3058655,3060705,2050
"23631","ENSMODG00000033238","3",244487257,244500113,12856
"23632","ENSMODG00000033239","4",377784183,377786521,2338
"23633","ENSMODG00000033240","3",421674273,421705542,31269
"23634","ENSMODG00000033241","4",74751122,74761846,10724
"23635","ENSMODG00000033242","Un",99045320,99046850,1530
"23636","ENSMODG00000033243","8",241091283,241093464,2181
"23637","ENSMODG00000033245","1",344845202,344847068,1866
"23638","ENSMODG00000033246","7",110883290,110884404,1114
"23639","ENSMODG00000033247","1",193530650,193547767,17117
"23640","ENSMODG00000033248","X",48985895,49226664,240769
"23641","ENSMODG00000033249","7",169321216,169388342,67126
"23642","ENSMODG00000033250","2",277700214,277702114,1900
"23643","ENSMODG00000033252","1",62851458,62854002,2544
"23644","ENSMODG00000033253","X",72168002,72169789,1787
"23645","ENSMODG00000033254","7",175212858,175213693,835
"23646","ENSMODG00000033255","7",109060568,109082195,21627
"23647","ENSMODG00000033256","2",76801597,76802655,1058
"23648","ENSMODG00000033257","3",420099224,420131448,32224
"23649","ENSMODG00000033260","1",285727933,285746133,18200
"23650","ENSMODG00000033263","4",356593792,356662906,69114
"23651","ENSMODG00000033265","4",44193412,44195992,2580
"23652","ENSMODG00000033266","1",437010919,437015606,4687
"23653","ENSMODG00000033267","4",275509096,275611472,102376
"23654","ENSMODG00000033268","1",431002526,431007748,5222
"23655","ENSMODG00000033270","3",504713147,504716717,3570
"23656","ENSMODG00000033271","Un",4332068,4333146,1078
"23657","ENSMODG00000033272","5",230992917,230996214,3297
"23658","ENSMODG00000033273","1",218555174,218562168,6994
"23659","ENSMODG00000033274","1",393063336,393083793,20457
"23660","ENSMODG00000033275","8",116468265,116485648,17383
"23661","ENSMODG00000033276","5",11584642,11586779,2137
"23662","ENSMODG00000033277","3",421341098,421396037,54939
"23663","ENSMODG00000033278","1",26829893,26835127,5234
"23664","ENSMODG00000033281","4",250002869,250061921,59052
"23665","ENSMODG00000033282","8",237343565,237351632,8067
"23666","ENSMODG00000033283","5",239471570,239495490,23920
"23667","ENSMODG00000033284","1",37075979,37087798,11819
"23668","ENSMODG00000033285","2",44079483,44080320,837
"23669","ENSMODG00000033288","8",252101902,252150086,48184
"23670","ENSMODG00000033289","4",207118480,207124193,5713
"23671","ENSMODG00000033290","4",234675626,234686942,11316
"23672","ENSMODG00000033292","5",269191414,269197102,5688
"23673","ENSMODG00000033293","1",16197991,16201599,3608
"23674","ENSMODG00000033294","2",235175212,235197852,22640
"23675","ENSMODG00000033295","2",266625073,266643708,18635
"23676","ENSMODG00000033297","2",10304647,10306265,1618
"23677","ENSMODG00000033298","5",300254901,300256305,1404
"23678","ENSMODG00000033302","5",121217440,121286357,68917
"23679","ENSMODG00000033303","3",45726638,45728786,2148
"23680","ENSMODG00000033304","1",451684652,451690180,5528
"23681","ENSMODG00000033305","X",57649290,57667939,18649
"23682","ENSMODG00000033306","5",251090255,251092223,1968
"23683","ENSMODG00000033307","7",21448849,21455009,6160
"23684","ENSMODG00000033308","Un",11682851,11721340,38489
"23685","ENSMODG00000033309","3",191320332,191590008,269676
"23686","ENSMODG00000033310","2",101533345,101534858,1513
"23687","ENSMODG00000033312","3",85127625,85202675,75050
"23688","ENSMODG00000033313","4",224714221,224715004,783
"23689","ENSMODG00000033314","3",357981339,357987561,6222
"23690","ENSMODG00000033315","8",179012309,179017473,5164
"23691","ENSMODG00000033318","4",22717564,22727264,9700
"23692","ENSMODG00000033320","4",110908117,110917646,9529
"23693","ENSMODG00000033321","3",298508748,298509653,905
"23694","ENSMODG00000033322","X",40227710,40229450,1740
"23695","ENSMODG00000033323","7",96257333,96266477,9144
"23696","ENSMODG00000033324","5",756831,760107,3276
"23697","ENSMODG00000033325","3",464838030,464900827,62797
"23698","ENSMODG00000033326","6",89887695,89963448,75753
"23699","ENSMODG00000033327","7",145549627,145555094,5467
"23700","ENSMODG00000033328","X",39165051,39173233,8182
"23701","ENSMODG00000033330","7",181651125,181718419,67294
"23702","ENSMODG00000033332","8",17326341,17360021,33680
"23703","ENSMODG00000033334","3",4414443,4423217,8774
"23704","ENSMODG00000033335","7",3357022,3392147,35125
"23705","ENSMODG00000033336","2",153276366,153296304,19938
"23706","ENSMODG00000033337","4",145293249,145300073,6824
"23707","ENSMODG00000033339","2",272648149,272672018,23869
"23708","ENSMODG00000033341","1",372625594,372645895,20301
"23709","ENSMODG00000033342","2",277732785,277828754,95969
"23710","ENSMODG00000033343","1",153236963,153241388,4425
"23711","ENSMODG00000033344","2",396888144,396895319,7175
"23712","ENSMODG00000033345","Un",2190389,2217730,27341
"23713","ENSMODG00000033346","3",244645873,244654817,8944
"23714","ENSMODG00000033347","8",7354529,7373535,19006
"23715","ENSMODG00000033348","2",357149410,357156865,7455
"23716","ENSMODG00000033349","3",214005696,214015585,9889
"23717","ENSMODG00000033350","X",23172108,23200744,28636
"23718","ENSMODG00000033351","2",496570544,496576014,5470
"23719","ENSMODG00000033352","2",126680475,126684177,3702
"23720","ENSMODG00000033355","7",26339468,26345493,6025
"23721","ENSMODG00000033357","3",193810678,193811603,925
"23722","ENSMODG00000033358","2",174674177,174693740,19563
"23723","ENSMODG00000033359","7",227434181,227450172,15991
"23724","ENSMODG00000033360","3",412515598,412517116,1518
"23725","ENSMODG00000033361","X",50133308,50178051,44743
"23726","ENSMODG00000033362","1",168448738,168454038,5300
"23727","ENSMODG00000033363","6",167734479,167754658,20179
"23728","ENSMODG00000033364","8",148285522,148299203,13681
"23729","ENSMODG00000033365","7",254072952,254080660,7708
"23730","ENSMODG00000033366","Un",76921677,76927452,5775
"23731","ENSMODG00000033367","4",412583095,412590805,7710
"23732","ENSMODG00000033368","6",187606845,187613816,6971
"23733","ENSMODG00000033369","7",62466915,62487314,20399
"23734","ENSMODG00000033370","4",301466138,301478122,11984
"23735","ENSMODG00000033372","7",164132640,164150934,18294
"23736","ENSMODG00000033373","8",65686037,65779986,93949
"23737","ENSMODG00000033374","1",55013749,55027983,14234
"23738","ENSMODG00000033375","8",235957090,236028569,71479
"23739","ENSMODG00000033377","1",111785980,111815126,29146
"23740","ENSMODG00000033378","8",6852995,6924139,71144
"23741","ENSMODG00000033379","3",492398917,492440087,41170
"23742","ENSMODG00000033380","X",16371235,16382352,11117
"23743","ENSMODG00000033381","3",181502583,181506282,3699
"23744","ENSMODG00000033382","5",99479905,99483269,3364
"23745","ENSMODG00000033385","1",193316282,193317937,1655
"23746","ENSMODG00000033386","8",277876020,277917616,41596
"23747","ENSMODG00000033387","3",494592410,494596122,3712
"23748","ENSMODG00000033388","8",46530436,46559063,28627
"23749","ENSMODG00000033390","5",228569550,228592966,23416
"23750","ENSMODG00000033391","3",506859251,506861084,1833
"23751","ENSMODG00000033392","3",362011019,362043335,32316
"23752","ENSMODG00000033393","4",17279398,17496888,217490
"23753","ENSMODG00000033394","2",324481134,324495102,13968
"23754","ENSMODG00000033395","7",67561167,67603749,42582
"23755","ENSMODG00000033396","4",240138685,240142077,3392
"23756","ENSMODG00000033397","7",71095007,71112192,17185
"23757","ENSMODG00000033398","6",19814230,19874659,60429
"23758","ENSMODG00000033399","6",11707941,11716288,8347
"23759","ENSMODG00000033400","6",31004959,31008283,3324
"23760","ENSMODG00000033401","8",178903541,178961347,57806
"23761","ENSMODG00000033402","1",442078179,442103605,25426
"23762","ENSMODG00000033403","4",384911044,384912789,1745
"23763","ENSMODG00000033405","1",146513612,146576329,62717
"23764","ENSMODG00000033407","6",118893195,118896218,3023
"23765","ENSMODG00000033408","6",7274855,7279119,4264
"23766","ENSMODG00000033409","3",350350694,350473915,123221
"23767","ENSMODG00000033410","Un",38592601,38594390,1789
"23768","ENSMODG00000033411","3",182021978,182076196,54218
"23769","ENSMODG00000033412","7",85232667,85233282,615
"23770","ENSMODG00000033414","1",396877706,396909173,31467
"23771","ENSMODG00000033416","1",99600175,99748062,147887
"23772","ENSMODG00000033417","4",59520059,59682829,162770
"23773","ENSMODG00000033418","8",79100227,79103510,3283
"23774","ENSMODG00000033419","2",415709615,415762588,52973
"23775","ENSMODG00000033420","X",69771095,69781735,10640
"23776","ENSMODG00000033421","5",116930579,116998085,67506
"23777","ENSMODG00000033422","3",460345590,460354667,9077
"23778","ENSMODG00000033423","3",496999005,497009429,10424
"23779","ENSMODG00000033424","3",254106325,254107993,1668
"23780","ENSMODG00000033425","8",85477914,85502633,24719
"23781","ENSMODG00000033426","4",197442956,197447164,4208
"23782","ENSMODG00000033429","1",495471731,495566672,94941
"23783","ENSMODG00000033430","4",286864793,287048986,184193
"23784","ENSMODG00000033434","4",305346516,305371277,24761
"23785","ENSMODG00000033435","2",133071496,133086699,15203
"23786","ENSMODG00000033436","1",446874693,446951990,77297
"23787","ENSMODG00000033438","1",244338152,244340612,2460
"23788","ENSMODG00000033439","7",169446003,169470988,24985
"23789","ENSMODG00000033440","2",109687945,109706771,18826
"23790","ENSMODG00000033442","3",348911564,348918101,6537
"23791","ENSMODG00000033443","4",326956996,327117428,160432
"23792","ENSMODG00000033444","3",219879110,219936362,57252
"23793","ENSMODG00000033445","6",260732999,260750398,17399
"23794","ENSMODG00000033446","3",414744999,414795075,50076
"23795","ENSMODG00000033448","7",84117157,84121905,4748
"23796","ENSMODG00000033451","4",422075618,422156618,81000
"23797","ENSMODG00000033454","3",372291506,372292663,1157
"23798","ENSMODG00000033455","7",24966074,24995156,29082
"23799","ENSMODG00000033456","6",7553817,7556914,3097
"23800","ENSMODG00000033457","7",248163280,248171427,8147
"23801","ENSMODG00000033458","8",5336365,5342440,6075
"23802","ENSMODG00000033460","4",232085567,232089658,4091
"23803","ENSMODG00000033462","3",262306030,262306982,952
"23804","ENSMODG00000033463","7",26258380,26331199,72819
"23805","ENSMODG00000033464","7",19750126,19768058,17932
"23806","ENSMODG00000033465","8",298395149,298399272,4123
"23807","ENSMODG00000033466","7",244173715,244211591,37876
"23808","ENSMODG00000033467","5",204029586,204385933,356347
"23809","ENSMODG00000033468","3",400868379,400870479,2100
"23810","ENSMODG00000033470","3",423939166,423981615,42449
"23811","ENSMODG00000033471","2",346286277,346294215,7938
"23812","ENSMODG00000033472","4",124202610,124411416,208806
"23813","ENSMODG00000033473","7",230457659,230479494,21835
"23814","ENSMODG00000033474","3",145553745,145561962,8217
"23815","ENSMODG00000033475","8",290720374,290776532,56158
"23816","ENSMODG00000033476","Un",23899415,23906051,6636
"23817","ENSMODG00000033477","7",140623679,140660505,36826
"23818","ENSMODG00000033478","8",302670577,302726234,55657
"23819","ENSMODG00000033480","3",345218782,345220194,1412
"23820","ENSMODG00000033481","Un",49837186,49845793,8607
"23821","ENSMODG00000033482","1",235838902,235843173,4271
"23822","ENSMODG00000033483","4",324822399,324829620,7221
"23823","ENSMODG00000033484","3",254722656,254726038,3382
"23824","ENSMODG00000033486","3",368618003,368619733,1730
"23825","ENSMODG00000033488","6",136883888,136892691,8803
"23826","ENSMODG00000033489","1",171386098,171388878,2780
"23827","ENSMODG00000033491","1",427077897,427166587,88690
"23828","ENSMODG00000033493","4",10068189,10074708,6519
"23829","ENSMODG00000033494","1",335654403,335767992,113589
"23830","ENSMODG00000033496","3",225070995,225148838,77843
"23831","ENSMODG00000033497","3",64455293,64463523,8230
"23832","ENSMODG00000033498","7",109221908,109223273,1365
"23833","ENSMODG00000033499","5",20643158,20647159,4001
"23834","ENSMODG00000033501","6",27322005,27326377,4372
"23835","ENSMODG00000033503","3",84136239,84275882,139643
"23836","ENSMODG00000033504","3",142972216,142975155,2939
"23837","ENSMODG00000033505","Un",56215206,56217004,1798
"23838","ENSMODG00000033506","2",296225759,296228384,2625
"23839","ENSMODG00000033507","Un",71730357,71734219,3862
"23840","ENSMODG00000033509","6",253454348,253457617,3269
"23841","ENSMODG00000033510","2",283523256,283552707,29451
"23842","ENSMODG00000033511","5",280336852,280338868,2016
"23843","ENSMODG00000033512","3",158021411,158085114,63703
"23844","ENSMODG00000033513","5",216473894,216540886,66992
"23845","ENSMODG00000033514","5",159316438,159349682,33244
"23846","ENSMODG00000033516","2",345268363,345299630,31267
"23847","ENSMODG00000033517","1",157376690,157416115,39425
"23848","ENSMODG00000033518","5",29040531,29041722,1191
"23849","ENSMODG00000033519","6",100043359,100103573,60214
"23850","ENSMODG00000033520","7",2688628,2902806,214178
"23851","ENSMODG00000033521","5",218237914,218290638,52724
"23852","ENSMODG00000033522","3",312527148,312529428,2280
"23853","ENSMODG00000033523","1",56558450,56564810,6360
"23854","ENSMODG00000033524","6",216169560,216185167,15607
"23855","ENSMODG00000033525","4",287522481,287534834,12353
"23856","ENSMODG00000033526","5",281735622,281741164,5542
"23857","ENSMODG00000033527","3",223069849,223101224,31375
"23858","ENSMODG00000033528","Un",2263518,2265791,2273
"23859","ENSMODG00000033529","Un",13159852,13183070,23218
"23860","ENSMODG00000033530","1",157089552,157210017,120465
"23861","ENSMODG00000033531","3",285379846,285406203,26357
"23862","ENSMODG00000033532","3",24291754,24296011,4257
"23863","ENSMODG00000033533","5",125452545,125508129,55584
"23864","ENSMODG00000033534","2",218947524,218995204,47680
"23865","ENSMODG00000033535","2",390097420,390137385,39965
"23866","ENSMODG00000033536","2",519703454,519713165,9711
"23867","ENSMODG00000033537","2",67611856,67632055,20199
"23868","ENSMODG00000033538","7",175439427,175453141,13714
"23869","ENSMODG00000033539","5",68767947,68784457,16510
"23870","ENSMODG00000033541","1",356875968,357043161,167193
"23871","ENSMODG00000033542","1",146671984,146680735,8751
"23872","ENSMODG00000033543","1",455729376,455749096,19720
"23873","ENSMODG00000033544","5",225926088,225972272,46184
"23874","ENSMODG00000033545","3",79896704,79901605,4901
"23875","ENSMODG00000033546","4",224841806,224850588,8782
"23876","ENSMODG00000033547","5",233792059,233882847,90788
"23877","ENSMODG00000033548","2",453267896,453282603,14707
"23878","ENSMODG00000033551","2",220026413,220027887,1474
"23879","ENSMODG00000033552","8",204793293,204801567,8274
"23880","ENSMODG00000033553","2",280264905,280282373,17468
"23881","ENSMODG00000033554","2",256574455,256577553,3098
"23882","ENSMODG00000033555","3",91156329,91161288,4959
"23883","ENSMODG00000033556","1",399108452,399148258,39806
"23884","ENSMODG00000033557","X",50628764,50631806,3042
"23885","ENSMODG00000033558","5",258452326,258452887,561
"23886","ENSMODG00000033559","3",145275696,145280374,4678
"23887","ENSMODG00000033560","7",246442116,246445197,3081
"23888","ENSMODG00000033561","8",51344184,51348307,4123
"23889","ENSMODG00000033563","3",14366456,14449365,82909
"23890","ENSMODG00000033564","3",295139042,295167577,28535
"23891","ENSMODG00000033565","X",22435107,22436342,1235
"23892","ENSMODG00000033566","4",431803938,431833621,29683
"23893","ENSMODG00000033567","4",296901075,297006611,105536
"23894","ENSMODG00000033568","1",510612249,510613985,1736
"23895","ENSMODG00000033569","2",215217355,215224499,7144
"23896","ENSMODG00000033570","6",10419528,10643696,224168
"23897","ENSMODG00000033571","6",45903775,46039785,136010
"23898","ENSMODG00000033572","4",231014358,231022792,8434
"23899","ENSMODG00000033575","2",301761196,301829994,68798
"23900","ENSMODG00000033577","5",185594232,185609314,15082
"23901","ENSMODG00000033578","6",78725411,78731697,6286
"23902","ENSMODG00000033579","5",225082706,225088608,5902
"23903","ENSMODG00000033580","2",372890046,372931716,41670
"23904","ENSMODG00000033581","1",459101775,459105894,4119
"23905","ENSMODG00000033582","X",64265681,64269252,3571
"23906","ENSMODG00000033583","2",478828795,478834534,5739
"23907","ENSMODG00000033585","8",309751748,309765329,13581
"23908","ENSMODG00000033586","2",433156307,433158640,2333
"23909","ENSMODG00000033587","1",133166784,133170642,3858
"23910","ENSMODG00000033589","1",3448891,3452190,3299
"23911","ENSMODG00000033590","1",18688499,18783378,94879
"23912","ENSMODG00000033591","4",419176745,419181782,5037
"23913","ENSMODG00000033592","5",220185514,220191678,6164
"23914","ENSMODG00000033593","1",130175568,130186508,10940
"23915","ENSMODG00000033594","8",256483326,256534932,51606
"23916","ENSMODG00000033595","2",13995594,14038393,42799
"23917","ENSMODG00000033596","5",215006828,215009503,2675
"23918","ENSMODG00000033597","4",25056511,25078572,22061
"23919","ENSMODG00000033598","1",99698519,99721680,23161
"23920","ENSMODG00000033599","7",49226272,49261332,35060
"23921","ENSMODG00000033600","6",108769847,108798386,28539
"23922","ENSMODG00000033601","Un",22125522,22360454,234932
"23923","ENSMODG00000033602","3",499291951,499311364,19413
"23924","ENSMODG00000033603","4",363426248,363435625,9377
"23925","ENSMODG00000033604","6",227207574,227212528,4954
"23926","ENSMODG00000033605","4",168285656,168286267,611
"23927","ENSMODG00000033606","4",25409137,25410257,1120
"23928","ENSMODG00000033607","1",397616574,397617655,1081
"23929","ENSMODG00000033608","Un",15435409,15439666,4257
"23930","ENSMODG00000033609","1",211525716,211547837,22121
"23931","ENSMODG00000033610","2",242064630,242067094,2464
"23932","ENSMODG00000033611","7",27041492,27050406,8914
"23933","ENSMODG00000033612","8",223485533,223490207,4674
"23934","ENSMODG00000033613","4",59502653,59508706,6053
"23935","ENSMODG00000033614","4",167046416,167048690,2274
"23936","ENSMODG00000033617","5",22846272,22848768,2496
"23937","ENSMODG00000033618","1",432695938,432701971,6033
"23938","ENSMODG00000033619","5",46001736,46054883,53147
"23939","ENSMODG00000033620","1",140638321,140674591,36270
"23940","ENSMODG00000033621","1",373380573,373446776,66203
"23941","ENSMODG00000033623","2",26256702,26266858,10156
"23942","ENSMODG00000033624","8",151068344,151110182,41838
"23943","ENSMODG00000033625","2",378650964,378671929,20965
"23944","ENSMODG00000033626","5",164224007,164228790,4783
"23945","ENSMODG00000033627","7",65641325,65659015,17690
"23946","ENSMODG00000033629","6",288636975,288642612,5637
"23947","ENSMODG00000033630","6",241667241,241669767,2526
"23948","ENSMODG00000033631","7",227831913,227835277,3364
"23949","ENSMODG00000033632","5",40513195,40522176,8981
"23950","ENSMODG00000033633","6",205510628,205516901,6273
"23951","ENSMODG00000033634","3",423253112,423280551,27439
"23952","ENSMODG00000033635","1",450590549,450594400,3851
"23953","ENSMODG00000033636","1",310691094,310693742,2648
"23954","ENSMODG00000033638","X",48135499,48146976,11477
"23955","ENSMODG00000033640","4",385853819,385855557,1738
"23956","ENSMODG00000033641","3",455923713,455935963,12250
"23957","ENSMODG00000033642","4",428143146,428403075,259929
"23958","ENSMODG00000033643","2",487940335,487946211,5876
"23959","ENSMODG00000033645","5",245004333,245015129,10796
"23960","ENSMODG00000033646","8",135145020,135149553,4533
"23961","ENSMODG00000033647","8",86609900,86611851,1951
"23962","ENSMODG00000033648","3",205027148,205189265,162117
"23963","ENSMODG00000033649","1",183793822,183796175,2353
"23964","ENSMODG00000033650","3",18031725,18068366,36641
"23965","ENSMODG00000033651","5",117174214,117176694,2480
"23966","ENSMODG00000033652","4",170931923,170982499,50576
"23967","ENSMODG00000033653","2",415086231,415095801,9570
"23968","ENSMODG00000033655","2",469714798,469842045,127247
"23969","ENSMODG00000033656","7",78738744,78810057,71313
"23970","ENSMODG00000033657","6",131851407,131911738,60331
"23971","ENSMODG00000033658","2",149543361,149569089,25728
"23972","ENSMODG00000033659","2",184568300,184586027,17727
"23973","ENSMODG00000033660","6",145750200,145755486,5286
"23974","ENSMODG00000033662","5",210601342,210606414,5072
"23975","ENSMODG00000033663","8",286565402,286650954,85552
"23976","ENSMODG00000033664","8",301083695,301087729,4034
"23977","ENSMODG00000033665","3",511995252,512017651,22399
"23978","ENSMODG00000033666","2",311993516,311994846,1330
"23979","ENSMODG00000033667","8",191777186,191779837,2651
"23980","ENSMODG00000033668","5",228558260,228630037,71777
"23981","ENSMODG00000033669","2",199193867,199195878,2011
"23982","ENSMODG00000033670","2",33504993,33507466,2473
"23983","ENSMODG00000033671","1",401908148,401920393,12245
"23984","ENSMODG00000033673","3",181150719,181152201,1482
"23985","ENSMODG00000033674","3",406571508,406575121,3613
"23986","ENSMODG00000033675","2",391027756,391032224,4468
"23987","ENSMODG00000033676","1",273782025,273786853,4828
"23988","ENSMODG00000033677","Un",11094797,11098743,3946
"23989","ENSMODG00000033678","8",258106652,258108959,2307
"23990","ENSMODG00000033679","8",121030376,121031537,1161
"23991","ENSMODG00000033680","1",512293495,512295961,2466
"23992","ENSMODG00000033681","8",156157880,156162899,5019
"23993","ENSMODG00000033682","8",291671280,291683213,11933
"23994","ENSMODG00000033683","Un",100034242,100036450,2208
"23995","ENSMODG00000033684","4",422424346,422427789,3443
"23996","ENSMODG00000033685","Un",93822765,93883139,60374
"23997","ENSMODG00000033686","2",418158948,418214631,55683
"23998","ENSMODG00000033688","2",107635175,107654978,19803
"23999","ENSMODG00000033689","2",505675941,505687881,11940
"24000","ENSMODG00000033691","3",279970539,279980750,10211
"24001","ENSMODG00000033693","7",9045774,9047812,2038
"24002","ENSMODG00000033694","2",165198017,165205386,7369
"24003","ENSMODG00000033697","5",253339184,253359247,20063
"24004","ENSMODG00000033698","2",91830974,91957949,126975
"24005","ENSMODG00000033699","5",6853114,6856509,3395
"24006","ENSMODG00000033700","1",390145989,390147199,1210
"24007","ENSMODG00000033701","1",116941987,116943923,1936
"24008","ENSMODG00000033702","1",396480096,396485285,5189
"24009","ENSMODG00000033703","6",111060500,111061903,1403
"24010","ENSMODG00000033704","8",103179967,103180666,699
"24011","ENSMODG00000033705","Un",64920117,64926876,6759
"24012","ENSMODG00000033706","6",198752747,198764193,11446
"24013","ENSMODG00000033708","5",22038443,22046694,8251
"24014","ENSMODG00000033709","2",480138462,480140304,1842
"24015","ENSMODG00000033711","5",1004785,1006107,1322
"24016","ENSMODG00000033712","6",200055399,200066219,10820
"24017","ENSMODG00000033713","1",451145031,451147844,2813
"24018","ENSMODG00000033714","7",155182745,155228148,45403
"24019","ENSMODG00000033715","8",249132776,249399124,266348
"24020","ENSMODG00000033718","8",66386302,66549355,163053
"24021","ENSMODG00000033719","3",235396960,235406235,9275
"24022","ENSMODG00000033720","3",329157394,329193824,36430
"24023","ENSMODG00000033722","1",526773318,526787461,14143
"24024","ENSMODG00000033723","7",252430605,252430984,379
"24025","ENSMODG00000033725","8",293415925,293428218,12293
"24026","ENSMODG00000033726","8",12895099,12897000,1901
"24027","ENSMODG00000033727","6",151272439,151273299,860
"24028","ENSMODG00000033728","4",205893981,205995549,101568
"24029","ENSMODG00000033729","3",226120046,226122195,2149
"24030","ENSMODG00000033730","Un",30091731,30097598,5867
"24031","ENSMODG00000033731","Un",8199562,8204719,5157
"24032","ENSMODG00000033732","2",18289581,18293737,4156
"24033","ENSMODG00000033733","1",215474580,215485222,10642
"24034","ENSMODG00000033734","7",108598208,108602581,4373
"24035","ENSMODG00000033736","3",485692748,485699146,6398
"24036","ENSMODG00000033737","3",91344880,91348623,3743
"24037","ENSMODG00000033740","X",57400041,57537877,137836
"24038","ENSMODG00000033741","4",384384834,384390754,5920
"24039","ENSMODG00000033742","1",352845612,352856437,10825
"24040","ENSMODG00000033744","2",38804647,38814376,9729
"24041","ENSMODG00000033745","3",144643141,144646494,3353
"24042","ENSMODG00000033746","2",423356883,423390516,33633
"24043","ENSMODG00000033749","5",187974424,187979495,5071
"24044","ENSMODG00000033750","7",224340839,224346442,5603
"24045","ENSMODG00000033751","8",236483127,236593115,109988
"24046","ENSMODG00000033754","Un",34476253,34481075,4822
"24047","ENSMODG00000033755","7",205462872,205472202,9330
"24048","ENSMODG00000033756","7",159016316,159020457,4141
"24049","ENSMODG00000033759","4",254755102,254757554,2452
"24050","ENSMODG00000033760","4",337321146,337360825,39679
"24051","ENSMODG00000033761","3",498525304,498562290,36986
"24052","ENSMODG00000033762","1",233611758,233631181,19423
"24053","ENSMODG00000033763","X",59001356,59036586,35230
"24054","ENSMODG00000033765","4",144066827,144090895,24068
"24055","ENSMODG00000033766","4",385063812,385091082,27270
"24056","ENSMODG00000033767","4",420914617,420917739,3122
"24057","ENSMODG00000033769","2",456717352,456724959,7607
"24058","ENSMODG00000033770","3",39700722,39720560,19838
"24059","ENSMODG00000033771","X",77117290,77293669,176379
"24060","ENSMODG00000033772","4",94169307,94176835,7528
"24061","ENSMODG00000033773","3",357991332,357996631,5299
"24062","ENSMODG00000033775","5",129171682,129291595,119913
"24063","ENSMODG00000033777","8",27112400,27130539,18139
"24064","ENSMODG00000033778","7",151948948,152117004,168056
"24065","ENSMODG00000033779","1",12788092,12790350,2258
"24066","ENSMODG00000033780","1",474863188,474864760,1572
"24067","ENSMODG00000033781","1",335471244,335472617,1373
"24068","ENSMODG00000033782","1",191688445,191707630,19185
"24069","ENSMODG00000033783","5",229018266,229021045,2779
"24070","ENSMODG00000033784","5",115638487,115650362,11875
"24071","ENSMODG00000033786","8",28531794,28545563,13769
"24072","ENSMODG00000033788","2",58632533,58638734,6201
"24073","ENSMODG00000033790","8",219258081,219278227,20146
"24074","ENSMODG00000033791","6",218294497,218299998,5501
"24075","ENSMODG00000033792","6",227966096,228028709,62613
"24076","ENSMODG00000033793","8",304134901,304138556,3655
"24077","ENSMODG00000033794","5",66132924,66140303,7379
"24078","ENSMODG00000033795","3",81836193,81845496,9303
"24079","ENSMODG00000033797","7",9977277,9978725,1448
"24080","ENSMODG00000033798","5",63808584,63934038,125454
"24081","ENSMODG00000033800","4",322593493,322614943,21450
"24082","ENSMODG00000033801","X",72660822,72667157,6335
"24083","ENSMODG00000033802","2",113119634,113135708,16074
"24084","ENSMODG00000033803","3",174322479,174374128,51649
"24085","ENSMODG00000033804","5",184191756,184193575,1819
"24086","ENSMODG00000033807","3",453069065,453190244,121179
"24087","ENSMODG00000033808","4",342974082,342976175,2093
"24088","ENSMODG00000033809","1",372223932,372345001,121069
"24089","ENSMODG00000033810","4",111310391,111354962,44571
"24090","ENSMODG00000033811","5",247612749,247691475,78726
"24091","ENSMODG00000033815","3",296954296,296961251,6955
"24092","ENSMODG00000033816","5",63099567,63184837,85270
"24093","ENSMODG00000033817","2",405939344,405986488,47144
"24094","ENSMODG00000033818","4",135406400,135431864,25464
"24095","ENSMODG00000033819","1",248528924,248530122,1198
"24096","ENSMODG00000033820","1",373086783,373088781,1998
"24097","ENSMODG00000033821","8",282702128,282718720,16592
"24098","ENSMODG00000033822","7",248331266,248474930,143664
"24099","ENSMODG00000033823","6",162251061,162268313,17252
"24100","ENSMODG00000033824","3",318202370,318207006,4636
"24101","ENSMODG00000033826","7",150520827,150568464,47637
"24102","ENSMODG00000033827","4",387242496,387243764,1268
"24103","ENSMODG00000033828","8",113200316,113207657,7341
"24104","ENSMODG00000033831","6",64230343,64272010,41667
"24105","ENSMODG00000033832","7",11823171,11841687,18516
"24106","ENSMODG00000033833","3",317192944,317194871,1927
"24107","ENSMODG00000033835","2",229646082,229647269,1187
"24108","ENSMODG00000033836","2",466986416,466994552,8136
"24109","ENSMODG00000033837","1",158303862,158305237,1375
"24110","ENSMODG00000033838","8",236402022,236419157,17135
"24111","ENSMODG00000033840","3",162475131,162478966,3835
"24112","ENSMODG00000033841","2",396828241,396831892,3651
"24113","ENSMODG00000033842","2",470205541,470226574,21033
"24114","ENSMODG00000033843","2",376769940,376773213,3273
"24115","ENSMODG00000033844","Un",36694112,36703466,9354
"24116","ENSMODG00000033846","8",26744868,26751648,6780
"24117","ENSMODG00000033847","X",57300864,57303736,2872
"24118","ENSMODG00000033848","8",243653048,243666398,13350
"24119","ENSMODG00000033849","Un",42730513,42731658,1145
"24120","ENSMODG00000033850","Un",46028618,46029729,1111
"24121","ENSMODG00000033851","3",16973467,16978821,5354
"24122","ENSMODG00000033852","8",82165519,82202593,37074
"24123","ENSMODG00000033853","8",52799230,52881186,81956
"24124","ENSMODG00000033854","6",256207043,256209730,2687
"24125","ENSMODG00000033855","7",232723692,232863326,139634
"24126","ENSMODG00000033856","7",12284025,12286775,2750
"24127","ENSMODG00000033858","8",236431106,236433510,2404
"24128","ENSMODG00000033859","7",165142316,165145677,3361
"24129","ENSMODG00000033860","3",307483818,307578146,94328
"24130","ENSMODG00000033861","8",283112815,283134239,21424
"24131","ENSMODG00000033862","Un",66148051,66150118,2067
"24132","ENSMODG00000033863","Un",16626866,16630861,3995
"24133","ENSMODG00000033864","X",64386655,64389494,2839
"24134","ENSMODG00000033865","6",253385560,253388813,3253
"24135","ENSMODG00000033866","2",120657815,120662853,5038
"24136","ENSMODG00000033867","2",257727576,257740399,12823
"24137","ENSMODG00000033868","1",25105307,25125511,20204
"24138","ENSMODG00000033871","4",360343891,360357557,13666
"24139","ENSMODG00000033872","3",413379224,413380008,784
"24140","ENSMODG00000033873","3",440205538,440211389,5851
"24141","ENSMODG00000033874","1",48084861,48092839,7978
"24142","ENSMODG00000033876","8",302542679,302545197,2518
"24143","ENSMODG00000033877","6",118255094,118287147,32053
"24144","ENSMODG00000033878","X",52212677,52214145,1468
"24145","ENSMODG00000033879","1",392919863,393012443,92580
"24146","ENSMODG00000033881","1",254731828,254733621,1793
"24147","ENSMODG00000033883","3",518881783,518883833,2050
"24148","ENSMODG00000033885","3",189010299,189121906,111607
"24149","ENSMODG00000033886","5",282400084,282408700,8616
"24150","ENSMODG00000033887","4",314390927,314394466,3539
"24151","ENSMODG00000033888","8",109482261,109583116,100855
"24152","ENSMODG00000033890","1",418768633,418808334,39701
"24153","ENSMODG00000033893","1",68526262,68527783,1521
"24154","ENSMODG00000033894","Un",102434375,102436458,2083
"24155","ENSMODG00000033895","5",225044018,225055630,11612
"24156","ENSMODG00000033896","2",267001856,267002670,814
"24157","ENSMODG00000033897","5",90769112,90791067,21955
"24158","ENSMODG00000033898","3",494793644,494819182,25538
"24159","ENSMODG00000033899","2",421550568,421568399,17831
"24160","ENSMODG00000033901","1",104434404,104532021,97617
"24161","ENSMODG00000033902","5",18250020,18261198,11178
"24162","ENSMODG00000033903","5",259180158,259302962,122804
"24163","ENSMODG00000033904","7",79166708,79223080,56372
"24164","ENSMODG00000033905","1",448291640,448310769,19129
"24165","ENSMODG00000033906","7",26892101,26965335,73234
"24166","ENSMODG00000033908","3",469302896,469321143,18247
"24167","ENSMODG00000033909","5",173185049,173188811,3762
"24168","ENSMODG00000033910","2",13537684,13545248,7564
"24169","ENSMODG00000033911","3",317908835,317912982,4147
"24170","ENSMODG00000033912","1",9251543,9256784,5241
"24171","ENSMODG00000033913","6",277157085,277159508,2423
"24172","ENSMODG00000033914","1",499161602,499167445,5843
"24173","ENSMODG00000033915","4",226421897,226462412,40515
"24174","ENSMODG00000033916","3",451067618,451079158,11540
"24175","ENSMODG00000033918","1",247910992,247915065,4073
"24176","ENSMODG00000033919","7",32170492,32173204,2712
"24177","ENSMODG00000033920","3",488708096,488714445,6349
"24178","ENSMODG00000033921","6",131958560,131984870,26310
"24179","ENSMODG00000033922","1",507703398,507704955,1557
"24180","ENSMODG00000033923","1",22555473,22573936,18463
"24181","ENSMODG00000033924","6",26732970,26751225,18255
"24182","ENSMODG00000033925","4",389281258,389285156,3898
"24183","ENSMODG00000033926","3",326708387,326764648,56261
"24184","ENSMODG00000033929","3",305157159,305158484,1325
"24185","ENSMODG00000033930","5",241426368,241430584,4216
"24186","ENSMODG00000033934","6",171779839,171857617,77778
"24187","ENSMODG00000033935","1",4174091,4209579,35488
"24188","ENSMODG00000033937","Un",49789187,49800848,11661
"24189","ENSMODG00000033939","1",168814435,168817118,2683
"24190","ENSMODG00000033940","2",134315755,134331339,15584
"24191","ENSMODG00000033942","7",123677075,123830094,153019
"24192","ENSMODG00000033943","X",36699739,36707977,8238
"24193","ENSMODG00000033944","7",19538772,19555797,17025
"24194","ENSMODG00000033946","8",263925204,263928968,3764
"24195","ENSMODG00000033947","5",11669073,11673422,4349
"24196","ENSMODG00000033948","1",39358019,39359527,1508
"24197","ENSMODG00000033949","2",478114350,478115136,786
"24198","ENSMODG00000033950","7",205789674,205795388,5714
"24199","ENSMODG00000033951","8",68265547,68275955,10408
"24200","ENSMODG00000033952","8",244586969,244591924,4955
"24201","ENSMODG00000033953","Un",29759707,29763456,3749
"24202","ENSMODG00000033954","5",210655005,210659253,4248
"24203","ENSMODG00000033955","4",84493596,84494934,1338
"24204","ENSMODG00000033956","1",331040321,331049304,8983
"24205","ENSMODG00000033957","7",86715101,86717038,1937
"24206","ENSMODG00000033958","1",297418610,297424482,5872
"24207","ENSMODG00000033959","2",456240277,456286395,46118
"24208","ENSMODG00000033960","3",498601837,498647213,45376
"24209","ENSMODG00000033961","7",258449814,258490275,40461
"24210","ENSMODG00000033962","4",55673035,55690044,17009
"24211","ENSMODG00000033963","4",166542104,166551952,9848
"24212","ENSMODG00000033964","8",134635135,134755832,120697
"24213","ENSMODG00000033965","8",127480894,127485108,4214
"24214","ENSMODG00000033967","Un",58850013,58857908,7895
"24215","ENSMODG00000033968","1",536470269,536490668,20399
"24216","ENSMODG00000033969","3",247941020,247943521,2501
"24217","ENSMODG00000033970","4",135431464,135473775,42311
"24218","ENSMODG00000033972","4",268650626,268670904,20278
"24219","ENSMODG00000033973","Un",16811905,16813933,2028
"24220","ENSMODG00000033974","7",156794228,156794928,700
"24221","ENSMODG00000033975","X",64788295,64978681,190386
"24222","ENSMODG00000033976","8",192055275,192108018,52743
"24223","ENSMODG00000033977","2",59006878,59008111,1233
"24224","ENSMODG00000033978","8",229691447,229989393,297946
"24225","ENSMODG00000033979","8",61842316,61896747,54431
"24226","ENSMODG00000033980","6",195300189,195323180,22991
"24227","ENSMODG00000033981","Un",48869903,48878048,8145
"24228","ENSMODG00000033982","3",489593572,489661154,67582
"24229","ENSMODG00000033983","3",75671275,75707321,36046
"24230","ENSMODG00000033984","X",44066816,44073712,6896
"24231","ENSMODG00000033985","3",199402679,199408851,6172
"24232","ENSMODG00000033986","2",264542641,264583973,41332
"24233","ENSMODG00000033987","1",468693652,468694704,1052
"24234","ENSMODG00000033988","2",378023500,378033121,9621
"24235","ENSMODG00000033989","4",272844652,272860523,15871
"24236","ENSMODG00000033990","1",391017726,391021550,3824
"24237","ENSMODG00000033991","1",325837238,325842348,5110
"24238","ENSMODG00000033995","1",139671113,139672455,1342
"24239","ENSMODG00000033996","5",245664329,245695161,30832
"24240","ENSMODG00000033997","8",134763520,134783307,19787
"24241","ENSMODG00000033998","2",131567188,131666908,99720
"24242","ENSMODG00000033999","7",232607823,232614675,6852
"24243","ENSMODG00000034000","4",86208345,86213060,4715
"24244","ENSMODG00000034001","3",37731297,37733917,2620
"24245","ENSMODG00000034002","3",254926305,254928472,2167
"24246","ENSMODG00000034003","3",147997584,148012883,15299
"24247","ENSMODG00000034004","5",146641889,146697276,55387
"24248","ENSMODG00000034006","3",340323620,340324792,1172
"24249","ENSMODG00000034007","1",145318914,145321289,2375
"24250","ENSMODG00000034008","3",144410253,144413099,2846
"24251","ENSMODG00000034009","1",91707507,91710746,3239
"24252","ENSMODG00000034010","6",76866502,76917656,51154
"24253","ENSMODG00000034011","3",200450778,200532559,81781
"24254","ENSMODG00000034012","4",182975188,182980219,5031
"24255","ENSMODG00000034013","1",83048564,83049068,504
"24256","ENSMODG00000034014","1",158260557,158290542,29985
"24257","ENSMODG00000034017","4",24396249,24399556,3307
"24258","ENSMODG00000034018","7",233243058,233245396,2338
"24259","ENSMODG00000034019","5",252104474,252112078,7604
"24260","ENSMODG00000034020","8",86407975,86411115,3140
"24261","ENSMODG00000034021","5",300770321,300772862,2541
"24262","ENSMODG00000034024","4",320836354,320856509,20155
"24263","ENSMODG00000034026","6",229161800,229165380,3580
"24264","ENSMODG00000034028","4",376181790,376187710,5920
"24265","ENSMODG00000034030","Un",75103651,75111651,8000
"24266","ENSMODG00000034031","8",102447845,102454968,7123
"24267","ENSMODG00000034032","3",3316265,3349092,32827
"24268","ENSMODG00000034033","6",278853406,278863717,10311
"24269","ENSMODG00000034034","5",265110057,265110464,407
"24270","ENSMODG00000034035","3",34032610,34042490,9880
"24271","ENSMODG00000034036","1",19024727,19031047,6320
"24272","ENSMODG00000034037","2",140505644,140508457,2813
"24273","ENSMODG00000034038","X",50678771,50683738,4967
"24274","ENSMODG00000034039","8",112371336,112373219,1883
"24275","ENSMODG00000034040","8",34712112,34746059,33947
"24276","ENSMODG00000034041","8",271831851,271832479,628
"24277","ENSMODG00000034042","5",54848389,54858419,10030
"24278","ENSMODG00000034044","8",94092739,94248706,155967
"24279","ENSMODG00000034045","2",301761196,301763111,1915
"24280","ENSMODG00000034046","Un",49127770,49128492,722
"24281","ENSMODG00000034047","X",10523845,10530186,6341
"24282","ENSMODG00000034049","2",140184524,140203069,18545
"24283","ENSMODG00000034050","4",31407215,31439170,31955
"24284","ENSMODG00000034051","1",315780826,315797339,16513
"24285","ENSMODG00000034052","1",420644802,420673000,28198
"24286","ENSMODG00000034053","3",445314869,445327460,12591
"24287","ENSMODG00000034055","1",259582763,259590277,7514
"24288","ENSMODG00000034056","6",287925282,287927736,2454
"24289","ENSMODG00000034057","5",34671003,34673261,2258
"24290","ENSMODG00000034058","8",241074768,241108375,33607
"24291","ENSMODG00000034059","3",475842787,475868959,26172
"24292","ENSMODG00000034061","4",34498757,34501968,3211
"24293","ENSMODG00000034062","8",56212624,56222642,10018
"24294","ENSMODG00000034064","X",22901705,22997789,96084
"24295","ENSMODG00000034065","6",38502770,38503256,486
"24296","ENSMODG00000034067","5",74180004,74224183,44179
"24297","ENSMODG00000034068","3",204791464,204792509,1045
"24298","ENSMODG00000034069","2",137122269,137145184,22915
"24299","ENSMODG00000034070","5",834864,865208,30344
"24300","ENSMODG00000034071","7",125596678,125599978,3300
"24301","ENSMODG00000034072","1",328859668,328892204,32536
"24302","ENSMODG00000034073","3",476786871,476815420,28549
"24303","ENSMODG00000034074","4",111401543,111403519,1976
"24304","ENSMODG00000034075","5",197052853,197186933,134080
"24305","ENSMODG00000034076","5",119772282,119787068,14786
"24306","ENSMODG00000034077","7",257967674,257969452,1778
"24307","ENSMODG00000034078","4",123707119,123708417,1298
"24308","ENSMODG00000034079","2",321429152,321443026,13874
"24309","ENSMODG00000034080","2",530244291,530250451,6160
"24310","ENSMODG00000034081","6",195086111,195095649,9538
"24311","ENSMODG00000034082","8",13625669,13626717,1048
"24312","ENSMODG00000034083","8",108136868,108155099,18231
"24313","ENSMODG00000034084","5",144071638,144073557,1919
"24314","ENSMODG00000034085","1",532256318,532328658,72340
"24315","ENSMODG00000034086","8",5929588,5936226,6638
"24316","ENSMODG00000034087","7",247006829,247016738,9909
"24317","ENSMODG00000034088","8",310035738,310036939,1201
"24318","ENSMODG00000034089","2",156786850,156905818,118968
"24319","ENSMODG00000034090","2",65827215,65829824,2609
"24320","ENSMODG00000034091","3",174499806,174570315,70509
"24321","ENSMODG00000034092","6",201214474,201224645,10171
"24322","ENSMODG00000034093","7",213030099,213031817,1718
"24323","ENSMODG00000034094","7",11352838,11369488,16650
"24324","ENSMODG00000034095","1",52101044,52112538,11494
"24325","ENSMODG00000034096","5",224169300,224173077,3777
"24326","ENSMODG00000034097","8",301205337,301213429,8092
"24327","ENSMODG00000034098","3",448255843,448262318,6475
"24328","ENSMODG00000034099","Un",81915521,81924959,9438
"24329","ENSMODG00000034100","7",232649315,232655110,5795
"24330","ENSMODG00000034102","3",42506282,42525615,19333
"24331","ENSMODG00000034103","7",48276001,48309187,33186
"24332","ENSMODG00000034104","4",368780677,368783484,2807
"24333","ENSMODG00000034106","2",27716555,27717705,1150
"24334","ENSMODG00000034107","4",226791506,226793311,1805
"24335","ENSMODG00000034108","3",171899423,171910619,11196
"24336","ENSMODG00000034109","2",477347628,477355180,7552
"24337","ENSMODG00000034110","2",272909170,273034009,124839
"24338","ENSMODG00000034111","2",527566083,527571573,5490
"24339","ENSMODG00000034112","1",476835745,476956809,121064
"24340","ENSMODG00000034113","2",40233054,40272146,39092
"24341","ENSMODG00000034114","2",459327926,459351054,23128
"24342","ENSMODG00000034115","3",509200041,509202046,2005
"24343","ENSMODG00000034116","2",198665508,198670273,4765
"24344","ENSMODG00000034117","8",279268062,279288107,20045
"24345","ENSMODG00000034118","1",115566514,115589829,23315
"24346","ENSMODG00000034119","7",9450175,9466931,16756
"24347","ENSMODG00000034121","3",34426920,34467158,40238
"24348","ENSMODG00000034122","3",52394481,52625940,231459
"24349","ENSMODG00000034124","6",65081676,65082461,785
"24350","ENSMODG00000034125","1",129177718,129242325,64607
"24351","ENSMODG00000034126","1",472574068,472578174,4106
"24352","ENSMODG00000034127","1",449988814,449996535,7721
"24353","ENSMODG00000034128","8",257621437,257625282,3845
"24354","ENSMODG00000034129","8",251967125,251988470,21345
"24355","ENSMODG00000034130","6",19792980,19802053,9073
"24356","ENSMODG00000034134","6",217233754,217252801,19047
"24357","ENSMODG00000034135","5",6259344,6261940,2596
"24358","ENSMODG00000034136","6",46689070,46696675,7605
"24359","ENSMODG00000034138","X",58478915,58562518,83603
"24360","ENSMODG00000034139","8",225616489,225618173,1684
"24361","ENSMODG00000034140","7",66292658,66305464,12806
"24362","ENSMODG00000034141","6",118467039,118470874,3835
"24363","ENSMODG00000034143","3",205503461,205510303,6842
"24364","ENSMODG00000034144","1",534514941,534552044,37103
"24365","ENSMODG00000034146","X",70020777,70025432,4655
"24366","ENSMODG00000034147","8",143516496,143527829,11333
"24367","ENSMODG00000034149","3",384382120,384386600,4480
"24368","ENSMODG00000034153","3",109008036,109115652,107616
"24369","ENSMODG00000034154","4",226031524,226097001,65477
"24370","ENSMODG00000034155","4",164969399,164981896,12497
"24371","ENSMODG00000034156","4",425697433,425700996,3563
"24372","ENSMODG00000034158","2",513792078,513798207,6129
"24373","ENSMODG00000034159","8",190878758,190886145,7387
"24374","ENSMODG00000034160","1",512472460,512543233,70773
"24375","ENSMODG00000034161","2",459680964,459711714,30750
"24376","ENSMODG00000034162","6",290494076,290495799,1723
"24377","ENSMODG00000034163","1",2667960,2673675,5715
"24378","ENSMODG00000034164","X",58977084,58978997,1913
"24379","ENSMODG00000034165","3",352801613,352832664,31051
"24380","ENSMODG00000034166","5",22445120,22458918,13798
"24381","ENSMODG00000034167","3",320594124,320596591,2467
"24382","ENSMODG00000034168","1",158648338,158660110,11772
"24383","ENSMODG00000034169","8",70623084,70664029,40945
"24384","ENSMODG00000034170","6",276973351,276974991,1640
"24385","ENSMODG00000034172","Un",57056533,57058726,2193
"24386","ENSMODG00000034173","1",440187413,440215383,27970
"24387","ENSMODG00000034174","3",494724973,494734669,9696
"24388","ENSMODG00000034176","3",243609127,243611849,2722
"24389","ENSMODG00000034177","1",150414219,150417441,3222
"24390","ENSMODG00000034178","6",155879014,155886476,7462
"24391","ENSMODG00000034180","2",138393648,138396456,2808
"24392","ENSMODG00000034183","1",526976076,526980309,4233
"24393","ENSMODG00000034184","5",190600752,190617890,17138
"24394","ENSMODG00000034185","Un",8275050,8277324,2274
"24395","ENSMODG00000034186","1",196459083,196460918,1835
"24396","ENSMODG00000034187","2",487676123,487683536,7413
"24397","ENSMODG00000034188","3",75214591,75311576,96985
"24398","ENSMODG00000034189","6",197447035,197447965,930
"24399","ENSMODG00000034190","1",342465561,342494044,28483
"24400","ENSMODG00000034192","3",152000234,152005405,5171
"24401","ENSMODG00000034193","4",14712637,14750117,37480
"24402","ENSMODG00000034195","2",134927203,134949801,22598
"24403","ENSMODG00000034196","4",309905365,309913028,7663
"24404","ENSMODG00000034197","7",76377269,76384822,7553
"24405","ENSMODG00000034198","7",141008105,141013121,5016
"24406","ENSMODG00000034199","X",43501301,43518445,17144
"24407","ENSMODG00000034200","5",284309276,284320181,10905
"24408","ENSMODG00000034201","8",243519219,243564475,45256
"24409","ENSMODG00000034202","5",162379156,162518340,139184
"24410","ENSMODG00000034203","1",194982372,194992386,10014
"24411","ENSMODG00000034204","1",193162207,193233764,71557
"24412","ENSMODG00000034206","1",197474190,197492284,18094
"24413","ENSMODG00000034208","X",51510097,51644637,134540
"24414","ENSMODG00000034209","8",182971030,182971804,774
"24415","ENSMODG00000034211","6",284531746,284534032,2286
"24416","ENSMODG00000034212","3",46519456,46532662,13206
"24417","ENSMODG00000034213","1",219686747,219688052,1305
"24418","ENSMODG00000034215","6",137493606,137500763,7157
"24419","ENSMODG00000034218","7",245803927,245827829,23902
"24420","ENSMODG00000034219","4",420687727,420704799,17072
"24421","ENSMODG00000034220","2",110000573,110001962,1389
"24422","ENSMODG00000034221","3",420019731,420027858,8127
"24423","ENSMODG00000034222","4",20663175,20670212,7037
"24424","ENSMODG00000034223","4",369766780,369767709,929
"24425","ENSMODG00000034226","8",285447603,285465407,17804
"24426","ENSMODG00000034227","2",198231267,198234090,2823
"24427","ENSMODG00000034229","Un",22517816,22518622,806
"24428","ENSMODG00000034230","6",245309430,245325088,15658
"24429","ENSMODG00000034231","1",214308049,214347440,39391
"24430","ENSMODG00000034232","1",143512320,143527867,15547
"24431","ENSMODG00000034233","4",324131979,324135238,3259
"24432","ENSMODG00000034234","6",49250649,49251970,1321
"24433","ENSMODG00000034236","4",192863344,192914948,51604
"24434","ENSMODG00000034237","6",291341512,291371730,30218
"24435","ENSMODG00000034238","5",238197584,238201675,4091
"24436","ENSMODG00000034239","6",16150999,16176854,25855
"24437","ENSMODG00000034240","6",244544708,244665275,120567
"24438","ENSMODG00000034241","2",121154666,121157223,2557
"24439","ENSMODG00000034242","2",460115668,460116425,757
"24440","ENSMODG00000034243","4",113184559,113192547,7988
"24441","ENSMODG00000034244","1",312805545,312818544,12999
"24442","ENSMODG00000034245","7",201036720,201093444,56724
"24443","ENSMODG00000034246","1",467076006,467077123,1117
"24444","ENSMODG00000034247","2",308888903,308896226,7323
"24445","ENSMODG00000034248","8",121067014,121076818,9804
"24446","ENSMODG00000034249","8",167111068,167169520,58452
"24447","ENSMODG00000034251","8",95576504,95577789,1285
"24448","ENSMODG00000034252","3",356473889,356478892,5003
"24449","ENSMODG00000034253","2",79520907,79549713,28806
"24450","ENSMODG00000034254","2",416114049,416122424,8375
"24451","ENSMODG00000034256","1",402757183,402774850,17667
"24452","ENSMODG00000034257","1",520106867,520110762,3895
"24453","ENSMODG00000034258","4",38688090,38699874,11784
"24454","ENSMODG00000034259","5",200078656,200120936,42280
"24455","ENSMODG00000034260","5",194746565,194748941,2376
"24456","ENSMODG00000034261","5",119792967,119797642,4675
"24457","ENSMODG00000034262","5",11146941,11149533,2592
"24458","ENSMODG00000034263","3",200160655,200183962,23307
"24459","ENSMODG00000034265","2",144073815,144075333,1518
"24460","ENSMODG00000034266","6",115009291,115011863,2572
"24461","ENSMODG00000034268","5",2903433,2941738,38305
"24462","ENSMODG00000034270","Un",81840690,81843030,2340
"24463","ENSMODG00000034271","2",505888024,505891882,3858
"24464","ENSMODG00000034272","3",281436904,281446677,9773
"24465","ENSMODG00000034273","6",237267909,237269460,1551
"24466","ENSMODG00000034274","1",48425561,48433772,8211
"24467","ENSMODG00000034276","3",121781920,121782990,1070
"24468","ENSMODG00000034277","4",187764977,187770401,5424
"24469","ENSMODG00000034278","4",170341172,170359681,18509
"24470","ENSMODG00000034280","7",176173136,176204638,31502
"24471","ENSMODG00000034281","1",463859080,463877307,18227
"24472","ENSMODG00000034282","Un",74931659,74932918,1259
"24473","ENSMODG00000034283","3",463831995,463833686,1691
"24474","ENSMODG00000034284","5",16970637,16974652,4015
"24475","ENSMODG00000034285","1",117934296,117940099,5803
"24476","ENSMODG00000034286","4",185440664,185453119,12455
"24477","ENSMODG00000034287","Un",22544680,22545817,1137
"24478","ENSMODG00000034288","6",20805139,20853813,48674
"24479","ENSMODG00000034289","2",432835627,432841969,6342
"24480","ENSMODG00000034290","8",300837764,300844312,6548
"24481","ENSMODG00000034292","1",65724352,65737740,13388
"24482","ENSMODG00000034293","3",329939011,329977497,38486
"24483","ENSMODG00000034294","3",514237546,514248587,11041
"24484","ENSMODG00000034295","8",244178156,244199528,21372
"24485","ENSMODG00000034297","8",215638256,215641308,3052
"24486","ENSMODG00000034298","8",258179375,258220183,40808
"24487","ENSMODG00000034299","3",346331572,346353074,21502
"24488","ENSMODG00000034300","3",166056992,166081320,24328
"24489","ENSMODG00000034301","4",359700022,359736810,36788
"24490","ENSMODG00000034302","3",488992435,489058045,65610
"24491","ENSMODG00000034303","1",524372294,524374488,2194
"24492","ENSMODG00000034304","7",33880754,34020443,139689
"24493","ENSMODG00000034305","2",521468191,521469783,1592
"24494","ENSMODG00000034306","7",254294166,254298978,4812
"24495","ENSMODG00000034307","3",294108273,294111562,3289
"24496","ENSMODG00000034308","2",120289782,120291358,1576
"24497","ENSMODG00000034309","4",71307974,71309428,1454
"24498","ENSMODG00000034310","4",285553175,285554677,1502
"24499","ENSMODG00000034312","4",54473596,54497840,24244
"24500","ENSMODG00000034313","4",257871691,257942783,71092
"24501","ENSMODG00000034314","2",398586091,398594220,8129
"24502","ENSMODG00000034315","8",275432416,275433860,1444
"24503","ENSMODG00000034316","1",314921715,314969839,48124
"24504","ENSMODG00000034317","1",240878138,240886590,8452
"24505","ENSMODG00000034318","1",418754039,418766057,12018
"24506","ENSMODG00000034319","8",79752204,79761625,9421
"24507","ENSMODG00000034320","7",242767583,242768995,1412
"24508","ENSMODG00000034321","1",268484633,268538653,54020
"24509","ENSMODG00000034322","7",162769012,162804737,35725
"24510","ENSMODG00000034323","4",181697686,181706830,9144
"24511","ENSMODG00000034324","6",210272113,210361069,88956
"24512","ENSMODG00000034325","1",450920814,450953758,32944
"24513","ENSMODG00000034326","1",440419167,440424768,5601
"24514","ENSMODG00000034327","1",443054089,443080528,26439
"24515","ENSMODG00000034328","2",84160010,84171939,11929
"24516","ENSMODG00000034329","5",172073966,172099011,25045
"24517","ENSMODG00000034331","2",168786392,168787245,853
"24518","ENSMODG00000034333","1",533883535,533908579,25044
"24519","ENSMODG00000034334","6",290136097,290155941,19844
"24520","ENSMODG00000034335","5",126930437,126947579,17142
"24521","ENSMODG00000034336","3",418107432,418163834,56402
"24522","ENSMODG00000034338","Un",48249233,48266856,17623
"24523","ENSMODG00000034339","8",12876478,12887050,10572
"24524","ENSMODG00000034340","7",26444154,26447398,3244
"24525","ENSMODG00000034343","4",343005294,343020139,14845
"24526","ENSMODG00000034344","1",343612515,343648470,35955
"24527","ENSMODG00000034346","5",238659573,238661438,1865
"24528","ENSMODG00000034347","2",193637978,193664438,26460
"24529","ENSMODG00000034348","6",117404993,117424244,19251
"24530","ENSMODG00000034349","X",24984448,24991449,7001
"24531","ENSMODG00000034351","4",5448482,5452767,4285
"24532","ENSMODG00000034353","7",142989302,143033342,44040
"24533","ENSMODG00000034354","Un",94690715,94694020,3305
"24534","ENSMODG00000034355","1",507796476,507806196,9720
"24535","ENSMODG00000034357","8",251127435,251147299,19864
"24536","ENSMODG00000034359","8",196790701,196803584,12883
"24537","ENSMODG00000034360","8",219430946,219432274,1328
"24538","ENSMODG00000034361","2",470163124,470165792,2668
"24539","ENSMODG00000034362","3",421239584,421297658,58074
"24540","ENSMODG00000034364","3",16008681,16012481,3800
"24541","ENSMODG00000034365","8",305682335,305686801,4466
"24542","ENSMODG00000034366","2",13033734,13054825,21091
"24543","ENSMODG00000034368","3",516032343,516049862,17519
"24544","ENSMODG00000034369","3",463662606,463686818,24212
"24545","ENSMODG00000034370","7",108413123,108426933,13810
"24546","ENSMODG00000034371","5",250489153,250490589,1436
"24547","ENSMODG00000034372","6",118778078,118787683,9605
"24548","ENSMODG00000034373","8",11639648,11642545,2897
"24549","ENSMODG00000034376","3",475021955,475023142,1187
"24550","ENSMODG00000034377","2",288256984,288261626,4642
"24551","ENSMODG00000034378","7",210976641,210980425,3784
"24552","ENSMODG00000034380","8",214073186,214088284,15098
"24553","ENSMODG00000034382","Un",22589174,22622977,33803
"24554","ENSMODG00000034383","8",271941462,271949567,8105
"24555","ENSMODG00000034384","Un",54282759,54286677,3918
"24556","ENSMODG00000034386","2",438034092,438037493,3401
"24557","ENSMODG00000034387","7",252433996,252445037,11041
"24558","ENSMODG00000034389","8",271907940,271917769,9829
"24559","ENSMODG00000034390","1",477146602,477189664,43062
"24560","ENSMODG00000034391","7",19422660,19429990,7330
"24561","ENSMODG00000034392","3",449692507,449701001,8494
"24562","ENSMODG00000034393","8",145398749,145402889,4140
"24563","ENSMODG00000034395","4",434816893,434829415,12522
"24564","ENSMODG00000034396","3",171592367,171598625,6258
"24565","ENSMODG00000034398","4",133288145,133292198,4053
"24566","ENSMODG00000034399","2",155456399,155497359,40960
"24567","ENSMODG00000034400","Un",46466141,46468117,1976
"24568","ENSMODG00000034402","1",404055884,404056799,915
"24569","ENSMODG00000034403","3",21318767,21377828,59061
"24570","ENSMODG00000034404","4",397759150,397762219,3069
"24571","ENSMODG00000034406","8",201641513,201645955,4442
"24572","ENSMODG00000034408","5",108514719,108530553,15834
"24573","ENSMODG00000034409","8",280542859,280586578,43719
"24574","ENSMODG00000034410","8",74734214,74784588,50374
"24575","ENSMODG00000034411","Un",28620212,28624009,3797
"24576","ENSMODG00000034412","3",70891282,70895681,4399
"24577","ENSMODG00000034413","2",472791113,472799383,8270
"24578","ENSMODG00000034414","3",26153408,26160542,7134
"24579","ENSMODG00000034415","3",234632985,234678125,45140
"24580","ENSMODG00000034416","8",262323526,262342686,19160
"24581","ENSMODG00000034419","6",124135698,124139854,4156
"24582","ENSMODG00000034420","8",192150648,192174629,23981
"24583","ENSMODG00000034421","8",18597278,18603257,5979
"24584","ENSMODG00000034422","X",65062482,65127411,64929
"24585","ENSMODG00000034423","8",14380865,14388271,7406
"24586","ENSMODG00000034424","3",428712538,428715890,3352
"24587","ENSMODG00000034426","1",82307986,82309142,1156
"24588","ENSMODG00000034427","2",61299637,61335471,35834
"24589","ENSMODG00000034428","8",242111409,242121389,9980
"24590","ENSMODG00000034429","5",173920681,173921782,1101
"24591","ENSMODG00000034430","1",56258342,56262339,3997
"24592","ENSMODG00000034431","5",189010842,189089757,78915
"24593","ENSMODG00000034432","2",112287749,112306833,19084
"24594","ENSMODG00000034433","6",2037726,2063238,25512
"24595","ENSMODG00000034434","8",243234635,243259168,24533
"24596","ENSMODG00000034436","8",214900333,214928863,28530
"24597","ENSMODG00000034437","4",77204463,77209489,5026
"24598","ENSMODG00000034438","Un",60342946,60346353,3407
"24599","ENSMODG00000034440","3",337772388,337773951,1563
"24600","ENSMODG00000034442","4",188876565,188879212,2647
"24601","ENSMODG00000034443","Un",59443217,59444867,1650
"24602","ENSMODG00000034444","2",77148953,77150571,1618
"24603","ENSMODG00000034446","1",230075251,230083556,8305
"24604","ENSMODG00000034448","5",254237310,254262354,25044
"24605","ENSMODG00000034449","7",19362169,19363674,1505
"24606","ENSMODG00000034450","2",373782699,373785045,2346
"24607","ENSMODG00000034451","3",324692930,324695096,2166
"24608","ENSMODG00000034453","7",194089401,194091741,2340
"24609","ENSMODG00000034456","8",130392622,130669017,276395
"24610","ENSMODG00000034459","7",138447578,138488136,40558
"24611","ENSMODG00000034460","3",32946373,32949648,3275
"24612","ENSMODG00000034461","3",417399120,417402409,3289
"24613","ENSMODG00000034462","4",236724319,236782260,57941
"24614","ENSMODG00000034463","5",301757504,301761325,3821
"24615","ENSMODG00000034465","1",435338765,435380896,42131
"24616","ENSMODG00000034466","4",174786698,174835549,48851
"24617","ENSMODG00000034467","4",61849589,61868636,19047
"24618","ENSMODG00000034468","4",147864844,147932973,68129
"24619","ENSMODG00000034469","1",515028932,515044163,15231
"24620","ENSMODG00000034470","2",214730360,214735447,5087
"24621","ENSMODG00000034472","3",369127537,369129627,2090
"24622","ENSMODG00000034474","3",182109410,182351899,242489
"24623","ENSMODG00000034475","1",406519256,406582932,63676
"24624","ENSMODG00000034476","2",356735378,356736360,982
"24625","ENSMODG00000034477","3",158942304,158988413,46109
"24626","ENSMODG00000034478","2",205744700,205749282,4582
"24627","ENSMODG00000034480","3",453593748,453626506,32758
"24628","ENSMODG00000034481","7",153479128,153487050,7922
"24629","ENSMODG00000034483","5",86270359,86421994,151635
"24630","ENSMODG00000034484","2",186757256,186766411,9155
"24631","ENSMODG00000034485","1",129577580,129591477,13897
"24632","ENSMODG00000034486","4",407584735,407590245,5510
"24633","ENSMODG00000034487","Un",59734705,59737662,2957
"24634","ENSMODG00000034488","3",436829967,436833641,3674
"24635","ENSMODG00000034489","Un",92566480,92569983,3503
"24636","ENSMODG00000034490","7",259831167,259898502,67335
"24637","ENSMODG00000034493","6",108682254,108749328,67074
"24638","ENSMODG00000034495","4",189884587,189914832,30245
"24639","ENSMODG00000034496","2",429870041,429889910,19869
"24640","ENSMODG00000034497","6",81743093,81747276,4183
"24641","ENSMODG00000034498","4",362837600,362841788,4188
"24642","ENSMODG00000034499","7",142400004,142578913,178909
"24643","ENSMODG00000034500","3",449172268,449179079,6811
"24644","ENSMODG00000034501","8",155117989,155166750,48761
"24645","ENSMODG00000034502","8",286892886,286999481,106595
"24646","ENSMODG00000034503","6",270559867,270562792,2925
"24647","ENSMODG00000034505","3",50021229,50056295,35066
"24648","ENSMODG00000034506","8",68820708,68839790,19082
"24649","ENSMODG00000034507","2",446818753,446866655,47902
"24650","ENSMODG00000034508","4",360836830,360859351,22521
"24651","ENSMODG00000034509","4",375165466,375174857,9391
"24652","ENSMODG00000034511","5",248365445,248408200,42755
"24653","ENSMODG00000034512","3",300998347,301029191,30844
"24654","ENSMODG00000034513","1",58189925,58201153,11228
"24655","ENSMODG00000034515","3",11583835,11585248,1413
"24656","ENSMODG00000034517","X",58954140,58974511,20371
"24657","ENSMODG00000034518","7",222293332,222308446,15114
"24658","ENSMODG00000034520","1",276262466,276281186,18720
"24659","ENSMODG00000034522","Un",73318620,73321101,2481
"24660","ENSMODG00000034523","X",20046712,20195081,148369
"24661","ENSMODG00000034525","8",90320011,90322412,2401
"24662","ENSMODG00000034526","1",515007840,515039185,31345
"24663","ENSMODG00000034528","3",303536582,303546018,9436
"24664","ENSMODG00000034529","4",357823898,357827075,3177
"24665","ENSMODG00000034530","6",194126687,194129282,2595
"24666","ENSMODG00000034531","6",15224362,15246877,22515
"24667","ENSMODG00000034532","4",349438415,349440891,2476
"24668","ENSMODG00000034533","2",168225303,168229459,4156
"24669","ENSMODG00000034534","Un",59546451,59558112,11661
"24670","ENSMODG00000034535","Un",96279705,96282564,2859
"24671","ENSMODG00000034537","Un",34439267,34544735,105468
"24672","ENSMODG00000034538","4",281332498,281337305,4807
"24673","ENSMODG00000034539","1",495716566,495725203,8637
"24674","ENSMODG00000034541","3",100206249,100213601,7352
"24675","ENSMODG00000034542","6",205171569,205179909,8340
"24676","ENSMODG00000034545","2",91951642,91964678,13036
"24677","ENSMODG00000034546","1",237131802,237259565,127763
"24678","ENSMODG00000034547","1",232191806,232193197,1391
"24679","ENSMODG00000034548","2",28321351,28329902,8551
"24680","ENSMODG00000034550","5",167249856,167255453,5597
"24681","ENSMODG00000034551","3",319515241,319515935,694
"24682","ENSMODG00000034552","3",475608797,475623549,14752
"24683","ENSMODG00000034554","8",181838221,181890548,52327
"24684","ENSMODG00000034555","2",114205937,114216684,10747
"24685","ENSMODG00000034556","Un",39200609,39297611,97002
"24686","ENSMODG00000034557","4",135557218,135558942,1724
"24687","ENSMODG00000034559","2",67564290,67582250,17960
"24688","ENSMODG00000034561","3",348606306,348629592,23286
"24689","ENSMODG00000034562","2",155101291,155102326,1035
"24690","ENSMODG00000034563","2",408976228,409015023,38795
"24691","ENSMODG00000034564","X",15221666,15225298,3632
"24692","ENSMODG00000034566","3",389546646,389576771,30125
"24693","ENSMODG00000034569","2",518099471,518126053,26582
"24694","ENSMODG00000034570","3",294805688,294815555,9867
"24695","ENSMODG00000034571","4",123606548,123611729,5181
"24696","ENSMODG00000034572","X",33021266,33028495,7229
"24697","ENSMODG00000034573","1",448544277,448546375,2098
"24698","ENSMODG00000034575","7",127551264,127554328,3064
"24699","ENSMODG00000034576","2",103297359,103298902,1543
"24700","ENSMODG00000034578","3",87706572,87708126,1554
"24701","ENSMODG00000034579","2",494582346,494583777,1431
"24702","ENSMODG00000034580","1",244702542,244734774,32232
"24703","ENSMODG00000034581","3",90446646,90472512,25866
"24704","ENSMODG00000034582","1",157281427,157283198,1771
"24705","ENSMODG00000034585","6",235695548,235744332,48784
"24706","ENSMODG00000034586","2",99925509,99972181,46672
"24707","ENSMODG00000034589","Un",71912808,71920719,7911
"24708","ENSMODG00000034590","8",284474527,284481542,7015
"24709","ENSMODG00000034591","1",248051960,248056666,4706
"24710","ENSMODG00000034592","1",172458321,172466174,7853
"24711","ENSMODG00000034593","8",18570699,18572189,1490
"24712","ENSMODG00000034594","1",368092662,368101671,9009
"24713","ENSMODG00000034595","3",464907565,464909957,2392
"24714","ENSMODG00000034596","7",169903325,169934956,31631
"24715","ENSMODG00000034597","6",46496884,46686870,189986
"24716","ENSMODG00000034598","Un",22392835,22419169,26334
"24717","ENSMODG00000034599","3",203543451,203549530,6079
"24718","ENSMODG00000034600","3",184895419,184896365,946
"24719","ENSMODG00000034601","1",294415974,294418453,2479
"24720","ENSMODG00000034602","5",143422151,143423142,991
"24721","ENSMODG00000034603","2",506584557,506586067,1510
"24722","ENSMODG00000034605","7",245783614,245787276,3662
"24723","ENSMODG00000034606","6",225935750,225942214,6464
"24724","ENSMODG00000034607","Un",23923719,23931002,7283
"24725","ENSMODG00000034609","2",23326649,23337878,11229
"24726","ENSMODG00000034610","3",250347397,250371059,23662
"24727","ENSMODG00000034612","3",188480562,188482769,2207
"24728","ENSMODG00000034613","4",161696296,161721605,25309
"24729","ENSMODG00000034614","2",250962980,250965329,2349
"24730","ENSMODG00000034615","4",241943675,241944715,1040
"24731","ENSMODG00000034616","7",168626735,168662266,35531
"24732","ENSMODG00000034617","5",75298430,75300636,2206
"24733","ENSMODG00000034618","2",326126875,326139009,12134
"24734","ENSMODG00000034620","7",218591257,218625375,34118
"24735","ENSMODG00000034621","Un",79224393,79232138,7745
"24736","ENSMODG00000034622","1",220585130,220598263,13133
"24737","ENSMODG00000034624","3",441742833,441775801,32968
"24738","ENSMODG00000034625","4",6474039,6491188,17149
"24739","ENSMODG00000034628","1",268194640,268224186,29546
"24740","ENSMODG00000034629","2",27666072,27667370,1298
"24741","ENSMODG00000034631","3",255981061,256065561,84500
"24742","ENSMODG00000034634","4",16094434,16153904,59470
"24743","ENSMODG00000034635","5",228673874,228676587,2713
"24744","ENSMODG00000034636","8",78932808,78937271,4463
"24745","ENSMODG00000034637","1",306937738,306953354,15616
"24746","ENSMODG00000034638","X",64662263,64663397,1134
"24747","ENSMODG00000034639","8",273085442,273086925,1483
"24748","ENSMODG00000034640","2",519726676,519729808,3132
"24749","ENSMODG00000034641","2",156706914,156777441,70527
"24750","ENSMODG00000034642","1",230967427,231080962,113535
"24751","ENSMODG00000034643","5",215156261,215167622,11361
"24752","ENSMODG00000034644","2",528413578,528432195,18617
"24753","ENSMODG00000034646","4",286488424,286496366,7942
"24754","ENSMODG00000034647","Un",39764006,39764993,987
"24755","ENSMODG00000034648","8",56406837,56428114,21277
"24756","ENSMODG00000034649","7",33533052,33724876,191824
"24757","ENSMODG00000034652","3",165336521,165414471,77950
"24758","ENSMODG00000034653","1",159201174,159207915,6741
"24759","ENSMODG00000034654","3",456611805,456638845,27040
"24760","ENSMODG00000034655","8",84663821,84696315,32494
"24761","ENSMODG00000034657","7",150479979,150501368,21389
"24762","ENSMODG00000034658","6",185316150,185317832,1682
"24763","ENSMODG00000034660","6",223586016,223586583,567
"24764","ENSMODG00000034662","2",388653462,388726472,73010
"24765","ENSMODG00000034663","3",274256648,274284533,27885
"24766","ENSMODG00000034664","7",259080827,259082171,1344
"24767","ENSMODG00000034665","1",331075783,331221595,145812
"24768","ENSMODG00000034666","7",26723583,26733519,9936
"24769","ENSMODG00000034668","4",315819085,315858642,39557
"24770","ENSMODG00000034669","8",231756294,231762096,5802
"24771","ENSMODG00000034670","8",288946938,289145645,198707
"24772","ENSMODG00000034673","3",37361138,37372922,11784
"24773","ENSMODG00000034674","7",65105401,65106778,1377
"24774","ENSMODG00000034675","3",347190325,347193123,2798
"24775","ENSMODG00000034676","1",533263633,533264445,812
"24776","ENSMODG00000034677","3",411306039,411316138,10099
"24777","ENSMODG00000034678","X",57802729,57805457,2728
"24778","ENSMODG00000034680","5",201357542,201373442,15900
"24779","ENSMODG00000034682","2",454416000,454417538,1538
"24780","ENSMODG00000034683","4",282545060,282556505,11445
"24781","ENSMODG00000034684","4",24441003,24615583,174580
"24782","ENSMODG00000034685","7",162042478,162044906,2428
"24783","ENSMODG00000034686","3",363705815,363710035,4220
"24784","ENSMODG00000034687","5",156937846,156940695,2849
"24785","ENSMODG00000034689","8",260541248,260548090,6842
"24786","ENSMODG00000034690","1",326998771,327003306,4535
"24787","ENSMODG00000034692","8",45364492,45391803,27311
"24788","ENSMODG00000034693","3",77704886,77708818,3932
"24789","ENSMODG00000034694","1",432317081,432327029,9948
"24790","ENSMODG00000034695","3",439885895,439887988,2093
"24791","ENSMODG00000034697","8",157827636,157837079,9443
"24792","ENSMODG00000034698","4",120207983,120328598,120615
"24793","ENSMODG00000034700","3",18201572,18204072,2500
"24794","ENSMODG00000034702","1",375001144,375022180,21036
"24795","ENSMODG00000034707","3",294779912,294903615,123703
"24796","ENSMODG00000034708","8",243888829,243889795,966
"24797","ENSMODG00000034709","4",84185795,84191033,5238
"24798","ENSMODG00000034710","8",162938467,162953851,15384
"24799","ENSMODG00000034711","4",77780755,77781587,832
"24800","ENSMODG00000034712","7",181649427,181652439,3012
"24801","ENSMODG00000034713","2",362592816,362614333,21517
"24802","ENSMODG00000034714","5",89421561,89438251,16690
"24803","ENSMODG00000034715","7",98328895,98329444,549
"24804","ENSMODG00000034717","1",107983200,108007769,24569
"24805","ENSMODG00000034718","5",109260104,109544004,283900
"24806","ENSMODG00000034719","7",244788055,244794412,6357
"24807","ENSMODG00000034720","2",54793099,54902038,108939
"24808","ENSMODG00000034721","5",56743522,56829790,86268
"24809","ENSMODG00000034722","4",194225970,194230504,4534
"24810","ENSMODG00000034723","4",15151762,15181117,29355
"24811","ENSMODG00000034725","7",139490381,139630064,139683
"24812","ENSMODG00000034726","8",94526972,94844797,317825
"24813","ENSMODG00000034727","4",161584910,161624416,39506
"24814","ENSMODG00000034728","7",232645850,232648420,2570
"24815","ENSMODG00000034729","6",203430989,203451262,20273
"24816","ENSMODG00000034730","1",383783408,383788933,5525
"24817","ENSMODG00000034731","3",330673073,330678169,5096
"24818","ENSMODG00000034732","4",317541345,317605781,64436
"24819","ENSMODG00000034733","6",224365380,224442825,77445
"24820","ENSMODG00000034734","3",398774824,398854412,79588
"24821","ENSMODG00000034735","5",56668689,56683338,14649
"24822","ENSMODG00000034738","1",176629771,176644243,14472
"24823","ENSMODG00000034739","2",308321713,308323766,2053
"24824","ENSMODG00000034740","5",275352390,275364581,12191
"24825","ENSMODG00000034741","7",247663096,247665220,2124
"24826","ENSMODG00000034742","2",176072161,176084194,12033
"24827","ENSMODG00000034743","2",337284297,337394967,110670
"24828","ENSMODG00000034744","5",173394271,173406468,12197
"24829","ENSMODG00000034745","5",23290785,23297083,6298
"24830","ENSMODG00000034748","6",5297654,5301531,3877
"24831","ENSMODG00000034752","5",172138400,172139825,1425
"24832","ENSMODG00000034753","4",94262257,94277402,15145
"24833","ENSMODG00000034755","1",126788059,126791636,3577
"24834","ENSMODG00000034756","1",214519762,214523032,3270
"24835","ENSMODG00000034757","1",356030489,356034870,4381
"24836","ENSMODG00000034758","1",302113327,302120581,7254
"24837","ENSMODG00000034759","8",169934911,169943408,8497
"24838","ENSMODG00000034760","5",64824496,64831600,7104
"24839","ENSMODG00000034762","Un",88866169,88867275,1106
"24840","ENSMODG00000034763","1",485001160,485177822,176662
"24841","ENSMODG00000034764","3",1036568,1037902,1334
"24842","ENSMODG00000034766","4",146870028,146901911,31883
"24843","ENSMODG00000034767","8",149686885,149690174,3289
"24844","ENSMODG00000034768","4",303086842,303156447,69605
"24845","ENSMODG00000034769","8",120949743,120953194,3451
"24846","ENSMODG00000034770","2",365500478,365572494,72016
"24847","ENSMODG00000034771","3",461853290,461855497,2207
"24848","ENSMODG00000034772","6",217106374,217155959,49585
"24849","ENSMODG00000034773","8",158010463,158014232,3769
"24850","ENSMODG00000034774","8",204808824,204811071,2247
"24851","ENSMODG00000034775","3",19799060,19803094,4034
"24852","ENSMODG00000034776","1",390951714,390958247,6533
"24853","ENSMODG00000034777","1",505367090,505372950,5860
"24854","ENSMODG00000034778","8",309297045,309297433,388
"24855","ENSMODG00000034779","4",365152039,365168346,16307
"24856","ENSMODG00000034780","4",39871200,39885541,14341
"24857","ENSMODG00000034781","8",272108583,272296862,188279
"24858","ENSMODG00000034783","6",122382222,122384668,2446
"24859","ENSMODG00000034784","2",480369881,480380529,10648
"24860","ENSMODG00000034785","4",280600463,280602235,1772
"24861","ENSMODG00000034787","1",309644794,309665306,20512
"24862","ENSMODG00000034788","3",35007854,35009659,1805
"24863","ENSMODG00000034789","4",30944106,31002246,58140
"24864","ENSMODG00000034790","7",28520426,28530366,9940
"24865","ENSMODG00000034791","2",116370632,116677803,307171
"24866","ENSMODG00000034792","3",44935840,44938254,2414
"24867","ENSMODG00000034793","3",316254789,316270787,15998
"24868","ENSMODG00000034794","Un",27762568,27763910,1342
"24869","ENSMODG00000034797","3",280872066,280873187,1121
"24870","ENSMODG00000034798","2",118452530,118457108,4578
"24871","ENSMODG00000034799","3",4511250,4516256,5006
"24872","ENSMODG00000034800","X",69366520,69372810,6290
"24873","ENSMODG00000034801","4",336000644,336003933,3289
"24874","ENSMODG00000034802","8",214881900,214884508,2608
"24875","ENSMODG00000034803","7",129030601,129033814,3213
"24876","ENSMODG00000034804","8",74442196,74475190,32994
"24877","ENSMODG00000034805","X",14872583,14978387,105804
"24878","ENSMODG00000034807","2",426092265,426106214,13949
"24879","ENSMODG00000034808","8",265497574,265498559,985
"24880","ENSMODG00000034809","3",424022240,424139159,116919
"24881","ENSMODG00000034811","4",148956212,148957034,822
"24882","ENSMODG00000034812","4",11318596,11319617,1021
"24883","ENSMODG00000034813","6",291364801,291385602,20801
"24884","ENSMODG00000034815","6",202676852,202690162,13310
"24885","ENSMODG00000034816","6",43301483,43454032,152549
"24886","ENSMODG00000034817","1",248203230,248222233,19003
"24887","ENSMODG00000034818","1",52315372,52327858,12486
"24888","ENSMODG00000034819","1",148090337,148091427,1090
"24889","ENSMODG00000034820","3",6916140,6923738,7598
"24890","ENSMODG00000034821","1",14496660,14497254,594
"24891","ENSMODG00000034822","3",4348646,4349616,970
"24892","ENSMODG00000034823","4",25261034,25274901,13867
"24893","ENSMODG00000034824","5",62284882,62299688,14806
"24894","ENSMODG00000034825","7",168441332,168682444,241112
"24895","ENSMODG00000034826","7",19298669,19300288,1619
"24896","ENSMODG00000034827","1",418435761,418441839,6078
"24897","ENSMODG00000034828","4",94142880,94152328,9448
"24898","ENSMODG00000034831","7",204917704,204927019,9315
"24899","ENSMODG00000034832","5",188159917,188221582,61665
"24900","ENSMODG00000034833","1",128021982,128023932,1950
"24901","ENSMODG00000034834","7",11761727,11772444,10717
"24902","ENSMODG00000034837","1",194079786,194084421,4635
"24903","ENSMODG00000034838","3",21813682,21814900,1218
"24904","ENSMODG00000034839","2",353038216,353128347,90131
"24905","ENSMODG00000034840","5",202759121,202873503,114382
"24906","ENSMODG00000034841","2",325625858,325638858,13000
"24907","ENSMODG00000034842","1",21076743,21077791,1048
"24908","ENSMODG00000034844","8",129990300,129993346,3046
"24909","ENSMODG00000034845","3",427493709,427508368,14659
"24910","ENSMODG00000034846","6",147964218,147970050,5832
"24911","ENSMODG00000034847","1",490929315,490941792,12477
"24912","ENSMODG00000034848","Un",33529825,33532155,2330
"24913","ENSMODG00000034849","7",162610602,162634813,24211
"24914","ENSMODG00000034851","8",284827037,284940070,113033
"24915","ENSMODG00000034852","5",280410671,280462117,51446
"24916","ENSMODG00000034853","5",81991558,82031572,40014
"24917","ENSMODG00000034854","4",337391316,337410791,19475
"24918","ENSMODG00000034855","1",530048101,530065182,17081
"24919","ENSMODG00000034856","4",15574570,15603616,29046
"24920","ENSMODG00000034857","4",219668819,219671973,3154
"24921","ENSMODG00000034858","3",441390876,441396149,5273
"24922","ENSMODG00000034859","5",167349480,167350836,1356
"24923","ENSMODG00000034860","6",115884513,115887415,2902
"24924","ENSMODG00000034861","6",268680771,268699140,18369
"24925","ENSMODG00000034862","2",339178206,339295374,117168
"24926","ENSMODG00000034864","1",434473070,434493697,20627
"24927","ENSMODG00000034866","4",235828104,235829009,905
"24928","ENSMODG00000034867","3",412663544,412702868,39324
"24929","ENSMODG00000034868","8",109929332,109932869,3537
"24930","ENSMODG00000034869","1",55472621,55482766,10145
"24931","ENSMODG00000034873","6",22363541,22378253,14712
"24932","ENSMODG00000034874","2",201289151,201291485,2334
"24933","ENSMODG00000034875","7",86441685,86489528,47843
"24934","ENSMODG00000034876","4",81658478,81762030,103552
"24935","ENSMODG00000034877","6",274483069,274538892,55823
"24936","ENSMODG00000034879","5",207427202,207516066,88864
"24937","ENSMODG00000034880","5",161541200,161548424,7224
"24938","ENSMODG00000034881","3",263114438,263181722,67284
"24939","ENSMODG00000034884","5",42059536,42060743,1207
"24940","ENSMODG00000034885","3",95092574,95246358,153784
"24941","ENSMODG00000034886","Un",66588097,66601490,13393
"24942","ENSMODG00000034888","7",168618861,168620359,1498
"24943","ENSMODG00000034889","5",257568286,257569205,919
"24944","ENSMODG00000034890","1",531887189,531978567,91378
"24945","ENSMODG00000034893","1",221712115,221782232,70117
"24946","ENSMODG00000034895","7",175750159,175753183,3024
"24947","ENSMODG00000034896","4",10856013,10917400,61387
"24948","ENSMODG00000034898","7",4721617,4830705,109088
"24949","ENSMODG00000034899","1",360926355,360942297,15942
"24950","ENSMODG00000034901","7",230753326,230775070,21744
"24951","ENSMODG00000034902","X",10081237,10082236,999
"24952","ENSMODG00000034903","5",246655563,246656339,776
"24953","ENSMODG00000034904","4",389672488,389674020,1532
"24954","ENSMODG00000034905","1",331721144,331725090,3946
"24955","ENSMODG00000034906","3",225963849,225968728,4879
"24956","ENSMODG00000034907","8",253867144,253872428,5284
"24957","ENSMODG00000034908","8",168130582,168261134,130552
"24958","ENSMODG00000034909","6",221859156,221921324,62168
"24959","ENSMODG00000034910","3",366389270,366433150,43880
"24960","ENSMODG00000034912","6",6205764,6214012,8248
"24961","ENSMODG00000034913","7",79472357,79474594,2237
"24962","ENSMODG00000034914","4",264734477,264738090,3613
"24963","ENSMODG00000034915","Un",32494221,32495278,1057
"24964","ENSMODG00000034916","3",405249100,405276543,27443
"24965","ENSMODG00000034918","5",216246237,216257240,11003
"24966","ENSMODG00000034919","5",92141192,92157241,16049
"24967","ENSMODG00000034920","2",15292962,15295577,2615
"24968","ENSMODG00000034921","3",245611523,245619750,8227
"24969","ENSMODG00000034922","5",280085255,280106068,20813
"24970","ENSMODG00000034923","4",154821374,154845948,24574
"24971","ENSMODG00000034924","Un",28305375,28313950,8575
"24972","ENSMODG00000034925","1",42208363,42224691,16328
"24973","ENSMODG00000034927","2",155741505,155747221,5716
"24974","ENSMODG00000034928","3",519594546,519595337,791
"24975","ENSMODG00000034929","Un",1809483,1811415,1932
"24976","ENSMODG00000034930","1",172258354,172265564,7210
"24977","ENSMODG00000034931","8",161647760,161648626,866
"24978","ENSMODG00000034932","5",1944865,1946698,1833
"24979","ENSMODG00000034934","2",136418903,136420001,1098
"24980","ENSMODG00000034935","3",319684202,319741509,57307
"24981","ENSMODG00000034936","3",317759309,317766725,7416
"24982","ENSMODG00000034938","1",297701706,297825237,123531
"24983","ENSMODG00000034939","4",105312058,105323024,10966
"24984","ENSMODG00000034940","2",18691581,18694563,2982
"24985","ENSMODG00000034941","1",216181107,216211697,30590
"24986","ENSMODG00000034942","2",392547360,392656871,109511
"24987","ENSMODG00000034943","8",298162464,298169212,6748
"24988","ENSMODG00000034946","3",414563814,414665410,101596
"24989","ENSMODG00000034947","3",249005339,249007497,2158
"24990","ENSMODG00000034948","2",375696621,375701257,4636
"24991","ENSMODG00000034949","1",11006731,11009064,2333
"24992","ENSMODG00000034950","Un",65737051,65741462,4411
"24993","ENSMODG00000034951","4",305991129,305996752,5623
"24994","ENSMODG00000034953","8",173619435,173624493,5058
"24995","ENSMODG00000034954","7",204019408,204027839,8431
"24996","ENSMODG00000034955","4",25530284,25574502,44218
"24997","ENSMODG00000034957","4",301370887,301404585,33698
"24998","ENSMODG00000034959","4",112066970,112207308,140338
"24999","ENSMODG00000034960","5",20599139,20613978,14839
"25000","ENSMODG00000034962","6",236792328,236797451,5123
"25001","ENSMODG00000034964","3",463702621,463706606,3985
"25002","ENSMODG00000034965","2",237905836,237915934,10098
"25003","ENSMODG00000034966","X",37310208,37320923,10715
"25004","ENSMODG00000034967","2",163933557,163940616,7059
"25005","ENSMODG00000034968","Un",73819974,73829824,9850
"25006","ENSMODG00000034969","3",75713631,75714913,1282
"25007","ENSMODG00000034973","1",527403784,527406752,2968
"25008","ENSMODG00000034974","3",239374029,239469265,95236
"25009","ENSMODG00000034975","1",263554369,263561801,7432
"25010","ENSMODG00000034976","2",143724771,143725373,602
"25011","ENSMODG00000034977","4",360001462,360003746,2284
"25012","ENSMODG00000034978","7",229240830,229250406,9576
"25013","ENSMODG00000034979","7",118746996,118891645,144649
"25014","ENSMODG00000034980","6",186854458,186891458,37000
"25015","ENSMODG00000034981","8",58165955,58186683,20728
"25016","ENSMODG00000034982","3",295797155,295812994,15839
"25017","ENSMODG00000034983","4",19764877,19779285,14408
"25018","ENSMODG00000034984","6",88006346,88030159,23813
"25019","ENSMODG00000034985","6",281061807,281071090,9283
"25020","ENSMODG00000034986","6",250540929,250542504,1575
"25021","ENSMODG00000034987","1",64844788,64855059,10271
"25022","ENSMODG00000034988","1",27823951,27824842,891
"25023","ENSMODG00000034989","8",90988992,90992832,3840
"25024","ENSMODG00000034990","6",77845086,77855034,9948
"25025","ENSMODG00000034991","7",208720210,208726798,6588
"25026","ENSMODG00000034993","Un",85191887,85298651,106764
"25027","ENSMODG00000034994","4",201330635,201437583,106948
"25028","ENSMODG00000034995","6",173064733,173085092,20359
"25029","ENSMODG00000034997","5",795321,807736,12415
"25030","ENSMODG00000034999","5",20583852,20586574,2722
"25031","ENSMODG00000035000","8",31018805,31022996,4191
"25032","ENSMODG00000035001","6",5059882,5213807,153925
"25033","ENSMODG00000035003","6",134072475,134075524,3049
"25034","ENSMODG00000035004","6",25081008,25273918,192910
"25035","ENSMODG00000035005","7",259788860,259817490,28630
"25036","ENSMODG00000035006","4",338498025,338603054,105029
"25037","ENSMODG00000035007","6",256678374,256704516,26142
"25038","ENSMODG00000035008","4",374043729,374053207,9478
"25039","ENSMODG00000035009","5",98055467,98057002,1535
"25040","ENSMODG00000035010","Un",62304303,62307629,3326
"25041","ENSMODG00000035011","7",3793733,3797305,3572
"25042","ENSMODG00000035012","8",276146038,276151560,5522
"25043","ENSMODG00000035013","6",198965766,198968564,2798
"25044","ENSMODG00000035014","1",77857761,77858467,706
"25045","ENSMODG00000035016","4",66360961,66388372,27411
"25046","ENSMODG00000035017","4",182627998,182663207,35209
"25047","ENSMODG00000035018","7",138955496,138957545,2049
"25048","ENSMODG00000035019","2",193915544,193917332,1788
"25049","ENSMODG00000035020","4",133854515,133878922,24407
"25050","ENSMODG00000035021","1",419352259,419396641,44382
"25051","ENSMODG00000035023","2",479541661,479556947,15286
"25052","ENSMODG00000035025","3",330393417,330399775,6358
"25053","ENSMODG00000035026","2",71687065,71706368,19303
"25054","ENSMODG00000035027","2",480120008,480125605,5597
"25055","ENSMODG00000035028","7",212410625,212415454,4829
"25056","ENSMODG00000035030","4",3919978,3944279,24301
"25057","ENSMODG00000035032","6",162945684,163034285,88601
"25058","ENSMODG00000035033","6",153145179,153167315,22136
"25059","ENSMODG00000035034","1",189379975,189388419,8444
"25060","ENSMODG00000035035","4",203104280,203105888,1608
"25061","ENSMODG00000035037","2",16475451,16485895,10444
"25062","ENSMODG00000035038","2",534281794,534295555,13761
"25063","ENSMODG00000035040","6",70156186,70181716,25530
"25064","ENSMODG00000035041","7",191919499,191921309,1810
"25065","ENSMODG00000035042","8",19538621,19541371,2750
"25066","ENSMODG00000035044","2",255211102,255216409,5307
"25067","ENSMODG00000035045","6",290103586,290115251,11665
"25068","ENSMODG00000035046","8",83062177,83069119,6942
"25069","ENSMODG00000035047","7",209264707,209273941,9234
"25070","ENSMODG00000035048","4",405755948,405756652,704
"25071","ENSMODG00000035049","3",3167218,3222797,55579
"25072","ENSMODG00000035050","5",266826905,266875774,48869
"25073","ENSMODG00000035051","1",348115606,348120670,5064
"25074","ENSMODG00000035052","2",55956853,56033745,76892
"25075","ENSMODG00000035053","8",201975301,201987207,11906
"25076","ENSMODG00000035056","8",131879528,131915881,36353
"25077","ENSMODG00000035057","1",205980320,205982488,2168
"25078","ENSMODG00000035058","2",348563213,348629108,65895
"25079","ENSMODG00000035059","2",42357844,42428377,70533
"25080","ENSMODG00000035060","3",321669812,321689728,19916
"25081","ENSMODG00000035062","5",33187239,33211786,24547
"25082","ENSMODG00000035064","8",63460139,63493327,33188
"25083","ENSMODG00000035065","2",413306064,413364121,58057
"25084","ENSMODG00000035066","4",15718229,15729073,10844
"25085","ENSMODG00000035067","8",292241688,292249789,8101
"25086","ENSMODG00000035068","4",205107986,205112515,4529
"25087","ENSMODG00000035069","8",124374195,124375197,1002
"25088","ENSMODG00000035070","8",185218147,185219626,1479
"25089","ENSMODG00000035073","4",195246204,195290046,43842
"25090","ENSMODG00000035075","8",222582663,222584589,1926
"25091","ENSMODG00000035076","5",182369122,182371154,2032
"25092","ENSMODG00000035077","7",24870202,24876705,6503
"25093","ENSMODG00000035078","2",529324119,529326388,2269
"25094","ENSMODG00000035079","6",88216935,88221522,4587
"25095","ENSMODG00000035081","4",333653441,333798505,145064
"25096","ENSMODG00000035084","3",509609623,509611895,2272
"25097","ENSMODG00000035085","7",248643885,248658327,14442
"25098","ENSMODG00000035086","7",5685144,5698410,13266
"25099","ENSMODG00000035088","3",457040450,457041542,1092
"25100","ENSMODG00000035089","2",469606953,469611716,4763
"25101","ENSMODG00000035090","8",58240199,58333835,93636
"25102","ENSMODG00000035093","1",399843732,399844777,1045
"25103","ENSMODG00000035094","5",33240487,33241125,638
"25104","ENSMODG00000035095","6",253908754,253910249,1495
"25105","ENSMODG00000035096","3",453432112,453439181,7069
"25106","ENSMODG00000035097","2",528864302,528865620,1318
"25107","ENSMODG00000035098","2",216260611,216361225,100614
"25108","ENSMODG00000035099","3",237960431,237961202,771
"25109","ENSMODG00000035100","5",95576446,95793472,217026
"25110","ENSMODG00000035102","5",290935744,290941301,5557
"25111","ENSMODG00000035103","3",497551277,497571454,20177
"25112","ENSMODG00000035104","7",7526467,7613447,86980
"25113","ENSMODG00000035105","7",191290913,191309615,18702
"25114","ENSMODG00000035107","2",58155850,58185675,29825
"25115","ENSMODG00000035109","4",208928572,208950541,21969
"25116","ENSMODG00000035110","4",57868692,57947995,79303
"25117","ENSMODG00000035111","3",68349822,68359900,10078
"25118","ENSMODG00000035113","5",277092550,277098938,6388
"25119","ENSMODG00000035116","3",419290470,419299712,9242
"25120","ENSMODG00000035118","3",273135199,273158930,23731
"25121","ENSMODG00000035119","1",22308916,22316259,7343
"25122","ENSMODG00000035120","3",90509290,90530379,21089
"25123","ENSMODG00000035121","2",428156320,428251129,94809
"25124","ENSMODG00000035122","6",268544519,268556142,11623
"25125","ENSMODG00000035124","3",344978749,344995841,17092
"25126","ENSMODG00000035126","2",536345054,536346071,1017
"25127","ENSMODG00000035127","1",419948142,419969947,21805
"25128","ENSMODG00000035128","Un",61871188,61886864,15676
"25129","ENSMODG00000035129","2",437007078,437029816,22738
"25130","ENSMODG00000035130","5",69917291,69927582,10291
"25131","ENSMODG00000035131","5",219937220,219963027,25807
"25132","ENSMODG00000035132","2",46600915,46722166,121251
"25133","ENSMODG00000035134","5",123205861,123223641,17780
"25134","ENSMODG00000035135","1",16045265,16056752,11487
"25135","ENSMODG00000035136","7",127288886,127296622,7736
"25136","ENSMODG00000035137","7",175052351,175054211,1860
"25137","ENSMODG00000035138","4",263800074,263800824,750
"25138","ENSMODG00000035140","6",176568876,176572060,3184
"25139","ENSMODG00000035142","6",254439191,254444813,5622
"25140","ENSMODG00000035144","1",143967662,143969526,1864
"25141","ENSMODG00000035145","4",1191401,1207524,16123
"25142","ENSMODG00000035146","4",5155748,5184826,29078
"25143","ENSMODG00000035147","3",48891216,48910981,19765
"25144","ENSMODG00000035149","4",389269725,389275869,6144
"25145","ENSMODG00000035150","4",88222552,88224010,1458
"25146","ENSMODG00000035151","7",153373317,153386951,13634
"25147","ENSMODG00000035152","4",94102007,94109892,7885
"25148","ENSMODG00000035153","3",124913495,124966148,52653
"25149","ENSMODG00000035154","1",512259022,512274545,15523
"25150","ENSMODG00000035156","5",195877121,195898585,21464
"25151","ENSMODG00000035157","X",58967833,58981847,14014
"25152","ENSMODG00000035158","1",388369214,388375222,6008
"25153","ENSMODG00000035159","3",104524006,104539544,15538
"25154","ENSMODG00000035160","6",104969025,104970066,1041
"25155","ENSMODG00000035161","Un",10407322,10444095,36773
"25156","ENSMODG00000035162","1",374608302,374612051,3749
"25157","ENSMODG00000035166","1",189225481,189226697,1216
"25158","ENSMODG00000035167","7",231568344,231632971,64627
"25159","ENSMODG00000035168","1",375479046,375479811,765
"25160","ENSMODG00000035169","1",393942021,393945092,3071
"25161","ENSMODG00000035170","2",25579826,25587029,7203
"25162","ENSMODG00000035173","1",443510251,443515863,5612
"25163","ENSMODG00000035175","7",158997855,159009064,11209
"25164","ENSMODG00000035176","5",233494692,233497872,3180
"25165","ENSMODG00000035177","2",58630308,58631312,1004
"25166","ENSMODG00000035178","3",445261567,445276811,15244
"25167","ENSMODG00000035180","3",134340724,134408953,68229
"25168","ENSMODG00000035181","4",406867008,406873986,6978
"25169","ENSMODG00000035182","1",21755360,21757352,1992
"25170","ENSMODG00000035184","1",148009310,148028634,19324
"25171","ENSMODG00000035186","4",351558390,351562424,4034
"25172","ENSMODG00000035187","6",205295305,205344452,49147
"25173","ENSMODG00000035188","1",316176145,316193267,17122
"25174","ENSMODG00000035189","7",234207902,234209304,1402
"25175","ENSMODG00000035190","1",73657938,73661919,3981
"25176","ENSMODG00000035191","8",221057242,221153926,96684
"25177","ENSMODG00000035193","6",249170746,249174653,3907
"25178","ENSMODG00000035194","6",57986194,57988738,2544
"25179","ENSMODG00000035195","3",401035138,401179891,144753
"25180","ENSMODG00000035196","5",44326005,44500319,174314
"25181","ENSMODG00000035197","3",425023765,425026239,2474
"25182","ENSMODG00000035199","7",137763960,137917922,153962
"25183","ENSMODG00000035200","5",56642348,56660982,18634
"25184","ENSMODG00000035202","1",128487504,128490367,2863
"25185","ENSMODG00000035203","6",137649621,137658911,9290
"25186","ENSMODG00000035204","4",153266103,153581243,315140
"25187","ENSMODG00000035205","4",397383274,397385240,1966
"25188","ENSMODG00000035206","7",185513196,185514332,1136
"25189","ENSMODG00000035207","X",47771735,47813661,41926
"25190","ENSMODG00000035208","1",114022518,114034380,11862
"25191","ENSMODG00000035209","5",57703271,57704478,1207
"25192","ENSMODG00000035210","2",31492924,31496905,3981
"25193","ENSMODG00000035211","6",9743273,9791989,48716
"25194","ENSMODG00000035212","7",126455630,126535549,79919
"25195","ENSMODG00000035216","3",366396225,366412343,16118
"25196","ENSMODG00000035217","4",344737453,344740091,2638
"25197","ENSMODG00000035218","3",93125658,93128246,2588
"25198","ENSMODG00000035220","7",38465479,38603796,138317
"25199","ENSMODG00000035221","2",251051369,251065158,13789
"25200","ENSMODG00000035223","1",221523594,221584520,60926
"25201","ENSMODG00000035224","1",330719161,330721355,2194
"25202","ENSMODG00000035225","2",44426599,44427661,1062
"25203","ENSMODG00000035226","4",22231017,22281476,50459
"25204","ENSMODG00000035227","2",62417939,62424430,6491
"25205","ENSMODG00000035229","3",233552036,233587242,35206
"25206","ENSMODG00000035230","1",279762238,279948571,186333
"25207","ENSMODG00000035232","8",79011853,79016156,4303
"25208","ENSMODG00000035233","4",234061437,234063339,1902
"25209","ENSMODG00000035234","5",96080232,96082944,2712
"25210","ENSMODG00000035235","7",240105828,240114248,8420
"25211","ENSMODG00000035236","5",229482415,229484663,2248
"25212","ENSMODG00000035237","1",209419580,209424346,4766
"25213","ENSMODG00000035239","8",311138520,311140115,1595
"25214","ENSMODG00000035240","3",394814287,394818185,3898
"25215","ENSMODG00000035241","2",177633940,177659229,25289
"25216","ENSMODG00000035243","2",200270450,200272041,1591
"25217","ENSMODG00000035244","6",219497016,219523621,26605
"25218","ENSMODG00000035245","2",236998335,237037513,39178
"25219","ENSMODG00000035246","2",401411777,401431423,19646
"25220","ENSMODG00000035247","X",33897982,33900644,2662
"25221","ENSMODG00000035251","8",266519384,266530732,11348
"25222","ENSMODG00000035252","3",29624904,29630723,5819
"25223","ENSMODG00000035253","2",259052556,259058187,5631
"25224","ENSMODG00000035254","Un",9758428,9760319,1891
"25225","ENSMODG00000035255","1",388368149,388374209,6060
"25226","ENSMODG00000035256","1",159507199,159510286,3087
"25227","ENSMODG00000035257","6",54778892,54779442,550
"25228","ENSMODG00000035258","3",77501928,77509270,7342
"25229","ENSMODG00000035260","1",43663942,43666639,2697
"25230","ENSMODG00000035261","1",245614143,245625943,11800
"25231","ENSMODG00000035262","4",279195403,279219442,24039
"25232","ENSMODG00000035263","X",77283522,77286458,2936
"25233","ENSMODG00000035264","6",133804975,133900736,95761
"25234","ENSMODG00000035266","8",241579374,241644167,64793
"25235","ENSMODG00000035267","8",221279688,221281174,1486
"25236","ENSMODG00000035268","2",42329023,42331187,2164
"25237","ENSMODG00000035270","8",184401898,184403960,2062
"25238","ENSMODG00000035271","5",211083894,211163153,79259
"25239","ENSMODG00000035272","1",55039621,55041393,1772
"25240","ENSMODG00000035274","5",173702332,173719963,17631
"25241","ENSMODG00000035275","5",274017932,274035358,17426
"25242","ENSMODG00000035276","1",90718001,90740980,22979
"25243","ENSMODG00000035278","2",295820745,295829961,9216
"25244","ENSMODG00000035280","6",8103619,8109248,5629
"25245","ENSMODG00000035281","6",11852708,11853578,870
"25246","ENSMODG00000035282","5",238113738,238127341,13603
"25247","ENSMODG00000035284","3",429413422,429416880,3458
"25248","ENSMODG00000035285","2",345318570,345376737,58167
"25249","ENSMODG00000035287","2",334435199,334473628,38429
"25250","ENSMODG00000035288","1",373114644,373157179,42535
"25251","ENSMODG00000035289","4",27013155,27014511,1356
"25252","ENSMODG00000035290","2",7438139,7444478,6339
"25253","ENSMODG00000035291","3",514223197,514228175,4978
"25254","ENSMODG00000035292","5",124891075,124971272,80197
"25255","ENSMODG00000035294","Un",74849544,74856727,7183
"25256","ENSMODG00000035295","1",56342849,56350019,7170
"25257","ENSMODG00000035296","1",316299794,316306354,6560
"25258","ENSMODG00000035297","8",217521257,217523660,2403
"25259","ENSMODG00000035298","4",79947587,79957979,10392
"25260","ENSMODG00000035299","5",251574419,251608623,34204
"25261","ENSMODG00000035300","5",184786806,184798283,11477
"25262","ENSMODG00000035303","7",15734268,15859937,125669
"25263","ENSMODG00000035304","4",54107493,54149497,42004
"25264","ENSMODG00000035305","3",14136124,14176380,40256
"25265","ENSMODG00000035306","1",427236333,427268353,32020
"25266","ENSMODG00000035308","2",418818901,418865289,46388
"25267","ENSMODG00000035309","4",25475351,25530203,54852
"25268","ENSMODG00000035310","2",346800116,346835040,34924
"25269","ENSMODG00000035311","X",22820007,22822182,2175
"25270","ENSMODG00000035312","3",88010754,88012877,2123
"25271","ENSMODG00000035313","7",74621863,74675625,53762
"25272","ENSMODG00000035316","7",14479638,14492646,13008
"25273","ENSMODG00000035317","1",383777868,383780086,2218
"25274","ENSMODG00000035318","X",10959734,10976045,16311
"25275","ENSMODG00000035319","4",49477963,49478915,952
"25276","ENSMODG00000035320","1",332396881,332403153,6272
"25277","ENSMODG00000035322","4",79638412,79650631,12219
"25278","ENSMODG00000035323","6",131510663,131525274,14611
"25279","ENSMODG00000035324","6",273222138,273366489,144351
"25280","ENSMODG00000035325","4",229735498,229737118,1620
"25281","ENSMODG00000035326","4",184710738,184714172,3434
"25282","ENSMODG00000035327","X",23027207,23029635,2428
"25283","ENSMODG00000035328","3",461878987,461906819,27832
"25284","ENSMODG00000035329","8",183455325,183459123,3798
"25285","ENSMODG00000035330","4",243274600,243290220,15620
"25286","ENSMODG00000035331","X",5523082,5525010,1928
"25287","ENSMODG00000035332","5",79122019,79122737,718
"25288","ENSMODG00000035333","Un",27193341,27223383,30042
"25289","ENSMODG00000035334","2",200437062,200442668,5606
"25290","ENSMODG00000035335","5",10538579,10547017,8438
"25291","ENSMODG00000035336","X",49814611,49827362,12751
"25292","ENSMODG00000035338","7",163060714,163186725,126011
"25293","ENSMODG00000035339","6",186054617,186056735,2118
"25294","ENSMODG00000035340","1",39818904,39820730,1826
"25295","ENSMODG00000035342","1",383309684,383314331,4647
"25296","ENSMODG00000035343","7",249837495,249840486,2991
"25297","ENSMODG00000035345","4",34845108,34845419,311
"25298","ENSMODG00000035347","5",203144812,203201363,56551
"25299","ENSMODG00000035348","8",108153838,108156153,2315
"25300","ENSMODG00000035349","3",359333640,359372990,39350
"25301","ENSMODG00000035351","5",192609428,192781636,172208
"25302","ENSMODG00000035352","4",97327255,97328523,1268
"25303","ENSMODG00000035353","7",204732958,204733476,518
"25304","ENSMODG00000035354","1",385565413,385572523,7110
"25305","ENSMODG00000035355","X",47858810,47866377,7567
"25306","ENSMODG00000035357","8",286341991,286391801,49810
"25307","ENSMODG00000035358","1",7308646,7340070,31424
"25308","ENSMODG00000035360","2",84063752,84067042,3290
"25309","ENSMODG00000035361","2",151067596,151087698,20102
"25310","ENSMODG00000035363","6",240662288,240685608,23320
"25311","ENSMODG00000035364","1",195282022,195289637,7615
"25312","ENSMODG00000035365","2",161478941,161479894,953
"25313","ENSMODG00000035366","6",186738879,186740357,1478
"25314","ENSMODG00000035367","7",46072425,46073656,1231
"25315","ENSMODG00000035368","1",501149855,501170153,20298
"25316","ENSMODG00000035369","8",269493182,269498079,4897
"25317","ENSMODG00000035370","3",20530808,20549117,18309
"25318","ENSMODG00000035371","7",160089119,160091220,2101
"25319","ENSMODG00000035374","6",65066012,65067219,1207
"25320","ENSMODG00000035375","Un",5360795,5362500,1705
"25321","ENSMODG00000035376","6",6218025,6219561,1536
"25322","ENSMODG00000035377","4",148350502,148519780,169278
"25323","ENSMODG00000035378","4",242145659,242154735,9076
"25324","ENSMODG00000035379","8",147917423,148003042,85619
"25325","ENSMODG00000035380","5",25460008,25522280,62272
"25326","ENSMODG00000035381","8",69699666,69705806,6140
"25327","ENSMODG00000035382","8",3622787,3628576,5789
"25328","ENSMODG00000035383","8",104196959,104198194,1235
"25329","ENSMODG00000035384","5",52551716,52561566,9850
"25330","ENSMODG00000035386","3",96569458,96592743,23285
"25331","ENSMODG00000035387","4",262923778,262946354,22576
"25332","ENSMODG00000035388","Un",29511613,29518103,6490
"25333","ENSMODG00000035389","2",437221615,437224251,2636
"25334","ENSMODG00000035392","4",193501489,193503837,2348
"25335","ENSMODG00000035393","2",420617773,420638332,20559
"25336","ENSMODG00000035394","3",395785986,395793149,7163
"25337","ENSMODG00000035395","4",286944828,287037524,92696
"25338","ENSMODG00000035398","2",12440086,12441266,1180
"25339","ENSMODG00000035400","4",362050673,362054146,3473
"25340","ENSMODG00000035401","5",92930182,92999886,69704
"25341","ENSMODG00000035402","4",186358072,186519236,161164
"25342","ENSMODG00000035403","4",167056714,167057832,1118
"25343","ENSMODG00000035405","Un",11405908,11604000,198092
"25344","ENSMODG00000035406","4",319999914,320004976,5062
"25345","ENSMODG00000035408","2",155649419,155651124,1705
"25346","ENSMODG00000035409","7",213849929,213851161,1232
"25347","ENSMODG00000035411","3",354438554,354452549,13995
"25348","ENSMODG00000035412","7",86969662,87124506,154844
"25349","ENSMODG00000035413","2",4823281,4825049,1768
"25350","ENSMODG00000035414","X",3601295,3603480,2185
"25351","ENSMODG00000035416","3",398204846,398231811,26965
"25352","ENSMODG00000035417","7",82125876,82128318,2442
"25353","ENSMODG00000035419","8",233327968,233520242,192274
"25354","ENSMODG00000035420","3",318213072,318228415,15343
"25355","ENSMODG00000035421","3",527017574,527019581,2007
"25356","ENSMODG00000035423","2",426912639,426932090,19451
"25357","ENSMODG00000035424","3",446029708,446047351,17643
"25358","ENSMODG00000035425","5",227576427,227578047,1620
"25359","ENSMODG00000035427","2",128354234,128358064,3830
"25360","ENSMODG00000035428","4",326777367,326778660,1293
"25361","ENSMODG00000035429","6",208899640,208909833,10193
"25362","ENSMODG00000035431","7",157296604,157297311,707
"25363","ENSMODG00000035432","Un",62364366,62365808,1442
"25364","ENSMODG00000035434","1",3565049,3566440,1391
"25365","ENSMODG00000035435","2",417492955,417501934,8979
"25366","ENSMODG00000035436","1",93752934,93759040,6106
"25367","ENSMODG00000035437","4",416186693,416189381,2688
"25368","ENSMODG00000035438","1",136337432,136436071,98639
"25369","ENSMODG00000035439","3",399608021,399630353,22332
"25370","ENSMODG00000035440","6",92427834,92578565,150731
"25371","ENSMODG00000035441","3",216856426,216969354,112928
"25372","ENSMODG00000035442","7",204237301,204295097,57796
"25373","ENSMODG00000035443","2",183846919,183854853,7934
"25374","ENSMODG00000035444","2",337443457,337446098,2641
"25375","ENSMODG00000035445","4",366720535,366722303,1768
"25376","ENSMODG00000035446","1",333602959,333608467,5508
"25377","ENSMODG00000035447","1",46716227,46768384,52157
"25378","ENSMODG00000035448","4",432706563,432710013,3450
"25379","ENSMODG00000035449","3",489625283,489637286,12003
"25380","ENSMODG00000035450","4",418582162,418644789,62627
"25381","ENSMODG00000035451","2",30581955,30584028,2073
"25382","ENSMODG00000035453","5",203747725,203763820,16095
"25383","ENSMODG00000035454","1",508649233,508662110,12877
"25384","ENSMODG00000035455","8",257162902,257170130,7228
"25385","ENSMODG00000035456","X",59086717,59095853,9136
"25386","ENSMODG00000035459","6",111557508,111558748,1240
"25387","ENSMODG00000035460","2",265816505,265817864,1359
"25388","ENSMODG00000035461","5",299829666,299832912,3246
"25389","ENSMODG00000035462","3",402353408,402358440,5032
"25390","ENSMODG00000035465","8",168099295,168101328,2033
"25391","ENSMODG00000035468","1",372590259,372591386,1127
"25392","ENSMODG00000035469","4",201532332,201541283,8951
"25393","ENSMODG00000035470","4",40127715,40133809,6094
"25394","ENSMODG00000035471","4",397607336,397613856,6520
"25395","ENSMODG00000035472","Un",22157532,22248178,90646
"25396","ENSMODG00000035473","7",254611355,254667850,56495
"25397","ENSMODG00000035474","2",518235536,518262611,27075
"25398","ENSMODG00000035476","2",276065171,276070066,4895
"25399","ENSMODG00000035477","Un",39681268,39682282,1014
"25400","ENSMODG00000035478","5",201461749,201467549,5800
"25401","ENSMODG00000035480","Un",100790239,100791717,1478
"25402","ENSMODG00000035482","1",7522660,7530456,7796
"25403","ENSMODG00000035483","6",217248405,217273925,25520
"25404","ENSMODG00000035485","5",301991399,301993191,1792
"25405","ENSMODG00000035486","4",12652343,12653804,1461
"25406","ENSMODG00000035487","1",156199997,156202805,2808
"25407","ENSMODG00000035488","8",299648137,299704030,55893
"25408","ENSMODG00000035489","1",110678556,110687110,8554
"25409","ENSMODG00000035490","3",11006395,11030171,23776
"25410","ENSMODG00000035491","3",145001682,145019656,17974
"25411","ENSMODG00000035492","3",315343162,315353999,10837
"25412","ENSMODG00000035493","4",63631666,63691619,59953
"25413","ENSMODG00000035495","4",103147383,103190123,42740
"25414","ENSMODG00000035498","Un",98872755,98875933,3178
"25415","ENSMODG00000035499","2",495211760,495243027,31267
"25416","ENSMODG00000035500","8",84106270,84111771,5501
"25417","ENSMODG00000035501","3",164333427,164338856,5429
"25418","ENSMODG00000035502","Un",59836664,59837613,949
"25419","ENSMODG00000035503","4",287725611,287728227,2616
"25420","ENSMODG00000035504","3",171817886,171820843,2957
"25421","ENSMODG00000035505","3",400459718,400481945,22227
"25422","ENSMODG00000035506","4",218542892,218562639,19747
"25423","ENSMODG00000035507","6",13165175,13184736,19561
"25424","ENSMODG00000035508","2",11388996,11396746,7750
"25425","ENSMODG00000035510","2",496785338,496792975,7637
"25426","ENSMODG00000035511","4",421826717,421828615,1898
"25427","ENSMODG00000035512","7",222750601,222807971,57370
"25428","ENSMODG00000035514","1",402136646,402174608,37962
"25429","ENSMODG00000035515","3",208820286,208829333,9047
"25430","ENSMODG00000035517","7",215045628,215216222,170594
"25431","ENSMODG00000035518","1",173279489,173281184,1695
"25432","ENSMODG00000035519","8",249480273,249499886,19613
"25433","ENSMODG00000035522","2",39179738,39213397,33659
"25434","ENSMODG00000035523","2",530829810,530831568,1758
"25435","ENSMODG00000035524","2",302167340,302167988,648
"25436","ENSMODG00000035525","5",101613924,101618729,4805
"25437","ENSMODG00000035526","6",186730750,186738391,7641
"25438","ENSMODG00000035528","4",110605076,110610497,5421
"25439","ENSMODG00000035529","6",8585375,8589218,3843
"25440","ENSMODG00000035530","3",310750166,310752930,2764
"25441","ENSMODG00000035531","4",115681952,115714036,32084
"25442","ENSMODG00000035532","3",24093601,24102598,8997
"25443","ENSMODG00000035534","6",291300293,291341468,41175
"25444","ENSMODG00000035535","4",281324006,281332431,8425
"25445","ENSMODG00000035536","3",273743603,273797056,53453
"25446","ENSMODG00000035537","2",446963794,446965649,1855
"25447","ENSMODG00000035538","5",298406668,298420604,13936
"25448","ENSMODG00000035539","5",122376934,122380708,3774
"25449","ENSMODG00000035542","8",115454781,115463582,8801
"25450","ENSMODG00000035543","3",35643144,35644748,1604
"25451","ENSMODG00000035544","5",1995545,2000575,5030
"25452","ENSMODG00000035545","3",71359383,71368006,8623
"25453","ENSMODG00000035546","4",338231551,338235073,3522
"25454","ENSMODG00000035547","8",281074439,281096319,21880
"25455","ENSMODG00000035549","6",24238239,24267113,28874
"25456","ENSMODG00000035550","4",205911409,205941751,30342
"25457","ENSMODG00000035551","1",36752935,36803355,50420
"25458","ENSMODG00000035552","4",169980954,169990069,9115
"25459","ENSMODG00000035553","2",507473354,507492335,18981
"25460","ENSMODG00000035558","X",58980419,59038686,58267
"25461","ENSMODG00000035559","4",229146902,229181674,34772
"25462","ENSMODG00000035560","7",200595952,200608937,12985
"25463","ENSMODG00000035562","1",16167443,16186396,18953
"25464","ENSMODG00000035563","Un",71496147,71503552,7405
"25465","ENSMODG00000035564","1",131877310,131898648,21338
"25466","ENSMODG00000035565","7",126016465,126064415,47950
"25467","ENSMODG00000035566","7",111768850,111810209,41359
"25468","ENSMODG00000035567","3",200143165,200157115,13950
"25469","ENSMODG00000035568","7",217495731,217499277,3546
"25470","ENSMODG00000035569","1",174801432,174837878,36446
"25471","ENSMODG00000035572","1",437465919,437523766,57847
"25472","ENSMODG00000035573","6",59029745,59043964,14219
"25473","ENSMODG00000035575","5",203482362,203517750,35388
"25474","ENSMODG00000035576","4",315694393,315696239,1846
"25475","ENSMODG00000035577","2",122053314,122113618,60304
"25476","ENSMODG00000035578","8",100065755,100084534,18779
"25477","ENSMODG00000035579","3",180866448,180950691,84243
"25478","ENSMODG00000035580","2",277852636,277856328,3692
"25479","ENSMODG00000035581","1",101884619,101895443,10824
"25480","ENSMODG00000035582","1",47175241,47182767,7526
"25481","ENSMODG00000035583","1",188194050,188201255,7205
"25482","ENSMODG00000035584","5",291843616,291847511,3895
"25483","ENSMODG00000035585","5",5980437,5983442,3005
"25484","ENSMODG00000035586","4",380271802,380318512,46710
"25485","ENSMODG00000035588","4",412594824,412595736,912
"25486","ENSMODG00000035589","1",157269849,157272741,2892
"25487","ENSMODG00000035590","4",273287346,273288701,1355
"25488","ENSMODG00000035591","1",479391904,479397210,5306
"25489","ENSMODG00000035594","1",309763474,309765671,2197
"25490","ENSMODG00000035595","7",169935841,169941133,5292
"25491","ENSMODG00000035596","7",239574954,239577285,2331
"25492","ENSMODG00000035597","2",153295856,153338984,43128
"25493","ENSMODG00000035598","2",291697653,291732702,35049
"25494","ENSMODG00000035600","2",309246854,309262089,15235
"25495","ENSMODG00000035601","2",211834838,211845195,10357
"25496","ENSMODG00000035602","8",283032906,283078346,45440
"25497","ENSMODG00000035604","3",229262444,229322328,59884
"25498","ENSMODG00000035605","3",476293358,476294310,952
"25499","ENSMODG00000035607","8",182618213,182895378,277165
"25500","ENSMODG00000035608","1",353767662,353772084,4422
"25501","ENSMODG00000035609","2",396838135,396845675,7540
"25502","ENSMODG00000035611","3",152022139,152042222,20083
"25503","ENSMODG00000035612","1",211331785,211332979,1194
"25504","ENSMODG00000035614","Un",94419415,94421402,1987
"25505","ENSMODG00000035615","4",25555932,25559426,3494
"25506","ENSMODG00000035616","4",406217374,406221518,4144
"25507","ENSMODG00000035617","2",446829612,446834424,4812
"25508","ENSMODG00000035618","1",426406013,426408841,2828
"25509","ENSMODG00000035619","1",402323984,402359383,35399
"25510","ENSMODG00000035621","6",248868988,248870254,1266
"25511","ENSMODG00000035622","1",146526966,146559838,32872
"25512","ENSMODG00000035625","6",281251627,281257704,6077
"25513","ENSMODG00000035626","3",465196327,465208058,11731
"25514","ENSMODG00000035627","7",84223874,84240177,16303
"25515","ENSMODG00000035628","7",150598367,150612986,14619
"25516","ENSMODG00000035629","3",385825854,385826774,920
"25517","ENSMODG00000035630","8",7922141,7932468,10327
"25518","ENSMODG00000035631","1",527566501,527575667,9166
"25519","ENSMODG00000035632","8",166432897,166437345,4448
"25520","ENSMODG00000035633","1",510118961,510121990,3029
"25521","ENSMODG00000035634","8",85504669,85517891,13222
"25522","ENSMODG00000035636","5",178277689,178365903,88214
"25523","ENSMODG00000035637","4",77858438,77864711,6273
"25524","ENSMODG00000035638","Un",91918579,91922094,3515
"25525","ENSMODG00000035641","X",57447863,57450161,2298
"25526","ENSMODG00000035642","4",392379496,392383881,4385
"25527","ENSMODG00000035643","6",212512851,212575005,62154
"25528","ENSMODG00000035644","3",237720997,237722261,1264
"25529","ENSMODG00000035645","2",469948361,469962489,14128
"25530","ENSMODG00000035646","6",256708016,256722145,14129
"25531","ENSMODG00000035647","3",16882689,16884172,1483
"25532","ENSMODG00000035648","5",24605072,24612894,7822
"25533","ENSMODG00000035649","7",149063451,149065551,2100
"25534","ENSMODG00000035650","1",360509592,360631092,121500
"25535","ENSMODG00000035651","7",89869230,89965475,96245
"25536","ENSMODG00000035652","1",514856412,514943170,86758
"25537","ENSMODG00000035653","2",137138201,137139928,1727
"25538","ENSMODG00000035654","7",252715856,252719121,3265
"25539","ENSMODG00000035656","8",40734622,40747741,13119
"25540","ENSMODG00000035657","7",197499067,197691870,192803
"25541","ENSMODG00000035658","2",325838116,325854300,16184
"25542","ENSMODG00000035659","2",40513994,40514488,494
"25543","ENSMODG00000035660","7",83993278,84000655,7377
"25544","ENSMODG00000035661","5",247632485,247697470,64985
"25545","ENSMODG00000035662","2",51957590,51960981,3391
"25546","ENSMODG00000035663","4",384911090,384927287,16197
"25547","ENSMODG00000035665","6",82125200,82163282,38082
"25548","ENSMODG00000035666","3",321760943,321765194,4251
"25549","ENSMODG00000035670","5",129356173,129356941,768
"25550","ENSMODG00000035672","4",389990776,389997605,6829
"25551","ENSMODG00000035673","3",71842670,71844505,1835
"25552","ENSMODG00000035675","4",99040144,99128659,88515
"25553","ENSMODG00000035676","1",1846293,1851700,5407
"25554","ENSMODG00000035677","2",508988286,508997272,8986
"25555","ENSMODG00000035678","4",10831930,10875645,43715
"25556","ENSMODG00000035679","Un",72550003,72561767,11764
"25557","ENSMODG00000035681","2",244469968,244471226,1258
"25558","ENSMODG00000035682","Un",59290840,59312826,21986
"25559","ENSMODG00000035683","7",251941380,251947990,6610
"25560","ENSMODG00000035684","1",440476780,440539965,63185
"25561","ENSMODG00000035685","8",15123352,15138014,14662
"25562","ENSMODG00000035686","8",276612330,276623434,11104
"25563","ENSMODG00000035687","3",487432094,487443471,11377
"25564","ENSMODG00000035688","6",114739892,114783552,43660
"25565","ENSMODG00000035689","1",153432360,153441610,9250
"25566","ENSMODG00000035690","2",428913831,428932226,18395
"25567","ENSMODG00000035691","3",262415129,262483699,68570
"25568","ENSMODG00000035692","2",268355664,268357734,2070
"25569","ENSMODG00000035693","4",341199155,341255823,56668
"25570","ENSMODG00000035694","5",282822110,282825741,3631
"25571","ENSMODG00000035695","4",184795869,184799306,3437
"25572","ENSMODG00000035696","8",301466027,301470919,4892
"25573","ENSMODG00000035697","3",479556632,479568941,12309
"25574","ENSMODG00000035698","2",336477554,336479679,2125
"25575","ENSMODG00000035699","4",84000928,84008305,7377
"25576","ENSMODG00000035700","4",135491825,135492804,979
"25577","ENSMODG00000035701","4",188039380,188042349,2969
"25578","ENSMODG00000035703","3",510342768,510419676,76908
"25579","ENSMODG00000035704","1",382023161,382024152,991
"25580","ENSMODG00000035707","8",181411645,181412668,1023
"25581","ENSMODG00000035709","8",277709158,277713665,4507
"25582","ENSMODG00000035710","3",220212168,220218669,6501
"25583","ENSMODG00000035713","8",293157487,293186913,29426
"25584","ENSMODG00000035714","7",19555852,19564476,8624
"25585","ENSMODG00000035715","4",169815022,169816221,1199
"25586","ENSMODG00000035716","2",229566071,229568799,2728
"25587","ENSMODG00000035717","Un",44390116,44395990,5874
"25588","ENSMODG00000035718","4",384107602,384109713,2111
"25589","ENSMODG00000035719","4",108031029,108034235,3206
"25590","ENSMODG00000035720","8",244013296,244053207,39911
"25591","ENSMODG00000035721","2",270766967,270769935,2968
"25592","ENSMODG00000035722","8",195136321,195167725,31404
"25593","ENSMODG00000035724","3",363022228,363026873,4645
"25594","ENSMODG00000035725","6",196081247,196100906,19659
"25595","ENSMODG00000035726","8",175098597,175112292,13695
"25596","ENSMODG00000035727","3",456332523,456337270,4747
"25597","ENSMODG00000035729","7",248596848,248638791,41943
"25598","ENSMODG00000035730","4",189614908,189636894,21986
"25599","ENSMODG00000035731","6",214709480,214710133,653
"25600","ENSMODG00000035732","1",400749251,400766731,17480
"25601","ENSMODG00000035733","X",69297241,69298981,1740
"25602","ENSMODG00000035735","8",262577089,262588570,11481
"25603","ENSMODG00000035736","4",347544014,347563046,19032
"25604","ENSMODG00000035737","4",326675905,326677622,1717
"25605","ENSMODG00000035738","2",206406146,206422444,16298
"25606","ENSMODG00000035739","4",42286477,42288440,1963
"25607","ENSMODG00000035740","1",405031366,405074663,43297
"25608","ENSMODG00000035741","1",368957131,368984516,27385
"25609","ENSMODG00000035743","X",73585876,73595022,9146
"25610","ENSMODG00000035744","2",382948717,382954869,6152
"25611","ENSMODG00000035746","8",283292678,283308023,15345
"25612","ENSMODG00000035747","1",75831374,75853333,21959
"25613","ENSMODG00000035748","5",224956492,224963292,6800
"25614","ENSMODG00000035749","6",139320953,139324971,4018
"25615","ENSMODG00000035750","1",26773943,26782462,8519
"25616","ENSMODG00000035752","6",210410708,210426062,15354
"25617","ENSMODG00000035753","1",116794596,116868422,73826
"25618","ENSMODG00000035754","2",344628772,344723425,94653
"25619","ENSMODG00000035755","6",100047246,100060080,12834
"25620","ENSMODG00000035757","2",533891091,533898610,7519
"25621","ENSMODG00000035758","2",197444765,197448397,3632
"25622","ENSMODG00000035760","4",182328208,182338265,10057
"25623","ENSMODG00000035761","8",112958915,112966851,7936
"25624","ENSMODG00000035762","8",239304189,239328972,24783
"25625","ENSMODG00000035763","1",56530428,56691289,160861
"25626","ENSMODG00000035764","3",18947315,18987162,39847
"25627","ENSMODG00000035766","1",160676854,160689157,12303
"25628","ENSMODG00000035768","2",460820752,460827661,6909
"25629","ENSMODG00000035769","4",358017508,358020695,3187
"25630","ENSMODG00000035770","3",182309120,182328222,19102
"25631","ENSMODG00000035771","3",92356339,92368496,12157
"25632","ENSMODG00000035772","4",261662838,261684145,21307
"25633","ENSMODG00000035775","Un",53546216,53576244,30028
"25634","ENSMODG00000035776","1",13389961,13403387,13426
"25635","ENSMODG00000035777","1",229695336,229704342,9006
"25636","ENSMODG00000035780","1",493577861,493588880,11019
"25637","ENSMODG00000035781","5",75262006,75263446,1440
"25638","ENSMODG00000035783","2",468226842,468232361,5519
"25639","ENSMODG00000035784","2",2839888,2849630,9742
"25640","ENSMODG00000035785","2",241239774,241241526,1752
"25641","ENSMODG00000035786","5",105560086,105651951,91865
"25642","ENSMODG00000035787","2",398973505,399006019,32514
"25643","ENSMODG00000035788","4",245117255,245171257,54002
"25644","ENSMODG00000035790","2",31482098,31503635,21537
"25645","ENSMODG00000035792","6",48568828,48576885,8057
"25646","ENSMODG00000035793","3",463141264,463146413,5149
"25647","ENSMODG00000035796","Un",99295088,99298285,3197
"25648","ENSMODG00000035797","2",455818746,455841819,23073
"25649","ENSMODG00000035798","3",358501179,358507918,6739
"25650","ENSMODG00000035799","6",94155798,94173481,17683
"25651","ENSMODG00000035800","6",227276693,227277786,1093
"25652","ENSMODG00000035801","4",152292897,152346664,53767
"25653","ENSMODG00000035802","6",3881831,3889029,7198
"25654","ENSMODG00000035803","8",184842421,184852804,10383
"25655","ENSMODG00000035804","6",123901868,123912349,10481
"25656","ENSMODG00000035805","1",48096040,48097727,1687
"25657","ENSMODG00000035806","1",388939636,388940873,1237
"25658","ENSMODG00000035807","4",312094630,312122434,27804
"25659","ENSMODG00000035808","8",309811162,309831401,20239
"25660","ENSMODG00000035809","4",323094869,323108968,14099
"25661","ENSMODG00000035811","1",157747413,157749736,2323
"25662","ENSMODG00000035812","4",176961733,176974954,13221
"25663","ENSMODG00000035814","6",247930323,247971219,40896
"25664","ENSMODG00000035815","1",56773339,56777166,3827
"25665","ENSMODG00000035816","3",25738501,25759492,20991
"25666","ENSMODG00000035817","2",447223582,447343112,119530
"25667","ENSMODG00000035818","5",77762046,77764614,2568
"25668","ENSMODG00000035819","5",850478,1015118,164640
"25669","ENSMODG00000035820","5",215563660,215590876,27216
"25670","ENSMODG00000035821","8",88744843,88763933,19090
"25671","ENSMODG00000035822","2",356378898,356387360,8462
"25672","ENSMODG00000035823","2",126617494,126680392,62898
"25673","ENSMODG00000035824","6",160061219,160065770,4551
"25674","ENSMODG00000035825","4",385380805,385382910,2105
"25675","ENSMODG00000035826","4",109280919,109309613,28694
"25676","ENSMODG00000035827","2",334184924,334195135,10211
"25677","ENSMODG00000035828","2",487933802,487936681,2879
"25678","ENSMODG00000035829","2",14154691,14157285,2594
"25679","ENSMODG00000035830","Un",52017610,52036755,19145
"25680","ENSMODG00000035831","1",7085776,7089334,3558
"25681","ENSMODG00000035832","4",341174128,341250740,76612
"25682","ENSMODG00000035834","2",424149000,424179281,30281
"25683","ENSMODG00000035835","2",218107309,218126802,19493
"25684","ENSMODG00000035836","3",206417956,206436065,18109
"25685","ENSMODG00000035837","2",139372763,139374268,1505
"25686","ENSMODG00000035838","2",202311919,202312811,892
"25687","ENSMODG00000035839","1",479149940,479159446,9506
"25688","ENSMODG00000035840","2",193637978,193647765,9787
"25689","ENSMODG00000035841","3",141038234,141093066,54832
"25690","ENSMODG00000035842","3",520087766,520089112,1346
"25691","ENSMODG00000035843","2",471885706,471928631,42925
"25692","ENSMODG00000035844","Un",64881177,64882923,1746
"25693","ENSMODG00000035846","8",201272829,201280296,7467
"25694","ENSMODG00000035847","3",202774419,202775673,1254
"25695","ENSMODG00000035849","1",371632946,371652365,19419
"25696","ENSMODG00000035851","1",273432474,273503983,71509
"25697","ENSMODG00000035852","4",42176200,42193351,17151
"25698","ENSMODG00000035853","4",69658288,69659441,1153
"25699","ENSMODG00000035854","2",479099202,479127244,28042
"25700","ENSMODG00000035855","Un",8755319,8762502,7183
"25701","ENSMODG00000035856","5",300955990,300965763,9773
"25702","ENSMODG00000035857","1",106967284,106975126,7842
"25703","ENSMODG00000035858","6",126375364,126377855,2491
"25704","ENSMODG00000035859","2",174412181,174428557,16376
"25705","ENSMODG00000035861","5",132920767,132928168,7401
"25706","ENSMODG00000035863","2",11910694,11917574,6880
"25707","ENSMODG00000035864","Un",71362991,71364277,1286
"25708","ENSMODG00000035866","Un",63826041,63844135,18094
"25709","ENSMODG00000035867","8",302675024,302695952,20928
"25710","ENSMODG00000035868","X",44060610,44064579,3969
"25711","ENSMODG00000035869","3",159849094,159852790,3696
"25712","ENSMODG00000035870","8",311295174,311302410,7236
"25713","ENSMODG00000035871","1",391056493,391107200,50707
"25714","ENSMODG00000035872","5",153169551,153173917,4366
"25715","ENSMODG00000035873","1",360074240,360087066,12826
"25716","ENSMODG00000035874","3",253338837,253357160,18323
"25717","ENSMODG00000035875","7",13977645,13980152,2507
"25718","ENSMODG00000035876","1",501588646,501629755,41109
"25719","ENSMODG00000035877","1",301111912,301122617,10705
"25720","ENSMODG00000035878","8",156231708,156233791,2083
"25721","ENSMODG00000035879","7",10862985,10956857,93872
"25722","ENSMODG00000035880","1",90266547,90274100,7553
"25723","ENSMODG00000035882","3",424888933,424891854,2921
"25724","ENSMODG00000035885","5",214881334,214893855,12521
"25725","ENSMODG00000035887","3",402107691,402188773,81082
"25726","ENSMODG00000035889","4",389366301,389371676,5375
"25727","ENSMODG00000035891","8",242793795,242805895,12100
"25728","ENSMODG00000035892","6",290759727,290768692,8965
"25729","ENSMODG00000035893","2",75058363,75060508,2145
"25730","ENSMODG00000035894","3",167084285,167085944,1659
"25731","ENSMODG00000035895","4",319975536,319998928,23392
"25732","ENSMODG00000035897","3",83009673,83017974,8301
"25733","ENSMODG00000035898","4",296204780,296235817,31037
"25734","ENSMODG00000035899","8",118439715,118443005,3290
"25735","ENSMODG00000035900","4",424049238,424050253,1015
"25736","ENSMODG00000035901","7",260242575,260247788,5213
"25737","ENSMODG00000035902","2",24271208,24274166,2958
"25738","ENSMODG00000035905","6",118041494,118042496,1002
"25739","ENSMODG00000035907","2",232586632,232591375,4743
"25740","ENSMODG00000035909","3",187573197,187580067,6870
"25741","ENSMODG00000035911","3",341216704,341220837,4133
"25742","ENSMODG00000035912","8",45085071,45086368,1297
"25743","ENSMODG00000035913","5",300088012,300108561,20549
"25744","ENSMODG00000035914","4",287823115,287841172,18057
"25745","ENSMODG00000035915","4",432368748,432380044,11296
"25746","ENSMODG00000035916","3",263064475,263068790,4315
"25747","ENSMODG00000035918","7",26770265,26876602,106337
"25748","ENSMODG00000035920","6",19761807,19763164,1357
"25749","ENSMODG00000035922","1",373337944,373345235,7291
"25750","ENSMODG00000035924","2",36845119,36855524,10405
"25751","ENSMODG00000035925","1",529037468,529043973,6505
"25752","ENSMODG00000035926","5",299356540,299358233,1693
"25753","ENSMODG00000035927","2",99302586,99323008,20422
"25754","ENSMODG00000035928","4",119805233,119837975,32742
"25755","ENSMODG00000035929","8",255714110,255885012,170902
"25756","ENSMODG00000035930","6",57279546,57283712,4166
"25757","ENSMODG00000035931","3",269069521,269077027,7506
"25758","ENSMODG00000035932","7",93957490,93998781,41291
"25759","ENSMODG00000035933","X",50880047,50901365,21318
"25760","ENSMODG00000035935","2",229584053,229586281,2228
"25761","ENSMODG00000035936","6",10959489,10975310,15821
"25762","ENSMODG00000035937","4",271388715,271397869,9154
"25763","ENSMODG00000035938","1",373569801,373632310,62509
"25764","ENSMODG00000035940","3",515028095,515048952,20857
"25765","ENSMODG00000035942","3",433240064,433243801,3737
"25766","ENSMODG00000035943","6",263302186,263354515,52329
"25767","ENSMODG00000035946","2",293290127,293374499,84372
"25768","ENSMODG00000035948","2",149865319,149925553,60234
"25769","ENSMODG00000035949","6",77817743,77878248,60505
"25770","ENSMODG00000035950","Un",93418973,93546927,127954
"25771","ENSMODG00000035951","8",200279138,200296574,17436
"25772","ENSMODG00000035952","1",455312930,455341573,28643
"25773","ENSMODG00000035953","6",252373208,252390985,17777
"25774","ENSMODG00000035954","1",390165966,390167087,1121
"25775","ENSMODG00000035955","2",164439501,164441545,2044
"25776","ENSMODG00000035957","7",212334674,212366357,31683
"25777","ENSMODG00000035958","1",346262075,346363971,101896
"25778","ENSMODG00000035960","2",15278749,15291510,12761
"25779","ENSMODG00000035961","4",34468502,34485069,16567
"25780","ENSMODG00000035962","4",320657508,320659124,1616
"25781","ENSMODG00000035963","1",84581149,84596706,15557
"25782","ENSMODG00000035964","Un",49020957,49023151,2194
"25783","ENSMODG00000035965","1",199024456,199035903,11447
"25784","ENSMODG00000035966","6",35878448,35886617,8169
"25785","ENSMODG00000035969","1",4088667,4098589,9922
"25786","ENSMODG00000035970","2",106992003,106995606,3603
"25787","ENSMODG00000035971","3",44855713,44868586,12873
"25788","ENSMODG00000035972","Un",30112183,30119678,7495
"25789","ENSMODG00000035973","2",184424804,184426505,1701
"25790","ENSMODG00000035974","4",235233789,235275640,41851
"25791","ENSMODG00000035975","2",120234045,120393998,159953
"25792","ENSMODG00000035976","5",11154033,11168763,14730
"25793","ENSMODG00000035978","7",89749545,89813352,63807
"25794","ENSMODG00000035979","2",435228519,435260330,31811
"25795","ENSMODG00000035981","8",293201507,293220535,19028
"25796","ENSMODG00000035982","5",183699691,183703797,4106
"25797","ENSMODG00000035984","2",408866089,408924542,58453
"25798","ENSMODG00000035987","8",7003477,7151499,148022
"25799","ENSMODG00000035988","1",360890317,360911576,21259
"25800","ENSMODG00000035990","1",529302059,529344397,42338
"25801","ENSMODG00000035991","4",249424914,249435926,11012
"25802","ENSMODG00000035993","Un",64000760,64002408,1648
"25803","ENSMODG00000035995","1",487030304,487036461,6157
"25804","ENSMODG00000035996","4",287730202,287741309,11107
"25805","ENSMODG00000035997","8",169899519,169959904,60385
"25806","ENSMODG00000035998","3",9148381,9150410,2029
"25807","ENSMODG00000035999","4",398445507,398447330,1823
"25808","ENSMODG00000036000","1",179842939,179847670,4731
"25809","ENSMODG00000036001","5",156692821,156719445,26624
"25810","ENSMODG00000036002","8",236604809,236619025,14216
"25811","ENSMODG00000036003","8",305017943,305072033,54090
"25812","ENSMODG00000036004","5",107989046,108021040,31994
"25813","ENSMODG00000036005","2",80972118,80978695,6577
"25814","ENSMODG00000036006","X",64670574,64674073,3499
"25815","ENSMODG00000036007","3",187045634,187144889,99255
"25816","ENSMODG00000036008","5",134806334,134823415,17081
"25817","ENSMODG00000036009","2",143676345,143683652,7307
"25818","ENSMODG00000036010","8",302474245,302477253,3008
"25819","ENSMODG00000036011","6",57962101,58043347,81246
"25820","ENSMODG00000036013","3",165036894,165089765,52871
"25821","ENSMODG00000036014","3",389461249,389473743,12494
"25822","ENSMODG00000036015","2",397106482,397125253,18771
"25823","ENSMODG00000036016","3",358121835,358158397,36562
"25824","ENSMODG00000036017","4",49969862,49972530,2668
"25825","ENSMODG00000036018","3",244013400,244021392,7992
"25826","ENSMODG00000036019","Un",59202815,59207020,4205
"25827","ENSMODG00000036020","4",373494004,373495953,1949
"25828","ENSMODG00000036021","6",216225156,216291131,65975
"25829","ENSMODG00000036022","3",461910090,461931626,21536
"25830","ENSMODG00000036023","2",17792572,18057653,265081
"25831","ENSMODG00000036024","4",55683604,55744739,61135
"25832","ENSMODG00000036025","1",26770172,26776352,6180
"25833","ENSMODG00000036026","5",254232048,254236356,4308
"25834","ENSMODG00000036027","1",437233461,437253813,20352
"25835","ENSMODG00000036028","2",461048126,461167240,119114
"25836","ENSMODG00000036029","7",1499506,1539517,40011
"25837","ENSMODG00000036031","4",242036325,242037772,1447
"25838","ENSMODG00000036032","1",62839241,62858675,19434
"25839","ENSMODG00000036035","1",497442421,497447226,4805
"25840","ENSMODG00000036036","3",522402363,522417978,15615
"25841","ENSMODG00000036037","1",163682626,163700110,17484
"25842","ENSMODG00000036038","5",203132883,203133978,1095
"25843","ENSMODG00000036040","5",111857329,111890678,33349
"25844","ENSMODG00000036042","8",66262262,66266830,4568
"25845","ENSMODG00000036043","8",294548233,294572423,24190
"25846","ENSMODG00000036045","5",276464573,276465383,810
"25847","ENSMODG00000036047","3",267146320,267302808,156488
"25848","ENSMODG00000036048","1",389618948,389621458,2510
"25849","ENSMODG00000036049","6",44587379,44796140,208761
"25850","ENSMODG00000036050","Un",42488185,42488858,673
"25851","ENSMODG00000036051","4",284928490,284932759,4269
"25852","ENSMODG00000036052","4",421720194,421746416,26222
"25853","ENSMODG00000036054","8",9425440,9456153,30713
"25854","ENSMODG00000036056","3",277633184,277683402,50218
"25855","ENSMODG00000036057","4",137073146,137075806,2660
"25856","ENSMODG00000036058","4",144419029,144420991,1962
"25857","ENSMODG00000036060","8",144803467,144928800,125333
"25858","ENSMODG00000036061","4",287359346,287370832,11486
"25859","ENSMODG00000036062","1",467861827,467895007,33180
"25860","ENSMODG00000036063","2",454845222,454871187,25965
"25861","ENSMODG00000036065","4",10929126,11000501,71375
"25862","ENSMODG00000036066","8",174501918,174506782,4864
"25863","ENSMODG00000036069","3",4471646,4515330,43684
"25864","ENSMODG00000036072","7",89198080,89264416,66336
"25865","ENSMODG00000036073","4",312190601,312242455,51854
"25866","ENSMODG00000036074","1",361005051,361153523,148472
"25867","ENSMODG00000036075","7",151159673,151166187,6514
"25868","ENSMODG00000036078","2",214425406,214434578,9172
"25869","ENSMODG00000036079","2",501640474,501691880,51406
"25870","ENSMODG00000036080","7",132198454,132377662,179208
"25871","ENSMODG00000036081","6",58420511,58422178,1667
"25872","ENSMODG00000036082","3",458713211,458720650,7439
"25873","ENSMODG00000036083","3",176280792,176297660,16868
"25874","ENSMODG00000036084","1",122602330,122664744,62414
"25875","ENSMODG00000036085","2",184855953,184863245,7292
"25876","ENSMODG00000036086","2",439671663,439674116,2453
"25877","ENSMODG00000036087","7",146691149,146718067,26918
"25878","ENSMODG00000036088","2",95559871,95707016,147145
"25879","ENSMODG00000036089","2",162025282,162052924,27642
"25880","ENSMODG00000036090","2",531795671,531797535,1864
"25881","ENSMODG00000036092","7",21308191,21309949,1758
"25882","ENSMODG00000036093","Un",22199453,22328253,128800
"25883","ENSMODG00000036094","2",330181288,330200158,18870
"25884","ENSMODG00000036095","7",154062267,154099430,37163
"25885","ENSMODG00000036096","8",189980143,189984231,4088
"25886","ENSMODG00000036097","1",223813077,223842240,29163
"25887","ENSMODG00000036098","3",326620770,326622056,1286
"25888","ENSMODG00000036099","2",699068,706443,7375
"25889","ENSMODG00000036100","1",16745547,16747671,2124
"25890","ENSMODG00000036101","2",206383943,206389032,5089
"25891","ENSMODG00000036102","3",317185948,317214188,28240
"25892","ENSMODG00000036103","4",205156976,205236138,79162
"25893","ENSMODG00000036104","6",291284804,291301392,16588
"25894","ENSMODG00000036105","1",197394790,197397046,2256
"25895","ENSMODG00000036106","6",81040398,81041475,1077
"25896","ENSMODG00000036108","8",94875617,94878929,3312
"25897","ENSMODG00000036109","8",68010149,68022456,12307
"25898","ENSMODG00000036110","4",49520276,49531375,11099
"25899","ENSMODG00000036112","1",372485180,372497521,12341
"25900","ENSMODG00000036113","4",276752975,276771701,18726
"25901","ENSMODG00000036114","4",425976885,425984577,7692
"25902","ENSMODG00000036115","2",76645441,76715937,70496
"25903","ENSMODG00000036116","4",362878701,362880133,1432
"25904","ENSMODG00000036117","5",275663980,275798727,134747
"25905","ENSMODG00000036120","2",511565085,511567641,2556
"25906","ENSMODG00000036121","6",235413714,235432441,18727
"25907","ENSMODG00000036122","2",268755082,268760866,5784
"25908","ENSMODG00000036124","6",134557372,134575867,18495
"25909","ENSMODG00000036125","1",302503510,302623909,120399
"25910","ENSMODG00000036126","2",11564032,11565275,1243
"25911","ENSMODG00000036127","6",169059894,169062142,2248
"25912","ENSMODG00000036129","7",155907056,155926101,19045
"25913","ENSMODG00000036130","Un",43654757,43659058,4301
"25914","ENSMODG00000036131","8",11055093,11095338,40245
"25915","ENSMODG00000036132","3",11597100,11598742,1642
"25916","ENSMODG00000036133","7",62662087,62663084,997
"25917","ENSMODG00000036134","3",120191032,120323572,132540
"25918","ENSMODG00000036135","X",40239049,40251801,12752
"25919","ENSMODG00000036136","2",426940341,426999867,59526
"25920","ENSMODG00000036140","3",507290954,507361880,70926
"25921","ENSMODG00000036141","8",298610769,298614519,3750
"25922","ENSMODG00000036142","3",506188504,506190544,2040
"25923","ENSMODG00000036143","3",358648207,358655162,6955
"25924","ENSMODG00000036144","4",420807194,420837224,30030
"25925","ENSMODG00000036145","4",189649429,189650828,1399
"25926","ENSMODG00000036146","8",283195790,283230304,34514
"25927","ENSMODG00000036147","7",232633442,232637756,4314
"25928","ENSMODG00000036148","7",237339880,237363330,23450
"25929","ENSMODG00000036149","6",7427376,7429080,1704
"25930","ENSMODG00000036150","3",308228490,308265232,36742
"25931","ENSMODG00000036151","4",20994782,21018589,23807
"25932","ENSMODG00000036152","Un",19537938,19540270,2332
"25933","ENSMODG00000036153","8",147487877,147502168,14291
"25934","ENSMODG00000036154","4",419647989,419668594,20605
"25935","ENSMODG00000036155","4",370409746,370413556,3810
"25936","ENSMODG00000036156","2",85342326,85348950,6624
"25937","ENSMODG00000036157","2",47931872,47935949,4077
"25938","ENSMODG00000036158","1",129702424,129706042,3618
"25939","ENSMODG00000036159","3",441561742,441565688,3946
"25940","ENSMODG00000036161","4",57157766,57162477,4711
"25941","ENSMODG00000036163","1",463217489,463247826,30337
"25942","ENSMODG00000036164","4",123630360,123638921,8561
"25943","ENSMODG00000036165","7",9495696,9497097,1401
"25944","ENSMODG00000036166","X",17420008,17446312,26304
"25945","ENSMODG00000036167","X",72977486,72980506,3020
"25946","ENSMODG00000036168","3",3464350,3653139,188789
"25947","ENSMODG00000036169","4",235644242,235646707,2465
"25948","ENSMODG00000036170","4",44675145,44678447,3302
"25949","ENSMODG00000036171","3",92588208,92619612,31404
"25950","ENSMODG00000036176","7",48346032,48366116,20084
"25951","ENSMODG00000036177","Un",49825735,49830587,4852
"25952","ENSMODG00000036178","6",101583652,101648054,64402
"25953","ENSMODG00000036179","1",150522120,150540972,18852
"25954","ENSMODG00000036180","2",525946158,525947592,1434
"25955","ENSMODG00000036181","4",379473332,379495648,22316
"25956","ENSMODG00000036182","3",219898473,219969056,70583
"25957","ENSMODG00000036183","4",70954979,70956956,1977
"25958","ENSMODG00000036184","1",495327490,495352828,25338
"25959","ENSMODG00000036185","5",75240510,75241959,1449
"25960","ENSMODG00000036186","4",289431091,289434096,3005
"25961","ENSMODG00000036187","7",107168240,107169240,1000
"25962","ENSMODG00000036188","8",221531577,221537828,6251
"25963","ENSMODG00000036190","3",405147908,405230163,82255
"25964","ENSMODG00000036191","3",124081628,124160627,78999
"25965","ENSMODG00000036192","3",208881025,208889697,8672
"25966","ENSMODG00000036193","X",66532564,66595004,62440
"25967","ENSMODG00000036195","7",55889578,55915515,25937
"25968","ENSMODG00000036196","1",44522669,44674121,151452
"25969","ENSMODG00000036197","4",104189015,104302211,113196
"25970","ENSMODG00000036199","6",113914699,113930960,16261
"25971","ENSMODG00000036200","1",529157943,529160419,2476
"25972","ENSMODG00000036201","5",204534313,204535727,1414
"25973","ENSMODG00000036202","2",153000761,153001616,855
"25974","ENSMODG00000036203","3",94796120,94806528,10408
"25975","ENSMODG00000036205","1",48042757,48056838,14081
"25976","ENSMODG00000036206","3",74065617,74194100,128483
"25977","ENSMODG00000036207","8",167549575,167591807,42232
"25978","ENSMODG00000036209","5",295474741,295483892,9151
"25979","ENSMODG00000036210","2",140495972,140497767,1795
"25980","ENSMODG00000036211","1",444492449,444630074,137625
"25981","ENSMODG00000036212","8",306390465,306391895,1430
"25982","ENSMODG00000036213","4",108182830,108220685,37855
"25983","ENSMODG00000036215","3",247995724,248028473,32749
"25984","ENSMODG00000036217","4",106439440,106573842,134402
"25985","ENSMODG00000036218","3",121987427,121995665,8238
"25986","ENSMODG00000036219","1",82513978,82516672,2694
"25987","ENSMODG00000036220","8",284705099,284768350,63251
"25988","ENSMODG00000036221","8",192118780,192174276,55496
"25989","ENSMODG00000036224","3",71337356,71343725,6369
"25990","ENSMODG00000036225","2",488698169,488699541,1372
"25991","ENSMODG00000036226","8",276384723,276385717,994
"25992","ENSMODG00000036227","4",338212035,338231229,19194
"25993","ENSMODG00000036228","4",329116563,329118485,1922
"25994","ENSMODG00000036229","2",50991086,50992626,1540
"25995","ENSMODG00000036230","8",74544846,74619905,75059
"25996","ENSMODG00000036231","2",135888672,135892520,3848
"25997","ENSMODG00000036232","3",87705426,87730248,24822
"25998","ENSMODG00000036233","6",24476923,24480133,3210
"25999","ENSMODG00000036234","4",294676685,294680948,4263
"26000","ENSMODG00000036235","1",54869114,54889623,20509
"26001","ENSMODG00000036237","5",172163367,172173084,9717
"26002","ENSMODG00000036239","8",36526409,36527910,1501
"26003","ENSMODG00000036240","8",237900228,237917655,17427
"26004","ENSMODG00000036241","4",314283149,314284727,1578
"26005","ENSMODG00000036242","5",282275654,282368893,93239
"26006","ENSMODG00000036243","6",289859689,289860607,918
"26007","ENSMODG00000036245","5",202441918,202446656,4738
"26008","ENSMODG00000036246","6",193721918,193743494,21576
"26009","ENSMODG00000036247","3",481455100,481502893,47793
"26010","ENSMODG00000036248","6",70136333,70179741,43408
"26011","ENSMODG00000036251","4",235042910,235113441,70531
"26012","ENSMODG00000036255","8",150589012,150620661,31649
"26013","ENSMODG00000036258","7",250876494,250879097,2603
"26014","ENSMODG00000036259","7",258242875,258251839,8964
"26015","ENSMODG00000036261","3",106419238,106423458,4220
"26016","ENSMODG00000036262","5",21129407,21142606,13199
"26017","ENSMODG00000036263","4",271920152,271921840,1688
"26018","ENSMODG00000036264","3",389040237,389101307,61070
"26019","ENSMODG00000036265","8",248152832,248154288,1456
"26020","ENSMODG00000036266","4",107939987,107958224,18237
"26021","ENSMODG00000036267","6",67598703,67671007,72304
"26022","ENSMODG00000036268","7",80670527,80671512,985
"26023","ENSMODG00000036271","8",47095593,47155243,59650
"26024","ENSMODG00000036272","3",326525044,326533718,8674
"26025","ENSMODG00000036275","1",411038850,411113155,74305
"26026","ENSMODG00000036276","X",68740631,68747798,7167
"26027","ENSMODG00000036277","1",280315290,280318703,3413
"26028","ENSMODG00000036278","4",354440297,354447399,7102
"26029","ENSMODG00000036279","2",468239331,468251998,12667
"26030","ENSMODG00000036280","X",50632074,50637819,5745
"26031","ENSMODG00000036281","4",188155230,188157066,1836
"26032","ENSMODG00000036284","4",267829400,267874922,45522
"26033","ENSMODG00000036285","8",113038745,113135982,97237
"26034","ENSMODG00000036286","6",113525594,113669317,143723
"26035","ENSMODG00000036287","3",463372446,463373766,1320
"26036","ENSMODG00000036288","1",464094020,464103610,9590
"26037","ENSMODG00000036289","7",10148835,10151992,3157
"26038","ENSMODG00000036290","2",131602997,131604642,1645
"26039","ENSMODG00000036291","3",451426401,451430863,4462
"26040","ENSMODG00000036292","5",114701410,114765105,63695
"26041","ENSMODG00000036293","8",292530244,292565208,34964
"26042","ENSMODG00000036294","3",337303965,337331996,28031
"26043","ENSMODG00000036295","1",145746844,145899880,153036
"26044","ENSMODG00000036296","8",250232219,250234015,1796
"26045","ENSMODG00000036297","4",33925822,33960135,34313
"26046","ENSMODG00000036298","5",210648851,210687744,38893
"26047","ENSMODG00000036299","8",191584104,191592628,8524
"26048","ENSMODG00000036300","3",116069320,116186326,117006
"26049","ENSMODG00000036301","4",234079854,234176404,96550
"26050","ENSMODG00000036302","2",446674792,446846344,171552
"26051","ENSMODG00000036303","1",163976949,164006257,29308
"26052","ENSMODG00000036304","8",239356492,239357709,1217
"26053","ENSMODG00000036305","1",386267728,386279287,11559
"26054","ENSMODG00000036306","6",111008527,111009357,830
"26055","ENSMODG00000036307","8",280521732,280541926,20194
"26056","ENSMODG00000036308","6",127723880,127726363,2483
"26057","ENSMODG00000036309","5",258426862,258435050,8188
"26058","ENSMODG00000036310","1",275195813,275200202,4389
"26059","ENSMODG00000036311","3",92795595,92796588,993
"26060","ENSMODG00000036312","6",51125647,51178305,52658
"26061","ENSMODG00000036313","1",15411965,15426381,14416
"26062","ENSMODG00000036314","8",57124211,57188762,64551
"26063","ENSMODG00000036315","8",286782313,286783487,1174
"26064","ENSMODG00000036316","4",284370199,284376142,5943
"26065","ENSMODG00000036318","5",229506020,229514131,8111
"26066","ENSMODG00000036319","6",62846227,62847228,1001
"26067","ENSMODG00000036320","8",143350560,143420967,70407
"26068","ENSMODG00000036322","2",370540888,370561548,20660
"26069","ENSMODG00000036323","3",388324057,388381029,56972
"26070","ENSMODG00000036324","2",163652211,163653523,1312
"26071","ENSMODG00000036325","8",114135798,114140011,4213
"26072","ENSMODG00000036326","4",425114373,425124543,10170
"26073","ENSMODG00000036327","4",9518660,9521470,2810
"26074","ENSMODG00000036328","2",15275360,15301993,26633
"26075","ENSMODG00000036329","3",132101480,132237822,136342
"26076","ENSMODG00000036331","2",25875403,25877202,1799
"26077","ENSMODG00000036332","2",401502689,401525182,22493
"26078","ENSMODG00000036333","2",26377451,26417863,40412
"26079","ENSMODG00000036335","X",23216677,23221467,4790
"26080","ENSMODG00000036336","2",169001266,169008635,7369
"26081","ENSMODG00000036338","4",23554239,23557214,2975
"26082","ENSMODG00000036339","5",243140609,243146387,5778
"26083","ENSMODG00000036340","Un",15672145,15676196,4051
"26084","ENSMODG00000036341","1",398055664,398077428,21764
"26085","ENSMODG00000036342","1",485773528,485774630,1102
"26086","ENSMODG00000036343","4",240586990,240589417,2427
"26087","ENSMODG00000036345","X",36448634,36468855,20221
"26088","ENSMODG00000036346","7",61807667,61814435,6768
"26089","ENSMODG00000036347","5",291622784,291623635,851
"26090","ENSMODG00000036348","1",353538122,353667643,129521
"26091","ENSMODG00000036349","6",117542464,117545352,2888
"26092","ENSMODG00000036350","6",218858729,218867429,8700
"26093","ENSMODG00000036351","3",340858108,340944200,86092
"26094","ENSMODG00000036352","4",331871835,331927685,55850
"26095","ENSMODG00000036353","2",108112261,108133157,20896
"26096","ENSMODG00000036354","8",297318964,297327398,8434
"26097","ENSMODG00000036355","3",266154646,266156120,1474
"26098","ENSMODG00000036356","6",19666895,19748738,81843
"26099","ENSMODG00000036358","4",433508161,433509605,1444
"26100","ENSMODG00000036359","1",232424785,232428864,4079
"26101","ENSMODG00000036360","8",223908489,223916075,7586
"26102","ENSMODG00000036361","4",301940203,301944218,4015
"26103","ENSMODG00000036362","1",111223186,111225100,1914
"26104","ENSMODG00000036363","2",487742590,487750139,7549
"26105","ENSMODG00000036364","5",146330519,146351754,21235
"26106","ENSMODG00000036365","5",168083501,168138489,54988
"26107","ENSMODG00000036366","Un",17006538,17015460,8922
"26108","ENSMODG00000036367","4",128933038,128934380,1342
"26109","ENSMODG00000036368","7",240000396,240179560,179164
"26110","ENSMODG00000036370","5",208788074,208887905,99831
